,,,,,,,,,,,,,,,,,,,
,Nibe Marketing Ltd,,,,,,,,,,,,,,,,,,
,,,,,,,,,,,,,,,,,,,
,,,,,,,,,,,,,,,,,,,
Nominal Ledger Transaction History,,,,,,,,,,,,,,,,,,,
,,,,,,,,,,,,,,,,,,,
Report Period from 01/01/2018 to 31/12/2018,,,, ,,,,,,,,,,,,,,,
,,,,,,,,,,,,,,,,,,,
,,,,,,,,,,,,,,,,,,,
,Account: 1 - Suspense B/S,,,,,,,,,,,,,,,,,,
,Pr.,Mod.,Reference,Dept,Div,Suffix,Details,,,Cheque,,User,Doc Date,Post Date,Debit,,Credit,,Balance
,,,,,,Opening Balance as at :01/01/2018,,,,,,,,,0.00,,0.00,,0.00
,IN,AP,40002061,0000,900,,Invoice,,,,,,01/01/2018,01/01/2018,131.15,,0.00,,131.15
,JN,GL,22000070,0000,900,,Opening Balance Adjustment,,,,,,01/01/2018,01/01/2018,0.00,,131.15,,0.00
,JN,GL,22000072,0000,900,,Opening Balance,,,,,,01/01/2018,01/01/2018,326.57,,0.00,,326.57
,JN,GL,22000073,0000,900,,Opening Balance,,,,,,01/01/2018,01/01/2018,0.00,,"6,029.97",,"-5,703.40"
,JN,GL,22000074,0000,900,,Opening Balance,,,,,,01/01/2018,01/01/2018,"6,340.57",,0.00,,637.17
,JN,GL,22000075,0000,900,,Opening Balance,,,,,,01/01/2018,01/01/2018,"7,547.04",,0.00,,"8,184.21"
,JN,GL,22000076,0000,900,,Opening Balance,,,,,,01/01/2018,01/01/2018,336.28,,0.00,,"8,520.49"
,JN,GL,22000077,0000,900,,Opening Balance,,,,,,01/01/2018,01/01/2018,0.00,,"2,028.37",,"6,492.12"
,JN,GL,22000078,0000,900,,Opening Balance,,,,,,01/01/2018,01/01/2018,0.00,,"6,492.12",,0.00
,JN,GL,22000154,0000,900,,Journal Entry,,,,,,16/03/2018,16/03/2018,0.00,,"42,077.04",,"-42,077.04"
,JN,GL,22000460,0000,900,,Journal Entry,,,,,,16/03/2018,16/03/2018,"42,077.04",,0.00,,0.00
,JN,GL,22000265,0000,900,,Journal Entry,,,,,,18/07/2018,18/07/2018,0.00,,"34,700.00",,"-34,700.00"
,JN,GL,22000461,0000,900,,Journal Entry,,,,,,18/07/2018,18/07/2018,"34,700.00",,0.00,,0.00
,JN,GL,22000267,0000,900,,Journal Entry,,,,,,19/07/2018,19/07/2018,0.00,,"6,044.26",,"-6,044.26"
,JN,GL,22000268,0000,900,,Journal Entry,,,,,,21/07/2018,21/07/2018,0.00,,"6,044.26",,"-12,088.52"
,JN,GL,22000462,0000,900,,Journal Entry,,,,,,21/07/2018,21/07/2018,"6,044.26",,0.00,,"-6,044.26"
,JN,GL,22000462,0000,900,,Journal Entry,,,,,,21/07/2018,21/07/2018,"6,044.26",,0.00,,0.00
,JN,GL,22000281,0000,900,,Journal Entry,,,,,,11/08/2018,11/08/2018,0.00,,"49,042.29",,"-49,042.29"
,JN,GL,22000463,0000,900,,Journal Entry,,,,,,11/08/2018,11/08/2018,"49,042.29",,0.00,,0.00
,JN,GL,22000338,0000,900,,Journal Entry,,,,,,31/10/2018,31/10/2018,0.00,,"117,735.40",,"-117,735.40"
,JN,GL,22000464,0000,900,,Journal Entry,,,,,,31/10/2018,31/10/2018,"117,735.40",,0.00,,0.00
,JN,GL,22000355,0000,900,,Journal Entry,,,,,,04/12/2018,04/12/2018,"30,600.00",,0.00,,"30,600.00"
,JN,GL,22000358,0000,900,,Reversal,,,,,,10/12/2018,10/12/2018,0.00,,"3,586.06",,"27,013.94"
,JN,GL,22000358,0000,900,,Eurochange Overpayment,,,,,,10/12/2018,10/12/2018,0.00,,"3,586.06",,"23,427.88"
,JN,GL,22000466,0000,900,,Journal Entry,,,,,,10/12/2018,10/12/2018,"3,586.06",,0.00,,"27,013.94"
,JN,GL,22000357,0000,900,,Journal Entry,,,,,,11/12/2018,11/12/2018,0.00,,"60,341.40",,"-33,327.46"
,JN,GL,22000357,0000,900,,Eurocharge Overpayment,,,,,,11/12/2018,11/12/2018,"3,586.06",,0.00,,"-29,741.40"
,JN,GL,22000361,0000,900,,Nectar Ltd Cash Sales Collected,,,,,,18/12/2018,18/12/2018,"4,035.91",,0.00,,"-25,705.49"
,JN,GL,22000465,0000,900,,Journal Entry,,,,,,18/12/2018,18/12/2018,"25,705.49",,0.00,,0.00
,,,,,,,,,,,,,,,,,,,
,Account: 10 - Suspense P&L,,,,,,,,,,,,,,,,,,
,Pr.,Mod.,Reference,Dept,Div,Suffix,Details,,,Cheque,,User,Doc Date,Post Date,Debit,,Credit,,Balance
,,,,,,Opening Balance as at :01/01/2018,,,,,,,,,0.00,,0.00,,0.00
,CN,AP,41000085,9000,900,,Credit Note,,,,,,01/01/2018,01/01/2018,0.00,,"18,769.71",,"-18,769.71"
,IN,AP,40002062,9000,900,,Invoice,,,,,,01/01/2018,01/01/2018,487.40,,0.00,,"-18,282.31"
,,,,,,,,,,,,,,,,,,,
,IN,AP,40002063,9000,900,,Invoice,,,,,,01/01/2018,01/01/2018,"1,170.00",,0.00,,"-17,112.31"
,IN,AP,40002064,9000,900,,Invoice,,,,,,01/01/2018,01/01/2018,"3,203.87",,0.00,,"-13,908.44"
,IN,AP,40002065,9000,900,,Invoice,,,,,,01/01/2018,01/01/2018,107.77,,0.00,,"-13,800.67"
,IN,AP,40002066,9000,900,,Invoice,,,,,,01/01/2018,01/01/2018,"3,137.38",,0.00,,"-10,663.29"
,IN,AP,40002067,9000,900,,Invoice,,,,,,01/01/2018,01/01/2018,"4,181.03",,0.00,,"-6,482.26"
,IN,AP,40002068,9000,900,,Invoice,,,,,,01/01/2018,01/01/2018,"3,171.07",,0.00,,"-3,311.19"
,JN,GL,22000070,1001,100,,Opening Balance Adjustment,,,,,,01/01/2018,01/01/2018,"3,311.19",,0.00,,0.00
,,,,,,,,,,,,,,,,,,,
,Account: 1000100 - Sales - 19ltr Water,,,,,,,,,,,,,,,,,,
,Pr.,Mod.,Reference,Dept,Div,Suffix,Details,,,Cheque,,User,Doc Date,Post Date,Debit,,Credit,,Balance
,CS,AR,32000036,1005,100,,Cash sale,,,,,,02/01/2018,02/01/2018,0.00,,7.29,,-7.29
,CS,AR,32000084,1005,100,,Cash sale,,,,,,02/01/2018,02/01/2018,0.00,,3.64,,-10.93
,CS,AR,32000111,1005,100,,Cash sale,,,,,,02/01/2018,02/01/2018,0.00,,9.49,,-20.42
,CS,AR,32000128,1005,100,,Cash sale,,,,,,02/01/2018,02/01/2018,0.00,,14.53,,-34.95
,CS,AR,32000186,1005,100,,Cash sale,,,,,,02/01/2018,02/01/2018,0.00,,10.93,,-45.88
,CS,AR,32000214,1005,100,,Cash sale,,,,,,02/01/2018,02/01/2018,0.00,,10.34,,-56.22
,CS,AR,32000256,1005,100,,Cash sale,,,,,,02/01/2018,02/01/2018,0.00,,5.17,,-61.39
,CS,AR,32000260,1005,100,,Cash sale,,,,,,02/01/2018,02/01/2018,0.00,,10.17,,-71.56
,CS,AR,32000274,1005,100,,Cash sale,,,,,,02/01/2018,02/01/2018,0.00,,10.34,,-81.90
,CS,AR,32000280,1005,100,,Cash sale,,,,,,02/01/2018,02/01/2018,0.00,,7.29,,-89.19
,CS,AR,32000289,1005,100,,Cash sale,,,,,,02/01/2018,02/01/2018,0.00,,18.09,,-107.28
,CS,AR,32000309,1005,100,,Cash sale,,,,,,02/01/2018,02/01/2018,0.00,,19.24,,-126.52
,CS,AR,32000325,1005,100,,Cash sale,,,,,,02/01/2018,02/01/2018,0.00,,3.64,,-130.16
,CS,AR,32000445,1005,100,,Cash sale,,,,,,02/01/2018,02/01/2018,0.00,,5.08,,-135.24
,CS,AR,32000459,1005,100,,Cash sale,,,,,,02/01/2018,02/01/2018,0.00,,14.58,,-149.82
,CS,AR,32000469,1005,100,,Cash sale,,,,,,02/01/2018,02/01/2018,0.00,,5.08,,-154.90
,CS,AR,32000480,1005,100,,Cash sale,,,,,,02/01/2018,02/01/2018,0.00,,3.64,,-158.54
,CS,AR,32000507,1005,100,,Cash sale,,,,,,02/01/2018,02/01/2018,0.00,,7.75,,-166.29
,CS,AR,32000603,1005,100,,Cash sale,,,,,,02/01/2018,02/01/2018,0.00,,7.29,,-173.58
,CS,AR,32000628,1005,100,,Cash sale,,,,,,02/01/2018,02/01/2018,0.00,,18.22,,-191.80
,CS,AR,32000699,1005,100,,Cash sale,,,,,,02/01/2018,02/01/2018,0.00,,5.47,,-197.27
,CS,AR,32000709,1005,100,,Cash sale,,,,,,02/01/2018,02/01/2018,0.00,,11.44,,-208.71
,CS,AR,32000734,1005,100,,Cash sale,,,,,,02/01/2018,02/01/2018,0.00,,11.86,,-220.57
,CS,AR,32000770,1005,100,,Cash sale,,,,,,02/01/2018,02/01/2018,0.00,,3.64,,-224.21
,CS,AR,32000783,1005,100,,Cash sale,,,,,,02/01/2018,02/01/2018,0.00,,10.93,,-235.14
,CS,AR,32000811,1005,100,,Cash sale,,,,,,02/01/2018,02/01/2018,0.00,,10.34,,-245.48
,CS,AR,32000869,1005,100,,Cash sale,,,,,,02/01/2018,02/01/2018,0.00,,8.75,,-254.23
,IN,AR,30304360,1005,100,,Invoice,,,,,,02/01/2018,02/01/2018,0.00,,5.93,,-260.16
,IN,AR,30304361,1005,100,,Invoice,,,,,,02/01/2018,02/01/2018,0.00,,59.32,,-319.48
,IN,AR,30304387,1005,100,,Invoice,,,,,,02/01/2018,02/01/2018,0.00,,14.58,,-334.06
,IN,AR,30304477,1005,100,,Invoice,,,,,,02/01/2018,02/01/2018,0.00,,29.59,,-363.65
,IN,AR,30304517,1005,100,,Invoice,,,,,,02/01/2018,02/01/2018,0.00,,75.93,,-439.58
,IN,AR,30304550,1005,100,,Invoice,,,,,,02/01/2018,02/01/2018,0.00,,34.00,,-473.58
,IN,AR,30304568,1005,100,,Invoice,,,,,,02/01/2018,02/01/2018,0.00,,14.58,,-488.16
,IN,AR,30304579,1005,100,,Invoice,,,,,,02/01/2018,02/01/2018,0.00,,21.21,,-509.37
,IN,AR,30304603,1005,100,,Invoice,,,,,,02/01/2018,02/01/2018,0.00,,42.00,,-551.37
,IN,AR,30304626,1005,100,,Invoice,,,,,,02/01/2018,02/01/2018,0.00,,43.22,,-594.59
,IN,AR,30304629,1005,100,,Invoice,,,,,,02/01/2018,02/01/2018,0.00,,5.51,,-600.10
,IN,AR,30304658,1005,100,,Invoice,,,,,,02/01/2018,02/01/2018,0.00,,11.69,,-611.79
,IN,AR,30304771,1005,100,,Invoice,,,,,,02/01/2018,02/01/2018,0.00,,9.66,,-621.45
,IN,AR,30304788,1005,100,,Invoice,,,,,,02/01/2018,02/01/2018,0.00,,8.52,,-629.97
,IN,AR,30304806,1005,100,,Invoice,,,,,,02/01/2018,02/01/2018,0.00,,1.59,,-631.56
,IN,AR,30304807,1005,100,,Invoice,,,,,,02/01/2018,02/01/2018,0.00,,9.56,,-641.12
,IN,AR,30304830,1005,100,,Invoice,,,,,,02/01/2018,02/01/2018,0.00,,5.17,,-646.29
,IN,AR,30304837,1005,100,,Invoice,,,,,,02/01/2018,02/01/2018,0.00,,41.19,,-687.48
,IN,AR,30304839,1005,100,,Invoice,,,,,,02/01/2018,02/01/2018,0.00,,4.64,,-692.12
,IN,AR,30304856,1005,100,,Invoice,,,,,,02/01/2018,02/01/2018,0.00,,16.08,,-708.20
,IN,AR,30304862,1005,100,,Invoice,,,,,,02/01/2018,02/01/2018,0.00,,10.17,,-718.37
,IN,AR,30304881,1005,100,,Invoice,,,,,,02/01/2018,02/01/2018,0.00,,12.92,,-731.29
,IN,AR,30304905,1005,100,,Invoice,,,,,,02/01/2018,02/01/2018,0.00,,61.02,,-792.31
,IN,AR,30304944,1005,100,,Invoice,,,,,,02/01/2018,02/01/2018,0.00,,20.68,,-812.99
,IN,AR,30305019,1005,100,,Invoice,,,,,,02/01/2018,02/01/2018,0.00,,79.98,,-892.97
,IN,AR,30305032,1005,100,,Invoice,,,,,,02/01/2018,02/01/2018,0.00,,43.22,,-936.19
,IN,AR,30305056,1005,100,,Invoice,,,,,,02/01/2018,02/01/2018,0.00,,7.17,,-943.36
,IN,AR,30305075,1005,100,,Invoice,,,,,,02/01/2018,02/01/2018,0.00,,41.86,,-985.22
,IN,AR,30305088,1005,100,,Invoice,,,,,,02/01/2018,02/01/2018,0.00,,6.02,,-991.24
,IN,AR,30305119,1005,100,,Invoice,,,,,,02/01/2018,02/01/2018,0.00,,8.26,,-999.50
,IN,AR,30305122,1005,100,,Invoice,,,,,,02/01/2018,02/01/2018,0.00,,7.29,,"-1,006.79"
,IN,AR,30305138,1005,100,,Invoice,,,,,,02/01/2018,02/01/2018,0.00,,49.02,,"-1,055.81"
,IN,AR,30305216,1005,100,,Invoice,,,,,,02/01/2018,02/01/2018,0.00,,12.71,,"-1,068.52"
,IN,AR,30305324,1005,100,,Invoice,,,,,,02/01/2018,02/01/2018,0.00,,7.29,,"-1,075.81"
,IN,AR,30305351,1005,100,,Invoice,,,,,,02/01/2018,02/01/2018,0.00,,3.90,,"-1,079.71"
,IN,AR,30305352,1005,100,,Invoice,,,,,,02/01/2018,02/01/2018,0.00,,3.64,,"-1,083.35"
,IN,AR,30305371,1005,100,,Invoice,,,,,,02/01/2018,02/01/2018,0.00,,40.68,,"-1,124.03"
,IN,AR,30305387,1005,100,,Invoice,,,,,,02/01/2018,02/01/2018,0.00,,6.10,,"-1,130.13"
,IN,AR,30305392,1005,100,,Invoice,,,,,,02/01/2018,02/01/2018,0.00,,4.08,,"-1,134.21"
,IN,AR,30305396,1005,100,,Invoice,,,,,,02/01/2018,02/01/2018,0.00,,4.96,,"-1,139.17"
,IN,AR,30305402,1005,100,,Invoice,,,,,,02/01/2018,02/01/2018,0.00,,4.78,,"-1,143.95"
,IN,AR,30305417,1005,100,,Invoice,,,,,,02/01/2018,02/01/2018,0.00,,10.53,,"-1,154.48"
,IN,AR,30305491,1005,100,,Invoice,,,,,,02/01/2018,02/01/2018,0.00,,11.02,,"-1,165.50"
,IN,AR,30305502,1005,100,,Invoice,,,,,,02/01/2018,02/01/2018,0.00,,3.64,,"-1,169.14"
,IN,AR,30305531,1005,100,,Invoice,,,,,,02/01/2018,02/01/2018,0.00,,7.88,,"-1,177.02"
,IN,AR,30305559,1005,100,,Invoice,,,,,,02/01/2018,02/01/2018,0.00,,10.34,,"-1,187.36"
,IN,AR,30305624,1005,100,,Invoice,,,,,,02/01/2018,02/01/2018,0.00,,34.17,,"-1,221.53"
,IN,AR,30305644,1005,100,,Invoice,,,,,,02/01/2018,02/01/2018,0.00,,7.02,,"-1,228.55"
,IN,AR,30305658,1005,100,,Invoice,,,,,,02/01/2018,02/01/2018,0.00,,56.78,,"-1,285.33"
,IN,AR,30305679,1005,100,,Invoice,,,,,,02/01/2018,02/01/2018,0.00,,5.59,,"-1,290.92"
,IN,AR,30305698,1005,100,,Invoice,,,,,,02/01/2018,02/01/2018,0.00,,8.52,,"-1,299.44"
,IN,AR,30305703,1005,100,,Invoice,,,,,,02/01/2018,02/01/2018,0.00,,49.25,,"-1,348.69"
,IN,AR,30305795,1005,100,,Invoice,,,,,,02/01/2018,02/01/2018,0.00,,8.81,,"-1,357.50"
,IN,AR,30305992,1005,100,,Invoice,,,,,,02/01/2018,02/01/2018,0.00,,20.04,,"-1,377.54"
,IN,AR,30306026,1005,100,,Invoice,,,,,,02/01/2018,02/01/2018,0.00,,193.86,,"-1,571.40"
,IN,AR,30306036,1005,100,,Invoice,,,,,,02/01/2018,02/01/2018,0.00,,4.81,,"-1,576.21"
,IN,AR,30306097,1005,100,,Invoice,,,,,,02/01/2018,02/01/2018,0.00,,39.41,,"-1,615.62"
,IN,AR,30306152,1005,100,,Invoice,,,,,,02/01/2018,02/01/2018,0.00,,12.71,,"-1,628.33"
,IN,AR,30306167,1005,100,,Invoice,,,,,,02/01/2018,02/01/2018,0.00,,26.01,,"-1,654.34"
,IN,AR,30306194,1005,100,,Invoice,,,,,,02/01/2018,02/01/2018,0.00,,28.39,,"-1,682.73"
,IN,AR,30306267,1005,100,,Invoice,,,,,,02/01/2018,02/01/2018,0.00,,13.69,,"-1,696.42"
,IN,AR,30306272,1005,100,,Invoice,,,,,,02/01/2018,02/01/2018,0.00,,28.05,,"-1,724.47"
,IN,AR,30306308,1005,100,,Invoice,,,,,,02/01/2018,02/01/2018,0.00,,27.31,,"-1,751.78"
,IN,AR,30306314,1005,100,,Invoice,,,,,,02/01/2018,02/01/2018,0.00,,6.13,,"-1,757.91"
,IN,AR,30306324,1005,100,,Invoice,,,,,,02/01/2018,02/01/2018,0.00,,16.61,,"-1,774.52"
,IN,AR,30306333,1005,100,,Invoice,,,,,,02/01/2018,02/01/2018,0.00,,3.64,,"-1,778.16"
,IN,AR,30306335,1005,100,,Invoice,,,,,,02/01/2018,02/01/2018,0.00,,9.84,,"-1,788.00"
,IN,AR,30306357,1005,100,,Invoice,,,,,,02/01/2018,02/01/2018,0.00,,17.49,,"-1,805.49"
,IN,AR,30306370,1005,100,,Invoice,,,,,,02/01/2018,02/01/2018,0.00,,6.37,,"-1,811.86"
,IN,AR,30306414,1005,100,,Invoice,,,,,,02/01/2018,02/01/2018,0.00,,94.92,,"-1,906.78"
,IN,AR,30306434,1005,100,,Invoice,,,,,,02/01/2018,02/01/2018,0.00,,12.00,,"-1,918.78"
,IN,AR,30306479,1005,100,,Invoice,,,,,,02/01/2018,02/01/2018,0.00,,76.64,,"-1,995.42"
,IN,AR,30306498,1005,100,,Invoice,,,,,,02/01/2018,02/01/2018,0.00,,5.26,,"-2,000.68"
,IN,AR,30306602,1005,100,,Invoice,,,,,,02/01/2018,02/01/2018,0.00,,8.17,,"-2,008.85"
,CN,AR,31016878,1005,100,,Credit Note,,,,,,03/01/2018,03/01/2018,7.29,,0.00,,"-2,001.56"
,CN,AR,31016990,1005,100,,Credit Note,,,,,,03/01/2018,03/01/2018,6.02,,0.00,,"-1,995.54"
,CN,AR,31017017,1005,100,,Credit Note,,,,,,03/01/2018,03/01/2018,426.86,,0.00,,"-1,568.68"
,CN,AR,31017138,1005,100,,Credit Note,,,,,,03/01/2018,03/01/2018,7.29,,0.00,,"-1,561.39"
,CS,AR,32000007,1005,100,,Cash sale,,,,,,03/01/2018,03/01/2018,0.00,,11.22,,"-1,572.61"
,CS,AR,32000018,1005,100,,Cash sale,,,,,,03/01/2018,03/01/2018,0.00,,3.64,,"-1,576.25"
,CS,AR,32000020,1005,100,,Cash sale,,,,,,03/01/2018,03/01/2018,0.00,,32.61,,"-1,608.86"
,CS,AR,32000025,1005,100,,Cash sale,,,,,,03/01/2018,03/01/2018,0.00,,28.47,,"-1,637.33"
,CS,AR,32000050,1005,100,,Cash sale,,,,,,03/01/2018,03/01/2018,0.00,,21.86,,"-1,659.19"
,CS,AR,32000053,1005,100,,Cash sale,,,,,,03/01/2018,03/01/2018,0.00,,7.29,,"-1,666.48"
,CS,AR,32000055,1005,100,,Cash sale,,,,,,03/01/2018,03/01/2018,0.00,,7.29,,"-1,673.77"
,CS,AR,32000069,1005,100,,Cash sale,,,,,,03/01/2018,03/01/2018,0.00,,3.64,,"-1,677.41"
,CS,AR,32000088,1005,100,,Cash sale,,,,,,03/01/2018,03/01/2018,0.00,,42.12,,"-1,719.53"
,CS,AR,32000108,1005,100,,Cash sale,,,,,,03/01/2018,03/01/2018,0.00,,10.93,,"-1,730.46"
,CS,AR,32000159,1005,100,,Cash sale,,,,,,03/01/2018,03/01/2018,0.00,,3.64,,"-1,734.10"
,CS,AR,32000189,1005,100,,Cash sale,,,,,,03/01/2018,03/01/2018,0.00,,20.69,,"-1,754.79"
,CS,AR,32000198,1005,100,,Cash sale,,,,,,03/01/2018,03/01/2018,0.00,,3.64,,"-1,758.43"
,CS,AR,32000203,1005,100,,Cash sale,,,,,,03/01/2018,03/01/2018,0.00,,5.86,,"-1,764.29"
,CS,AR,32000237,1005,100,,Cash sale,,,,,,03/01/2018,03/01/2018,0.00,,12.03,,"-1,776.32"
,CS,AR,32000261,1005,100,,Cash sale,,,,,,03/01/2018,03/01/2018,0.00,,10.17,,"-1,786.49"
,CS,AR,32000285,1005,100,,Cash sale,,,,,,03/01/2018,03/01/2018,0.00,,7.29,,"-1,793.78"
,CS,AR,32000303,1005,100,,Cash sale,,,,,,03/01/2018,03/01/2018,0.00,,3.64,,"-1,797.42"
,CS,AR,32000363,1005,100,,Cash sale,,,,,,03/01/2018,03/01/2018,0.00,,2.54,,"-1,799.96"
,CS,AR,32000366,1005,100,,Cash sale,,,,,,03/01/2018,03/01/2018,0.00,,12.71,,"-1,812.67"
,CS,AR,32000382,1005,100,,Cash sale,,,,,,03/01/2018,03/01/2018,0.00,,35.08,,"-1,847.75"
,CS,AR,32000394,1005,100,,Cash sale,,,,,,03/01/2018,03/01/2018,0.00,,6.02,,"-1,853.77"
,CS,AR,32000397,1005,100,,Cash sale,,,,,,03/01/2018,03/01/2018,0.00,,4.32,,"-1,858.09"
,CS,AR,32000402,1005,100,,Cash sale,,,,,,03/01/2018,03/01/2018,0.00,,33.09,,"-1,891.18"
,CS,AR,32000437,1005,100,,Cash sale,,,,,,03/01/2018,03/01/2018,0.00,,3.64,,"-1,894.82"
,CS,AR,32000472,1005,100,,Cash sale,,,,,,03/01/2018,03/01/2018,0.00,,7.29,,"-1,902.11"
,CS,AR,32000500,1005,100,,Cash sale,,,,,,03/01/2018,03/01/2018,0.00,,18.09,,"-1,920.20"
,CS,AR,32000509,1005,100,,Cash sale,,,,,,03/01/2018,03/01/2018,0.00,,14.58,,"-1,934.78"
,CS,AR,32000517,1005,100,,Cash sale,,,,,,03/01/2018,03/01/2018,0.00,,7.29,,"-1,942.07"
,CS,AR,32000581,1005,100,,Cash sale,,,,,,03/01/2018,03/01/2018,0.00,,21.44,,"-1,963.51"
,CS,AR,32000643,1005,100,,Cash sale,,,,,,03/01/2018,03/01/2018,0.00,,7.29,,"-1,970.80"
,CS,AR,32000645,1005,100,,Cash sale,,,,,,03/01/2018,03/01/2018,0.00,,5.17,,"-1,975.97"
,CS,AR,32000655,1005,100,,Cash sale,,,,,,03/01/2018,03/01/2018,0.00,,3.64,,"-1,979.61"
,CS,AR,32000689,1005,100,,Cash sale,,,,,,03/01/2018,03/01/2018,0.00,,8.20,,"-1,987.81"
,CS,AR,32000707,1005,100,,Cash sale,,,,,,03/01/2018,03/01/2018,0.00,,7.29,,"-1,995.10"
,CS,AR,32000730,1005,100,,Cash sale,,,,,,03/01/2018,03/01/2018,0.00,,6.07,,"-2,001.17"
,CS,AR,32000764,1005,100,,Cash sale,,,,,,03/01/2018,03/01/2018,0.00,,25.51,,"-2,026.68"
,CS,AR,32000781,1005,100,,Cash sale,,,,,,03/01/2018,03/01/2018,0.00,,13.98,,"-2,040.66"
,CS,AR,32000784,1005,100,,Cash sale,,,,,,03/01/2018,03/01/2018,0.00,,7.29,,"-2,047.95"
,CS,AR,32000817,1005,100,,Cash sale,,,,,,03/01/2018,03/01/2018,0.00,,9.10,,"-2,057.05"
,CS,AR,32000823,1005,100,,Cash sale,,,,,,03/01/2018,03/01/2018,0.00,,7.29,,"-2,064.34"
,CS,AR,32000841,1005,100,,Cash sale,,,,,,03/01/2018,03/01/2018,0.00,,14.58,,"-2,078.92"
,IN,AR,30304351,1005,100,,Invoice,,,,,,03/01/2018,03/01/2018,0.00,,6.02,,"-2,084.94"
,IN,AR,30304355,1005,100,,Invoice,,,,,,03/01/2018,03/01/2018,0.00,,84.54,,"-2,169.48"
,IN,AR,30304428,1005,100,,Invoice,,,,,,03/01/2018,03/01/2018,0.00,,11.36,,"-2,180.84"
,IN,AR,30304434,1005,100,,Invoice,,,,,,03/01/2018,03/01/2018,0.00,,7.29,,"-2,188.13"
,IN,AR,30304453,1005,100,,Invoice,,,,,,03/01/2018,03/01/2018,0.00,,31.40,,"-2,219.53"
,IN,AR,30304466,1005,100,,Invoice,,,,,,03/01/2018,03/01/2018,0.00,,3.50,,"-2,223.03"
,IN,AR,30304494,1005,100,,Invoice,,,,,,03/01/2018,03/01/2018,0.00,,2.16,,"-2,225.19"
,IN,AR,30304499,1005,100,,Invoice,,,,,,03/01/2018,03/01/2018,0.00,,18.22,,"-2,243.41"
,IN,AR,30304518,1005,100,,Invoice,,,,,,03/01/2018,03/01/2018,0.00,,149.49,,"-2,392.90"
,IN,AR,30304547,1005,100,,Invoice,,,,,,03/01/2018,03/01/2018,0.00,,7.29,,"-2,400.19"
,IN,AR,30304589,1005,100,,Invoice,,,,,,03/01/2018,03/01/2018,0.00,,10.93,,"-2,411.12"
,IN,AR,30304645,1005,100,,Invoice,,,,,,03/01/2018,03/01/2018,0.00,,9.73,,"-2,420.85"
,IN,AR,30304650,1005,100,,Invoice,,,,,,03/01/2018,03/01/2018,0.00,,24.00,,"-2,444.85"
,IN,AR,30304683,1005,100,,Invoice,,,,,,03/01/2018,03/01/2018,0.00,,7.29,,"-2,452.14"
,IN,AR,30304708,1005,100,,Invoice,,,,,,03/01/2018,03/01/2018,0.00,,8.52,,"-2,460.66"
,IN,AR,30304747,1005,100,,Invoice,,,,,,03/01/2018,03/01/2018,0.00,,38.00,,"-2,498.66"
,IN,AR,30304760,1005,100,,Invoice,,,,,,03/01/2018,03/01/2018,0.00,,21.86,,"-2,520.52"
,IN,AR,30304780,1005,100,,Invoice,,,,,,03/01/2018,03/01/2018,0.00,,21.22,,"-2,541.74"
,IN,AR,30304864,1005,100,,Invoice,,,,,,03/01/2018,03/01/2018,0.00,,7.29,,"-2,549.03"
,IN,AR,30304870,1005,100,,Invoice,,,,,,03/01/2018,03/01/2018,0.00,,15.25,,"-2,564.28"
,IN,AR,30304914,1005,100,,Invoice,,,,,,03/01/2018,03/01/2018,0.00,,7.75,,"-2,572.03"
,IN,AR,30304972,1005,100,,Invoice,,,,,,03/01/2018,03/01/2018,0.00,,10.38,,"-2,582.41"
,IN,AR,30304982,1005,100,,Invoice,,,,,,03/01/2018,03/01/2018,0.00,,21.51,,"-2,603.92"
,IN,AR,30305047,1005,100,,Invoice,,,,,,03/01/2018,03/01/2018,0.00,,12.58,,"-2,616.50"
,IN,AR,30305057,1005,100,,Invoice,,,,,,03/01/2018,03/01/2018,0.00,,23.90,,"-2,640.40"
,IN,AR,30305125,1005,100,,Invoice,,,,,,03/01/2018,03/01/2018,0.00,,5.17,,"-2,645.57"
,IN,AR,30305129,1005,100,,Invoice,,,,,,03/01/2018,03/01/2018,0.00,,2.58,,"-2,648.15"
,IN,AR,30305152,1005,100,,Invoice,,,,,,03/01/2018,03/01/2018,0.00,,6.02,,"-2,654.17"
,IN,AR,30305153,1005,100,,Invoice,,,,,,03/01/2018,03/01/2018,0.00,,6.02,,"-2,660.19"
,IN,AR,30305155,1005,100,,Invoice,,,,,,03/01/2018,03/01/2018,0.00,,150.04,,"-2,810.23"
,IN,AR,30305217,1005,100,,Invoice,,,,,,03/01/2018,03/01/2018,0.00,,5.08,,"-2,815.31"
,IN,AR,30305242,1005,100,,Invoice,,,,,,03/01/2018,03/01/2018,0.00,,38.24,,"-2,853.55"
,IN,AR,30305423,1005,100,,Invoice,,,,,,03/01/2018,03/01/2018,0.00,,7.29,,"-2,860.84"
,IN,AR,30305432,1005,100,,Invoice,,,,,,03/01/2018,03/01/2018,0.00,,10.93,,"-2,871.77"
,IN,AR,30305459,1005,100,,Invoice,,,,,,03/01/2018,03/01/2018,0.00,,7.29,,"-2,879.06"
,IN,AR,30305472,1005,100,,Invoice,,,,,,03/01/2018,03/01/2018,0.00,,4.78,,"-2,883.84"
,IN,AR,30305496,1005,100,,Invoice,,,,,,03/01/2018,03/01/2018,0.00,,3.64,,"-2,887.48"
,IN,AR,30305514,1005,100,,Invoice,,,,,,03/01/2018,03/01/2018,0.00,,16.08,,"-2,903.56"
,IN,AR,30305519,1005,100,,Invoice,,,,,,03/01/2018,03/01/2018,0.00,,22.44,,"-2,926.00"
,IN,AR,30305571,1005,100,,Invoice,,,,,,03/01/2018,03/01/2018,0.00,,21.86,,"-2,947.86"
,IN,AR,30305588,1005,100,,Invoice,,,,,,03/01/2018,03/01/2018,0.00,,10.93,,"-2,958.79"
,IN,AR,30305719,1005,100,,Invoice,,,,,,03/01/2018,03/01/2018,0.00,,11.23,,"-2,970.02"
,IN,AR,30305725,1005,100,,Invoice,,,,,,03/01/2018,03/01/2018,0.00,,21.06,,"-2,991.08"
,IN,AR,30305733,1005,100,,Invoice,,,,,,03/01/2018,03/01/2018,0.00,,30.08,,"-3,021.16"
,IN,AR,30305763,1005,100,,Invoice,,,,,,03/01/2018,03/01/2018,0.00,,7.29,,"-3,028.45"
,IN,AR,30305790,1005,100,,Invoice,,,,,,03/01/2018,03/01/2018,0.00,,7.29,,"-3,035.74"
,IN,AR,30305796,1005,100,,Invoice,,,,,,03/01/2018,03/01/2018,0.00,,1.76,,"-3,037.50"
,IN,AR,30305892,1005,100,,Invoice,,,,,,03/01/2018,03/01/2018,0.00,,6.43,,"-3,043.93"
,IN,AR,30305914,1005,100,,Invoice,,,,,,03/01/2018,03/01/2018,0.00,,54.66,,"-3,098.59"
,IN,AR,30305931,1005,100,,Invoice,,,,,,03/01/2018,03/01/2018,0.00,,9.76,,"-3,108.35"
,IN,AR,30305965,1005,100,,Invoice,,,,,,03/01/2018,03/01/2018,0.00,,31.23,,"-3,139.58"
,IN,AR,30305973,1005,100,,Invoice,,,,,,03/01/2018,03/01/2018,0.00,,38.00,,"-3,177.58"
,IN,AR,30305980,1005,100,,Invoice,,,,,,03/01/2018,03/01/2018,0.00,,20.95,,"-3,198.53"
,IN,AR,30305989,1005,100,,Invoice,,,,,,03/01/2018,03/01/2018,0.00,,14.03,,"-3,212.56"
,IN,AR,30306008,1005,100,,Invoice,,,,,,03/01/2018,03/01/2018,0.00,,26.69,,"-3,239.25"
,IN,AR,30306009,1005,100,,Invoice,,,,,,03/01/2018,03/01/2018,0.00,,7.29,,"-3,246.54"
,IN,AR,30306022,1005,100,,Invoice,,,,,,03/01/2018,03/01/2018,0.00,,17.29,,"-3,263.83"
,IN,AR,30306037,1005,100,,Invoice,,,,,,03/01/2018,03/01/2018,0.00,,6.42,,"-3,270.25"
,IN,AR,30306038,1005,100,,Invoice,,,,,,03/01/2018,03/01/2018,0.00,,16.03,,"-3,286.28"
,IN,AR,30306039,1005,100,,Invoice,,,,,,03/01/2018,03/01/2018,0.00,,3.20,,"-3,289.48"
,IN,AR,30306040,1005,100,,Invoice,,,,,,03/01/2018,03/01/2018,0.00,,3.20,,"-3,292.68"
,IN,AR,30306104,1005,100,,Invoice,,,,,,03/01/2018,03/01/2018,0.00,,4.58,,"-3,297.26"
,IN,AR,30306193,1005,100,,Invoice,,,,,,03/01/2018,03/01/2018,0.00,,21.86,,"-3,319.12"
,IN,AR,30306199,1005,100,,Invoice,,,,,,03/01/2018,03/01/2018,0.00,,4.53,,"-3,323.65"
,IN,AR,30306200,1005,100,,Invoice,,,,,,03/01/2018,03/01/2018,0.00,,72.41,,"-3,396.06"
,IN,AR,30306242,1005,100,,Invoice,,,,,,03/01/2018,03/01/2018,0.00,,10.93,,"-3,406.99"
,IN,AR,30306262,1005,100,,Invoice,,,,,,03/01/2018,03/01/2018,0.00,,144.49,,"-3,551.48"
,IN,AR,30306359,1005,100,,Invoice,,,,,,03/01/2018,03/01/2018,0.00,,42.71,,"-3,594.19"
,IN,AR,30306371,1005,100,,Invoice,,,,,,03/01/2018,03/01/2018,0.00,,11.15,,"-3,605.34"
,IN,AR,30306415,1005,100,,Invoice,,,,,,03/01/2018,03/01/2018,0.00,,28.47,,"-3,633.81"
,IN,AR,30306447,1005,100,,Invoice,,,,,,03/01/2018,03/01/2018,0.00,,5.64,,"-3,639.45"
,IN,AR,30306455,1005,100,,Invoice,,,,,,03/01/2018,03/01/2018,0.00,,3.51,,"-3,642.96"
,IN,AR,30306472,1005,100,,Invoice,,,,,,03/01/2018,03/01/2018,0.00,,7.29,,"-3,650.25"
,IN,AR,30306476,1005,100,,Invoice,,,,,,03/01/2018,03/01/2018,0.00,,54.66,,"-3,704.91"
,IN,AR,30306532,1005,100,,Invoice,,,,,,03/01/2018,03/01/2018,0.00,,3.76,,"-3,708.67"
,IN,AR,30306580,1005,100,,Invoice,,,,,,03/01/2018,03/01/2018,0.00,,72.88,,"-3,781.55"
,IN,AR,30306593,1005,100,,Invoice,,,,,,03/01/2018,03/01/2018,0.00,,14.83,,"-3,796.38"
,IN,AR,30306596,1005,100,,Invoice,,,,,,03/01/2018,03/01/2018,0.00,,8.39,,"-3,804.77"
,IN,AR,30306614,1005,100,,Invoice,,,,,,03/01/2018,03/01/2018,0.00,,29.15,,"-3,833.92"
,IN,AR,30306617,1005,100,,Invoice,,,,,,03/01/2018,03/01/2018,0.00,,419.07,,"-4,252.99"
,CR,AR,33000014,1005,100,,Cash Return,,,,,,04/01/2018,04/01/2018,9.03,,0.00,,"-4,243.96"
,CS,AR,32000004,1005,100,,Cash sale,,,,,,04/01/2018,04/01/2018,0.00,,18.05,,"-4,262.01"
,CS,AR,32000104,1005,100,,Cash sale,,,,,,04/01/2018,04/01/2018,0.00,,7.29,,"-4,269.30"
,CS,AR,32000139,1005,100,,Cash sale,,,,,,04/01/2018,04/01/2018,0.00,,3.64,,"-4,272.94"
,CS,AR,32000148,1005,100,,Cash sale,,,,,,04/01/2018,04/01/2018,0.00,,6.02,,"-4,278.96"
,CS,AR,32000173,1005,100,,Cash sale,,,,,,04/01/2018,04/01/2018,0.00,,7.29,,"-4,286.25"
,CS,AR,32000310,1005,100,,Cash sale,,,,,,04/01/2018,04/01/2018,0.00,,19.24,,"-4,305.49"
,CS,AR,32000320,1005,100,,Cash sale,,,,,,04/01/2018,04/01/2018,0.00,,12.03,,"-4,317.52"
,CS,AR,32000345,1005,100,,Cash sale,,,,,,04/01/2018,04/01/2018,0.00,,10.93,,"-4,328.45"
,CS,AR,32000391,1005,100,,Cash sale,,,,,,04/01/2018,04/01/2018,0.00,,13.47,,"-4,341.92"
,CS,AR,32000462,1005,100,,Cash sale,,,,,,04/01/2018,04/01/2018,0.00,,7.29,,"-4,349.21"
,CS,AR,32000491,1005,100,,Cash sale,,,,,,04/01/2018,04/01/2018,0.00,,3.64,,"-4,352.85"
,CS,AR,32000494,1005,100,,Cash sale,,,,,,04/01/2018,04/01/2018,0.00,,36.36,,"-4,389.21"
,CS,AR,32000523,1005,100,,Cash sale,,,,,,04/01/2018,04/01/2018,0.00,,12.03,,"-4,401.24"
,CS,AR,32000531,1005,100,,Cash sale,,,,,,04/01/2018,04/01/2018,0.00,,3.64,,"-4,404.88"
,CS,AR,32000544,1005,100,,Cash sale,,,,,,04/01/2018,04/01/2018,0.00,,2.58,,"-4,407.46"
,CS,AR,32000562,1005,100,,Cash sale,,,,,,04/01/2018,04/01/2018,0.00,,3.64,,"-4,411.10"
,CS,AR,32000574,1005,100,,Cash sale,,,,,,04/01/2018,04/01/2018,0.00,,54.66,,"-4,465.76"
,CS,AR,32000616,1005,100,,Cash sale,,,,,,04/01/2018,04/01/2018,0.00,,7.86,,"-4,473.62"
,CS,AR,32000658,1005,100,,Cash sale,,,,,,04/01/2018,04/01/2018,0.00,,29.15,,"-4,502.77"
,CS,AR,32000674,1005,100,,Cash sale,,,,,,04/01/2018,04/01/2018,0.00,,2.62,,"-4,505.39"
,CS,AR,32000680,1005,100,,Cash sale,,,,,,04/01/2018,04/01/2018,0.00,,15.17,,"-4,520.56"
,CS,AR,32000687,1005,100,,Cash sale,,,,,,04/01/2018,04/01/2018,0.00,,5.93,,"-4,526.49"
,CS,AR,32000759,1005,100,,Cash sale,,,,,,04/01/2018,04/01/2018,0.00,,15.04,,"-4,541.53"
,CS,AR,32000766,1005,100,,Cash sale,,,,,,04/01/2018,04/01/2018,0.00,,10.93,,"-4,552.46"
,CS,AR,32000780,1005,100,,Cash sale,,,,,,04/01/2018,04/01/2018,0.00,,5.47,,"-4,557.93"
,CS,AR,32000894,1005,100,,Cash sale,,,,,,04/01/2018,04/01/2018,0.00,,10.93,,"-4,568.86"
,CS,AR,32000900,1005,100,,Cash sale,,,,,,04/01/2018,04/01/2018,0.00,,7.29,,"-4,576.15"
,CS,AR,32000904,1005,100,,Cash sale,,,,,,04/01/2018,04/01/2018,0.00,,7.29,,"-4,583.44"
,IN,AR,30304381,1005,100,,Invoice,,,,,,04/01/2018,04/01/2018,0.00,,3.64,,"-4,587.08"
,IN,AR,30304392,1005,100,,Invoice,,,,,,04/01/2018,04/01/2018,0.00,,40.34,,"-4,627.42"
,IN,AR,30304459,1005,100,,Invoice,,,,,,04/01/2018,04/01/2018,0.00,,18.22,,"-4,645.64"
,IN,AR,30304486,1005,100,,Invoice,,,,,,04/01/2018,04/01/2018,0.00,,32.80,,"-4,678.44"
,IN,AR,30304519,1005,100,,Invoice,,,,,,04/01/2018,04/01/2018,0.00,,21.36,,"-4,699.80"
,IN,AR,30304660,1005,100,,Invoice,,,,,,04/01/2018,04/01/2018,0.00,,49.83,,"-4,749.63"
,IN,AR,30304691,1005,100,,Invoice,,,,,,04/01/2018,04/01/2018,0.00,,21.97,,"-4,771.60"
,IN,AR,30304799,1005,100,,Invoice,,,,,,04/01/2018,04/01/2018,0.00,,7.29,,"-4,778.89"
,IN,AR,30304821,1005,100,,Invoice,,,,,,04/01/2018,04/01/2018,0.00,,14.00,,"-4,792.89"
,IN,AR,30304844,1005,100,,Invoice,,,,,,04/01/2018,04/01/2018,0.00,,15.04,,"-4,807.93"
,IN,AR,30304987,1005,100,,Invoice,,,,,,04/01/2018,04/01/2018,0.00,,10.93,,"-4,818.86"
,IN,AR,30304993,1005,100,,Invoice,,,,,,04/01/2018,04/01/2018,0.00,,11.95,,"-4,830.81"
,IN,AR,30305001,1005,100,,Invoice,,,,,,04/01/2018,04/01/2018,0.00,,7.17,,"-4,837.98"
,IN,AR,30305008,1005,100,,Invoice,,,,,,04/01/2018,04/01/2018,0.00,,76.53,,"-4,914.51"
,IN,AR,30305015,1005,100,,Invoice,,,,,,04/01/2018,04/01/2018,0.00,,5.08,,"-4,919.59"
,IN,AR,30305033,1005,100,,Invoice,,,,,,04/01/2018,04/01/2018,0.00,,73.73,,"-4,993.32"
,IN,AR,30305034,1005,100,,Invoice,,,,,,04/01/2018,04/01/2018,0.00,,17.80,,"-5,011.12"
,IN,AR,30305051,1005,100,,Invoice,,,,,,04/01/2018,04/01/2018,0.00,,3.64,,"-5,014.76"
,IN,AR,30305058,1005,100,,Invoice,,,,,,04/01/2018,04/01/2018,0.00,,21.51,,"-5,036.27"
,IN,AR,30305083,1005,100,,Invoice,,,,,,04/01/2018,04/01/2018,0.00,,19.32,,"-5,055.59"
,IN,AR,30305106,1005,100,,Invoice,,,,,,04/01/2018,04/01/2018,0.00,,7.75,,"-5,063.34"
,IN,AR,30305200,1005,100,,Invoice,,,,,,04/01/2018,04/01/2018,0.00,,12.92,,"-5,076.26"
,IN,AR,30305210,1005,100,,Invoice,,,,,,04/01/2018,04/01/2018,0.00,,2.39,,"-5,078.65"
,IN,AR,30305218,1005,100,,Invoice,,,,,,04/01/2018,04/01/2018,0.00,,7.63,,"-5,086.28"
,IN,AR,30305243,1005,100,,Invoice,,,,,,04/01/2018,04/01/2018,0.00,,47.80,,"-5,134.08"
,IN,AR,30305254,1005,100,,Invoice,,,,,,04/01/2018,04/01/2018,0.00,,9.19,,"-5,143.27"
,IN,AR,30305259,1005,100,,Invoice,,,,,,04/01/2018,04/01/2018,0.00,,7.29,,"-5,150.56"
,IN,AR,30305264,1005,100,,Invoice,,,,,,04/01/2018,04/01/2018,0.00,,2.58,,"-5,153.14"
,IN,AR,30305268,1005,100,,Invoice,,,,,,04/01/2018,04/01/2018,0.00,,2.58,,"-5,155.72"
,IN,AR,30305382,1005,100,,Invoice,,,,,,04/01/2018,04/01/2018,0.00,,20.00,,"-5,175.72"
,IN,AR,30305407,1005,100,,Invoice,,,,,,04/01/2018,04/01/2018,0.00,,15.25,,"-5,190.97"
,IN,AR,30305477,1005,100,,Invoice,,,,,,04/01/2018,04/01/2018,0.00,,30.30,,"-5,221.27"
,IN,AR,30305483,1005,100,,Invoice,,,,,,04/01/2018,04/01/2018,0.00,,18.22,,"-5,239.49"
,IN,AR,30305510,1005,100,,Invoice,,,,,,04/01/2018,04/01/2018,0.00,,10.98,,"-5,250.47"
,IN,AR,30305551,1005,100,,Invoice,,,,,,04/01/2018,04/01/2018,0.00,,9.15,,"-5,259.62"
,IN,AR,30305552,1005,100,,Invoice,,,,,,04/01/2018,04/01/2018,0.00,,2.29,,"-5,261.91"
,IN,AR,30305619,1005,100,,Invoice,,,,,,04/01/2018,04/01/2018,0.00,,36.36,,"-5,298.27"
,IN,AR,30305654,1005,100,,Invoice,,,,,,04/01/2018,04/01/2018,0.00,,4.64,,"-5,302.91"
,IN,AR,30305667,1005,100,,Invoice,,,,,,04/01/2018,04/01/2018,0.00,,8.77,,"-5,311.68"
,IN,AR,30305674,1005,100,,Invoice,,,,,,04/01/2018,04/01/2018,0.00,,19.28,,"-5,330.96"
,IN,AR,30305712,1005,100,,Invoice,,,,,,04/01/2018,04/01/2018,0.00,,54.66,,"-5,385.62"
,IN,AR,30305714,1005,100,,Invoice,,,,,,04/01/2018,04/01/2018,0.00,,15.51,,"-5,401.13"
,IN,AR,30305740,1005,100,,Invoice,,,,,,04/01/2018,04/01/2018,0.00,,14.58,,"-5,415.71"
,IN,AR,30305751,1005,100,,Invoice,,,,,,04/01/2018,04/01/2018,0.00,,11.64,,"-5,427.35"
,IN,AR,30305756,1005,100,,Invoice,,,,,,04/01/2018,04/01/2018,0.00,,2.54,,"-5,429.89"
,IN,AR,30305767,1005,100,,Invoice,,,,,,04/01/2018,04/01/2018,0.00,,28.39,,"-5,458.28"
,IN,AR,30305771,1005,100,,Invoice,,,,,,04/01/2018,04/01/2018,0.00,,4.00,,"-5,462.28"
,IN,AR,30305776,1005,100,,Invoice,,,,,,04/01/2018,04/01/2018,0.00,,7.53,,"-5,469.81"
,IN,AR,30305794,1005,100,,Invoice,,,,,,04/01/2018,04/01/2018,0.00,,27.97,,"-5,497.78"
,IN,AR,30305797,1005,100,,Invoice,,,,,,04/01/2018,04/01/2018,0.00,,3.53,,"-5,501.31"
,IN,AR,30305798,1005,100,,Invoice,,,,,,04/01/2018,04/01/2018,0.00,,3.53,,"-5,504.84"
,IN,AR,30305810,1005,100,,Invoice,,,,,,04/01/2018,04/01/2018,0.00,,3.01,,"-5,507.85"
,IN,AR,30305829,1005,100,,Invoice,,,,,,04/01/2018,04/01/2018,0.00,,4.54,,"-5,512.39"
,IN,AR,30305834,1005,100,,Invoice,,,,,,04/01/2018,04/01/2018,0.00,,8.24,,"-5,520.63"
,IN,AR,30305841,1005,100,,Invoice,,,,,,04/01/2018,04/01/2018,0.00,,21.90,,"-5,542.53"
,IN,AR,30305851,1005,100,,Invoice,,,,,,04/01/2018,04/01/2018,0.00,,7.29,,"-5,549.82"
,IN,AR,30305865,1005,100,,Invoice,,,,,,04/01/2018,04/01/2018,0.00,,10.00,,"-5,559.82"
,IN,AR,30305885,1005,100,,Invoice,,,,,,04/01/2018,04/01/2018,0.00,,7.29,,"-5,567.11"
,IN,AR,30305915,1005,100,,Invoice,,,,,,04/01/2018,04/01/2018,0.00,,10.93,,"-5,578.04"
,IN,AR,30305932,1005,100,,Invoice,,,,,,04/01/2018,04/01/2018,0.00,,13.02,,"-5,591.06"
,IN,AR,30305933,1005,100,,Invoice,,,,,,04/01/2018,04/01/2018,0.00,,6.51,,"-5,597.57"
,IN,AR,30305934,1005,100,,Invoice,,,,,,04/01/2018,04/01/2018,0.00,,1.63,,"-5,599.20"
,IN,AR,30305947,1005,100,,Invoice,,,,,,04/01/2018,04/01/2018,0.00,,7.95,,"-5,607.15"
,IN,AR,30305972,1005,100,,Invoice,,,,,,04/01/2018,04/01/2018,0.00,,24.00,,"-5,631.15"
,IN,AR,30306004,1005,100,,Invoice,,,,,,04/01/2018,04/01/2018,0.00,,10.93,,"-5,642.08"
,IN,AR,30306013,1005,100,,Invoice,,,,,,04/01/2018,04/01/2018,0.00,,3.64,,"-5,645.72"
,IN,AR,30306032,1005,100,,Invoice,,,,,,04/01/2018,04/01/2018,0.00,,7.29,,"-5,653.01"
,IN,AR,30306041,1005,100,,Invoice,,,,,,04/01/2018,04/01/2018,0.00,,9.62,,"-5,662.63"
,IN,AR,30306042,1005,100,,Invoice,,,,,,04/01/2018,04/01/2018,0.00,,8.02,,"-5,670.65"
,IN,AR,30306043,1005,100,,Invoice,,,,,,04/01/2018,04/01/2018,0.00,,3.20,,"-5,673.85"
,IN,AR,30306111,1005,100,,Invoice,,,,,,04/01/2018,04/01/2018,0.00,,3.28,,"-5,677.13"
,IN,AR,30306121,1005,100,,Invoice,,,,,,04/01/2018,04/01/2018,0.00,,6.56,,"-5,683.69"
,IN,AR,30306135,1005,100,,Invoice,,,,,,04/01/2018,04/01/2018,0.00,,10.93,,"-5,694.62"
,IN,AR,30306148,1005,100,,Invoice,,,,,,04/01/2018,04/01/2018,0.00,,10.93,,"-5,705.55"
,IN,AR,30306163,1005,100,,Invoice,,,,,,04/01/2018,04/01/2018,0.00,,24.01,,"-5,729.56"
,IN,AR,30306172,1005,100,,Invoice,,,,,,04/01/2018,04/01/2018,0.00,,34.01,,"-5,763.57"
,IN,AR,30306176,1005,100,,Invoice,,,,,,04/01/2018,04/01/2018,0.00,,34.01,,"-5,797.58"
,IN,AR,30306180,1005,100,,Invoice,,,,,,04/01/2018,04/01/2018,0.00,,26.01,,"-5,823.59"
,IN,AR,30306186,1005,100,,Invoice,,,,,,04/01/2018,04/01/2018,0.00,,8.75,,"-5,832.34"
,IN,AR,30306273,1005,100,,Invoice,,,,,,04/01/2018,04/01/2018,0.00,,8.42,,"-5,840.76"
,IN,AR,30306287,1005,100,,Invoice,,,,,,04/01/2018,04/01/2018,0.00,,13.73,,"-5,854.49"
,IN,AR,30306302,1005,100,,Invoice,,,,,,04/01/2018,04/01/2018,0.00,,112.00,,"-5,966.49"
,IN,AR,30306372,1005,100,,Invoice,,,,,,04/01/2018,04/01/2018,0.00,,1.59,,"-5,968.08"
,IN,AR,30306373,1005,100,,Invoice,,,,,,04/01/2018,04/01/2018,0.00,,3.19,,"-5,971.27"
,IN,AR,30306374,1005,100,,Invoice,,,,,,04/01/2018,04/01/2018,0.00,,1.59,,"-5,972.86"
,IN,AR,30306375,1005,100,,Invoice,,,,,,04/01/2018,04/01/2018,0.00,,9.56,,"-5,982.42"
,IN,AR,30306427,1005,100,,Invoice,,,,,,04/01/2018,04/01/2018,0.00,,10.17,,"-5,992.59"
,IN,AR,30306464,1005,100,,Invoice,,,,,,04/01/2018,04/01/2018,0.00,,8.00,,"-6,000.59"
,IN,AR,30306494,1005,100,,Invoice,,,,,,04/01/2018,04/01/2018,0.00,,13.12,,"-6,013.71"
,IN,AR,30306512,1005,100,,Invoice,,,,,,04/01/2018,04/01/2018,0.00,,16.42,,"-6,030.13"
,IN,AR,30306574,1005,100,,Invoice,,,,,,04/01/2018,04/01/2018,0.00,,7.29,,"-6,037.42"
,IN,AR,30306578,1005,100,,Invoice,,,,,,04/01/2018,04/01/2018,0.00,,5.86,,"-6,043.28"
,IN,AR,30306620,1005,100,,Invoice,,,,,,04/01/2018,04/01/2018,0.00,,7.29,,"-6,050.57"
,CN,AR,31016874,1005,100,,Credit Note,,,,,,05/01/2018,05/01/2018,58.22,,0.00,,"-5,992.35"
,CN,AR,31016963,1005,100,,Credit Note,,,,,,05/01/2018,05/01/2018,9.56,,0.00,,"-5,982.79"
,CN,AR,31017035,1005,100,,Credit Note,,,,,,05/01/2018,05/01/2018,18.17,,0.00,,"-5,964.62"
,CS,AR,32000001,1005,100,,Cash sale,,,,,,05/01/2018,05/01/2018,0.00,,90.67,,"-6,055.29"
,CS,AR,32000015,1005,100,,Cash sale,,,,,,05/01/2018,05/01/2018,0.00,,16.78,,"-6,072.07"
,CS,AR,32000061,1005,100,,Cash sale,,,,,,05/01/2018,05/01/2018,0.00,,14.58,,"-6,086.65"
,CS,AR,32000096,1005,100,,Cash sale,,,,,,05/01/2018,05/01/2018,0.00,,18.22,,"-6,104.87"
,CS,AR,32000112,1005,100,,Cash sale,,,,,,05/01/2018,05/01/2018,0.00,,11.86,,"-6,116.73"
,CS,AR,32000123,1005,100,,Cash sale,,,,,,05/01/2018,05/01/2018,0.00,,3.64,,"-6,120.37"
,CS,AR,32000129,1005,100,,Cash sale,,,,,,05/01/2018,05/01/2018,0.00,,10.38,,"-6,130.75"
,CS,AR,32000178,1005,100,,Cash sale,,,,,,05/01/2018,05/01/2018,0.00,,21.86,,"-6,152.61"
,CS,AR,32000219,1005,100,,Cash sale,,,,,,05/01/2018,05/01/2018,0.00,,7.75,,"-6,160.36"
,CS,AR,32000248,1005,100,,Cash sale,,,,,,05/01/2018,05/01/2018,0.00,,36.44,,"-6,196.80"
,CS,AR,32000262,1005,100,,Cash sale,,,,,,05/01/2018,05/01/2018,0.00,,10.17,,"-6,206.97"
,CS,AR,32000263,1005,100,,Cash sale,,,,,,05/01/2018,05/01/2018,0.00,,7.63,,"-6,214.60"
,CS,AR,32000272,1005,100,,Cash sale,,,,,,05/01/2018,05/01/2018,0.00,,27.97,,"-6,242.57"
,CS,AR,32000283,1005,100,,Cash sale,,,,,,05/01/2018,05/01/2018,0.00,,12.92,,"-6,255.49"
,CS,AR,32000294,1005,100,,Cash sale,,,,,,05/01/2018,05/01/2018,0.00,,46.71,,"-6,302.20"
,CS,AR,32000298,1005,100,,Cash sale,,,,,,05/01/2018,05/01/2018,0.00,,14.58,,"-6,316.78"
,CS,AR,32000311,1005,100,,Cash sale,,,,,,05/01/2018,05/01/2018,0.00,,8.25,,"-6,325.03"
,CS,AR,32000327,1005,100,,Cash sale,,,,,,05/01/2018,05/01/2018,0.00,,10.93,,"-6,335.96"
,CS,AR,32000335,1005,100,,Cash sale,,,,,,05/01/2018,05/01/2018,0.00,,6.02,,"-6,341.98"
,CS,AR,32000367,1005,100,,Cash sale,,,,,,05/01/2018,05/01/2018,0.00,,5.08,,"-6,347.06"
,CS,AR,32000403,1005,100,,Cash sale,,,,,,05/01/2018,05/01/2018,0.00,,18.05,,"-6,365.11"
,CS,AR,32000429,1005,100,,Cash sale,,,,,,05/01/2018,05/01/2018,0.00,,10.00,,"-6,375.11"
,CS,AR,32000505,1005,100,,Cash sale,,,,,,05/01/2018,05/01/2018,0.00,,10.93,,"-6,386.04"
,CS,AR,32000522,1005,100,,Cash sale,,,,,,05/01/2018,05/01/2018,0.00,,7.29,,"-6,393.33"
,CS,AR,32000529,1005,100,,Cash sale,,,,,,05/01/2018,05/01/2018,0.00,,14.58,,"-6,407.91"
,CS,AR,32000532,1005,100,,Cash sale,,,,,,05/01/2018,05/01/2018,0.00,,17.56,,"-6,425.47"
,CS,AR,32000586,1005,100,,Cash sale,,,,,,05/01/2018,05/01/2018,0.00,,36.10,,"-6,461.57"
,CS,AR,32000599,1005,100,,Cash sale,,,,,,05/01/2018,05/01/2018,0.00,,14.58,,"-6,476.15"
,CS,AR,32000619,1005,100,,Cash sale,,,,,,05/01/2018,05/01/2018,0.00,,17.80,,"-6,493.95"
,CS,AR,32000626,1005,100,,Cash sale,,,,,,05/01/2018,05/01/2018,0.00,,10.93,,"-6,504.88"
,CS,AR,32000671,1005,100,,Cash sale,,,,,,05/01/2018,05/01/2018,0.00,,30.00,,"-6,534.88"
,CS,AR,32000676,1005,100,,Cash sale,,,,,,05/01/2018,05/01/2018,0.00,,3.64,,"-6,538.52"
,CS,AR,32000691,1005,100,,Cash sale,,,,,,05/01/2018,05/01/2018,0.00,,9.11,,"-6,547.63"
,CS,AR,32000692,1005,100,,Cash sale,,,,,,05/01/2018,05/01/2018,0.00,,9.84,,"-6,557.47"
,CS,AR,32000695,1005,100,,Cash sale,,,,,,05/01/2018,05/01/2018,0.00,,12.71,,"-6,570.18"
,CS,AR,32000696,1005,100,,Cash sale,,,,,,05/01/2018,05/01/2018,0.00,,5.08,,"-6,575.26"
,CS,AR,32000710,1005,100,,Cash sale,,,,,,05/01/2018,05/01/2018,0.00,,9.15,,"-6,584.41"
,CS,AR,32000722,1005,100,,Cash sale,,,,,,05/01/2018,05/01/2018,0.00,,21.86,,"-6,606.27"
,CS,AR,32000755,1005,100,,Cash sale,,,,,,05/01/2018,05/01/2018,0.00,,14.58,,"-6,620.85"
,CS,AR,32000776,1005,100,,Cash sale,,,,,,05/01/2018,05/01/2018,0.00,,14.58,,"-6,635.43"
,CS,AR,32000796,1005,100,,Cash sale,,,,,,05/01/2018,05/01/2018,0.00,,7.63,,"-6,643.06"
,CS,AR,32000798,1005,100,,Cash sale,,,,,,05/01/2018,05/01/2018,0.00,,3.64,,"-6,646.70"
,CS,AR,32000835,1005,100,,Cash sale,,,,,,05/01/2018,05/01/2018,0.00,,7.29,,"-6,653.99"
,CS,AR,32000849,1005,100,,Cash sale,,,,,,05/01/2018,05/01/2018,0.00,,13.12,,"-6,667.11"
,CS,AR,32000870,1005,100,,Cash sale,,,,,,05/01/2018,05/01/2018,0.00,,3.64,,"-6,670.75"
,IN,AR,30304362,1005,100,,Invoice,,,,,,05/01/2018,05/01/2018,0.00,,23.73,,"-6,694.48"
,IN,AR,30304377,1005,100,,Invoice,,,,,,05/01/2018,05/01/2018,0.00,,7.29,,"-6,701.77"
,IN,AR,30304395,1005,100,,Invoice,,,,,,05/01/2018,05/01/2018,0.00,,82.43,,"-6,784.20"
,IN,AR,30304405,1005,100,,Invoice,,,,,,05/01/2018,05/01/2018,0.00,,25.51,,"-6,809.71"
,IN,AR,30304409,1005,100,,Invoice,,,,,,05/01/2018,05/01/2018,0.00,,26.85,,"-6,836.56"
,IN,AR,30304410,1005,100,,Invoice,,,,,,05/01/2018,05/01/2018,0.00,,34.17,,"-6,870.73"
,IN,AR,30304411,1005,100,,Invoice,,,,,,05/01/2018,05/01/2018,0.00,,41.49,,"-6,912.22"
,IN,AR,30304425,1005,100,,Invoice,,,,,,05/01/2018,05/01/2018,0.00,,7.29,,"-6,919.51"
,IN,AR,30304431,1005,100,,Invoice,,,,,,05/01/2018,05/01/2018,0.00,,7.29,,"-6,926.80"
,IN,AR,30304451,1005,100,,Invoice,,,,,,05/01/2018,05/01/2018,0.00,,18.22,,"-6,945.02"
,IN,AR,30304472,1005,100,,Invoice,,,,,,05/01/2018,05/01/2018,0.00,,28.47,,"-6,973.49"
,IN,AR,30304507,1005,100,,Invoice,,,,,,05/01/2018,05/01/2018,0.00,,58.22,,"-7,031.71"
,IN,AR,30304508,1005,100,,Invoice,,,,,,05/01/2018,05/01/2018,0.00,,58.22,,"-7,089.93"
,IN,AR,30304520,1005,100,,Invoice,,,,,,05/01/2018,05/01/2018,0.00,,54.58,,"-7,144.51"
,IN,AR,30304548,1005,100,,Invoice,,,,,,05/01/2018,05/01/2018,0.00,,10.93,,"-7,155.44"
,IN,AR,30304551,1005,100,,Invoice,,,,,,05/01/2018,05/01/2018,0.00,,34.00,,"-7,189.44"
,IN,AR,30304560,1005,100,,Invoice,,,,,,05/01/2018,05/01/2018,0.00,,10.93,,"-7,200.37"
,IN,AR,30304573,1005,100,,Invoice,,,,,,05/01/2018,05/01/2018,0.00,,10.93,,"-7,211.30"
,IN,AR,30304588,1005,100,,Invoice,,,,,,05/01/2018,05/01/2018,0.00,,9.66,,"-7,220.96"
,IN,AR,30304604,1005,100,,Invoice,,,,,,05/01/2018,05/01/2018,0.00,,24.00,,"-7,244.96"
,IN,AR,30304661,1005,100,,Invoice,,,,,,05/01/2018,05/01/2018,0.00,,2.37,,"-7,247.33"
,IN,AR,30304668,1005,100,,Invoice,,,,,,05/01/2018,05/01/2018,0.00,,22.00,,"-7,269.33"
,IN,AR,30304698,1005,100,,Invoice,,,,,,05/01/2018,05/01/2018,0.00,,29.15,,"-7,298.48"
,IN,AR,30304703,1005,100,,Invoice,,,,,,05/01/2018,05/01/2018,0.00,,14.58,,"-7,313.06"
,IN,AR,30304707,1005,100,,Invoice,,,,,,05/01/2018,05/01/2018,0.00,,18.22,,"-7,331.28"
,IN,AR,30304711,1005,100,,Invoice,,,,,,05/01/2018,05/01/2018,0.00,,70.95,,"-7,402.23"
,IN,AR,30304712,1005,100,,Invoice,,,,,,05/01/2018,05/01/2018,0.00,,8.19,,"-7,410.42"
,IN,AR,30304713,1005,100,,Invoice,,,,,,05/01/2018,05/01/2018,0.00,,27.29,,"-7,437.71"
,IN,AR,30304732,1005,100,,Invoice,,,,,,05/01/2018,05/01/2018,0.00,,7.76,,"-7,445.47"
,IN,AR,30304751,1005,100,,Invoice,,,,,,05/01/2018,05/01/2018,0.00,,7.29,,"-7,452.76"
,IN,AR,30304808,1005,100,,Invoice,,,,,,05/01/2018,05/01/2018,0.00,,9.56,,"-7,462.32"
,IN,AR,30304816,1005,100,,Invoice,,,,,,05/01/2018,05/01/2018,0.00,,25.85,,"-7,488.17"
,IN,AR,30304935,1005,100,,Invoice,,,,,,05/01/2018,05/01/2018,0.00,,3.64,,"-7,491.81"
,IN,AR,30304953,1005,100,,Invoice,,,,,,05/01/2018,05/01/2018,0.00,,2.39,,"-7,494.20"
,IN,AR,30304962,1005,100,,Invoice,,,,,,05/01/2018,05/01/2018,0.00,,151.14,,"-7,645.34"
,IN,AR,30304985,1005,100,,Invoice,,,,,,05/01/2018,05/01/2018,0.00,,24.79,,"-7,670.13"
,IN,AR,30305020,1005,100,,Invoice,,,,,,05/01/2018,05/01/2018,0.00,,94.34,,"-7,764.47"
,IN,AR,30305031,1005,100,,Invoice,,,,,,05/01/2018,05/01/2018,0.00,,25.25,,"-7,789.72"
,IN,AR,30305059,1005,100,,Invoice,,,,,,05/01/2018,05/01/2018,0.00,,9.56,,"-7,799.28"
,IN,AR,30305060,1005,100,,Invoice,,,,,,05/01/2018,05/01/2018,0.00,,2.39,,"-7,801.67"
,IN,AR,30305061,1005,100,,Invoice,,,,,,05/01/2018,05/01/2018,0.00,,23.90,,"-7,825.57"
,IN,AR,30305087,1005,100,,Invoice,,,,,,05/01/2018,05/01/2018,0.00,,14.58,,"-7,840.15"
,IN,AR,30305103,1005,100,,Invoice,,,,,,05/01/2018,05/01/2018,0.00,,3.01,,"-7,843.16"
,IN,AR,30305112,1005,100,,Invoice,,,,,,05/01/2018,05/01/2018,0.00,,6.36,,"-7,849.52"
,IN,AR,30305144,1005,100,,Invoice,,,,,,05/01/2018,05/01/2018,0.00,,10.34,,"-7,859.86"
,IN,AR,30305219,1005,100,,Invoice,,,,,,05/01/2018,05/01/2018,0.00,,5.08,,"-7,864.94"
,IN,AR,30305260,1005,100,,Invoice,,,,,,05/01/2018,05/01/2018,0.00,,78.94,,"-7,943.88"
,IN,AR,30305309,1005,100,,Invoice,,,,,,05/01/2018,05/01/2018,0.00,,10.21,,"-7,954.09"
,IN,AR,30305311,1005,100,,Invoice,,,,,,05/01/2018,05/01/2018,0.00,,426.78,,"-8,380.87"
,IN,AR,30305320,1005,100,,Invoice,,,,,,05/01/2018,05/01/2018,0.00,,15.25,,"-8,396.12"
,IN,AR,30305334,1005,100,,Invoice,,,,,,05/01/2018,05/01/2018,0.00,,12.92,,"-8,409.04"
,IN,AR,30305356,1005,100,,Invoice,,,,,,05/01/2018,05/01/2018,0.00,,7.75,,"-8,416.79"
,IN,AR,30305359,1005,100,,Invoice,,,,,,05/01/2018,05/01/2018,0.00,,7.29,,"-8,424.08"
,IN,AR,30305367,1005,100,,Invoice,,,,,,05/01/2018,05/01/2018,0.00,,49.83,,"-8,473.91"
,IN,AR,30305372,1005,100,,Invoice,,,,,,05/01/2018,05/01/2018,0.00,,22.88,,"-8,496.79"
,IN,AR,30305501,1005,100,,Invoice,,,,,,05/01/2018,05/01/2018,0.00,,7.63,,"-8,504.42"
,IN,AR,30305507,1005,100,,Invoice,,,,,,05/01/2018,05/01/2018,0.00,,8.17,,"-8,512.59"
,IN,AR,30305526,1005,100,,Invoice,,,,,,05/01/2018,05/01/2018,0.00,,7.29,,"-8,519.88"
,IN,AR,30305543,1005,100,,Invoice,,,,,,05/01/2018,05/01/2018,0.00,,38.56,,"-8,558.44"
,IN,AR,30305591,1005,100,,Invoice,,,,,,05/01/2018,05/01/2018,0.00,,14.58,,"-8,573.02"
,IN,AR,30305600,1005,100,,Invoice,,,,,,05/01/2018,05/01/2018,0.00,,40.08,,"-8,613.10"
,IN,AR,30305631,1005,100,,Invoice,,,,,,05/01/2018,05/01/2018,0.00,,12.71,,"-8,625.81"
,IN,AR,30305659,1005,100,,Invoice,,,,,,05/01/2018,05/01/2018,0.00,,70.97,,"-8,696.78"
,IN,AR,30305688,1005,100,,Invoice,,,,,,05/01/2018,05/01/2018,0.00,,11.70,,"-8,708.48"
,IN,AR,30305737,1005,100,,Invoice,,,,,,05/01/2018,05/01/2018,0.00,,11.70,,"-8,720.18"
,IN,AR,30305799,1005,100,,Invoice,,,,,,05/01/2018,05/01/2018,0.00,,15.86,,"-8,736.04"
,IN,AR,30305822,1005,100,,Invoice,,,,,,05/01/2018,05/01/2018,0.00,,2.42,,"-8,738.46"
,IN,AR,30305842,1005,100,,Invoice,,,,,,05/01/2018,05/01/2018,0.00,,7.29,,"-8,745.75"
,IN,AR,30305855,1005,100,,Invoice,,,,,,05/01/2018,05/01/2018,0.00,,10.93,,"-8,756.68"
,IN,AR,30305858,1005,100,,Invoice,,,,,,05/01/2018,05/01/2018,0.00,,14.58,,"-8,771.26"
,IN,AR,30305870,1005,100,,Invoice,,,,,,05/01/2018,05/01/2018,0.00,,18.22,,"-8,789.48"
,IN,AR,30305919,1005,100,,Invoice,,,,,,05/01/2018,05/01/2018,0.00,,10.17,,"-8,799.65"
,IN,AR,30305948,1005,100,,Invoice,,,,,,05/01/2018,05/01/2018,0.00,,271.89,,"-9,071.54"
,IN,AR,30305966,1005,100,,Invoice,,,,,,05/01/2018,05/01/2018,0.00,,19.87,,"-9,091.41"
,IN,AR,30305981,1005,100,,Invoice,,,,,,05/01/2018,05/01/2018,0.00,,7.86,,"-9,099.27"
,IN,AR,30305993,1005,100,,Invoice,,,,,,05/01/2018,05/01/2018,0.00,,12.03,,"-9,111.30"
,IN,AR,30306005,1005,100,,Invoice,,,,,,05/01/2018,05/01/2018,0.00,,14.58,,"-9,125.88"
,IN,AR,30306017,1005,100,,Invoice,,,,,,05/01/2018,05/01/2018,0.00,,6.02,,"-9,131.90"
,IN,AR,30306044,1005,100,,Invoice,,,,,,05/01/2018,05/01/2018,0.00,,41.69,,"-9,173.59"
,IN,AR,30306045,1005,100,,Invoice,,,,,,05/01/2018,05/01/2018,0.00,,12.83,,"-9,186.42"
,IN,AR,30306098,1005,100,,Invoice,,,,,,05/01/2018,05/01/2018,0.00,,34.15,,"-9,220.57"
,IN,AR,30306126,1005,100,,Invoice,,,,,,05/01/2018,05/01/2018,0.00,,18.11,,"-9,238.68"
,IN,AR,30306131,1005,100,,Invoice,,,,,,05/01/2018,05/01/2018,0.00,,43.03,,"-9,281.71"
,IN,AR,30306150,1005,100,,Invoice,,,,,,05/01/2018,05/01/2018,0.00,,10.93,,"-9,292.64"
,IN,AR,30306153,1005,100,,Invoice,,,,,,05/01/2018,05/01/2018,0.00,,2.54,,"-9,295.18"
,IN,AR,30306210,1005,100,,Invoice,,,,,,05/01/2018,05/01/2018,0.00,,14.58,,"-9,309.76"
,IN,AR,30306223,1005,100,,Invoice,,,,,,05/01/2018,05/01/2018,0.00,,24.64,,"-9,334.40"
,IN,AR,30306227,1005,100,,Invoice,,,,,,05/01/2018,05/01/2018,0.00,,8.41,,"-9,342.81"
,IN,AR,30306247,1005,100,,Invoice,,,,,,05/01/2018,05/01/2018,0.00,,419.07,,"-9,761.88"
,IN,AR,30306248,1005,100,,Invoice,,,,,,05/01/2018,05/01/2018,0.00,,419.07,,"-10,180.95"
,IN,AR,30306283,1005,100,,Invoice,,,,,,05/01/2018,05/01/2018,0.00,,6.89,,"-10,187.84"
,IN,AR,30306312,1005,100,,Invoice,,,,,,05/01/2018,05/01/2018,0.00,,7.29,,"-10,195.13"
,IN,AR,30306313,1005,100,,Invoice,,,,,,05/01/2018,05/01/2018,0.00,,6.10,,"-10,201.23"
,IN,AR,30306350,1005,100,,Invoice,,,,,,05/01/2018,05/01/2018,0.00,,12.14,,"-10,213.37"
,IN,AR,30306354,1005,100,,Invoice,,,,,,05/01/2018,05/01/2018,0.00,,16.91,,"-10,230.28"
,IN,AR,30306376,1005,100,,Invoice,,,,,,05/01/2018,05/01/2018,0.00,,4.78,,"-10,235.06"
,IN,AR,30306407,1005,100,,Invoice,,,,,,05/01/2018,05/01/2018,0.00,,21.86,,"-10,256.92"
,IN,AR,30306409,1005,100,,Invoice,,,,,,05/01/2018,05/01/2018,0.00,,10.93,,"-10,267.85"
,IN,AR,30306435,1005,100,,Invoice,,,,,,05/01/2018,05/01/2018,0.00,,14.00,,"-10,281.85"
,IN,AR,30306473,1005,100,,Invoice,,,,,,05/01/2018,05/01/2018,0.00,,29.15,,"-10,311.00"
,IN,AR,30306508,1005,100,,Invoice,,,,,,05/01/2018,05/01/2018,0.00,,7.29,,"-10,318.29"
,IN,AR,30306524,1005,100,,Invoice,,,,,,05/01/2018,05/01/2018,0.00,,25.42,,"-10,343.71"
,IN,AR,30306597,1005,100,,Invoice,,,,,,05/01/2018,05/01/2018,0.00,,11.19,,"-10,354.90"
,IN,AR,30306613,1005,100,,Invoice,,,,,,05/01/2018,05/01/2018,0.00,,16.34,,"-10,371.24"
,IN,AR,30306621,1005,100,,Invoice,,,,,,05/01/2018,05/01/2018,0.00,,29.15,,"-10,400.39"
,IN,AR,30306628,1005,100,,Invoice,,,,,,05/01/2018,05/01/2018,0.00,,455.51,,"-10,855.90"
,CS,AR,32000745,1005,100,,Cash sale,,,,,,06/01/2018,06/01/2018,0.00,,4.24,,"-10,860.14"
,CS,AR,32000903,1005,100,,Cash sale,,,,,,06/01/2018,06/01/2018,0.00,,10.93,,"-10,871.07"
,IN,AR,30304363,1005,100,,Invoice,,,,,,06/01/2018,06/01/2018,0.00,,29.66,,"-10,900.73"
,IN,AR,30304669,1005,100,,Invoice,,,,,,06/01/2018,06/01/2018,0.00,,8.00,,"-10,908.73"
,IN,AR,30304977,1005,100,,Invoice,,,,,,06/01/2018,06/01/2018,0.00,,46.57,,"-10,955.30"
,IN,AR,30304996,1005,100,,Invoice,,,,,,06/01/2018,06/01/2018,0.00,,24.07,,"-10,979.37"
,IN,AR,30305009,1005,100,,Invoice,,,,,,06/01/2018,06/01/2018,0.00,,408.14,,"-11,387.51"
,IN,AR,30305778,1005,100,,Invoice,,,,,,06/01/2018,06/01/2018,0.00,,5.17,,"-11,392.68"
,IN,AR,30305871,1005,100,,Invoice,,,,,,06/01/2018,06/01/2018,0.00,,14.58,,"-11,407.26"
,IN,AR,30306522,1005,100,,Invoice,,,,,,06/01/2018,06/01/2018,0.00,,10.93,,"-11,418.19"
,IN,AR,30306538,1005,100,,Invoice,,,,,,06/01/2018,06/01/2018,0.00,,12.14,,"-11,430.33"
,CS,AR,32000839,1005,100,,Cash sale,,,,,,07/01/2018,07/01/2018,0.00,,29.15,,"-11,459.48"
,CS,AR,32000840,1005,100,,Cash sale,,,,,,07/01/2018,07/01/2018,0.00,,29.15,,"-11,488.63"
,CS,AR,32000026,1005,100,,Cash sale,,,,,,08/01/2018,08/01/2018,0.00,,11.86,,"-11,500.49"
,CS,AR,32000059,1005,100,,Cash sale,,,,,,08/01/2018,08/01/2018,0.00,,10.93,,"-11,511.42"
,CS,AR,32000085,1005,100,,Cash sale,,,,,,08/01/2018,08/01/2018,0.00,,3.64,,"-11,515.06"
,CS,AR,32000118,1005,100,,Cash sale,,,,,,08/01/2018,08/01/2018,0.00,,3.64,,"-11,518.70"
,CS,AR,32000130,1005,100,,Cash sale,,,,,,08/01/2018,08/01/2018,0.00,,12.46,,"-11,531.16"
,CS,AR,32000163,1005,100,,Cash sale,,,,,,08/01/2018,08/01/2018,0.00,,5.85,,"-11,537.01"
,CS,AR,32000213,1005,100,,Cash sale,,,,,,08/01/2018,08/01/2018,0.00,,7.29,,"-11,544.30"
,CS,AR,32000215,1005,100,,Cash sale,,,,,,08/01/2018,08/01/2018,0.00,,10.34,,"-11,554.64"
,CS,AR,32000246,1005,100,,Cash sale,,,,,,08/01/2018,08/01/2018,0.00,,3.64,,"-11,558.28"
,CS,AR,32000264,1005,100,,Cash sale,,,,,,08/01/2018,08/01/2018,0.00,,10.17,,"-11,568.45"
,CS,AR,32000312,1005,100,,Cash sale,,,,,,08/01/2018,08/01/2018,0.00,,8.25,,"-11,576.70"
,CS,AR,32000350,1005,100,,Cash sale,,,,,,08/01/2018,08/01/2018,0.00,,7.29,,"-11,583.99"
,CS,AR,32000378,1005,100,,Cash sale,,,,,,08/01/2018,08/01/2018,0.00,,12.97,,"-11,596.96"
,CS,AR,32000383,1005,100,,Cash sale,,,,,,08/01/2018,08/01/2018,0.00,,17.54,,"-11,614.50"
,CS,AR,32000404,1005,100,,Cash sale,,,,,,08/01/2018,08/01/2018,0.00,,30.08,,"-11,644.58"
,CS,AR,32000414,1005,100,,Cash sale,,,,,,08/01/2018,08/01/2018,0.00,,14.58,,"-11,659.16"
,CS,AR,32000415,1005,100,,Cash sale,,,,,,08/01/2018,08/01/2018,0.00,,7.29,,"-11,666.45"
,CS,AR,32000467,1005,100,,Cash sale,,,,,,08/01/2018,08/01/2018,0.00,,21.86,,"-11,688.31"
,CS,AR,32000481,1005,100,,Cash sale,,,,,,08/01/2018,08/01/2018,0.00,,3.64,,"-11,691.95"
,CS,AR,32000501,1005,100,,Cash sale,,,,,,08/01/2018,08/01/2018,0.00,,7.75,,"-11,699.70"
,CS,AR,32000508,1005,100,,Cash sale,,,,,,08/01/2018,08/01/2018,0.00,,8.77,,"-11,708.47"
,CS,AR,32000518,1005,100,,Cash sale,,,,,,08/01/2018,08/01/2018,0.00,,7.29,,"-11,715.76"
,CS,AR,32000549,1005,100,,Cash sale,,,,,,08/01/2018,08/01/2018,0.00,,7.29,,"-11,723.05"
,CS,AR,32000554,1005,100,,Cash sale,,,,,,08/01/2018,08/01/2018,0.00,,3.64,,"-11,726.69"
,CS,AR,32000564,1005,100,,Cash sale,,,,,,08/01/2018,08/01/2018,0.00,,5.17,,"-11,731.86"
,CS,AR,32000567,1005,100,,Cash sale,,,,,,08/01/2018,08/01/2018,0.00,,7.29,,"-11,739.15"
,CS,AR,32000629,1005,100,,Cash sale,,,,,,08/01/2018,08/01/2018,0.00,,21.86,,"-11,761.01"
,CS,AR,32000640,1005,100,,Cash sale,,,,,,08/01/2018,08/01/2018,0.00,,7.29,,"-11,768.30"
,CS,AR,32000647,1005,100,,Cash sale,,,,,,08/01/2018,08/01/2018,0.00,,5.17,,"-11,773.47"
,CS,AR,32000651,1005,100,,Cash sale,,,,,,08/01/2018,08/01/2018,0.00,,22.88,,"-11,796.35"
,CS,AR,32000711,1005,100,,Cash sale,,,,,,08/01/2018,08/01/2018,0.00,,11.44,,"-11,807.79"
,CS,AR,32000747,1005,100,,Cash sale,,,,,,08/01/2018,08/01/2018,0.00,,18.22,,"-11,826.01"
,CS,AR,32000750,1005,100,,Cash sale,,,,,,08/01/2018,08/01/2018,0.00,,14.58,,"-11,840.59"
,CS,AR,32000767,1005,100,,Cash sale,,,,,,08/01/2018,08/01/2018,0.00,,7.29,,"-11,847.88"
,CS,AR,32000830,1005,100,,Cash sale,,,,,,08/01/2018,08/01/2018,0.00,,10.34,,"-11,858.22"
,CS,AR,32000834,1005,100,,Cash sale,,,,,,08/01/2018,08/01/2018,0.00,,14.58,,"-11,872.80"
,CS,AR,32000842,1005,100,,Cash sale,,,,,,08/01/2018,08/01/2018,0.00,,14.58,,"-11,887.38"
,CS,AR,32000846,1005,100,,Cash sale,,,,,,08/01/2018,08/01/2018,0.00,,3.64,,"-11,891.02"
,IN,AR,30304359,1005,100,,Invoice,,,,,,08/01/2018,08/01/2018,0.00,,182.20,,"-12,073.22"
,IN,AR,30304364,1005,100,,Invoice,,,,,,08/01/2018,08/01/2018,0.00,,56.36,,"-12,129.58"
,IN,AR,30304388,1005,100,,Invoice,,,,,,08/01/2018,08/01/2018,0.00,,7.29,,"-12,136.87"
,IN,AR,30304402,1005,100,,Invoice,,,,,,08/01/2018,08/01/2018,0.00,,25.51,,"-12,162.38"
,IN,AR,30304449,1005,100,,Invoice,,,,,,08/01/2018,08/01/2018,0.00,,6.02,,"-12,168.40"
,IN,AR,30304478,1005,100,,Invoice,,,,,,08/01/2018,08/01/2018,0.00,,42.27,,"-12,210.67"
,IN,AR,30304497,1005,100,,Invoice,,,,,,08/01/2018,08/01/2018,0.00,,3.64,,"-12,214.31"
,IN,AR,30304521,1005,100,,Invoice,,,,,,08/01/2018,08/01/2018,0.00,,97.29,,"-12,311.60"
,IN,AR,30304552,1005,100,,Invoice,,,,,,08/01/2018,08/01/2018,0.00,,32.00,,"-12,343.60"
,IN,AR,30304563,1005,100,,Invoice,,,,,,08/01/2018,08/01/2018,0.00,,10.93,,"-12,354.53"
,IN,AR,30304597,1005,100,,Invoice,,,,,,08/01/2018,08/01/2018,0.00,,3.64,,"-12,358.17"
,IN,AR,30304605,1005,100,,Invoice,,,,,,08/01/2018,08/01/2018,0.00,,12.00,,"-12,370.17"
,IN,AR,30304615,1005,100,,Invoice,,,,,,08/01/2018,08/01/2018,0.00,,54.66,,"-12,424.83"
,IN,AR,30304623,1005,100,,Invoice,,,,,,08/01/2018,08/01/2018,0.00,,2.75,,"-12,427.58"
,IN,AR,30304627,1005,100,,Invoice,,,,,,08/01/2018,08/01/2018,0.00,,17.80,,"-12,445.38"
,IN,AR,30304630,1005,100,,Invoice,,,,,,08/01/2018,08/01/2018,0.00,,2.75,,"-12,448.13"
,IN,AR,30304646,1005,100,,Invoice,,,,,,08/01/2018,08/01/2018,0.00,,7.78,,"-12,455.91"
,IN,AR,30304670,1005,100,,Invoice,,,,,,08/01/2018,08/01/2018,0.00,,8.00,,"-12,463.91"
,IN,AR,30304679,1005,100,,Invoice,,,,,,08/01/2018,08/01/2018,0.00,,364.41,,"-12,828.32"
,IN,AR,30304680,1005,100,,Invoice,,,,,,08/01/2018,08/01/2018,0.00,,7.29,,"-12,835.61"
,IN,AR,30304739,1005,100,,Invoice,,,,,,08/01/2018,08/01/2018,0.00,,69.31,,"-12,904.92"
,IN,AR,30304772,1005,100,,Invoice,,,,,,08/01/2018,08/01/2018,0.00,,9.66,,"-12,914.58"
,IN,AR,30304777,1005,100,,Invoice,,,,,,08/01/2018,08/01/2018,0.00,,29.15,,"-12,943.73"
,IN,AR,30304779,1005,100,,Invoice,,,,,,08/01/2018,08/01/2018,0.00,,29.15,,"-12,972.88"
,IN,AR,30304789,1005,100,,Invoice,,,,,,08/01/2018,08/01/2018,0.00,,17.03,,"-12,989.91"
,IN,AR,30304796,1005,100,,Invoice,,,,,,08/01/2018,08/01/2018,0.00,,182.20,,"-13,172.11"
,IN,AR,30304798,1005,100,,Invoice,,,,,,08/01/2018,08/01/2018,0.00,,10.93,,"-13,183.04"
,IN,AR,30304805,1005,100,,Invoice,,,,,,08/01/2018,08/01/2018,0.00,,182.20,,"-13,365.24"
,IN,AR,30304809,1005,100,,Invoice,,,,,,08/01/2018,08/01/2018,0.00,,14.34,,"-13,379.58"
,IN,AR,30304831,1005,100,,Invoice,,,,,,08/01/2018,08/01/2018,0.00,,10.34,,"-13,389.92"
,IN,AR,30304845,1005,100,,Invoice,,,,,,08/01/2018,08/01/2018,0.00,,182.20,,"-13,572.12"
,IN,AR,30304848,1005,100,,Invoice,,,,,,08/01/2018,08/01/2018,0.00,,54.66,,"-13,626.78"
,IN,AR,30304857,1005,100,,Invoice,,,,,,08/01/2018,08/01/2018,0.00,,9.19,,"-13,635.97"
,IN,AR,30304906,1005,100,,Invoice,,,,,,08/01/2018,08/01/2018,0.00,,6.10,,"-13,642.07"
,IN,AR,30304945,1005,100,,Invoice,,,,,,08/01/2018,08/01/2018,0.00,,23.26,,"-13,665.33"
,IN,AR,30304969,1005,100,,Invoice,,,,,,08/01/2018,08/01/2018,0.00,,182.20,,"-13,847.53"
,IN,AR,30304970,1005,100,,Invoice,,,,,,08/01/2018,08/01/2018,0.00,,364.41,,"-14,211.94"
,IN,AR,30304990,1005,100,,Invoice,,,,,,08/01/2018,08/01/2018,0.00,,3.64,,"-14,215.58"
,IN,AR,30305021,1005,100,,Invoice,,,,,,08/01/2018,08/01/2018,0.00,,61.53,,"-14,277.11"
,IN,AR,30305035,1005,100,,Invoice,,,,,,08/01/2018,08/01/2018,0.00,,30.51,,"-14,307.62"
,IN,AR,30305052,1005,100,,Invoice,,,,,,08/01/2018,08/01/2018,0.00,,10.72,,"-14,318.34"
,IN,AR,30305062,1005,100,,Invoice,,,,,,08/01/2018,08/01/2018,0.00,,19.12,,"-14,337.46"
,IN,AR,30305089,1005,100,,Invoice,,,,,,08/01/2018,08/01/2018,0.00,,6.02,,"-14,343.48"
,IN,AR,30305220,1005,100,,Invoice,,,,,,08/01/2018,08/01/2018,0.00,,12.71,,"-14,356.19"
,IN,AR,30305253,1005,100,,Invoice,,,,,,08/01/2018,08/01/2018,0.00,,4.49,,"-14,360.68"
,IN,AR,30305282,1005,100,,Invoice,,,,,,08/01/2018,08/01/2018,0.00,,7.29,,"-14,367.97"
,IN,AR,30305373,1005,100,,Invoice,,,,,,08/01/2018,08/01/2018,0.00,,17.80,,"-14,385.77"
,IN,AR,30305388,1005,100,,Invoice,,,,,,08/01/2018,08/01/2018,0.00,,14.24,,"-14,400.01"
,IN,AR,30305401,1005,100,,Invoice,,,,,,08/01/2018,08/01/2018,0.00,,364.41,,"-14,764.42"
,IN,AR,30305408,1005,100,,Invoice,,,,,,08/01/2018,08/01/2018,0.00,,5.08,,"-14,769.50"
,IN,AR,30305422,1005,100,,Invoice,,,,,,08/01/2018,08/01/2018,0.00,,10.93,,"-14,780.43"
,IN,AR,30305433,1005,100,,Invoice,,,,,,08/01/2018,08/01/2018,0.00,,3.64,,"-14,784.07"
,IN,AR,30305478,1005,100,,Invoice,,,,,,08/01/2018,08/01/2018,0.00,,11.02,,"-14,795.09"
,IN,AR,30305492,1005,100,,Invoice,,,,,,08/01/2018,08/01/2018,0.00,,5.51,,"-14,800.60"
,IN,AR,30305520,1005,100,,Invoice,,,,,,08/01/2018,08/01/2018,0.00,,28.05,,"-14,828.65"
,IN,AR,30305563,1005,100,,Invoice,,,,,,08/01/2018,08/01/2018,0.00,,7.29,,"-14,835.94"
,IN,AR,30305590,1005,100,,Invoice,,,,,,08/01/2018,08/01/2018,0.00,,54.66,,"-14,890.60"
,IN,AR,30305625,1005,100,,Invoice,,,,,,08/01/2018,08/01/2018,0.00,,43.93,,"-14,934.53"
,IN,AR,30305630,1005,100,,Invoice,,,,,,08/01/2018,08/01/2018,0.00,,10.93,,"-14,945.46"
,IN,AR,30305641,1005,100,,Invoice,,,,,,08/01/2018,08/01/2018,0.00,,24.00,,"-14,969.46"
,IN,AR,30305651,1005,100,,Invoice,,,,,,08/01/2018,08/01/2018,0.00,,3.01,,"-14,972.47"
,IN,AR,30305685,1005,100,,Invoice,,,,,,08/01/2018,08/01/2018,0.00,,15.51,,"-14,987.98"
,IN,AR,30305696,1005,100,,Invoice,,,,,,08/01/2018,08/01/2018,0.00,,364.41,,"-15,352.39"
,IN,AR,30305731,1005,100,,Invoice,,,,,,08/01/2018,08/01/2018,0.00,,6.42,,"-15,358.81"
,IN,AR,30305745,1005,100,,Invoice,,,,,,08/01/2018,08/01/2018,0.00,,"1,093.22",,"-16,452.03"
,IN,AR,30305762,1005,100,,Invoice,,,,,,08/01/2018,08/01/2018,0.00,,364.41,,"-16,816.44"
,IN,AR,30305787,1005,100,,Invoice,,,,,,08/01/2018,08/01/2018,0.00,,7.29,,"-16,823.73"
,IN,AR,30305816,1005,100,,Invoice,,,,,,08/01/2018,08/01/2018,0.00,,3.64,,"-16,827.37"
,IN,AR,30305840,1005,100,,Invoice,,,,,,08/01/2018,08/01/2018,0.00,,10.93,,"-16,838.30"
,IN,AR,30305859,1005,100,,Invoice,,,,,,08/01/2018,08/01/2018,0.00,,182.20,,"-17,020.50"
,IN,AR,30305861,1005,100,,Invoice,,,,,,08/01/2018,08/01/2018,0.00,,29.15,,"-17,049.65"
,IN,AR,30305924,1005,100,,Invoice,,,,,,08/01/2018,08/01/2018,0.00,,182.20,,"-17,231.85"
,IN,AR,30305949,1005,100,,Invoice,,,,,,08/01/2018,08/01/2018,0.00,,31.80,,"-17,263.65"
,IN,AR,30305994,1005,100,,Invoice,,,,,,08/01/2018,08/01/2018,0.00,,12.03,,"-17,275.68"
,IN,AR,30306000,1005,100,,Invoice,,,,,,08/01/2018,08/01/2018,0.00,,7.29,,"-17,282.97"
,IN,AR,30306046,1005,100,,Invoice,,,,,,08/01/2018,08/01/2018,0.00,,4.81,,"-17,287.78"
,IN,AR,30306096,1005,100,,Invoice,,,,,,08/01/2018,08/01/2018,0.00,,19.62,,"-17,307.40"
,IN,AR,30306140,1005,100,,Invoice,,,,,,08/01/2018,08/01/2018,0.00,,25.51,,"-17,332.91"
,IN,AR,30306168,1005,100,,Invoice,,,,,,08/01/2018,08/01/2018,0.00,,16.01,,"-17,348.92"
,IN,AR,30306187,1005,100,,Invoice,,,,,,08/01/2018,08/01/2018,0.00,,14.58,,"-17,363.50"
,IN,AR,30306191,1005,100,,Invoice,,,,,,08/01/2018,08/01/2018,0.00,,6.07,,"-17,369.57"
,IN,AR,30306195,1005,100,,Invoice,,,,,,08/01/2018,08/01/2018,0.00,,39.75,,"-17,409.32"
,IN,AR,30306258,1005,100,,Invoice,,,,,,08/01/2018,08/01/2018,0.00,,38.65,,"-17,447.97"
,IN,AR,30306274,1005,100,,Invoice,,,,,,08/01/2018,08/01/2018,0.00,,22.44,,"-17,470.41"
,IN,AR,30306299,1005,100,,Invoice,,,,,,08/01/2018,08/01/2018,0.00,,9.64,,"-17,480.05"
,IN,AR,30306307,1005,100,,Invoice,,,,,,08/01/2018,08/01/2018,0.00,,29.15,,"-17,509.20"
,IN,AR,30306360,1005,100,,Invoice,,,,,,08/01/2018,08/01/2018,0.00,,18.69,,"-17,527.89"
,IN,AR,30306377,1005,100,,Invoice,,,,,,08/01/2018,08/01/2018,0.00,,6.37,,"-17,534.26"
,IN,AR,30306412,1005,100,,Invoice,,,,,,08/01/2018,08/01/2018,0.00,,44.24,,"-17,578.50"
,IN,AR,30306436,1005,100,,Invoice,,,,,,08/01/2018,08/01/2018,0.00,,8.00,,"-17,586.50"
,IN,AR,30306543,1005,100,,Invoice,,,,,,08/01/2018,08/01/2018,0.00,,10.93,,"-17,597.43"
,IN,AR,30306603,1005,100,,Invoice,,,,,,08/01/2018,08/01/2018,0.00,,10.21,,"-17,607.64"
,IN,AR,30306623,1005,100,,Invoice,,,,,,08/01/2018,08/01/2018,0.00,,16.47,,"-17,624.11"
,CN,AR,31016961,1005,100,,Credit Note,,,,,,09/01/2018,09/01/2018,12.86,,0.00,,"-17,611.25"
,CN,AR,31016962,1005,100,,Credit Note,,,,,,09/01/2018,09/01/2018,40.74,,0.00,,"-17,570.51"
,CN,AR,31017036,1005,100,,Credit Note,,,,,,09/01/2018,09/01/2018,20.34,,0.00,,"-17,550.17"
,CN,AR,31017175,1005,100,,Credit Note,,,,,,09/01/2018,09/01/2018,10.93,,0.00,,"-17,539.24"
,CR,AR,33000028,1005,100,,Cash Return,,,,,,09/01/2018,09/01/2018,10.93,,0.00,,"-17,528.31"
,CR,AR,33000033,1005,100,,Cash Return,,,,,,09/01/2018,09/01/2018,10.93,,0.00,,"-17,517.38"
,CS,AR,32000016,1005,100,,Cash sale,,,,,,09/01/2018,09/01/2018,0.00,,3.64,,"-17,521.02"
,CS,AR,32000046,1005,100,,Cash sale,,,,,,09/01/2018,09/01/2018,0.00,,7.29,,"-17,528.31"
,CS,AR,32000066,1005,100,,Cash sale,,,,,,09/01/2018,09/01/2018,0.00,,3.64,,"-17,531.95"
,CS,AR,32000073,1005,100,,Cash sale,,,,,,09/01/2018,09/01/2018,0.00,,18.22,,"-17,550.17"
,CS,AR,32000121,1005,100,,Cash sale,,,,,,09/01/2018,09/01/2018,0.00,,7.29,,"-17,557.46"
,CS,AR,32000224,1005,100,,Cash sale,,,,,,09/01/2018,09/01/2018,0.00,,7.63,,"-17,565.09"
,CS,AR,32000233,1005,100,,Cash sale,,,,,,09/01/2018,09/01/2018,0.00,,4.78,,"-17,569.87"
,CS,AR,32000235,1005,100,,Cash sale,,,,,,09/01/2018,09/01/2018,0.00,,4.32,,"-17,574.19"
,CS,AR,32000236,1005,100,,Cash sale,,,,,,09/01/2018,09/01/2018,0.00,,5.17,,"-17,579.36"
,CS,AR,32000240,1005,100,,Cash sale,,,,,,09/01/2018,09/01/2018,0.00,,2.16,,"-17,581.52"
,CS,AR,32000275,1005,100,,Cash sale,,,,,,09/01/2018,09/01/2018,0.00,,7.75,,"-17,589.27"
,CS,AR,32000301,1005,100,,Cash sale,,,,,,09/01/2018,09/01/2018,0.00,,18.22,,"-17,607.49"
,CS,AR,32000340,1005,100,,Cash sale,,,,,,09/01/2018,09/01/2018,0.00,,3.64,,"-17,611.13"
,CS,AR,32000354,1005,100,,Cash sale,,,,,,09/01/2018,09/01/2018,0.00,,4.29,,"-17,615.42"
,CS,AR,32000357,1005,100,,Cash sale,,,,,,09/01/2018,09/01/2018,0.00,,3.64,,"-17,619.06"
,CS,AR,32000399,1005,100,,Cash sale,,,,,,09/01/2018,09/01/2018,0.00,,11.69,,"-17,630.75"
,CS,AR,32000411,1005,100,,Cash sale,,,,,,09/01/2018,09/01/2018,0.00,,6.86,,"-17,637.61"
,CS,AR,32000419,1005,100,,Cash sale,,,,,,09/01/2018,09/01/2018,0.00,,5.85,,"-17,643.46"
,CS,AR,32000432,1005,100,,Cash sale,,,,,,09/01/2018,09/01/2018,0.00,,2.39,,"-17,645.85"
,CS,AR,32000434,1005,100,,Cash sale,,,,,,09/01/2018,09/01/2018,0.00,,3.90,,"-17,649.75"
,CS,AR,32000455,1005,100,,Cash sale,,,,,,09/01/2018,09/01/2018,0.00,,7.75,,"-17,657.50"
,CS,AR,32000476,1005,100,,Cash sale,,,,,,09/01/2018,09/01/2018,0.00,,18.09,,"-17,675.59"
,CS,AR,32000482,1005,100,,Cash sale,,,,,,09/01/2018,09/01/2018,0.00,,9.75,,"-17,685.34"
,CS,AR,32000485,1005,100,,Cash sale,,,,,,09/01/2018,09/01/2018,0.00,,10.93,,"-17,696.27"
,CS,AR,32000582,1005,100,,Cash sale,,,,,,09/01/2018,09/01/2018,0.00,,15.01,,"-17,711.28"
,CS,AR,32000627,1005,100,,Cash sale,,,,,,09/01/2018,09/01/2018,0.00,,29.15,,"-17,740.43"
,CS,AR,32000661,1005,100,,Cash sale,,,,,,09/01/2018,09/01/2018,0.00,,14.58,,"-17,755.01"
,CS,AR,32000663,1005,100,,Cash sale,,,,,,09/01/2018,09/01/2018,0.00,,5.08,,"-17,760.09"
,CS,AR,32000667,1005,100,,Cash sale,,,,,,09/01/2018,09/01/2018,0.00,,24.00,,"-17,784.09"
,CS,AR,32000683,1005,100,,Cash sale,,,,,,09/01/2018,09/01/2018,0.00,,3.64,,"-17,787.73"
,CS,AR,32000693,1005,100,,Cash sale,,,,,,09/01/2018,09/01/2018,0.00,,6.56,,"-17,794.29"
,CS,AR,32000700,1005,100,,Cash sale,,,,,,09/01/2018,09/01/2018,0.00,,2.74,,"-17,797.03"
,CS,AR,32000756,1005,100,,Cash sale,,,,,,09/01/2018,09/01/2018,0.00,,10.93,,"-17,807.96"
,CS,AR,32000810,1005,100,,Cash sale,,,,,,09/01/2018,09/01/2018,0.00,,7.29,,"-17,815.25"
,CS,AR,32000831,1005,100,,Cash sale,,,,,,09/01/2018,09/01/2018,0.00,,7.29,,"-17,822.54"
,CS,AR,32000865,1005,100,,Cash sale,,,,,,09/01/2018,09/01/2018,0.00,,14.58,,"-17,837.12"
,CS,AR,32000880,1005,100,,Cash sale,,,,,,09/01/2018,09/01/2018,0.00,,14.58,,"-17,851.70"
,CS,AR,32000901,1005,100,,Cash sale,,,,,,09/01/2018,09/01/2018,0.00,,7.29,,"-17,858.99"
,CS,AR,32000910,1005,100,,Cash sale,,,,,,09/01/2018,09/01/2018,0.00,,18.22,,"-17,877.21"
,IN,AR,30304467,1005,100,,Invoice,,,,,,09/01/2018,09/01/2018,0.00,,7.00,,"-17,884.21"
,IN,AR,30304490,1005,100,,Invoice,,,,,,09/01/2018,09/01/2018,0.00,,19.87,,"-17,904.08"
,IN,AR,30304522,1005,100,,Invoice,,,,,,09/01/2018,09/01/2018,0.00,,52.20,,"-17,956.28"
,IN,AR,30304567,1005,100,,Invoice,,,,,,09/01/2018,09/01/2018,0.00,,11.86,,"-17,968.14"
,IN,AR,30304569,1005,100,,Invoice,,,,,,09/01/2018,09/01/2018,0.00,,21.86,,"-17,990.00"
,IN,AR,30304578,1005,100,,Invoice,,,,,,09/01/2018,09/01/2018,0.00,,7.29,,"-17,997.29"
,IN,AR,30304580,1005,100,,Invoice,,,,,,09/01/2018,09/01/2018,0.00,,31.81,,"-18,029.10"
,IN,AR,30304684,1005,100,,Invoice,,,,,,09/01/2018,09/01/2018,0.00,,10.93,,"-18,040.03"
,IN,AR,30304690,1005,100,,Invoice,,,,,,09/01/2018,09/01/2018,0.00,,21.86,,"-18,061.89"
,IN,AR,30304725,1005,100,,Invoice,,,,,,09/01/2018,09/01/2018,0.00,,488.10,,"-18,549.99"
,IN,AR,30304733,1005,100,,Invoice,,,,,,09/01/2018,09/01/2018,0.00,,5.82,,"-18,555.81"
,IN,AR,30304754,1005,100,,Invoice,,,,,,09/01/2018,09/01/2018,0.00,,30.22,,"-18,586.03"
,IN,AR,30304758,1005,100,,Invoice,,,,,,09/01/2018,09/01/2018,0.00,,7.29,,"-18,593.32"
,IN,AR,30304793,1005,100,,Invoice,,,,,,09/01/2018,09/01/2018,0.00,,3.64,,"-18,596.96"
,IN,AR,30304840,1005,100,,Invoice,,,,,,09/01/2018,09/01/2018,0.00,,4.64,,"-18,601.60"
,IN,AR,30304850,1005,100,,Invoice,,,,,,09/01/2018,09/01/2018,0.00,,7.19,,"-18,608.79"
,IN,AR,30304851,1005,100,,Invoice,,,,,,09/01/2018,09/01/2018,0.00,,16.79,,"-18,625.58"
,IN,AR,30304882,1005,100,,Invoice,,,,,,09/01/2018,09/01/2018,0.00,,10.34,,"-18,635.92"
,IN,AR,30304907,1005,100,,Invoice,,,,,,09/01/2018,09/01/2018,0.00,,30.51,,"-18,666.43"
,IN,AR,30304908,1005,100,,Invoice,,,,,,09/01/2018,09/01/2018,0.00,,20.34,,"-18,686.77"
,IN,AR,30304922,1005,100,,Invoice,,,,,,09/01/2018,09/01/2018,0.00,,10.34,,"-18,697.11"
,IN,AR,30304973,1005,100,,Invoice,,,,,,09/01/2018,09/01/2018,0.00,,7.42,,"-18,704.53"
,IN,AR,30305010,1005,100,,Invoice,,,,,,09/01/2018,09/01/2018,0.00,,63.77,,"-18,768.30"
,IN,AR,30305012,1005,100,,Invoice,,,,,,09/01/2018,09/01/2018,0.00,,11.69,,"-18,779.99"
,IN,AR,30305046,1005,100,,Invoice,,,,,,09/01/2018,09/01/2018,0.00,,5.17,,"-18,785.16"
,IN,AR,30305076,1005,100,,Invoice,,,,,,09/01/2018,09/01/2018,0.00,,12.88,,"-18,798.04"
,IN,AR,30305104,1005,100,,Invoice,,,,,,09/01/2018,09/01/2018,0.00,,7.29,,"-18,805.33"
,IN,AR,30305124,1005,100,,Invoice,,,,,,09/01/2018,09/01/2018,0.00,,51.27,,"-18,856.60"
,IN,AR,30305130,1005,100,,Invoice,,,,,,09/01/2018,09/01/2018,0.00,,2.58,,"-18,859.18"
,IN,AR,30305139,1005,100,,Invoice,,,,,,09/01/2018,09/01/2018,0.00,,55.14,,"-18,914.32"
,IN,AR,30305273,1005,100,,Invoice,,,,,,09/01/2018,09/01/2018,0.00,,17.80,,"-18,932.12"
,IN,AR,30305283,1005,100,,Invoice,,,,,,09/01/2018,09/01/2018,0.00,,21.86,,"-18,953.98"
,IN,AR,30305346,1005,100,,Invoice,,,,,,09/01/2018,09/01/2018,0.00,,7.29,,"-18,961.27"
,IN,AR,30305354,1005,100,,Invoice,,,,,,09/01/2018,09/01/2018,0.00,,32.80,,"-18,994.07"
,IN,AR,30305397,1005,100,,Invoice,,,,,,09/01/2018,09/01/2018,0.00,,9.92,,"-19,003.99"
,IN,AR,30305418,1005,100,,Invoice,,,,,,09/01/2018,09/01/2018,0.00,,8.77,,"-19,012.76"
,IN,AR,30305424,1005,100,,Invoice,,,,,,09/01/2018,09/01/2018,0.00,,3.64,,"-19,016.40"
,IN,AR,30305463,1005,100,,Invoice,,,,,,09/01/2018,09/01/2018,0.00,,12.92,,"-19,029.32"
,IN,AR,30305497,1005,100,,Invoice,,,,,,09/01/2018,09/01/2018,0.00,,3.64,,"-19,032.96"
,IN,AR,30305515,1005,100,,Invoice,,,,,,09/01/2018,09/01/2018,0.00,,6.89,,"-19,039.85"
,IN,AR,30305530,1005,100,,Invoice,,,,,,09/01/2018,09/01/2018,0.00,,45.13,,"-19,084.98"
,IN,AR,30305537,1005,100,,Invoice,,,,,,09/01/2018,09/01/2018,0.00,,10.34,,"-19,095.32"
,IN,AR,30305645,1005,100,,Invoice,,,,,,09/01/2018,09/01/2018,0.00,,17.54,,"-19,112.86"
,IN,AR,30305660,1005,100,,Invoice,,,,,,09/01/2018,09/01/2018,0.00,,68.14,,"-19,181.00"
,IN,AR,30305675,1005,100,,Invoice,,,,,,09/01/2018,09/01/2018,0.00,,8.26,,"-19,189.26"
,IN,AR,30305680,1005,100,,Invoice,,,,,,09/01/2018,09/01/2018,0.00,,5.59,,"-19,194.85"
,IN,AR,30305699,1005,100,,Invoice,,,,,,09/01/2018,09/01/2018,0.00,,8.52,,"-19,203.37"
,IN,AR,30305720,1005,100,,Invoice,,,,,,09/01/2018,09/01/2018,0.00,,4.49,,"-19,207.86"
,IN,AR,30305748,1005,100,,Invoice,,,,,,09/01/2018,09/01/2018,0.00,,89.28,,"-19,297.14"
,IN,AR,30305764,1005,100,,Invoice,,,,,,09/01/2018,09/01/2018,0.00,,7.29,,"-19,304.43"
,IN,AR,30305779,1005,100,,Invoice,,,,,,09/01/2018,09/01/2018,0.00,,49.31,,"-19,353.74"
,IN,AR,30305800,1005,100,,Invoice,,,,,,09/01/2018,09/01/2018,0.00,,5.29,,"-19,359.03"
,IN,AR,30305827,1005,100,,Invoice,,,,,,09/01/2018,09/01/2018,0.00,,54.66,,"-19,413.69"
,IN,AR,30305863,1005,100,,Invoice,,,,,,09/01/2018,09/01/2018,0.00,,11.70,,"-19,425.39"
,IN,AR,30305911,1005,100,,Invoice,,,,,,09/01/2018,09/01/2018,0.00,,7.29,,"-19,432.68"
,IN,AR,30306027,1005,100,,Invoice,,,,,,09/01/2018,09/01/2018,0.00,,201.52,,"-19,634.20"
,IN,AR,30306047,1005,100,,Invoice,,,,,,09/01/2018,09/01/2018,0.00,,6.42,,"-19,640.62"
,IN,AR,30306105,1005,100,,Invoice,,,,,,09/01/2018,09/01/2018,0.00,,4.58,,"-19,645.20"
,IN,AR,30306117,1005,100,,Invoice,,,,,,09/01/2018,09/01/2018,0.00,,12.73,,"-19,657.93"
,IN,AR,30306123,1005,100,,Invoice,,,,,,09/01/2018,09/01/2018,0.00,,10.93,,"-19,668.86"
,IN,AR,30306142,1005,100,,Invoice,,,,,,09/01/2018,09/01/2018,0.00,,5.93,,"-19,674.79"
,IN,AR,30306144,1005,100,,Invoice,,,,,,09/01/2018,09/01/2018,0.00,,7.29,,"-19,682.08"
,IN,AR,30306147,1005,100,,Invoice,,,,,,09/01/2018,09/01/2018,0.00,,7.29,,"-19,689.37"
,IN,AR,30306154,1005,100,,Invoice,,,,,,09/01/2018,09/01/2018,0.00,,15.25,,"-19,704.62"
,IN,AR,30306201,1005,100,,Invoice,,,,,,09/01/2018,09/01/2018,0.00,,33.19,,"-19,737.81"
,IN,AR,30306215,1005,100,,Invoice,,,,,,09/01/2018,09/01/2018,0.00,,10.93,,"-19,748.74"
,IN,AR,30306228,1005,100,,Invoice,,,,,,09/01/2018,09/01/2018,0.00,,21.03,,"-19,769.77"
,IN,AR,30306229,1005,100,,Invoice,,,,,,09/01/2018,09/01/2018,0.00,,12.62,,"-19,782.39"
,IN,AR,30306263,1005,100,,Invoice,,,,,,09/01/2018,09/01/2018,0.00,,114.19,,"-19,896.58"
,IN,AR,30306268,1005,100,,Invoice,,,,,,09/01/2018,09/01/2018,0.00,,10.95,,"-19,907.53"
,IN,AR,30306285,1005,100,,Invoice,,,,,,09/01/2018,09/01/2018,0.00,,361.03,,"-20,268.56"
,IN,AR,30306303,1005,100,,Invoice,,,,,,09/01/2018,09/01/2018,0.00,,58.00,,"-20,326.56"
,IN,AR,30306309,1005,100,,Invoice,,,,,,09/01/2018,09/01/2018,0.00,,12.14,,"-20,338.70"
,IN,AR,30306318,1005,100,,Invoice,,,,,,09/01/2018,09/01/2018,0.00,,29.15,,"-20,367.85"
,IN,AR,30306326,1005,100,,Invoice,,,,,,09/01/2018,09/01/2018,0.00,,37.97,,"-20,405.82"
,IN,AR,30306334,1005,100,,Invoice,,,,,,09/01/2018,09/01/2018,0.00,,3.64,,"-20,409.46"
,IN,AR,30306336,1005,100,,Invoice,,,,,,09/01/2018,09/01/2018,0.00,,29.15,,"-20,438.61"
,IN,AR,30306348,1005,100,,Invoice,,,,,,09/01/2018,09/01/2018,0.00,,5.08,,"-20,443.69"
,IN,AR,30306401,1005,100,,Invoice,,,,,,09/01/2018,09/01/2018,0.00,,89.49,,"-20,533.18"
,IN,AR,30306416,1005,100,,Invoice,,,,,,09/01/2018,09/01/2018,0.00,,21.36,,"-20,554.54"
,IN,AR,30306417,1005,100,,Invoice,,,,,,09/01/2018,09/01/2018,0.00,,23.73,,"-20,578.27"
,IN,AR,30306418,1005,100,,Invoice,,,,,,09/01/2018,09/01/2018,0.00,,78.31,,"-20,656.58"
,IN,AR,30306448,1005,100,,Invoice,,,,,,09/01/2018,09/01/2018,0.00,,3.76,,"-20,660.34"
,IN,AR,30306460,1005,100,,Invoice,,,,,,09/01/2018,09/01/2018,0.00,,5.26,,"-20,665.60"
,IN,AR,30306465,1005,100,,Invoice,,,,,,09/01/2018,09/01/2018,0.00,,6.00,,"-20,671.60"
,IN,AR,30306480,1005,100,,Invoice,,,,,,09/01/2018,09/01/2018,0.00,,88.75,,"-20,760.35"
,IN,AR,30306499,1005,100,,Invoice,,,,,,09/01/2018,09/01/2018,0.00,,5.26,,"-20,765.61"
,IN,AR,30306544,1005,100,,Invoice,,,,,,09/01/2018,09/01/2018,0.00,,14.58,,"-20,780.19"
,CN,AR,31016896,1005,100,,Credit Note,,,,,,10/01/2018,10/01/2018,"2,135.40",,0.00,,"-18,644.79"
,CN,AR,31016903,1005,100,,Credit Note,,,,,,10/01/2018,10/01/2018,7.29,,0.00,,"-18,637.50"
,CN,AR,31017185,1005,100,,Credit Note,,,,,,10/01/2018,10/01/2018,10.93,,0.00,,"-18,626.57"
,CN,AR,31017197,1005,100,,Credit Note,,,,,,10/01/2018,10/01/2018,13.17,,0.00,,"-18,613.40"
,CS,AR,32000008,1005,100,,Cash sale,,,,,,10/01/2018,10/01/2018,0.00,,8.42,,"-18,621.82"
,CS,AR,32000021,1005,100,,Cash sale,,,,,,10/01/2018,10/01/2018,0.00,,30.10,,"-18,651.92"
,CS,AR,32000037,1005,100,,Cash sale,,,,,,10/01/2018,10/01/2018,0.00,,12.17,,"-18,664.09"
,CS,AR,32000058,1005,100,,Cash sale,,,,,,10/01/2018,10/01/2018,0.00,,7.29,,"-18,671.38"
,CS,AR,32000065,1005,100,,Cash sale,,,,,,10/01/2018,10/01/2018,0.00,,10.93,,"-18,682.31"
,CS,AR,32000145,1005,100,,Cash sale,,,,,,10/01/2018,10/01/2018,0.00,,7.29,,"-18,689.60"
,CS,AR,32000149,1005,100,,Cash sale,,,,,,10/01/2018,10/01/2018,0.00,,6.02,,"-18,695.62"
,CS,AR,32000168,1005,100,,Cash sale,,,,,,10/01/2018,10/01/2018,0.00,,7.29,,"-18,702.91"
,CS,AR,32000184,1005,100,,Cash sale,,,,,,10/01/2018,10/01/2018,0.00,,8.39,,"-18,711.30"
,CS,AR,32000190,1005,100,,Cash sale,,,,,,10/01/2018,10/01/2018,0.00,,23.29,,"-18,734.59"
,CS,AR,32000204,1005,100,,Cash sale,,,,,,10/01/2018,10/01/2018,0.00,,5.86,,"-18,740.45"
,CS,AR,32000290,1005,100,,Cash sale,,,,,,10/01/2018,10/01/2018,0.00,,23.26,,"-18,763.71"
,CS,AR,32000304,1005,100,,Cash sale,,,,,,10/01/2018,10/01/2018,0.00,,3.64,,"-18,767.35"
,CS,AR,32000313,1005,100,,Cash sale,,,,,,10/01/2018,10/01/2018,0.00,,5.49,,"-18,772.84"
,CS,AR,32000321,1005,100,,Cash sale,,,,,,10/01/2018,10/01/2018,0.00,,21.06,,"-18,793.90"
,CS,AR,32000346,1005,100,,Cash sale,,,,,,10/01/2018,10/01/2018,0.00,,10.93,,"-18,804.83"
,CS,AR,32000364,1005,100,,Cash sale,,,,,,10/01/2018,10/01/2018,0.00,,2.54,,"-18,807.37"
,CS,AR,32000377,1005,100,,Cash sale,,,,,,10/01/2018,10/01/2018,0.00,,7.00,,"-18,814.37"
,CS,AR,32000389,1005,100,,Cash sale,,,,,,10/01/2018,10/01/2018,0.00,,6.74,,"-18,821.11"
,CS,AR,32000417,1005,100,,Cash sale,,,,,,10/01/2018,10/01/2018,0.00,,6.48,,"-18,827.59"
,CS,AR,32000438,1005,100,,Cash sale,,,,,,10/01/2018,10/01/2018,0.00,,3.64,,"-18,831.23"
,CS,AR,32000510,1005,100,,Cash sale,,,,,,10/01/2018,10/01/2018,0.00,,14.58,,"-18,845.81"
,CS,AR,32000528,1005,100,,Cash sale,,,,,,10/01/2018,10/01/2018,0.00,,7.29,,"-18,853.10"
,CS,AR,32000653,1005,100,,Cash sale,,,,,,10/01/2018,10/01/2018,0.00,,10.93,,"-18,864.03"
,CS,AR,32000662,1005,100,,Cash sale,,,,,,10/01/2018,10/01/2018,0.00,,9.84,,"-18,873.87"
,CS,AR,32000712,1005,100,,Cash sale,,,,,,10/01/2018,10/01/2018,0.00,,6.86,,"-18,880.73"
,CS,AR,32000729,1005,100,,Cash sale,,,,,,10/01/2018,10/01/2018,0.00,,21.86,,"-18,902.59"
,CS,AR,32000748,1005,100,,Cash sale,,,,,,10/01/2018,10/01/2018,0.00,,7.29,,"-18,909.88"
,CS,AR,32000777,1005,100,,Cash sale,,,,,,10/01/2018,10/01/2018,0.00,,7.29,,"-18,917.17"
,CS,AR,32000785,1005,100,,Cash sale,,,,,,10/01/2018,10/01/2018,0.00,,10.93,,"-18,928.10"
,CS,AR,32000802,1005,100,,Cash sale,,,,,,10/01/2018,10/01/2018,0.00,,5.08,,"-18,933.18"
,CS,AR,32000818,1005,100,,Cash sale,,,,,,10/01/2018,10/01/2018,0.00,,3.03,,"-18,936.21"
,CS,AR,32000824,1005,100,,Cash sale,,,,,,10/01/2018,10/01/2018,0.00,,3.64,,"-18,939.85"
,CS,AR,32000827,1005,100,,Cash sale,,,,,,10/01/2018,10/01/2018,0.00,,25.51,,"-18,965.36"
,CS,AR,32000861,1005,100,,Cash sale,,,,,,10/01/2018,10/01/2018,0.00,,7.29,,"-18,972.65"
,CS,AR,32000875,1005,100,,Cash sale,,,,,,10/01/2018,10/01/2018,0.00,,14.58,,"-18,987.23"
,CS,AR,32000897,1005,100,,Cash sale,,,,,,10/01/2018,10/01/2018,0.00,,7.29,,"-18,994.52"
,IN,AR,30304356,1005,100,,Invoice,,,,,,10/01/2018,10/01/2018,0.00,,54.66,,"-19,049.18"
,IN,AR,30304365,1005,100,,Invoice,,,,,,10/01/2018,10/01/2018,0.00,,26.69,,"-19,075.87"
,IN,AR,30304366,1005,100,,Invoice,,,,,,10/01/2018,10/01/2018,0.00,,5.93,,"-19,081.80"
,IN,AR,30304393,1005,100,,Invoice,,,,,,10/01/2018,10/01/2018,0.00,,7.12,,"-19,088.92"
,IN,AR,30304396,1005,100,,Invoice,,,,,,10/01/2018,10/01/2018,0.00,,219.81,,"-19,308.73"
,IN,AR,30304397,1005,100,,Invoice,,,,,,10/01/2018,10/01/2018,0.00,,10.93,,"-19,319.66"
,IN,AR,30304403,1005,100,,Invoice,,,,,,10/01/2018,10/01/2018,0.00,,14.58,,"-19,334.24"
,IN,AR,30304412,1005,100,,Invoice,,,,,,10/01/2018,10/01/2018,0.00,,61.02,,"-19,395.26"
,IN,AR,30304413,1005,100,,Invoice,,,,,,10/01/2018,10/01/2018,0.00,,29.29,,"-19,424.55"
,IN,AR,30304414,1005,100,,Invoice,,,,,,10/01/2018,10/01/2018,0.00,,9.76,,"-19,434.31"
,IN,AR,30304441,1005,100,,Invoice,,,,,,10/01/2018,10/01/2018,0.00,,"1,093.22",,"-20,527.53"
,IN,AR,30304487,1005,100,,Invoice,,,,,,10/01/2018,10/01/2018,0.00,,14.58,,"-20,542.11"
,IN,AR,30304523,1005,100,,Invoice,,,,,,10/01/2018,10/01/2018,0.00,,21.36,,"-20,563.47"
,IN,AR,30304590,1005,100,,Invoice,,,,,,10/01/2018,10/01/2018,0.00,,32.80,,"-20,596.27"
,IN,AR,30304606,1005,100,,Invoice,,,,,,10/01/2018,10/01/2018,0.00,,16.00,,"-20,612.27"
,IN,AR,30304641,1005,100,,Invoice,,,,,,10/01/2018,10/01/2018,0.00,,7.29,,"-20,619.56"
,IN,AR,30304651,1005,100,,Invoice,,,,,,10/01/2018,10/01/2018,0.00,,22.00,,"-20,641.56"
,IN,AR,30304662,1005,100,,Invoice,,,,,,10/01/2018,10/01/2018,0.00,,71.19,,"-20,712.75"
,IN,AR,30304671,1005,100,,Invoice,,,,,,10/01/2018,10/01/2018,0.00,,20.00,,"-20,732.75"
,IN,AR,30304714,1005,100,,Invoice,,,,,,10/01/2018,10/01/2018,0.00,,54.58,,"-20,787.33"
,IN,AR,30304715,1005,100,,Invoice,,,,,,10/01/2018,10/01/2018,0.00,,40.93,,"-20,828.26"
,IN,AR,30304716,1005,100,,Invoice,,,,,,10/01/2018,10/01/2018,0.00,,13.64,,"-20,841.90"
,IN,AR,30304740,1005,100,,Invoice,,,,,,10/01/2018,10/01/2018,0.00,,43.02,,"-20,884.92"
,IN,AR,30304759,1005,100,,Invoice,,,,,,10/01/2018,10/01/2018,0.00,,15.04,,"-20,899.96"
,IN,AR,30304781,1005,100,,Invoice,,,,,,10/01/2018,10/01/2018,0.00,,15.92,,"-20,915.88"
,IN,AR,30304871,1005,100,,Invoice,,,,,,10/01/2018,10/01/2018,0.00,,20.34,,"-20,936.22"
,IN,AR,30304893,1005,100,,Invoice,,,,,,10/01/2018,10/01/2018,0.00,,10.34,,"-20,946.56"
,IN,AR,30304909,1005,100,,Invoice,,,,,,10/01/2018,10/01/2018,0.00,,81.36,,"-21,027.92"
,IN,AR,30304915,1005,100,,Invoice,,,,,,10/01/2018,10/01/2018,0.00,,2.58,,"-21,030.50"
,IN,AR,30304943,1005,100,,Invoice,,,,,,10/01/2018,10/01/2018,0.00,,182.20,,"-21,212.70"
,IN,AR,30304957,1005,100,,Invoice,,,,,,10/01/2018,10/01/2018,0.00,,"1,093.22",,"-22,305.92"
,IN,AR,30305036,1005,100,,Invoice,,,,,,10/01/2018,10/01/2018,0.00,,50.85,,"-22,356.77"
,IN,AR,30305156,1005,100,,Invoice,,,,,,10/01/2018,10/01/2018,0.00,,72.03,,"-22,428.80"
,IN,AR,30305208,1005,100,,Invoice,,,,,,10/01/2018,10/01/2018,0.00,,36.44,,"-22,465.24"
,IN,AR,30305221,1005,100,,Invoice,,,,,,10/01/2018,10/01/2018,0.00,,7.63,,"-22,472.87"
,IN,AR,30305222,1005,100,,Invoice,,,,,,10/01/2018,10/01/2018,0.00,,5.08,,"-22,477.95"
,IN,AR,30305244,1005,100,,Invoice,,,,,,10/01/2018,10/01/2018,0.00,,4.78,,"-22,482.73"
,IN,AR,30305370,1005,100,,Invoice,,,,,,10/01/2018,10/01/2018,0.00,,10.93,,"-22,493.66"
,IN,AR,30305374,1005,100,,Invoice,,,,,,10/01/2018,10/01/2018,0.00,,12.71,,"-22,506.37"
,IN,AR,30305429,1005,100,,Invoice,,,,,,10/01/2018,10/01/2018,0.00,,10.93,,"-22,517.30"
,IN,AR,30305460,1005,100,,Invoice,,,,,,10/01/2018,10/01/2018,0.00,,10.93,,"-22,528.23"
,IN,AR,30305473,1005,100,,Invoice,,,,,,10/01/2018,10/01/2018,0.00,,38.24,,"-22,566.47"
,IN,AR,30305484,1005,100,,Invoice,,,,,,10/01/2018,10/01/2018,0.00,,10.93,,"-22,577.40"
,IN,AR,30305485,1005,100,,Invoice,,,,,,10/01/2018,10/01/2018,0.00,,7.75,,"-22,585.15"
,IN,AR,30305544,1005,100,,Invoice,,,,,,10/01/2018,10/01/2018,0.00,,23.73,,"-22,608.88"
,IN,AR,30305553,1005,100,,Invoice,,,,,,10/01/2018,10/01/2018,0.00,,13.73,,"-22,622.61"
,IN,AR,30305582,1005,100,,Invoice,,,,,,10/01/2018,10/01/2018,0.00,,1.88,,"-22,624.49"
,IN,AR,30305595,1005,100,,Invoice,,,,,,10/01/2018,10/01/2018,0.00,,10.93,,"-22,635.42"
,IN,AR,30305596,1005,100,,Invoice,,,,,,10/01/2018,10/01/2018,0.00,,14.58,,"-22,650.00"
,IN,AR,30305620,1005,100,,Invoice,,,,,,10/01/2018,10/01/2018,0.00,,22.37,,"-22,672.37"
,IN,AR,30305726,1005,100,,Invoice,,,,,,10/01/2018,10/01/2018,0.00,,21.06,,"-22,693.43"
,IN,AR,30305734,1005,100,,Invoice,,,,,,10/01/2018,10/01/2018,0.00,,12.03,,"-22,705.46"
,IN,AR,30305801,1005,100,,Invoice,,,,,,10/01/2018,10/01/2018,0.00,,10.57,,"-22,716.03"
,IN,AR,30305843,1005,100,,Invoice,,,,,,10/01/2018,10/01/2018,0.00,,4.88,,"-22,720.91"
,IN,AR,30305866,1005,100,,Invoice,,,,,,10/01/2018,10/01/2018,0.00,,12.00,,"-22,732.91"
,IN,AR,30305925,1005,100,,Invoice,,,,,,10/01/2018,10/01/2018,0.00,,22.88,,"-22,755.79"
,IN,AR,30305928,1005,100,,Invoice,,,,,,10/01/2018,10/01/2018,0.00,,9.15,,"-22,764.94"
,IN,AR,30305974,1005,100,,Invoice,,,,,,10/01/2018,10/01/2018,0.00,,36.00,,"-22,800.94"
,IN,AR,30306023,1005,100,,Invoice,,,,,,10/01/2018,10/01/2018,0.00,,23.77,,"-22,824.71"
,IN,AR,30306048,1005,100,,Invoice,,,,,,10/01/2018,10/01/2018,0.00,,8.02,,"-22,832.73"
,IN,AR,30306049,1005,100,,Invoice,,,,,,10/01/2018,10/01/2018,0.00,,14.43,,"-22,847.16"
,IN,AR,30306050,1005,100,,Invoice,,,,,,10/01/2018,10/01/2018,0.00,,9.62,,"-22,856.78"
,IN,AR,30306051,1005,100,,Invoice,,,,,,10/01/2018,10/01/2018,0.00,,3.20,,"-22,859.98"
,IN,AR,30306052,1005,100,,Invoice,,,,,,10/01/2018,10/01/2018,0.00,,4.81,,"-22,864.79"
,IN,AR,30306099,1005,100,,Invoice,,,,,,10/01/2018,10/01/2018,0.00,,39.41,,"-22,904.20"
,IN,AR,30306127,1005,100,,Invoice,,,,,,10/01/2018,10/01/2018,0.00,,7.76,,"-22,911.96"
,IN,AR,30306173,1005,100,,Invoice,,,,,,10/01/2018,10/01/2018,0.00,,10.00,,"-22,921.96"
,IN,AR,30306183,1005,100,,Invoice,,,,,,10/01/2018,10/01/2018,0.00,,20.01,,"-22,941.97"
,IN,AR,30306184,1005,100,,Invoice,,,,,,10/01/2018,10/01/2018,0.00,,72.88,,"-23,014.85"
,IN,AR,30306202,1005,100,,Invoice,,,,,,10/01/2018,10/01/2018,0.00,,7.54,,"-23,022.39"
,IN,AR,30306209,1005,100,,Invoice,,,,,,10/01/2018,10/01/2018,0.00,,7.29,,"-23,029.68"
,IN,AR,30306230,1005,100,,Invoice,,,,,,10/01/2018,10/01/2018,0.00,,25.23,,"-23,054.91"
,IN,AR,30306239,1005,100,,Invoice,,,,,,10/01/2018,10/01/2018,0.00,,23.90,,"-23,078.81"
,IN,AR,30306244,1005,100,,Invoice,,,,,,10/01/2018,10/01/2018,0.00,,6.99,,"-23,085.80"
,IN,AR,30306257,1005,100,,Invoice,,,,,,10/01/2018,10/01/2018,0.00,,10.93,,"-23,096.73"
,IN,AR,30306292,1005,100,,Invoice,,,,,,10/01/2018,10/01/2018,0.00,,5.47,,"-23,102.20"
,IN,AR,30306364,1005,100,,Invoice,,,,,,10/01/2018,10/01/2018,0.00,,40.58,,"-23,142.78"
,IN,AR,30306410,1005,100,,Invoice,,,,,,10/01/2018,10/01/2018,0.00,,10.93,,"-23,153.71"
,IN,AR,30306456,1005,100,,Invoice,,,,,,10/01/2018,10/01/2018,0.00,,3.51,,"-23,157.22"
,IN,AR,30306488,1005,100,,Invoice,,,,,,10/01/2018,10/01/2018,0.00,,29.15,,"-23,186.37"
,IN,AR,30306513,1005,100,,Invoice,,,,,,10/01/2018,10/01/2018,0.00,,5.47,,"-23,191.84"
,IN,AR,30306517,1005,100,,Invoice,,,,,,10/01/2018,10/01/2018,0.00,,182.20,,"-23,374.04"
,IN,AR,30306533,1005,100,,Invoice,,,,,,10/01/2018,10/01/2018,0.00,,13.17,,"-23,387.21"
,IN,AR,30306534,1005,100,,Invoice,,,,,,10/01/2018,10/01/2018,0.00,,5.64,,"-23,392.85"
,IN,AR,30306572,1005,100,,Invoice,,,,,,10/01/2018,10/01/2018,0.00,,54.66,,"-23,447.51"
,IN,AR,30306582,1005,100,,Invoice,,,,,,10/01/2018,10/01/2018,0.00,,10.93,,"-23,458.44"
,IN,AR,30306598,1005,100,,Invoice,,,,,,10/01/2018,10/01/2018,0.00,,16.78,,"-23,475.22"
,IN,AR,30306624,1005,100,,Invoice,,,,,,10/01/2018,10/01/2018,0.00,,8.24,,"-23,483.46"
,IN,AR,30306629,1005,100,,Invoice,,,,,,10/01/2018,10/01/2018,0.00,,21.86,,"-23,505.32"
,IN,AR,30306641,1005,100,,Invoice,,,,,,10/01/2018,10/01/2018,0.00,,182.20,,"-23,687.52"
,CN,AR,31016969,1005,100,,Credit Note,,,,,,11/01/2018,11/01/2018,10.34,,0.00,,"-23,677.18"
,CN,AR,31016970,1005,100,,Credit Note,,,,,,11/01/2018,11/01/2018,7.75,,0.00,,"-23,669.43"
,CN,AR,31016971,1005,100,,Credit Note,,,,,,11/01/2018,11/01/2018,7.75,,0.00,,"-23,661.68"
,CN,AR,31016992,1005,100,,Credit Note,,,,,,11/01/2018,11/01/2018,92.97,,0.00,,"-23,568.71"
,CS,AR,32000033,1005,100,,Cash sale,,,,,,11/01/2018,11/01/2018,0.00,,3.64,,"-23,572.35"
,CS,AR,32000040,1005,100,,Cash sale,,,,,,11/01/2018,11/01/2018,0.00,,7.29,,"-23,579.64"
,CS,AR,32000071,1005,100,,Cash sale,,,,,,11/01/2018,11/01/2018,0.00,,47.37,,"-23,627.01"
,CS,AR,32000082,1005,100,,Cash sale,,,,,,11/01/2018,11/01/2018,0.00,,7.29,,"-23,634.30"
,CS,AR,32000105,1005,100,,Cash sale,,,,,,11/01/2018,11/01/2018,0.00,,3.64,,"-23,637.94"
,CS,AR,32000154,1005,100,,Cash sale,,,,,,11/01/2018,11/01/2018,0.00,,3.64,,"-23,641.58"
,CS,AR,32000157,1005,100,,Cash sale,,,,,,11/01/2018,11/01/2018,0.00,,7.29,,"-23,648.87"
,CS,AR,32000160,1005,100,,Cash sale,,,,,,11/01/2018,11/01/2018,0.00,,3.64,,"-23,652.51"
,CS,AR,32000185,1005,100,,Cash sale,,,,,,11/01/2018,11/01/2018,0.00,,18.22,,"-23,670.73"
,CS,AR,32000220,1005,100,,Cash sale,,,,,,11/01/2018,11/01/2018,0.00,,5.17,,"-23,675.90"
,CS,AR,32000228,1005,100,,Cash sale,,,,,,11/01/2018,11/01/2018,0.00,,3.64,,"-23,679.54"
,CS,AR,32000230,1005,100,,Cash sale,,,,,,11/01/2018,11/01/2018,0.00,,7.29,,"-23,686.83"
,CS,AR,32000238,1005,100,,Cash sale,,,,,,11/01/2018,11/01/2018,0.00,,4.32,,"-23,691.15"
,CS,AR,32000242,1005,100,,Cash sale,,,,,,11/01/2018,11/01/2018,0.00,,7.29,,"-23,698.44"
,CS,AR,32000249,1005,100,,Cash sale,,,,,,11/01/2018,11/01/2018,0.00,,36.44,,"-23,734.88"
,CS,AR,32000258,1005,100,,Cash sale,,,,,,11/01/2018,11/01/2018,0.00,,18.11,,"-23,752.99"
,CS,AR,32000431,1005,100,,Cash sale,,,,,,11/01/2018,11/01/2018,0.00,,7.29,,"-23,760.28"
,CS,AR,32000443,1005,100,,Cash sale,,,,,,11/01/2018,11/01/2018,0.00,,15.04,,"-23,775.32"
,CS,AR,32000495,1005,100,,Cash sale,,,,,,11/01/2018,11/01/2018,0.00,,11.19,,"-23,786.51"
,CS,AR,32000514,1005,100,,Cash sale,,,,,,11/01/2018,11/01/2018,0.00,,10.93,,"-23,797.44"
,CS,AR,32000545,1005,100,,Cash sale,,,,,,11/01/2018,11/01/2018,0.00,,2.58,,"-23,800.02"
,CS,AR,32000566,1005,100,,Cash sale,,,,,,11/01/2018,11/01/2018,0.00,,10.93,,"-23,810.95"
,CS,AR,32000577,1005,100,,Cash sale,,,,,,11/01/2018,11/01/2018,0.00,,11.12,,"-23,822.07"
,CS,AR,32000579,1005,100,,Cash sale,,,,,,11/01/2018,11/01/2018,0.00,,10.93,,"-23,833.00"
,CS,AR,32000584,1005,100,,Cash sale,,,,,,11/01/2018,11/01/2018,0.00,,5.34,,"-23,838.34"
,CS,AR,32000597,1005,100,,Cash sale,,,,,,11/01/2018,11/01/2018,0.00,,10.93,,"-23,849.27"
,CS,AR,32000612,1005,100,,Cash sale,,,,,,11/01/2018,11/01/2018,0.00,,3.64,,"-23,852.91"
,CS,AR,32000636,1005,100,,Cash sale,,,,,,11/01/2018,11/01/2018,0.00,,14.58,,"-23,867.49"
,CS,AR,32000642,1005,100,,Cash sale,,,,,,11/01/2018,11/01/2018,0.00,,8.16,,"-23,875.65"
,CS,AR,32000659,1005,100,,Cash sale,,,,,,11/01/2018,11/01/2018,0.00,,32.80,,"-23,908.45"
,CS,AR,32000684,1005,100,,Cash sale,,,,,,11/01/2018,11/01/2018,0.00,,2.75,,"-23,911.20"
,CS,AR,32000721,1005,100,,Cash sale,,,,,,11/01/2018,11/01/2018,0.00,,30.36,,"-23,941.56"
,CS,AR,32000836,1005,100,,Cash sale,,,,,,11/01/2018,11/01/2018,0.00,,7.29,,"-23,948.85"
,CS,AR,32000837,1005,100,,Cash sale,,,,,,11/01/2018,11/01/2018,0.00,,7.29,,"-23,956.14"
,CS,AR,32000854,1005,100,,Cash sale,,,,,,11/01/2018,11/01/2018,0.00,,10.93,,"-23,967.07"
,CS,AR,32000858,1005,100,,Cash sale,,,,,,11/01/2018,11/01/2018,0.00,,7.29,,"-23,974.36"
,CS,AR,32000867,1005,100,,Cash sale,,,,,,11/01/2018,11/01/2018,0.00,,10.93,,"-23,985.29"
,CS,AR,32000872,1005,100,,Cash sale,,,,,,11/01/2018,11/01/2018,0.00,,7.29,,"-23,992.58"
,CS,AR,32000882,1005,100,,Cash sale,,,,,,11/01/2018,11/01/2018,0.00,,5.86,,"-23,998.44"
,CS,AR,32000886,1005,100,,Cash sale,,,,,,11/01/2018,11/01/2018,0.00,,21.86,,"-24,020.30"
,CS,AR,32000890,1005,100,,Cash sale,,,,,,11/01/2018,11/01/2018,0.00,,7.29,,"-24,027.59"
,CS,AR,32000891,1005,100,,Cash sale,,,,,,11/01/2018,11/01/2018,0.00,,18.22,,"-24,045.81"
,IN,AR,30304367,1005,100,,Invoice,,,,,,11/01/2018,11/01/2018,0.00,,5.93,,"-24,051.74"
,IN,AR,30304382,1005,100,,Invoice,,,,,,11/01/2018,11/01/2018,0.00,,3.64,,"-24,055.38"
,IN,AR,30304423,1005,100,,Invoice,,,,,,11/01/2018,11/01/2018,0.00,,13.56,,"-24,068.94"
,IN,AR,30304442,1005,100,,Invoice,,,,,,11/01/2018,11/01/2018,0.00,,3.64,,"-24,072.58"
,IN,AR,30304460,1005,100,,Invoice,,,,,,11/01/2018,11/01/2018,0.00,,3.64,,"-24,076.22"
,IN,AR,30304473,1005,100,,Invoice,,,,,,11/01/2018,11/01/2018,0.00,,4.07,,"-24,080.29"
,IN,AR,30304500,1005,100,,Invoice,,,,,,11/01/2018,11/01/2018,0.00,,21.86,,"-24,102.15"
,IN,AR,30304524,1005,100,,Invoice,,,,,,11/01/2018,11/01/2018,0.00,,30.85,,"-24,133.00"
,IN,AR,30304542,1005,100,,Invoice,,,,,,11/01/2018,11/01/2018,0.00,,3.64,,"-24,136.64"
,IN,AR,30304617,1005,100,,Invoice,,,,,,11/01/2018,11/01/2018,0.00,,3.64,,"-24,140.28"
,IN,AR,30304672,1005,100,,Invoice,,,,,,11/01/2018,11/01/2018,0.00,,20.00,,"-24,160.28"
,IN,AR,30304692,1005,100,,Invoice,,,,,,11/01/2018,11/01/2018,0.00,,35.69,,"-24,195.97"
,IN,AR,30304709,1005,100,,Invoice,,,,,,11/01/2018,11/01/2018,0.00,,17.03,,"-24,213.00"
,IN,AR,30304748,1005,100,,Invoice,,,,,,11/01/2018,11/01/2018,0.00,,40.00,,"-24,253.00"
,IN,AR,30304761,1005,100,,Invoice,,,,,,11/01/2018,11/01/2018,0.00,,21.86,,"-24,274.86"
,IN,AR,30304769,1005,100,,Invoice,,,,,,11/01/2018,11/01/2018,0.00,,11.19,,"-24,286.05"
,IN,AR,30304797,1005,100,,Invoice,,,,,,11/01/2018,11/01/2018,0.00,,3.01,,"-24,289.06"
,IN,AR,30304814,1005,100,,Invoice,,,,,,11/01/2018,11/01/2018,0.00,,18.22,,"-24,307.28"
,IN,AR,30304818,1005,100,,Invoice,,,,,,11/01/2018,11/01/2018,0.00,,10.93,,"-24,318.21"
,IN,AR,30304822,1005,100,,Invoice,,,,,,11/01/2018,11/01/2018,0.00,,21.00,,"-24,339.21"
,IN,AR,30304835,1005,100,,Invoice,,,,,,11/01/2018,11/01/2018,0.00,,14.58,,"-24,353.79"
,IN,AR,30304865,1005,100,,Invoice,,,,,,11/01/2018,11/01/2018,0.00,,10.93,,"-24,364.72"
,IN,AR,30304903,1005,100,,Invoice,,,,,,11/01/2018,11/01/2018,0.00,,29.15,,"-24,393.87"
,IN,AR,30304958,1005,100,,Invoice,,,,,,11/01/2018,11/01/2018,0.00,,7.29,,"-24,401.16"
,IN,AR,30304994,1005,100,,Invoice,,,,,,11/01/2018,11/01/2018,0.00,,19.12,,"-24,420.28"
,IN,AR,30304997,1005,100,,Invoice,,,,,,11/01/2018,11/01/2018,0.00,,12.03,,"-24,432.31"
,IN,AR,30305002,1005,100,,Invoice,,,,,,11/01/2018,11/01/2018,0.00,,7.17,,"-24,439.48"
,IN,AR,30305016,1005,100,,Invoice,,,,,,11/01/2018,11/01/2018,0.00,,18.64,,"-24,458.12"
,IN,AR,30305063,1005,100,,Invoice,,,,,,11/01/2018,11/01/2018,0.00,,14.34,,"-24,472.46"
,IN,AR,30305084,1005,100,,Invoice,,,,,,11/01/2018,11/01/2018,0.00,,3.22,,"-24,475.68"
,IN,AR,30305107,1005,100,,Invoice,,,,,,11/01/2018,11/01/2018,0.00,,10.34,,"-24,486.02"
,IN,AR,30305201,1005,100,,Invoice,,,,,,11/01/2018,11/01/2018,0.00,,7.75,,"-24,493.77"
,IN,AR,30305211,1005,100,,Invoice,,,,,,11/01/2018,11/01/2018,0.00,,2.39,,"-24,496.16"
,IN,AR,30305223,1005,100,,Invoice,,,,,,11/01/2018,11/01/2018,0.00,,10.17,,"-24,506.33"
,IN,AR,30305224,1005,100,,Invoice,,,,,,11/01/2018,11/01/2018,0.00,,7.63,,"-24,513.96"
,IN,AR,30305245,1005,100,,Invoice,,,,,,11/01/2018,11/01/2018,0.00,,36.64,,"-24,550.60"
,IN,AR,30305246,1005,100,,Invoice,,,,,,11/01/2018,11/01/2018,0.00,,47.80,,"-24,598.40"
,IN,AR,30305255,1005,100,,Invoice,,,,,,11/01/2018,11/01/2018,0.00,,18.39,,"-24,616.79"
,IN,AR,30305265,1005,100,,Invoice,,,,,,11/01/2018,11/01/2018,0.00,,2.58,,"-24,619.37"
,IN,AR,30305363,1005,100,,Invoice,,,,,,11/01/2018,11/01/2018,0.00,,43.15,,"-24,662.52"
,IN,AR,30305409,1005,100,,Invoice,,,,,,11/01/2018,11/01/2018,0.00,,12.71,,"-24,675.23"
,IN,AR,30305505,1005,100,,Invoice,,,,,,11/01/2018,11/01/2018,0.00,,5.51,,"-24,680.74"
,IN,AR,30305511,1005,100,,Invoice,,,,,,11/01/2018,11/01/2018,0.00,,21.97,,"-24,702.71"
,IN,AR,30305585,1005,100,,Invoice,,,,,,11/01/2018,11/01/2018,0.00,,14.58,,"-24,717.29"
,IN,AR,30305603,1005,100,,Invoice,,,,,,11/01/2018,11/01/2018,0.00,,12.92,,"-24,730.21"
,IN,AR,30305632,1005,100,,Invoice,,,,,,11/01/2018,11/01/2018,0.00,,12.71,,"-24,742.92"
,IN,AR,30305655,1005,100,,Invoice,,,,,,11/01/2018,11/01/2018,0.00,,6.97,,"-24,749.89"
,IN,AR,30305668,1005,100,,Invoice,,,,,,11/01/2018,11/01/2018,0.00,,5.85,,"-24,755.74"
,IN,AR,30305742,1005,100,,Invoice,,,,,,11/01/2018,11/01/2018,0.00,,5.49,,"-24,761.23"
,IN,AR,30305752,1005,100,,Invoice,,,,,,11/01/2018,11/01/2018,0.00,,11.64,,"-24,772.87"
,IN,AR,30305757,1005,100,,Invoice,,,,,,11/01/2018,11/01/2018,0.00,,7.63,,"-24,780.50"
,IN,AR,30305772,1005,100,,Invoice,,,,,,11/01/2018,11/01/2018,0.00,,10.00,,"-24,790.50"
,IN,AR,30305802,1005,100,,Invoice,,,,,,11/01/2018,11/01/2018,0.00,,5.29,,"-24,795.79"
,IN,AR,30305811,1005,100,,Invoice,,,,,,11/01/2018,11/01/2018,0.00,,15.04,,"-24,810.83"
,IN,AR,30305819,1005,100,,Invoice,,,,,,11/01/2018,11/01/2018,0.00,,18.22,,"-24,829.05"
,IN,AR,30305821,1005,100,,Invoice,,,,,,11/01/2018,11/01/2018,0.00,,10.93,,"-24,839.98"
,IN,AR,30305830,1005,100,,Invoice,,,,,,11/01/2018,11/01/2018,0.00,,4.54,,"-24,844.52"
,IN,AR,30305845,1005,100,,Invoice,,,,,,11/01/2018,11/01/2018,0.00,,29.15,,"-24,873.67"
,IN,AR,30305847,1005,100,,Invoice,,,,,,11/01/2018,11/01/2018,0.00,,12.92,,"-24,886.59"
,IN,AR,30305872,1005,100,,Invoice,,,,,,11/01/2018,11/01/2018,0.00,,21.86,,"-24,908.45"
,IN,AR,30305873,1005,100,,Invoice,,,,,,11/01/2018,11/01/2018,0.00,,76.53,,"-24,984.98"
,IN,AR,30305913,1005,100,,Invoice,,,,,,11/01/2018,11/01/2018,0.00,,14.07,,"-24,999.05"
,IN,AR,30305916,1005,100,,Invoice,,,,,,11/01/2018,11/01/2018,0.00,,7.29,,"-25,006.34"
,IN,AR,30305920,1005,100,,Invoice,,,,,,11/01/2018,11/01/2018,0.00,,7.63,,"-25,013.97"
,IN,AR,30305935,1005,100,,Invoice,,,,,,11/01/2018,11/01/2018,0.00,,14.64,,"-25,028.61"
,IN,AR,30305936,1005,100,,Invoice,,,,,,11/01/2018,11/01/2018,0.00,,9.76,,"-25,038.37"
,IN,AR,30305937,1005,100,,Invoice,,,,,,11/01/2018,11/01/2018,0.00,,3.25,,"-25,041.62"
,IN,AR,30305950,1005,100,,Invoice,,,,,,11/01/2018,11/01/2018,0.00,,7.95,,"-25,049.57"
,IN,AR,30305982,1005,100,,Invoice,,,,,,11/01/2018,11/01/2018,0.00,,26.19,,"-25,075.76"
,IN,AR,30305988,1005,100,,Invoice,,,,,,11/01/2018,11/01/2018,0.00,,60.57,,"-25,136.33"
,IN,AR,30306020,1005,100,,Invoice,,,,,,11/01/2018,11/01/2018,0.00,,18.22,,"-25,154.55"
,IN,AR,30306053,1005,100,,Invoice,,,,,,11/01/2018,11/01/2018,0.00,,4.81,,"-25,159.36"
,IN,AR,30306054,1005,100,,Invoice,,,,,,11/01/2018,11/01/2018,0.00,,14.43,,"-25,173.79"
,IN,AR,30306055,1005,100,,Invoice,,,,,,11/01/2018,11/01/2018,0.00,,11.22,,"-25,185.01"
,IN,AR,30306056,1005,100,,Invoice,,,,,,11/01/2018,11/01/2018,0.00,,9.62,,"-25,194.63"
,IN,AR,30306155,1005,100,,Invoice,,,,,,11/01/2018,11/01/2018,0.00,,2.54,,"-25,197.17"
,IN,AR,30306164,1005,100,,Invoice,,,,,,11/01/2018,11/01/2018,0.00,,18.01,,"-25,215.18"
,IN,AR,30306177,1005,100,,Invoice,,,,,,11/01/2018,11/01/2018,0.00,,20.01,,"-25,235.19"
,IN,AR,30306188,1005,100,,Invoice,,,,,,11/01/2018,11/01/2018,0.00,,14.58,,"-25,249.77"
,IN,AR,30306245,1005,100,,Invoice,,,,,,11/01/2018,11/01/2018,0.00,,17.49,,"-25,267.26"
,IN,AR,30306275,1005,100,,Invoice,,,,,,11/01/2018,11/01/2018,0.00,,14.03,,"-25,281.29"
,IN,AR,30306288,1005,100,,Invoice,,,,,,11/01/2018,11/01/2018,0.00,,16.02,,"-25,297.31"
,IN,AR,30306290,1005,100,,Invoice,,,,,,11/01/2018,11/01/2018,0.00,,14.58,,"-25,311.89"
,IN,AR,30306346,1005,100,,Invoice,,,,,,11/01/2018,11/01/2018,0.00,,10.93,,"-25,322.82"
,IN,AR,30306378,1005,100,,Invoice,,,,,,11/01/2018,11/01/2018,0.00,,9.56,,"-25,332.38"
,IN,AR,30306379,1005,100,,Invoice,,,,,,11/01/2018,11/01/2018,0.00,,9.56,,"-25,341.94"
,IN,AR,30306380,1005,100,,Invoice,,,,,,11/01/2018,11/01/2018,0.00,,6.37,,"-25,348.31"
,IN,AR,30306381,1005,100,,Invoice,,,,,,11/01/2018,11/01/2018,0.00,,175.25,,"-25,523.56"
,IN,AR,30306382,1005,100,,Invoice,,,,,,11/01/2018,11/01/2018,0.00,,7.97,,"-25,531.53"
,IN,AR,30306428,1005,100,,Invoice,,,,,,11/01/2018,11/01/2018,0.00,,18.31,,"-25,549.84"
,IN,AR,30306474,1005,100,,Invoice,,,,,,11/01/2018,11/01/2018,0.00,,11.36,,"-25,561.20"
,IN,AR,30306509,1005,100,,Invoice,,,,,,11/01/2018,11/01/2018,0.00,,54.66,,"-25,615.86"
,IN,AR,30306610,1005,100,,Invoice,,,,,,11/01/2018,11/01/2018,0.00,,8.17,,"-25,624.03"
,IN,AR,30306642,1005,100,,Invoice,,,,,,11/01/2018,11/01/2018,0.00,,3.64,,"-25,627.67"
,CN,AR,31016993,1005,100,,Credit Note,,,,,,12/01/2018,12/01/2018,22.57,,0.00,,"-25,605.10"
,CN,AR,31016994,1005,100,,Credit Note,,,,,,12/01/2018,12/01/2018,60.19,,0.00,,"-25,544.91"
,CN,AR,31016995,1005,100,,Credit Note,,,,,,12/01/2018,12/01/2018,33.86,,0.00,,"-25,511.05"
,CN,AR,31016996,1005,100,,Credit Note,,,,,,12/01/2018,12/01/2018,40.35,,0.00,,"-25,470.70"
,CN,AR,31016997,1005,100,,Credit Note,,,,,,12/01/2018,12/01/2018,35.08,,0.00,,"-25,435.62"
,CN,AR,31016998,1005,100,,Credit Note,,,,,,12/01/2018,12/01/2018,0.07,,0.00,,"-25,435.55"
,CN,AR,31017082,1005,100,,Credit Note,,,,,,12/01/2018,12/01/2018,3.64,,0.00,,"-25,431.91"
,CS,AR,32000009,1005,100,,Cash sale,,,,,,12/01/2018,12/01/2018,0.00,,2.81,,"-25,434.72"
,CS,AR,32000027,1005,100,,Cash sale,,,,,,12/01/2018,12/01/2018,0.00,,9.49,,"-25,444.21"
,CS,AR,32000039,1005,100,,Cash sale,,,,,,12/01/2018,12/01/2018,0.00,,3.64,,"-25,447.85"
,CS,AR,32000049,1005,100,,Cash sale,,,,,,12/01/2018,12/01/2018,0.00,,3.64,,"-25,451.49"
,CS,AR,32000067,1005,100,,Cash sale,,,,,,12/01/2018,12/01/2018,0.00,,14.58,,"-25,466.07"
,CS,AR,32000080,1005,100,,Cash sale,,,,,,12/01/2018,12/01/2018,0.00,,7.29,,"-25,473.36"
,CS,AR,32000087,1005,100,,Cash sale,,,,,,12/01/2018,12/01/2018,0.00,,3.64,,"-25,477.00"
,CS,AR,32000097,1005,100,,Cash sale,,,,,,12/01/2018,12/01/2018,0.00,,3.64,,"-25,480.64"
,CS,AR,32000099,1005,100,,Cash sale,,,,,,12/01/2018,12/01/2018,0.00,,9.66,,"-25,490.30"
,CS,AR,32000113,1005,100,,Cash sale,,,,,,12/01/2018,12/01/2018,0.00,,18.98,,"-25,509.28"
,CS,AR,32000131,1005,100,,Cash sale,,,,,,12/01/2018,12/01/2018,0.00,,16.61,,"-25,525.89"
,CS,AR,32000141,1005,100,,Cash sale,,,,,,12/01/2018,12/01/2018,0.00,,7.29,,"-25,533.18"
,CS,AR,32000166,1005,100,,Cash sale,,,,,,12/01/2018,12/01/2018,0.00,,3.64,,"-25,536.82"
,CS,AR,32000172,1005,100,,Cash sale,,,,,,12/01/2018,12/01/2018,0.00,,14.58,,"-25,551.40"
,CS,AR,32000179,1005,100,,Cash sale,,,,,,12/01/2018,12/01/2018,0.00,,18.22,,"-25,569.62"
,CS,AR,32000188,1005,100,,Cash sale,,,,,,12/01/2018,12/01/2018,0.00,,7.29,,"-25,576.91"
,CS,AR,32000231,1005,100,,Cash sale,,,,,,12/01/2018,12/01/2018,0.00,,7.29,,"-25,584.20"
,CS,AR,32000252,1005,100,,Cash sale,,,,,,12/01/2018,12/01/2018,0.00,,5.17,,"-25,589.37"
,CS,AR,32000265,1005,100,,Cash sale,,,,,,12/01/2018,12/01/2018,0.00,,7.63,,"-25,597.00"
,CS,AR,32000281,1005,100,,Cash sale,,,,,,12/01/2018,12/01/2018,0.00,,8.52,,"-25,605.52"
,CS,AR,32000295,1005,100,,Cash sale,,,,,,12/01/2018,12/01/2018,0.00,,13.74,,"-25,619.26"
,CS,AR,32000314,1005,100,,Cash sale,,,,,,12/01/2018,12/01/2018,0.00,,5.49,,"-25,624.75"
,CS,AR,32000343,1005,100,,Cash sale,,,,,,12/01/2018,12/01/2018,0.00,,14.58,,"-25,639.33"
,CS,AR,32000368,1005,100,,Cash sale,,,,,,12/01/2018,12/01/2018,0.00,,10.17,,"-25,649.50"
,CS,AR,32000376,1005,100,,Cash sale,,,,,,12/01/2018,12/01/2018,0.00,,15.51,,"-25,665.01"
,CS,AR,32000384,1005,100,,Cash sale,,,,,,12/01/2018,12/01/2018,0.00,,29.24,,"-25,694.25"
,CS,AR,32000405,1005,100,,Cash sale,,,,,,12/01/2018,12/01/2018,0.00,,24.07,,"-25,718.32"
,CS,AR,32000451,1005,100,,Cash sale,,,,,,12/01/2018,12/01/2018,0.00,,21.86,,"-25,740.18"
,CS,AR,32000488,1005,100,,Cash sale,,,,,,12/01/2018,12/01/2018,0.00,,10.93,,"-25,751.11"
,CS,AR,32000490,1005,100,,Cash sale,,,,,,12/01/2018,12/01/2018,0.00,,9.66,,"-25,760.77"
,CS,AR,32000502,1005,100,,Cash sale,,,,,,12/01/2018,12/01/2018,0.00,,7.75,,"-25,768.52"
,CS,AR,32000515,1005,100,,Cash sale,,,,,,12/01/2018,12/01/2018,0.00,,10.93,,"-25,779.45"
,CS,AR,32000524,1005,100,,Cash sale,,,,,,12/01/2018,12/01/2018,0.00,,6.02,,"-25,785.47"
,CS,AR,32000555,1005,100,,Cash sale,,,,,,12/01/2018,12/01/2018,0.00,,3.64,,"-25,789.11"
,CS,AR,32000556,1005,100,,Cash sale,,,,,,12/01/2018,12/01/2018,0.00,,7.29,,"-25,796.40"
,CS,AR,32000620,1005,100,,Cash sale,,,,,,12/01/2018,12/01/2018,0.00,,12.71,,"-25,809.11"
,CS,AR,32000634,1005,100,,Cash sale,,,,,,12/01/2018,12/01/2018,0.00,,10.93,,"-25,820.04"
,CS,AR,32000672,1005,100,,Cash sale,,,,,,12/01/2018,12/01/2018,0.00,,28.00,,"-25,848.04"
,CS,AR,32000677,1005,100,,Cash sale,,,,,,12/01/2018,12/01/2018,0.00,,3.64,,"-25,851.68"
,CS,AR,32000682,1005,100,,Cash sale,,,,,,12/01/2018,12/01/2018,0.00,,10.17,,"-25,861.85"
,CS,AR,32000713,1005,100,,Cash sale,,,,,,12/01/2018,12/01/2018,0.00,,9.15,,"-25,871.00"
,CS,AR,32000725,1005,100,,Cash sale,,,,,,12/01/2018,12/01/2018,0.00,,10.93,,"-25,881.93"
,CS,AR,32000754,1005,100,,Cash sale,,,,,,12/01/2018,12/01/2018,0.00,,14.58,,"-25,896.51"
,CS,AR,32000757,1005,100,,Cash sale,,,,,,12/01/2018,12/01/2018,0.00,,45.53,,"-25,942.04"
,CS,AR,32000786,1005,100,,Cash sale,,,,,,12/01/2018,12/01/2018,0.00,,10.93,,"-25,952.97"
,CS,AR,32000800,1005,100,,Cash sale,,,,,,12/01/2018,12/01/2018,0.00,,14.58,,"-25,967.55"
,CS,AR,32000805,1005,100,,Cash sale,,,,,,12/01/2018,12/01/2018,0.00,,3.05,,"-25,970.60"
,CS,AR,32000813,1005,100,,Cash sale,,,,,,12/01/2018,12/01/2018,0.00,,4.15,,"-25,974.75"
,CS,AR,32000822,1005,100,,Cash sale,,,,,,12/01/2018,12/01/2018,0.00,,18.22,,"-25,992.97"
,CS,AR,32000850,1005,100,,Cash sale,,,,,,12/01/2018,12/01/2018,0.00,,5.93,,"-25,998.90"
,CS,AR,32000852,1005,100,,Cash sale,,,,,,12/01/2018,12/01/2018,0.00,,10.93,,"-26,009.83"
,CS,AR,32000856,1005,100,,Cash sale,,,,,,12/01/2018,12/01/2018,0.00,,7.29,,"-26,017.12"
,CS,AR,32000874,1005,100,,Cash sale,,,,,,12/01/2018,12/01/2018,0.00,,7.29,,"-26,024.41"
,CS,AR,32000876,1005,100,,Cash sale,,,,,,12/01/2018,12/01/2018,0.00,,10.93,,"-26,035.34"
,CS,AR,32000887,1005,100,,Cash sale,,,,,,12/01/2018,12/01/2018,0.00,,10.93,,"-26,046.27"
,IN,AR,30304368,1005,100,,Invoice,,,,,,12/01/2018,12/01/2018,0.00,,14.83,,"-26,061.10"
,IN,AR,30304378,1005,100,,Invoice,,,,,,12/01/2018,12/01/2018,0.00,,18.22,,"-26,079.32"
,IN,AR,30304454,1005,100,,Invoice,,,,,,12/01/2018,12/01/2018,0.00,,26.57,,"-26,105.89"
,IN,AR,30304491,1005,100,,Invoice,,,,,,12/01/2018,12/01/2018,0.00,,3.64,,"-26,109.53"
,IN,AR,30304503,1005,100,,Invoice,,,,,,12/01/2018,12/01/2018,0.00,,4.59,,"-26,114.12"
,IN,AR,30304509,1005,100,,Invoice,,,,,,12/01/2018,12/01/2018,0.00,,75.69,,"-26,189.81"
,IN,AR,30304525,1005,100,,Invoice,,,,,,12/01/2018,12/01/2018,0.00,,28.47,,"-26,218.28"
,IN,AR,30304553,1005,100,,Invoice,,,,,,12/01/2018,12/01/2018,0.00,,32.00,,"-26,250.28"
,IN,AR,30304592,1005,100,,Invoice,,,,,,12/01/2018,12/01/2018,0.00,,25.51,,"-26,275.79"
,IN,AR,30304607,1005,100,,Invoice,,,,,,12/01/2018,12/01/2018,0.00,,18.00,,"-26,293.79"
,IN,AR,30304663,1005,100,,Invoice,,,,,,12/01/2018,12/01/2018,0.00,,4.75,,"-26,298.54"
,IN,AR,30304734,1005,100,,Invoice,,,,,,12/01/2018,12/01/2018,0.00,,9.70,,"-26,308.24"
,IN,AR,30304764,1005,100,,Invoice,,,,,,12/01/2018,12/01/2018,0.00,,10.93,,"-26,319.17"
,IN,AR,30304827,1005,100,,Invoice,,,,,,12/01/2018,12/01/2018,0.00,,5.17,,"-26,324.34"
,IN,AR,30304932,1005,100,,Invoice,,,,,,12/01/2018,12/01/2018,0.00,,5.59,,"-26,329.93"
,IN,AR,30304946,1005,100,,Invoice,,,,,,12/01/2018,12/01/2018,0.00,,10.34,,"-26,340.27"
,IN,AR,30304954,1005,100,,Invoice,,,,,,12/01/2018,12/01/2018,0.00,,2.39,,"-26,342.66"
,IN,AR,30304963,1005,100,,Invoice,,,,,,12/01/2018,12/01/2018,0.00,,179.73,,"-26,522.39"
,IN,AR,30305011,1005,100,,Invoice,,,,,,12/01/2018,12/01/2018,0.00,,63.77,,"-26,586.16"
,IN,AR,30305022,1005,100,,Invoice,,,,,,12/01/2018,12/01/2018,0.00,,73.83,,"-26,659.99"
,IN,AR,30305090,1005,100,,Invoice,,,,,,12/01/2018,12/01/2018,0.00,,6.02,,"-26,666.01"
,IN,AR,30305187,1005,100,,Invoice,,,,,,12/01/2018,12/01/2018,0.00,,0.03,,"-26,666.04"
,IN,AR,30305188,1005,100,,Invoice,,,,,,12/01/2018,12/01/2018,0.00,,21.05,,"-26,687.09"
,IN,AR,30305189,1005,100,,Invoice,,,,,,12/01/2018,12/01/2018,0.00,,56.13,,"-26,743.22"
,IN,AR,30305190,1005,100,,Invoice,,,,,,12/01/2018,12/01/2018,0.00,,31.57,,"-26,774.79"
,IN,AR,30305191,1005,100,,Invoice,,,,,,12/01/2018,12/01/2018,0.00,,40.34,,"-26,815.13"
,IN,AR,30305192,1005,100,,Invoice,,,,,,12/01/2018,12/01/2018,0.00,,35.08,,"-26,850.21"
,IN,AR,30305193,1005,100,,Invoice,,,,,,12/01/2018,12/01/2018,0.00,,56.13,,"-26,906.34"
,IN,AR,30305225,1005,100,,Invoice,,,,,,12/01/2018,12/01/2018,0.00,,2.54,,"-26,908.88"
,IN,AR,30305237,1005,100,,Invoice,,,,,,12/01/2018,12/01/2018,0.00,,7.29,,"-26,916.17"
,IN,AR,30305238,1005,100,,Invoice,,,,,,12/01/2018,12/01/2018,0.00,,10.17,,"-26,926.34"
,IN,AR,30305261,1005,100,,Invoice,,,,,,12/01/2018,12/01/2018,0.00,,50.87,,"-26,977.21"
,IN,AR,30305321,1005,100,,Invoice,,,,,,12/01/2018,12/01/2018,0.00,,12.71,,"-26,989.92"
,IN,AR,30305328,1005,100,,Invoice,,,,,,12/01/2018,12/01/2018,0.00,,12.92,,"-27,002.84"
,IN,AR,30305380,1005,100,,Invoice,,,,,,12/01/2018,12/01/2018,0.00,,14.63,,"-27,017.47"
,IN,AR,30305488,1005,100,,Invoice,,,,,,12/01/2018,12/01/2018,0.00,,4.29,,"-27,021.76"
,IN,AR,30305521,1005,100,,Invoice,,,,,,12/01/2018,12/01/2018,0.00,,33.66,,"-27,055.42"
,IN,AR,30305579,1005,100,,Invoice,,,,,,12/01/2018,12/01/2018,0.00,,3.64,,"-27,059.06"
,IN,AR,30305661,1005,100,,Invoice,,,,,,12/01/2018,12/01/2018,0.00,,76.65,,"-27,135.71"
,IN,AR,30305671,1005,100,,Invoice,,,,,,12/01/2018,12/01/2018,0.00,,7.29,,"-27,143.00"
,IN,AR,30305711,1005,100,,Invoice,,,,,,12/01/2018,12/01/2018,0.00,,7.29,,"-27,150.29"
,IN,AR,30305760,1005,100,,Invoice,,,,,,12/01/2018,12/01/2018,0.00,,6.53,,"-27,156.82"
,IN,AR,30305789,1005,100,,Invoice,,,,,,12/01/2018,12/01/2018,0.00,,182.20,,"-27,339.02"
,IN,AR,30305815,1005,100,,Invoice,,,,,,12/01/2018,12/01/2018,0.00,,29.15,,"-27,368.17"
,IN,AR,30305823,1005,100,,Invoice,,,,,,12/01/2018,12/01/2018,0.00,,2.42,,"-27,370.59"
,IN,AR,30305828,1005,100,,Invoice,,,,,,12/01/2018,12/01/2018,0.00,,8.01,,"-27,378.60"
,IN,AR,30305838,1005,100,,Invoice,,,,,,12/01/2018,12/01/2018,0.00,,74.15,,"-27,452.75"
,IN,AR,30305895,1005,100,,Invoice,,,,,,12/01/2018,12/01/2018,0.00,,20.47,,"-27,473.22"
,IN,AR,30305951,1005,100,,Invoice,,,,,,12/01/2018,12/01/2018,0.00,,7.95,,"-27,481.17"
,IN,AR,30305967,1005,100,,Invoice,,,,,,12/01/2018,12/01/2018,0.00,,22.71,,"-27,503.88"
,IN,AR,30305995,1005,100,,Invoice,,,,,,12/01/2018,12/01/2018,0.00,,42.09,,"-27,545.97"
,IN,AR,30306011,1005,100,,Invoice,,,,,,12/01/2018,12/01/2018,0.00,,8.21,,"-27,554.18"
,IN,AR,30306057,1005,100,,Invoice,,,,,,12/01/2018,12/01/2018,0.00,,60.93,,"-27,615.11"
,IN,AR,30306132,1005,100,,Invoice,,,,,,12/01/2018,12/01/2018,0.00,,26.30,,"-27,641.41"
,IN,AR,30306145,1005,100,,Invoice,,,,,,12/01/2018,12/01/2018,0.00,,18.22,,"-27,659.63"
,IN,AR,30306156,1005,100,,Invoice,,,,,,12/01/2018,12/01/2018,0.00,,30.51,,"-27,690.14"
,IN,AR,30306181,1005,100,,Invoice,,,,,,12/01/2018,12/01/2018,0.00,,4.00,,"-27,694.14"
,IN,AR,30306224,1005,100,,Invoice,,,,,,12/01/2018,12/01/2018,0.00,,13.69,,"-27,707.83"
,IN,AR,30306284,1005,100,,Invoice,,,,,,12/01/2018,12/01/2018,0.00,,16.08,,"-27,723.91"
,IN,AR,30306352,1005,100,,Invoice,,,,,,12/01/2018,12/01/2018,0.00,,19.87,,"-27,743.78"
,IN,AR,30306355,1005,100,,Invoice,,,,,,12/01/2018,12/01/2018,0.00,,9.66,,"-27,753.44"
,IN,AR,30306437,1005,100,,Invoice,,,,,,12/01/2018,12/01/2018,0.00,,8.00,,"-27,761.44"
,IN,AR,30306514,1005,100,,Invoice,,,,,,12/01/2018,12/01/2018,0.00,,2.74,,"-27,764.18"
,IN,AR,30306518,1005,100,,Invoice,,,,,,12/01/2018,12/01/2018,0.00,,54.66,,"-27,818.84"
,IN,AR,30306525,1005,100,,Invoice,,,,,,12/01/2018,12/01/2018,0.00,,29.66,,"-27,848.50"
,IN,AR,30306604,1005,100,,Invoice,,,,,,12/01/2018,12/01/2018,0.00,,8.17,,"-27,856.67"
,IN,AR,30306646,1005,100,,Invoice,,,,,,12/01/2018,12/01/2018,0.00,,54.66,,"-27,911.33"
,CS,AR,32000153,1005,100,,Cash sale,,,,,,13/01/2018,13/01/2018,0.00,,25.51,,"-27,936.84"
,CS,AR,32000229,1005,100,,Cash sale,,,,,,13/01/2018,13/01/2018,0.00,,6.02,,"-27,942.86"
,CS,AR,32000423,1005,100,,Cash sale,,,,,,13/01/2018,13/01/2018,0.00,,7.29,,"-27,950.15"
,CS,AR,32000520,1005,100,,Cash sale,,,,,,13/01/2018,13/01/2018,0.00,,21.86,,"-27,972.01"
,CS,AR,32000548,1005,100,,Cash sale,,,,,,13/01/2018,13/01/2018,0.00,,7.29,,"-27,979.30"
,CS,AR,32000613,1005,100,,Cash sale,,,,,,13/01/2018,13/01/2018,0.00,,14.58,,"-27,993.88"
,CS,AR,32000832,1005,100,,Cash sale,,,,,,13/01/2018,13/01/2018,0.00,,3.64,,"-27,997.52"
,CS,AR,32000838,1005,100,,Cash sale,,,,,,13/01/2018,13/01/2018,0.00,,18.22,,"-28,015.74"
,IN,AR,30304595,1005,100,,Invoice,,,,,,13/01/2018,13/01/2018,0.00,,10.93,,"-28,026.67"
,IN,AR,30305050,1005,100,,Invoice,,,,,,13/01/2018,13/01/2018,0.00,,5.17,,"-28,031.84"
,IN,AR,30306237,1005,100,,Invoice,,,,,,13/01/2018,13/01/2018,0.00,,14.58,,"-28,046.42"
,CS,AR,32000028,1005,100,,Cash sale,,,,,,15/01/2018,15/01/2018,0.00,,4.75,,"-28,051.17"
,CS,AR,32000114,1005,100,,Cash sale,,,,,,15/01/2018,15/01/2018,0.00,,7.12,,"-28,058.29"
,CS,AR,32000132,1005,100,,Cash sale,,,,,,15/01/2018,15/01/2018,0.00,,10.38,,"-28,068.67"
,CS,AR,32000194,1005,100,,Cash sale,,,,,,15/01/2018,15/01/2018,0.00,,21.86,,"-28,090.53"
,CS,AR,32000199,1005,100,,Cash sale,,,,,,15/01/2018,15/01/2018,0.00,,3.64,,"-28,094.17"
,CS,AR,32000208,1005,100,,Cash sale,,,,,,15/01/2018,15/01/2018,0.00,,3.64,,"-28,097.81"
,CS,AR,32000234,1005,100,,Cash sale,,,,,,15/01/2018,15/01/2018,0.00,,2.39,,"-28,100.20"
,CS,AR,32000251,1005,100,,Cash sale,,,,,,15/01/2018,15/01/2018,0.00,,10.34,,"-28,110.54"
,CS,AR,32000266,1005,100,,Cash sale,,,,,,15/01/2018,15/01/2018,0.00,,7.63,,"-28,118.17"
,CS,AR,32000315,1005,100,,Cash sale,,,,,,15/01/2018,15/01/2018,0.00,,10.99,,"-28,129.16"
,CS,AR,32000329,1005,100,,Cash sale,,,,,,15/01/2018,15/01/2018,0.00,,10.93,,"-28,140.09"
,CS,AR,32000332,1005,100,,Cash sale,,,,,,15/01/2018,15/01/2018,0.00,,7.29,,"-28,147.38"
,CS,AR,32000336,1005,100,,Cash sale,,,,,,15/01/2018,15/01/2018,0.00,,9.03,,"-28,156.41"
,CS,AR,32000351,1005,100,,Cash sale,,,,,,15/01/2018,15/01/2018,0.00,,7.29,,"-28,163.70"
,CS,AR,32000356,1005,100,,Cash sale,,,,,,15/01/2018,15/01/2018,0.00,,10.93,,"-28,174.63"
,CS,AR,32000369,1005,100,,Cash sale,,,,,,15/01/2018,15/01/2018,0.00,,7.63,,"-28,182.26"
,CS,AR,32000385,1005,100,,Cash sale,,,,,,15/01/2018,15/01/2018,0.00,,17.54,,"-28,199.80"
,CS,AR,32000393,1005,100,,Cash sale,,,,,,15/01/2018,15/01/2018,0.00,,7.29,,"-28,207.09"
,CS,AR,32000406,1005,100,,Cash sale,,,,,,15/01/2018,15/01/2018,0.00,,30.08,,"-28,237.17"
,CS,AR,32000470,1005,100,,Cash sale,,,,,,15/01/2018,15/01/2018,0.00,,5.08,,"-28,242.25"
,CS,AR,32000473,1005,100,,Cash sale,,,,,,15/01/2018,15/01/2018,0.00,,7.29,,"-28,249.54"
,CS,AR,32000486,1005,100,,Cash sale,,,,,,15/01/2018,15/01/2018,0.00,,7.63,,"-28,257.17"
,CS,AR,32000538,1005,100,,Cash sale,,,,,,15/01/2018,15/01/2018,0.00,,14.58,,"-28,271.75"
,CS,AR,32000552,1005,100,,Cash sale,,,,,,15/01/2018,15/01/2018,0.00,,9.03,,"-28,280.78"
,CS,AR,32000592,1005,100,,Cash sale,,,,,,15/01/2018,15/01/2018,0.00,,13.14,,"-28,293.92"
,CS,AR,32000595,1005,100,,Cash sale,,,,,,15/01/2018,15/01/2018,0.00,,7.29,,"-28,301.21"
,CS,AR,32000604,1005,100,,Cash sale,,,,,,15/01/2018,15/01/2018,0.00,,3.64,,"-28,304.85"
,CS,AR,32000630,1005,100,,Cash sale,,,,,,15/01/2018,15/01/2018,0.00,,25.51,,"-28,330.36"
,CS,AR,32000633,1005,100,,Cash sale,,,,,,15/01/2018,15/01/2018,0.00,,14.58,,"-28,344.94"
,CS,AR,32000637,1005,100,,Cash sale,,,,,,15/01/2018,15/01/2018,0.00,,9.79,,"-28,354.73"
,CS,AR,32000714,1005,100,,Cash sale,,,,,,15/01/2018,15/01/2018,0.00,,11.44,,"-28,366.17"
,CS,AR,32000778,1005,100,,Cash sale,,,,,,15/01/2018,15/01/2018,0.00,,12.71,,"-28,378.88"
,CS,AR,32000787,1005,100,,Cash sale,,,,,,15/01/2018,15/01/2018,0.00,,10.93,,"-28,389.81"
,CS,AR,32000843,1005,100,,Cash sale,,,,,,15/01/2018,15/01/2018,0.00,,10.93,,"-28,400.74"
,CS,AR,32000893,1005,100,,Cash sale,,,,,,15/01/2018,15/01/2018,0.00,,7.29,,"-28,408.03"
,CS,AR,32000905,1005,100,,Cash sale,,,,,,15/01/2018,15/01/2018,0.00,,6.56,,"-28,414.59"
,CS,AR,32000907,1005,100,,Cash sale,,,,,,15/01/2018,15/01/2018,0.00,,7.29,,"-28,421.88"
,IN,AR,30304369,1005,100,,Invoice,,,,,,15/01/2018,15/01/2018,0.00,,41.53,,"-28,463.41"
,IN,AR,30304389,1005,100,,Invoice,,,,,,15/01/2018,15/01/2018,0.00,,21.86,,"-28,485.27"
,IN,AR,30304450,1005,100,,Invoice,,,,,,15/01/2018,15/01/2018,0.00,,7.29,,"-28,492.56"
,IN,AR,30304479,1005,100,,Invoice,,,,,,15/01/2018,15/01/2018,0.00,,31.70,,"-28,524.26"
,IN,AR,30304514,1005,100,,Invoice,,,,,,15/01/2018,15/01/2018,0.00,,3.64,,"-28,527.90"
,IN,AR,30304526,1005,100,,Invoice,,,,,,15/01/2018,15/01/2018,0.00,,113.90,,"-28,641.80"
,IN,AR,30304539,1005,100,,Invoice,,,,,,15/01/2018,15/01/2018,0.00,,2.75,,"-28,644.55"
,IN,AR,30304544,1005,100,,Invoice,,,,,,15/01/2018,15/01/2018,0.00,,3.64,,"-28,648.19"
,IN,AR,30304554,1005,100,,Invoice,,,,,,15/01/2018,15/01/2018,0.00,,50.00,,"-28,698.19"
,IN,AR,30304577,1005,100,,Invoice,,,,,,15/01/2018,15/01/2018,0.00,,54.66,,"-28,752.85"
,IN,AR,30304581,1005,100,,Invoice,,,,,,15/01/2018,15/01/2018,0.00,,50.90,,"-28,803.75"
,IN,AR,30304608,1005,100,,Invoice,,,,,,15/01/2018,15/01/2018,0.00,,28.00,,"-28,831.75"
,IN,AR,30304631,1005,100,,Invoice,,,,,,15/01/2018,15/01/2018,0.00,,11.02,,"-28,842.77"
,IN,AR,30304640,1005,100,,Invoice,,,,,,15/01/2018,15/01/2018,0.00,,3.64,,"-28,846.41"
,IN,AR,30304647,1005,100,,Invoice,,,,,,15/01/2018,15/01/2018,0.00,,5.84,,"-28,852.25"
,IN,AR,30304659,1005,100,,Invoice,,,,,,15/01/2018,15/01/2018,0.00,,8.77,,"-28,861.02"
,IN,AR,30304673,1005,100,,Invoice,,,,,,15/01/2018,15/01/2018,0.00,,4.00,,"-28,865.02"
,IN,AR,30304681,1005,100,,Invoice,,,,,,15/01/2018,15/01/2018,0.00,,3.64,,"-28,868.66"
,IN,AR,30304685,1005,100,,Invoice,,,,,,15/01/2018,15/01/2018,0.00,,18.22,,"-28,886.88"
,IN,AR,30304699,1005,100,,Invoice,,,,,,15/01/2018,15/01/2018,0.00,,338.90,,"-29,225.78"
,IN,AR,30304773,1005,100,,Invoice,,,,,,15/01/2018,15/01/2018,0.00,,11.27,,"-29,237.05"
,IN,AR,30304790,1005,100,,Invoice,,,,,,15/01/2018,15/01/2018,0.00,,28.39,,"-29,265.44"
,IN,AR,30304810,1005,100,,Invoice,,,,,,15/01/2018,15/01/2018,0.00,,3.19,,"-29,268.63"
,IN,AR,30304817,1005,100,,Invoice,,,,,,15/01/2018,15/01/2018,0.00,,10.34,,"-29,278.97"
,IN,AR,30304832,1005,100,,Invoice,,,,,,15/01/2018,15/01/2018,0.00,,10.34,,"-29,289.31"
,IN,AR,30304846,1005,100,,Invoice,,,,,,15/01/2018,15/01/2018,0.00,,7.29,,"-29,296.60"
,IN,AR,30304858,1005,100,,Invoice,,,,,,15/01/2018,15/01/2018,0.00,,9.19,,"-29,305.79"
,IN,AR,30304869,1005,100,,Invoice,,,,,,15/01/2018,15/01/2018,0.00,,10.51,,"-29,316.30"
,IN,AR,30304947,1005,100,,Invoice,,,,,,15/01/2018,15/01/2018,0.00,,12.92,,"-29,329.22"
,IN,AR,30304959,1005,100,,Invoice,,,,,,15/01/2018,15/01/2018,0.00,,91.10,,"-29,420.32"
,IN,AR,30304974,1005,100,,Invoice,,,,,,15/01/2018,15/01/2018,0.00,,10.38,,"-29,430.70"
,IN,AR,30304978,1005,100,,Invoice,,,,,,15/01/2018,15/01/2018,0.00,,7.76,,"-29,438.46"
,IN,AR,30305023,1005,100,,Invoice,,,,,,15/01/2018,15/01/2018,0.00,,73.83,,"-29,512.29"
,IN,AR,30305037,1005,100,,Invoice,,,,,,15/01/2018,15/01/2018,0.00,,40.68,,"-29,552.97"
,IN,AR,30305064,1005,100,,Invoice,,,,,,15/01/2018,15/01/2018,0.00,,26.29,,"-29,579.26"
,IN,AR,30305065,1005,100,,Invoice,,,,,,15/01/2018,15/01/2018,0.00,,9.56,,"-29,588.82"
,IN,AR,30305077,1005,100,,Invoice,,,,,,15/01/2018,15/01/2018,0.00,,22.54,,"-29,611.36"
,IN,AR,30305091,1005,100,,Invoice,,,,,,15/01/2018,15/01/2018,0.00,,12.03,,"-29,623.39"
,IN,AR,30305114,1005,100,,Invoice,,,,,,15/01/2018,15/01/2018,0.00,,182.20,,"-29,805.59"
,IN,AR,30305131,1005,100,,Invoice,,,,,,15/01/2018,15/01/2018,0.00,,5.17,,"-29,810.76"
,IN,AR,30305226,1005,100,,Invoice,,,,,,15/01/2018,15/01/2018,0.00,,17.80,,"-29,828.56"
,IN,AR,30305349,1005,100,,Invoice,,,,,,15/01/2018,15/01/2018,0.00,,7.29,,"-29,835.85"
,IN,AR,30305350,1005,100,,Invoice,,,,,,15/01/2018,15/01/2018,0.00,,4.78,,"-29,840.63"
,IN,AR,30305353,1005,100,,Invoice,,,,,,15/01/2018,15/01/2018,0.00,,7.29,,"-29,847.92"
,IN,AR,30305375,1005,100,,Invoice,,,,,,15/01/2018,15/01/2018,0.00,,22.88,,"-29,870.80"
,IN,AR,30305383,1005,100,,Invoice,,,,,,15/01/2018,15/01/2018,0.00,,30.00,,"-29,900.80"
,IN,AR,30305389,1005,100,,Invoice,,,,,,15/01/2018,15/01/2018,0.00,,10.17,,"-29,910.97"
,IN,AR,30305434,1005,100,,Invoice,,,,,,15/01/2018,15/01/2018,0.00,,14.58,,"-29,925.55"
,IN,AR,30305474,1005,100,,Invoice,,,,,,15/01/2018,15/01/2018,0.00,,1.59,,"-29,927.14"
,IN,AR,30305479,1005,100,,Invoice,,,,,,15/01/2018,15/01/2018,0.00,,11.02,,"-29,938.16"
,IN,AR,30305480,1005,100,,Invoice,,,,,,15/01/2018,15/01/2018,0.00,,8.26,,"-29,946.42"
,IN,AR,30305493,1005,100,,Invoice,,,,,,15/01/2018,15/01/2018,0.00,,11.02,,"-29,957.44"
,IN,AR,30305498,1005,100,,Invoice,,,,,,15/01/2018,15/01/2018,0.00,,3.64,,"-29,961.08"
,IN,AR,30305516,1005,100,,Invoice,,,,,,15/01/2018,15/01/2018,0.00,,6.89,,"-29,967.97"
,IN,AR,30305532,1005,100,,Invoice,,,,,,15/01/2018,15/01/2018,0.00,,10.51,,"-29,978.48"
,IN,AR,30305545,1005,100,,Invoice,,,,,,15/01/2018,15/01/2018,0.00,,65.25,,"-30,043.73"
,IN,AR,30305606,1005,100,,Invoice,,,,,,15/01/2018,15/01/2018,0.00,,25.85,,"-30,069.58"
,IN,AR,30305626,1005,100,,Invoice,,,,,,15/01/2018,15/01/2018,0.00,,53.69,,"-30,123.27"
,IN,AR,30305642,1005,100,,Invoice,,,,,,15/01/2018,15/01/2018,0.00,,26.00,,"-30,149.27"
,IN,AR,30305704,1005,100,,Invoice,,,,,,15/01/2018,15/01/2018,0.00,,55.81,,"-30,205.08"
,IN,AR,30305708,1005,100,,Invoice,,,,,,15/01/2018,15/01/2018,0.00,,5.17,,"-30,210.25"
,IN,AR,30305853,1005,100,,Invoice,,,,,,15/01/2018,15/01/2018,0.00,,5.17,,"-30,215.42"
,IN,AR,30305938,1005,100,,Invoice,,,,,,15/01/2018,15/01/2018,0.00,,35.80,,"-30,251.22"
,IN,AR,30305952,1005,100,,Invoice,,,,,,15/01/2018,15/01/2018,0.00,,6.36,,"-30,257.58"
,IN,AR,30305953,1005,100,,Invoice,,,,,,15/01/2018,15/01/2018,0.00,,7.95,,"-30,265.53"
,IN,AR,30305985,1005,100,,Invoice,,,,,,15/01/2018,15/01/2018,0.00,,4.29,,"-30,269.82"
,IN,AR,30306058,1005,100,,Invoice,,,,,,15/01/2018,15/01/2018,0.00,,9.62,,"-30,279.44"
,IN,AR,30306106,1005,100,,Invoice,,,,,,15/01/2018,15/01/2018,0.00,,2.29,,"-30,281.73"
,IN,AR,30306122,1005,100,,Invoice,,,,,,15/01/2018,15/01/2018,0.00,,6.56,,"-30,288.29"
,IN,AR,30306169,1005,100,,Invoice,,,,,,15/01/2018,15/01/2018,0.00,,20.01,,"-30,308.30"
,IN,AR,30306196,1005,100,,Invoice,,,,,,15/01/2018,15/01/2018,0.00,,65.30,,"-30,373.60"
,IN,AR,30306203,1005,100,,Invoice,,,,,,15/01/2018,15/01/2018,0.00,,36.20,,"-30,409.80"
,IN,AR,30306252,1005,100,,Invoice,,,,,,15/01/2018,15/01/2018,0.00,,7.29,,"-30,417.09"
,IN,AR,30306259,1005,100,,Invoice,,,,,,15/01/2018,15/01/2018,0.00,,36.24,,"-30,453.33"
,IN,AR,30306264,1005,100,,Invoice,,,,,,15/01/2018,15/01/2018,0.00,,137.50,,"-30,590.83"
,IN,AR,30306276,1005,100,,Invoice,,,,,,15/01/2018,15/01/2018,0.00,,16.83,,"-30,607.66"
,IN,AR,30306298,1005,100,,Invoice,,,,,,15/01/2018,15/01/2018,0.00,,29.15,,"-30,636.81"
,IN,AR,30306315,1005,100,,Invoice,,,,,,15/01/2018,15/01/2018,0.00,,10.21,,"-30,647.02"
,IN,AR,30306341,1005,100,,Invoice,,,,,,15/01/2018,15/01/2018,0.00,,18.22,,"-30,665.24"
,IN,AR,30306361,1005,100,,Invoice,,,,,,15/01/2018,15/01/2018,0.00,,34.70,,"-30,699.94"
,IN,AR,30306383,1005,100,,Invoice,,,,,,15/01/2018,15/01/2018,0.00,,9.56,,"-30,709.50"
,IN,AR,30306438,1005,100,,Invoice,,,,,,15/01/2018,15/01/2018,0.00,,12.00,,"-30,721.50"
,IN,AR,30306449,1005,100,,Invoice,,,,,,15/01/2018,15/01/2018,0.00,,7.53,,"-30,729.03"
,IN,AR,30306450,1005,100,,Invoice,,,,,,15/01/2018,15/01/2018,0.00,,1.88,,"-30,730.91"
,IN,AR,30306584,1005,100,,Invoice,,,,,,15/01/2018,15/01/2018,0.00,,10.47,,"-30,741.38"
,IN,AR,30306605,1005,100,,Invoice,,,,,,15/01/2018,15/01/2018,0.00,,4.08,,"-30,745.46"
,IN,AR,30306615,1005,100,,Invoice,,,,,,15/01/2018,15/01/2018,0.00,,29.15,,"-30,774.61"
,IN,AR,30306625,1005,100,,Invoice,,,,,,15/01/2018,15/01/2018,0.00,,38.44,,"-30,813.05"
,IN,AR,30306630,1005,100,,Invoice,,,,,,15/01/2018,15/01/2018,0.00,,18.22,,"-30,831.27"
,IN,AR,30306647,1005,100,,Invoice,,,,,,15/01/2018,15/01/2018,0.00,,21.86,,"-30,853.13"
,CN,AR,31017157,1005,100,,Credit Note,,,,,,16/01/2018,16/01/2018,5.93,,0.00,,"-30,847.20"
,CN,AR,31017176,1005,100,,Credit Note,,,,,,16/01/2018,16/01/2018,15.51,,0.00,,"-30,831.69"
,CN,AR,31017177,1005,100,,Credit Note,,,,,,16/01/2018,16/01/2018,15.51,,0.00,,"-30,816.18"
,CN,AR,31017178,1005,100,,Credit Note,,,,,,16/01/2018,16/01/2018,2.58,,0.00,,"-30,813.60"
,CS,AR,32000035,1005,100,,Cash sale,,,,,,16/01/2018,16/01/2018,0.00,,18.22,,"-30,831.82"
,CS,AR,32000056,1005,100,,Cash sale,,,,,,16/01/2018,16/01/2018,0.00,,7.29,,"-30,839.11"
,CS,AR,32000081,1005,100,,Cash sale,,,,,,16/01/2018,16/01/2018,0.00,,3.64,,"-30,842.75"
,CS,AR,32000094,1005,100,,Cash sale,,,,,,16/01/2018,16/01/2018,0.00,,10.93,,"-30,853.68"
,CS,AR,32000109,1005,100,,Cash sale,,,,,,16/01/2018,16/01/2018,0.00,,10.93,,"-30,864.61"
,CS,AR,32000137,1005,100,,Cash sale,,,,,,16/01/2018,16/01/2018,0.00,,10.93,,"-30,875.54"
,CS,AR,32000225,1005,100,,Cash sale,,,,,,16/01/2018,16/01/2018,0.00,,10.17,,"-30,885.71"
,CS,AR,32000241,1005,100,,Cash sale,,,,,,16/01/2018,16/01/2018,0.00,,2.16,,"-30,887.87"
,CS,AR,32000276,1005,100,,Cash sale,,,,,,16/01/2018,16/01/2018,0.00,,7.75,,"-30,895.62"
,CS,AR,32000286,1005,100,,Cash sale,,,,,,16/01/2018,16/01/2018,0.00,,7.29,,"-30,902.91"
,CS,AR,32000307,1005,100,,Cash sale,,,,,,16/01/2018,16/01/2018,0.00,,5.17,,"-30,908.08"
,CS,AR,32000358,1005,100,,Cash sale,,,,,,16/01/2018,16/01/2018,0.00,,3.64,,"-30,911.72"
,CS,AR,32000361,1005,100,,Cash sale,,,,,,16/01/2018,16/01/2018,0.00,,6.02,,"-30,917.74"
,CS,AR,32000379,1005,100,,Cash sale,,,,,,16/01/2018,16/01/2018,0.00,,5.85,,"-30,923.59"
,CS,AR,32000413,1005,100,,Cash sale,,,,,,16/01/2018,16/01/2018,0.00,,23.77,,"-30,947.36"
,CS,AR,32000420,1005,100,,Cash sale,,,,,,16/01/2018,16/01/2018,0.00,,5.85,,"-30,953.21"
,CS,AR,32000446,1005,100,,Cash sale,,,,,,16/01/2018,16/01/2018,0.00,,7.63,,"-30,960.84"
,CS,AR,32000453,1005,100,,Cash sale,,,,,,16/01/2018,16/01/2018,0.00,,14.58,,"-30,975.42"
,CS,AR,32000456,1005,100,,Cash sale,,,,,,16/01/2018,16/01/2018,0.00,,2.58,,"-30,978.00"
,CS,AR,32000483,1005,100,,Cash sale,,,,,,16/01/2018,16/01/2018,0.00,,3.90,,"-30,981.90"
,CS,AR,32000499,1005,100,,Cash sale,,,,,,16/01/2018,16/01/2018,0.00,,7.29,,"-30,989.19"
,CS,AR,32000503,1005,100,,Cash sale,,,,,,16/01/2018,16/01/2018,0.00,,10.34,,"-30,999.53"
,CS,AR,32000543,1005,100,,Cash sale,,,,,,16/01/2018,16/01/2018,0.00,,10.93,,"-31,010.46"
,CS,AR,32000598,1005,100,,Cash sale,,,,,,16/01/2018,16/01/2018,0.00,,5.18,,"-31,015.64"
,CS,AR,32000602,1005,100,,Cash sale,,,,,,16/01/2018,16/01/2018,0.00,,43.73,,"-31,059.37"
,CS,AR,32000607,1005,100,,Cash sale,,,,,,16/01/2018,16/01/2018,0.00,,10.95,,"-31,070.32"
,CS,AR,32000624,1005,100,,Cash sale,,,,,,16/01/2018,16/01/2018,0.00,,15.04,,"-31,085.36"
,CS,AR,32000635,1005,100,,Cash sale,,,,,,16/01/2018,16/01/2018,0.00,,10.93,,"-31,096.29"
,CS,AR,32000664,1005,100,,Cash sale,,,,,,16/01/2018,16/01/2018,0.00,,5.08,,"-31,101.37"
,CS,AR,32000668,1005,100,,Cash sale,,,,,,16/01/2018,16/01/2018,0.00,,24.00,,"-31,125.37"
,CS,AR,32000701,1005,100,,Cash sale,,,,,,16/01/2018,16/01/2018,0.00,,2.74,,"-31,128.11"
,CS,AR,32000705,1005,100,,Cash sale,,,,,,16/01/2018,16/01/2018,0.00,,14.58,,"-31,142.69"
,CS,AR,32000736,1005,100,,Cash sale,,,,,,16/01/2018,16/01/2018,0.00,,10.93,,"-31,153.62"
,CS,AR,32000751,1005,100,,Cash sale,,,,,,16/01/2018,16/01/2018,0.00,,5.50,,"-31,159.12"
,CS,AR,32000885,1005,100,,Cash sale,,,,,,16/01/2018,16/01/2018,0.00,,6.07,,"-31,165.19"
,IN,AR,30304352,1005,100,,Invoice,,,,,,16/01/2018,16/01/2018,0.00,,6.02,,"-31,171.21"
,IN,AR,30304421,1005,100,,Invoice,,,,,,16/01/2018,16/01/2018,0.00,,27.47,,"-31,198.68"
,IN,AR,30304444,1005,100,,Invoice,,,,,,16/01/2018,16/01/2018,0.00,,3.64,,"-31,202.32"
,IN,AR,30304445,1005,100,,Invoice,,,,,,16/01/2018,16/01/2018,0.00,,546.61,,"-31,748.93"
,IN,AR,30304468,1005,100,,Invoice,,,,,,16/01/2018,16/01/2018,0.00,,7.00,,"-31,755.93"
,IN,AR,30304527,1005,100,,Invoice,,,,,,16/01/2018,16/01/2018,0.00,,47.46,,"-31,803.39"
,IN,AR,30304538,1005,100,,Invoice,,,,,,16/01/2018,16/01/2018,0.00,,21.86,,"-31,825.25"
,IN,AR,30304546,1005,100,,Invoice,,,,,,16/01/2018,16/01/2018,0.00,,"1,093.22",,"-32,918.47"
,IN,AR,30304570,1005,100,,Invoice,,,,,,16/01/2018,16/01/2018,0.00,,18.22,,"-32,936.69"
,IN,AR,30304619,1005,100,,Invoice,,,,,,16/01/2018,16/01/2018,0.00,,7.29,,"-32,943.98"
,IN,AR,30304635,1005,100,,Invoice,,,,,,16/01/2018,16/01/2018,0.00,,364.41,,"-33,308.39"
,IN,AR,30304638,1005,100,,Invoice,,,,,,16/01/2018,16/01/2018,0.00,,364.41,,"-33,672.80"
,IN,AR,30304639,1005,100,,Invoice,,,,,,16/01/2018,16/01/2018,0.00,,364.41,,"-34,037.21"
,IN,AR,30304686,1005,100,,Invoice,,,,,,16/01/2018,16/01/2018,0.00,,7.29,,"-34,044.50"
,IN,AR,30304735,1005,100,,Invoice,,,,,,16/01/2018,16/01/2018,0.00,,3.88,,"-34,048.38"
,IN,AR,30304746,1005,100,,Invoice,,,,,,16/01/2018,16/01/2018,0.00,,364.41,,"-34,412.79"
,IN,AR,30304755,1005,100,,Invoice,,,,,,16/01/2018,16/01/2018,0.00,,8.25,,"-34,421.04"
,IN,AR,30304766,1005,100,,Invoice,,,,,,16/01/2018,16/01/2018,0.00,,7.29,,"-34,428.33"
,IN,AR,30304768,1005,100,,Invoice,,,,,,16/01/2018,16/01/2018,0.00,,18.05,,"-34,446.38"
,IN,AR,30304794,1005,100,,Invoice,,,,,,16/01/2018,16/01/2018,0.00,,3.64,,"-34,450.02"
,IN,AR,30304800,1005,100,,Invoice,,,,,,16/01/2018,16/01/2018,0.00,,10.93,,"-34,460.95"
,IN,AR,30304811,1005,100,,Invoice,,,,,,16/01/2018,16/01/2018,0.00,,9.56,,"-34,470.51"
,IN,AR,30304841,1005,100,,Invoice,,,,,,16/01/2018,16/01/2018,0.00,,4.64,,"-34,475.15"
,IN,AR,30304861,1005,100,,Invoice,,,,,,16/01/2018,16/01/2018,0.00,,7.29,,"-34,482.44"
,IN,AR,30304883,1005,100,,Invoice,,,,,,16/01/2018,16/01/2018,0.00,,7.75,,"-34,490.19"
,IN,AR,30304904,1005,100,,Invoice,,,,,,16/01/2018,16/01/2018,0.00,,18.22,,"-34,508.41"
,IN,AR,30304960,1005,100,,Invoice,,,,,,16/01/2018,16/01/2018,0.00,,2.58,,"-34,510.99"
,IN,AR,30304998,1005,100,,Invoice,,,,,,16/01/2018,16/01/2018,0.00,,18.05,,"-34,529.04"
,IN,AR,30305013,1005,100,,Invoice,,,,,,16/01/2018,16/01/2018,0.00,,3.90,,"-34,532.94"
,IN,AR,30305066,1005,100,,Invoice,,,,,,16/01/2018,16/01/2018,0.00,,7.17,,"-34,540.11"
,IN,AR,30305078,1005,100,,Invoice,,,,,,16/01/2018,16/01/2018,0.00,,6.44,,"-34,546.55"
,IN,AR,30305117,1005,100,,Invoice,,,,,,16/01/2018,16/01/2018,0.00,,6.02,,"-34,552.57"
,IN,AR,30305140,1005,100,,Invoice,,,,,,16/01/2018,16/01/2018,0.00,,51.06,,"-34,603.63"
,IN,AR,30305247,1005,100,,Invoice,,,,,,16/01/2018,16/01/2018,0.00,,6.37,,"-34,610.00"
,IN,AR,30305274,1005,100,,Invoice,,,,,,16/01/2018,16/01/2018,0.00,,12.71,,"-34,622.71"
,IN,AR,30305280,1005,100,,Invoice,,,,,,16/01/2018,16/01/2018,0.00,,54.66,,"-34,677.37"
,IN,AR,30305325,1005,100,,Invoice,,,,,,16/01/2018,16/01/2018,0.00,,3.64,,"-34,681.01"
,IN,AR,30305368,1005,100,,Invoice,,,,,,16/01/2018,16/01/2018,0.00,,26.69,,"-34,707.70"
,IN,AR,30305381,1005,100,,Invoice,,,,,,16/01/2018,16/01/2018,0.00,,7.29,,"-34,714.99"
,IN,AR,30305398,1005,100,,Invoice,,,,,,16/01/2018,16/01/2018,0.00,,11.57,,"-34,726.56"
,IN,AR,30305410,1005,100,,Invoice,,,,,,16/01/2018,16/01/2018,0.00,,15.25,,"-34,741.81"
,IN,AR,30305415,1005,100,,Invoice,,,,,,16/01/2018,16/01/2018,0.00,,1.95,,"-34,743.76"
,IN,AR,30305419,1005,100,,Invoice,,,,,,16/01/2018,16/01/2018,0.00,,7.02,,"-34,750.78"
,IN,AR,30305441,1005,100,,Invoice,,,,,,16/01/2018,16/01/2018,0.00,,15.51,,"-34,766.29"
,IN,AR,30305448,1005,100,,Invoice,,,,,,16/01/2018,16/01/2018,0.00,,10.34,,"-34,776.63"
,IN,AR,30305490,1005,100,,Invoice,,,,,,16/01/2018,16/01/2018,0.00,,364.41,,"-35,141.04"
,IN,AR,30305504,1005,100,,Invoice,,,,,,16/01/2018,16/01/2018,0.00,,54.66,,"-35,195.70"
,IN,AR,30305592,1005,100,,Invoice,,,,,,16/01/2018,16/01/2018,0.00,,18.09,,"-35,213.79"
,IN,AR,30305646,1005,100,,Invoice,,,,,,16/01/2018,16/01/2018,0.00,,19.30,,"-35,233.09"
,IN,AR,30305662,1005,100,,Invoice,,,,,,16/01/2018,16/01/2018,0.00,,68.14,,"-35,301.23"
,IN,AR,30305681,1005,100,,Invoice,,,,,,16/01/2018,16/01/2018,0.00,,8.39,,"-35,309.62"
,IN,AR,30305690,1005,100,,Invoice,,,,,,16/01/2018,16/01/2018,0.00,,8.78,,"-35,318.40"
,IN,AR,30305694,1005,100,,Invoice,,,,,,16/01/2018,16/01/2018,0.00,,16.41,,"-35,334.81"
,IN,AR,30305700,1005,100,,Invoice,,,,,,16/01/2018,16/01/2018,0.00,,8.52,,"-35,343.33"
,IN,AR,30305709,1005,100,,Invoice,,,,,,16/01/2018,16/01/2018,0.00,,364.41,,"-35,707.74"
,IN,AR,30305780,1005,100,,Invoice,,,,,,16/01/2018,16/01/2018,0.00,,25.73,,"-35,733.47"
,IN,AR,30305803,1005,100,,Invoice,,,,,,16/01/2018,16/01/2018,0.00,,3.53,,"-35,737.00"
,IN,AR,30305818,1005,100,,Invoice,,,,,,16/01/2018,16/01/2018,0.00,,10.93,,"-35,747.93"
,IN,AR,30305836,1005,100,,Invoice,,,,,,16/01/2018,16/01/2018,0.00,,7.75,,"-35,755.68"
,IN,AR,30305883,1005,100,,Invoice,,,,,,16/01/2018,16/01/2018,0.00,,546.61,,"-36,302.29"
,IN,AR,30305884,1005,100,,Invoice,,,,,,16/01/2018,16/01/2018,0.00,,29.15,,"-36,331.44"
,IN,AR,30305954,1005,100,,Invoice,,,,,,16/01/2018,16/01/2018,0.00,,173.31,,"-36,504.75"
,IN,AR,30305975,1005,100,,Invoice,,,,,,16/01/2018,16/01/2018,0.00,,38.00,,"-36,542.75"
,IN,AR,30305979,1005,100,,Invoice,,,,,,16/01/2018,16/01/2018,0.00,,419.07,,"-36,961.82"
,IN,AR,30306024,1005,100,,Invoice,,,,,,16/01/2018,16/01/2018,0.00,,21.61,,"-36,983.43"
,IN,AR,30306028,1005,100,,Invoice,,,,,,16/01/2018,16/01/2018,0.00,,186.21,,"-37,169.64"
,IN,AR,30306059,1005,100,,Invoice,,,,,,16/01/2018,16/01/2018,0.00,,9.62,,"-37,179.26"
,IN,AR,30306120,1005,100,,Invoice,,,,,,16/01/2018,16/01/2018,0.00,,29.15,,"-37,208.41"
,IN,AR,30306125,1005,100,,Invoice,,,,,,16/01/2018,16/01/2018,0.00,,3.64,,"-37,212.05"
,IN,AR,30306143,1005,100,,Invoice,,,,,,16/01/2018,16/01/2018,0.00,,5.93,,"-37,217.98"
,IN,AR,30306157,1005,100,,Invoice,,,,,,16/01/2018,16/01/2018,0.00,,17.80,,"-37,235.78"
,IN,AR,30306238,1005,100,,Invoice,,,,,,16/01/2018,16/01/2018,0.00,,364.41,,"-37,600.19"
,IN,AR,30306269,1005,100,,Invoice,,,,,,16/01/2018,16/01/2018,0.00,,8.21,,"-37,608.40"
,IN,AR,30306304,1005,100,,Invoice,,,,,,16/01/2018,16/01/2018,0.00,,104.00,,"-37,712.40"
,IN,AR,30306328,1005,100,,Invoice,,,,,,16/01/2018,16/01/2018,0.00,,23.73,,"-37,736.13"
,IN,AR,30306351,1005,100,,Invoice,,,,,,16/01/2018,16/01/2018,0.00,,3.64,,"-37,739.77"
,IN,AR,30306402,1005,100,,Invoice,,,,,,16/01/2018,16/01/2018,0.00,,81.36,,"-37,821.13"
,IN,AR,30306419,1005,100,,Invoice,,,,,,16/01/2018,16/01/2018,0.00,,87.81,,"-37,908.94"
,IN,AR,30306461,1005,100,,Invoice,,,,,,16/01/2018,16/01/2018,0.00,,5.26,,"-37,914.20"
,IN,AR,30306481,1005,100,,Invoice,,,,,,16/01/2018,16/01/2018,0.00,,114.97,,"-38,029.17"
,IN,AR,30306486,1005,100,,Invoice,,,,,,16/01/2018,16/01/2018,0.00,,29.15,,"-38,058.32"
,IN,AR,30306500,1005,100,,Invoice,,,,,,16/01/2018,16/01/2018,0.00,,5.26,,"-38,063.58"
,IN,AR,30306510,1005,100,,Invoice,,,,,,16/01/2018,16/01/2018,0.00,,54.66,,"-38,118.24"
,CS,AR,32000010,1005,100,,Cash sale,,,,,,17/01/2018,17/01/2018,0.00,,5.61,,"-38,123.85"
,CS,AR,32000019,1005,100,,Cash sale,,,,,,17/01/2018,17/01/2018,0.00,,7.29,,"-38,131.14"
,CS,AR,32000022,1005,100,,Cash sale,,,,,,17/01/2018,17/01/2018,0.00,,30.10,,"-38,161.24"
,CS,AR,32000045,1005,100,,Cash sale,,,,,,17/01/2018,17/01/2018,0.00,,7.29,,"-38,168.53"
,CS,AR,32000079,1005,100,,Cash sale,,,,,,17/01/2018,17/01/2018,0.00,,10.93,,"-38,179.46"
,CS,AR,32000119,1005,100,,Cash sale,,,,,,17/01/2018,17/01/2018,0.00,,3.64,,"-38,183.10"
,CS,AR,32000150,1005,100,,Cash sale,,,,,,17/01/2018,17/01/2018,0.00,,3.01,,"-38,186.11"
,CS,AR,32000169,1005,100,,Cash sale,,,,,,17/01/2018,17/01/2018,0.00,,7.29,,"-38,193.40"
,CS,AR,32000191,1005,100,,Cash sale,,,,,,17/01/2018,17/01/2018,0.00,,23.29,,"-38,216.69"
,CS,AR,32000205,1005,100,,Cash sale,,,,,,17/01/2018,17/01/2018,0.00,,5.86,,"-38,222.55"
,CS,AR,32000209,1005,100,,Cash sale,,,,,,17/01/2018,17/01/2018,0.00,,7.29,,"-38,229.84"
,CS,AR,32000291,1005,100,,Cash sale,,,,,,17/01/2018,17/01/2018,0.00,,28.43,,"-38,258.27"
,CS,AR,32000322,1005,100,,Cash sale,,,,,,17/01/2018,17/01/2018,0.00,,15.04,,"-38,273.31"
,CS,AR,32000337,1005,100,,Cash sale,,,,,,17/01/2018,17/01/2018,0.00,,9.03,,"-38,282.34"
,CS,AR,32000347,1005,100,,Cash sale,,,,,,17/01/2018,17/01/2018,0.00,,10.93,,"-38,293.27"
,CS,AR,32000370,1005,100,,Cash sale,,,,,,17/01/2018,17/01/2018,0.00,,7.63,,"-38,300.90"
,CS,AR,32000395,1005,100,,Cash sale,,,,,,17/01/2018,17/01/2018,0.00,,6.02,,"-38,306.92"
,CS,AR,32000398,1005,100,,Cash sale,,,,,,17/01/2018,17/01/2018,0.00,,4.32,,"-38,311.24"
,CS,AR,32000439,1005,100,,Cash sale,,,,,,17/01/2018,17/01/2018,0.00,,3.64,,"-38,314.88"
,CS,AR,32000511,1005,100,,Cash sale,,,,,,17/01/2018,17/01/2018,0.00,,14.58,,"-38,329.46"
,CS,AR,32000540,1005,100,,Cash sale,,,,,,17/01/2018,17/01/2018,0.00,,7.29,,"-38,336.75"
,CS,AR,32000561,1005,100,,Cash sale,,,,,,17/01/2018,17/01/2018,0.00,,5.17,,"-38,341.92"
,CS,AR,32000572,1005,100,,Cash sale,,,,,,17/01/2018,17/01/2018,0.00,,15.21,,"-38,357.13"
,CS,AR,32000656,1005,100,,Cash sale,,,,,,17/01/2018,17/01/2018,0.00,,7.29,,"-38,364.42"
,CS,AR,32000678,1005,100,,Cash sale,,,,,,17/01/2018,17/01/2018,0.00,,7.29,,"-38,371.71"
,CS,AR,32000703,1005,100,,Cash sale,,,,,,17/01/2018,17/01/2018,0.00,,5.18,,"-38,376.89"
,CS,AR,32000708,1005,100,,Cash sale,,,,,,17/01/2018,17/01/2018,0.00,,7.29,,"-38,384.18"
,CS,AR,32000715,1005,100,,Cash sale,,,,,,17/01/2018,17/01/2018,0.00,,9.15,,"-38,393.33"
,CS,AR,32000742,1005,100,,Cash sale,,,,,,17/01/2018,17/01/2018,0.00,,18.22,,"-38,411.55"
,CS,AR,32000744,1005,100,,Cash sale,,,,,,17/01/2018,17/01/2018,0.00,,7.29,,"-38,418.84"
,CS,AR,32000760,1005,100,,Cash sale,,,,,,17/01/2018,17/01/2018,0.00,,15.04,,"-38,433.88"
,CS,AR,32000788,1005,100,,Cash sale,,,,,,17/01/2018,17/01/2018,0.00,,14.58,,"-38,448.46"
,CS,AR,32000799,1005,100,,Cash sale,,,,,,17/01/2018,17/01/2018,0.00,,3.64,,"-38,452.10"
,CS,AR,32000819,1005,100,,Cash sale,,,,,,17/01/2018,17/01/2018,0.00,,9.10,,"-38,461.20"
,CS,AR,32000913,1005,100,,Cash sale,,,,,,17/01/2018,17/01/2018,0.00,,10.99,,"-38,472.19"
,IN,AR,30304370,1005,100,,Invoice,,,,,,17/01/2018,17/01/2018,0.00,,17.80,,"-38,489.99"
,IN,AR,30304399,1005,100,,Invoice,,,,,,17/01/2018,17/01/2018,0.00,,13.98,,"-38,503.97"
,IN,AR,30304406,1005,100,,Invoice,,,,,,17/01/2018,17/01/2018,0.00,,18.22,,"-38,522.19"
,IN,AR,30304415,1005,100,,Invoice,,,,,,17/01/2018,17/01/2018,0.00,,43.93,,"-38,566.12"
,IN,AR,30304429,1005,100,,Invoice,,,,,,17/01/2018,17/01/2018,0.00,,11.36,,"-38,577.48"
,IN,AR,30304432,1005,100,,Invoice,,,,,,17/01/2018,17/01/2018,0.00,,10.93,,"-38,588.41"
,IN,AR,30304436,1005,100,,Invoice,,,,,,17/01/2018,17/01/2018,0.00,,33.86,,"-38,622.27"
,IN,AR,30304455,1005,100,,Invoice,,,,,,17/01/2018,17/01/2018,0.00,,7.25,,"-38,629.52"
,IN,AR,30304492,1005,100,,Invoice,,,,,,17/01/2018,17/01/2018,0.00,,10.93,,"-38,640.45"
,IN,AR,30304495,1005,100,,Invoice,,,,,,17/01/2018,17/01/2018,0.00,,2.16,,"-38,642.61"
,IN,AR,30304528,1005,100,,Invoice,,,,,,17/01/2018,17/01/2018,0.00,,14.24,,"-38,656.85"
,IN,AR,30304652,1005,100,,Invoice,,,,,,17/01/2018,17/01/2018,0.00,,28.00,,"-38,684.85"
,IN,AR,30304664,1005,100,,Invoice,,,,,,17/01/2018,17/01/2018,0.00,,54.58,,"-38,739.43"
,IN,AR,30304695,1005,100,,Invoice,,,,,,17/01/2018,17/01/2018,0.00,,10.93,,"-38,750.36"
,IN,AR,30304717,1005,100,,Invoice,,,,,,17/01/2018,17/01/2018,0.00,,51.85,,"-38,802.21"
,IN,AR,30304718,1005,100,,Invoice,,,,,,17/01/2018,17/01/2018,0.00,,125.53,,"-38,927.74"
,IN,AR,30304727,1005,100,,Invoice,,,,,,17/01/2018,17/01/2018,0.00,,748.42,,"-39,676.16"
,IN,AR,30304782,1005,100,,Invoice,,,,,,17/01/2018,17/01/2018,0.00,,29.18,,"-39,705.34"
,IN,AR,30304863,1005,100,,Invoice,,,,,,17/01/2018,17/01/2018,0.00,,7.29,,"-39,712.63"
,IN,AR,30304894,1005,100,,Invoice,,,,,,17/01/2018,17/01/2018,0.00,,5.17,,"-39,717.80"
,IN,AR,30304916,1005,100,,Invoice,,,,,,17/01/2018,17/01/2018,0.00,,7.75,,"-39,725.55"
,IN,AR,30304936,1005,100,,Invoice,,,,,,17/01/2018,17/01/2018,0.00,,18.09,,"-39,743.64"
,IN,AR,30304983,1005,100,,Invoice,,,,,,17/01/2018,17/01/2018,0.00,,23.90,,"-39,767.54"
,IN,AR,30305024,1005,100,,Invoice,,,,,,17/01/2018,17/01/2018,0.00,,45.12,,"-39,812.66"
,IN,AR,30305038,1005,100,,Invoice,,,,,,17/01/2018,17/01/2018,0.00,,76.27,,"-39,888.93"
,IN,AR,30305039,1005,100,,Invoice,,,,,,17/01/2018,17/01/2018,0.00,,12.71,,"-39,901.64"
,IN,AR,30305053,1005,100,,Invoice,,,,,,17/01/2018,17/01/2018,0.00,,8.58,,"-39,910.22"
,IN,AR,30305157,1005,100,,Invoice,,,,,,17/01/2018,17/01/2018,0.00,,108.03,,"-40,018.25"
,IN,AR,30305176,1005,100,,Invoice,,,,,,17/01/2018,17/01/2018,0.00,,2.54,,"-40,020.79"
,IN,AR,30305284,1005,100,,Invoice,,,,,,17/01/2018,17/01/2018,0.00,,18.22,,"-40,039.01"
,IN,AR,30305341,1005,100,,Invoice,,,,,,17/01/2018,17/01/2018,0.00,,33.60,,"-40,072.61"
,IN,AR,30305406,1005,100,,Invoice,,,,,,17/01/2018,17/01/2018,0.00,,7.29,,"-40,079.90"
,IN,AR,30305546,1005,100,,Invoice,,,,,,17/01/2018,17/01/2018,0.00,,29.66,,"-40,109.56"
,IN,AR,30305554,1005,100,,Invoice,,,,,,17/01/2018,17/01/2018,0.00,,11.44,,"-40,121.00"
,IN,AR,30305566,1005,100,,Invoice,,,,,,17/01/2018,17/01/2018,0.00,,13.98,,"-40,134.98"
,IN,AR,30305580,1005,100,,Invoice,,,,,,17/01/2018,17/01/2018,0.00,,7.29,,"-40,142.27"
,IN,AR,30305597,1005,100,,Invoice,,,,,,17/01/2018,17/01/2018,0.00,,7.29,,"-40,149.56"
,IN,AR,30305727,1005,100,,Invoice,,,,,,17/01/2018,17/01/2018,0.00,,30.08,,"-40,179.64"
,IN,AR,30305775,1005,100,,Invoice,,,,,,17/01/2018,17/01/2018,0.00,,13.14,,"-40,192.78"
,IN,AR,30305791,1005,100,,Invoice,,,,,,17/01/2018,17/01/2018,0.00,,3.64,,"-40,196.42"
,IN,AR,30305867,1005,100,,Invoice,,,,,,17/01/2018,17/01/2018,0.00,,6.00,,"-40,202.42"
,IN,AR,30305880,1005,100,,Invoice,,,,,,17/01/2018,17/01/2018,0.00,,54.66,,"-40,257.08"
,IN,AR,30305882,1005,100,,Invoice,,,,,,17/01/2018,17/01/2018,0.00,,29.15,,"-40,286.23"
,IN,AR,30305900,1005,100,,Invoice,,,,,,17/01/2018,17/01/2018,0.00,,10.93,,"-40,297.16"
,IN,AR,30305930,1005,100,,Invoice,,,,,,17/01/2018,17/01/2018,0.00,,10.93,,"-40,308.09"
,IN,AR,30305946,1005,100,,Invoice,,,,,,17/01/2018,17/01/2018,0.00,,7.29,,"-40,315.38"
,IN,AR,30305955,1005,100,,Invoice,,,,,,17/01/2018,17/01/2018,0.00,,41.34,,"-40,356.72"
,IN,AR,30305990,1005,100,,Invoice,,,,,,17/01/2018,17/01/2018,0.00,,54.12,,"-40,410.84"
,IN,AR,30306006,1005,100,,Invoice,,,,,,17/01/2018,17/01/2018,0.00,,43.73,,"-40,454.57"
,IN,AR,30306014,1005,100,,Invoice,,,,,,17/01/2018,17/01/2018,0.00,,3.64,,"-40,458.21"
,IN,AR,30306018,1005,100,,Invoice,,,,,,17/01/2018,17/01/2018,0.00,,12.03,,"-40,470.24"
,IN,AR,30306033,1005,100,,Invoice,,,,,,17/01/2018,17/01/2018,0.00,,7.29,,"-40,477.53"
,IN,AR,30306060,1005,100,,Invoice,,,,,,17/01/2018,17/01/2018,0.00,,9.62,,"-40,487.15"
,IN,AR,30306061,1005,100,,Invoice,,,,,,17/01/2018,17/01/2018,0.00,,24.05,,"-40,511.20"
,IN,AR,30306062,1005,100,,Invoice,,,,,,17/01/2018,17/01/2018,0.00,,6.42,,"-40,517.62"
,IN,AR,30306063,1005,100,,Invoice,,,,,,17/01/2018,17/01/2018,0.00,,3.20,,"-40,520.82"
,IN,AR,30306064,1005,100,,Invoice,,,,,,17/01/2018,17/01/2018,0.00,,4.81,,"-40,525.63"
,IN,AR,30306065,1005,100,,Invoice,,,,,,17/01/2018,17/01/2018,0.00,,11.22,,"-40,536.85"
,IN,AR,30306100,1005,100,,Invoice,,,,,,17/01/2018,17/01/2018,0.00,,26.27,,"-40,563.12"
,IN,AR,30306128,1005,100,,Invoice,,,,,,17/01/2018,17/01/2018,0.00,,18.11,,"-40,581.23"
,IN,AR,30306174,1005,100,,Invoice,,,,,,17/01/2018,17/01/2018,0.00,,10.00,,"-40,591.23"
,IN,AR,30306192,1005,100,,Invoice,,,,,,17/01/2018,17/01/2018,0.00,,6.07,,"-40,597.30"
,IN,AR,30306212,1005,100,,Invoice,,,,,,17/01/2018,17/01/2018,0.00,,2.92,,"-40,600.22"
,IN,AR,30306231,1005,100,,Invoice,,,,,,17/01/2018,17/01/2018,0.00,,39.95,,"-40,640.17"
,IN,AR,30306365,1005,100,,Invoice,,,,,,17/01/2018,17/01/2018,0.00,,40.58,,"-40,680.75"
,IN,AR,30306384,1005,100,,Invoice,,,,,,17/01/2018,17/01/2018,0.00,,15.93,,"-40,696.68"
,IN,AR,30306385,1005,100,,Invoice,,,,,,17/01/2018,17/01/2018,0.00,,79.66,,"-40,776.34"
,IN,AR,30306386,1005,100,,Invoice,,,,,,17/01/2018,17/01/2018,0.00,,7.97,,"-40,784.31"
,IN,AR,30306387,1005,100,,Invoice,,,,,,17/01/2018,17/01/2018,0.00,,12.75,,"-40,797.06"
,IN,AR,30306420,1005,100,,Invoice,,,,,,17/01/2018,17/01/2018,0.00,,21.36,,"-40,818.42"
,IN,AR,30306457,1005,100,,Invoice,,,,,,17/01/2018,17/01/2018,0.00,,5.26,,"-40,823.68"
,IN,AR,30306484,1005,100,,Invoice,,,,,,17/01/2018,17/01/2018,0.00,,10.93,,"-40,834.61"
,IN,AR,30306535,1005,100,,Invoice,,,,,,17/01/2018,17/01/2018,0.00,,7.53,,"-40,842.14"
,IN,AR,30306595,1005,100,,Invoice,,,,,,17/01/2018,17/01/2018,0.00,,13.09,,"-40,855.23"
,IN,AR,30306599,1005,100,,Invoice,,,,,,17/01/2018,17/01/2018,0.00,,19.58,,"-40,874.81"
,CN,AR,31016899,1005,100,,Credit Note,,,,,,18/01/2018,18/01/2018,380.34,,0.00,,"-40,494.47"
,CN,AR,31016900,1005,100,,Credit Note,,,,,,18/01/2018,18/01/2018,569.49,,0.00,,"-39,924.98"
,CN,AR,31016901,1005,100,,Credit Note,,,,,,18/01/2018,18/01/2018,325.42,,0.00,,"-39,599.56"
,CN,AR,31017140,1005,100,,Credit Note,,,,,,18/01/2018,18/01/2018,28.81,,0.00,,"-39,570.75"
,CN,AR,31017158,1005,100,,Credit Note,,,,,,18/01/2018,18/01/2018,21.73,,0.00,,"-39,549.02"
,CS,AR,32000005,1005,100,,Cash sale,,,,,,18/01/2018,18/01/2018,0.00,,15.04,,"-39,564.06"
,CS,AR,32000041,1005,100,,Cash sale,,,,,,18/01/2018,18/01/2018,0.00,,3.64,,"-39,567.70"
,CS,AR,32000051,1005,100,,Cash sale,,,,,,18/01/2018,18/01/2018,0.00,,25.51,,"-39,593.21"
,CS,AR,32000052,1005,100,,Cash sale,,,,,,18/01/2018,18/01/2018,0.00,,5.17,,"-39,598.38"
,CS,AR,32000089,1005,100,,Cash sale,,,,,,18/01/2018,18/01/2018,0.00,,51.14,,"-39,649.52"
,CS,AR,32000106,1005,100,,Cash sale,,,,,,18/01/2018,18/01/2018,0.00,,3.64,,"-39,653.16"
,CS,AR,32000161,1005,100,,Cash sale,,,,,,18/01/2018,18/01/2018,0.00,,3.64,,"-39,656.80"
,CS,AR,32000221,1005,100,,Cash sale,,,,,,18/01/2018,18/01/2018,0.00,,5.17,,"-39,661.97"
,CS,AR,32000284,1005,100,,Cash sale,,,,,,18/01/2018,18/01/2018,0.00,,7.75,,"-39,669.72"
,CS,AR,32000426,1005,100,,Cash sale,,,,,,18/01/2018,18/01/2018,0.00,,3.64,,"-39,673.36"
,CS,AR,32000430,1005,100,,Cash sale,,,,,,18/01/2018,18/01/2018,0.00,,3.64,,"-39,677.00"
,CS,AR,32000442,1005,100,,Cash sale,,,,,,18/01/2018,18/01/2018,0.00,,3.64,,"-39,680.64"
,CS,AR,32000452,1005,100,,Cash sale,,,,,,18/01/2018,18/01/2018,0.00,,7.29,,"-39,687.93"
,CS,AR,32000463,1005,100,,Cash sale,,,,,,18/01/2018,18/01/2018,0.00,,3.64,,"-39,691.57"
,CS,AR,32000475,1005,100,,Cash sale,,,,,,18/01/2018,18/01/2018,0.00,,7.29,,"-39,698.86"
,CS,AR,32000496,1005,100,,Cash sale,,,,,,18/01/2018,18/01/2018,0.00,,41.95,,"-39,740.81"
,CS,AR,32000546,1005,100,,Cash sale,,,,,,18/01/2018,18/01/2018,0.00,,2.58,,"-39,743.39"
,CS,AR,32000573,1005,100,,Cash sale,,,,,,18/01/2018,18/01/2018,0.00,,7.29,,"-39,750.68"
,CS,AR,32000587,1005,100,,Cash sale,,,,,,18/01/2018,18/01/2018,0.00,,48.14,,"-39,798.82"
,CS,AR,32000617,1005,100,,Cash sale,,,,,,18/01/2018,18/01/2018,0.00,,7.86,,"-39,806.68"
,CS,AR,32000646,1005,100,,Cash sale,,,,,,18/01/2018,18/01/2018,0.00,,5.17,,"-39,811.85"
,CS,AR,32000688,1005,100,,Cash sale,,,,,,18/01/2018,18/01/2018,0.00,,5.93,,"-39,817.78"
,CS,AR,32000883,1005,100,,Cash sale,,,,,,18/01/2018,18/01/2018,0.00,,5.86,,"-39,823.64"
,CS,AR,32000892,1005,100,,Cash sale,,,,,,18/01/2018,18/01/2018,0.00,,7.29,,"-39,830.93"
,IN,AR,30304383,1005,100,,Invoice,,,,,,18/01/2018,18/01/2018,0.00,,3.64,,"-39,834.57"
,IN,AR,30304461,1005,100,,Invoice,,,,,,18/01/2018,18/01/2018,0.00,,3.64,,"-39,838.21"
,IN,AR,30304474,1005,100,,Invoice,,,,,,18/01/2018,18/01/2018,0.00,,2.03,,"-39,840.24"
,IN,AR,30304501,1005,100,,Invoice,,,,,,18/01/2018,18/01/2018,0.00,,40.08,,"-39,880.32"
,IN,AR,30304529,1005,100,,Invoice,,,,,,18/01/2018,18/01/2018,0.00,,33.22,,"-39,913.54"
,IN,AR,30304584,1005,100,,Invoice,,,,,,18/01/2018,18/01/2018,0.00,,29.15,,"-39,942.69"
,IN,AR,30304622,1005,100,,Invoice,,,,,,18/01/2018,18/01/2018,0.00,,3.64,,"-39,946.33"
,IN,AR,30304637,1005,100,,Invoice,,,,,,18/01/2018,18/01/2018,0.00,,14.58,,"-39,960.91"
,IN,AR,30304674,1005,100,,Invoice,,,,,,18/01/2018,18/01/2018,0.00,,14.00,,"-39,974.91"
,IN,AR,30304682,1005,100,,Invoice,,,,,,18/01/2018,18/01/2018,0.00,,7.29,,"-39,982.20"
,IN,AR,30304693,1005,100,,Invoice,,,,,,18/01/2018,18/01/2018,0.00,,38.44,,"-40,020.64"
,IN,AR,30304749,1005,100,,Invoice,,,,,,18/01/2018,18/01/2018,0.00,,36.00,,"-40,056.64"
,IN,AR,30304753,1005,100,,Invoice,,,,,,18/01/2018,18/01/2018,0.00,,18.22,,"-40,074.86"
,IN,AR,30304762,1005,100,,Invoice,,,,,,18/01/2018,18/01/2018,0.00,,25.51,,"-40,100.37"
,IN,AR,30304804,1005,100,,Invoice,,,,,,18/01/2018,18/01/2018,0.00,,10.93,,"-40,111.30"
,IN,AR,30304823,1005,100,,Invoice,,,,,,18/01/2018,18/01/2018,0.00,,17.50,,"-40,128.80"
,IN,AR,30304852,1005,100,,Invoice,,,,,,18/01/2018,18/01/2018,0.00,,16.79,,"-40,145.59"
,IN,AR,30304880,1005,100,,Invoice,,,,,,18/01/2018,18/01/2018,0.00,,12.03,,"-40,157.62"
,IN,AR,30304910,1005,100,,Invoice,,,,,,18/01/2018,18/01/2018,0.00,,61.02,,"-40,218.64"
,IN,AR,30304942,1005,100,,Invoice,,,,,,18/01/2018,18/01/2018,0.00,,7.29,,"-40,225.93"
,IN,AR,30304952,1005,100,,Invoice,,,,,,18/01/2018,18/01/2018,0.00,,14.58,,"-40,240.51"
,IN,AR,30305003,1005,100,,Invoice,,,,,,18/01/2018,18/01/2018,0.00,,19.12,,"-40,259.63"
,IN,AR,30305017,1005,100,,Invoice,,,,,,18/01/2018,18/01/2018,0.00,,20.34,,"-40,279.97"
,IN,AR,30305067,1005,100,,Invoice,,,,,,18/01/2018,18/01/2018,0.00,,9.56,,"-40,289.53"
,IN,AR,30305085,1005,100,,Invoice,,,,,,18/01/2018,18/01/2018,0.00,,19.32,,"-40,308.85"
,IN,AR,30305143,1005,100,,Invoice,,,,,,18/01/2018,18/01/2018,0.00,,10.93,,"-40,319.78"
,IN,AR,30305180,1005,100,,Invoice,,,,,,18/01/2018,18/01/2018,0.00,,10.93,,"-40,330.71"
,IN,AR,30305212,1005,100,,Invoice,,,,,,18/01/2018,18/01/2018,0.00,,2.39,,"-40,333.10"
,IN,AR,30305227,1005,100,,Invoice,,,,,,18/01/2018,18/01/2018,0.00,,5.08,,"-40,338.18"
,IN,AR,30305248,1005,100,,Invoice,,,,,,18/01/2018,18/01/2018,0.00,,65.32,,"-40,403.50"
,IN,AR,30305249,1005,100,,Invoice,,,,,,18/01/2018,18/01/2018,0.00,,44.61,,"-40,448.11"
,IN,AR,30305256,1005,100,,Invoice,,,,,,18/01/2018,18/01/2018,0.00,,18.39,,"-40,466.50"
,IN,AR,30305262,1005,100,,Invoice,,,,,,18/01/2018,18/01/2018,0.00,,45.61,,"-40,512.11"
,IN,AR,30305266,1005,100,,Invoice,,,,,,18/01/2018,18/01/2018,0.00,,2.58,,"-40,514.69"
,IN,AR,30305278,1005,100,,Invoice,,,,,,18/01/2018,18/01/2018,0.00,,6.48,,"-40,521.17"
,IN,AR,30305338,1005,100,,Invoice,,,,,,18/01/2018,18/01/2018,0.00,,7.75,,"-40,528.92"
,IN,AR,30305355,1005,100,,Invoice,,,,,,18/01/2018,18/01/2018,0.00,,10.93,,"-40,539.85"
,IN,AR,30305357,1005,100,,Invoice,,,,,,18/01/2018,18/01/2018,0.00,,5.17,,"-40,545.02"
,IN,AR,30305395,1005,100,,Invoice,,,,,,18/01/2018,18/01/2018,0.00,,3.64,,"-40,548.66"
,IN,AR,30305461,1005,100,,Invoice,,,,,,18/01/2018,18/01/2018,0.00,,14.58,,"-40,563.24"
,IN,AR,30305512,1005,100,,Invoice,,,,,,18/01/2018,18/01/2018,0.00,,13.73,,"-40,576.97"
,IN,AR,30305534,1005,100,,Invoice,,,,,,18/01/2018,18/01/2018,0.00,,5.17,,"-40,582.14"
,IN,AR,30305555,1005,100,,Invoice,,,,,,18/01/2018,18/01/2018,0.00,,4.58,,"-40,586.72"
,IN,AR,30305560,1005,100,,Invoice,,,,,,18/01/2018,18/01/2018,0.00,,14.00,,"-40,600.72"
,IN,AR,30305569,1005,100,,Invoice,,,,,,18/01/2018,18/01/2018,0.00,,10.93,,"-40,611.65"
,IN,AR,30305572,1005,100,,Invoice,,,,,,18/01/2018,18/01/2018,0.00,,14.58,,"-40,626.23"
,IN,AR,30305578,1005,100,,Invoice,,,,,,18/01/2018,18/01/2018,0.00,,3.64,,"-40,629.87"
,IN,AR,30305587,1005,100,,Invoice,,,,,,18/01/2018,18/01/2018,0.00,,182.20,,"-40,812.07"
,IN,AR,30305633,1005,100,,Invoice,,,,,,18/01/2018,18/01/2018,0.00,,15.25,,"-40,827.32"
,IN,AR,30305656,1005,100,,Invoice,,,,,,18/01/2018,18/01/2018,0.00,,4.64,,"-40,831.96"
,IN,AR,30305669,1005,100,,Invoice,,,,,,18/01/2018,18/01/2018,0.00,,8.77,,"-40,840.73"
,IN,AR,30305672,1005,100,,Invoice,,,,,,18/01/2018,18/01/2018,0.00,,10.93,,"-40,851.66"
,IN,AR,30305676,1005,100,,Invoice,,,,,,18/01/2018,18/01/2018,0.00,,27.54,,"-40,879.20"
,IN,AR,30305710,1005,100,,Invoice,,,,,,18/01/2018,18/01/2018,0.00,,11.02,,"-40,890.22"
,IN,AR,30305753,1005,100,,Invoice,,,,,,18/01/2018,18/01/2018,0.00,,19.41,,"-40,909.63"
,IN,AR,30305758,1005,100,,Invoice,,,,,,18/01/2018,18/01/2018,0.00,,7.63,,"-40,917.26"
,IN,AR,30305773,1005,100,,Invoice,,,,,,18/01/2018,18/01/2018,0.00,,8.00,,"-40,925.26"
,IN,AR,30305777,1005,100,,Invoice,,,,,,18/01/2018,18/01/2018,0.00,,3.64,,"-40,928.90"
,IN,AR,30305804,1005,100,,Invoice,,,,,,18/01/2018,18/01/2018,0.00,,8.81,,"-40,937.71"
,IN,AR,30305852,1005,100,,Invoice,,,,,,18/01/2018,18/01/2018,0.00,,3.64,,"-40,941.35"
,IN,AR,30305874,1005,100,,Invoice,,,,,,18/01/2018,18/01/2018,0.00,,14.58,,"-40,955.93"
,IN,AR,30305875,1005,100,,Invoice,,,,,,18/01/2018,18/01/2018,0.00,,32.80,,"-40,988.73"
,IN,AR,30305921,1005,100,,Invoice,,,,,,18/01/2018,18/01/2018,0.00,,12.71,,"-41,001.44"
,IN,AR,30305927,1005,100,,Invoice,,,,,,18/01/2018,18/01/2018,0.00,,29.15,,"-41,030.59"
,IN,AR,30305939,1005,100,,Invoice,,,,,,18/01/2018,18/01/2018,0.00,,9.76,,"-41,040.35"
,IN,AR,30305940,1005,100,,Invoice,,,,,,18/01/2018,18/01/2018,0.00,,11.39,,"-41,051.74"
,IN,AR,30305941,1005,100,,Invoice,,,,,,18/01/2018,18/01/2018,0.00,,3.25,,"-41,054.99"
,IN,AR,30305956,1005,100,,Invoice,,,,,,18/01/2018,18/01/2018,0.00,,7.95,,"-41,062.94"
,IN,AR,30305983,1005,100,,Invoice,,,,,,18/01/2018,18/01/2018,0.00,,10.47,,"-41,073.41"
,IN,AR,30306066,1005,100,,Invoice,,,,,,18/01/2018,18/01/2018,0.00,,11.22,,"-41,084.63"
,IN,AR,30306067,1005,100,,Invoice,,,,,,18/01/2018,18/01/2018,0.00,,6.42,,"-41,091.05"
,IN,AR,30306146,1005,100,,Invoice,,,,,,18/01/2018,18/01/2018,0.00,,8.90,,"-41,099.95"
,IN,AR,30306158,1005,100,,Invoice,,,,,,18/01/2018,18/01/2018,0.00,,7.63,,"-41,107.58"
,IN,AR,30306165,1005,100,,Invoice,,,,,,18/01/2018,18/01/2018,0.00,,8.00,,"-41,115.58"
,IN,AR,30306178,1005,100,,Invoice,,,,,,18/01/2018,18/01/2018,0.00,,16.01,,"-41,131.59"
,IN,AR,30306189,1005,100,,Invoice,,,,,,18/01/2018,18/01/2018,0.00,,17.49,,"-41,149.08"
,IN,AR,30306204,1005,100,,Invoice,,,,,,18/01/2018,18/01/2018,0.00,,4.53,,"-41,153.61"
,IN,AR,30306220,1005,100,,Invoice,,,,,,18/01/2018,18/01/2018,0.00,,10.93,,"-41,164.54"
,IN,AR,30306256,1005,100,,Invoice,,,,,,18/01/2018,18/01/2018,0.00,,25.51,,"-41,190.05"
,IN,AR,30306289,1005,100,,Invoice,,,,,,18/01/2018,18/01/2018,0.00,,11.44,,"-41,201.49"
,IN,AR,30306293,1005,100,,Invoice,,,,,,18/01/2018,18/01/2018,0.00,,11.36,,"-41,212.85"
,IN,AR,30306323,1005,100,,Invoice,,,,,,18/01/2018,18/01/2018,0.00,,29.15,,"-41,242.00"
,IN,AR,30306345,1005,100,,Invoice,,,,,,18/01/2018,18/01/2018,0.00,,14.58,,"-41,256.58"
,IN,AR,30306388,1005,100,,Invoice,,,,,,18/01/2018,18/01/2018,0.00,,1.59,,"-41,258.17"
,IN,AR,30306389,1005,100,,Invoice,,,,,,18/01/2018,18/01/2018,0.00,,9.56,,"-41,267.73"
,IN,AR,30306390,1005,100,,Invoice,,,,,,18/01/2018,18/01/2018,0.00,,27.08,,"-41,294.81"
,IN,AR,30306429,1005,100,,Invoice,,,,,,18/01/2018,18/01/2018,0.00,,18.31,,"-41,313.12"
,IN,AR,30306466,1005,100,,Invoice,,,,,,18/01/2018,18/01/2018,0.00,,10.00,,"-41,323.12"
,IN,AR,30306495,1005,100,,Invoice,,,,,,18/01/2018,18/01/2018,0.00,,9.84,,"-41,332.96"
,IN,AR,30306503,1005,100,,Invoice,,,,,,18/01/2018,18/01/2018,0.00,,3.64,,"-41,336.60"
,IN,AR,30306505,1005,100,,Invoice,,,,,,18/01/2018,18/01/2018,0.00,,11.66,,"-41,348.26"
,IN,AR,30306539,1005,100,,Invoice,,,,,,18/01/2018,18/01/2018,0.00,,29.15,,"-41,377.41"
,IN,AR,30306541,1005,100,,Invoice,,,,,,18/01/2018,18/01/2018,0.00,,54.66,,"-41,432.07"
,IN,AR,30306592,1005,100,,Invoice,,,,,,18/01/2018,18/01/2018,0.00,,7.29,,"-41,439.36"
,IN,AR,30306645,1005,100,,Invoice,,,,,,18/01/2018,18/01/2018,0.00,,10.93,,"-41,450.29"
,CN,AR,31016978,1005,100,,Credit Note,,,,,,19/01/2018,19/01/2018,5.51,,0.00,,"-41,444.78"
,CN,AR,31017143,1005,100,,Credit Note,,,,,,19/01/2018,19/01/2018,25.44,,0.00,,"-41,419.34"
,CN,AR,31017183,1005,100,,Credit Note,,,,,,19/01/2018,19/01/2018,364.41,,0.00,,"-41,054.93"
,CS,AR,32000002,1005,100,,Cash sale,,,,,,19/01/2018,19/01/2018,0.00,,57.70,,"-41,112.63"
,CS,AR,32000011,1005,100,,Cash sale,,,,,,19/01/2018,19/01/2018,0.00,,2.81,,"-41,115.44"
,CS,AR,32000029,1005,100,,Cash sale,,,,,,19/01/2018,19/01/2018,0.00,,9.49,,"-41,124.93"
,CS,AR,32000034,1005,100,,Cash sale,,,,,,19/01/2018,19/01/2018,0.00,,22.71,,"-41,147.64"
,CS,AR,32000074,1005,100,,Cash sale,,,,,,19/01/2018,19/01/2018,0.00,,3.64,,"-41,151.28"
,CS,AR,32000092,1005,100,,Cash sale,,,,,,19/01/2018,19/01/2018,0.00,,7.29,,"-41,158.57"
,CS,AR,32000100,1005,100,,Cash sale,,,,,,19/01/2018,19/01/2018,0.00,,7.25,,"-41,165.82"
,CS,AR,32000115,1005,100,,Cash sale,,,,,,19/01/2018,19/01/2018,0.00,,14.24,,"-41,180.06"
,CS,AR,32000133,1005,100,,Cash sale,,,,,,19/01/2018,19/01/2018,0.00,,16.61,,"-41,196.67"
,CS,AR,32000144,1005,100,,Cash sale,,,,,,19/01/2018,19/01/2018,0.00,,7.29,,"-41,203.96"
,CS,AR,32000180,1005,100,,Cash sale,,,,,,19/01/2018,19/01/2018,0.00,,14.58,,"-41,218.54"
,CS,AR,32000196,1005,100,,Cash sale,,,,,,19/01/2018,19/01/2018,0.00,,10.93,,"-41,229.47"
,CS,AR,32000200,1005,100,,Cash sale,,,,,,19/01/2018,19/01/2018,0.00,,3.64,,"-41,233.11"
,CS,AR,32000212,1005,100,,Cash sale,,,,,,19/01/2018,19/01/2018,0.00,,7.29,,"-41,240.40"
,CS,AR,32000267,1005,100,,Cash sale,,,,,,19/01/2018,19/01/2018,0.00,,12.71,,"-41,253.11"
,CS,AR,32000296,1005,100,,Cash sale,,,,,,19/01/2018,19/01/2018,0.00,,21.98,,"-41,275.09"
,CS,AR,32000302,1005,100,,Cash sale,,,,,,19/01/2018,19/01/2018,0.00,,19.64,,"-41,294.73"
,CS,AR,32000316,1005,100,,Cash sale,,,,,,19/01/2018,19/01/2018,0.00,,13.74,,"-41,308.47"
,CS,AR,32000330,1005,100,,Cash sale,,,,,,19/01/2018,19/01/2018,0.00,,3.64,,"-41,312.11"
,CS,AR,32000342,1005,100,,Cash sale,,,,,,19/01/2018,19/01/2018,0.00,,5.51,,"-41,317.62"
,CS,AR,32000380,1005,100,,Cash sale,,,,,,19/01/2018,19/01/2018,0.00,,14.58,,"-41,332.20"
,CS,AR,32000407,1005,100,,Cash sale,,,,,,19/01/2018,19/01/2018,0.00,,27.08,,"-41,359.28"
,CS,AR,32000428,1005,100,,Cash sale,,,,,,19/01/2018,19/01/2018,0.00,,8.39,,"-41,367.67"
,CS,AR,32000433,1005,100,,Cash sale,,,,,,19/01/2018,19/01/2018,0.00,,14.58,,"-41,382.25"
,CS,AR,32000447,1005,100,,Cash sale,,,,,,19/01/2018,19/01/2018,0.00,,5.08,,"-41,387.33"
,CS,AR,32000449,1005,100,,Cash sale,,,,,,19/01/2018,19/01/2018,0.00,,10.17,,"-41,397.50"
,CS,AR,32000464,1005,100,,Cash sale,,,,,,19/01/2018,19/01/2018,0.00,,7.29,,"-41,404.79"
,CS,AR,32000525,1005,100,,Cash sale,,,,,,19/01/2018,19/01/2018,0.00,,3.01,,"-41,407.80"
,CS,AR,32000533,1005,100,,Cash sale,,,,,,19/01/2018,19/01/2018,0.00,,20.48,,"-41,428.28"
,CS,AR,32000535,1005,100,,Cash sale,,,,,,19/01/2018,19/01/2018,0.00,,3.64,,"-41,431.92"
,CS,AR,32000537,1005,100,,Cash sale,,,,,,19/01/2018,19/01/2018,0.00,,3.64,,"-41,435.56"
,CS,AR,32000542,1005,100,,Cash sale,,,,,,19/01/2018,19/01/2018,0.00,,3.64,,"-41,439.20"
,CS,AR,32000568,1005,100,,Cash sale,,,,,,19/01/2018,19/01/2018,0.00,,3.64,,"-41,442.84"
,CS,AR,32000588,1005,100,,Cash sale,,,,,,19/01/2018,19/01/2018,0.00,,18.22,,"-41,461.06"
,CS,AR,32000591,1005,100,,Cash sale,,,,,,19/01/2018,19/01/2018,0.00,,26.69,,"-41,487.75"
,CS,AR,32000594,1005,100,,Cash sale,,,,,,19/01/2018,19/01/2018,0.00,,7.29,,"-41,495.04"
,CS,AR,32000600,1005,100,,Cash sale,,,,,,19/01/2018,19/01/2018,0.00,,21.36,,"-41,516.40"
,CS,AR,32000621,1005,100,,Cash sale,,,,,,19/01/2018,19/01/2018,0.00,,17.80,,"-41,534.20"
,CS,AR,32000625,1005,100,,Cash sale,,,,,,19/01/2018,19/01/2018,0.00,,12.03,,"-41,546.23"
,CS,AR,32000648,1005,100,,Cash sale,,,,,,19/01/2018,19/01/2018,0.00,,5.17,,"-41,551.40"
,CS,AR,32000673,1005,100,,Cash sale,,,,,,19/01/2018,19/01/2018,0.00,,22.00,,"-41,573.40"
,CS,AR,32000697,1005,100,,Cash sale,,,,,,19/01/2018,19/01/2018,0.00,,2.54,,"-41,575.94"
,CS,AR,32000716,1005,100,,Cash sale,,,,,,19/01/2018,19/01/2018,0.00,,6.86,,"-41,582.80"
,CS,AR,32000739,1005,100,,Cash sale,,,,,,19/01/2018,19/01/2018,0.00,,7.29,,"-41,590.09"
,CS,AR,32000743,1005,100,,Cash sale,,,,,,19/01/2018,19/01/2018,0.00,,27.97,,"-41,618.06"
,CS,AR,32000775,1005,100,,Cash sale,,,,,,19/01/2018,19/01/2018,0.00,,3.64,,"-41,621.70"
,CS,AR,32000779,1005,100,,Cash sale,,,,,,19/01/2018,19/01/2018,0.00,,7.29,,"-41,628.99"
,CS,AR,32000789,1005,100,,Cash sale,,,,,,19/01/2018,19/01/2018,0.00,,14.58,,"-41,643.57"
,CS,AR,32000797,1005,100,,Cash sale,,,,,,19/01/2018,19/01/2018,0.00,,5.08,,"-41,648.65"
,CS,AR,32000804,1005,100,,Cash sale,,,,,,19/01/2018,19/01/2018,0.00,,6.07,,"-41,654.72"
,CS,AR,32000806,1005,100,,Cash sale,,,,,,19/01/2018,19/01/2018,0.00,,12.20,,"-41,666.92"
,CS,AR,32000812,1005,100,,Cash sale,,,,,,19/01/2018,19/01/2018,0.00,,18.09,,"-41,685.01"
,CS,AR,32000815,1005,100,,Cash sale,,,,,,19/01/2018,19/01/2018,0.00,,5.93,,"-41,690.94"
,CS,AR,32000828,1005,100,,Cash sale,,,,,,19/01/2018,19/01/2018,0.00,,10.93,,"-41,701.87"
,CS,AR,32000848,1005,100,,Cash sale,,,,,,19/01/2018,19/01/2018,0.00,,18.22,,"-41,720.09"
,CS,AR,32000859,1005,100,,Cash sale,,,,,,19/01/2018,19/01/2018,0.00,,6.56,,"-41,726.65"
,CS,AR,32000879,1005,100,,Cash sale,,,,,,19/01/2018,19/01/2018,0.00,,7.29,,"-41,733.94"
,CS,AR,32000888,1005,100,,Cash sale,,,,,,19/01/2018,19/01/2018,0.00,,7.29,,"-41,741.23"
,CS,AR,32000918,1005,100,,Cash sale,,,,,,19/01/2018,19/01/2018,0.00,,7.29,,"-41,748.52"
,IN,AR,30304379,1005,100,,Invoice,,,,,,19/01/2018,19/01/2018,0.00,,14.58,,"-41,763.10"
,IN,AR,30304416,1005,100,,Invoice,,,,,,19/01/2018,19/01/2018,0.00,,31.73,,"-41,794.83"
,IN,AR,30304426,1005,100,,Invoice,,,,,,19/01/2018,19/01/2018,0.00,,7.29,,"-41,802.12"
,IN,AR,30304456,1005,100,,Invoice,,,,,,19/01/2018,19/01/2018,0.00,,24.15,,"-41,826.27"
,IN,AR,30304471,1005,100,,Invoice,,,,,,19/01/2018,19/01/2018,0.00,,7.29,,"-41,833.56"
,IN,AR,30304475,1005,100,,Invoice,,,,,,19/01/2018,19/01/2018,0.00,,16.27,,"-41,849.83"
,IN,AR,30304489,1005,100,,Invoice,,,,,,19/01/2018,19/01/2018,0.00,,54.66,,"-41,904.49"
,IN,AR,30304504,1005,100,,Invoice,,,,,,19/01/2018,19/01/2018,0.00,,9.19,,"-41,913.68"
,IN,AR,30304510,1005,100,,Invoice,,,,,,19/01/2018,19/01/2018,0.00,,64.04,,"-41,977.72"
,IN,AR,30304530,1005,100,,Invoice,,,,,,19/01/2018,19/01/2018,0.00,,80.68,,"-42,058.40"
,IN,AR,30304549,1005,100,,Invoice,,,,,,19/01/2018,19/01/2018,0.00,,10.93,,"-42,069.33"
,IN,AR,30304555,1005,100,,Invoice,,,,,,19/01/2018,19/01/2018,0.00,,48.00,,"-42,117.33"
,IN,AR,30304609,1005,100,,Invoice,,,,,,19/01/2018,19/01/2018,0.00,,26.00,,"-42,143.33"
,IN,AR,30304616,1005,100,,Invoice,,,,,,19/01/2018,19/01/2018,0.00,,3.64,,"-42,146.97"
,IN,AR,30304665,1005,100,,Invoice,,,,,,19/01/2018,19/01/2018,0.00,,4.75,,"-42,151.72"
,IN,AR,30304728,1005,100,,Invoice,,,,,,19/01/2018,19/01/2018,0.00,,748.42,,"-42,900.14"
,IN,AR,30304736,1005,100,,Invoice,,,,,,19/01/2018,19/01/2018,0.00,,7.76,,"-42,907.90"
,IN,AR,30304745,1005,100,,Invoice,,,,,,19/01/2018,19/01/2018,0.00,,7.29,,"-42,915.19"
,IN,AR,30304752,1005,100,,Invoice,,,,,,19/01/2018,19/01/2018,0.00,,7.29,,"-42,922.48"
,IN,AR,30304801,1005,100,,Invoice,,,,,,19/01/2018,19/01/2018,0.00,,3.64,,"-42,926.12"
,IN,AR,30304812,1005,100,,Invoice,,,,,,19/01/2018,19/01/2018,0.00,,9.56,,"-42,935.68"
,IN,AR,30304828,1005,100,,Invoice,,,,,,19/01/2018,19/01/2018,0.00,,5.17,,"-42,940.85"
,IN,AR,30304867,1005,100,,Invoice,,,,,,19/01/2018,19/01/2018,0.00,,3.64,,"-42,944.49"
,IN,AR,30304948,1005,100,,Invoice,,,,,,19/01/2018,19/01/2018,0.00,,12.92,,"-42,957.41"
,IN,AR,30304955,1005,100,,Invoice,,,,,,19/01/2018,19/01/2018,0.00,,2.39,,"-42,959.80"
,IN,AR,30304964,1005,100,,Invoice,,,,,,19/01/2018,19/01/2018,0.00,,163.39,,"-43,123.19"
,IN,AR,30304980,1005,100,,Invoice,,,,,,19/01/2018,19/01/2018,0.00,,36.44,,"-43,159.63"
,IN,AR,30304988,1005,100,,Invoice,,,,,,19/01/2018,19/01/2018,0.00,,21.86,,"-43,181.49"
,IN,AR,30305025,1005,100,,Invoice,,,,,,19/01/2018,19/01/2018,0.00,,51.27,,"-43,232.76"
,IN,AR,30305068,1005,100,,Invoice,,,,,,19/01/2018,19/01/2018,0.00,,4.78,,"-43,237.54"
,IN,AR,30305069,1005,100,,Invoice,,,,,,19/01/2018,19/01/2018,0.00,,19.12,,"-43,256.66"
,IN,AR,30305113,1005,100,,Invoice,,,,,,19/01/2018,19/01/2018,0.00,,8.47,,"-43,265.13"
,IN,AR,30305126,1005,100,,Invoice,,,,,,19/01/2018,19/01/2018,0.00,,12.92,,"-43,278.05"
,IN,AR,30305145,1005,100,,Invoice,,,,,,19/01/2018,19/01/2018,0.00,,18.09,,"-43,296.14"
,IN,AR,30305178,1005,100,,Invoice,,,,,,19/01/2018,19/01/2018,0.00,,5.08,,"-43,301.22"
,IN,AR,30305228,1005,100,,Invoice,,,,,,19/01/2018,19/01/2018,0.00,,2.54,,"-43,303.76"
,IN,AR,30305269,1005,100,,Invoice,,,,,,19/01/2018,19/01/2018,0.00,,12.92,,"-43,316.68"
,IN,AR,30305322,1005,100,,Invoice,,,,,,19/01/2018,19/01/2018,0.00,,12.71,,"-43,329.39"
,IN,AR,30305335,1005,100,,Invoice,,,,,,19/01/2018,19/01/2018,0.00,,18.09,,"-43,347.48"
,IN,AR,30305360,1005,100,,Invoice,,,,,,19/01/2018,19/01/2018,0.00,,7.29,,"-43,354.77"
,IN,AR,30305364,1005,100,,Invoice,,,,,,19/01/2018,19/01/2018,0.00,,15.90,,"-43,370.67"
,IN,AR,30305376,1005,100,,Invoice,,,,,,19/01/2018,19/01/2018,0.00,,27.97,,"-43,398.64"
,IN,AR,30305411,1005,100,,Invoice,,,,,,19/01/2018,19/01/2018,0.00,,10.17,,"-43,408.81"
,IN,AR,30305508,1005,100,,Invoice,,,,,,19/01/2018,19/01/2018,0.00,,8.17,,"-43,416.98"
,IN,AR,30305522,1005,100,,Invoice,,,,,,19/01/2018,19/01/2018,0.00,,39.27,,"-43,456.25"
,IN,AR,30305640,1005,100,,Invoice,,,,,,19/01/2018,19/01/2018,0.00,,14.58,,"-43,470.83"
,IN,AR,30305663,1005,100,,Invoice,,,,,,19/01/2018,19/01/2018,0.00,,56.78,,"-43,527.61"
,IN,AR,30305691,1005,100,,Invoice,,,,,,19/01/2018,19/01/2018,0.00,,8.78,,"-43,536.39"
,IN,AR,30305695,1005,100,,Invoice,,,,,,19/01/2018,19/01/2018,0.00,,7.29,,"-43,543.68"
,IN,AR,30305781,1005,100,,Invoice,,,,,,19/01/2018,19/01/2018,0.00,,47.17,,"-43,590.85"
,IN,AR,30305786,1005,100,,Invoice,,,,,,19/01/2018,19/01/2018,0.00,,29.15,,"-43,620.00"
,IN,AR,30305812,1005,100,,Invoice,,,,,,19/01/2018,19/01/2018,0.00,,15.04,,"-43,635.04"
,IN,AR,30305824,1005,100,,Invoice,,,,,,19/01/2018,19/01/2018,0.00,,2.42,,"-43,637.46"
,IN,AR,30305831,1005,100,,Invoice,,,,,,19/01/2018,19/01/2018,0.00,,4.54,,"-43,642.00"
,IN,AR,30305848,1005,100,,Invoice,,,,,,19/01/2018,19/01/2018,0.00,,10.34,,"-43,652.34"
,IN,AR,30305897,1005,100,,Invoice,,,,,,19/01/2018,19/01/2018,0.00,,14.58,,"-43,666.92"
,IN,AR,30305917,1005,100,,Invoice,,,,,,19/01/2018,19/01/2018,0.00,,14.58,,"-43,681.50"
,IN,AR,30305957,1005,100,,Invoice,,,,,,19/01/2018,19/01/2018,0.00,,25.44,,"-43,706.94"
,IN,AR,30305958,1005,100,,Invoice,,,,,,19/01/2018,19/01/2018,0.00,,4.77,,"-43,711.71"
,IN,AR,30305968,1005,100,,Invoice,,,,,,19/01/2018,19/01/2018,0.00,,39.75,,"-43,751.46"
,IN,AR,30305996,1005,100,,Invoice,,,,,,19/01/2018,19/01/2018,0.00,,32.07,,"-43,783.53"
,IN,AR,30306019,1005,100,,Invoice,,,,,,19/01/2018,19/01/2018,0.00,,12.03,,"-43,795.56"
,IN,AR,30306068,1005,100,,Invoice,,,,,,19/01/2018,19/01/2018,0.00,,52.92,,"-43,848.48"
,IN,AR,30306069,1005,100,,Invoice,,,,,,19/01/2018,19/01/2018,0.00,,1.60,,"-43,850.08"
,IN,AR,30306070,1005,100,,Invoice,,,,,,19/01/2018,19/01/2018,0.00,,9.62,,"-43,859.70"
,IN,AR,30306133,1005,100,,Invoice,,,,,,19/01/2018,19/01/2018,0.00,,9.56,,"-43,869.26"
,IN,AR,30306219,1005,100,,Invoice,,,,,,19/01/2018,19/01/2018,0.00,,364.41,,"-44,233.67"
,IN,AR,30306225,1005,100,,Invoice,,,,,,19/01/2018,19/01/2018,0.00,,21.90,,"-44,255.57"
,IN,AR,30306232,1005,100,,Invoice,,,,,,19/01/2018,19/01/2018,0.00,,8.41,,"-44,263.98"
,IN,AR,30306240,1005,100,,Invoice,,,,,,19/01/2018,19/01/2018,0.00,,19.92,,"-44,283.90"
,IN,AR,30306255,1005,100,,Invoice,,,,,,19/01/2018,19/01/2018,0.00,,14.58,,"-44,298.48"
,IN,AR,30306277,1005,100,,Invoice,,,,,,19/01/2018,19/01/2018,0.00,,14.03,,"-44,312.51"
,IN,AR,30306300,1005,100,,Invoice,,,,,,19/01/2018,19/01/2018,0.00,,12.85,,"-44,325.36"
,IN,AR,30306439,1005,100,,Invoice,,,,,,19/01/2018,19/01/2018,0.00,,10.00,,"-44,335.36"
,IN,AR,30306490,1005,100,,Invoice,,,,,,19/01/2018,19/01/2018,0.00,,18.22,,"-44,353.58"
,IN,AR,30306504,1005,100,,Invoice,,,,,,19/01/2018,19/01/2018,0.00,,5.83,,"-44,359.41"
,IN,AR,30306515,1005,100,,Invoice,,,,,,19/01/2018,19/01/2018,0.00,,5.47,,"-44,364.88"
,IN,AR,30306523,1005,100,,Invoice,,,,,,19/01/2018,19/01/2018,0.00,,10.93,,"-44,375.81"
,IN,AR,30306526,1005,100,,Invoice,,,,,,19/01/2018,19/01/2018,0.00,,33.90,,"-44,409.71"
,IN,AR,30306586,1005,100,,Invoice,,,,,,19/01/2018,19/01/2018,0.00,,3.76,,"-44,413.47"
,IN,AR,30306606,1005,100,,Invoice,,,,,,19/01/2018,19/01/2018,0.00,,6.13,,"-44,419.60"
,IN,AR,30306611,1005,100,,Invoice,,,,,,19/01/2018,19/01/2018,0.00,,8.17,,"-44,427.77"
,IN,AR,30306631,1005,100,,Invoice,,,,,,19/01/2018,19/01/2018,0.00,,10.93,,"-44,438.70"
,IN,AR,30306639,1005,100,,Invoice,,,,,,19/01/2018,19/01/2018,0.00,,25.51,,"-44,464.21"
,IN,AR,30306648,1005,100,,Invoice,,,,,,19/01/2018,19/01/2018,0.00,,14.58,,"-44,478.79"
,IN,AR,30306654,1005,100,,Invoice,,,,,,19/01/2018,19/01/2018,0.00,,182.20,,"-44,660.99"
,CS,AR,32000170,1005,100,,Cash sale,,,,,,20/01/2018,20/01/2018,0.00,,7.29,,"-44,668.28"
,CS,AR,32000183,1005,100,,Cash sale,,,,,,20/01/2018,20/01/2018,0.00,,10.93,,"-44,679.21"
,CS,AR,32000257,1005,100,,Cash sale,,,,,,20/01/2018,20/01/2018,0.00,,7.75,,"-44,686.96"
,CS,AR,32000299,1005,100,,Cash sale,,,,,,20/01/2018,20/01/2018,0.00,,10.93,,"-44,697.89"
,CS,AR,32000424,1005,100,,Cash sale,,,,,,20/01/2018,20/01/2018,0.00,,7.29,,"-44,705.18"
,CS,AR,32000615,1005,100,,Cash sale,,,,,,20/01/2018,20/01/2018,0.00,,7.29,,"-44,712.47"
,CS,AR,32000706,1005,100,,Cash sale,,,,,,20/01/2018,20/01/2018,0.00,,10.93,,"-44,723.40"
,CS,AR,32000808,1005,100,,Cash sale,,,,,,20/01/2018,20/01/2018,0.00,,21.86,,"-44,745.26"
,IN,AR,30306141,1005,100,,Invoice,,,,,,20/01/2018,20/01/2018,0.00,,18.22,,"-44,763.48"
,CN,AR,31017104,1005,100,,Credit Note,,,,,,22/01/2018,22/01/2018,12.71,,0.00,,"-44,750.77"
,CN,AR,31017111,1005,100,,Credit Note,,,,,,22/01/2018,22/01/2018,23.70,,0.00,,"-44,727.07"
,CN,AR,31017141,1005,100,,Credit Note,,,,,,22/01/2018,22/01/2018,10.17,,0.00,,"-44,716.90"
,CN,AR,31017201,1005,100,,Credit Note,,,,,,22/01/2018,22/01/2018,7.29,,0.00,,"-44,709.61"
,CN,AR,31017206,1005,100,,Credit Note,,,,,,22/01/2018,22/01/2018,29.15,,0.00,,"-44,680.46"
,CS,AR,32000030,1005,100,,Cash sale,,,,,,22/01/2018,22/01/2018,0.00,,7.12,,"-44,687.58"
,CS,AR,32000090,1005,100,,Cash sale,,,,,,22/01/2018,22/01/2018,0.00,,21.06,,"-44,708.64"
,CS,AR,32000093,1005,100,,Cash sale,,,,,,22/01/2018,22/01/2018,0.00,,3.64,,"-44,712.28"
,CS,AR,32000116,1005,100,,Cash sale,,,,,,22/01/2018,22/01/2018,0.00,,9.49,,"-44,721.77"
,CS,AR,32000122,1005,100,,Cash sale,,,,,,22/01/2018,22/01/2018,0.00,,3.64,,"-44,725.41"
,CS,AR,32000134,1005,100,,Cash sale,,,,,,22/01/2018,22/01/2018,0.00,,12.46,,"-44,737.87"
,CS,AR,32000158,1005,100,,Cash sale,,,,,,22/01/2018,22/01/2018,0.00,,3.89,,"-44,741.76"
,CS,AR,32000164,1005,100,,Cash sale,,,,,,22/01/2018,22/01/2018,0.00,,8.77,,"-44,750.53"
,CS,AR,32000177,1005,100,,Cash sale,,,,,,22/01/2018,22/01/2018,0.00,,7.29,,"-44,757.82"
,CS,AR,32000195,1005,100,,Cash sale,,,,,,22/01/2018,22/01/2018,0.00,,18.22,,"-44,776.04"
,CS,AR,32000210,1005,100,,Cash sale,,,,,,22/01/2018,22/01/2018,0.00,,7.29,,"-44,783.33"
,CS,AR,32000216,1005,100,,Cash sale,,,,,,22/01/2018,22/01/2018,0.00,,5.17,,"-44,788.50"
,CS,AR,32000244,1005,100,,Cash sale,,,,,,22/01/2018,22/01/2018,0.00,,14.58,,"-44,803.08"
,CS,AR,32000268,1005,100,,Cash sale,,,,,,22/01/2018,22/01/2018,0.00,,10.17,,"-44,813.25"
,CS,AR,32000292,1005,100,,Cash sale,,,,,,22/01/2018,22/01/2018,0.00,,18.09,,"-44,831.34"
,CS,AR,32000317,1005,100,,Cash sale,,,,,,22/01/2018,22/01/2018,0.00,,5.49,,"-44,836.83"
,CS,AR,32000333,1005,100,,Cash sale,,,,,,22/01/2018,22/01/2018,0.00,,7.29,,"-44,844.12"
,CS,AR,32000352,1005,100,,Cash sale,,,,,,22/01/2018,22/01/2018,0.00,,7.29,,"-44,851.41"
,CS,AR,32000372,1005,100,,Cash sale,,,,,,22/01/2018,22/01/2018,0.00,,5.08,,"-44,856.49"
,CS,AR,32000386,1005,100,,Cash sale,,,,,,22/01/2018,22/01/2018,0.00,,17.54,,"-44,874.03"
,CS,AR,32000392,1005,100,,Cash sale,,,,,,22/01/2018,22/01/2018,0.00,,8.16,,"-44,882.19"
,CS,AR,32000408,1005,100,,Cash sale,,,,,,22/01/2018,22/01/2018,0.00,,24.07,,"-44,906.26"
,CS,AR,32000416,1005,100,,Cash sale,,,,,,22/01/2018,22/01/2018,0.00,,7.29,,"-44,913.55"
,CS,AR,32000435,1005,100,,Cash sale,,,,,,22/01/2018,22/01/2018,0.00,,3.64,,"-44,917.19"
,CS,AR,32000465,1005,100,,Cash sale,,,,,,22/01/2018,22/01/2018,0.00,,60.17,,"-44,977.36"
,CS,AR,32000468,1005,100,,Cash sale,,,,,,22/01/2018,22/01/2018,0.00,,10.51,,"-44,987.87"
,CS,AR,32000471,1005,100,,Cash sale,,,,,,22/01/2018,22/01/2018,0.00,,5.08,,"-44,992.95"
,CS,AR,32000474,1005,100,,Cash sale,,,,,,22/01/2018,22/01/2018,0.00,,3.64,,"-44,996.59"
,CS,AR,32000516,1005,100,,Cash sale,,,,,,22/01/2018,22/01/2018,0.00,,3.64,,"-45,000.23"
,CS,AR,32000521,1005,100,,Cash sale,,,,,,22/01/2018,22/01/2018,0.00,,7.29,,"-45,007.52"
,CS,AR,32000605,1005,100,,Cash sale,,,,,,22/01/2018,22/01/2018,0.00,,7.29,,"-45,014.81"
,CS,AR,32000631,1005,100,,Cash sale,,,,,,22/01/2018,22/01/2018,0.00,,21.86,,"-45,036.67"
,CS,AR,32000639,1005,100,,Cash sale,,,,,,22/01/2018,22/01/2018,0.00,,5.17,,"-45,041.84"
,CS,AR,32000641,1005,100,,Cash sale,,,,,,22/01/2018,22/01/2018,0.00,,7.29,,"-45,049.13"
,CS,AR,32000694,1005,100,,Cash sale,,,,,,22/01/2018,22/01/2018,0.00,,6.56,,"-45,055.69"
,CS,AR,32000704,1005,100,,Cash sale,,,,,,22/01/2018,22/01/2018,0.00,,9.84,,"-45,065.53"
,CS,AR,32000717,1005,100,,Cash sale,,,,,,22/01/2018,22/01/2018,0.00,,11.44,,"-45,076.97"
,CS,AR,32000753,1005,100,,Cash sale,,,,,,22/01/2018,22/01/2018,0.00,,25.51,,"-45,102.48"
,CS,AR,32000765,1005,100,,Cash sale,,,,,,22/01/2018,22/01/2018,0.00,,7.29,,"-45,109.77"
,CS,AR,32000790,1005,100,,Cash sale,,,,,,22/01/2018,22/01/2018,0.00,,14.58,,"-45,124.35"
,CS,AR,32000844,1005,100,,Cash sale,,,,,,22/01/2018,22/01/2018,0.00,,18.22,,"-45,142.57"
,CS,AR,32000847,1005,100,,Cash sale,,,,,,22/01/2018,22/01/2018,0.00,,3.64,,"-45,146.21"
,IN,AR,30304371,1005,100,,Invoice,,,,,,22/01/2018,22/01/2018,0.00,,38.56,,"-45,184.77"
,IN,AR,30304390,1005,100,,Invoice,,,,,,22/01/2018,22/01/2018,0.00,,18.22,,"-45,202.99"
,IN,AR,30304480,1005,100,,Invoice,,,,,,22/01/2018,22/01/2018,0.00,,57.07,,"-45,260.06"
,IN,AR,30304493,1005,100,,Invoice,,,,,,22/01/2018,22/01/2018,0.00,,5.59,,"-45,265.65"
,IN,AR,30304531,1005,100,,Invoice,,,,,,22/01/2018,22/01/2018,0.00,,54.58,,"-45,320.23"
,IN,AR,30304556,1005,100,,Invoice,,,,,,22/01/2018,22/01/2018,0.00,,30.00,,"-45,350.23"
,IN,AR,30304582,1005,100,,Invoice,,,,,,22/01/2018,22/01/2018,0.00,,48.78,,"-45,399.01"
,IN,AR,30304610,1005,100,,Invoice,,,,,,22/01/2018,22/01/2018,0.00,,10.00,,"-45,409.01"
,IN,AR,30304611,1005,100,,Invoice,,,,,,22/01/2018,22/01/2018,0.00,,24.00,,"-45,433.01"
,IN,AR,30304624,1005,100,,Invoice,,,,,,22/01/2018,22/01/2018,0.00,,2.75,,"-45,435.76"
,IN,AR,30304632,1005,100,,Invoice,,,,,,22/01/2018,22/01/2018,0.00,,11.02,,"-45,446.78"
,IN,AR,30304675,1005,100,,Invoice,,,,,,22/01/2018,22/01/2018,0.00,,8.00,,"-45,454.78"
,IN,AR,30304737,1005,100,,Invoice,,,,,,22/01/2018,22/01/2018,0.00,,3.88,,"-45,458.66"
,IN,AR,30304741,1005,100,,Invoice,,,,,,22/01/2018,22/01/2018,0.00,,69.31,,"-45,527.97"
,IN,AR,30304774,1005,100,,Invoice,,,,,,22/01/2018,22/01/2018,0.00,,9.66,,"-45,537.63"
,IN,AR,30304791,1005,100,,Invoice,,,,,,22/01/2018,22/01/2018,0.00,,28.39,,"-45,566.02"
,IN,AR,30304833,1005,100,,Invoice,,,,,,22/01/2018,22/01/2018,0.00,,7.75,,"-45,573.77"
,IN,AR,30304859,1005,100,,Invoice,,,,,,22/01/2018,22/01/2018,0.00,,6.89,,"-45,580.66"
,IN,AR,30304937,1005,100,,Invoice,,,,,,22/01/2018,22/01/2018,0.00,,5.17,,"-45,585.83"
,IN,AR,30304975,1005,100,,Invoice,,,,,,22/01/2018,22/01/2018,0.00,,10.38,,"-45,596.21"
,IN,AR,30304991,1005,100,,Invoice,,,,,,22/01/2018,22/01/2018,0.00,,7.29,,"-45,603.50"
,IN,AR,30305026,1005,100,,Invoice,,,,,,22/01/2018,22/01/2018,0.00,,41.02,,"-45,644.52"
,IN,AR,30305040,1005,100,,Invoice,,,,,,22/01/2018,22/01/2018,0.00,,35.59,,"-45,680.11"
,IN,AR,30305070,1005,100,,Invoice,,,,,,22/01/2018,22/01/2018,0.00,,23.90,,"-45,704.01"
,IN,AR,30305079,1005,100,,Invoice,,,,,,22/01/2018,22/01/2018,0.00,,6.44,,"-45,710.45"
,IN,AR,30305080,1005,100,,Invoice,,,,,,22/01/2018,22/01/2018,0.00,,16.10,,"-45,726.55"
,IN,AR,30305092,1005,100,,Invoice,,,,,,22/01/2018,22/01/2018,0.00,,3.01,,"-45,729.56"
,IN,AR,30305115,1005,100,,Invoice,,,,,,22/01/2018,22/01/2018,0.00,,7.29,,"-45,736.85"
,IN,AR,30305120,1005,100,,Invoice,,,,,,22/01/2018,22/01/2018,0.00,,5.51,,"-45,742.36"
,IN,AR,30305132,1005,100,,Invoice,,,,,,22/01/2018,22/01/2018,0.00,,2.58,,"-45,744.94"
,IN,AR,30305377,1005,100,,Invoice,,,,,,22/01/2018,22/01/2018,0.00,,20.34,,"-45,765.28"
,IN,AR,30305390,1005,100,,Invoice,,,,,,22/01/2018,22/01/2018,0.00,,24.41,,"-45,789.69"
,IN,AR,30305426,1005,100,,Invoice,,,,,,22/01/2018,22/01/2018,0.00,,27.47,,"-45,817.16"
,IN,AR,30305435,1005,100,,Invoice,,,,,,22/01/2018,22/01/2018,0.00,,10.93,,"-45,828.09"
,IN,AR,30305438,1005,100,,Invoice,,,,,,22/01/2018,22/01/2018,0.00,,7.75,,"-45,835.84"
,IN,AR,30305475,1005,100,,Invoice,,,,,,22/01/2018,22/01/2018,0.00,,3.19,,"-45,839.03"
,IN,AR,30305481,1005,100,,Invoice,,,,,,22/01/2018,22/01/2018,0.00,,8.26,,"-45,847.29"
,IN,AR,30305494,1005,100,,Invoice,,,,,,22/01/2018,22/01/2018,0.00,,11.02,,"-45,858.31"
,IN,AR,30305499,1005,100,,Invoice,,,,,,22/01/2018,22/01/2018,0.00,,7.29,,"-45,865.60"
,IN,AR,30305517,1005,100,,Invoice,,,,,,22/01/2018,22/01/2018,0.00,,6.89,,"-45,872.49"
,IN,AR,30305523,1005,100,,Invoice,,,,,,22/01/2018,22/01/2018,0.00,,19.64,,"-45,892.13"
,IN,AR,30305627,1005,100,,Invoice,,,,,,22/01/2018,22/01/2018,0.00,,48.81,,"-45,940.94"
,IN,AR,30305634,1005,100,,Invoice,,,,,,22/01/2018,22/01/2018,0.00,,10.17,,"-45,951.11"
,IN,AR,30305686,1005,100,,Invoice,,,,,,22/01/2018,22/01/2018,0.00,,15.51,,"-45,966.62"
,IN,AR,30305697,1005,100,,Invoice,,,,,,22/01/2018,22/01/2018,0.00,,54.66,,"-46,021.28"
,IN,AR,30305705,1005,100,,Invoice,,,,,,22/01/2018,22/01/2018,0.00,,39.40,,"-46,060.68"
,IN,AR,30305732,1005,100,,Invoice,,,,,,22/01/2018,22/01/2018,0.00,,6.42,,"-46,067.10"
,IN,AR,30305749,1005,100,,Invoice,,,,,,22/01/2018,22/01/2018,0.00,,35.30,,"-46,102.40"
,IN,AR,30305788,1005,100,,Invoice,,,,,,22/01/2018,22/01/2018,0.00,,36.44,,"-46,138.84"
,IN,AR,30305817,1005,100,,Invoice,,,,,,22/01/2018,22/01/2018,0.00,,10.93,,"-46,149.77"
,IN,AR,30305893,1005,100,,Invoice,,,,,,22/01/2018,22/01/2018,0.00,,4.29,,"-46,154.06"
,IN,AR,30305922,1005,100,,Invoice,,,,,,22/01/2018,22/01/2018,0.00,,12.71,,"-46,166.77"
,IN,AR,30305997,1005,100,,Invoice,,,,,,22/01/2018,22/01/2018,0.00,,6.02,,"-46,172.79"
,IN,AR,30306001,1005,100,,Invoice,,,,,,22/01/2018,22/01/2018,0.00,,3.64,,"-46,176.43"
,IN,AR,30306021,1005,100,,Invoice,,,,,,22/01/2018,22/01/2018,0.00,,27.32,,"-46,203.75"
,IN,AR,30306071,1005,100,,Invoice,,,,,,22/01/2018,22/01/2018,0.00,,11.22,,"-46,214.97"
,IN,AR,30306093,1005,100,,Invoice,,,,,,22/01/2018,22/01/2018,0.00,,9.84,,"-46,224.81"
,IN,AR,30306101,1005,100,,Invoice,,,,,,22/01/2018,22/01/2018,0.00,,26.27,,"-46,251.08"
,IN,AR,30306107,1005,100,,Invoice,,,,,,22/01/2018,22/01/2018,0.00,,4.58,,"-46,255.66"
,IN,AR,30306110,1005,100,,Invoice,,,,,,22/01/2018,22/01/2018,0.00,,54.66,,"-46,310.32"
,IN,AR,30306170,1005,100,,Invoice,,,,,,22/01/2018,22/01/2018,0.00,,18.01,,"-46,328.33"
,IN,AR,30306197,1005,100,,Invoice,,,,,,22/01/2018,22/01/2018,0.00,,62.46,,"-46,390.79"
,IN,AR,30306205,1005,100,,Invoice,,,,,,22/01/2018,22/01/2018,0.00,,58.83,,"-46,449.62"
,IN,AR,30306253,1005,100,,Invoice,,,,,,22/01/2018,22/01/2018,0.00,,7.29,,"-46,456.91"
,IN,AR,30306265,1005,100,,Invoice,,,,,,22/01/2018,22/01/2018,0.00,,158.47,,"-46,615.38"
,IN,AR,30306278,1005,100,,Invoice,,,,,,22/01/2018,22/01/2018,0.00,,5.61,,"-46,620.99"
,IN,AR,30306316,1005,100,,Invoice,,,,,,22/01/2018,22/01/2018,0.00,,4.08,,"-46,625.07"
,IN,AR,30306339,1005,100,,Invoice,,,,,,22/01/2018,22/01/2018,0.00,,29.15,,"-46,654.22"
,IN,AR,30306362,1005,100,,Invoice,,,,,,22/01/2018,22/01/2018,0.00,,32.03,,"-46,686.25"
,IN,AR,30306391,1005,100,,Invoice,,,,,,22/01/2018,22/01/2018,0.00,,7.97,,"-46,694.22"
,IN,AR,30306413,1005,100,,Invoice,,,,,,22/01/2018,22/01/2018,0.00,,41.78,,"-46,736.00"
,IN,AR,30306431,1005,100,,Invoice,,,,,,22/01/2018,22/01/2018,0.00,,54.66,,"-46,790.66"
,IN,AR,30306440,1005,100,,Invoice,,,,,,22/01/2018,22/01/2018,0.00,,10.00,,"-46,800.66"
,IN,AR,30306451,1005,100,,Invoice,,,,,,22/01/2018,22/01/2018,0.00,,13.17,,"-46,813.83"
,IN,AR,30306452,1005,100,,Invoice,,,,,,22/01/2018,22/01/2018,0.00,,3.76,,"-46,817.59"
,IN,AR,30306575,1005,100,,Invoice,,,,,,22/01/2018,22/01/2018,0.00,,29.15,,"-46,846.74"
,IN,AR,30306585,1005,100,,Invoice,,,,,,22/01/2018,22/01/2018,0.00,,5.24,,"-46,851.98"
,IN,AR,30306587,1005,100,,Invoice,,,,,,22/01/2018,22/01/2018,0.00,,7.53,,"-46,859.51"
,IN,AR,30306589,1005,100,,Invoice,,,,,,22/01/2018,22/01/2018,0.00,,29.15,,"-46,888.66"
,IN,AR,30306590,1005,100,,Invoice,,,,,,22/01/2018,22/01/2018,0.00,,182.20,,"-47,070.86"
,IN,AR,30306591,1005,100,,Invoice,,,,,,22/01/2018,22/01/2018,0.00,,3.64,,"-47,074.50"
,IN,AR,30306594,1005,100,,Invoice,,,,,,22/01/2018,22/01/2018,0.00,,14.83,,"-47,089.33"
,IN,AR,30306607,1005,100,,Invoice,,,,,,22/01/2018,22/01/2018,0.00,,6.13,,"-47,095.46"
,CN,AR,31016869,1005,100,,Credit Note,,,,,,23/01/2018,23/01/2018,182.20,,0.00,,"-46,913.26"
,CN,AR,31016934,1005,100,,Credit Note,,,,,,23/01/2018,23/01/2018,7.29,,0.00,,"-46,905.97"
,CN,AR,31017123,1005,100,,Credit Note,,,,,,23/01/2018,23/01/2018,32.80,,0.00,,"-46,873.17"
,CN,AR,31017170,1005,100,,Credit Note,,,,,,23/01/2018,23/01/2018,16.08,,0.00,,"-46,857.09"
,CN,AR,31017209,1005,100,,Credit Note,,,,,,23/01/2018,23/01/2018,51.02,,0.00,,"-46,806.07"
,CS,AR,32000047,1005,100,,Cash sale,,,,,,23/01/2018,23/01/2018,0.00,,7.29,,"-46,813.36"
,CS,AR,32000070,1005,100,,Cash sale,,,,,,23/01/2018,23/01/2018,0.00,,7.29,,"-46,820.65"
,CS,AR,32000102,1005,100,,Cash sale,,,,,,23/01/2018,23/01/2018,0.00,,3.01,,"-46,823.66"
,CS,AR,32000143,1005,100,,Cash sale,,,,,,23/01/2018,23/01/2018,0.00,,10.93,,"-46,834.59"
,CS,AR,32000175,1005,100,,Cash sale,,,,,,23/01/2018,23/01/2018,0.00,,21.86,,"-46,856.45"
,CS,AR,32000223,1005,100,,Cash sale,,,,,,23/01/2018,23/01/2018,0.00,,7.29,,"-46,863.74"
,CS,AR,32000226,1005,100,,Cash sale,,,,,,23/01/2018,23/01/2018,0.00,,20.34,,"-46,884.08"
,CS,AR,32000271,1005,100,,Cash sale,,,,,,23/01/2018,23/01/2018,0.00,,5.85,,"-46,889.93"
,CS,AR,32000277,1005,100,,Cash sale,,,,,,23/01/2018,23/01/2018,0.00,,7.75,,"-46,897.68"
,CS,AR,32000282,1005,100,,Cash sale,,,,,,23/01/2018,23/01/2018,0.00,,5.68,,"-46,903.36"
,CS,AR,32000288,1005,100,,Cash sale,,,,,,23/01/2018,23/01/2018,0.00,,7.29,,"-46,910.65"
,CS,AR,32000308,1005,100,,Cash sale,,,,,,23/01/2018,23/01/2018,0.00,,5.17,,"-46,915.82"
,CS,AR,32000341,1005,100,,Cash sale,,,,,,23/01/2018,23/01/2018,0.00,,3.64,,"-46,919.46"
,CS,AR,32000355,1005,100,,Cash sale,,,,,,23/01/2018,23/01/2018,0.00,,6.43,,"-46,925.89"
,CS,AR,32000359,1005,100,,Cash sale,,,,,,23/01/2018,23/01/2018,0.00,,3.64,,"-46,929.53"
,CS,AR,32000444,1005,100,,Cash sale,,,,,,23/01/2018,23/01/2018,0.00,,12.97,,"-46,942.50"
,CS,AR,32000457,1005,100,,Cash sale,,,,,,23/01/2018,23/01/2018,0.00,,5.17,,"-46,947.67"
,CS,AR,32000477,1005,100,,Cash sale,,,,,,23/01/2018,23/01/2018,0.00,,5.17,,"-46,952.84"
,CS,AR,32000493,1005,100,,Cash sale,,,,,,23/01/2018,23/01/2018,0.00,,7.29,,"-46,960.13"
,CS,AR,32000504,1005,100,,Cash sale,,,,,,23/01/2018,23/01/2018,0.00,,10.34,,"-46,970.47"
,CS,AR,32000526,1005,100,,Cash sale,,,,,,23/01/2018,23/01/2018,0.00,,3.01,,"-46,973.48"
,CS,AR,32000563,1005,100,,Cash sale,,,,,,23/01/2018,23/01/2018,0.00,,7.29,,"-46,980.77"
,CS,AR,32000611,1005,100,,Cash sale,,,,,,23/01/2018,23/01/2018,0.00,,14.58,,"-46,995.35"
,CS,AR,32000652,1005,100,,Cash sale,,,,,,23/01/2018,23/01/2018,0.00,,35.59,,"-47,030.94"
,CS,AR,32000665,1005,100,,Cash sale,,,,,,23/01/2018,23/01/2018,0.00,,5.08,,"-47,036.02"
,CS,AR,32000669,1005,100,,Cash sale,,,,,,23/01/2018,23/01/2018,0.00,,24.00,,"-47,060.02"
,CS,AR,32000769,1005,100,,Cash sale,,,,,,23/01/2018,23/01/2018,0.00,,14.58,,"-47,074.60"
,CS,AR,32000771,1005,100,,Cash sale,,,,,,23/01/2018,23/01/2018,0.00,,3.64,,"-47,078.24"
,CS,AR,32000809,1005,100,,Cash sale,,,,,,23/01/2018,23/01/2018,0.00,,18.22,,"-47,096.46"
,CS,AR,32000814,1005,100,,Cash sale,,,,,,23/01/2018,23/01/2018,0.00,,7.29,,"-47,103.75"
,CS,AR,32000857,1005,100,,Cash sale,,,,,,23/01/2018,23/01/2018,0.00,,7.29,,"-47,111.04"
,CS,AR,32000860,1005,100,,Cash sale,,,,,,23/01/2018,23/01/2018,0.00,,29.15,,"-47,140.19"
,CS,AR,32000864,1005,100,,Cash sale,,,,,,23/01/2018,23/01/2018,0.00,,7.29,,"-47,147.48"
,CS,AR,32000902,1005,100,,Cash sale,,,,,,23/01/2018,23/01/2018,0.00,,3.64,,"-47,151.12"
,CS,AR,32000908,1005,100,,Cash sale,,,,,,23/01/2018,23/01/2018,0.00,,3.64,,"-47,154.76"
,IN,AR,30304446,1005,100,,Invoice,,,,,,23/01/2018,23/01/2018,0.00,,173.38,,"-47,328.14"
,IN,AR,30304465,1005,100,,Invoice,,,,,,23/01/2018,23/01/2018,0.00,,3.64,,"-47,331.78"
,IN,AR,30304469,1005,100,,Invoice,,,,,,23/01/2018,23/01/2018,0.00,,3.50,,"-47,335.28"
,IN,AR,30304505,1005,100,,Invoice,,,,,,23/01/2018,23/01/2018,0.00,,16.08,,"-47,351.36"
,IN,AR,30304532,1005,100,,Invoice,,,,,,23/01/2018,23/01/2018,0.00,,85.42,,"-47,436.78"
,IN,AR,30304571,1005,100,,Invoice,,,,,,23/01/2018,23/01/2018,0.00,,18.22,,"-47,455.00"
,IN,AR,30304620,1005,100,,Invoice,,,,,,23/01/2018,23/01/2018,0.00,,7.29,,"-47,462.29"
,IN,AR,30304642,1005,100,,Invoice,,,,,,23/01/2018,23/01/2018,0.00,,10.93,,"-47,473.22"
,IN,AR,30304644,1005,100,,Invoice,,,,,,23/01/2018,23/01/2018,0.00,,"3,644.07",,"-51,117.29"
,IN,AR,30304687,1005,100,,Invoice,,,,,,23/01/2018,23/01/2018,0.00,,10.93,,"-51,128.22"
,IN,AR,30304756,1005,100,,Invoice,,,,,,23/01/2018,23/01/2018,0.00,,16.48,,"-51,144.70"
,IN,AR,30304778,1005,100,,Invoice,,,,,,23/01/2018,23/01/2018,0.00,,7.29,,"-51,151.99"
,IN,AR,30304842,1005,100,,Invoice,,,,,,23/01/2018,23/01/2018,0.00,,6.97,,"-51,158.96"
,IN,AR,30304853,1005,100,,Invoice,,,,,,23/01/2018,23/01/2018,0.00,,7.19,,"-51,166.15"
,IN,AR,30304879,1005,100,,Invoice,,,,,,23/01/2018,23/01/2018,0.00,,4.32,,"-51,170.47"
,IN,AR,30304884,1005,100,,Invoice,,,,,,23/01/2018,23/01/2018,0.00,,5.17,,"-51,175.64"
,IN,AR,30304911,1005,100,,Invoice,,,,,,23/01/2018,23/01/2018,0.00,,28.47,,"-51,204.11"
,IN,AR,30305014,1005,100,,Invoice,,,,,,23/01/2018,23/01/2018,0.00,,11.69,,"-51,215.80"
,IN,AR,30305048,1005,100,,Invoice,,,,,,23/01/2018,23/01/2018,0.00,,12.58,,"-51,228.38"
,IN,AR,30305141,1005,100,,Invoice,,,,,,23/01/2018,23/01/2018,0.00,,55.14,,"-51,283.52"
,IN,AR,30305250,1005,100,,Invoice,,,,,,23/01/2018,23/01/2018,0.00,,7.97,,"-51,291.49"
,IN,AR,30305258,1005,100,,Invoice,,,,,,23/01/2018,23/01/2018,0.00,,7.29,,"-51,298.78"
,IN,AR,30305275,1005,100,,Invoice,,,,,,23/01/2018,23/01/2018,0.00,,12.71,,"-51,311.49"
,IN,AR,30305347,1005,100,,Invoice,,,,,,23/01/2018,23/01/2018,0.00,,10.93,,"-51,322.42"
,IN,AR,30305393,1005,100,,Invoice,,,,,,23/01/2018,23/01/2018,0.00,,4.08,,"-51,326.50"
,IN,AR,30305399,1005,100,,Invoice,,,,,,23/01/2018,23/01/2018,0.00,,8.26,,"-51,334.76"
,IN,AR,30305403,1005,100,,Invoice,,,,,,23/01/2018,23/01/2018,0.00,,2.39,,"-51,337.15"
,IN,AR,30305412,1005,100,,Invoice,,,,,,23/01/2018,23/01/2018,0.00,,10.17,,"-51,347.32"
,IN,AR,30305420,1005,100,,Invoice,,,,,,23/01/2018,23/01/2018,0.00,,12.28,,"-51,359.60"
,IN,AR,30305425,1005,100,,Invoice,,,,,,23/01/2018,23/01/2018,0.00,,3.64,,"-51,363.24"
,IN,AR,30305430,1005,100,,Invoice,,,,,,23/01/2018,23/01/2018,0.00,,14.58,,"-51,377.82"
,IN,AR,30305464,1005,100,,Invoice,,,,,,23/01/2018,23/01/2018,0.00,,10.34,,"-51,388.16"
,IN,AR,30305489,1005,100,,Invoice,,,,,,23/01/2018,23/01/2018,0.00,,4.29,,"-51,392.45"
,IN,AR,30305573,1005,100,,Invoice,,,,,,23/01/2018,23/01/2018,0.00,,10.93,,"-51,403.38"
,IN,AR,30305589,1005,100,,Invoice,,,,,,23/01/2018,23/01/2018,0.00,,14.58,,"-51,417.96"
,IN,AR,30305647,1005,100,,Invoice,,,,,,23/01/2018,23/01/2018,0.00,,17.54,,"-51,435.50"
,IN,AR,30305652,1005,100,,Invoice,,,,,,23/01/2018,23/01/2018,0.00,,7.29,,"-51,442.79"
,IN,AR,30305664,1005,100,,Invoice,,,,,,23/01/2018,23/01/2018,0.00,,70.97,,"-51,513.76"
,IN,AR,30305682,1005,100,,Invoice,,,,,,23/01/2018,23/01/2018,0.00,,5.59,,"-51,519.35"
,IN,AR,30305701,1005,100,,Invoice,,,,,,23/01/2018,23/01/2018,0.00,,8.52,,"-51,527.87"
,IN,AR,30305750,1005,100,,Invoice,,,,,,23/01/2018,23/01/2018,0.00,,103.81,,"-51,631.68"
,IN,AR,30305761,1005,100,,Invoice,,,,,,23/01/2018,23/01/2018,0.00,,6.53,,"-51,638.21"
,IN,AR,30305765,1005,100,,Invoice,,,,,,23/01/2018,23/01/2018,0.00,,14.58,,"-51,652.79"
,IN,AR,30305769,1005,100,,Invoice,,,,,,23/01/2018,23/01/2018,0.00,,17.15,,"-51,669.94"
,IN,AR,30305782,1005,100,,Invoice,,,,,,23/01/2018,23/01/2018,0.00,,21.44,,"-51,691.38"
,IN,AR,30305805,1005,100,,Invoice,,,,,,23/01/2018,23/01/2018,0.00,,5.29,,"-51,696.67"
,IN,AR,30305837,1005,100,,Invoice,,,,,,23/01/2018,23/01/2018,0.00,,5.17,,"-51,701.84"
,IN,AR,30305899,1005,100,,Invoice,,,,,,23/01/2018,23/01/2018,0.00,,29.15,,"-51,730.99"
,IN,AR,30305969,1005,100,,Invoice,,,,,,23/01/2018,23/01/2018,0.00,,8.52,,"-51,739.51"
,IN,AR,30306010,1005,100,,Invoice,,,,,,23/01/2018,23/01/2018,0.00,,3.64,,"-51,743.15"
,IN,AR,30306029,1005,100,,Invoice,,,,,,23/01/2018,23/01/2018,0.00,,183.66,,"-51,926.81"
,IN,AR,30306072,1005,100,,Invoice,,,,,,23/01/2018,23/01/2018,0.00,,6.42,,"-51,933.23"
,IN,AR,30306159,1005,100,,Invoice,,,,,,23/01/2018,23/01/2018,0.00,,12.71,,"-51,945.94"
,IN,AR,30306185,1005,100,,Invoice,,,,,,23/01/2018,23/01/2018,0.00,,222.29,,"-52,168.23"
,IN,AR,30306221,1005,100,,Invoice,,,,,,23/01/2018,23/01/2018,0.00,,14.58,,"-52,182.81"
,IN,AR,30306270,1005,100,,Invoice,,,,,,23/01/2018,23/01/2018,0.00,,8.21,,"-52,191.02"
,IN,AR,30306305,1005,100,,Invoice,,,,,,23/01/2018,23/01/2018,0.00,,126.00,,"-52,317.02"
,IN,AR,30306310,1005,100,,Invoice,,,,,,23/01/2018,23/01/2018,0.00,,9.10,,"-52,326.12"
,IN,AR,30306331,1005,100,,Invoice,,,,,,23/01/2018,23/01/2018,0.00,,28.47,,"-52,354.59"
,IN,AR,30306403,1005,100,,Invoice,,,,,,23/01/2018,23/01/2018,0.00,,94.92,,"-52,449.51"
,IN,AR,30306421,1005,100,,Invoice,,,,,,23/01/2018,23/01/2018,0.00,,18.98,,"-52,468.49"
,IN,AR,30306422,1005,100,,Invoice,,,,,,23/01/2018,23/01/2018,0.00,,113.91,,"-52,582.40"
,IN,AR,30306423,1005,100,,Invoice,,,,,,23/01/2018,23/01/2018,0.00,,35.59,,"-52,617.99"
,IN,AR,30306462,1005,100,,Invoice,,,,,,23/01/2018,23/01/2018,0.00,,3.51,,"-52,621.50"
,IN,AR,30306467,1005,100,,Invoice,,,,,,23/01/2018,23/01/2018,0.00,,4.00,,"-52,625.50"
,IN,AR,30306482,1005,100,,Invoice,,,,,,23/01/2018,23/01/2018,0.00,,90.76,,"-52,716.26"
,IN,AR,30306501,1005,100,,Invoice,,,,,,23/01/2018,23/01/2018,0.00,,7.02,,"-52,723.28"
,IN,AR,30306633,1005,100,,Invoice,,,,,,23/01/2018,23/01/2018,0.00,,16.48,,"-52,739.76"
,IN,AR,30306634,1005,100,,Invoice,,,,,,23/01/2018,23/01/2018,0.00,,13.73,,"-52,753.49"
,IN,AR,30306635,1005,100,,Invoice,,,,,,23/01/2018,23/01/2018,0.00,,8.24,,"-52,761.73"
,IN,AR,30306655,1005,100,,Invoice,,,,,,23/01/2018,23/01/2018,0.00,,29.15,,"-52,790.88"
,CS,AR,32000012,1005,100,,Cash sale,,,,,,24/01/2018,24/01/2018,0.00,,11.22,,"-52,802.10"
,CS,AR,32000023,1005,100,,Cash sale,,,,,,24/01/2018,24/01/2018,0.00,,30.10,,"-52,832.20"
,CS,AR,32000038,1005,100,,Cash sale,,,,,,24/01/2018,24/01/2018,0.00,,12.17,,"-52,844.37"
,CS,AR,32000063,1005,100,,Cash sale,,,,,,24/01/2018,24/01/2018,0.00,,3.64,,"-52,848.01"
,CS,AR,32000140,1005,100,,Cash sale,,,,,,24/01/2018,24/01/2018,0.00,,10.93,,"-52,858.94"
,CS,AR,32000146,1005,100,,Cash sale,,,,,,24/01/2018,24/01/2018,0.00,,7.29,,"-52,866.23"
,CS,AR,32000151,1005,100,,Cash sale,,,,,,24/01/2018,24/01/2018,0.00,,3.01,,"-52,869.24"
,CS,AR,32000187,1005,100,,Cash sale,,,,,,24/01/2018,24/01/2018,0.00,,9.03,,"-52,878.27"
,CS,AR,32000192,1005,100,,Cash sale,,,,,,24/01/2018,24/01/2018,0.00,,23.29,,"-52,901.56"
,CS,AR,32000201,1005,100,,Cash sale,,,,,,24/01/2018,24/01/2018,0.00,,3.64,,"-52,905.20"
,CS,AR,32000206,1005,100,,Cash sale,,,,,,24/01/2018,24/01/2018,0.00,,5.86,,"-52,911.06"
,CS,AR,32000245,1005,100,,Cash sale,,,,,,24/01/2018,24/01/2018,0.00,,14.58,,"-52,925.64"
,CS,AR,32000279,1005,100,,Cash sale,,,,,,24/01/2018,24/01/2018,0.00,,10.93,,"-52,936.57"
,CS,AR,32000305,1005,100,,Cash sale,,,,,,24/01/2018,24/01/2018,0.00,,3.64,,"-52,940.21"
,CS,AR,32000323,1005,100,,Cash sale,,,,,,24/01/2018,24/01/2018,0.00,,12.03,,"-52,952.24"
,CS,AR,32000328,1005,100,,Cash sale,,,,,,24/01/2018,24/01/2018,0.00,,10.93,,"-52,963.17"
,CS,AR,32000344,1005,100,,Cash sale,,,,,,24/01/2018,24/01/2018,0.00,,10.93,,"-52,974.10"
,CS,AR,32000348,1005,100,,Cash sale,,,,,,24/01/2018,24/01/2018,0.00,,10.93,,"-52,985.03"
,CS,AR,32000365,1005,100,,Cash sale,,,,,,24/01/2018,24/01/2018,0.00,,5.08,,"-52,990.11"
,CS,AR,32000418,1005,100,,Cash sale,,,,,,24/01/2018,24/01/2018,0.00,,4.32,,"-52,994.43"
,CS,AR,32000440,1005,100,,Cash sale,,,,,,24/01/2018,24/01/2018,0.00,,3.64,,"-52,998.07"
,CS,AR,32000512,1005,100,,Cash sale,,,,,,24/01/2018,24/01/2018,0.00,,10.93,,"-53,009.00"
,CS,AR,32000527,1005,100,,Cash sale,,,,,,24/01/2018,24/01/2018,0.00,,3.01,,"-53,012.01"
,CS,AR,32000530,1005,100,,Cash sale,,,,,,24/01/2018,24/01/2018,0.00,,10.85,,"-53,022.86"
,CS,AR,32000585,1005,100,,Cash sale,,,,,,24/01/2018,24/01/2018,0.00,,5.34,,"-53,028.20"
,CS,AR,32000609,1005,100,,Cash sale,,,,,,24/01/2018,24/01/2018,0.00,,4.88,,"-53,033.08"
,CS,AR,32000654,1005,100,,Cash sale,,,,,,24/01/2018,24/01/2018,0.00,,7.29,,"-53,040.37"
,CS,AR,32000686,1005,100,,Cash sale,,,,,,24/01/2018,24/01/2018,0.00,,14.58,,"-53,054.95"
,CS,AR,32000728,1005,100,,Cash sale,,,,,,24/01/2018,24/01/2018,0.00,,14.58,,"-53,069.53"
,CS,AR,32000731,1005,100,,Cash sale,,,,,,24/01/2018,24/01/2018,0.00,,6.07,,"-53,075.60"
,CS,AR,32000737,1005,100,,Cash sale,,,,,,24/01/2018,24/01/2018,0.00,,14.58,,"-53,090.18"
,CS,AR,32000761,1005,100,,Cash sale,,,,,,24/01/2018,24/01/2018,0.00,,15.04,,"-53,105.22"
,CS,AR,32000791,1005,100,,Cash sale,,,,,,24/01/2018,24/01/2018,0.00,,10.93,,"-53,116.15"
,CS,AR,32000820,1005,100,,Cash sale,,,,,,24/01/2018,24/01/2018,0.00,,3.03,,"-53,119.18"
,CS,AR,32000825,1005,100,,Cash sale,,,,,,24/01/2018,24/01/2018,0.00,,7.29,,"-53,126.47"
,CS,AR,32000868,1005,100,,Cash sale,,,,,,24/01/2018,24/01/2018,0.00,,7.29,,"-53,133.76"
,CS,AR,32000877,1005,100,,Cash sale,,,,,,24/01/2018,24/01/2018,0.00,,10.93,,"-53,144.69"
,CS,AR,32000878,1005,100,,Cash sale,,,,,,24/01/2018,24/01/2018,0.00,,7.29,,"-53,151.98"
,CS,AR,32000896,1005,100,,Cash sale,,,,,,24/01/2018,24/01/2018,0.00,,7.86,,"-53,159.84"
,CS,AR,32000914,1005,100,,Cash sale,,,,,,24/01/2018,24/01/2018,0.00,,10.99,,"-53,170.83"
,CS,AR,32000919,1005,100,,Cash sale,,,,,,24/01/2018,24/01/2018,0.00,,7.29,,"-53,178.12"
,IN,AR,30304372,1005,100,,Invoice,,,,,,24/01/2018,24/01/2018,0.00,,41.53,,"-53,219.65"
,IN,AR,30304373,1005,100,,Invoice,,,,,,24/01/2018,24/01/2018,0.00,,23.73,,"-53,243.38"
,IN,AR,30304417,1005,100,,Invoice,,,,,,24/01/2018,24/01/2018,0.00,,73.22,,"-53,316.60"
,IN,AR,30304418,1005,100,,Invoice,,,,,,24/01/2018,24/01/2018,0.00,,12.20,,"-53,328.80"
,IN,AR,30304424,1005,100,,Invoice,,,,,,24/01/2018,24/01/2018,0.00,,5.42,,"-53,334.22"
,IN,AR,30304437,1005,100,,Invoice,,,,,,24/01/2018,24/01/2018,0.00,,15.93,,"-53,350.15"
,IN,AR,30304457,1005,100,,Invoice,,,,,,24/01/2018,24/01/2018,0.00,,9.66,,"-53,359.81"
,IN,AR,30304496,1005,100,,Invoice,,,,,,24/01/2018,24/01/2018,0.00,,6.48,,"-53,366.29"
,IN,AR,30304591,1005,100,,Invoice,,,,,,24/01/2018,24/01/2018,0.00,,21.86,,"-53,388.15"
,IN,AR,30304612,1005,100,,Invoice,,,,,,24/01/2018,24/01/2018,0.00,,34.00,,"-53,422.15"
,IN,AR,30304653,1005,100,,Invoice,,,,,,24/01/2018,24/01/2018,0.00,,22.00,,"-53,444.15"
,IN,AR,30304666,1005,100,,Invoice,,,,,,24/01/2018,24/01/2018,0.00,,71.19,,"-53,515.34"
,IN,AR,30304719,1005,100,,Invoice,,,,,,24/01/2018,24/01/2018,0.00,,40.93,,"-53,556.27"
,IN,AR,30304720,1005,100,,Invoice,,,,,,24/01/2018,24/01/2018,0.00,,76.41,,"-53,632.68"
,IN,AR,30304721,1005,100,,Invoice,,,,,,24/01/2018,24/01/2018,0.00,,30.02,,"-53,662.70"
,IN,AR,30304783,1005,100,,Invoice,,,,,,24/01/2018,24/01/2018,0.00,,15.92,,"-53,678.62"
,IN,AR,30304890,1005,100,,Invoice,,,,,,24/01/2018,24/01/2018,0.00,,5.17,,"-53,683.79"
,IN,AR,30304895,1005,100,,Invoice,,,,,,24/01/2018,24/01/2018,0.00,,5.17,,"-53,688.96"
,IN,AR,30304912,1005,100,,Invoice,,,,,,24/01/2018,24/01/2018,0.00,,61.02,,"-53,749.98"
,IN,AR,30304928,1005,100,,Invoice,,,,,,24/01/2018,24/01/2018,0.00,,7.29,,"-53,757.27"
,IN,AR,30304933,1005,100,,Invoice,,,,,,24/01/2018,24/01/2018,0.00,,2.80,,"-53,760.07"
,IN,AR,30304949,1005,100,,Invoice,,,,,,24/01/2018,24/01/2018,0.00,,23.26,,"-53,783.33"
,IN,AR,30304999,1005,100,,Invoice,,,,,,24/01/2018,24/01/2018,0.00,,18.05,,"-53,801.38"
,IN,AR,30305027,1005,100,,Invoice,,,,,,24/01/2018,24/01/2018,0.00,,36.92,,"-53,838.30"
,IN,AR,30305041,1005,100,,Invoice,,,,,,24/01/2018,24/01/2018,0.00,,12.71,,"-53,851.01"
,IN,AR,30305042,1005,100,,Invoice,,,,,,24/01/2018,24/01/2018,0.00,,12.71,,"-53,863.72"
,IN,AR,30305043,1005,100,,Invoice,,,,,,24/01/2018,24/01/2018,0.00,,66.10,,"-53,929.82"
,IN,AR,30305054,1005,100,,Invoice,,,,,,24/01/2018,24/01/2018,0.00,,6.43,,"-53,936.25"
,IN,AR,30305093,1005,100,,Invoice,,,,,,24/01/2018,24/01/2018,0.00,,3.01,,"-53,939.26"
,IN,AR,30305116,1005,100,,Invoice,,,,,,24/01/2018,24/01/2018,0.00,,20.88,,"-53,960.14"
,IN,AR,30305127,1005,100,,Invoice,,,,,,24/01/2018,24/01/2018,0.00,,10.34,,"-53,970.48"
,IN,AR,30305158,1005,100,,Invoice,,,,,,24/01/2018,24/01/2018,0.00,,174.05,,"-54,144.53"
,IN,AR,30305229,1005,100,,Invoice,,,,,,24/01/2018,24/01/2018,0.00,,7.63,,"-54,152.16"
,IN,AR,30305230,1005,100,,Invoice,,,,,,24/01/2018,24/01/2018,0.00,,5.08,,"-54,157.24"
,IN,AR,30305365,1005,100,,Invoice,,,,,,24/01/2018,24/01/2018,0.00,,13.63,,"-54,170.87"
,IN,AR,30305385,1005,100,,Invoice,,,,,,24/01/2018,24/01/2018,0.00,,27.50,,"-54,198.37"
,IN,AR,30305413,1005,100,,Invoice,,,,,,24/01/2018,24/01/2018,0.00,,10.17,,"-54,208.54"
,IN,AR,30305427,1005,100,,Invoice,,,,,,24/01/2018,24/01/2018,0.00,,16.48,,"-54,225.02"
,IN,AR,30305547,1005,100,,Invoice,,,,,,24/01/2018,24/01/2018,0.00,,23.73,,"-54,248.75"
,IN,AR,30305548,1005,100,,Invoice,,,,,,24/01/2018,24/01/2018,0.00,,32.63,,"-54,281.38"
,IN,AR,30305556,1005,100,,Invoice,,,,,,24/01/2018,24/01/2018,0.00,,13.73,,"-54,295.11"
,IN,AR,30305598,1005,100,,Invoice,,,,,,24/01/2018,24/01/2018,0.00,,14.58,,"-54,309.69"
,IN,AR,30305621,1005,100,,Invoice,,,,,,24/01/2018,24/01/2018,0.00,,55.93,,"-54,365.62"
,IN,AR,30305653,1005,100,,Invoice,,,,,,24/01/2018,24/01/2018,0.00,,9.66,,"-54,375.28"
,IN,AR,30305718,1005,100,,Invoice,,,,,,24/01/2018,24/01/2018,0.00,,3.64,,"-54,378.92"
,IN,AR,30305721,1005,100,,Invoice,,,,,,24/01/2018,24/01/2018,0.00,,11.23,,"-54,390.15"
,IN,AR,30305728,1005,100,,Invoice,,,,,,24/01/2018,24/01/2018,0.00,,21.06,,"-54,411.21"
,IN,AR,30305735,1005,100,,Invoice,,,,,,24/01/2018,24/01/2018,0.00,,24.07,,"-54,435.28"
,IN,AR,30305806,1005,100,,Invoice,,,,,,24/01/2018,24/01/2018,0.00,,15.86,,"-54,451.14"
,IN,AR,30305807,1005,100,,Invoice,,,,,,24/01/2018,24/01/2018,0.00,,7.05,,"-54,458.19"
,IN,AR,30305813,1005,100,,Invoice,,,,,,24/01/2018,24/01/2018,0.00,,3.01,,"-54,461.20"
,IN,AR,30305849,1005,100,,Invoice,,,,,,24/01/2018,24/01/2018,0.00,,2.58,,"-54,463.78"
,IN,AR,30305856,1005,100,,Invoice,,,,,,24/01/2018,24/01/2018,0.00,,18.22,,"-54,482.00"
,IN,AR,30305864,1005,100,,Invoice,,,,,,24/01/2018,24/01/2018,0.00,,5.86,,"-54,487.86"
,IN,AR,30305868,1005,100,,Invoice,,,,,,24/01/2018,24/01/2018,0.00,,10.00,,"-54,497.86"
,IN,AR,30305929,1005,100,,Invoice,,,,,,24/01/2018,24/01/2018,0.00,,4.58,,"-54,502.44"
,IN,AR,30305976,1005,100,,Invoice,,,,,,24/01/2018,24/01/2018,0.00,,40.00,,"-54,542.44"
,IN,AR,30305987,1005,100,,Invoice,,,,,,24/01/2018,24/01/2018,0.00,,10.93,,"-54,553.37"
,IN,AR,30306007,1005,100,,Invoice,,,,,,24/01/2018,24/01/2018,0.00,,14.58,,"-54,567.95"
,IN,AR,30306073,1005,100,,Invoice,,,,,,24/01/2018,24/01/2018,0.00,,1.60,,"-54,569.55"
,IN,AR,30306074,1005,100,,Invoice,,,,,,24/01/2018,24/01/2018,0.00,,3.20,,"-54,572.75"
,IN,AR,30306075,1005,100,,Invoice,,,,,,24/01/2018,24/01/2018,0.00,,1.60,,"-54,574.35"
,IN,AR,30306076,1005,100,,Invoice,,,,,,24/01/2018,24/01/2018,0.00,,4.81,,"-54,579.16"
,IN,AR,30306077,1005,100,,Invoice,,,,,,24/01/2018,24/01/2018,0.00,,16.03,,"-54,595.19"
,IN,AR,30306078,1005,100,,Invoice,,,,,,24/01/2018,24/01/2018,0.00,,8.02,,"-54,603.21"
,IN,AR,30306079,1005,100,,Invoice,,,,,,24/01/2018,24/01/2018,0.00,,4.81,,"-54,608.02"
,IN,AR,30306118,1005,100,,Invoice,,,,,,24/01/2018,24/01/2018,0.00,,15.27,,"-54,623.29"
,IN,AR,30306129,1005,100,,Invoice,,,,,,24/01/2018,24/01/2018,0.00,,18.11,,"-54,641.40"
,IN,AR,30306139,1005,100,,Invoice,,,,,,24/01/2018,24/01/2018,0.00,,"1,093.22",,"-55,734.62"
,IN,AR,30306206,1005,100,,Invoice,,,,,,24/01/2018,24/01/2018,0.00,,3.02,,"-55,737.64"
,IN,AR,30306233,1005,100,,Invoice,,,,,,24/01/2018,24/01/2018,0.00,,16.82,,"-55,754.46"
,IN,AR,30306260,1005,100,,Invoice,,,,,,24/01/2018,24/01/2018,0.00,,24.16,,"-55,778.62"
,IN,AR,30306366,1005,100,,Invoice,,,,,,24/01/2018,24/01/2018,0.00,,40.58,,"-55,819.20"
,IN,AR,30306392,1005,100,,Invoice,,,,,,24/01/2018,24/01/2018,0.00,,119.49,,"-55,938.69"
,IN,AR,30306393,1005,100,,Invoice,,,,,,24/01/2018,24/01/2018,0.00,,4.78,,"-55,943.47"
,IN,AR,30306458,1005,100,,Invoice,,,,,,24/01/2018,24/01/2018,0.00,,5.26,,"-55,948.73"
,IN,AR,30306520,1005,100,,Invoice,,,,,,24/01/2018,24/01/2018,0.00,,29.15,,"-55,977.88"
,IN,AR,30306536,1005,100,,Invoice,,,,,,24/01/2018,24/01/2018,0.00,,5.64,,"-55,983.52"
,IN,AR,30306581,1005,100,,Invoice,,,,,,24/01/2018,24/01/2018,0.00,,145.76,,"-56,129.28"
,IN,AR,30306600,1005,100,,Invoice,,,,,,24/01/2018,24/01/2018,0.00,,16.78,,"-56,146.06"
,IN,AR,30306626,1005,100,,Invoice,,,,,,24/01/2018,24/01/2018,0.00,,38.44,,"-56,184.50"
,IN,AR,30306636,1005,100,,Invoice,,,,,,24/01/2018,24/01/2018,0.00,,8.24,,"-56,192.74"
,IN,AR,30306656,1005,100,,Invoice,,,,,,24/01/2018,24/01/2018,0.00,,16.47,,"-56,209.21"
,CN,AR,31016991,1005,100,,Credit Note,,,,,,25/01/2018,25/01/2018,29.15,,0.00,,"-56,180.06"
,CN,AR,31017083,1005,100,,Credit Note,,,,,,25/01/2018,25/01/2018,182.20,,0.00,,"-55,997.86"
,CS,AR,32000006,1005,100,,Cash sale,,,,,,25/01/2018,25/01/2018,0.00,,24.07,,"-56,021.93"
,CS,AR,32000042,1005,100,,Cash sale,,,,,,25/01/2018,25/01/2018,0.00,,7.29,,"-56,029.22"
,CS,AR,32000083,1005,100,,Cash sale,,,,,,25/01/2018,25/01/2018,0.00,,3.64,,"-56,032.86"
,CS,AR,32000098,1005,100,,Cash sale,,,,,,25/01/2018,25/01/2018,0.00,,7.29,,"-56,040.15"
,CS,AR,32000107,1005,100,,Cash sale,,,,,,25/01/2018,25/01/2018,0.00,,3.64,,"-56,043.79"
,CS,AR,32000127,1005,100,,Cash sale,,,,,,25/01/2018,25/01/2018,0.00,,7.29,,"-56,051.08"
,CS,AR,32000155,1005,100,,Cash sale,,,,,,25/01/2018,25/01/2018,0.00,,3.64,,"-56,054.72"
,CS,AR,32000162,1005,100,,Cash sale,,,,,,25/01/2018,25/01/2018,0.00,,3.64,,"-56,058.36"
,CS,AR,32000174,1005,100,,Cash sale,,,,,,25/01/2018,25/01/2018,0.00,,14.58,,"-56,072.94"
,CS,AR,32000197,1005,100,,Cash sale,,,,,,25/01/2018,25/01/2018,0.00,,6.02,,"-56,078.96"
,CS,AR,32000211,1005,100,,Cash sale,,,,,,25/01/2018,25/01/2018,0.00,,7.29,,"-56,086.25"
,CS,AR,32000222,1005,100,,Cash sale,,,,,,25/01/2018,25/01/2018,0.00,,5.17,,"-56,091.42"
,CS,AR,32000243,1005,100,,Cash sale,,,,,,25/01/2018,25/01/2018,0.00,,7.29,,"-56,098.71"
,CS,AR,32000259,1005,100,,Cash sale,,,,,,25/01/2018,25/01/2018,0.00,,18.11,,"-56,116.82"
,CS,AR,32000381,1005,100,,Cash sale,,,,,,25/01/2018,25/01/2018,0.00,,2.58,,"-56,119.40"
,CS,AR,32000412,1005,100,,Cash sale,,,,,,25/01/2018,25/01/2018,0.00,,6.13,,"-56,125.53"
,CS,AR,32000422,1005,100,,Cash sale,,,,,,25/01/2018,25/01/2018,0.00,,5.17,,"-56,130.70"
,CS,AR,32000436,1005,100,,Cash sale,,,,,,25/01/2018,25/01/2018,0.00,,19.28,,"-56,149.98"
,CS,AR,32000450,1005,100,,Cash sale,,,,,,25/01/2018,25/01/2018,0.00,,5.08,,"-56,155.06"
,CS,AR,32000497,1005,100,,Cash sale,,,,,,25/01/2018,25/01/2018,0.00,,27.97,,"-56,183.03"
,CS,AR,32000506,1005,100,,Cash sale,,,,,,25/01/2018,25/01/2018,0.00,,10.93,,"-56,193.96"
,CS,AR,32000547,1005,100,,Cash sale,,,,,,25/01/2018,25/01/2018,0.00,,5.17,,"-56,199.13"
,CS,AR,32000578,1005,100,,Cash sale,,,,,,25/01/2018,25/01/2018,0.00,,13.90,,"-56,213.03"
,CS,AR,32000580,1005,100,,Cash sale,,,,,,25/01/2018,25/01/2018,0.00,,10.93,,"-56,223.96"
,CS,AR,32000589,1005,100,,Cash sale,,,,,,25/01/2018,25/01/2018,0.00,,7.53,,"-56,231.49"
,CS,AR,32000614,1005,100,,Cash sale,,,,,,25/01/2018,25/01/2018,0.00,,7.29,,"-56,238.78"
,CS,AR,32000618,1005,100,,Cash sale,,,,,,25/01/2018,25/01/2018,0.00,,5.24,,"-56,244.02"
,CS,AR,32000622,1005,100,,Cash sale,,,,,,25/01/2018,25/01/2018,0.00,,20.34,,"-56,264.36"
,CS,AR,32000644,1005,100,,Cash sale,,,,,,25/01/2018,25/01/2018,0.00,,10.93,,"-56,275.29"
,CS,AR,32000650,1005,100,,Cash sale,,,,,,25/01/2018,25/01/2018,0.00,,14.58,,"-56,289.87"
,CS,AR,32000660,1005,100,,Cash sale,,,,,,25/01/2018,25/01/2018,0.00,,29.15,,"-56,319.02"
,CS,AR,32000685,1005,100,,Cash sale,,,,,,25/01/2018,25/01/2018,0.00,,13.77,,"-56,332.79"
,CS,AR,32000690,1005,100,,Cash sale,,,,,,25/01/2018,25/01/2018,0.00,,8.20,,"-56,340.99"
,CS,AR,32000726,1005,100,,Cash sale,,,,,,25/01/2018,25/01/2018,0.00,,14.58,,"-56,355.57"
,CS,AR,32000763,1005,100,,Cash sale,,,,,,25/01/2018,25/01/2018,0.00,,10.93,,"-56,366.50"
,CS,AR,32000768,1005,100,,Cash sale,,,,,,25/01/2018,25/01/2018,0.00,,7.29,,"-56,373.79"
,CS,AR,32000884,1005,100,,Cash sale,,,,,,25/01/2018,25/01/2018,0.00,,5.86,,"-56,379.65"
,CS,AR,32000895,1005,100,,Cash sale,,,,,,25/01/2018,25/01/2018,0.00,,10.93,,"-56,390.58"
,IN,AR,30304374,1005,100,,Invoice,,,,,,25/01/2018,25/01/2018,0.00,,29.66,,"-56,420.24"
,IN,AR,30304384,1005,100,,Invoice,,,,,,25/01/2018,25/01/2018,0.00,,3.64,,"-56,423.88"
,IN,AR,30304401,1005,100,,Invoice,,,,,,25/01/2018,25/01/2018,0.00,,182.20,,"-56,606.08"
,IN,AR,30304408,1005,100,,Invoice,,,,,,25/01/2018,25/01/2018,0.00,,14.58,,"-56,620.66"
,IN,AR,30304462,1005,100,,Invoice,,,,,,25/01/2018,25/01/2018,0.00,,7.29,,"-56,627.95"
,IN,AR,30304502,1005,100,,Invoice,,,,,,25/01/2018,25/01/2018,0.00,,10.93,,"-56,638.88"
,IN,AR,30304533,1005,100,,Invoice,,,,,,25/01/2018,25/01/2018,0.00,,26.10,,"-56,664.98"
,IN,AR,30304594,1005,100,,Invoice,,,,,,25/01/2018,25/01/2018,0.00,,7.29,,"-56,672.27"
,IN,AR,30304618,1005,100,,Invoice,,,,,,25/01/2018,25/01/2018,0.00,,3.64,,"-56,675.91"
,IN,AR,30304694,1005,100,,Invoice,,,,,,25/01/2018,25/01/2018,0.00,,30.20,,"-56,706.11"
,IN,AR,30304731,1005,100,,Invoice,,,,,,25/01/2018,25/01/2018,0.00,,15.51,,"-56,721.62"
,IN,AR,30304784,1005,100,,Invoice,,,,,,25/01/2018,25/01/2018,0.00,,10.61,,"-56,732.23"
,IN,AR,30304815,1005,100,,Invoice,,,,,,25/01/2018,25/01/2018,0.00,,18.22,,"-56,750.45"
,IN,AR,30304819,1005,100,,Invoice,,,,,,25/01/2018,25/01/2018,0.00,,18.22,,"-56,768.67"
,IN,AR,30304824,1005,100,,Invoice,,,,,,25/01/2018,25/01/2018,0.00,,17.50,,"-56,786.17"
,IN,AR,30304929,1005,100,,Invoice,,,,,,25/01/2018,25/01/2018,0.00,,3.64,,"-56,789.81"
,IN,AR,30304979,1005,100,,Invoice,,,,,,25/01/2018,25/01/2018,0.00,,31.05,,"-56,820.86"
,IN,AR,30304986,1005,100,,Invoice,,,,,,25/01/2018,25/01/2018,0.00,,"1,093.22",,"-57,914.08"
,IN,AR,30304995,1005,100,,Invoice,,,,,,25/01/2018,25/01/2018,0.00,,28.68,,"-57,942.76"
,IN,AR,30305004,1005,100,,Invoice,,,,,,25/01/2018,25/01/2018,0.00,,9.56,,"-57,952.32"
,IN,AR,30305018,1005,100,,Invoice,,,,,,25/01/2018,25/01/2018,0.00,,22.03,,"-57,974.35"
,IN,AR,30305071,1005,100,,Invoice,,,,,,25/01/2018,25/01/2018,0.00,,26.29,,"-58,000.64"
,IN,AR,30305081,1005,100,,Invoice,,,,,,25/01/2018,25/01/2018,0.00,,9.66,,"-58,010.30"
,IN,AR,30305086,1005,100,,Invoice,,,,,,25/01/2018,25/01/2018,0.00,,9.66,,"-58,019.96"
,IN,AR,30305123,1005,100,,Invoice,,,,,,25/01/2018,25/01/2018,0.00,,15.04,,"-58,035.00"
,IN,AR,30305202,1005,100,,Invoice,,,,,,25/01/2018,25/01/2018,0.00,,10.34,,"-58,045.34"
,IN,AR,30305213,1005,100,,Invoice,,,,,,25/01/2018,25/01/2018,0.00,,2.39,,"-58,047.73"
,IN,AR,30305231,1005,100,,Invoice,,,,,,25/01/2018,25/01/2018,0.00,,15.25,,"-58,062.98"
,IN,AR,30305232,1005,100,,Invoice,,,,,,25/01/2018,25/01/2018,0.00,,5.08,,"-58,068.06"
,IN,AR,30305251,1005,100,,Invoice,,,,,,25/01/2018,25/01/2018,0.00,,44.61,,"-58,112.67"
,IN,AR,30305252,1005,100,,Invoice,,,,,,25/01/2018,25/01/2018,0.00,,54.17,,"-58,166.84"
,IN,AR,30305257,1005,100,,Invoice,,,,,,25/01/2018,25/01/2018,0.00,,23.91,,"-58,190.75"
,IN,AR,30305267,1005,100,,Invoice,,,,,,25/01/2018,25/01/2018,0.00,,2.58,,"-58,193.33"
,IN,AR,30305428,1005,100,,Invoice,,,,,,25/01/2018,25/01/2018,0.00,,21.98,,"-58,215.31"
,IN,AR,30305462,1005,100,,Invoice,,,,,,25/01/2018,25/01/2018,0.00,,14.58,,"-58,229.89"
,IN,AR,30305506,1005,100,,Invoice,,,,,,25/01/2018,25/01/2018,0.00,,8.26,,"-58,238.15"
,IN,AR,30305513,1005,100,,Invoice,,,,,,25/01/2018,25/01/2018,0.00,,10.98,,"-58,249.13"
,IN,AR,30305561,1005,100,,Invoice,,,,,,25/01/2018,25/01/2018,0.00,,14.00,,"-58,263.13"
,IN,AR,30305584,1005,100,,Invoice,,,,,,25/01/2018,25/01/2018,0.00,,182.20,,"-58,445.33"
,IN,AR,30305657,1005,100,,Invoice,,,,,,25/01/2018,25/01/2018,0.00,,6.97,,"-58,452.30"
,IN,AR,30305670,1005,100,,Invoice,,,,,,25/01/2018,25/01/2018,0.00,,5.85,,"-58,458.15"
,IN,AR,30305673,1005,100,,Invoice,,,,,,25/01/2018,25/01/2018,0.00,,18.22,,"-58,476.37"
,IN,AR,30305717,1005,100,,Invoice,,,,,,25/01/2018,25/01/2018,0.00,,14.58,,"-58,490.95"
,IN,AR,30305743,1005,100,,Invoice,,,,,,25/01/2018,25/01/2018,0.00,,16.48,,"-58,507.43"
,IN,AR,30305754,1005,100,,Invoice,,,,,,25/01/2018,25/01/2018,0.00,,19.41,,"-58,526.84"
,IN,AR,30305759,1005,100,,Invoice,,,,,,25/01/2018,25/01/2018,0.00,,7.63,,"-58,534.47"
,IN,AR,30305768,1005,100,,Invoice,,,,,,25/01/2018,25/01/2018,0.00,,36.91,,"-58,571.38"
,IN,AR,30305774,1005,100,,Invoice,,,,,,25/01/2018,25/01/2018,0.00,,10.00,,"-58,581.38"
,IN,AR,30305783,1005,100,,Invoice,,,,,,25/01/2018,25/01/2018,0.00,,60.03,,"-58,641.41"
,IN,AR,30305808,1005,100,,Invoice,,,,,,25/01/2018,25/01/2018,0.00,,10.57,,"-58,651.98"
,IN,AR,30305820,1005,100,,Invoice,,,,,,25/01/2018,25/01/2018,0.00,,18.22,,"-58,670.20"
,IN,AR,30305832,1005,100,,Invoice,,,,,,25/01/2018,25/01/2018,0.00,,4.54,,"-58,674.74"
,IN,AR,30305876,1005,100,,Invoice,,,,,,25/01/2018,25/01/2018,0.00,,7.29,,"-58,682.03"
,IN,AR,30305877,1005,100,,Invoice,,,,,,25/01/2018,25/01/2018,0.00,,32.80,,"-58,714.83"
,IN,AR,30305878,1005,100,,Invoice,,,,,,25/01/2018,25/01/2018,0.00,,7.29,,"-58,722.12"
,IN,AR,30305896,1005,100,,Invoice,,,,,,25/01/2018,25/01/2018,0.00,,8.52,,"-58,730.64"
,IN,AR,30305910,1005,100,,Invoice,,,,,,25/01/2018,25/01/2018,0.00,,8.16,,"-58,738.80"
,IN,AR,30305918,1005,100,,Invoice,,,,,,25/01/2018,25/01/2018,0.00,,7.29,,"-58,746.09"
,IN,AR,30305942,1005,100,,Invoice,,,,,,25/01/2018,25/01/2018,0.00,,8.14,,"-58,754.23"
,IN,AR,30305943,1005,100,,Invoice,,,,,,25/01/2018,25/01/2018,0.00,,9.76,,"-58,763.99"
,IN,AR,30305944,1005,100,,Invoice,,,,,,25/01/2018,25/01/2018,0.00,,40.68,,"-58,804.67"
,IN,AR,30305945,1005,100,,Invoice,,,,,,25/01/2018,25/01/2018,0.00,,3.25,,"-58,807.92"
,IN,AR,30305959,1005,100,,Invoice,,,,,,25/01/2018,25/01/2018,0.00,,15.90,,"-58,823.82"
,IN,AR,30305960,1005,100,,Invoice,,,,,,25/01/2018,25/01/2018,0.00,,9.54,,"-58,833.36"
,IN,AR,30305961,1005,100,,Invoice,,,,,,25/01/2018,25/01/2018,0.00,,7.95,,"-58,841.31"
,IN,AR,30305984,1005,100,,Invoice,,,,,,25/01/2018,25/01/2018,0.00,,15.71,,"-58,857.02"
,IN,AR,30306015,1005,100,,Invoice,,,,,,25/01/2018,25/01/2018,0.00,,3.64,,"-58,860.66"
,IN,AR,30306025,1005,100,,Invoice,,,,,,25/01/2018,25/01/2018,0.00,,34.58,,"-58,895.24"
,IN,AR,30306031,1005,100,,Invoice,,,,,,25/01/2018,25/01/2018,0.00,,21.86,,"-58,917.10"
,IN,AR,30306080,1005,100,,Invoice,,,,,,25/01/2018,25/01/2018,0.00,,9.62,,"-58,926.72"
,IN,AR,30306081,1005,100,,Invoice,,,,,,25/01/2018,25/01/2018,0.00,,12.83,,"-58,939.55"
,IN,AR,30306082,1005,100,,Invoice,,,,,,25/01/2018,25/01/2018,0.00,,6.42,,"-58,945.97"
,IN,AR,30306112,1005,100,,Invoice,,,,,,25/01/2018,25/01/2018,0.00,,3.28,,"-58,949.25"
,IN,AR,30306124,1005,100,,Invoice,,,,,,25/01/2018,25/01/2018,0.00,,3.64,,"-58,952.89"
,IN,AR,30306149,1005,100,,Invoice,,,,,,25/01/2018,25/01/2018,0.00,,7.29,,"-58,960.18"
,IN,AR,30306160,1005,100,,Invoice,,,,,,25/01/2018,25/01/2018,0.00,,30.51,,"-58,990.69"
,IN,AR,30306161,1005,100,,Invoice,,,,,,25/01/2018,25/01/2018,0.00,,17.80,,"-59,008.49"
,IN,AR,30306166,1005,100,,Invoice,,,,,,25/01/2018,25/01/2018,0.00,,28.01,,"-59,036.50"
,IN,AR,30306179,1005,100,,Invoice,,,,,,25/01/2018,25/01/2018,0.00,,18.01,,"-59,054.51"
,IN,AR,30306279,1005,100,,Invoice,,,,,,25/01/2018,25/01/2018,0.00,,25.25,,"-59,079.76"
,IN,AR,30306294,1005,100,,Invoice,,,,,,25/01/2018,25/01/2018,0.00,,11.36,,"-59,091.12"
,IN,AR,30306394,1005,100,,Invoice,,,,,,25/01/2018,25/01/2018,0.00,,9.56,,"-59,100.68"
,IN,AR,30306395,1005,100,,Invoice,,,,,,25/01/2018,25/01/2018,0.00,,9.56,,"-59,110.24"
,IN,AR,30306396,1005,100,,Invoice,,,,,,25/01/2018,25/01/2018,0.00,,12.75,,"-59,122.99"
,IN,AR,30306397,1005,100,,Invoice,,,,,,25/01/2018,25/01/2018,0.00,,19.12,,"-59,142.11"
,IN,AR,30306430,1005,100,,Invoice,,,,,,25/01/2018,25/01/2018,0.00,,16.27,,"-59,158.38"
,IN,AR,30306475,1005,100,,Invoice,,,,,,25/01/2018,25/01/2018,0.00,,11.36,,"-59,169.74"
,IN,AR,30306577,1005,100,,Invoice,,,,,,25/01/2018,25/01/2018,0.00,,10.93,,"-59,180.67"
,IN,AR,30306612,1005,100,,Invoice,,,,,,25/01/2018,25/01/2018,0.00,,8.17,,"-59,188.84"
,IN,AR,30306637,1005,100,,Invoice,,,,,,25/01/2018,25/01/2018,0.00,,8.24,,"-59,197.08"
,IN,AR,30306649,1005,100,,Invoice,,,,,,25/01/2018,25/01/2018,0.00,,14.58,,"-59,211.66"
,IN,AR,30306652,1005,100,,Invoice,,,,,,25/01/2018,25/01/2018,0.00,,29.15,,"-59,240.81"
,IN,AR,30306658,1005,100,,Invoice,,,,,,25/01/2018,25/01/2018,0.00,,57.66,,"-59,298.47"
,IN,AR,30306660,1005,100,,Invoice,,,,,,25/01/2018,25/01/2018,0.00,,10.93,,"-59,309.40"
,CS,AR,32000003,1005,100,,Cash sale,,,,,,26/01/2018,26/01/2018,0.00,,18.22,,"-59,327.62"
,CS,AR,32000031,1005,100,,Cash sale,,,,,,26/01/2018,26/01/2018,0.00,,7.12,,"-59,334.74"
,CS,AR,32000054,1005,100,,Cash sale,,,,,,26/01/2018,26/01/2018,0.00,,18.22,,"-59,352.96"
,CS,AR,32000060,1005,100,,Cash sale,,,,,,26/01/2018,26/01/2018,0.00,,7.29,,"-59,360.25"
,CS,AR,32000062,1005,100,,Cash sale,,,,,,26/01/2018,26/01/2018,0.00,,14.58,,"-59,374.83"
,CS,AR,32000072,1005,100,,Cash sale,,,,,,26/01/2018,26/01/2018,0.00,,29.15,,"-59,403.98"
,CS,AR,32000091,1005,100,,Cash sale,,,,,,26/01/2018,26/01/2018,0.00,,18.22,,"-59,422.20"
,CS,AR,32000101,1005,100,,Cash sale,,,,,,26/01/2018,26/01/2018,0.00,,9.66,,"-59,431.86"
,CS,AR,32000117,1005,100,,Cash sale,,,,,,26/01/2018,26/01/2018,0.00,,14.24,,"-59,446.10"
,CS,AR,32000125,1005,100,,Cash sale,,,,,,26/01/2018,26/01/2018,0.00,,7.29,,"-59,453.39"
,CS,AR,32000135,1005,100,,Cash sale,,,,,,26/01/2018,26/01/2018,0.00,,14.53,,"-59,467.92"
,CS,AR,32000142,1005,100,,Cash sale,,,,,,26/01/2018,26/01/2018,0.00,,7.29,,"-59,475.21"
,CS,AR,32000167,1005,100,,Cash sale,,,,,,26/01/2018,26/01/2018,0.00,,3.64,,"-59,478.85"
,CS,AR,32000250,1005,100,,Cash sale,,,,,,26/01/2018,26/01/2018,0.00,,18.22,,"-59,497.07"
,CS,AR,32000253,1005,100,,Cash sale,,,,,,26/01/2018,26/01/2018,0.00,,5.17,,"-59,502.24"
,CS,AR,32000269,1005,100,,Cash sale,,,,,,26/01/2018,26/01/2018,0.00,,5.08,,"-59,507.32"
,CS,AR,32000273,1005,100,,Cash sale,,,,,,26/01/2018,26/01/2018,0.00,,19.58,,"-59,526.90"
,CS,AR,32000287,1005,100,,Cash sale,,,,,,26/01/2018,26/01/2018,0.00,,3.64,,"-59,530.54"
,CS,AR,32000297,1005,100,,Cash sale,,,,,,26/01/2018,26/01/2018,0.00,,8.25,,"-59,538.79"
,CS,AR,32000306,1005,100,,Cash sale,,,,,,26/01/2018,26/01/2018,0.00,,20.68,,"-59,559.47"
,CS,AR,32000318,1005,100,,Cash sale,,,,,,26/01/2018,26/01/2018,0.00,,13.74,,"-59,573.21"
,CS,AR,32000331,1005,100,,Cash sale,,,,,,26/01/2018,26/01/2018,0.00,,7.29,,"-59,580.50"
,CS,AR,32000338,1005,100,,Cash sale,,,,,,26/01/2018,26/01/2018,0.00,,6.02,,"-59,586.52"
,CS,AR,32000373,1005,100,,Cash sale,,,,,,26/01/2018,26/01/2018,0.00,,7.63,,"-59,594.15"
,CS,AR,32000387,1005,100,,Cash sale,,,,,,26/01/2018,26/01/2018,0.00,,20.47,,"-59,614.62"
,CS,AR,32000390,1005,100,,Cash sale,,,,,,26/01/2018,26/01/2018,0.00,,6.74,,"-59,621.36"
,CS,AR,32000409,1005,100,,Cash sale,,,,,,26/01/2018,26/01/2018,0.00,,24.07,,"-59,645.43"
,CS,AR,32000466,1005,100,,Cash sale,,,,,,26/01/2018,26/01/2018,0.00,,25.51,,"-59,670.94"
,CS,AR,32000534,1005,100,,Cash sale,,,,,,26/01/2018,26/01/2018,0.00,,20.48,,"-59,691.42"
,CS,AR,32000536,1005,100,,Cash sale,,,,,,26/01/2018,26/01/2018,0.00,,14.58,,"-59,706.00"
,CS,AR,32000550,1005,100,,Cash sale,,,,,,26/01/2018,26/01/2018,0.00,,27.77,,"-59,733.77"
,CS,AR,32000571,1005,100,,Cash sale,,,,,,26/01/2018,26/01/2018,0.00,,2.58,,"-59,736.35"
,CS,AR,32000593,1005,100,,Cash sale,,,,,,26/01/2018,26/01/2018,0.00,,10.93,,"-59,747.28"
,CS,AR,32000610,1005,100,,Cash sale,,,,,,26/01/2018,26/01/2018,0.00,,7.29,,"-59,754.57"
,CS,AR,32000623,1005,100,,Cash sale,,,,,,26/01/2018,26/01/2018,0.00,,2.54,,"-59,757.11"
,CS,AR,32000679,1005,100,,Cash sale,,,,,,26/01/2018,26/01/2018,0.00,,8.52,,"-59,765.63"
,CS,AR,32000698,1005,100,,Cash sale,,,,,,26/01/2018,26/01/2018,0.00,,2.54,,"-59,768.17"
,CS,AR,32000718,1005,100,,Cash sale,,,,,,26/01/2018,26/01/2018,0.00,,11.44,,"-59,779.61"
,CS,AR,32000723,1005,100,,Cash sale,,,,,,26/01/2018,26/01/2018,0.00,,25.51,,"-59,805.12"
,CS,AR,32000724,1005,100,,Cash sale,,,,,,26/01/2018,26/01/2018,0.00,,10.93,,"-59,816.05"
,CS,AR,32000732,1005,100,,Cash sale,,,,,,26/01/2018,26/01/2018,0.00,,6.07,,"-59,822.12"
,CS,AR,32000792,1005,100,,Cash sale,,,,,,26/01/2018,26/01/2018,0.00,,10.93,,"-59,833.05"
,CS,AR,32000807,1005,100,,Cash sale,,,,,,26/01/2018,26/01/2018,0.00,,9.15,,"-59,842.20"
,CS,AR,32000829,1005,100,,Cash sale,,,,,,26/01/2018,26/01/2018,0.00,,18.22,,"-59,860.42"
,CS,AR,32000871,1005,100,,Cash sale,,,,,,26/01/2018,26/01/2018,0.00,,3.64,,"-59,864.06"
,CS,AR,32000889,1005,100,,Cash sale,,,,,,26/01/2018,26/01/2018,0.00,,3.64,,"-59,867.70"
,IN,AR,30304375,1005,100,,Invoice,,,,,,26/01/2018,26/01/2018,0.00,,11.86,,"-59,879.56"
,IN,AR,30304380,1005,100,,Invoice,,,,,,26/01/2018,26/01/2018,0.00,,18.22,,"-59,897.78"
,IN,AR,30304398,1005,100,,Invoice,,,,,,26/01/2018,26/01/2018,0.00,,10.93,,"-59,908.71"
,IN,AR,30304427,1005,100,,Invoice,,,,,,26/01/2018,26/01/2018,0.00,,10.93,,"-59,919.64"
,IN,AR,30304458,1005,100,,Invoice,,,,,,26/01/2018,26/01/2018,0.00,,7.25,,"-59,926.89"
,IN,AR,30304506,1005,100,,Invoice,,,,,,26/01/2018,26/01/2018,0.00,,11.48,,"-59,938.37"
,IN,AR,30304511,1005,100,,Invoice,,,,,,26/01/2018,26/01/2018,0.00,,71.81,,"-60,010.18"
,IN,AR,30304534,1005,100,,Invoice,,,,,,26/01/2018,26/01/2018,0.00,,45.08,,"-60,055.26"
,IN,AR,30304540,1005,100,,Invoice,,,,,,26/01/2018,26/01/2018,0.00,,11.02,,"-60,066.28"
,IN,AR,30304557,1005,100,,Invoice,,,,,,26/01/2018,26/01/2018,0.00,,44.00,,"-60,110.28"
,IN,AR,30304566,1005,100,,Invoice,,,,,,26/01/2018,26/01/2018,0.00,,14.58,,"-60,124.86"
,IN,AR,30304587,1005,100,,Invoice,,,,,,26/01/2018,26/01/2018,0.00,,3.64,,"-60,128.50"
,IN,AR,30304596,1005,100,,Invoice,,,,,,26/01/2018,26/01/2018,0.00,,32.80,,"-60,161.30"
,IN,AR,30304613,1005,100,,Invoice,,,,,,26/01/2018,26/01/2018,0.00,,12.00,,"-60,173.30"
,IN,AR,30304648,1005,100,,Invoice,,,,,,26/01/2018,26/01/2018,0.00,,1.95,,"-60,175.25"
,IN,AR,30304676,1005,100,,Invoice,,,,,,26/01/2018,26/01/2018,0.00,,14.00,,"-60,189.25"
,IN,AR,30304704,1005,100,,Invoice,,,,,,26/01/2018,26/01/2018,0.00,,29.15,,"-60,218.40"
,IN,AR,30304710,1005,100,,Invoice,,,,,,26/01/2018,26/01/2018,0.00,,48.26,,"-60,266.66"
,IN,AR,30304738,1005,100,,Invoice,,,,,,26/01/2018,26/01/2018,0.00,,5.82,,"-60,272.48"
,IN,AR,30304750,1005,100,,Invoice,,,,,,26/01/2018,26/01/2018,0.00,,46.00,,"-60,318.48"
,IN,AR,30304763,1005,100,,Invoice,,,,,,26/01/2018,26/01/2018,0.00,,36.44,,"-60,354.92"
,IN,AR,30304770,1005,100,,Invoice,,,,,,26/01/2018,26/01/2018,0.00,,19.58,,"-60,374.50"
,IN,AR,30304813,1005,100,,Invoice,,,,,,26/01/2018,26/01/2018,0.00,,6.37,,"-60,380.87"
,IN,AR,30304829,1005,100,,Invoice,,,,,,26/01/2018,26/01/2018,0.00,,5.17,,"-60,386.04"
,IN,AR,30304866,1005,100,,Invoice,,,,,,26/01/2018,26/01/2018,0.00,,10.93,,"-60,396.97"
,IN,AR,30304950,1005,100,,Invoice,,,,,,26/01/2018,26/01/2018,0.00,,5.17,,"-60,402.14"
,IN,AR,30304956,1005,100,,Invoice,,,,,,26/01/2018,26/01/2018,0.00,,2.39,,"-60,404.53"
,IN,AR,30304965,1005,100,,Invoice,,,,,,26/01/2018,26/01/2018,0.00,,198.11,,"-60,602.64"
,IN,AR,30305028,1005,100,,Invoice,,,,,,26/01/2018,26/01/2018,0.00,,36.92,,"-60,639.56"
,IN,AR,30305105,1005,100,,Invoice,,,,,,26/01/2018,26/01/2018,0.00,,14.58,,"-60,654.14"
,IN,AR,30305118,1005,100,,Invoice,,,,,,26/01/2018,26/01/2018,0.00,,6.02,,"-60,660.16"
,IN,AR,30305146,1005,100,,Invoice,,,,,,26/01/2018,26/01/2018,0.00,,2.58,,"-60,662.74"
,IN,AR,30305233,1005,100,,Invoice,,,,,,26/01/2018,26/01/2018,0.00,,15.25,,"-60,677.99"
,IN,AR,30305234,1005,100,,Invoice,,,,,,26/01/2018,26/01/2018,0.00,,17.80,,"-60,695.79"
,IN,AR,30305239,1005,100,,Invoice,,,,,,26/01/2018,26/01/2018,0.00,,10.17,,"-60,705.96"
,IN,AR,30305241,1005,100,,Invoice,,,,,,26/01/2018,26/01/2018,0.00,,22.37,,"-60,728.33"
,IN,AR,30305263,1005,100,,Invoice,,,,,,26/01/2018,26/01/2018,0.00,,73.68,,"-60,802.01"
,IN,AR,30305323,1005,100,,Invoice,,,,,,26/01/2018,26/01/2018,0.00,,10.17,,"-60,812.18"
,IN,AR,30305329,1005,100,,Invoice,,,,,,26/01/2018,26/01/2018,0.00,,5.17,,"-60,817.35"
,IN,AR,30305358,1005,100,,Invoice,,,,,,26/01/2018,26/01/2018,0.00,,2.58,,"-60,819.93"
,IN,AR,30305361,1005,100,,Invoice,,,,,,26/01/2018,26/01/2018,0.00,,3.64,,"-60,823.57"
,IN,AR,30305378,1005,100,,Invoice,,,,,,26/01/2018,26/01/2018,0.00,,25.42,,"-60,848.99"
,IN,AR,30305524,1005,100,,Invoice,,,,,,26/01/2018,26/01/2018,0.00,,22.44,,"-60,871.43"
,IN,AR,30305542,1005,100,,Invoice,,,,,,26/01/2018,26/01/2018,0.00,,14.58,,"-60,886.01"
,IN,AR,30305635,1005,100,,Invoice,,,,,,26/01/2018,26/01/2018,0.00,,10.17,,"-60,896.18"
,IN,AR,30305665,1005,100,,Invoice,,,,,,26/01/2018,26/01/2018,0.00,,53.94,,"-60,950.12"
,IN,AR,30305730,1005,100,,Invoice,,,,,,26/01/2018,26/01/2018,0.00,,54.66,,"-61,004.78"
,IN,AR,30305736,1005,100,,Invoice,,,,,,26/01/2018,26/01/2018,0.00,,"1,093.22",,"-62,098.00"
,IN,AR,30305825,1005,100,,Invoice,,,,,,26/01/2018,26/01/2018,0.00,,4.85,,"-62,102.85"
,IN,AR,30305854,1005,100,,Invoice,,,,,,26/01/2018,26/01/2018,0.00,,7.29,,"-62,110.14"
,IN,AR,30305923,1005,100,,Invoice,,,,,,26/01/2018,26/01/2018,0.00,,10.17,,"-62,120.31"
,IN,AR,30305964,1005,100,,Invoice,,,,,,26/01/2018,26/01/2018,0.00,,16.23,,"-62,136.54"
,IN,AR,30305970,1005,100,,Invoice,,,,,,26/01/2018,26/01/2018,0.00,,39.75,,"-62,176.29"
,IN,AR,30305978,1005,100,,Invoice,,,,,,26/01/2018,26/01/2018,0.00,,22.00,,"-62,198.29"
,IN,AR,30305998,1005,100,,Invoice,,,,,,26/01/2018,26/01/2018,0.00,,36.08,,"-62,234.37"
,IN,AR,30306012,1005,100,,Invoice,,,,,,26/01/2018,26/01/2018,0.00,,8.21,,"-62,242.58"
,IN,AR,30306083,1005,100,,Invoice,,,,,,26/01/2018,26/01/2018,0.00,,62.53,,"-62,305.11"
,IN,AR,30306134,1005,100,,Invoice,,,,,,26/01/2018,26/01/2018,0.00,,28.69,,"-62,333.80"
,IN,AR,30306182,1005,100,,Invoice,,,,,,26/01/2018,26/01/2018,0.00,,14.00,,"-62,347.80"
,IN,AR,30306214,1005,100,,Invoice,,,,,,26/01/2018,26/01/2018,0.00,,10.93,,"-62,358.73"
,IN,AR,30306226,1005,100,,Invoice,,,,,,26/01/2018,26/01/2018,0.00,,16.42,,"-62,375.15"
,IN,AR,30306234,1005,100,,Invoice,,,,,,26/01/2018,26/01/2018,0.00,,25.23,,"-62,400.38"
,IN,AR,30306250,1005,100,,Invoice,,,,,,26/01/2018,26/01/2018,0.00,,18.21,,"-62,418.59"
,IN,AR,30306297,1005,100,,Invoice,,,,,,26/01/2018,26/01/2018,0.00,,3.64,,"-62,422.23"
,IN,AR,30306342,1005,100,,Invoice,,,,,,26/01/2018,26/01/2018,0.00,,10.93,,"-62,433.16"
,IN,AR,30306353,1005,100,,Invoice,,,,,,26/01/2018,26/01/2018,0.00,,14.19,,"-62,447.35"
,IN,AR,30306356,1005,100,,Invoice,,,,,,26/01/2018,26/01/2018,0.00,,12.08,,"-62,459.43"
,IN,AR,30306358,1005,100,,Invoice,,,,,,26/01/2018,26/01/2018,0.00,,11.66,,"-62,471.09"
,IN,AR,30306398,1005,100,,Invoice,,,,,,26/01/2018,26/01/2018,0.00,,22.31,,"-62,493.40"
,IN,AR,30306406,1005,100,,Invoice,,,,,,26/01/2018,26/01/2018,0.00,,54.66,,"-62,548.06"
,IN,AR,30306441,1005,100,,Invoice,,,,,,26/01/2018,26/01/2018,0.00,,8.00,,"-62,556.06"
,IN,AR,30306521,1005,100,,Invoice,,,,,,26/01/2018,26/01/2018,0.00,,14.58,,"-62,570.64"
,IN,AR,30306527,1005,100,,Invoice,,,,,,26/01/2018,26/01/2018,0.00,,44.49,,"-62,615.13"
,IN,AR,30306528,1005,100,,Invoice,,,,,,26/01/2018,26/01/2018,0.00,,21.86,,"-62,636.99"
,IN,AR,30306608,1005,100,,Invoice,,,,,,26/01/2018,26/01/2018,0.00,,6.13,,"-62,643.12"
,IN,AR,30306640,1005,100,,Invoice,,,,,,26/01/2018,26/01/2018,0.00,,29.15,,"-62,672.27"
,IN,AR,30306661,1005,100,,Invoice,,,,,,26/01/2018,26/01/2018,0.00,,419.07,,"-63,091.34"
,CS,AR,32000044,1005,100,,Cash sale,,,,,,27/01/2018,27/01/2018,0.00,,6.02,,"-63,097.36"
,CS,AR,32000326,1005,100,,Cash sale,,,,,,27/01/2018,27/01/2018,0.00,,3.64,,"-63,101.00"
,CS,AR,32000425,1005,100,,Cash sale,,,,,,27/01/2018,27/01/2018,0.00,,7.29,,"-63,108.29"
,CS,AR,32000741,1005,100,,Cash sale,,,,,,27/01/2018,27/01/2018,0.00,,54.66,,"-63,162.95"
,CS,AR,32000873,1005,100,,Cash sale,,,,,,27/01/2018,27/01/2018,0.00,,7.29,,"-63,170.24"
,CS,AR,32000906,1005,100,,Cash sale,,,,,,27/01/2018,27/01/2018,0.00,,6.56,,"-63,176.80"
,IN,AR,30304743,1005,100,,Invoice,,,,,,27/01/2018,27/01/2018,0.00,,14.58,,"-63,191.38"
,IN,AR,30304744,1005,100,,Invoice,,,,,,27/01/2018,27/01/2018,0.00,,7.29,,"-63,198.67"
,IN,AR,30305586,1005,100,,Invoice,,,,,,27/01/2018,27/01/2018,0.00,,18.22,,"-63,216.89"
,IN,AR,30306516,1005,100,,Invoice,,,,,,27/01/2018,27/01/2018,0.00,,29.15,,"-63,246.04"
,IN,AR,30306616,1005,100,,Invoice,,,,,,27/01/2018,27/01/2018,0.00,,10.93,,"-63,256.97"
,CS,AR,32000032,1005,100,,Cash sale,,,,,,29/01/2018,29/01/2018,0.00,,7.12,,"-63,264.09"
,CS,AR,32000136,1005,100,,Cash sale,,,,,,29/01/2018,29/01/2018,0.00,,10.38,,"-63,274.47"
,CS,AR,32000147,1005,100,,Cash sale,,,,,,29/01/2018,29/01/2018,0.00,,7.29,,"-63,281.76"
,CS,AR,32000156,1005,100,,Cash sale,,,,,,29/01/2018,29/01/2018,0.00,,3.64,,"-63,285.40"
,CS,AR,32000165,1005,100,,Cash sale,,,,,,29/01/2018,29/01/2018,0.00,,5.85,,"-63,291.25"
,CS,AR,32000171,1005,100,,Cash sale,,,,,,29/01/2018,29/01/2018,0.00,,14.58,,"-63,305.83"
,CS,AR,32000217,1005,100,,Cash sale,,,,,,29/01/2018,29/01/2018,0.00,,10.34,,"-63,316.17"
,CS,AR,32000247,1005,100,,Cash sale,,,,,,29/01/2018,29/01/2018,0.00,,7.29,,"-63,323.46"
,CS,AR,32000270,1005,100,,Cash sale,,,,,,29/01/2018,29/01/2018,0.00,,15.25,,"-63,338.71"
,CS,AR,32000293,1005,100,,Cash sale,,,,,,29/01/2018,29/01/2018,0.00,,28.43,,"-63,367.14"
,CS,AR,32000319,1005,100,,Cash sale,,,,,,29/01/2018,29/01/2018,0.00,,8.25,,"-63,375.39"
,CS,AR,32000334,1005,100,,Cash sale,,,,,,29/01/2018,29/01/2018,0.00,,7.29,,"-63,382.68"
,CS,AR,32000353,1005,100,,Cash sale,,,,,,29/01/2018,29/01/2018,0.00,,3.64,,"-63,386.32"
,CS,AR,32000362,1005,100,,Cash sale,,,,,,29/01/2018,29/01/2018,0.00,,6.02,,"-63,392.34"
,CS,AR,32000374,1005,100,,Cash sale,,,,,,29/01/2018,29/01/2018,0.00,,7.63,,"-63,399.97"
,CS,AR,32000388,1005,100,,Cash sale,,,,,,29/01/2018,29/01/2018,0.00,,14.62,,"-63,414.59"
,CS,AR,32000396,1005,100,,Cash sale,,,,,,29/01/2018,29/01/2018,0.00,,6.02,,"-63,420.61"
,CS,AR,32000410,1005,100,,Cash sale,,,,,,29/01/2018,29/01/2018,0.00,,36.10,,"-63,456.71"
,CS,AR,32000553,1005,100,,Cash sale,,,,,,29/01/2018,29/01/2018,0.00,,9.03,,"-63,465.74"
,CS,AR,32000557,1005,100,,Cash sale,,,,,,29/01/2018,29/01/2018,0.00,,3.64,,"-63,469.38"
,CS,AR,32000565,1005,100,,Cash sale,,,,,,29/01/2018,29/01/2018,0.00,,5.17,,"-63,474.55"
,CS,AR,32000569,1005,100,,Cash sale,,,,,,29/01/2018,29/01/2018,0.00,,3.64,,"-63,478.19"
,CS,AR,32000596,1005,100,,Cash sale,,,,,,29/01/2018,29/01/2018,0.00,,3.64,,"-63,481.83"
,CS,AR,32000606,1005,100,,Cash sale,,,,,,29/01/2018,29/01/2018,0.00,,7.29,,"-63,489.12"
,CS,AR,32000632,1005,100,,Cash sale,,,,,,29/01/2018,29/01/2018,0.00,,21.86,,"-63,510.98"
,CS,AR,32000638,1005,100,,Cash sale,,,,,,29/01/2018,29/01/2018,0.00,,6.53,,"-63,517.51"
,CS,AR,32000649,1005,100,,Cash sale,,,,,,29/01/2018,29/01/2018,0.00,,5.17,,"-63,522.68"
,CS,AR,32000719,1005,100,,Cash sale,,,,,,29/01/2018,29/01/2018,0.00,,11.44,,"-63,534.12"
,CS,AR,32000752,1005,100,,Cash sale,,,,,,29/01/2018,29/01/2018,0.00,,6.86,,"-63,540.98"
,CS,AR,32000758,1005,100,,Cash sale,,,,,,29/01/2018,29/01/2018,0.00,,48.57,,"-63,589.55"
,CS,AR,32000793,1005,100,,Cash sale,,,,,,29/01/2018,29/01/2018,0.00,,10.93,,"-63,600.48"
,CS,AR,32000801,1005,100,,Cash sale,,,,,,29/01/2018,29/01/2018,0.00,,14.58,,"-63,615.06"
,CS,AR,32000833,1005,100,,Cash sale,,,,,,29/01/2018,29/01/2018,0.00,,3.64,,"-63,618.70"
,CS,AR,32000845,1005,100,,Cash sale,,,,,,29/01/2018,29/01/2018,0.00,,18.22,,"-63,636.92"
,CS,AR,32000909,1005,100,,Cash sale,,,,,,29/01/2018,29/01/2018,0.00,,7.29,,"-63,644.21"
,IN,AR,30304376,1005,100,,Invoice,,,,,,29/01/2018,29/01/2018,0.00,,53.39,,"-63,697.60"
,IN,AR,30304400,1005,100,,Invoice,,,,,,29/01/2018,29/01/2018,0.00,,11.19,,"-63,708.79"
,IN,AR,30304404,1005,100,,Invoice,,,,,,29/01/2018,29/01/2018,0.00,,21.86,,"-63,730.65"
,IN,AR,30304470,1005,100,,Invoice,,,,,,29/01/2018,29/01/2018,0.00,,109.32,,"-63,839.97"
,IN,AR,30304481,1005,100,,Invoice,,,,,,29/01/2018,29/01/2018,0.00,,63.41,,"-63,903.38"
,IN,AR,30304512,1005,100,,Invoice,,,,,,29/01/2018,29/01/2018,0.00,,9.70,,"-63,913.08"
,IN,AR,30304515,1005,100,,Invoice,,,,,,29/01/2018,29/01/2018,0.00,,3.64,,"-63,916.72"
,IN,AR,30304535,1005,100,,Invoice,,,,,,29/01/2018,29/01/2018,0.00,,85.42,,"-64,002.14"
,IN,AR,30304541,1005,100,,Invoice,,,,,,29/01/2018,29/01/2018,0.00,,11.02,,"-64,013.16"
,IN,AR,30304558,1005,100,,Invoice,,,,,,29/01/2018,29/01/2018,0.00,,36.00,,"-64,049.16"
,IN,AR,30304562,1005,100,,Invoice,,,,,,29/01/2018,29/01/2018,0.00,,10.93,,"-64,060.09"
,IN,AR,30304583,1005,100,,Invoice,,,,,,29/01/2018,29/01/2018,0.00,,55.14,,"-64,115.23"
,IN,AR,30304598,1005,100,,Invoice,,,,,,29/01/2018,29/01/2018,0.00,,7.29,,"-64,122.52"
,IN,AR,30304614,1005,100,,Invoice,,,,,,29/01/2018,29/01/2018,0.00,,18.00,,"-64,140.52"
,IN,AR,30304625,1005,100,,Invoice,,,,,,29/01/2018,29/01/2018,0.00,,5.51,,"-64,146.03"
,IN,AR,30304628,1005,100,,Invoice,,,,,,29/01/2018,29/01/2018,0.00,,48.31,,"-64,194.34"
,IN,AR,30304633,1005,100,,Invoice,,,,,,29/01/2018,29/01/2018,0.00,,8.26,,"-64,202.60"
,IN,AR,30304649,1005,100,,Invoice,,,,,,29/01/2018,29/01/2018,0.00,,3.89,,"-64,206.49"
,IN,AR,30304677,1005,100,,Invoice,,,,,,29/01/2018,29/01/2018,0.00,,8.00,,"-64,214.49"
,IN,AR,30304688,1005,100,,Invoice,,,,,,29/01/2018,29/01/2018,0.00,,18.22,,"-64,232.71"
,IN,AR,30304729,1005,100,,Invoice,,,,,,29/01/2018,29/01/2018,0.00,,488.10,,"-64,720.81"
,IN,AR,30304742,1005,100,,Invoice,,,,,,29/01/2018,29/01/2018,0.00,,74.08,,"-64,794.89"
,IN,AR,30304775,1005,100,,Invoice,,,,,,29/01/2018,29/01/2018,0.00,,11.27,,"-64,806.16"
,IN,AR,30304776,1005,100,,Invoice,,,,,,29/01/2018,29/01/2018,0.00,,18.22,,"-64,824.38"
,IN,AR,30304792,1005,100,,Invoice,,,,,,29/01/2018,29/01/2018,0.00,,34.07,,"-64,858.45"
,IN,AR,30304826,1005,100,,Invoice,,,,,,29/01/2018,29/01/2018,0.00,,14.58,,"-64,873.03"
,IN,AR,30304834,1005,100,,Invoice,,,,,,29/01/2018,29/01/2018,0.00,,7.75,,"-64,880.78"
,IN,AR,30304838,1005,100,,Invoice,,,,,,29/01/2018,29/01/2018,0.00,,14.58,,"-64,895.36"
,IN,AR,30304860,1005,100,,Invoice,,,,,,29/01/2018,29/01/2018,0.00,,6.89,,"-64,902.25"
,IN,AR,30304951,1005,100,,Invoice,,,,,,29/01/2018,29/01/2018,0.00,,10.34,,"-64,912.59"
,IN,AR,30304976,1005,100,,Invoice,,,,,,29/01/2018,29/01/2018,0.00,,7.42,,"-64,920.01"
,IN,AR,30304992,1005,100,,Invoice,,,,,,29/01/2018,29/01/2018,0.00,,7.29,,"-64,927.30"
,IN,AR,30305029,1005,100,,Invoice,,,,,,29/01/2018,29/01/2018,0.00,,90.24,,"-65,017.54"
,IN,AR,30305044,1005,100,,Invoice,,,,,,29/01/2018,29/01/2018,0.00,,38.14,,"-65,055.68"
,IN,AR,30305072,1005,100,,Invoice,,,,,,29/01/2018,29/01/2018,0.00,,9.56,,"-65,065.24"
,IN,AR,30305073,1005,100,,Invoice,,,,,,29/01/2018,29/01/2018,0.00,,23.90,,"-65,089.14"
,IN,AR,30305082,1005,100,,Invoice,,,,,,29/01/2018,29/01/2018,0.00,,32.20,,"-65,121.34"
,IN,AR,30305094,1005,100,,Invoice,,,,,,29/01/2018,29/01/2018,0.00,,9.03,,"-65,130.37"
,IN,AR,30305121,1005,100,,Invoice,,,,,,29/01/2018,29/01/2018,0.00,,5.51,,"-65,135.88"
,IN,AR,30305133,1005,100,,Invoice,,,,,,29/01/2018,29/01/2018,0.00,,5.17,,"-65,141.05"
,IN,AR,30305235,1005,100,,Invoice,,,,,,29/01/2018,29/01/2018,0.00,,5.08,,"-65,146.13"
,IN,AR,30305285,1005,100,,Invoice,,,,,,29/01/2018,29/01/2018,0.00,,7.29,,"-65,153.42"
,IN,AR,30305379,1005,100,,Invoice,,,,,,29/01/2018,29/01/2018,0.00,,20.34,,"-65,173.76"
,IN,AR,30305391,1005,100,,Invoice,,,,,,29/01/2018,29/01/2018,0.00,,12.20,,"-65,185.96"
,IN,AR,30305405,1005,100,,Invoice,,,,,,29/01/2018,29/01/2018,0.00,,10.93,,"-65,196.89"
,IN,AR,30305431,1005,100,,Invoice,,,,,,29/01/2018,29/01/2018,0.00,,3.64,,"-65,200.53"
,IN,AR,30305436,1005,100,,Invoice,,,,,,29/01/2018,29/01/2018,0.00,,14.58,,"-65,215.11"
,IN,AR,30305476,1005,100,,Invoice,,,,,,29/01/2018,29/01/2018,0.00,,4.78,,"-65,219.89"
,IN,AR,30305482,1005,100,,Invoice,,,,,,29/01/2018,29/01/2018,0.00,,13.77,,"-65,233.66"
,IN,AR,30305495,1005,100,,Invoice,,,,,,29/01/2018,29/01/2018,0.00,,5.51,,"-65,239.17"
,IN,AR,30305500,1005,100,,Invoice,,,,,,29/01/2018,29/01/2018,0.00,,7.29,,"-65,246.46"
,IN,AR,30305518,1005,100,,Invoice,,,,,,29/01/2018,29/01/2018,0.00,,9.19,,"-65,255.65"
,IN,AR,30305525,1005,100,,Invoice,,,,,,29/01/2018,29/01/2018,0.00,,22.44,,"-65,278.09"
,IN,AR,30305533,1005,100,,Invoice,,,,,,29/01/2018,29/01/2018,0.00,,5.25,,"-65,283.34"
,IN,AR,30305564,1005,100,,Invoice,,,,,,29/01/2018,29/01/2018,0.00,,18.22,,"-65,301.56"
,IN,AR,30305628,1005,100,,Invoice,,,,,,29/01/2018,29/01/2018,0.00,,48.81,,"-65,350.37"
,IN,AR,30305629,1005,100,,Invoice,,,,,,29/01/2018,29/01/2018,0.00,,3.64,,"-65,354.01"
,IN,AR,30305639,1005,100,,Invoice,,,,,,29/01/2018,29/01/2018,0.00,,54.66,,"-65,408.67"
,IN,AR,30305643,1005,100,,Invoice,,,,,,29/01/2018,29/01/2018,0.00,,12.00,,"-65,420.67"
,IN,AR,30305687,1005,100,,Invoice,,,,,,29/01/2018,29/01/2018,0.00,,5.17,,"-65,425.84"
,IN,AR,30305722,1005,100,,Invoice,,,,,,29/01/2018,29/01/2018,0.00,,2.25,,"-65,428.09"
,IN,AR,30305755,1005,100,,Invoice,,,,,,29/01/2018,29/01/2018,0.00,,54.66,,"-65,482.75"
,IN,AR,30305784,1005,100,,Invoice,,,,,,29/01/2018,29/01/2018,0.00,,53.60,,"-65,536.35"
,IN,AR,30305860,1005,100,,Invoice,,,,,,29/01/2018,29/01/2018,0.00,,10.17,,"-65,546.52"
,IN,AR,30305894,1005,100,,Invoice,,,,,,29/01/2018,29/01/2018,0.00,,4.29,,"-65,550.81"
,IN,AR,30305986,1005,100,,Invoice,,,,,,29/01/2018,29/01/2018,0.00,,2.14,,"-65,552.95"
,IN,AR,30305999,1005,100,,Invoice,,,,,,29/01/2018,29/01/2018,0.00,,18.04,,"-65,570.99"
,IN,AR,30306035,1005,100,,Invoice,,,,,,29/01/2018,29/01/2018,0.00,,6.07,,"-65,577.06"
,IN,AR,30306084,1005,100,,Invoice,,,,,,29/01/2018,29/01/2018,0.00,,16.03,,"-65,593.09"
,IN,AR,30306102,1005,100,,Invoice,,,,,,29/01/2018,29/01/2018,0.00,,31.53,,"-65,624.62"
,IN,AR,30306108,1005,100,,Invoice,,,,,,29/01/2018,29/01/2018,0.00,,4.58,,"-65,629.20"
,IN,AR,30306171,1005,100,,Invoice,,,,,,29/01/2018,29/01/2018,0.00,,16.01,,"-65,645.21"
,IN,AR,30306198,1005,100,,Invoice,,,,,,29/01/2018,29/01/2018,0.00,,68.14,,"-65,713.35"
,IN,AR,30306207,1005,100,,Invoice,,,,,,29/01/2018,29/01/2018,0.00,,49.78,,"-65,763.13"
,IN,AR,30306235,1005,100,,Invoice,,,,,,29/01/2018,29/01/2018,0.00,,12.62,,"-65,775.75"
,IN,AR,30306246,1005,100,,Invoice,,,,,,29/01/2018,29/01/2018,0.00,,32.07,,"-65,807.82"
,IN,AR,30306261,1005,100,,Invoice,,,,,,29/01/2018,29/01/2018,0.00,,48.32,,"-65,856.14"
,IN,AR,30306266,1005,100,,Invoice,,,,,,29/01/2018,29/01/2018,0.00,,170.13,,"-66,026.27"
,IN,AR,30306280,1005,100,,Invoice,,,,,,29/01/2018,29/01/2018,0.00,,25.25,,"-66,051.52"
,IN,AR,30306317,1005,100,,Invoice,,,,,,29/01/2018,29/01/2018,0.00,,8.17,,"-66,059.69"
,IN,AR,30306347,1005,100,,Invoice,,,,,,29/01/2018,29/01/2018,0.00,,18.22,,"-66,077.91"
,IN,AR,30306363,1005,100,,Invoice,,,,,,29/01/2018,29/01/2018,0.00,,26.69,,"-66,104.60"
,IN,AR,30306399,1005,100,,Invoice,,,,,,29/01/2018,29/01/2018,0.00,,23.90,,"-66,128.50"
,IN,AR,30306408,1005,100,,Invoice,,,,,,29/01/2018,29/01/2018,0.00,,25.51,,"-66,154.01"
,IN,AR,30306442,1005,100,,Invoice,,,,,,29/01/2018,29/01/2018,0.00,,8.00,,"-66,162.01"
,IN,AR,30306453,1005,100,,Invoice,,,,,,29/01/2018,29/01/2018,0.00,,1.88,,"-66,163.89"
,IN,AR,30306454,1005,100,,Invoice,,,,,,29/01/2018,29/01/2018,0.00,,1.88,,"-66,165.77"
,IN,AR,30306609,1005,100,,Invoice,,,,,,29/01/2018,29/01/2018,0.00,,4.08,,"-66,169.85"
,IN,AR,30306643,1005,100,,Invoice,,,,,,29/01/2018,29/01/2018,0.00,,182.20,,"-66,352.05"
,IN,AR,30306650,1005,100,,Invoice,,,,,,29/01/2018,29/01/2018,0.00,,36.44,,"-66,388.49"
,IN,AR,30306653,1005,100,,Invoice,,,,,,29/01/2018,29/01/2018,0.00,,7.29,,"-66,395.78"
,IN,AR,30306659,1005,100,,Invoice,,,,,,29/01/2018,29/01/2018,0.00,,14.58,,"-66,410.36"
,CN,AR,31016922,1005,100,,Credit Note,,,,,,30/01/2018,30/01/2018,509.24,,0.00,,"-65,901.12"
,CN,AR,31016924,1005,100,,Credit Note,,,,,,30/01/2018,30/01/2018,7.76,,0.00,,"-65,893.36"
,CN,AR,31016926,1005,100,,Credit Note,,,,,,30/01/2018,30/01/2018,67.21,,0.00,,"-65,826.15"
,CN,AR,31016932,1005,100,,Credit Note,,,,,,30/01/2018,30/01/2018,139.59,,0.00,,"-65,686.56"
,CN,AR,31016936,1005,100,,Credit Note,,,,,,30/01/2018,30/01/2018,173.73,,0.00,,"-65,512.83"
,CN,AR,31016941,1005,100,,Credit Note,,,,,,30/01/2018,30/01/2018,134.42,,0.00,,"-65,378.41"
,CN,AR,31016943,1005,100,,Credit Note,,,,,,30/01/2018,30/01/2018,15.51,,0.00,,"-65,362.90"
,CN,AR,31016946,1005,100,,Credit Note,,,,,,30/01/2018,30/01/2018,155.10,,0.00,,"-65,207.80"
,CN,AR,31016949,1005,100,,Credit Note,,,,,,30/01/2018,30/01/2018,206.80,,0.00,,"-65,001.00"
,CN,AR,31016951,1005,100,,Credit Note,,,,,,30/01/2018,30/01/2018,310.20,,0.00,,"-64,690.80"
,CN,AR,31016973,1005,100,,Credit Note,,,,,,30/01/2018,30/01/2018,160.27,,0.00,,"-64,530.53"
,CN,AR,31016974,1005,100,,Credit Note,,,,,,30/01/2018,30/01/2018,160.27,,0.00,,"-64,370.26"
,CN,AR,31016982,1005,100,,Credit Note,,,,,,30/01/2018,30/01/2018,211.97,,0.00,,"-64,158.29"
,CN,AR,31016984,1005,100,,Credit Note,,,,,,30/01/2018,30/01/2018,5.17,,0.00,,"-64,153.12"
,CN,AR,31016986,1005,100,,Credit Note,,,,,,30/01/2018,30/01/2018,165.44,,0.00,,"-63,987.68"
,CN,AR,31016988,1005,100,,Credit Note,,,,,,30/01/2018,30/01/2018,2.58,,0.00,,"-63,985.10"
,CN,AR,31017005,1005,100,,Credit Note,,,,,,30/01/2018,30/01/2018,155.10,,0.00,,"-63,830.00"
,CN,AR,31017008,1005,100,,Credit Note,,,,,,30/01/2018,30/01/2018,219.72,,0.00,,"-63,610.28"
,CN,AR,31017019,1005,100,,Credit Note,,,,,,30/01/2018,30/01/2018,100.82,,0.00,,"-63,509.46"
,CN,AR,31017021,1005,100,,Credit Note,,,,,,30/01/2018,30/01/2018,193.88,,0.00,,"-63,315.58"
,CN,AR,31017025,1005,100,,Credit Note,,,,,,30/01/2018,30/01/2018,168.02,,0.00,,"-63,147.56"
,CN,AR,31017029,1005,100,,Credit Note,,,,,,30/01/2018,30/01/2018,359.32,,0.00,,"-62,788.24"
,CN,AR,31017031,1005,100,,Credit Note,,,,,,30/01/2018,30/01/2018,209.38,,0.00,,"-62,578.86"
,CN,AR,31017041,1005,100,,Credit Note,,,,,,30/01/2018,30/01/2018,87.89,,0.00,,"-62,490.97"
,CN,AR,31017043,1005,100,,Credit Note,,,,,,30/01/2018,30/01/2018,400.68,,0.00,,"-62,090.29"
,CN,AR,31017045,1005,100,,Credit Note,,,,,,30/01/2018,30/01/2018,152.51,,0.00,,"-61,937.78"
,CN,AR,31017047,1005,100,,Credit Note,,,,,,30/01/2018,30/01/2018,98.23,,0.00,,"-61,839.55"
,CN,AR,31017049,1005,100,,Credit Note,,,,,,30/01/2018,30/01/2018,183.54,,0.00,,"-61,656.01"
,CN,AR,31017051,1005,100,,Credit Note,,,,,,30/01/2018,30/01/2018,183.54,,0.00,,"-61,472.47"
,CN,AR,31017055,1005,100,,Credit Note,,,,,,30/01/2018,30/01/2018,93.06,,0.00,,"-61,379.41"
,CN,AR,31017058,1005,100,,Credit Note,,,,,,30/01/2018,30/01/2018,227.48,,0.00,,"-61,151.93"
,CN,AR,31017062,1005,100,,Credit Note,,,,,,30/01/2018,30/01/2018,152.51,,0.00,,"-60,999.42"
,CN,AR,31017064,1005,100,,Credit Note,,,,,,30/01/2018,30/01/2018,178.36,,0.00,,"-60,821.06"
,CN,AR,31017071,1005,100,,Credit Note,,,,,,30/01/2018,30/01/2018,105.98,,0.00,,"-60,715.08"
,CN,AR,31017073,1005,100,,Credit Note,,,,,,30/01/2018,30/01/2018,162.85,,0.00,,"-60,552.23"
,CN,AR,31017075,1005,100,,Credit Note,,,,,,30/01/2018,30/01/2018,217.14,,0.00,,"-60,335.09"
,CN,AR,31017076,1005,100,,Credit Note,,,,,,30/01/2018,30/01/2018,7.76,,0.00,,"-60,327.33"
,CN,AR,31017087,1005,100,,Credit Note,,,,,,30/01/2018,30/01/2018,196.46,,0.00,,"-60,130.87"
,CN,AR,31017089,1005,100,,Credit Note,,,,,,30/01/2018,30/01/2018,116.32,,0.00,,"-60,014.55"
,CN,AR,31017091,1005,100,,Credit Note,,,,,,30/01/2018,30/01/2018,248.16,,0.00,,"-59,766.39"
,CN,AR,31017093,1005,100,,Credit Note,,,,,,30/01/2018,30/01/2018,144.76,,0.00,,"-59,621.63"
,CN,AR,31017094,1005,100,,Credit Note,,,,,,30/01/2018,30/01/2018,144.76,,0.00,,"-59,476.87"
,CN,AR,31017097,1005,100,,Credit Note,,,,,,30/01/2018,30/01/2018,7.76,,0.00,,"-59,469.11"
,CN,AR,31017099,1005,100,,Credit Note,,,,,,30/01/2018,30/01/2018,33.60,,0.00,,"-59,435.51"
,CN,AR,31017101,1005,100,,Credit Note,,,,,,30/01/2018,30/01/2018,82.72,,0.00,,"-59,352.79"
,CN,AR,31017114,1005,100,,Credit Note,,,,,,30/01/2018,30/01/2018,165.44,,0.00,,"-59,187.35"
,CS,AR,32000017,1005,100,,Cash sale,,,,,,30/01/2018,30/01/2018,0.00,,7.29,,"-59,194.64"
,CS,AR,32000057,1005,100,,Cash sale,,,,,,30/01/2018,30/01/2018,0.00,,7.29,,"-59,201.93"
,CS,AR,32000103,1005,100,,Cash sale,,,,,,30/01/2018,30/01/2018,0.00,,3.01,,"-59,204.94"
,CS,AR,32000110,1005,100,,Cash sale,,,,,,30/01/2018,30/01/2018,0.00,,10.93,,"-59,215.87"
,CS,AR,32000138,1005,100,,Cash sale,,,,,,30/01/2018,30/01/2018,0.00,,3.64,,"-59,219.51"
,CS,AR,32000181,1005,100,,Cash sale,,,,,,30/01/2018,30/01/2018,0.00,,21.86,,"-59,241.37"
,CS,AR,32000207,1005,100,,Cash sale,,,,,,30/01/2018,30/01/2018,0.00,,3.64,,"-59,245.01"
,CS,AR,32000227,1005,100,,Cash sale,,,,,,30/01/2018,30/01/2018,0.00,,10.17,,"-59,255.18"
,CS,AR,32000232,1005,100,,Cash sale,,,,,,30/01/2018,30/01/2018,0.00,,18.22,,"-59,273.40"
,CS,AR,32000278,1005,100,,Cash sale,,,,,,30/01/2018,30/01/2018,0.00,,7.75,,"-59,281.15"
,CS,AR,32000339,1005,100,,Cash sale,,,,,,30/01/2018,30/01/2018,0.00,,12.03,,"-59,293.18"
,CS,AR,32000360,1005,100,,Cash sale,,,,,,30/01/2018,30/01/2018,0.00,,3.64,,"-59,296.82"
,CS,AR,32000400,1005,100,,Cash sale,,,,,,30/01/2018,30/01/2018,0.00,,11.69,,"-59,308.51"
,CS,AR,32000401,1005,100,,Cash sale,,,,,,30/01/2018,30/01/2018,0.00,,7.29,,"-59,315.80"
,CS,AR,32000421,1005,100,,Cash sale,,,,,,30/01/2018,30/01/2018,0.00,,5.85,,"-59,321.65"
,CS,AR,32000448,1005,100,,Cash sale,,,,,,30/01/2018,30/01/2018,0.00,,5.08,,"-59,326.73"
,CS,AR,32000458,1005,100,,Cash sale,,,,,,30/01/2018,30/01/2018,0.00,,7.75,,"-59,334.48"
,CS,AR,32000478,1005,100,,Cash sale,,,,,,30/01/2018,30/01/2018,0.00,,10.34,,"-59,344.82"
,CS,AR,32000484,1005,100,,Cash sale,,,,,,30/01/2018,30/01/2018,0.00,,13.64,,"-59,358.46"
,CS,AR,32000519,1005,100,,Cash sale,,,,,,30/01/2018,30/01/2018,0.00,,3.64,,"-59,362.10"
,CS,AR,32000583,1005,100,,Cash sale,,,,,,30/01/2018,30/01/2018,0.00,,10.72,,"-59,372.82"
,CS,AR,32000666,1005,100,,Cash sale,,,,,,30/01/2018,30/01/2018,0.00,,5.08,,"-59,377.90"
,CS,AR,32000670,1005,100,,Cash sale,,,,,,30/01/2018,30/01/2018,0.00,,32.00,,"-59,409.90"
,CS,AR,32000702,1005,100,,Cash sale,,,,,,30/01/2018,30/01/2018,0.00,,8.20,,"-59,418.10"
,CS,AR,32000727,1005,100,,Cash sale,,,,,,30/01/2018,30/01/2018,0.00,,3.22,,"-59,421.32"
,CS,AR,32000735,1005,100,,Cash sale,,,,,,30/01/2018,30/01/2018,0.00,,5.93,,"-59,427.25"
,CS,AR,32000853,1005,100,,Cash sale,,,,,,30/01/2018,30/01/2018,0.00,,29.15,,"-59,456.40"
,CS,AR,32000862,1005,100,,Cash sale,,,,,,30/01/2018,30/01/2018,0.00,,29.15,,"-59,485.55"
,CS,AR,32000866,1005,100,,Cash sale,,,,,,30/01/2018,30/01/2018,0.00,,16.42,,"-59,501.97"
,CS,AR,32000881,1005,100,,Cash sale,,,,,,30/01/2018,30/01/2018,0.00,,18.22,,"-59,520.19"
,IN,AR,30304353,1005,100,,Invoice,,,,,,30/01/2018,30/01/2018,0.00,,9.03,,"-59,529.22"
,IN,AR,30304488,1005,100,,Invoice,,,,,,30/01/2018,30/01/2018,0.00,,10.93,,"-59,540.15"
,IN,AR,30304536,1005,100,,Invoice,,,,,,30/01/2018,30/01/2018,0.00,,64.07,,"-59,604.22"
,IN,AR,30304572,1005,100,,Invoice,,,,,,30/01/2018,30/01/2018,0.00,,18.22,,"-59,622.44"
,IN,AR,30304689,1005,100,,Invoice,,,,,,30/01/2018,30/01/2018,0.00,,7.29,,"-59,629.73"
,IN,AR,30304730,1005,100,,Invoice,,,,,,30/01/2018,30/01/2018,0.00,,585.72,,"-60,215.45"
,IN,AR,30304757,1005,100,,Invoice,,,,,,30/01/2018,30/01/2018,0.00,,8.25,,"-60,223.70"
,IN,AR,30304767,1005,100,,Invoice,,,,,,30/01/2018,30/01/2018,0.00,,3.64,,"-60,227.34"
,IN,AR,30304795,1005,100,,Invoice,,,,,,30/01/2018,30/01/2018,0.00,,3.64,,"-60,230.98"
,IN,AR,30304820,1005,100,,Invoice,,,,,,30/01/2018,30/01/2018,0.00,,7.29,,"-60,238.27"
,IN,AR,30304843,1005,100,,Invoice,,,,,,30/01/2018,30/01/2018,0.00,,2.32,,"-60,240.59"
,IN,AR,30304854,1005,100,,Invoice,,,,,,30/01/2018,30/01/2018,0.00,,7.19,,"-60,247.78"
,IN,AR,30304885,1005,100,,Invoice,,,,,,30/01/2018,30/01/2018,0.00,,7.75,,"-60,255.53"
,IN,AR,30304887,1005,100,,Invoice,,,,,,30/01/2018,30/01/2018,0.00,,417.44,,"-60,672.97"
,IN,AR,30304889,1005,100,,Invoice,,,,,,30/01/2018,30/01/2018,0.00,,6.36,,"-60,679.33"
,IN,AR,30304902,1005,100,,Invoice,,,,,,30/01/2018,30/01/2018,0.00,,114.43,,"-60,793.76"
,IN,AR,30304917,1005,100,,Invoice,,,,,,30/01/2018,30/01/2018,0.00,,131.38,,"-60,925.14"
,IN,AR,30304923,1005,100,,Invoice,,,,,,30/01/2018,30/01/2018,0.00,,15.51,,"-60,940.65"
,IN,AR,30304925,1005,100,,Invoice,,,,,,30/01/2018,30/01/2018,0.00,,110.19,,"-61,050.84"
,IN,AR,30304927,1005,100,,Invoice,,,,,,30/01/2018,30/01/2018,0.00,,12.71,,"-61,063.55"
,IN,AR,30304931,1005,100,,Invoice,,,,,,30/01/2018,30/01/2018,0.00,,127.14,,"-61,190.69"
,IN,AR,30304939,1005,100,,Invoice,,,,,,30/01/2018,30/01/2018,0.00,,169.52,,"-61,360.21"
,IN,AR,30304961,1005,100,,Invoice,,,,,,30/01/2018,30/01/2018,0.00,,2.58,,"-61,362.79"
,IN,AR,30305000,1005,100,,Invoice,,,,,,30/01/2018,30/01/2018,0.00,,24.07,,"-61,386.86"
,IN,AR,30305074,1005,100,,Invoice,,,,,,30/01/2018,30/01/2018,0.00,,4.78,,"-61,391.64"
,IN,AR,30305108,1005,100,,Invoice,,,,,,30/01/2018,30/01/2018,0.00,,160.27,,"-61,551.91"
,IN,AR,30305111,1005,100,,Invoice,,,,,,30/01/2018,30/01/2018,0.00,,131.38,,"-61,683.29"
,IN,AR,30305135,1005,100,,Invoice,,,,,,30/01/2018,30/01/2018,0.00,,173.76,,"-61,857.05"
,IN,AR,30305137,1005,100,,Invoice,,,,,,30/01/2018,30/01/2018,0.00,,4.24,,"-61,861.29"
,IN,AR,30305142,1005,100,,Invoice,,,,,,30/01/2018,30/01/2018,0.00,,53.10,,"-61,914.39"
,IN,AR,30305148,1005,100,,Invoice,,,,,,30/01/2018,30/01/2018,0.00,,135.62,,"-62,050.01"
,IN,AR,30305150,1005,100,,Invoice,,,,,,30/01/2018,30/01/2018,0.00,,2.12,,"-62,052.13"
,IN,AR,30305204,1005,100,,Invoice,,,,,,30/01/2018,30/01/2018,0.00,,127.14,,"-62,179.27"
,IN,AR,30305271,1005,100,,Invoice,,,,,,30/01/2018,30/01/2018,0.00,,180.12,,"-62,359.39"
,IN,AR,30305276,1005,100,,Invoice,,,,,,30/01/2018,30/01/2018,0.00,,12.71,,"-62,372.10"
,IN,AR,30305327,1005,100,,Invoice,,,,,,30/01/2018,30/01/2018,0.00,,82.64,,"-62,454.74"
,IN,AR,30305331,1005,100,,Invoice,,,,,,30/01/2018,30/01/2018,0.00,,158.93,,"-62,613.67"
,IN,AR,30305337,1005,100,,Invoice,,,,,,30/01/2018,30/01/2018,0.00,,137.74,,"-62,751.41"
,IN,AR,30305343,1005,100,,Invoice,,,,,,30/01/2018,30/01/2018,0.00,,294.54,,"-63,045.95"
,IN,AR,30305345,1005,100,,Invoice,,,,,,30/01/2018,30/01/2018,0.00,,171.64,,"-63,217.59"
,IN,AR,30305348,1005,100,,Invoice,,,,,,30/01/2018,30/01/2018,0.00,,3.64,,"-63,221.23"
,IN,AR,30305369,1005,100,,Invoice,,,,,,30/01/2018,30/01/2018,0.00,,26.69,,"-63,247.92"
,IN,AR,30305400,1005,100,,Invoice,,,,,,30/01/2018,30/01/2018,0.00,,14.87,,"-63,262.79"
,IN,AR,30305404,1005,100,,Invoice,,,,,,30/01/2018,30/01/2018,0.00,,2.39,,"-63,265.18"
,IN,AR,30305414,1005,100,,Invoice,,,,,,30/01/2018,30/01/2018,0.00,,10.17,,"-63,275.35"
,IN,AR,30305416,1005,100,,Invoice,,,,,,30/01/2018,30/01/2018,0.00,,3.90,,"-63,279.25"
,IN,AR,30305421,1005,100,,Invoice,,,,,,30/01/2018,30/01/2018,0.00,,17.54,,"-63,296.79"
,IN,AR,30305440,1005,100,,Invoice,,,,,,30/01/2018,30/01/2018,0.00,,72.05,,"-63,368.84"
,IN,AR,30305443,1005,100,,Invoice,,,,,,30/01/2018,30/01/2018,0.00,,328.45,,"-63,697.29"
,IN,AR,30305445,1005,100,,Invoice,,,,,,30/01/2018,30/01/2018,0.00,,125.02,,"-63,822.31"
,IN,AR,30305447,1005,100,,Invoice,,,,,,30/01/2018,30/01/2018,0.00,,80.52,,"-63,902.83"
,IN,AR,30305449,1005,100,,Invoice,,,,,,30/01/2018,30/01/2018,0.00,,12.92,,"-63,915.75"
,IN,AR,30305451,1005,100,,Invoice,,,,,,30/01/2018,30/01/2018,0.00,,183.54,,"-64,099.29"
,IN,AR,30305453,1005,100,,Invoice,,,,,,30/01/2018,30/01/2018,0.00,,150.45,,"-64,249.74"
,IN,AR,30305457,1005,100,,Invoice,,,,,,30/01/2018,30/01/2018,0.00,,76.28,,"-64,326.02"
,IN,AR,30305465,1005,100,,Invoice,,,,,,30/01/2018,30/01/2018,0.00,,7.75,,"-64,333.77"
,IN,AR,30305467,1005,100,,Invoice,,,,,,30/01/2018,30/01/2018,0.00,,186.47,,"-64,520.24"
,IN,AR,30305471,1005,100,,Invoice,,,,,,30/01/2018,30/01/2018,0.00,,125.02,,"-64,645.26"
,IN,AR,30305487,1005,100,,Invoice,,,,,,30/01/2018,30/01/2018,0.00,,146.21,,"-64,791.47"
,IN,AR,30305527,1005,100,,Invoice,,,,,,30/01/2018,30/01/2018,0.00,,7.29,,"-64,798.76"
,IN,AR,30305529,1005,100,,Invoice,,,,,,30/01/2018,30/01/2018,0.00,,86.88,,"-64,885.64"
,IN,AR,30305536,1005,100,,Invoice,,,,,,30/01/2018,30/01/2018,0.00,,133.50,,"-65,019.14"
,IN,AR,30305538,1005,100,,Invoice,,,,,,30/01/2018,30/01/2018,0.00,,7.75,,"-65,026.89"
,IN,AR,30305541,1005,100,,Invoice,,,,,,30/01/2018,30/01/2018,0.00,,178.00,,"-65,204.89"
,IN,AR,30305549,1005,100,,Invoice,,,,,,30/01/2018,30/01/2018,0.00,,17.80,,"-65,222.69"
,IN,AR,30305557,1005,100,,Invoice,,,,,,30/01/2018,30/01/2018,0.00,,22.88,,"-65,245.57"
,IN,AR,30305594,1005,100,,Invoice,,,,,,30/01/2018,30/01/2018,0.00,,161.04,,"-65,406.61"
,IN,AR,30305605,1005,100,,Invoice,,,,,,30/01/2018,30/01/2018,0.00,,95.36,,"-65,501.97"
,IN,AR,30305611,1005,100,,Invoice,,,,,,30/01/2018,30/01/2018,0.00,,118.66,,"-65,620.63"
,IN,AR,30305616,1005,100,,Invoice,,,,,,30/01/2018,30/01/2018,0.00,,27.55,,"-65,648.18"
,IN,AR,30305618,1005,100,,Invoice,,,,,,30/01/2018,30/01/2018,0.00,,67.81,,"-65,715.99"
,IN,AR,30305648,1005,100,,Invoice,,,,,,30/01/2018,30/01/2018,0.00,,17.54,,"-65,733.53"
,IN,AR,30305666,1005,100,,Invoice,,,,,,30/01/2018,30/01/2018,0.00,,68.14,,"-65,801.67"
,IN,AR,30305683,1005,100,,Invoice,,,,,,30/01/2018,30/01/2018,0.00,,8.39,,"-65,810.06"
,IN,AR,30305692,1005,100,,Invoice,,,,,,30/01/2018,30/01/2018,0.00,,8.78,,"-65,818.84"
,IN,AR,30305702,1005,100,,Invoice,,,,,,30/01/2018,30/01/2018,0.00,,8.52,,"-65,827.36"
,IN,AR,30305716,1005,100,,Invoice,,,,,,30/01/2018,30/01/2018,0.00,,135.62,,"-65,962.98"
,IN,AR,30305739,1005,100,,Invoice,,,,,,30/01/2018,30/01/2018,0.00,,14.63,,"-65,977.61"
,IN,AR,30305741,1005,100,,Invoice,,,,,,30/01/2018,30/01/2018,0.00,,14.58,,"-65,992.19"
,IN,AR,30305766,1005,100,,Invoice,,,,,,30/01/2018,30/01/2018,0.00,,3.64,,"-65,995.83"
,IN,AR,30305785,1005,100,,Invoice,,,,,,30/01/2018,30/01/2018,0.00,,23.58,,"-66,019.41"
,IN,AR,30305809,1005,100,,Invoice,,,,,,30/01/2018,30/01/2018,0.00,,5.29,,"-66,024.70"
,IN,AR,30305839,1005,100,,Invoice,,,,,,30/01/2018,30/01/2018,0.00,,52.97,,"-66,077.67"
,IN,AR,30305857,1005,100,,Invoice,,,,,,30/01/2018,30/01/2018,0.00,,7.29,,"-66,084.96"
,IN,AR,30305962,1005,100,,Invoice,,,,,,30/01/2018,30/01/2018,0.00,,262.35,,"-66,347.31"
,IN,AR,30305971,1005,100,,Invoice,,,,,,30/01/2018,30/01/2018,0.00,,28.39,,"-66,375.70"
,IN,AR,30306030,1005,100,,Invoice,,,,,,30/01/2018,30/01/2018,0.00,,186.21,,"-66,561.91"
,IN,AR,30306085,1005,100,,Invoice,,,,,,30/01/2018,30/01/2018,0.00,,14.43,,"-66,576.34"
,IN,AR,30306162,1005,100,,Invoice,,,,,,30/01/2018,30/01/2018,0.00,,15.25,,"-66,591.59"
,IN,AR,30306175,1005,100,,Invoice,,,,,,30/01/2018,30/01/2018,0.00,,20.01,,"-66,611.60"
,IN,AR,30306217,1005,100,,Invoice,,,,,,30/01/2018,30/01/2018,0.00,,29.15,,"-66,640.75"
,IN,AR,30306254,1005,100,,Invoice,,,,,,30/01/2018,30/01/2018,0.00,,7.29,,"-66,648.04"
,IN,AR,30306271,1005,100,,Invoice,,,,,,30/01/2018,30/01/2018,0.00,,5.47,,"-66,653.51"
,IN,AR,30306301,1005,100,,Invoice,,,,,,30/01/2018,30/01/2018,0.00,,12.85,,"-66,666.36"
,IN,AR,30306306,1005,100,,Invoice,,,,,,30/01/2018,30/01/2018,0.00,,132.00,,"-66,798.36"
,IN,AR,30306311,1005,100,,Invoice,,,,,,30/01/2018,30/01/2018,0.00,,12.14,,"-66,810.50"
,IN,AR,30306332,1005,100,,Invoice,,,,,,30/01/2018,30/01/2018,0.00,,18.98,,"-66,829.48"
,IN,AR,30306349,1005,100,,Invoice,,,,,,30/01/2018,30/01/2018,0.00,,5.08,,"-66,834.56"
,IN,AR,30306404,1005,100,,Invoice,,,,,,30/01/2018,30/01/2018,0.00,,86.78,,"-66,921.34"
,IN,AR,30306424,1005,100,,Invoice,,,,,,30/01/2018,30/01/2018,0.00,,26.10,,"-66,947.44"
,IN,AR,30306425,1005,100,,Invoice,,,,,,30/01/2018,30/01/2018,0.00,,16.61,,"-66,964.05"
,IN,AR,30306426,1005,100,,Invoice,,,,,,30/01/2018,30/01/2018,0.00,,85.43,,"-67,049.48"
,IN,AR,30306463,1005,100,,Invoice,,,,,,30/01/2018,30/01/2018,0.00,,3.51,,"-67,052.99"
,IN,AR,30306468,1005,100,,Invoice,,,,,,30/01/2018,30/01/2018,0.00,,8.00,,"-67,060.99"
,IN,AR,30306469,1005,100,,Invoice,,,,,,30/01/2018,30/01/2018,0.00,,54.66,,"-67,115.65"
,IN,AR,30306483,1005,100,,Invoice,,,,,,30/01/2018,30/01/2018,0.00,,108.92,,"-67,224.57"
,IN,AR,30306502,1005,100,,Invoice,,,,,,30/01/2018,30/01/2018,0.00,,7.02,,"-67,231.59"
,IN,AR,30306651,1005,100,,Invoice,,,,,,30/01/2018,30/01/2018,0.00,,36.44,,"-67,268.03"
,IN,AR,30306663,1005,100,,Invoice,,,,,,30/01/2018,30/01/2018,0.00,,455.51,,"-67,723.54"
,IN,AR,30315783,1005,100,,Invoice,,,,,,30/01/2018,30/01/2018,0.00,,6.36,,"-67,729.90"
,CN,AR,31016929,1005,100,,Credit Note,,,,,,31/01/2018,31/01/2018,248.16,,0.00,,"-67,481.74"
,CN,AR,31016930,1005,100,,Credit Note,,,,,,31/01/2018,31/01/2018,248.16,,0.00,,"-67,233.58"
,CN,AR,31016938,1005,100,,Credit Note,,,,,,31/01/2018,31/01/2018,160.27,,0.00,,"-67,073.31"
,CN,AR,31016939,1005,100,,Credit Note,,,,,,31/01/2018,31/01/2018,5.17,,0.00,,"-67,068.14"
,CN,AR,31017023,1005,100,,Credit Note,,,,,,31/01/2018,31/01/2018,5.17,,0.00,,"-67,062.97"
,CN,AR,31017027,1005,100,,Credit Note,,,,,,31/01/2018,31/01/2018,219.72,,0.00,,"-66,843.25"
,CN,AR,31017053,1005,100,,Credit Note,,,,,,31/01/2018,31/01/2018,12.92,,0.00,,"-66,830.33"
,CN,AR,31017060,1005,100,,Credit Note,,,,,,31/01/2018,31/01/2018,7.76,,0.00,,"-66,822.57"
,CS,AR,32000013,1005,100,,Cash sale,,,,,,31/01/2018,31/01/2018,0.00,,8.42,,"-66,830.99"
,CS,AR,32000024,1005,100,,Cash sale,,,,,,31/01/2018,31/01/2018,0.00,,32.61,,"-66,863.60"
,CS,AR,32000043,1005,100,,Cash sale,,,,,,31/01/2018,31/01/2018,0.00,,7.29,,"-66,870.89"
,CS,AR,32000064,1005,100,,Cash sale,,,,,,31/01/2018,31/01/2018,0.00,,3.64,,"-66,874.53"
,CS,AR,32000068,1005,100,,Cash sale,,,,,,31/01/2018,31/01/2018,0.00,,10.93,,"-66,885.46"
,CS,AR,32000086,1005,100,,Cash sale,,,,,,31/01/2018,31/01/2018,0.00,,3.64,,"-66,889.10"
,CS,AR,32000095,1005,100,,Cash sale,,,,,,31/01/2018,31/01/2018,0.00,,7.29,,"-66,896.39"
,CS,AR,32000120,1005,100,,Cash sale,,,,,,31/01/2018,31/01/2018,0.00,,3.64,,"-66,900.03"
,CS,AR,32000126,1005,100,,Cash sale,,,,,,31/01/2018,31/01/2018,0.00,,7.29,,"-66,907.32"
,CS,AR,32000152,1005,100,,Cash sale,,,,,,31/01/2018,31/01/2018,0.00,,6.02,,"-66,913.34"
,CS,AR,32000193,1005,100,,Cash sale,,,,,,31/01/2018,31/01/2018,0.00,,23.29,,"-66,936.63"
,CS,AR,32000202,1005,100,,Cash sale,,,,,,31/01/2018,31/01/2018,0.00,,3.64,,"-66,940.27"
,CS,AR,32000218,1005,100,,Cash sale,,,,,,31/01/2018,31/01/2018,0.00,,29.15,,"-66,969.42"
,CS,AR,32000300,1005,100,,Cash sale,,,,,,31/01/2018,31/01/2018,0.00,,3.64,,"-66,973.06"
,CS,AR,32000324,1005,100,,Cash sale,,,,,,31/01/2018,31/01/2018,0.00,,18.05,,"-66,991.11"
,CS,AR,32000349,1005,100,,Cash sale,,,,,,31/01/2018,31/01/2018,0.00,,14.58,,"-67,005.69"
,CS,AR,32000375,1005,100,,Cash sale,,,,,,31/01/2018,31/01/2018,0.00,,2.54,,"-67,008.23"
,CS,AR,32000427,1005,100,,Cash sale,,,,,,31/01/2018,31/01/2018,0.00,,7.29,,"-67,015.52"
,CS,AR,32000441,1005,100,,Cash sale,,,,,,31/01/2018,31/01/2018,0.00,,3.64,,"-67,019.16"
,CS,AR,32000479,1005,100,,Cash sale,,,,,,31/01/2018,31/01/2018,0.00,,18.22,,"-67,037.38"
,CS,AR,32000489,1005,100,,Cash sale,,,,,,31/01/2018,31/01/2018,0.00,,10.93,,"-67,048.31"
,CS,AR,32000492,1005,100,,Cash sale,,,,,,31/01/2018,31/01/2018,0.00,,3.64,,"-67,051.95"
,CS,AR,32000498,1005,100,,Cash sale,,,,,,31/01/2018,31/01/2018,0.00,,3.64,,"-67,055.59"
,CS,AR,32000513,1005,100,,Cash sale,,,,,,31/01/2018,31/01/2018,0.00,,18.22,,"-67,073.81"
,CS,AR,32000590,1005,100,,Cash sale,,,,,,31/01/2018,31/01/2018,0.00,,5.17,,"-67,078.98"
,CS,AR,32000601,1005,100,,Cash sale,,,,,,31/01/2018,31/01/2018,0.00,,16.61,,"-67,095.59"
,CS,AR,32000608,1005,100,,Cash sale,,,,,,31/01/2018,31/01/2018,0.00,,24.64,,"-67,120.23"
,CS,AR,32000657,1005,100,,Cash sale,,,,,,31/01/2018,31/01/2018,0.00,,7.29,,"-67,127.52"
,CS,AR,32000675,1005,100,,Cash sale,,,,,,31/01/2018,31/01/2018,0.00,,2.62,,"-67,130.14"
,CS,AR,32000681,1005,100,,Cash sale,,,,,,31/01/2018,31/01/2018,0.00,,3.64,,"-67,133.78"
,CS,AR,32000720,1005,100,,Cash sale,,,,,,31/01/2018,31/01/2018,0.00,,9.15,,"-67,142.93"
,CS,AR,32000733,1005,100,,Cash sale,,,,,,31/01/2018,31/01/2018,0.00,,6.07,,"-67,149.00"
,CS,AR,32000746,1005,100,,Cash sale,,,,,,31/01/2018,31/01/2018,0.00,,9.10,,"-67,158.10"
,CS,AR,32000749,1005,100,,Cash sale,,,,,,31/01/2018,31/01/2018,0.00,,7.29,,"-67,165.39"
,CS,AR,32000762,1005,100,,Cash sale,,,,,,31/01/2018,31/01/2018,0.00,,9.03,,"-67,174.42"
,CS,AR,32000782,1005,100,,Cash sale,,,,,,31/01/2018,31/01/2018,0.00,,13.98,,"-67,188.40"
,CS,AR,32000794,1005,100,,Cash sale,,,,,,31/01/2018,31/01/2018,0.00,,14.58,,"-67,202.98"
,CS,AR,32000803,1005,100,,Cash sale,,,,,,31/01/2018,31/01/2018,0.00,,5.08,,"-67,208.06"
,CS,AR,32000821,1005,100,,Cash sale,,,,,,31/01/2018,31/01/2018,0.00,,12.14,,"-67,220.20"
,CS,AR,32000826,1005,100,,Cash sale,,,,,,31/01/2018,31/01/2018,0.00,,3.64,,"-67,223.84"
,CS,AR,32000851,1005,100,,Cash sale,,,,,,31/01/2018,31/01/2018,0.00,,5.17,,"-67,229.01"
,CS,AR,32000915,1005,100,,Cash sale,,,,,,31/01/2018,31/01/2018,0.00,,5.49,,"-67,234.50"
,CS,AR,32000924,1005,100,,Cash sale,,,,,,31/01/2018,31/01/2018,0.00,,7.29,,"-67,241.79"
,IN,AR,30304354,1005,100,,Invoice,,,,,,31/01/2018,31/01/2018,0.00,,18.64,,"-67,260.43"
,IN,AR,30304407,1005,100,,Invoice,,,,,,31/01/2018,31/01/2018,0.00,,14.58,,"-67,275.01"
,IN,AR,30304419,1005,100,,Invoice,,,,,,31/01/2018,31/01/2018,0.00,,56.14,,"-67,331.15"
,IN,AR,30304420,1005,100,,Invoice,,,,,,31/01/2018,31/01/2018,0.00,,24.41,,"-67,355.56"
,IN,AR,30304430,1005,100,,Invoice,,,,,,31/01/2018,31/01/2018,0.00,,5.68,,"-67,361.24"
,IN,AR,30304433,1005,100,,Invoice,,,,,,31/01/2018,31/01/2018,0.00,,7.29,,"-67,368.53"
,IN,AR,30304435,1005,100,,Invoice,,,,,,31/01/2018,31/01/2018,0.00,,"1,325.09",,"-68,693.62"
,IN,AR,30304438,1005,100,,Invoice,,,,,,31/01/2018,31/01/2018,0.00,,19.92,,"-68,713.54"
,IN,AR,30304447,1005,100,,Invoice,,,,,,31/01/2018,31/01/2018,0.00,,21.02,,"-68,734.56"
,IN,AR,30304448,1005,100,,Invoice,,,,,,31/01/2018,31/01/2018,0.00,,76.19,,"-68,810.75"
,IN,AR,30304452,1005,100,,Invoice,,,,,,31/01/2018,31/01/2018,0.00,,29.15,,"-68,839.90"
,IN,AR,30304513,1005,100,,Invoice,,,,,,31/01/2018,31/01/2018,0.00,,9.70,,"-68,849.60"
,IN,AR,30304537,1005,100,,Invoice,,,,,,31/01/2018,31/01/2018,0.00,,49.83,,"-68,899.43"
,IN,AR,30304543,1005,100,,Invoice,,,,,,31/01/2018,31/01/2018,0.00,,"1,521.82",,"-70,421.25"
,IN,AR,30304559,1005,100,,Invoice,,,,,,31/01/2018,31/01/2018,0.00,,24.00,,"-70,445.25"
,IN,AR,30304593,1005,100,,Invoice,,,,,,31/01/2018,31/01/2018,0.00,,29.15,,"-70,474.40"
,IN,AR,30304654,1005,100,,Invoice,,,,,,31/01/2018,31/01/2018,0.00,,26.00,,"-70,500.40"
,IN,AR,30304667,1005,100,,Invoice,,,,,,31/01/2018,31/01/2018,0.00,,49.83,,"-70,550.23"
,IN,AR,30304722,1005,100,,Invoice,,,,,,31/01/2018,31/01/2018,0.00,,46.39,,"-70,596.62"
,IN,AR,30304723,1005,100,,Invoice,,,,,,31/01/2018,31/01/2018,0.00,,106.42,,"-70,703.04"
,IN,AR,30304724,1005,100,,Invoice,,,,,,31/01/2018,31/01/2018,0.00,,21.83,,"-70,724.87"
,IN,AR,30304785,1005,100,,Invoice,,,,,,31/01/2018,31/01/2018,0.00,,7.96,,"-70,732.83"
,IN,AR,30304786,1005,100,,Invoice,,,,,,31/01/2018,31/01/2018,0.00,,81.23,,"-70,814.06"
,IN,AR,30304802,1005,100,,Invoice,,,,,,31/01/2018,31/01/2018,0.00,,10.93,,"-70,824.99"
,IN,AR,30304872,1005,100,,Invoice,,,,,,31/01/2018,31/01/2018,0.00,,10.17,,"-70,835.16"
,IN,AR,30304873,1005,100,,Invoice,,,,,,31/01/2018,31/01/2018,0.00,,"1,626.18",,"-72,461.34"
,IN,AR,30304874,1005,100,,Invoice,,,,,,31/01/2018,31/01/2018,0.00,,56.14,,"-72,517.48"
,IN,AR,30304875,1005,100,,Invoice,,,,,,31/01/2018,31/01/2018,0.00,,5.26,,"-72,522.74"
,IN,AR,30304876,1005,100,,Invoice,,,,,,31/01/2018,31/01/2018,0.00,,17.54,,"-72,540.28"
,IN,AR,30304877,1005,100,,Invoice,,,,,,31/01/2018,31/01/2018,0.00,,78.94,,"-72,619.22"
,IN,AR,30304892,1005,100,,Invoice,,,,,,31/01/2018,31/01/2018,0.00,,55.09,,"-72,674.31"
,IN,AR,30304896,1005,100,,Invoice,,,,,,31/01/2018,31/01/2018,0.00,,5.17,,"-72,679.48"
,IN,AR,30304897,1005,100,,Invoice,,,,,,31/01/2018,31/01/2018,0.00,,248.16,,"-72,927.64"
,IN,AR,30304900,1005,100,,Invoice,,,,,,31/01/2018,31/01/2018,0.00,,203.42,,"-73,131.06"
,IN,AR,30304913,1005,100,,Invoice,,,,,,31/01/2018,31/01/2018,0.00,,120.76,,"-73,251.82"
,IN,AR,30304918,1005,100,,Invoice,,,,,,31/01/2018,31/01/2018,0.00,,5.17,,"-73,256.99"
,IN,AR,30304921,1005,100,,Invoice,,,,,,31/01/2018,31/01/2018,0.00,,4.24,,"-73,261.23"
,IN,AR,30304934,1005,100,,Invoice,,,,,,31/01/2018,31/01/2018,0.00,,2.80,,"-73,264.03"
,IN,AR,30304941,1005,100,,Invoice,,,,,,31/01/2018,31/01/2018,0.00,,254.28,,"-73,518.31"
,IN,AR,30304984,1005,100,,Invoice,,,,,,31/01/2018,31/01/2018,0.00,,26.29,,"-73,544.60"
,IN,AR,30304989,1005,100,,Invoice,,,,,,31/01/2018,31/01/2018,0.00,,14.58,,"-73,559.18"
,IN,AR,30305007,1005,100,,Invoice,,,,,,31/01/2018,31/01/2018,0.00,,"1,523.15",,"-75,082.33"
,IN,AR,30305030,1005,100,,Invoice,,,,,,31/01/2018,31/01/2018,0.00,,32.81,,"-75,115.14"
,IN,AR,30305045,1005,100,,Invoice,,,,,,31/01/2018,31/01/2018,0.00,,10.17,,"-75,125.31"
,IN,AR,30305049,1005,100,,Invoice,,,,,,31/01/2018,31/01/2018,0.00,,18.22,,"-75,143.53"
,IN,AR,30305055,1005,100,,Invoice,,,,,,31/01/2018,31/01/2018,0.00,,4.29,,"-75,147.82"
,IN,AR,30305095,1005,100,,Invoice,,,,,,31/01/2018,31/01/2018,0.00,,731.59,,"-75,879.41"
,IN,AR,30305096,1005,100,,Invoice,,,,,,31/01/2018,31/01/2018,0.00,,13.42,,"-75,892.83"
,IN,AR,30305097,1005,100,,Invoice,,,,,,31/01/2018,31/01/2018,0.00,,18.46,,"-75,911.29"
,IN,AR,30305098,1005,100,,Invoice,,,,,,31/01/2018,31/01/2018,0.00,,18.46,,"-75,929.75"
,IN,AR,30305099,1005,100,,Invoice,,,,,,31/01/2018,31/01/2018,0.00,,18.46,,"-75,948.21"
,IN,AR,30305100,1005,100,,Invoice,,,,,,31/01/2018,31/01/2018,0.00,,18.46,,"-75,966.67"
,IN,AR,30305101,1005,100,,Invoice,,,,,,31/01/2018,31/01/2018,0.00,,6.71,,"-75,973.38"
,IN,AR,30305102,1005,100,,Invoice,,,,,,31/01/2018,31/01/2018,0.00,,3.36,,"-75,976.74"
,IN,AR,30305128,1005,100,,Invoice,,,,,,31/01/2018,31/01/2018,0.00,,7.75,,"-75,984.49"
,IN,AR,30305151,1005,100,,Invoice,,,,,,31/01/2018,31/01/2018,0.00,,87.71,,"-76,072.20"
,IN,AR,30305154,1005,100,,Invoice,,,,,,31/01/2018,31/01/2018,0.00,,171.92,,"-76,244.12"
,IN,AR,30305159,1005,100,,Invoice,,,,,,31/01/2018,31/01/2018,0.00,,108.03,,"-76,352.15"
,IN,AR,30305160,1005,100,,Invoice,,,,,,31/01/2018,31/01/2018,0.00,,50.80,,"-76,402.95"
,IN,AR,30305161,1005,100,,Invoice,,,,,,31/01/2018,31/01/2018,0.00,,61.40,,"-76,464.35"
,IN,AR,30305162,1005,100,,Invoice,,,,,,31/01/2018,31/01/2018,0.00,,184.19,,"-76,648.54"
,IN,AR,30305163,1005,100,,Invoice,,,,,,31/01/2018,31/01/2018,0.00,,40.35,,"-76,688.89"
,IN,AR,30305164,1005,100,,Invoice,,,,,,31/01/2018,31/01/2018,0.00,,15.05,,"-76,703.94"
,IN,AR,30305165,1005,100,,Invoice,,,,,,31/01/2018,31/01/2018,0.00,,9.41,,"-76,713.35"
,IN,AR,30305166,1005,100,,Invoice,,,,,,31/01/2018,31/01/2018,0.00,,39.51,,"-76,752.86"
,IN,AR,30305167,1005,100,,Invoice,,,,,,31/01/2018,31/01/2018,0.00,,31.98,,"-76,784.84"
,IN,AR,30305168,1005,100,,Invoice,,,,,,31/01/2018,31/01/2018,0.00,,22.58,,"-76,807.42"
,IN,AR,30305169,1005,100,,Invoice,,,,,,31/01/2018,31/01/2018,0.00,,26.34,,"-76,833.76"
,IN,AR,30305170,1005,100,,Invoice,,,,,,31/01/2018,31/01/2018,0.00,,15.05,,"-76,848.81"
,IN,AR,30305171,1005,100,,Invoice,,,,,,31/01/2018,31/01/2018,0.00,,37.63,,"-76,886.44"
,IN,AR,30305172,1005,100,,Invoice,,,,,,31/01/2018,31/01/2018,0.00,,15.05,,"-76,901.49"
,IN,AR,30305173,1005,100,,Invoice,,,,,,31/01/2018,31/01/2018,0.00,,16.93,,"-76,918.42"
,IN,AR,30305174,1005,100,,Invoice,,,,,,31/01/2018,31/01/2018,0.00,,3.76,,"-76,922.18"
,IN,AR,30305175,1005,100,,Invoice,,,,,,31/01/2018,31/01/2018,0.00,,18.81,,"-76,940.99"
,IN,AR,30305177,1005,100,,Invoice,,,,,,31/01/2018,31/01/2018,0.00,,2.54,,"-76,943.53"
,IN,AR,30305179,1005,100,,Invoice,,,,,,31/01/2018,31/01/2018,0.00,,345.58,,"-77,289.11"
,IN,AR,30305181,1005,100,,Invoice,,,,,,31/01/2018,31/01/2018,0.00,,61.40,,"-77,350.51"
,IN,AR,30305194,1005,100,,Invoice,,,,,,31/01/2018,31/01/2018,0.00,,29.82,,"-77,380.33"
,IN,AR,30305196,1005,100,,Invoice,,,,,,31/01/2018,31/01/2018,0.00,,11.29,,"-77,391.62"
,IN,AR,30305197,1005,100,,Invoice,,,,,,31/01/2018,31/01/2018,0.00,,38.59,,"-77,430.21"
,IN,AR,30305198,1005,100,,Invoice,,,,,,31/01/2018,31/01/2018,0.00,,38.59,,"-77,468.80"
,IN,AR,30305199,1005,100,,Invoice,,,,,,31/01/2018,31/01/2018,0.00,,31.58,,"-77,500.38"
,IN,AR,30305205,1005,100,,Invoice,,,,,,31/01/2018,31/01/2018,0.00,,26.31,,"-77,526.69"
,IN,AR,30305206,1005,100,,Invoice,,,,,,31/01/2018,31/01/2018,0.00,,42.10,,"-77,568.79"
,IN,AR,30305207,1005,100,,Invoice,,,,,,31/01/2018,31/01/2018,0.00,,22.81,,"-77,591.60"
,IN,AR,30305209,1005,100,,Invoice,,,,,,31/01/2018,31/01/2018,0.00,,43.73,,"-77,635.33"
,IN,AR,30305215,1005,100,,Invoice,,,,,,31/01/2018,31/01/2018,0.00,,5.26,,"-77,640.59"
,IN,AR,30305236,1005,100,,Invoice,,,,,,31/01/2018,31/01/2018,0.00,,24.56,,"-77,665.15"
,IN,AR,30305272,1005,100,,Invoice,,,,,,31/01/2018,31/01/2018,0.00,,4.24,,"-77,669.39"
,IN,AR,30305286,1005,100,,Invoice,,,,,,31/01/2018,31/01/2018,0.00,,91.19,,"-77,760.58"
,IN,AR,30305287,1005,100,,Invoice,,,,,,31/01/2018,31/01/2018,0.00,,25.03,,"-77,785.61"
,IN,AR,30305288,1005,100,,Invoice,,,,,,31/01/2018,31/01/2018,0.00,,12.52,,"-77,798.13"
,IN,AR,30305289,1005,100,,Invoice,,,,,,31/01/2018,31/01/2018,0.00,,73.31,,"-77,871.44"
,IN,AR,30305290,1005,100,,Invoice,,,,,,31/01/2018,31/01/2018,0.00,,44.70,,"-77,916.14"
,IN,AR,30305291,1005,100,,Invoice,,,,,,31/01/2018,31/01/2018,0.00,,16.09,,"-77,932.23"
,IN,AR,30305292,1005,100,,Invoice,,,,,,31/01/2018,31/01/2018,0.00,,17.88,,"-77,950.11"
,IN,AR,30305293,1005,100,,Invoice,,,,,,31/01/2018,31/01/2018,0.00,,30.40,,"-77,980.51"
,IN,AR,30305294,1005,100,,Invoice,,,,,,31/01/2018,31/01/2018,0.00,,239.61,,"-78,220.12"
,IN,AR,30305295,1005,100,,Invoice,,,,,,31/01/2018,31/01/2018,0.00,,12.52,,"-78,232.64"
,IN,AR,30305296,1005,100,,Invoice,,,,,,31/01/2018,31/01/2018,0.00,,8.94,,"-78,241.58"
,IN,AR,30305297,1005,100,,Invoice,,,,,,31/01/2018,31/01/2018,0.00,,25.03,,"-78,266.61"
,IN,AR,30305298,1005,100,,Invoice,,,,,,31/01/2018,31/01/2018,0.00,,14.31,,"-78,280.92"
,IN,AR,30305300,1005,100,,Invoice,,,,,,31/01/2018,31/01/2018,0.00,,19.67,,"-78,300.59"
,IN,AR,30305301,1005,100,,Invoice,,,,,,31/01/2018,31/01/2018,0.00,,30.40,,"-78,330.99"
,IN,AR,30305302,1005,100,,Invoice,,,,,,31/01/2018,31/01/2018,0.00,,67.95,,"-78,398.94"
,IN,AR,30305303,1005,100,,Invoice,,,,,,31/01/2018,31/01/2018,0.00,,10.73,,"-78,409.67"
,IN,AR,30305304,1005,100,,Invoice,,,,,,31/01/2018,31/01/2018,0.00,,12.52,,"-78,422.19"
,IN,AR,30305305,1005,100,,Invoice,,,,,,31/01/2018,31/01/2018,0.00,,26.82,,"-78,449.01"
,IN,AR,30305306,1005,100,,Invoice,,,,,,31/01/2018,31/01/2018,0.00,,8.94,,"-78,457.95"
,IN,AR,30305307,1005,100,,Invoice,,,,,,31/01/2018,31/01/2018,0.00,,8.94,,"-78,466.89"
,IN,AR,30305308,1005,100,,Invoice,,,,,,31/01/2018,31/01/2018,0.00,,23.25,,"-78,490.14"
,IN,AR,30305310,1005,100,,Invoice,,,,,,31/01/2018,31/01/2018,0.00,,91.22,,"-78,581.36"
,IN,AR,30305312,1005,100,,Invoice,,,,,,31/01/2018,31/01/2018,0.00,,108.25,,"-78,689.61"
,IN,AR,30305313,1005,100,,Invoice,,,,,,31/01/2018,31/01/2018,0.00,,110.29,,"-78,799.90"
,IN,AR,30305314,1005,100,,Invoice,,,,,,31/01/2018,31/01/2018,0.00,,22.47,,"-78,822.37"
,IN,AR,30305315,1005,100,,Invoice,,,,,,31/01/2018,31/01/2018,0.00,,102.12,,"-78,924.49"
,IN,AR,30305316,1005,100,,Invoice,,,,,,31/01/2018,31/01/2018,0.00,,32.68,,"-78,957.17"
,IN,AR,30305317,1005,100,,Invoice,,,,,,31/01/2018,31/01/2018,0.00,,8.17,,"-78,965.34"
,IN,AR,30305318,1005,100,,Invoice,,,,,,31/01/2018,31/01/2018,0.00,,167.47,,"-79,132.81"
,IN,AR,30305319,1005,100,,Invoice,,,,,,31/01/2018,31/01/2018,0.00,,6.13,,"-79,138.94"
,IN,AR,30305333,1005,100,,Invoice,,,,,,31/01/2018,31/01/2018,0.00,,4.24,,"-79,143.18"
,IN,AR,30305340,1005,100,,Invoice,,,,,,31/01/2018,31/01/2018,0.00,,180.12,,"-79,323.30"
,IN,AR,30305366,1005,100,,Invoice,,,,,,31/01/2018,31/01/2018,0.00,,18.17,,"-79,341.47"
,IN,AR,30305386,1005,100,,Invoice,,,,,,31/01/2018,31/01/2018,0.00,,25.00,,"-79,366.47"
,IN,AR,30305455,1005,100,,Invoice,,,,,,31/01/2018,31/01/2018,0.00,,10.60,,"-79,377.07"
,IN,AR,30305469,1005,100,,Invoice,,,,,,31/01/2018,31/01/2018,0.00,,6.36,,"-79,383.43"
,IN,AR,30305509,1005,100,,Invoice,,,,,,31/01/2018,31/01/2018,0.00,,18.25,,"-79,401.68"
,IN,AR,30305550,1005,100,,Invoice,,,,,,31/01/2018,31/01/2018,0.00,,14.83,,"-79,416.51"
,IN,AR,30305558,1005,100,,Invoice,,,,,,31/01/2018,31/01/2018,0.00,,11.44,,"-79,427.95"
,IN,AR,30305567,1005,100,,Invoice,,,,,,31/01/2018,31/01/2018,0.00,,11.19,,"-79,439.14"
,IN,AR,30305570,1005,100,,Invoice,,,,,,31/01/2018,31/01/2018,0.00,,"1,183.69",,"-80,622.83"
,IN,AR,30305575,1005,100,,Invoice,,,,,,31/01/2018,31/01/2018,0.00,,46.98,,"-80,669.81"
,IN,AR,30305576,1005,100,,Invoice,,,,,,31/01/2018,31/01/2018,0.00,,29.82,,"-80,699.63"
,IN,AR,30305599,1005,100,,Invoice,,,,,,31/01/2018,31/01/2018,0.00,,10.93,,"-80,710.56"
,IN,AR,30305608,1005,100,,Invoice,,,,,,31/01/2018,31/01/2018,0.00,,203.42,,"-80,913.98"
,IN,AR,30305612,1005,100,,Invoice,,,,,,31/01/2018,31/01/2018,0.00,,144.76,,"-81,058.74"
,IN,AR,30305614,1005,100,,Invoice,,,,,,31/01/2018,31/01/2018,0.00,,6.36,,"-81,065.10"
,IN,AR,30305622,1005,100,,Invoice,,,,,,31/01/2018,31/01/2018,0.00,,22.37,,"-81,087.47"
,IN,AR,30305677,1005,100,,Invoice,,,,,,31/01/2018,31/01/2018,0.00,,11.02,,"-81,098.49"
,IN,AR,30305678,1005,100,,Invoice,,,,,,31/01/2018,31/01/2018,0.00,,3.64,,"-81,102.13"
,IN,AR,30305706,1005,100,,Invoice,,,,,,31/01/2018,31/01/2018,0.00,,52.53,,"-81,154.66"
,IN,AR,30305724,1005,100,,Invoice,,,,,,31/01/2018,31/01/2018,0.00,,144.86,,"-81,299.52"
,IN,AR,30305729,1005,100,,Invoice,,,,,,31/01/2018,31/01/2018,0.00,,18.05,,"-81,317.57"
,IN,AR,30305770,1005,100,,Invoice,,,,,,31/01/2018,31/01/2018,0.00,,49.83,,"-81,367.40"
,IN,AR,30305792,1005,100,,Invoice,,,,,,31/01/2018,31/01/2018,0.00,,3.64,,"-81,371.04"
,IN,AR,30305814,1005,100,,Invoice,,,,,,31/01/2018,31/01/2018,0.00,,6.02,,"-81,377.06"
,IN,AR,30305826,1005,100,,Invoice,,,,,,31/01/2018,31/01/2018,0.00,,85.19,,"-81,462.25"
,IN,AR,30305835,1005,100,,Invoice,,,,,,31/01/2018,31/01/2018,0.00,,8.24,,"-81,470.49"
,IN,AR,30305869,1005,100,,Invoice,,,,,,31/01/2018,31/01/2018,0.00,,8.00,,"-81,478.49"
,IN,AR,30305881,1005,100,,Invoice,,,,,,31/01/2018,31/01/2018,0.00,,685.29,,"-82,163.78"
,IN,AR,30305901,1005,100,,Invoice,,,,,,31/01/2018,31/01/2018,0.00,,20.97,,"-82,184.75"
,IN,AR,30305902,1005,100,,Invoice,,,,,,31/01/2018,31/01/2018,0.00,,53.60,,"-82,238.35"
,IN,AR,30305903,1005,100,,Invoice,,,,,,31/01/2018,31/01/2018,0.00,,16.31,,"-82,254.66"
,IN,AR,30305904,1005,100,,Invoice,,,,,,31/01/2018,31/01/2018,0.00,,41.95,,"-82,296.61"
,IN,AR,30305905,1005,100,,Invoice,,,,,,31/01/2018,31/01/2018,0.00,,58.26,,"-82,354.87"
,IN,AR,30305906,1005,100,,Invoice,,,,,,31/01/2018,31/01/2018,0.00,,39.62,,"-82,394.49"
,IN,AR,30305907,1005,100,,Invoice,,,,,,31/01/2018,31/01/2018,0.00,,53.60,,"-82,448.09"
,IN,AR,30305908,1005,100,,Invoice,,,,,,31/01/2018,31/01/2018,0.00,,25.64,,"-82,473.73"
,IN,AR,30305909,1005,100,,Invoice,,,,,,31/01/2018,31/01/2018,0.00,,25.64,,"-82,499.37"
,IN,AR,30305912,1005,100,,Invoice,,,,,,31/01/2018,31/01/2018,0.00,,831.17,,"-83,330.54"
,IN,AR,30305977,1005,100,,Invoice,,,,,,31/01/2018,31/01/2018,0.00,,46.00,,"-83,376.54"
,IN,AR,30305991,1005,100,,Invoice,,,,,,31/01/2018,31/01/2018,0.00,,54.12,,"-83,430.66"
,IN,AR,30306002,1005,100,,Invoice,,,,,,31/01/2018,31/01/2018,0.00,,206.70,,"-83,637.36"
,IN,AR,30306003,1005,100,,Invoice,,,,,,31/01/2018,31/01/2018,0.00,,267.42,,"-83,904.78"
,IN,AR,30306016,1005,100,,Invoice,,,,,,31/01/2018,31/01/2018,0.00,,3.64,,"-83,908.42"
,IN,AR,30306034,1005,100,,Invoice,,,,,,31/01/2018,31/01/2018,0.00,,7.29,,"-83,915.71"
,IN,AR,30306086,1005,100,,Invoice,,,,,,31/01/2018,31/01/2018,0.00,,9.62,,"-83,925.33"
,IN,AR,30306087,1005,100,,Invoice,,,,,,31/01/2018,31/01/2018,0.00,,11.22,,"-83,936.55"
,IN,AR,30306088,1005,100,,Invoice,,,,,,31/01/2018,31/01/2018,0.00,,32.07,,"-83,968.62"
,IN,AR,30306089,1005,100,,Invoice,,,,,,31/01/2018,31/01/2018,0.00,,8.02,,"-83,976.64"
,IN,AR,30306090,1005,100,,Invoice,,,,,,31/01/2018,31/01/2018,0.00,,4.81,,"-83,981.45"
,IN,AR,30306091,1005,100,,Invoice,,,,,,31/01/2018,31/01/2018,0.00,,3.20,,"-83,984.65"
,IN,AR,30306092,1005,100,,Invoice,,,,,,31/01/2018,31/01/2018,0.00,,8.02,,"-83,992.67"
,IN,AR,30306109,1005,100,,Invoice,,,,,,31/01/2018,31/01/2018,0.00,,14.58,,"-84,007.25"
,IN,AR,30306113,1005,100,,Invoice,,,,,,31/01/2018,31/01/2018,0.00,,234.07,,"-84,241.32"
,IN,AR,30306114,1005,100,,Invoice,,,,,,31/01/2018,31/01/2018,0.00,,20.76,,"-84,262.08"
,IN,AR,30306115,1005,100,,Invoice,,,,,,31/01/2018,31/01/2018,0.00,,9.44,,"-84,271.52"
,IN,AR,30306116,1005,100,,Invoice,,,,,,31/01/2018,31/01/2018,0.00,,32.09,,"-84,303.61"
,IN,AR,30306119,1005,100,,Invoice,,,,,,31/01/2018,31/01/2018,0.00,,5.09,,"-84,308.70"
,IN,AR,30306130,1005,100,,Invoice,,,,,,31/01/2018,31/01/2018,0.00,,23.28,,"-84,331.98"
,IN,AR,30306208,1005,100,,Invoice,,,,,,31/01/2018,31/01/2018,0.00,,9.05,,"-84,341.03"
,IN,AR,30306213,1005,100,,Invoice,,,,,,31/01/2018,31/01/2018,0.00,,5.83,,"-84,346.86"
,IN,AR,30306222,1005,100,,Invoice,,,,,,31/01/2018,31/01/2018,0.00,,60.94,,"-84,407.80"
,IN,AR,30306236,1005,100,,Invoice,,,,,,31/01/2018,31/01/2018,0.00,,18.92,,"-84,426.72"
,IN,AR,30306241,1005,100,,Invoice,,,,,,31/01/2018,31/01/2018,0.00,,23.90,,"-84,450.62"
,IN,AR,30306282,1005,100,,Invoice,,,,,,31/01/2018,31/01/2018,0.00,,29.15,,"-84,479.77"
,IN,AR,30306337,1005,100,,Invoice,,,,,,31/01/2018,31/01/2018,0.00,,8.00,,"-84,487.77"
,IN,AR,30306367,1005,100,,Invoice,,,,,,31/01/2018,31/01/2018,0.00,,40.58,,"-84,528.35"
,IN,AR,30306400,1005,100,,Invoice,,,,,,31/01/2018,31/01/2018,0.00,,19.12,,"-84,547.47"
,IN,AR,30306443,1005,100,,Invoice,,,,,,31/01/2018,31/01/2018,0.00,,16.93,,"-84,564.40"
,IN,AR,30306444,1005,100,,Invoice,,,,,,31/01/2018,31/01/2018,0.00,,11.29,,"-84,575.69"
,IN,AR,30306445,1005,100,,Invoice,,,,,,31/01/2018,31/01/2018,0.00,,15.05,,"-84,590.74"
,IN,AR,30306446,1005,100,,Invoice,,,,,,31/01/2018,31/01/2018,0.00,,3.76,,"-84,594.50"
,IN,AR,30306459,1005,100,,Invoice,,,,,,31/01/2018,31/01/2018,0.00,,3.51,,"-84,598.01"
,IN,AR,30306489,1005,100,,Invoice,,,,,,31/01/2018,31/01/2018,0.00,,659.59,,"-85,257.60"
,IN,AR,30306507,1005,100,,Invoice,,,,,,31/01/2018,31/01/2018,0.00,,6.56,,"-85,264.16"
,IN,AR,30306537,1005,100,,Invoice,,,,,,31/01/2018,31/01/2018,0.00,,3.76,,"-85,267.92"
,IN,AR,30306542,1005,100,,Invoice,,,,,,31/01/2018,31/01/2018,0.00,,54.66,,"-85,322.58"
,IN,AR,30306545,1005,100,,Invoice,,,,,,31/01/2018,31/01/2018,0.00,,205.81,,"-85,528.39"
,IN,AR,30306546,1005,100,,Invoice,,,,,,31/01/2018,31/01/2018,0.00,,5.10,,"-85,533.49"
,IN,AR,30306547,1005,100,,Invoice,,,,,,31/01/2018,31/01/2018,0.00,,13.61,,"-85,547.10"
,IN,AR,30306548,1005,100,,Invoice,,,,,,31/01/2018,31/01/2018,0.00,,110.55,,"-85,657.65"
,IN,AR,30306549,1005,100,,Invoice,,,,,,31/01/2018,31/01/2018,0.00,,5.10,,"-85,662.75"
,IN,AR,30306550,1005,100,,Invoice,,,,,,31/01/2018,31/01/2018,0.00,,10.20,,"-85,672.95"
,IN,AR,30306551,1005,100,,Invoice,,,,,,31/01/2018,31/01/2018,0.00,,22.11,,"-85,695.06"
,IN,AR,30306552,1005,100,,Invoice,,,,,,31/01/2018,31/01/2018,0.00,,6.81,,"-85,701.87"
,IN,AR,30306553,1005,100,,Invoice,,,,,,31/01/2018,31/01/2018,0.00,,1.70,,"-85,703.57"
,IN,AR,30306554,1005,100,,Invoice,,,,,,31/01/2018,31/01/2018,0.00,,5.10,,"-85,708.67"
,IN,AR,30306555,1005,100,,Invoice,,,,,,31/01/2018,31/01/2018,0.00,,10.20,,"-85,718.87"
,IN,AR,30306556,1005,100,,Invoice,,,,,,31/01/2018,31/01/2018,0.00,,11.91,,"-85,730.78"
,IN,AR,30306557,1005,100,,Invoice,,,,,,31/01/2018,31/01/2018,0.00,,10.20,,"-85,740.98"
,IN,AR,30306558,1005,100,,Invoice,,,,,,31/01/2018,31/01/2018,0.00,,13.61,,"-85,754.59"
,IN,AR,30306559,1005,100,,Invoice,,,,,,31/01/2018,31/01/2018,0.00,,6.81,,"-85,761.40"
,IN,AR,30306560,1005,100,,Invoice,,,,,,31/01/2018,31/01/2018,0.00,,10.20,,"-85,771.60"
,IN,AR,30306561,1005,100,,Invoice,,,,,,31/01/2018,31/01/2018,0.00,,3.40,,"-85,775.00"
,IN,AR,30306562,1005,100,,Invoice,,,,,,31/01/2018,31/01/2018,0.00,,3.40,,"-85,778.40"
,IN,AR,30306563,1005,100,,Invoice,,,,,,31/01/2018,31/01/2018,0.00,,11.91,,"-85,790.31"
,IN,AR,30306564,1005,100,,Invoice,,,,,,31/01/2018,31/01/2018,0.00,,8.50,,"-85,798.81"
,IN,AR,30306565,1005,100,,Invoice,,,,,,31/01/2018,31/01/2018,0.00,,6.81,,"-85,805.62"
,IN,AR,30306566,1005,100,,Invoice,,,,,,31/01/2018,31/01/2018,0.00,,3.40,,"-85,809.02"
,IN,AR,30306567,1005,100,,Invoice,,,,,,31/01/2018,31/01/2018,0.00,,3.40,,"-85,812.42"
,IN,AR,30306568,1005,100,,Invoice,,,,,,31/01/2018,31/01/2018,0.00,,17.01,,"-85,829.43"
,IN,AR,30306601,1005,100,,Invoice,,,,,,31/01/2018,31/01/2018,0.00,,11.19,,"-85,840.62"
,IN,AR,30306627,1005,100,,Invoice,,,,,,31/01/2018,31/01/2018,0.00,,16.47,,"-85,857.09"
,CN,AR,31018082,1005,100,,Credit Note,,,,,,31/01/2018,31/01/2018,5.17,,0.00,,"-85,851.92"
,IN,AR,30315622,1005,100,,Invoice,,,,,,31/01/2018,31/01/2018,0.00,,4.24,,"-85,856.16"
,CN,AR,31017227,1005,100,,Credit Note,,,,,,01/02/2018,01/02/2018,10.93,,0.00,,"-85,845.23"
,CS,AR,32000929,1005,100,,Cash sale,,,,,,01/02/2018,01/02/2018,0.00,,21.06,,"-85,866.29"
,CS,AR,32000944,1005,100,,Cash sale,,,,,,01/02/2018,01/02/2018,0.00,,3.64,,"-85,869.93"
,CS,AR,32000958,1005,100,,Cash sale,,,,,,01/02/2018,01/02/2018,0.00,,3.64,,"-85,873.57"
,CS,AR,32000965,1005,100,,Cash sale,,,,,,01/02/2018,01/02/2018,0.00,,7.29,,"-85,880.86"
,CS,AR,32000987,1005,100,,Cash sale,,,,,,01/02/2018,01/02/2018,0.00,,3.64,,"-85,884.50"
,CS,AR,32000990,1005,100,,Cash sale,,,,,,01/02/2018,01/02/2018,0.00,,29.15,,"-85,913.65"
,CS,AR,32001001,1005,100,,Cash sale,,,,,,01/02/2018,01/02/2018,0.00,,3.64,,"-85,917.29"
,CS,AR,32001017,1005,100,,Cash sale,,,,,,01/02/2018,01/02/2018,0.00,,3.64,,"-85,920.93"
,CS,AR,32001054,1005,100,,Cash sale,,,,,,01/02/2018,01/02/2018,0.00,,3.64,,"-85,924.57"
,CS,AR,32001056,1005,100,,Cash sale,,,,,,01/02/2018,01/02/2018,0.00,,3.64,,"-85,928.21"
,CS,AR,32001079,1005,100,,Cash sale,,,,,,01/02/2018,01/02/2018,0.00,,10.93,,"-85,939.14"
,CS,AR,32001113,1005,100,,Cash sale,,,,,,01/02/2018,01/02/2018,0.00,,5.17,,"-85,944.31"
,CS,AR,32001118,1005,100,,Cash sale,,,,,,01/02/2018,01/02/2018,0.00,,7.29,,"-85,951.60"
,CS,AR,32001122,1005,100,,Cash sale,,,,,,01/02/2018,01/02/2018,0.00,,12.92,,"-85,964.52"
,CS,AR,32001140,1005,100,,Cash sale,,,,,,01/02/2018,01/02/2018,0.00,,10.35,,"-85,974.87"
,CS,AR,32001143,1005,100,,Cash sale,,,,,,01/02/2018,01/02/2018,0.00,,10.93,,"-85,985.80"
,CS,AR,32001161,1005,100,,Cash sale,,,,,,01/02/2018,01/02/2018,0.00,,10.34,,"-85,996.14"
,CS,AR,32001165,1005,100,,Cash sale,,,,,,01/02/2018,01/02/2018,0.00,,3.64,,"-85,999.78"
,CS,AR,32001218,1005,100,,Cash sale,,,,,,01/02/2018,01/02/2018,0.00,,21.86,,"-86,021.64"
,CS,AR,32001306,1005,100,,Cash sale,,,,,,01/02/2018,01/02/2018,0.00,,3.64,,"-86,025.28"
,CS,AR,32001330,1005,100,,Cash sale,,,,,,01/02/2018,01/02/2018,0.00,,50.34,,"-86,075.62"
,CS,AR,32001375,1005,100,,Cash sale,,,,,,01/02/2018,01/02/2018,0.00,,2.58,,"-86,078.20"
,CS,AR,32001416,1005,100,,Cash sale,,,,,,01/02/2018,01/02/2018,0.00,,30.08,,"-86,108.28"
,CS,AR,32001417,1005,100,,Cash sale,,,,,,01/02/2018,01/02/2018,0.00,,18.05,,"-86,126.33"
,CS,AR,32001476,1005,100,,Cash sale,,,,,,01/02/2018,01/02/2018,0.00,,22.88,,"-86,149.21"
,CS,AR,32001485,1005,100,,Cash sale,,,,,,01/02/2018,01/02/2018,0.00,,29.15,,"-86,178.36"
,CS,AR,32001510,1005,100,,Cash sale,,,,,,01/02/2018,01/02/2018,0.00,,8.90,,"-86,187.26"
,CS,AR,32001588,1005,100,,Cash sale,,,,,,01/02/2018,01/02/2018,0.00,,5.47,,"-86,192.73"
,CS,AR,32001610,1005,100,,Cash sale,,,,,,01/02/2018,01/02/2018,0.00,,54.66,,"-86,247.39"
,CS,AR,32001615,1005,100,,Cash sale,,,,,,01/02/2018,01/02/2018,0.00,,6.56,,"-86,253.95"
,CS,AR,32001641,1005,100,,Cash sale,,,,,,01/02/2018,01/02/2018,0.00,,10.93,,"-86,264.88"
,CS,AR,32001681,1005,100,,Cash sale,,,,,,01/02/2018,01/02/2018,0.00,,7.29,,"-86,272.17"
,IN,AR,30306673,1005,100,,Invoice,,,,,,01/02/2018,01/02/2018,0.00,,8.90,,"-86,281.07"
,IN,AR,30306696,1005,100,,Invoice,,,,,,01/02/2018,01/02/2018,0.00,,3.64,,"-86,284.71"
,IN,AR,30306714,1005,100,,Invoice,,,,,,01/02/2018,01/02/2018,0.00,,3.64,,"-86,288.35"
,IN,AR,30306748,1005,100,,Invoice,,,,,,01/02/2018,01/02/2018,0.00,,7.29,,"-86,295.64"
,IN,AR,30306785,1005,100,,Invoice,,,,,,01/02/2018,01/02/2018,0.00,,2.03,,"-86,297.67"
,IN,AR,30306795,1005,100,,Invoice,,,,,,01/02/2018,01/02/2018,0.00,,10.93,,"-86,308.60"
,IN,AR,30306860,1005,100,,Invoice,,,,,,01/02/2018,01/02/2018,0.00,,54.66,,"-86,363.26"
,IN,AR,30306873,1005,100,,Invoice,,,,,,01/02/2018,01/02/2018,0.00,,47.37,,"-86,410.63"
,IN,AR,30306891,1005,100,,Invoice,,,,,,01/02/2018,01/02/2018,0.00,,54.66,,"-86,465.29"
,IN,AR,30306926,1005,100,,Invoice,,,,,,01/02/2018,01/02/2018,0.00,,3.64,,"-86,468.93"
,IN,AR,30306942,1005,100,,Invoice,,,,,,01/02/2018,01/02/2018,0.00,,7.29,,"-86,476.22"
,IN,AR,30306997,1005,100,,Invoice,,,,,,01/02/2018,01/02/2018,0.00,,24.71,,"-86,500.93"
,IN,AR,30307004,1005,100,,Invoice,,,,,,01/02/2018,01/02/2018,0.00,,18.22,,"-86,519.15"
,IN,AR,30307012,1005,100,,Invoice,,,,,,01/02/2018,01/02/2018,0.00,,17.03,,"-86,536.18"
,IN,AR,30307039,1005,100,,Invoice,,,,,,01/02/2018,01/02/2018,0.00,,20.00,,"-86,556.18"
,IN,AR,30307098,1005,100,,Invoice,,,,,,01/02/2018,01/02/2018,0.00,,21.86,,"-86,578.04"
,IN,AR,30307106,1005,100,,Invoice,,,,,,01/02/2018,01/02/2018,0.00,,24.50,,"-86,602.54"
,IN,AR,30307118,1005,100,,Invoice,,,,,,01/02/2018,01/02/2018,0.00,,182.20,,"-86,784.74"
,IN,AR,30307120,1005,100,,Invoice,,,,,,01/02/2018,01/02/2018,0.00,,43.93,,"-86,828.67"
,IN,AR,30307212,1005,100,,Invoice,,,,,,01/02/2018,01/02/2018,0.00,,7.29,,"-86,835.96"
,IN,AR,30307251,1005,100,,Invoice,,,,,,01/02/2018,01/02/2018,0.00,,19.12,,"-86,855.08"
,IN,AR,30307264,1005,100,,Invoice,,,,,,01/02/2018,01/02/2018,0.00,,22.03,,"-86,877.11"
,IN,AR,30307296,1005,100,,Invoice,,,,,,01/02/2018,01/02/2018,0.00,,7.29,,"-86,884.40"
,IN,AR,30307303,1005,100,,Invoice,,,,,,01/02/2018,01/02/2018,0.00,,16.73,,"-86,901.13"
,IN,AR,30307324,1005,100,,Invoice,,,,,,01/02/2018,01/02/2018,0.00,,16.10,,"-86,917.23"
,IN,AR,30307325,1005,100,,Invoice,,,,,,01/02/2018,01/02/2018,0.00,,28.98,,"-86,946.21"
,IN,AR,30307348,1005,100,,Invoice,,,,,,01/02/2018,01/02/2018,0.00,,4.24,,"-86,950.45"
,IN,AR,30307399,1005,100,,Invoice,,,,,,01/02/2018,01/02/2018,0.00,,10.93,,"-86,961.38"
,IN,AR,30307418,1005,100,,Invoice,,,,,,01/02/2018,01/02/2018,0.00,,7.63,,"-86,969.01"
,IN,AR,30307419,1005,100,,Invoice,,,,,,01/02/2018,01/02/2018,0.00,,5.08,,"-86,974.09"
,IN,AR,30307446,1005,100,,Invoice,,,,,,01/02/2018,01/02/2018,0.00,,46.20,,"-87,020.29"
,IN,AR,30307447,1005,100,,Invoice,,,,,,01/02/2018,01/02/2018,0.00,,19.12,,"-87,039.41"
,IN,AR,30307448,1005,100,,Invoice,,,,,,01/02/2018,01/02/2018,0.00,,58.95,,"-87,098.36"
,IN,AR,30307460,1005,100,,Invoice,,,,,,01/02/2018,01/02/2018,0.00,,14.71,,"-87,113.07"
,IN,AR,30307464,1005,100,,Invoice,,,,,,01/02/2018,01/02/2018,0.00,,14.58,,"-87,127.65"
,IN,AR,30307471,1005,100,,Invoice,,,,,,01/02/2018,01/02/2018,0.00,,5.17,,"-87,132.82"
,IN,AR,30307633,1005,100,,Invoice,,,,,,01/02/2018,01/02/2018,0.00,,8.17,,"-87,140.99"
,IN,AR,30307636,1005,100,,Invoice,,,,,,01/02/2018,01/02/2018,0.00,,16.47,,"-87,157.46"
,IN,AR,30307666,1005,100,,Invoice,,,,,,01/02/2018,01/02/2018,0.00,,4.58,,"-87,162.04"
,IN,AR,30307688,1005,100,,Invoice,,,,,,01/02/2018,01/02/2018,0.00,,649.07,,"-87,811.11"
,IN,AR,30307698,1005,100,,Invoice,,,,,,01/02/2018,01/02/2018,0.00,,10.93,,"-87,822.04"
,IN,AR,30307724,1005,100,,Invoice,,,,,,01/02/2018,01/02/2018,0.00,,10.17,,"-87,832.21"
,IN,AR,30307725,1005,100,,Invoice,,,,,,01/02/2018,01/02/2018,0.00,,10.17,,"-87,842.38"
,IN,AR,30307746,1005,100,,Invoice,,,,,,01/02/2018,01/02/2018,0.00,,29.15,,"-87,871.53"
,IN,AR,30307751,1005,100,,Invoice,,,,,,01/02/2018,01/02/2018,0.00,,4.64,,"-87,876.17"
,IN,AR,30307761,1005,100,,Invoice,,,,,,01/02/2018,01/02/2018,0.00,,8.77,,"-87,884.94"
,IN,AR,30307766,1005,100,,Invoice,,,,,,01/02/2018,01/02/2018,0.00,,14.58,,"-87,899.52"
,IN,AR,30307771,1005,100,,Invoice,,,,,,01/02/2018,01/02/2018,0.00,,19.28,,"-87,918.80"
,IN,AR,30307838,1005,100,,Invoice,,,,,,01/02/2018,01/02/2018,0.00,,7.76,,"-87,926.56"
,IN,AR,30307843,1005,100,,Invoice,,,,,,01/02/2018,01/02/2018,0.00,,7.63,,"-87,934.19"
,IN,AR,30307857,1005,100,,Invoice,,,,,,01/02/2018,01/02/2018,0.00,,6.00,,"-87,940.19"
,IN,AR,30307886,1005,100,,Invoice,,,,,,01/02/2018,01/02/2018,0.00,,33.56,,"-87,973.75"
,IN,AR,30307888,1005,100,,Invoice,,,,,,01/02/2018,01/02/2018,0.00,,3.53,,"-87,977.28"
,IN,AR,30307909,1005,100,,Invoice,,,,,,01/02/2018,01/02/2018,0.00,,7.29,,"-87,984.57"
,IN,AR,30307953,1005,100,,Invoice,,,,,,01/02/2018,01/02/2018,0.00,,21.86,,"-88,006.43"
,IN,AR,30307954,1005,100,,Invoice,,,,,,01/02/2018,01/02/2018,0.00,,32.80,,"-88,039.23"
,IN,AR,30307996,1005,100,,Invoice,,,,,,01/02/2018,01/02/2018,0.00,,15.25,,"-88,054.48"
,IN,AR,30308007,1005,100,,Invoice,,,,,,01/02/2018,01/02/2018,0.00,,16.27,,"-88,070.75"
,IN,AR,30308008,1005,100,,Invoice,,,,,,01/02/2018,01/02/2018,0.00,,11.39,,"-88,082.14"
,IN,AR,30308009,1005,100,,Invoice,,,,,,01/02/2018,01/02/2018,0.00,,9.76,,"-88,091.90"
,IN,AR,30308010,1005,100,,Invoice,,,,,,01/02/2018,01/02/2018,0.00,,39.05,,"-88,130.95"
,IN,AR,30308011,1005,100,,Invoice,,,,,,01/02/2018,01/02/2018,0.00,,3.25,,"-88,134.20"
,IN,AR,30308025,1005,100,,Invoice,,,,,,01/02/2018,01/02/2018,0.00,,4.77,,"-88,138.97"
,IN,AR,30308026,1005,100,,Invoice,,,,,,01/02/2018,01/02/2018,0.00,,15.90,,"-88,154.87"
,IN,AR,30308058,1005,100,,Invoice,,,,,,01/02/2018,01/02/2018,0.00,,13.09,,"-88,167.96"
,IN,AR,30308082,1005,100,,Invoice,,,,,,01/02/2018,01/02/2018,0.00,,8.26,,"-88,176.22"
,IN,AR,30308095,1005,100,,Invoice,,,,,,01/02/2018,01/02/2018,0.00,,21.61,,"-88,197.83"
,IN,AR,30308106,1005,100,,Invoice,,,,,,01/02/2018,01/02/2018,0.00,,6.42,,"-88,204.25"
,IN,AR,30308107,1005,100,,Invoice,,,,,,01/02/2018,01/02/2018,0.00,,12.83,,"-88,217.08"
,IN,AR,30308108,1005,100,,Invoice,,,,,,01/02/2018,01/02/2018,0.00,,51.31,,"-88,268.39"
,IN,AR,30308216,1005,100,,Invoice,,,,,,01/02/2018,01/02/2018,0.00,,10.17,,"-88,278.56"
,IN,AR,30308217,1005,100,,Invoice,,,,,,01/02/2018,01/02/2018,0.00,,10.17,,"-88,288.73"
,IN,AR,30308229,1005,100,,Invoice,,,,,,01/02/2018,01/02/2018,0.00,,14.00,,"-88,302.73"
,IN,AR,30308241,1005,100,,Invoice,,,,,,01/02/2018,01/02/2018,0.00,,18.01,,"-88,320.74"
,IN,AR,30308254,1005,100,,Invoice,,,,,,01/02/2018,01/02/2018,0.00,,14.58,,"-88,335.32"
,IN,AR,30308255,1005,100,,Invoice,,,,,,01/02/2018,01/02/2018,0.00,,14.58,,"-88,349.90"
,IN,AR,30308270,1005,100,,Invoice,,,,,,01/02/2018,01/02/2018,0.00,,36.20,,"-88,386.10"
,IN,AR,30308283,1005,100,,Invoice,,,,,,01/02/2018,01/02/2018,0.00,,3.64,,"-88,389.74"
,IN,AR,30308303,1005,100,,Invoice,,,,,,01/02/2018,01/02/2018,0.00,,14.58,,"-88,404.32"
,IN,AR,30308312,1005,100,,Invoice,,,,,,01/02/2018,01/02/2018,0.00,,37.29,,"-88,441.61"
,IN,AR,30308322,1005,100,,Invoice,,,,,,01/02/2018,01/02/2018,0.00,,14.03,,"-88,455.64"
,IN,AR,30308341,1005,100,,Invoice,,,,,,01/02/2018,01/02/2018,0.00,,8.52,,"-88,464.16"
,IN,AR,30308378,1005,100,,Invoice,,,,,,01/02/2018,01/02/2018,0.00,,18.09,,"-88,482.25"
,IN,AR,30308420,1005,100,,Invoice,,,,,,01/02/2018,01/02/2018,0.00,,3.64,,"-88,485.89"
,IN,AR,30308438,1005,100,,Invoice,,,,,,01/02/2018,01/02/2018,0.00,,3.19,,"-88,489.08"
,IN,AR,30308439,1005,100,,Invoice,,,,,,01/02/2018,01/02/2018,0.00,,12.75,,"-88,501.83"
,IN,AR,30308440,1005,100,,Invoice,,,,,,01/02/2018,01/02/2018,0.00,,6.37,,"-88,508.20"
,IN,AR,30308441,1005,100,,Invoice,,,,,,01/02/2018,01/02/2018,0.00,,148.17,,"-88,656.37"
,IN,AR,30308496,1005,100,,Invoice,,,,,,01/02/2018,01/02/2018,0.00,,16.27,,"-88,672.64"
,IN,AR,30308541,1005,100,,Invoice,,,,,,01/02/2018,01/02/2018,0.00,,7.29,,"-88,679.93"
,IN,AR,30308559,1005,100,,Invoice,,,,,,01/02/2018,01/02/2018,0.00,,9.84,,"-88,689.77"
,IN,AR,30308584,1005,100,,Invoice,,,,,,01/02/2018,01/02/2018,0.00,,10.59,,"-88,700.36"
,IN,AR,30308646,1005,100,,Invoice,,,,,,01/02/2018,01/02/2018,0.00,,13.09,,"-88,713.45"
,IN,AR,30308674,1005,100,,Invoice,,,,,,01/02/2018,01/02/2018,0.00,,4.08,,"-88,717.53"
,IN,AR,30308678,1005,100,,Invoice,,,,,,01/02/2018,01/02/2018,0.00,,6.13,,"-88,723.66"
,CN,AR,31017257,1005,100,,Credit Note,,,,,,02/02/2018,02/02/2018,182.20,,0.00,,"-88,541.46"
,CN,AR,31017261,1005,100,,Credit Note,,,,,,02/02/2018,02/02/2018,1.27,,0.00,,"-88,540.19"
,CS,AR,32000925,1005,100,,Cash sale,,,,,,02/02/2018,02/02/2018,0.00,,43.97,,"-88,584.16"
,CS,AR,32000933,1005,100,,Cash sale,,,,,,02/02/2018,02/02/2018,0.00,,2.81,,"-88,586.97"
,CS,AR,32000938,1005,100,,Cash sale,,,,,,02/02/2018,02/02/2018,0.00,,22.37,,"-88,609.34"
,CS,AR,32000952,1005,100,,Cash sale,,,,,,02/02/2018,02/02/2018,0.00,,7.12,,"-88,616.46"
,CS,AR,32001002,1005,100,,Cash sale,,,,,,02/02/2018,02/02/2018,0.00,,45.13,,"-88,661.59"
,CS,AR,32001009,1005,100,,Cash sale,,,,,,02/02/2018,02/02/2018,0.00,,7.25,,"-88,668.84"
,CS,AR,32001023,1005,100,,Cash sale,,,,,,02/02/2018,02/02/2018,0.00,,26.10,,"-88,694.94"
,CS,AR,32001030,1005,100,,Cash sale,,,,,,02/02/2018,02/02/2018,0.00,,10.93,,"-88,705.87"
,CS,AR,32001034,1005,100,,Cash sale,,,,,,02/02/2018,02/02/2018,0.00,,14.53,,"-88,720.40"
,CS,AR,32001046,1005,100,,Cash sale,,,,,,02/02/2018,02/02/2018,0.00,,3.64,,"-88,724.04"
,CS,AR,32001075,1005,100,,Cash sale,,,,,,02/02/2018,02/02/2018,0.00,,7.29,,"-88,731.33"
,CS,AR,32001088,1005,100,,Cash sale,,,,,,02/02/2018,02/02/2018,0.00,,10.93,,"-88,742.26"
,CS,AR,32001097,1005,100,,Cash sale,,,,,,02/02/2018,02/02/2018,0.00,,8.78,,"-88,751.04"
,CS,AR,32001127,1005,100,,Cash sale,,,,,,02/02/2018,02/02/2018,0.00,,10.81,,"-88,761.85"
,CS,AR,32001134,1005,100,,Cash sale,,,,,,02/02/2018,02/02/2018,0.00,,36.44,,"-88,798.29"
,CS,AR,32001144,1005,100,,Cash sale,,,,,,02/02/2018,02/02/2018,0.00,,10.17,,"-88,808.46"
,CS,AR,32001172,1005,100,,Cash sale,,,,,,02/02/2018,02/02/2018,0.00,,16.48,,"-88,824.94"
,CS,AR,32001179,1005,100,,Cash sale,,,,,,02/02/2018,02/02/2018,0.00,,19.64,,"-88,844.58"
,CS,AR,32001183,1005,100,,Cash sale,,,,,,02/02/2018,02/02/2018,0.00,,13.74,,"-88,858.32"
,CS,AR,32001223,1005,100,,Cash sale,,,,,,02/02/2018,02/02/2018,0.00,,5.08,,"-88,863.40"
,CS,AR,32001237,1005,100,,Cash sale,,,,,,02/02/2018,02/02/2018,0.00,,20.47,,"-88,883.87"
,CS,AR,32001256,1005,100,,Cash sale,,,,,,02/02/2018,02/02/2018,0.00,,30.08,,"-88,913.95"
,CS,AR,32001285,1005,100,,Cash sale,,,,,,02/02/2018,02/02/2018,0.00,,27.97,,"-88,941.92"
,CS,AR,32001295,1005,100,,Cash sale,,,,,,02/02/2018,02/02/2018,0.00,,5.08,,"-88,947.00"
,CS,AR,32001323,1005,100,,Cash sale,,,,,,02/02/2018,02/02/2018,0.00,,14.58,,"-88,961.58"
,CS,AR,32001336,1005,100,,Cash sale,,,,,,02/02/2018,02/02/2018,0.00,,8.77,,"-88,970.35"
,CS,AR,32001352,1005,100,,Cash sale,,,,,,02/02/2018,02/02/2018,0.00,,18.22,,"-88,988.57"
,CS,AR,32001359,1005,100,,Cash sale,,,,,,02/02/2018,02/02/2018,0.00,,12.88,,"-89,001.45"
,CS,AR,32001424,1005,100,,Cash sale,,,,,,02/02/2018,02/02/2018,0.00,,21.86,,"-89,023.31"
,CS,AR,32001449,1005,100,,Cash sale,,,,,,02/02/2018,02/02/2018,0.00,,15.25,,"-89,038.56"
,CS,AR,32001496,1005,100,,Cash sale,,,,,,02/02/2018,02/02/2018,0.00,,30.00,,"-89,068.56"
,CS,AR,32001503,1005,100,,Cash sale,,,,,,02/02/2018,02/02/2018,0.00,,15.17,,"-89,083.73"
,CS,AR,32001514,1005,100,,Cash sale,,,,,,02/02/2018,02/02/2018,0.00,,6.56,,"-89,090.29"
,CS,AR,32001525,1005,100,,Cash sale,,,,,,02/02/2018,02/02/2018,0.00,,9.15,,"-89,099.44"
,CS,AR,32001537,1005,100,,Cash sale,,,,,,02/02/2018,02/02/2018,0.00,,3.03,,"-89,102.47"
,CS,AR,32001546,1005,100,,Cash sale,,,,,,02/02/2018,02/02/2018,0.00,,10.93,,"-89,113.40"
,CS,AR,32001555,1005,100,,Cash sale,,,,,,02/02/2018,02/02/2018,0.00,,5.47,,"-89,118.87"
,CS,AR,32001586,1005,100,,Cash sale,,,,,,02/02/2018,02/02/2018,0.00,,7.29,,"-89,126.16"
,CS,AR,32001590,1005,100,,Cash sale,,,,,,02/02/2018,02/02/2018,0.00,,14.58,,"-89,140.74"
,CS,AR,32001603,1005,100,,Cash sale,,,,,,02/02/2018,02/02/2018,0.00,,27.33,,"-89,168.07"
,CS,AR,32001604,1005,100,,Cash sale,,,,,,02/02/2018,02/02/2018,0.00,,3.03,,"-89,171.10"
,CS,AR,32001605,1005,100,,Cash sale,,,,,,02/02/2018,02/02/2018,0.00,,9.15,,"-89,180.25"
,CS,AR,32001611,1005,100,,Cash sale,,,,,,02/02/2018,02/02/2018,0.00,,8.31,,"-89,188.56"
,CS,AR,32001642,1005,100,,Cash sale,,,,,,02/02/2018,02/02/2018,0.00,,3.64,,"-89,192.20"
,CS,AR,32001645,1005,100,,Cash sale,,,,,,02/02/2018,02/02/2018,0.00,,10.93,,"-89,203.13"
,CS,AR,32001651,1005,100,,Cash sale,,,,,,02/02/2018,02/02/2018,0.00,,3.64,,"-89,206.77"
,CS,AR,32001656,1005,100,,Cash sale,,,,,,02/02/2018,02/02/2018,0.00,,8.75,,"-89,215.52"
,IN,AR,30306664,1005,100,,Invoice,,,,,,02/02/2018,02/02/2018,0.00,,3.64,,"-89,219.16"
,IN,AR,30306668,1005,100,,Invoice,,,,,,02/02/2018,02/02/2018,0.00,,29.66,,"-89,248.82"
,IN,AR,30306674,1005,100,,Invoice,,,,,,02/02/2018,02/02/2018,0.00,,62.29,,"-89,311.11"
,IN,AR,30306692,1005,100,,Invoice,,,,,,02/02/2018,02/02/2018,0.00,,14.58,,"-89,325.69"
,IN,AR,30306732,1005,100,,Invoice,,,,,,02/02/2018,02/02/2018,0.00,,7.29,,"-89,332.98"
,IN,AR,30306762,1005,100,,Invoice,,,,,,02/02/2018,02/02/2018,0.00,,28.98,,"-89,361.96"
,IN,AR,30306786,1005,100,,Invoice,,,,,,02/02/2018,02/02/2018,0.00,,18.31,,"-89,380.27"
,IN,AR,30306817,1005,100,,Invoice,,,,,,02/02/2018,02/02/2018,0.00,,50.46,,"-89,430.73"
,IN,AR,30306828,1005,100,,Invoice,,,,,,02/02/2018,02/02/2018,0.00,,61.69,,"-89,492.42"
,IN,AR,30306858,1005,100,,Invoice,,,,,,02/02/2018,02/02/2018,0.00,,14.58,,"-89,507.00"
,IN,AR,30306861,1005,100,,Invoice,,,,,,02/02/2018,02/02/2018,0.00,,24.00,,"-89,531.00"
,IN,AR,30306904,1005,100,,Invoice,,,,,,02/02/2018,02/02/2018,0.00,,38.00,,"-89,569.00"
,IN,AR,30306951,1005,100,,Invoice,,,,,,02/02/2018,02/02/2018,0.00,,3.89,,"-89,572.89"
,IN,AR,30306968,1005,100,,Invoice,,,,,,02/02/2018,02/02/2018,0.00,,7.12,,"-89,580.01"
,IN,AR,30306975,1005,100,,Invoice,,,,,,02/02/2018,02/02/2018,0.00,,16.00,,"-89,596.01"
,IN,AR,30306995,1005,100,,Invoice,,,,,,02/02/2018,02/02/2018,0.00,,40.08,,"-89,636.09"
,IN,AR,30307006,1005,100,,Invoice,,,,,,02/02/2018,02/02/2018,0.00,,54.66,,"-89,690.75"
,IN,AR,30307028,1005,100,,Invoice,,,,,,02/02/2018,02/02/2018,0.00,,7.76,,"-89,698.51"
,IN,AR,30307035,1005,100,,Invoice,,,,,,02/02/2018,02/02/2018,0.00,,7.20,,"-89,705.71"
,IN,AR,30307061,1005,100,,Invoice,,,,,,02/02/2018,02/02/2018,0.00,,8.39,,"-89,714.10"
,IN,AR,30307091,1005,100,,Invoice,,,,,,02/02/2018,02/02/2018,0.00,,7.97,,"-89,722.07"
,IN,AR,30307100,1005,100,,Invoice,,,,,,02/02/2018,02/02/2018,0.00,,10.93,,"-89,733.00"
,IN,AR,30307172,1005,100,,Invoice,,,,,,02/02/2018,02/02/2018,0.00,,61.02,,"-89,794.02"
,IN,AR,30307198,1005,100,,Invoice,,,,,,02/02/2018,02/02/2018,0.00,,15.51,,"-89,809.53"
,IN,AR,30307205,1005,100,,Invoice,,,,,,02/02/2018,02/02/2018,0.00,,4.78,,"-89,814.31"
,IN,AR,30307215,1005,100,,Invoice,,,,,,02/02/2018,02/02/2018,0.00,,179.73,,"-89,994.04"
,IN,AR,30307259,1005,100,,Invoice,,,,,,02/02/2018,02/02/2018,0.00,,408.14,,"-90,402.18"
,IN,AR,30307268,1005,100,,Invoice,,,,,,02/02/2018,02/02/2018,0.00,,38.97,,"-90,441.15"
,IN,AR,30307297,1005,100,,Invoice,,,,,,02/02/2018,02/02/2018,0.00,,2.58,,"-90,443.73"
,IN,AR,30307304,1005,100,,Invoice,,,,,,02/02/2018,02/02/2018,0.00,,4.78,,"-90,448.51"
,IN,AR,30307305,1005,100,,Invoice,,,,,,02/02/2018,02/02/2018,0.00,,9.56,,"-90,458.07"
,IN,AR,30307329,1005,100,,Invoice,,,,,,02/02/2018,02/02/2018,0.00,,21.86,,"-90,479.93"
,IN,AR,30307331,1005,100,,Invoice,,,,,,02/02/2018,02/02/2018,0.00,,7.29,,"-90,487.22"
,IN,AR,30307375,1005,100,,Invoice,,,,,,02/02/2018,02/02/2018,0.00,,6.36,,"-90,493.58"
,IN,AR,30307420,1005,100,,Invoice,,,,,,02/02/2018,02/02/2018,0.00,,7.63,,"-90,501.21"
,IN,AR,30307439,1005,100,,Invoice,,,,,,02/02/2018,02/02/2018,0.00,,5.08,,"-90,506.29"
,IN,AR,30307517,1005,100,,Invoice,,,,,,02/02/2018,02/02/2018,0.00,,15.25,,"-90,521.54"
,IN,AR,30307540,1005,100,,Invoice,,,,,,02/02/2018,02/02/2018,0.00,,22.88,,"-90,544.42"
,IN,AR,30307568,1005,100,,Invoice,,,,,,02/02/2018,02/02/2018,0.00,,17.80,,"-90,562.22"
,IN,AR,30307588,1005,100,,Invoice,,,,,,02/02/2018,02/02/2018,0.00,,12.03,,"-90,574.25"
,IN,AR,30307644,1005,100,,Invoice,,,,,,02/02/2018,02/02/2018,0.00,,28.05,,"-90,602.30"
,IN,AR,30307709,1005,100,,Invoice,,,,,,02/02/2018,02/02/2018,0.00,,10.93,,"-90,613.23"
,IN,AR,30307754,1005,100,,Invoice,,,,,,02/02/2018,02/02/2018,0.00,,76.65,,"-90,689.88"
,IN,AR,30307797,1005,100,,Invoice,,,,,,02/02/2018,02/02/2018,0.00,,44.54,,"-90,734.42"
,IN,AR,30307830,1005,100,,Invoice,,,,,,02/02/2018,02/02/2018,0.00,,364.41,,"-91,098.83"
,IN,AR,30307861,1005,100,,Invoice,,,,,,02/02/2018,02/02/2018,0.00,,18.22,,"-91,117.05"
,IN,AR,30307862,1005,100,,Invoice,,,,,,02/02/2018,02/02/2018,0.00,,42.88,,"-91,159.93"
,IN,AR,30307881,1005,100,,Invoice,,,,,,02/02/2018,02/02/2018,0.00,,13.14,,"-91,173.07"
,IN,AR,30307913,1005,100,,Invoice,,,,,,02/02/2018,02/02/2018,0.00,,2.42,,"-91,175.49"
,IN,AR,30307917,1005,100,,Invoice,,,,,,02/02/2018,02/02/2018,0.00,,6.81,,"-91,182.30"
,IN,AR,30307944,1005,100,,Invoice,,,,,,02/02/2018,02/02/2018,0.00,,10.93,,"-91,193.23"
,IN,AR,30307987,1005,100,,Invoice,,,,,,02/02/2018,02/02/2018,0.00,,419.07,,"-91,612.30"
,IN,AR,30308027,1005,100,,Invoice,,,,,,02/02/2018,02/02/2018,0.00,,33.39,,"-91,645.69"
,IN,AR,30308046,1005,100,,Invoice,,,,,,02/02/2018,02/02/2018,0.00,,28.39,,"-91,674.08"
,IN,AR,30308067,1005,100,,Invoice,,,,,,02/02/2018,02/02/2018,0.00,,48.10,,"-91,722.18"
,IN,AR,30308091,1005,100,,Invoice,,,,,,02/02/2018,02/02/2018,0.00,,9.03,,"-91,731.21"
,IN,AR,30308109,1005,100,,Invoice,,,,,,02/02/2018,02/02/2018,0.00,,52.92,,"-91,784.13"
,IN,AR,30308157,1005,100,,Invoice,,,,,,02/02/2018,02/02/2018,0.00,,28.03,,"-91,812.16"
,IN,AR,30308193,1005,100,,Invoice,,,,,,02/02/2018,02/02/2018,0.00,,10.93,,"-91,823.09"
,IN,AR,30308204,1005,100,,Invoice,,,,,,02/02/2018,02/02/2018,0.00,,11.95,,"-91,835.04"
,IN,AR,30308218,1005,100,,Invoice,,,,,,02/02/2018,02/02/2018,0.00,,25.42,,"-91,860.46"
,IN,AR,30308244,1005,100,,Invoice,,,,,,02/02/2018,02/02/2018,0.00,,6.00,,"-91,866.46"
,IN,AR,30308246,1005,100,,Invoice,,,,,,02/02/2018,02/02/2018,0.00,,16.01,,"-91,882.47"
,IN,AR,30308286,1005,100,,Invoice,,,,,,02/02/2018,02/02/2018,0.00,,19.16,,"-91,901.63"
,IN,AR,30308290,1005,100,,Invoice,,,,,,02/02/2018,02/02/2018,0.00,,4.20,,"-91,905.83"
,IN,AR,30308332,1005,100,,Invoice,,,,,,02/02/2018,02/02/2018,0.00,,9.19,,"-91,915.02"
,IN,AR,30308347,1005,100,,Invoice,,,,,,02/02/2018,02/02/2018,0.00,,29.15,,"-91,944.17"
,IN,AR,30308411,1005,100,,Invoice,,,,,,02/02/2018,02/02/2018,0.00,,54.66,,"-91,998.83"
,IN,AR,30308422,1005,100,,Invoice,,,,,,02/02/2018,02/02/2018,0.00,,5.68,,"-92,004.51"
,IN,AR,30308436,1005,100,,Invoice,,,,,,02/02/2018,02/02/2018,0.00,,18.22,,"-92,022.73"
,IN,AR,30308503,1005,100,,Invoice,,,,,,02/02/2018,02/02/2018,0.00,,8.00,,"-92,030.73"
,IN,AR,30308561,1005,100,,Invoice,,,,,,02/02/2018,02/02/2018,0.00,,29.15,,"-92,059.88"
,IN,AR,30308577,1005,100,,Invoice,,,,,,02/02/2018,02/02/2018,0.00,,13.69,,"-92,073.57"
,IN,AR,30308587,1005,100,,Invoice,,,,,,02/02/2018,02/02/2018,0.00,,29.15,,"-92,102.72"
,IN,AR,30308591,1005,100,,Invoice,,,,,,02/02/2018,02/02/2018,0.00,,42.37,,"-92,145.09"
,IN,AR,30308641,1005,100,,Invoice,,,,,,02/02/2018,02/02/2018,0.00,,145.76,,"-92,290.85"
,IN,AR,30308643,1005,100,,Invoice,,,,,,02/02/2018,02/02/2018,0.00,,7.29,,"-92,298.14"
,IN,AR,30308666,1005,100,,Invoice,,,,,,02/02/2018,02/02/2018,0.00,,8.17,,"-92,306.31"
,IN,AR,30308689,1005,100,,Invoice,,,,,,02/02/2018,02/02/2018,0.00,,18.22,,"-92,324.53"
,IN,AR,30308695,1005,100,,Invoice,,,,,,02/02/2018,02/02/2018,0.00,,7.29,,"-92,331.82"
,CN,AR,31017219,1005,100,,Credit Note,,,,,,03/02/2018,03/02/2018,39.64,,0.00,,"-92,292.18"
,CN,AR,31017269,1005,100,,Credit Note,,,,,,03/02/2018,03/02/2018,8.51,,0.00,,"-92,283.67"
,CN,AR,31017372,1005,100,,Credit Note,,,,,,03/02/2018,03/02/2018,7.29,,0.00,,"-92,276.38"
,CS,AR,32000937,1005,100,,Cash sale,,,,,,03/02/2018,03/02/2018,0.00,,21.86,,"-92,298.24"
,CS,AR,32001092,1005,100,,Cash sale,,,,,,03/02/2018,03/02/2018,0.00,,14.58,,"-92,312.82"
,CS,AR,32001159,1005,100,,Cash sale,,,,,,03/02/2018,03/02/2018,0.00,,11.36,,"-92,324.18"
,CS,AR,32001242,1005,100,,Cash sale,,,,,,03/02/2018,03/02/2018,0.00,,4.49,,"-92,328.67"
,CS,AR,32001274,1005,100,,Cash sale,,,,,,03/02/2018,03/02/2018,0.00,,7.75,,"-92,336.42"
,CS,AR,32001379,1005,100,,Cash sale,,,,,,03/02/2018,03/02/2018,0.00,,18.22,,"-92,354.64"
,CS,AR,32001443,1005,100,,Cash sale,,,,,,03/02/2018,03/02/2018,0.00,,14.58,,"-92,369.22"
,IN,AR,30306945,1005,100,,Invoice,,,,,,03/02/2018,03/02/2018,0.00,,18.22,,"-92,387.44"
,IN,AR,30308537,1005,100,,Invoice,,,,,,03/02/2018,03/02/2018,0.00,,29.15,,"-92,416.59"
,IN,AR,30308595,1005,100,,Invoice,,,,,,03/02/2018,03/02/2018,0.00,,7.29,,"-92,423.88"
,IN,AR,30308603,1005,100,,Invoice,,,,,,03/02/2018,03/02/2018,0.00,,15.17,,"-92,439.05"
,IN,AR,30308696,1005,100,,Invoice,,,,,,03/02/2018,03/02/2018,0.00,,21.86,,"-92,460.91"
,CN,AR,31017226,1005,100,,Credit Note,,,,,,05/02/2018,05/02/2018,7.29,,0.00,,"-92,453.62"
,CN,AR,31017312,1005,100,,Credit Note,,,,,,05/02/2018,05/02/2018,29.15,,0.00,,"-92,424.47"
,CN,AR,31017396,1005,100,,Credit Note,,,,,,05/02/2018,05/02/2018,9.19,,0.00,,"-92,415.28"
,CN,AR,31017398,1005,100,,Credit Note,,,,,,05/02/2018,05/02/2018,29.15,,0.00,,"-92,386.13"
,CS,AR,32000953,1005,100,,Cash sale,,,,,,05/02/2018,05/02/2018,0.00,,4.75,,"-92,390.88"
,CS,AR,32000978,1005,100,,Cash sale,,,,,,05/02/2018,05/02/2018,0.00,,7.29,,"-92,398.17"
,CS,AR,32001006,1005,100,,Cash sale,,,,,,05/02/2018,05/02/2018,0.00,,3.64,,"-92,401.81"
,CS,AR,32001029,1005,100,,Cash sale,,,,,,05/02/2018,05/02/2018,0.00,,7.29,,"-92,409.10"
,CS,AR,32001035,1005,100,,Cash sale,,,,,,05/02/2018,05/02/2018,0.00,,14.53,,"-92,423.63"
,CS,AR,32001058,1005,100,,Cash sale,,,,,,05/02/2018,05/02/2018,0.00,,8.77,,"-92,432.40"
,CS,AR,32001074,1005,100,,Cash sale,,,,,,05/02/2018,05/02/2018,0.00,,3.64,,"-92,436.04"
,CS,AR,32001084,1005,100,,Cash sale,,,,,,05/02/2018,05/02/2018,0.00,,14.58,,"-92,450.62"
,CS,AR,32001095,1005,100,,Cash sale,,,,,,05/02/2018,05/02/2018,0.00,,3.64,,"-92,454.26"
,CS,AR,32001104,1005,100,,Cash sale,,,,,,05/02/2018,05/02/2018,0.00,,3.64,,"-92,457.90"
,CS,AR,32001107,1005,100,,Cash sale,,,,,,05/02/2018,05/02/2018,0.00,,7.29,,"-92,465.19"
,CS,AR,32001109,1005,100,,Cash sale,,,,,,05/02/2018,05/02/2018,0.00,,10.34,,"-92,475.53"
,CS,AR,32001145,1005,100,,Cash sale,,,,,,05/02/2018,05/02/2018,0.00,,5.08,,"-92,480.61"
,CS,AR,32001168,1005,100,,Cash sale,,,,,,05/02/2018,05/02/2018,0.00,,28.43,,"-92,509.04"
,CS,AR,32001184,1005,100,,Cash sale,,,,,,05/02/2018,05/02/2018,0.00,,10.99,,"-92,520.03"
,CS,AR,32001192,1005,100,,Cash sale,,,,,,05/02/2018,05/02/2018,0.00,,3.64,,"-92,523.67"
,CS,AR,32001224,1005,100,,Cash sale,,,,,,05/02/2018,05/02/2018,0.00,,2.54,,"-92,526.21"
,CS,AR,32001238,1005,100,,Cash sale,,,,,,05/02/2018,05/02/2018,0.00,,17.54,,"-92,543.75"
,CS,AR,32001244,1005,100,,Cash sale,,,,,,05/02/2018,05/02/2018,0.00,,8.16,,"-92,551.91"
,CS,AR,32001248,1005,100,,Cash sale,,,,,,05/02/2018,05/02/2018,0.00,,7.29,,"-92,559.20"
,CS,AR,32001257,1005,100,,Cash sale,,,,,,05/02/2018,05/02/2018,0.00,,27.08,,"-92,586.28"
,CS,AR,32001309,1005,100,,Cash sale,,,,,,05/02/2018,05/02/2018,0.00,,13.14,,"-92,599.42"
,CS,AR,32001313,1005,100,,Cash sale,,,,,,05/02/2018,05/02/2018,0.00,,5.08,,"-92,604.50"
,CS,AR,32001321,1005,100,,Cash sale,,,,,,05/02/2018,05/02/2018,0.00,,3.64,,"-92,608.14"
,CS,AR,32001346,1005,100,,Cash sale,,,,,,05/02/2018,05/02/2018,0.00,,10.93,,"-92,619.07"
,CS,AR,32001371,1005,100,,Cash sale,,,,,,05/02/2018,05/02/2018,0.00,,7.29,,"-92,626.36"
,CS,AR,32001383,1005,100,,Cash sale,,,,,,05/02/2018,05/02/2018,0.00,,3.64,,"-92,630.00"
,CS,AR,32001408,1005,100,,Cash sale,,,,,,05/02/2018,05/02/2018,0.00,,6.53,,"-92,636.53"
,CS,AR,32001426,1005,100,,Cash sale,,,,,,05/02/2018,05/02/2018,0.00,,7.29,,"-92,643.82"
,CS,AR,32001436,1005,100,,Cash sale,,,,,,05/02/2018,05/02/2018,0.00,,7.29,,"-92,651.11"
,CS,AR,32001457,1005,100,,Cash sale,,,,,,05/02/2018,05/02/2018,0.00,,21.86,,"-92,672.97"
,CS,AR,32001467,1005,100,,Cash sale,,,,,,05/02/2018,05/02/2018,0.00,,14.58,,"-92,687.55"
,CS,AR,32001468,1005,100,,Cash sale,,,,,,05/02/2018,05/02/2018,0.00,,7.29,,"-92,694.84"
,CS,AR,32001526,1005,100,,Cash sale,,,,,,05/02/2018,05/02/2018,0.00,,11.44,,"-92,706.28"
,CS,AR,32001558,1005,100,,Cash sale,,,,,,05/02/2018,05/02/2018,0.00,,6.07,,"-92,712.35"
,CS,AR,32001577,1005,100,,Cash sale,,,,,,05/02/2018,05/02/2018,0.00,,7.29,,"-92,719.64"
,CS,AR,32001591,1005,100,,Cash sale,,,,,,05/02/2018,05/02/2018,0.00,,7.29,,"-92,726.93"
,CS,AR,32001637,1005,100,,Cash sale,,,,,,05/02/2018,05/02/2018,0.00,,10.93,,"-92,737.86"
,CS,AR,32001686,1005,100,,Cash sale,,,,,,05/02/2018,05/02/2018,0.00,,3.64,,"-92,741.50"
,IN,AR,30306675,1005,100,,Invoice,,,,,,05/02/2018,05/02/2018,0.00,,53.39,,"-92,794.89"
,IN,AR,30306700,1005,100,,Invoice,,,,,,05/02/2018,05/02/2018,0.00,,18.22,,"-92,813.11"
,IN,AR,30306789,1005,100,,Invoice,,,,,,05/02/2018,05/02/2018,0.00,,57.07,,"-92,870.18"
,IN,AR,30306811,1005,100,,Invoice,,,,,,05/02/2018,05/02/2018,0.00,,9.19,,"-92,879.37"
,IN,AR,30306829,1005,100,,Invoice,,,,,,05/02/2018,05/02/2018,0.00,,47.46,,"-92,926.83"
,IN,AR,30306847,1005,100,,Invoice,,,,,,05/02/2018,05/02/2018,0.00,,5.51,,"-92,932.34"
,IN,AR,30306848,1005,100,,Invoice,,,,,,05/02/2018,05/02/2018,0.00,,22.03,,"-92,954.37"
,IN,AR,30306862,1005,100,,Invoice,,,,,,05/02/2018,05/02/2018,0.00,,18.00,,"-92,972.37"
,IN,AR,30306905,1005,100,,Invoice,,,,,,05/02/2018,05/02/2018,0.00,,52.00,,"-93,024.37"
,IN,AR,30306928,1005,100,,Invoice,,,,,,05/02/2018,05/02/2018,0.00,,5.51,,"-93,029.88"
,IN,AR,30306933,1005,100,,Invoice,,,,,,05/02/2018,05/02/2018,0.00,,10.17,,"-93,040.05"
,IN,AR,30306937,1005,100,,Invoice,,,,,,05/02/2018,05/02/2018,0.00,,11.02,,"-93,051.07"
,IN,AR,30306952,1005,100,,Invoice,,,,,,05/02/2018,05/02/2018,0.00,,5.84,,"-93,056.91"
,IN,AR,30306964,1005,100,,Invoice,,,,,,05/02/2018,05/02/2018,0.00,,364.41,,"-93,421.32"
,IN,AR,30306976,1005,100,,Invoice,,,,,,05/02/2018,05/02/2018,0.00,,10.00,,"-93,431.32"
,IN,AR,30307065,1005,100,,Invoice,,,,,,05/02/2018,05/02/2018,0.00,,12.88,,"-93,444.20"
,IN,AR,30307077,1005,100,,Invoice,,,,,,05/02/2018,05/02/2018,0.00,,22.71,,"-93,466.91"
,IN,AR,30307088,1005,100,,Invoice,,,,,,05/02/2018,05/02/2018,0.00,,54.66,,"-93,521.57"
,IN,AR,30307114,1005,100,,Invoice,,,,,,05/02/2018,05/02/2018,0.00,,5.17,,"-93,526.74"
,IN,AR,30307126,1005,100,,Invoice,,,,,,05/02/2018,05/02/2018,0.00,,10.93,,"-93,537.67"
,IN,AR,30307133,1005,100,,Invoice,,,,,,05/02/2018,05/02/2018,0.00,,7.19,,"-93,544.86"
,IN,AR,30307139,1005,100,,Invoice,,,,,,05/02/2018,05/02/2018,0.00,,11.48,,"-93,556.34"
,IN,AR,30307174,1005,100,,Invoice,,,,,,05/02/2018,05/02/2018,0.00,,61.02,,"-93,617.36"
,IN,AR,30307199,1005,100,,Invoice,,,,,,05/02/2018,05/02/2018,0.00,,15.51,,"-93,632.87"
,IN,AR,30307220,1005,100,,Invoice,,,,,,05/02/2018,05/02/2018,0.00,,11.86,,"-93,644.73"
,IN,AR,30307236,1005,100,,Invoice,,,,,,05/02/2018,05/02/2018,0.00,,46.98,,"-93,691.71"
,IN,AR,30307239,1005,100,,Invoice,,,,,,05/02/2018,05/02/2018,0.00,,7.29,,"-93,699.00"
,IN,AR,30307269,1005,100,,Invoice,,,,,,05/02/2018,05/02/2018,0.00,,75.88,,"-93,774.88"
,IN,AR,30307282,1005,100,,Invoice,,,,,,05/02/2018,05/02/2018,0.00,,30.51,,"-93,805.39"
,IN,AR,30307306,1005,100,,Invoice,,,,,,05/02/2018,05/02/2018,0.00,,23.90,,"-93,829.29"
,IN,AR,30307333,1005,100,,Invoice,,,,,,05/02/2018,05/02/2018,0.00,,21.06,,"-93,850.35"
,IN,AR,30307346,1005,100,,Invoice,,,,,,05/02/2018,05/02/2018,0.00,,3.64,,"-93,853.99"
,IN,AR,30307358,1005,100,,Invoice,,,,,,05/02/2018,05/02/2018,0.00,,7.29,,"-93,861.28"
,IN,AR,30307421,1005,100,,Invoice,,,,,,05/02/2018,05/02/2018,0.00,,10.17,,"-93,871.45"
,IN,AR,30307465,1005,100,,Invoice,,,,,,05/02/2018,05/02/2018,0.00,,92.97,,"-93,964.42"
,IN,AR,30307541,1005,100,,Invoice,,,,,,05/02/2018,05/02/2018,0.00,,20.34,,"-93,984.76"
,IN,AR,30307554,1005,100,,Invoice,,,,,,05/02/2018,05/02/2018,0.00,,16.27,,"-94,001.03"
,IN,AR,30307582,1005,100,,Invoice,,,,,,05/02/2018,05/02/2018,0.00,,10.93,,"-94,011.96"
,IN,AR,30307585,1005,100,,Invoice,,,,,,05/02/2018,05/02/2018,0.00,,3.64,,"-94,015.60"
,IN,AR,30307590,1005,100,,Invoice,,,,,,05/02/2018,05/02/2018,0.00,,14.58,,"-94,030.18"
,IN,AR,30307612,1005,100,,Invoice,,,,,,05/02/2018,05/02/2018,0.00,,4.78,,"-94,034.96"
,IN,AR,30307615,1005,100,,Invoice,,,,,,05/02/2018,05/02/2018,0.00,,13.77,,"-94,048.73"
,IN,AR,30307623,1005,100,,Invoice,,,,,,05/02/2018,05/02/2018,0.00,,16.53,,"-94,065.26"
,IN,AR,30307635,1005,100,,Invoice,,,,,,05/02/2018,05/02/2018,0.00,,7.29,,"-94,072.55"
,IN,AR,30307645,1005,100,,Invoice,,,,,,05/02/2018,05/02/2018,0.00,,16.83,,"-94,089.38"
,IN,AR,30307658,1005,100,,Invoice,,,,,,05/02/2018,05/02/2018,0.00,,182.20,,"-94,271.58"
,IN,AR,30307687,1005,100,,Invoice,,,,,,05/02/2018,05/02/2018,0.00,,18.22,,"-94,289.80"
,IN,AR,30307733,1005,100,,Invoice,,,,,,05/02/2018,05/02/2018,0.00,,24.00,,"-94,313.80"
,IN,AR,30307782,1005,100,,Invoice,,,,,,05/02/2018,05/02/2018,0.00,,12.92,,"-94,326.72"
,IN,AR,30307804,1005,100,,Invoice,,,,,,05/02/2018,05/02/2018,0.00,,29.15,,"-94,355.87"
,IN,AR,30307806,1005,100,,Invoice,,,,,,05/02/2018,05/02/2018,0.00,,21.86,,"-94,377.73"
,IN,AR,30307825,1005,100,,Invoice,,,,,,05/02/2018,05/02/2018,0.00,,6.42,,"-94,384.15"
,IN,AR,30307863,1005,100,,Invoice,,,,,,05/02/2018,05/02/2018,0.00,,64.32,,"-94,448.47"
,IN,AR,30307905,1005,100,,Invoice,,,,,,05/02/2018,05/02/2018,0.00,,7.29,,"-94,455.76"
,IN,AR,30307907,1005,100,,Invoice,,,,,,05/02/2018,05/02/2018,0.00,,10.93,,"-94,466.69"
,IN,AR,30307945,1005,100,,Invoice,,,,,,05/02/2018,05/02/2018,0.00,,10.17,,"-94,476.86"
,IN,AR,30307947,1005,100,,Invoice,,,,,,05/02/2018,05/02/2018,0.00,,8.78,,"-94,485.64"
,IN,AR,30307968,1005,100,,Invoice,,,,,,05/02/2018,05/02/2018,0.00,,4.29,,"-94,489.93"
,IN,AR,30308043,1005,100,,Invoice,,,,,,05/02/2018,05/02/2018,0.00,,14.03,,"-94,503.96"
,IN,AR,30308044,1005,100,,Invoice,,,,,,05/02/2018,05/02/2018,0.00,,182.20,,"-94,686.16"
,IN,AR,30308068,1005,100,,Invoice,,,,,,05/02/2018,05/02/2018,0.00,,22.05,,"-94,708.21"
,IN,AR,30308078,1005,100,,Invoice,,,,,,05/02/2018,05/02/2018,0.00,,10.93,,"-94,719.14"
,IN,AR,30308110,1005,100,,Invoice,,,,,,05/02/2018,05/02/2018,0.00,,9.62,,"-94,728.76"
,IN,AR,30308159,1005,100,,Invoice,,,,,,05/02/2018,05/02/2018,0.00,,44.66,,"-94,773.42"
,IN,AR,30308210,1005,100,,Invoice,,,,,,05/02/2018,05/02/2018,0.00,,29.15,,"-94,802.57"
,IN,AR,30308233,1005,100,,Invoice,,,,,,05/02/2018,05/02/2018,0.00,,16.01,,"-94,818.58"
,IN,AR,30308266,1005,100,,Invoice,,,,,,05/02/2018,05/02/2018,0.00,,65.30,,"-94,883.88"
,IN,AR,30308271,1005,100,,Invoice,,,,,,05/02/2018,05/02/2018,0.00,,48.27,,"-94,932.15"
,IN,AR,30308308,1005,100,,Invoice,,,,,,05/02/2018,05/02/2018,0.00,,33.82,,"-94,965.97"
,IN,AR,30308313,1005,100,,Invoice,,,,,,05/02/2018,05/02/2018,0.00,,193.43,,"-95,159.40"
,IN,AR,30308323,1005,100,,Invoice,,,,,,05/02/2018,05/02/2018,0.00,,16.83,,"-95,176.23"
,IN,AR,30308348,1005,100,,Invoice,,,,,,05/02/2018,05/02/2018,0.00,,3.64,,"-95,179.87"
,IN,AR,30308349,1005,100,,Invoice,,,,,,05/02/2018,05/02/2018,0.00,,3.64,,"-95,183.51"
,IN,AR,30308405,1005,100,,Invoice,,,,,,05/02/2018,05/02/2018,0.00,,7.29,,"-95,190.80"
,IN,AR,30308409,1005,100,,Invoice,,,,,,05/02/2018,05/02/2018,0.00,,182.20,,"-95,373.00"
,IN,AR,30308442,1005,100,,Invoice,,,,,,05/02/2018,05/02/2018,0.00,,30.27,,"-95,403.27"
,IN,AR,30308504,1005,100,,Invoice,,,,,,05/02/2018,05/02/2018,0.00,,6.00,,"-95,409.27"
,IN,AR,30308511,1005,100,,Invoice,,,,,,05/02/2018,05/02/2018,0.00,,3.64,,"-95,412.91"
,IN,AR,30308649,1005,100,,Invoice,,,,,,05/02/2018,05/02/2018,0.00,,9.41,,"-95,422.32"
,IN,AR,30308667,1005,100,,Invoice,,,,,,05/02/2018,05/02/2018,0.00,,6.13,,"-95,428.45"
,IN,AR,30308725,1005,100,,Invoice,,,,,,05/02/2018,05/02/2018,0.00,,182.20,,"-95,610.65"
,CN,AR,31017238,1005,100,,Credit Note,,,,,,06/02/2018,06/02/2018,3.64,,0.00,,"-95,607.01"
,CN,AR,31017245,1005,100,,Credit Note,,,,,,06/02/2018,06/02/2018,10.93,,0.00,,"-95,596.08"
,CN,AR,31017246,1005,100,,Credit Note,,,,,,06/02/2018,06/02/2018,7.29,,0.00,,"-95,588.79"
,CN,AR,31017274,1005,100,,Credit Note,,,,,,06/02/2018,06/02/2018,40.08,,0.00,,"-95,548.71"
,CN,AR,31017339,1005,100,,Credit Note,,,,,,06/02/2018,06/02/2018,54.66,,0.00,,"-95,494.05"
,CN,AR,31017348,1005,100,,Credit Note,,,,,,06/02/2018,06/02/2018,5.17,,0.00,,"-95,488.88"
,CS,AR,32000962,1005,100,,Cash sale,,,,,,06/02/2018,06/02/2018,0.00,,3.64,,"-95,492.52"
,CS,AR,32000971,1005,100,,Cash sale,,,,,,06/02/2018,06/02/2018,0.00,,7.29,,"-95,499.81"
,CS,AR,32000979,1005,100,,Cash sale,,,,,,06/02/2018,06/02/2018,0.00,,7.29,,"-95,507.10"
,CS,AR,32001012,1005,100,,Cash sale,,,,,,06/02/2018,06/02/2018,0.00,,6.02,,"-95,513.12"
,CS,AR,32001042,1005,100,,Cash sale,,,,,,06/02/2018,06/02/2018,0.00,,7.29,,"-95,520.41"
,CS,AR,32001067,1005,100,,Cash sale,,,,,,06/02/2018,06/02/2018,0.00,,18.22,,"-95,538.63"
,CS,AR,32001115,1005,100,,Cash sale,,,,,,06/02/2018,06/02/2018,0.00,,10.17,,"-95,548.80"
,CS,AR,32001154,1005,100,,Cash sale,,,,,,06/02/2018,06/02/2018,0.00,,5.17,,"-95,553.97"
,CS,AR,32001182,1005,100,,Cash sale,,,,,,06/02/2018,06/02/2018,0.00,,7.75,,"-95,561.72"
,CS,AR,32001213,1005,100,,Cash sale,,,,,,06/02/2018,06/02/2018,0.00,,8.58,,"-95,570.30"
,CS,AR,32001231,1005,100,,Cash sale,,,,,,06/02/2018,06/02/2018,0.00,,21.06,,"-95,591.36"
,CS,AR,32001234,1005,100,,Cash sale,,,,,,06/02/2018,06/02/2018,0.00,,15.13,,"-95,606.49"
,CS,AR,32001236,1005,100,,Cash sale,,,,,,06/02/2018,06/02/2018,0.00,,6.74,,"-95,613.23"
,CS,AR,32001252,1005,100,,Cash sale,,,,,,06/02/2018,06/02/2018,0.00,,4.32,,"-95,617.55"
,CS,AR,32001265,1005,100,,Cash sale,,,,,,06/02/2018,06/02/2018,0.00,,14.58,,"-95,632.13"
,CS,AR,32001269,1005,100,,Cash sale,,,,,,06/02/2018,06/02/2018,0.00,,5.85,,"-95,637.98"
,CS,AR,32001315,1005,100,,Cash sale,,,,,,06/02/2018,06/02/2018,0.00,,7.29,,"-95,645.27"
,CS,AR,32001345,1005,100,,Cash sale,,,,,,06/02/2018,06/02/2018,0.00,,14.58,,"-95,659.85"
,CS,AR,32001355,1005,100,,Cash sale,,,,,,06/02/2018,06/02/2018,0.00,,3.01,,"-95,662.86"
,CS,AR,32001388,1005,100,,Cash sale,,,,,,06/02/2018,06/02/2018,0.00,,3.64,,"-95,666.50"
,CS,AR,32001410,1005,100,,Cash sale,,,,,,06/02/2018,06/02/2018,0.00,,10.72,,"-95,677.22"
,CS,AR,32001420,1005,100,,Cash sale,,,,,,06/02/2018,06/02/2018,0.00,,3.76,,"-95,680.98"
,CS,AR,32001446,1005,100,,Cash sale,,,,,,06/02/2018,06/02/2018,0.00,,29.15,,"-95,710.13"
,CS,AR,32001488,1005,100,,Cash sale,,,,,,06/02/2018,06/02/2018,0.00,,18.22,,"-95,728.35"
,CS,AR,32001490,1005,100,,Cash sale,,,,,,06/02/2018,06/02/2018,0.00,,5.08,,"-95,733.43"
,CS,AR,32001492,1005,100,,Cash sale,,,,,,06/02/2018,06/02/2018,0.00,,24.00,,"-95,757.43"
,CS,AR,32001506,1005,100,,Cash sale,,,,,,06/02/2018,06/02/2018,0.00,,7.29,,"-95,764.72"
,CS,AR,32001519,1005,100,,Cash sale,,,,,,06/02/2018,06/02/2018,0.00,,5.47,,"-95,770.19"
,CS,AR,32001543,1005,100,,Cash sale,,,,,,06/02/2018,06/02/2018,0.00,,5.93,,"-95,776.12"
,CS,AR,32001562,1005,100,,Cash sale,,,,,,06/02/2018,06/02/2018,0.00,,2.75,,"-95,778.87"
,CS,AR,32001568,1005,100,,Cash sale,,,,,,06/02/2018,06/02/2018,0.00,,14.58,,"-95,793.45"
,CS,AR,32001582,1005,100,,Cash sale,,,,,,06/02/2018,06/02/2018,0.00,,7.29,,"-95,800.74"
,CS,AR,32001583,1005,100,,Cash sale,,,,,,06/02/2018,06/02/2018,0.00,,3.64,,"-95,804.38"
,CS,AR,32001625,1005,100,,Cash sale,,,,,,06/02/2018,06/02/2018,0.00,,7.29,,"-95,811.67"
,CS,AR,32001646,1005,100,,Cash sale,,,,,,06/02/2018,06/02/2018,0.00,,7.29,,"-95,818.96"
,CS,AR,32001657,1005,100,,Cash sale,,,,,,06/02/2018,06/02/2018,0.00,,7.29,,"-95,826.25"
,CS,AR,32001661,1005,100,,Cash sale,,,,,,06/02/2018,06/02/2018,0.00,,14.58,,"-95,840.83"
,CS,AR,32001675,1005,100,,Cash sale,,,,,,06/02/2018,06/02/2018,0.00,,7.29,,"-95,848.12"
,IN,AR,30306666,1005,100,,Invoice,,,,,,06/02/2018,06/02/2018,0.00,,6.02,,"-95,854.14"
,IN,AR,30306708,1005,100,,Invoice,,,,,,06/02/2018,06/02/2018,0.00,,364.41,,"-96,218.55"
,IN,AR,30306724,1005,100,,Invoice,,,,,,06/02/2018,06/02/2018,0.00,,3.64,,"-96,222.19"
,IN,AR,30306751,1005,100,,Invoice,,,,,,06/02/2018,06/02/2018,0.00,,10.51,,"-96,232.70"
,IN,AR,30306773,1005,100,,Invoice,,,,,,06/02/2018,06/02/2018,0.00,,21.86,,"-96,254.56"
,IN,AR,30306779,1005,100,,Invoice,,,,,,06/02/2018,06/02/2018,0.00,,7.00,,"-96,261.56"
,IN,AR,30306783,1005,100,,Invoice,,,,,,06/02/2018,06/02/2018,0.00,,364.41,,"-96,625.97"
,IN,AR,30306799,1005,100,,Invoice,,,,,,06/02/2018,06/02/2018,0.00,,3.64,,"-96,629.61"
,IN,AR,30306830,1005,100,,Invoice,,,,,,06/02/2018,06/02/2018,0.00,,52.20,,"-96,681.81"
,IN,AR,30306856,1005,100,,Invoice,,,,,,06/02/2018,06/02/2018,0.00,,182.20,,"-96,864.01"
,IN,AR,30306877,1005,100,,Invoice,,,,,,06/02/2018,06/02/2018,0.00,,18.22,,"-96,882.23"
,IN,AR,30306884,1005,100,,Invoice,,,,,,06/02/2018,06/02/2018,0.00,,14.58,,"-96,896.81"
,IN,AR,30306885,1005,100,,Invoice,,,,,,06/02/2018,06/02/2018,0.00,,61.51,,"-96,958.32"
,IN,AR,30306947,1005,100,,Invoice,,,,,,06/02/2018,06/02/2018,0.00,,10.93,,"-96,969.25"
,IN,AR,30306948,1005,100,,Invoice,,,,,,06/02/2018,06/02/2018,0.00,,7.29,,"-96,976.54"
,IN,AR,30306950,1005,100,,Invoice,,,,,,06/02/2018,06/02/2018,0.00,,7.29,,"-96,983.83"
,IN,AR,30306996,1005,100,,Invoice,,,,,,06/02/2018,06/02/2018,0.00,,43.73,,"-97,027.56"
,IN,AR,30307029,1005,100,,Invoice,,,,,,06/02/2018,06/02/2018,0.00,,5.82,,"-97,033.38"
,IN,AR,30307047,1005,100,,Invoice,,,,,,06/02/2018,06/02/2018,0.00,,5.49,,"-97,038.87"
,IN,AR,30307083,1005,100,,Invoice,,,,,,06/02/2018,06/02/2018,0.00,,182.20,,"-97,221.07"
,IN,AR,30307121,1005,100,,Invoice,,,,,,06/02/2018,06/02/2018,0.00,,4.64,,"-97,225.71"
,IN,AR,30307146,1005,100,,Invoice,,,,,,06/02/2018,06/02/2018,0.00,,14.58,,"-97,240.29"
,IN,AR,30307159,1005,100,,Invoice,,,,,,06/02/2018,06/02/2018,0.00,,2.16,,"-97,242.45"
,IN,AR,30307162,1005,100,,Invoice,,,,,,06/02/2018,06/02/2018,0.00,,4.24,,"-97,246.69"
,IN,AR,30307221,1005,100,,Invoice,,,,,,06/02/2018,06/02/2018,0.00,,2.97,,"-97,249.66"
,IN,AR,30307242,1005,100,,Invoice,,,,,,06/02/2018,06/02/2018,0.00,,29.15,,"-97,278.81"
,IN,AR,30307246,1005,100,,Invoice,,,,,,06/02/2018,06/02/2018,0.00,,18.05,,"-97,296.86"
,IN,AR,30307262,1005,100,,Invoice,,,,,,06/02/2018,06/02/2018,0.00,,15.59,,"-97,312.45"
,IN,AR,30307292,1005,100,,Invoice,,,,,,06/02/2018,06/02/2018,0.00,,9.43,,"-97,321.88"
,IN,AR,30307295,1005,100,,Invoice,,,,,,06/02/2018,06/02/2018,0.00,,364.41,,"-97,686.29"
,IN,AR,30307307,1005,100,,Invoice,,,,,,06/02/2018,06/02/2018,0.00,,2.39,,"-97,688.68"
,IN,AR,30307318,1005,100,,Invoice,,,,,,06/02/2018,06/02/2018,0.00,,19.32,,"-97,708.00"
,IN,AR,30307366,1005,100,,Invoice,,,,,,06/02/2018,06/02/2018,0.00,,4.24,,"-97,712.24"
,IN,AR,30307369,1005,100,,Invoice,,,,,,06/02/2018,06/02/2018,0.00,,53.10,,"-97,765.34"
,IN,AR,30307416,1005,100,,Invoice,,,,,,06/02/2018,06/02/2018,0.00,,364.41,,"-98,129.75"
,IN,AR,30307459,1005,100,,Invoice,,,,,,06/02/2018,06/02/2018,0.00,,13.47,,"-98,143.22"
,IN,AR,30307477,1005,100,,Invoice,,,,,,06/02/2018,06/02/2018,0.00,,10.17,,"-98,153.39"
,IN,AR,30307523,1005,100,,Invoice,,,,,,06/02/2018,06/02/2018,0.00,,10.93,,"-98,164.32"
,IN,AR,30307548,1005,100,,Invoice,,,,,,06/02/2018,06/02/2018,0.00,,14.63,,"-98,178.95"
,IN,AR,30307549,1005,100,,Invoice,,,,,,06/02/2018,06/02/2018,0.00,,7.29,,"-98,186.24"
,IN,AR,30307560,1005,100,,Invoice,,,,,,06/02/2018,06/02/2018,0.00,,9.92,,"-98,196.16"
,IN,AR,30307569,1005,100,,Invoice,,,,,,06/02/2018,06/02/2018,0.00,,5.08,,"-98,201.24"
,IN,AR,30307575,1005,100,,Invoice,,,,,,06/02/2018,06/02/2018,0.00,,1.95,,"-98,203.19"
,IN,AR,30307577,1005,100,,Invoice,,,,,,06/02/2018,06/02/2018,0.00,,10.53,,"-98,213.72"
,IN,AR,30307595,1005,100,,Invoice,,,,,,06/02/2018,06/02/2018,0.00,,364.41,,"-98,578.13"
,IN,AR,30307597,1005,100,,Invoice,,,,,,06/02/2018,06/02/2018,0.00,,12.71,,"-98,590.84"
,IN,AR,30307600,1005,100,,Invoice,,,,,,06/02/2018,06/02/2018,0.00,,8.47,,"-98,599.31"
,IN,AR,30307627,1005,100,,Invoice,,,,,,06/02/2018,06/02/2018,0.00,,10.93,,"-98,610.24"
,IN,AR,30307640,1005,100,,Invoice,,,,,,06/02/2018,06/02/2018,0.00,,9.19,,"-98,619.43"
,IN,AR,30307652,1005,100,,Invoice,,,,,,06/02/2018,06/02/2018,0.00,,78.22,,"-98,697.65"
,IN,AR,30307660,1005,100,,Invoice,,,,,,06/02/2018,06/02/2018,0.00,,14.83,,"-98,712.48"
,IN,AR,30307721,1005,100,,Invoice,,,,,,06/02/2018,06/02/2018,0.00,,7.29,,"-98,719.77"
,IN,AR,30307730,1005,100,,Invoice,,,,,,06/02/2018,06/02/2018,0.00,,54.66,,"-98,774.43"
,IN,AR,30307737,1005,100,,Invoice,,,,,,06/02/2018,06/02/2018,0.00,,14.03,,"-98,788.46"
,IN,AR,30307741,1005,100,,Invoice,,,,,,06/02/2018,06/02/2018,0.00,,364.41,,"-99,152.87"
,IN,AR,30307745,1005,100,,Invoice,,,,,,06/02/2018,06/02/2018,0.00,,7.29,,"-99,160.16"
,IN,AR,30307755,1005,100,,Invoice,,,,,,06/02/2018,06/02/2018,0.00,,65.30,,"-99,225.46"
,IN,AR,30307760,1005,100,,Invoice,,,,,,06/02/2018,06/02/2018,0.00,,"1,093.22",,"-100,318.68"
,IN,AR,30307772,1005,100,,Invoice,,,,,,06/02/2018,06/02/2018,0.00,,5.51,,"-100,324.19"
,IN,AR,30307779,1005,100,,Invoice,,,,,,06/02/2018,06/02/2018,0.00,,2.80,,"-100,326.99"
,IN,AR,30307791,1005,100,,Invoice,,,,,,06/02/2018,06/02/2018,0.00,,8.52,,"-100,335.51"
,IN,AR,30307809,1005,100,,Invoice,,,,,,06/02/2018,06/02/2018,0.00,,5.17,,"-100,340.68"
,IN,AR,30307813,1005,100,,Invoice,,,,,,06/02/2018,06/02/2018,0.00,,6.74,,"-100,347.42"
,IN,AR,30307851,1005,100,,Invoice,,,,,,06/02/2018,06/02/2018,0.00,,10.93,,"-100,358.35"
,IN,AR,30307864,1005,100,,Invoice,,,,,,06/02/2018,06/02/2018,0.00,,25.73,,"-100,384.08"
,IN,AR,30307889,1005,100,,Invoice,,,,,,06/02/2018,06/02/2018,0.00,,3.53,,"-100,387.61"
,IN,AR,30307921,1005,100,,Invoice,,,,,,06/02/2018,06/02/2018,0.00,,25.51,,"-100,413.12"
,IN,AR,30307971,1005,100,,Invoice,,,,,,06/02/2018,06/02/2018,0.00,,2.58,,"-100,415.70"
,IN,AR,30307988,1005,100,,Invoice,,,,,,06/02/2018,06/02/2018,0.00,,29.15,,"-100,444.85"
,IN,AR,30307990,1005,100,,Invoice,,,,,,06/02/2018,06/02/2018,0.00,,11.25,,"-100,456.10"
,IN,AR,30308028,1005,100,,Invoice,,,,,,06/02/2018,06/02/2018,0.00,,6.36,,"-100,462.46"
,IN,AR,30308047,1005,100,,Invoice,,,,,,06/02/2018,06/02/2018,0.00,,22.71,,"-100,485.17"
,IN,AR,30308096,1005,100,,Invoice,,,,,,06/02/2018,06/02/2018,0.00,,15.13,,"-100,500.30"
,IN,AR,30308100,1005,100,,Invoice,,,,,,06/02/2018,06/02/2018,0.00,,183.66,,"-100,683.96"
,IN,AR,30308111,1005,100,,Invoice,,,,,,06/02/2018,06/02/2018,0.00,,4.81,,"-100,688.77"
,IN,AR,30308112,1005,100,,Invoice,,,,,,06/02/2018,06/02/2018,0.00,,6.42,,"-100,695.19"
,IN,AR,30308165,1005,100,,Invoice,,,,,,06/02/2018,06/02/2018,0.00,,4.58,,"-100,699.77"
,IN,AR,30308219,1005,100,,Invoice,,,,,,06/02/2018,06/02/2018,0.00,,20.34,,"-100,720.11"
,IN,AR,30308318,1005,100,,Invoice,,,,,,06/02/2018,06/02/2018,0.00,,5.47,,"-100,725.58"
,IN,AR,30308357,1005,100,,Invoice,,,,,,06/02/2018,06/02/2018,0.00,,104.00,,"-100,829.58"
,IN,AR,30308383,1005,100,,Invoice,,,,,,06/02/2018,06/02/2018,0.00,,30.85,,"-100,860.43"
,IN,AR,30308403,1005,100,,Invoice,,,,,,06/02/2018,06/02/2018,0.00,,7.29,,"-100,867.72"
,IN,AR,30308428,1005,100,,Invoice,,,,,,06/02/2018,06/02/2018,0.00,,32.03,,"-100,899.75"
,IN,AR,30308466,1005,100,,Invoice,,,,,,06/02/2018,06/02/2018,0.00,,81.36,,"-100,981.11"
,IN,AR,30308484,1005,100,,Invoice,,,,,,06/02/2018,06/02/2018,0.00,,21.36,,"-101,002.47"
,IN,AR,30308485,1005,100,,Invoice,,,,,,06/02/2018,06/02/2018,0.00,,18.98,,"-101,021.45"
,IN,AR,30308486,1005,100,,Invoice,,,,,,06/02/2018,06/02/2018,0.00,,85.43,,"-101,106.88"
,IN,AR,30308502,1005,100,,Invoice,,,,,,06/02/2018,06/02/2018,0.00,,"1,093.22",,"-102,200.10"
,IN,AR,30308515,1005,100,,Invoice,,,,,,06/02/2018,06/02/2018,0.00,,5.64,,"-102,205.74"
,IN,AR,30308516,1005,100,,Invoice,,,,,,06/02/2018,06/02/2018,0.00,,3.76,,"-102,209.50"
,IN,AR,30308524,1005,100,,Invoice,,,,,,06/02/2018,06/02/2018,0.00,,3.51,,"-102,213.01"
,IN,AR,30308531,1005,100,,Invoice,,,,,,06/02/2018,06/02/2018,0.00,,6.00,,"-102,219.01"
,IN,AR,30308536,1005,100,,Invoice,,,,,,06/02/2018,06/02/2018,0.00,,5.93,,"-102,224.94"
,IN,AR,30308542,1005,100,,Invoice,,,,,,06/02/2018,06/02/2018,0.00,,108.92,,"-102,333.86"
,IN,AR,30308562,1005,100,,Invoice,,,,,,06/02/2018,06/02/2018,0.00,,7.02,,"-102,340.88"
,IN,AR,30308590,1005,100,,Invoice,,,,,,06/02/2018,06/02/2018,0.00,,29.15,,"-102,370.03"
,IN,AR,30308608,1005,100,,Invoice,,,,,,06/02/2018,06/02/2018,0.00,,7.29,,"-102,377.32"
,IN,AR,30308610,1005,100,,Invoice,,,,,,06/02/2018,06/02/2018,0.00,,14.58,,"-102,391.90"
,IN,AR,30308656,1005,100,,Invoice,,,,,,06/02/2018,06/02/2018,0.00,,10.93,,"-102,402.83"
,IN,AR,30308660,1005,100,,Invoice,,,,,,06/02/2018,06/02/2018,0.00,,182.20,,"-102,585.03"
,IN,AR,30308692,1005,100,,Invoice,,,,,,06/02/2018,06/02/2018,0.00,,7.29,,"-102,592.32"
,IN,AR,30308697,1005,100,,Invoice,,,,,,06/02/2018,06/02/2018,0.00,,21.86,,"-102,614.18"
,IN,AR,30308698,1005,100,,Invoice,,,,,,06/02/2018,06/02/2018,0.00,,25.51,,"-102,639.69"
,IN,AR,30308707,1005,100,,Invoice,,,,,,06/02/2018,06/02/2018,0.00,,7.29,,"-102,646.98"
,IN,AR,30308720,1005,100,,Invoice,,,,,,06/02/2018,06/02/2018,0.00,,16.78,,"-102,663.76"
,IN,AR,30308722,1005,100,,Invoice,,,,,,06/02/2018,06/02/2018,0.00,,182.20,,"-102,845.96"
,IN,AR,30308729,1005,100,,Invoice,,,,,,06/02/2018,06/02/2018,0.00,,72.88,,"-102,918.84"
,CN,AR,31017224,1005,100,,Credit Note,,,,,,07/02/2018,07/02/2018,10.93,,0.00,,"-102,907.91"
,CS,AR,32000934,1005,100,,Cash sale,,,,,,07/02/2018,07/02/2018,0.00,,8.42,,"-102,916.33"
,CS,AR,32000945,1005,100,,Cash sale,,,,,,07/02/2018,07/02/2018,0.00,,3.64,,"-102,919.97"
,CS,AR,32000948,1005,100,,Cash sale,,,,,,07/02/2018,07/02/2018,0.00,,32.61,,"-102,952.58"
,CS,AR,32000963,1005,100,,Cash sale,,,,,,07/02/2018,07/02/2018,0.00,,12.17,,"-102,964.75"
,CS,AR,32000982,1005,100,,Cash sale,,,,,,07/02/2018,07/02/2018,0.00,,3.64,,"-102,968.39"
,CS,AR,32001005,1005,100,,Cash sale,,,,,,07/02/2018,07/02/2018,0.00,,7.29,,"-102,975.68"
,CS,AR,32001008,1005,100,,Cash sale,,,,,,07/02/2018,07/02/2018,0.00,,7.29,,"-102,982.97"
,CS,AR,32001049,1005,100,,Cash sale,,,,,,07/02/2018,07/02/2018,0.00,,7.29,,"-102,990.26"
,CS,AR,32001051,1005,100,,Cash sale,,,,,,07/02/2018,07/02/2018,0.00,,6.02,,"-102,996.28"
,CS,AR,32001073,1005,100,,Cash sale,,,,,,07/02/2018,07/02/2018,0.00,,8.39,,"-103,004.67"
,CS,AR,32001081,1005,100,,Cash sale,,,,,,07/02/2018,07/02/2018,0.00,,23.29,,"-103,027.96"
,CS,AR,32001098,1005,100,,Cash sale,,,,,,07/02/2018,07/02/2018,0.00,,2.92,,"-103,030.88"
,CS,AR,32001176,1005,100,,Cash sale,,,,,,07/02/2018,07/02/2018,0.00,,7.29,,"-103,038.17"
,CS,AR,32001180,1005,100,,Cash sale,,,,,,07/02/2018,07/02/2018,0.00,,3.64,,"-103,041.81"
,CS,AR,32001189,1005,100,,Cash sale,,,,,,07/02/2018,07/02/2018,0.00,,12.03,,"-103,053.84"
,CS,AR,32001202,1005,100,,Cash sale,,,,,,07/02/2018,07/02/2018,0.00,,7.29,,"-103,061.13"
,CS,AR,32001204,1005,100,,Cash sale,,,,,,07/02/2018,07/02/2018,0.00,,10.93,,"-103,072.06"
,CS,AR,32001206,1005,100,,Cash sale,,,,,,07/02/2018,07/02/2018,0.00,,14.58,,"-103,086.64"
,CS,AR,32001219,1005,100,,Cash sale,,,,,,07/02/2018,07/02/2018,0.00,,2.54,,"-103,089.18"
,CS,AR,32001225,1005,100,,Cash sale,,,,,,07/02/2018,07/02/2018,0.00,,2.54,,"-103,091.72"
,CS,AR,32001233,1005,100,,Cash sale,,,,,,07/02/2018,07/02/2018,0.00,,5.17,,"-103,096.89"
,CS,AR,32001278,1005,100,,Cash sale,,,,,,07/02/2018,07/02/2018,0.00,,10.93,,"-103,107.82"
,CS,AR,32001292,1005,100,,Cash sale,,,,,,07/02/2018,07/02/2018,0.00,,3.64,,"-103,111.46"
,CS,AR,32001302,1005,100,,Cash sale,,,,,,07/02/2018,07/02/2018,0.00,,10.93,,"-103,122.39"
,CS,AR,32001324,1005,100,,Cash sale,,,,,,07/02/2018,07/02/2018,0.00,,7.63,,"-103,130.02"
,CS,AR,32001338,1005,100,,Cash sale,,,,,,07/02/2018,07/02/2018,0.00,,10.93,,"-103,140.95"
,CS,AR,32001358,1005,100,,Cash sale,,,,,,07/02/2018,07/02/2018,0.00,,7.29,,"-103,148.24"
,CS,AR,32001397,1005,100,,Cash sale,,,,,,07/02/2018,07/02/2018,0.00,,21.86,,"-103,170.10"
,CS,AR,32001409,1005,100,,Cash sale,,,,,,07/02/2018,07/02/2018,0.00,,10.93,,"-103,181.03"
,CS,AR,32001414,1005,100,,Cash sale,,,,,,07/02/2018,07/02/2018,0.00,,8.02,,"-103,189.05"
,CS,AR,32001442,1005,100,,Cash sale,,,,,,07/02/2018,07/02/2018,0.00,,7.29,,"-103,196.34"
,CS,AR,32001471,1005,100,,Cash sale,,,,,,07/02/2018,07/02/2018,0.00,,5.17,,"-103,201.51"
,CS,AR,32001477,1005,100,,Cash sale,,,,,,07/02/2018,07/02/2018,0.00,,22.88,,"-103,224.39"
,CS,AR,32001481,1005,100,,Cash sale,,,,,,07/02/2018,07/02/2018,0.00,,7.29,,"-103,231.68"
,CS,AR,32001523,1005,100,,Cash sale,,,,,,07/02/2018,07/02/2018,0.00,,7.29,,"-103,238.97"
,CS,AR,32001527,1005,100,,Cash sale,,,,,,07/02/2018,07/02/2018,0.00,,9.15,,"-103,248.12"
,CS,AR,32001551,1005,100,,Cash sale,,,,,,07/02/2018,07/02/2018,0.00,,10.93,,"-103,259.05"
,CS,AR,32001561,1005,100,,Cash sale,,,,,,07/02/2018,07/02/2018,0.00,,14.58,,"-103,273.63"
,CS,AR,32001571,1005,100,,Cash sale,,,,,,07/02/2018,07/02/2018,0.00,,12.03,,"-103,285.66"
,CS,AR,32001576,1005,100,,Cash sale,,,,,,07/02/2018,07/02/2018,0.00,,10.93,,"-103,296.59"
,CS,AR,32001587,1005,100,,Cash sale,,,,,,07/02/2018,07/02/2018,0.00,,12.71,,"-103,309.30"
,CS,AR,32001592,1005,100,,Cash sale,,,,,,07/02/2018,07/02/2018,0.00,,10.93,,"-103,320.23"
,CS,AR,32001601,1005,100,,Cash sale,,,,,,07/02/2018,07/02/2018,0.00,,3.64,,"-103,323.87"
,CS,AR,32001619,1005,100,,Cash sale,,,,,,07/02/2018,07/02/2018,0.00,,7.29,,"-103,331.16"
,CS,AR,32001677,1005,100,,Cash sale,,,,,,07/02/2018,07/02/2018,0.00,,10.99,,"-103,342.15"
,IN,AR,30306676,1005,100,,Invoice,,,,,,07/02/2018,07/02/2018,0.00,,50.42,,"-103,392.57"
,IN,AR,30306677,1005,100,,Invoice,,,,,,07/02/2018,07/02/2018,0.00,,26.69,,"-103,419.26"
,IN,AR,30306678,1005,100,,Invoice,,,,,,07/02/2018,07/02/2018,0.00,,20.76,,"-103,440.02"
,IN,AR,30306707,1005,100,,Invoice,,,,,,07/02/2018,07/02/2018,0.00,,329.71,,"-103,769.73"
,IN,AR,30306716,1005,100,,Invoice,,,,,,07/02/2018,07/02/2018,0.00,,63.46,,"-103,833.19"
,IN,AR,30306717,1005,100,,Invoice,,,,,,07/02/2018,07/02/2018,0.00,,17.08,,"-103,850.27"
,IN,AR,30306730,1005,100,,Invoice,,,,,,07/02/2018,07/02/2018,0.00,,16.27,,"-103,866.54"
,IN,AR,30306741,1005,100,,Invoice,,,,,,07/02/2018,07/02/2018,0.00,,9.96,,"-103,876.50"
,IN,AR,30306752,1005,100,,Invoice,,,,,,07/02/2018,07/02/2018,0.00,,21.02,,"-103,897.52"
,IN,AR,30306753,1005,100,,Invoice,,,,,,07/02/2018,07/02/2018,0.00,,86.69,,"-103,984.21"
,IN,AR,30306770,1005,100,,Invoice,,,,,,07/02/2018,07/02/2018,0.00,,3.64,,"-103,987.85"
,IN,AR,30306771,1005,100,,Invoice,,,,,,07/02/2018,07/02/2018,0.00,,7.29,,"-103,995.14"
,IN,AR,30306804,1005,100,,Invoice,,,,,,07/02/2018,07/02/2018,0.00,,7.29,,"-104,002.43"
,IN,AR,30306806,1005,100,,Invoice,,,,,,07/02/2018,07/02/2018,0.00,,2.16,,"-104,004.59"
,IN,AR,30306831,1005,100,,Invoice,,,,,,07/02/2018,07/02/2018,0.00,,90.17,,"-104,094.76"
,IN,AR,30306863,1005,100,,Invoice,,,,,,07/02/2018,07/02/2018,0.00,,18.00,,"-104,112.76"
,IN,AR,30306874,1005,100,,Invoice,,,,,,07/02/2018,07/02/2018,0.00,,21.86,,"-104,134.62"
,IN,AR,30306875,1005,100,,Invoice,,,,,,07/02/2018,07/02/2018,0.00,,11.86,,"-104,146.48"
,IN,AR,30306893,1005,100,,Invoice,,,,,,07/02/2018,07/02/2018,0.00,,32.80,,"-104,179.28"
,IN,AR,30306906,1005,100,,Invoice,,,,,,07/02/2018,07/02/2018,0.00,,14.00,,"-104,193.28"
,IN,AR,30306957,1005,100,,Invoice,,,,,,07/02/2018,07/02/2018,0.00,,30.00,,"-104,223.28"
,IN,AR,30306965,1005,100,,Invoice,,,,,,07/02/2018,07/02/2018,0.00,,10.93,,"-104,234.21"
,IN,AR,30306969,1005,100,,Invoice,,,,,,07/02/2018,07/02/2018,0.00,,64.07,,"-104,298.28"
,IN,AR,30307016,1005,100,,Invoice,,,,,,07/02/2018,07/02/2018,0.00,,125.53,,"-104,423.81"
,IN,AR,30307033,1005,100,,Invoice,,,,,,07/02/2018,07/02/2018,0.00,,81.25,,"-104,505.06"
,IN,AR,30307052,1005,100,,Invoice,,,,,,07/02/2018,07/02/2018,0.00,,6.02,,"-104,511.08"
,IN,AR,30307071,1005,100,,Invoice,,,,,,07/02/2018,07/02/2018,0.00,,15.92,,"-104,527.00"
,IN,AR,30307150,1005,100,,Invoice,,,,,,07/02/2018,07/02/2018,0.00,,7.63,,"-104,534.63"
,IN,AR,30307166,1005,100,,Invoice,,,,,,07/02/2018,07/02/2018,0.00,,8.47,,"-104,543.10"
,IN,AR,30307184,1005,100,,Invoice,,,,,,07/02/2018,07/02/2018,0.00,,4.24,,"-104,547.34"
,IN,AR,30307230,1005,100,,Invoice,,,,,,07/02/2018,07/02/2018,0.00,,9.56,,"-104,556.90"
,IN,AR,30307270,1005,100,,Invoice,,,,,,07/02/2018,07/02/2018,0.00,,49.22,,"-104,606.12"
,IN,AR,30307283,1005,100,,Invoice,,,,,,07/02/2018,07/02/2018,0.00,,144.92,,"-104,751.04"
,IN,AR,30307299,1005,100,,Invoice,,,,,,07/02/2018,07/02/2018,0.00,,10.72,,"-104,761.76"
,IN,AR,30307344,1005,100,,Invoice,,,,,,07/02/2018,07/02/2018,0.00,,7.29,,"-104,769.05"
,IN,AR,30307354,1005,100,,Invoice,,,,,,07/02/2018,07/02/2018,0.00,,11.02,,"-104,780.07"
,IN,AR,30307361,1005,100,,Invoice,,,,,,07/02/2018,07/02/2018,0.00,,5.17,,"-104,785.24"
,IN,AR,30307378,1005,100,,Invoice,,,,,,07/02/2018,07/02/2018,0.00,,72.03,,"-104,857.27"
,IN,AR,30307422,1005,100,,Invoice,,,,,,07/02/2018,07/02/2018,0.00,,7.63,,"-104,864.90"
,IN,AR,30307423,1005,100,,Invoice,,,,,,07/02/2018,07/02/2018,0.00,,2.54,,"-104,867.44"
,IN,AR,30307481,1005,100,,Invoice,,,,,,07/02/2018,07/02/2018,0.00,,11.86,,"-104,879.30"
,IN,AR,30307535,1005,100,,Invoice,,,,,,07/02/2018,07/02/2018,0.00,,13.63,,"-104,892.93"
,IN,AR,30307570,1005,100,,Invoice,,,,,,07/02/2018,07/02/2018,0.00,,5.08,,"-104,898.01"
,IN,AR,30307619,1005,100,,Invoice,,,,,,07/02/2018,07/02/2018,0.00,,10.93,,"-104,908.94"
,IN,AR,30307661,1005,100,,Invoice,,,,,,07/02/2018,07/02/2018,0.00,,32.63,,"-104,941.57"
,IN,AR,30307667,1005,100,,Invoice,,,,,,07/02/2018,07/02/2018,0.00,,9.15,,"-104,950.72"
,IN,AR,30307680,1005,100,,Invoice,,,,,,07/02/2018,07/02/2018,0.00,,5.59,,"-104,956.31"
,IN,AR,30307700,1005,100,,Invoice,,,,,,07/02/2018,07/02/2018,0.00,,1.88,,"-104,958.19"
,IN,AR,30307706,1005,100,,Invoice,,,,,,07/02/2018,07/02/2018,0.00,,10.93,,"-104,969.12"
,IN,AR,30307710,1005,100,,Invoice,,,,,,07/02/2018,07/02/2018,0.00,,10.93,,"-104,980.05"
,IN,AR,30307717,1005,100,,Invoice,,,,,,07/02/2018,07/02/2018,0.00,,68.34,,"-105,048.39"
,IN,AR,30307749,1005,100,,Invoice,,,,,,07/02/2018,07/02/2018,0.00,,2.71,,"-105,051.10"
,IN,AR,30307798,1005,100,,Invoice,,,,,,07/02/2018,07/02/2018,0.00,,25.98,,"-105,077.08"
,IN,AR,30307818,1005,100,,Invoice,,,,,,07/02/2018,07/02/2018,0.00,,18.05,,"-105,095.13"
,IN,AR,30307827,1005,100,,Invoice,,,,,,07/02/2018,07/02/2018,0.00,,21.06,,"-105,116.19"
,IN,AR,30307865,1005,100,,Invoice,,,,,,07/02/2018,07/02/2018,0.00,,36.45,,"-105,152.64"
,IN,AR,30307880,1005,100,,Invoice,,,,,,07/02/2018,07/02/2018,0.00,,9.29,,"-105,161.93"
,IN,AR,30307890,1005,100,,Invoice,,,,,,07/02/2018,07/02/2018,0.00,,17.62,,"-105,179.55"
,IN,AR,30307901,1005,100,,Invoice,,,,,,07/02/2018,07/02/2018,0.00,,12.03,,"-105,191.58"
,IN,AR,30307935,1005,100,,Invoice,,,,,,07/02/2018,07/02/2018,0.00,,12.92,,"-105,204.50"
,IN,AR,30308053,1005,100,,Invoice,,,,,,07/02/2018,07/02/2018,0.00,,30.00,,"-105,234.50"
,IN,AR,30308088,1005,100,,Invoice,,,,,,07/02/2018,07/02/2018,0.00,,3.64,,"-105,238.14"
,IN,AR,30308113,1005,100,,Invoice,,,,,,07/02/2018,07/02/2018,0.00,,8.02,,"-105,246.16"
,IN,AR,30308114,1005,100,,Invoice,,,,,,07/02/2018,07/02/2018,0.00,,14.43,,"-105,260.59"
,IN,AR,30308115,1005,100,,Invoice,,,,,,07/02/2018,07/02/2018,0.00,,6.42,,"-105,267.01"
,IN,AR,30308116,1005,100,,Invoice,,,,,,07/02/2018,07/02/2018,0.00,,3.20,,"-105,270.21"
,IN,AR,30308117,1005,100,,Invoice,,,,,,07/02/2018,07/02/2018,0.00,,1.60,,"-105,271.81"
,IN,AR,30308118,1005,100,,Invoice,,,,,,07/02/2018,07/02/2018,0.00,,6.42,,"-105,278.23"
,IN,AR,30308119,1005,100,,Invoice,,,,,,07/02/2018,07/02/2018,0.00,,9.62,,"-105,287.85"
,IN,AR,30308174,1005,100,,Invoice,,,,,,07/02/2018,07/02/2018,0.00,,182.20,,"-105,470.05"
,IN,AR,30308198,1005,100,,Invoice,,,,,,07/02/2018,07/02/2018,0.00,,28.46,,"-105,498.51"
,IN,AR,30308208,1005,100,,Invoice,,,,,,07/02/2018,07/02/2018,0.00,,18.22,,"-105,516.73"
,IN,AR,30308237,1005,100,,Invoice,,,,,,07/02/2018,07/02/2018,0.00,,10.00,,"-105,526.73"
,IN,AR,30308272,1005,100,,Invoice,,,,,,07/02/2018,07/02/2018,0.00,,3.02,,"-105,529.75"
,IN,AR,30308278,1005,100,,Invoice,,,,,,07/02/2018,07/02/2018,0.00,,5.83,,"-105,535.58"
,IN,AR,30308291,1005,100,,Invoice,,,,,,07/02/2018,07/02/2018,0.00,,23.13,,"-105,558.71"
,IN,AR,30308353,1005,100,,Invoice,,,,,,07/02/2018,07/02/2018,0.00,,9.64,,"-105,568.35"
,IN,AR,30308371,1005,100,,Invoice,,,,,,07/02/2018,07/02/2018,0.00,,8.17,,"-105,576.52"
,IN,AR,30308419,1005,100,,Invoice,,,,,,07/02/2018,07/02/2018,0.00,,29.15,,"-105,605.67"
,IN,AR,30308432,1005,100,,Invoice,,,,,,07/02/2018,07/02/2018,0.00,,40.58,,"-105,646.25"
,IN,AR,30308437,1005,100,,Invoice,,,,,,07/02/2018,07/02/2018,0.00,,14.58,,"-105,660.83"
,IN,AR,30308443,1005,100,,Invoice,,,,,,07/02/2018,07/02/2018,0.00,,9.56,,"-105,670.39"
,IN,AR,30308444,1005,100,,Invoice,,,,,,07/02/2018,07/02/2018,0.00,,9.56,,"-105,679.95"
,IN,AR,30308520,1005,100,,Invoice,,,,,,07/02/2018,07/02/2018,0.00,,5.26,,"-105,685.21"
,IN,AR,30308566,1005,100,,Invoice,,,,,,07/02/2018,07/02/2018,0.00,,3.64,,"-105,688.85"
,IN,AR,30308585,1005,100,,Invoice,,,,,,07/02/2018,07/02/2018,0.00,,7.29,,"-105,696.14"
,IN,AR,30308597,1005,100,,Invoice,,,,,,07/02/2018,07/02/2018,0.00,,11.29,,"-105,707.43"
,IN,AR,30308662,1005,100,,Invoice,,,,,,07/02/2018,07/02/2018,0.00,,11.19,,"-105,718.62"
,IN,AR,30308682,1005,100,,Invoice,,,,,,07/02/2018,07/02/2018,0.00,,5.49,,"-105,724.11"
,IN,AR,30308734,1005,100,,Invoice,,,,,,07/02/2018,07/02/2018,0.00,,54.66,,"-105,778.77"
,CN,AR,31017293,1005,100,,Credit Note,,,,,,08/02/2018,08/02/2018,10.72,,0.00,,"-105,768.05"
,CN,AR,31017390,1005,100,,Credit Note,,,,,,08/02/2018,08/02/2018,29.15,,0.00,,"-105,738.90"
,CN,AR,31017395,1005,100,,Credit Note,,,,,,08/02/2018,08/02/2018,7.90,,0.00,,"-105,731.00"
,CN,AR,31017427,1005,100,,Credit Note,,,,,,08/02/2018,08/02/2018,16.93,,0.00,,"-105,714.07"
,CN,AR,31017428,1005,100,,Credit Note,,,,,,08/02/2018,08/02/2018,3.76,,0.00,,"-105,710.31"
,CN,AR,31017429,1005,100,,Credit Note,,,,,,08/02/2018,08/02/2018,7.53,,0.00,,"-105,702.78"
,CN,AR,31017430,1005,100,,Credit Note,,,,,,08/02/2018,08/02/2018,9.41,,0.00,,"-105,693.37"
,CS,AR,32000930,1005,100,,Cash sale,,,,,,08/02/2018,08/02/2018,0.00,,21.06,,"-105,714.43"
,CS,AR,32000966,1005,100,,Cash sale,,,,,,08/02/2018,08/02/2018,0.00,,3.64,,"-105,718.07"
,CS,AR,32000975,1005,100,,Cash sale,,,,,,08/02/2018,08/02/2018,0.00,,7.75,,"-105,725.82"
,CS,AR,32000977,1005,100,,Cash sale,,,,,,08/02/2018,08/02/2018,0.00,,11.22,,"-105,737.04"
,CS,AR,32000988,1005,100,,Cash sale,,,,,,08/02/2018,08/02/2018,0.00,,3.64,,"-105,740.68"
,CS,AR,32000997,1005,100,,Cash sale,,,,,,08/02/2018,08/02/2018,0.00,,14.58,,"-105,755.26"
,CS,AR,32001000,1005,100,,Cash sale,,,,,,08/02/2018,08/02/2018,0.00,,10.93,,"-105,766.19"
,CS,AR,32001018,1005,100,,Cash sale,,,,,,08/02/2018,08/02/2018,0.00,,3.64,,"-105,769.83"
,CS,AR,32001032,1005,100,,Cash sale,,,,,,08/02/2018,08/02/2018,0.00,,7.29,,"-105,777.12"
,CS,AR,32001057,1005,100,,Cash sale,,,,,,08/02/2018,08/02/2018,0.00,,3.64,,"-105,780.76"
,CS,AR,32001080,1005,100,,Cash sale,,,,,,08/02/2018,08/02/2018,0.00,,7.29,,"-105,788.05"
,CS,AR,32001090,1005,100,,Cash sale,,,,,,08/02/2018,08/02/2018,0.00,,3.64,,"-105,791.69"
,CS,AR,32001102,1005,100,,Cash sale,,,,,,08/02/2018,08/02/2018,0.00,,7.29,,"-105,798.98"
,CS,AR,32001126,1005,100,,Cash sale,,,,,,08/02/2018,08/02/2018,0.00,,9.03,,"-105,808.01"
,CS,AR,32001131,1005,100,,Cash sale,,,,,,08/02/2018,08/02/2018,0.00,,7.29,,"-105,815.30"
,CS,AR,32001141,1005,100,,Cash sale,,,,,,08/02/2018,08/02/2018,0.00,,10.35,,"-105,825.65"
,CS,AR,32001162,1005,100,,Cash sale,,,,,,08/02/2018,08/02/2018,0.00,,7.75,,"-105,833.40"
,CS,AR,32001166,1005,100,,Cash sale,,,,,,08/02/2018,08/02/2018,0.00,,3.64,,"-105,837.04"
,CS,AR,32001289,1005,100,,Cash sale,,,,,,08/02/2018,08/02/2018,0.00,,19.28,,"-105,856.32"
,CS,AR,32001308,1005,100,,Cash sale,,,,,,08/02/2018,08/02/2018,0.00,,3.64,,"-105,859.96"
,CS,AR,32001331,1005,100,,Cash sale,,,,,,08/02/2018,08/02/2018,0.00,,36.36,,"-105,896.32"
,CS,AR,32001372,1005,100,,Cash sale,,,,,,08/02/2018,08/02/2018,0.00,,10.93,,"-105,907.25"
,CS,AR,32001376,1005,100,,Cash sale,,,,,,08/02/2018,08/02/2018,0.00,,5.17,,"-105,912.42"
,CS,AR,32001404,1005,100,,Cash sale,,,,,,08/02/2018,08/02/2018,0.00,,11.12,,"-105,923.54"
,CS,AR,32001418,1005,100,,Cash sale,,,,,,08/02/2018,08/02/2018,0.00,,42.12,,"-105,965.66"
,CS,AR,32001430,1005,100,,Cash sale,,,,,,08/02/2018,08/02/2018,0.00,,7.29,,"-105,972.95"
,CS,AR,32001447,1005,100,,Cash sale,,,,,,08/02/2018,08/02/2018,0.00,,5.24,,"-105,978.19"
,CS,AR,32001486,1005,100,,Cash sale,,,,,,08/02/2018,08/02/2018,0.00,,32.80,,"-106,010.99"
,CS,AR,32001508,1005,100,,Cash sale,,,,,,08/02/2018,08/02/2018,0.00,,11.02,,"-106,022.01"
,CS,AR,32001547,1005,100,,Cash sale,,,,,,08/02/2018,08/02/2018,0.00,,5.93,,"-106,027.94"
,CS,AR,32001549,1005,100,,Cash sale,,,,,,08/02/2018,08/02/2018,0.00,,25.51,,"-106,053.45"
,CS,AR,32001643,1005,100,,Cash sale,,,,,,08/02/2018,08/02/2018,0.00,,10.93,,"-106,064.38"
,CS,AR,32001671,1005,100,,Cash sale,,,,,,08/02/2018,08/02/2018,0.00,,7.29,,"-106,071.67"
,IN,AR,30306679,1005,100,,Invoice,,,,,,08/02/2018,08/02/2018,0.00,,5.93,,"-106,077.60"
,IN,AR,30306697,1005,100,,Invoice,,,,,,08/02/2018,08/02/2018,0.00,,7.29,,"-106,084.89"
,IN,AR,30306746,1005,100,,Invoice,,,,,,08/02/2018,08/02/2018,0.00,,3.64,,"-106,088.53"
,IN,AR,30306808,1005,100,,Invoice,,,,,,08/02/2018,08/02/2018,0.00,,47.37,,"-106,135.90"
,IN,AR,30306816,1005,100,,Invoice,,,,,,08/02/2018,08/02/2018,0.00,,10.93,,"-106,146.83"
,IN,AR,30306832,1005,100,,Invoice,,,,,,08/02/2018,08/02/2018,0.00,,16.61,,"-106,163.44"
,IN,AR,30306853,1005,100,,Invoice,,,,,,08/02/2018,08/02/2018,0.00,,3.64,,"-106,167.08"
,IN,AR,30306898,1005,100,,Invoice,,,,,,08/02/2018,08/02/2018,0.00,,7.29,,"-106,174.37"
,IN,AR,30306918,1005,100,,Invoice,,,,,,08/02/2018,08/02/2018,0.00,,7.29,,"-106,181.66"
,IN,AR,30306998,1005,100,,Invoice,,,,,,08/02/2018,08/02/2018,0.00,,46.68,,"-106,228.34"
,IN,AR,30307001,1005,100,,Invoice,,,,,,08/02/2018,08/02/2018,0.00,,182.20,,"-106,410.54"
,IN,AR,30307011,1005,100,,Invoice,,,,,,08/02/2018,08/02/2018,0.00,,182.20,,"-106,592.74"
,IN,AR,30307040,1005,100,,Invoice,,,,,,08/02/2018,08/02/2018,0.00,,32.00,,"-106,624.74"
,IN,AR,30307056,1005,100,,Invoice,,,,,,08/02/2018,08/02/2018,0.00,,47.37,,"-106,672.11"
,IN,AR,30307107,1005,100,,Invoice,,,,,,08/02/2018,08/02/2018,0.00,,17.50,,"-106,689.61"
,IN,AR,30307182,1005,100,,Invoice,,,,,,08/02/2018,08/02/2018,0.00,,18.05,,"-106,707.66"
,IN,AR,30307243,1005,100,,Invoice,,,,,,08/02/2018,08/02/2018,0.00,,26.29,,"-106,733.95"
,IN,AR,30307252,1005,100,,Invoice,,,,,,08/02/2018,08/02/2018,0.00,,9.56,,"-106,743.51"
,IN,AR,30307265,1005,100,,Invoice,,,,,,08/02/2018,08/02/2018,0.00,,20.34,,"-106,763.85"
,IN,AR,30307308,1005,100,,Invoice,,,,,,08/02/2018,08/02/2018,0.00,,16.73,,"-106,780.58"
,IN,AR,30307326,1005,100,,Invoice,,,,,,08/02/2018,08/02/2018,0.00,,19.32,,"-106,799.90"
,IN,AR,30307352,1005,100,,Invoice,,,,,,08/02/2018,08/02/2018,0.00,,6.02,,"-106,805.92"
,IN,AR,30307407,1005,100,,Invoice,,,,,,08/02/2018,08/02/2018,0.00,,6.36,,"-106,812.28"
,IN,AR,30307424,1005,100,,Invoice,,,,,,08/02/2018,08/02/2018,0.00,,7.63,,"-106,819.91"
,IN,AR,30307425,1005,100,,Invoice,,,,,,08/02/2018,08/02/2018,0.00,,7.63,,"-106,827.54"
,IN,AR,30307450,1005,100,,Invoice,,,,,,08/02/2018,08/02/2018,0.00,,22.31,,"-106,849.85"
,IN,AR,30307451,1005,100,,Invoice,,,,,,08/02/2018,08/02/2018,0.00,,50.98,,"-106,900.83"
,IN,AR,30307461,1005,100,,Invoice,,,,,,08/02/2018,08/02/2018,0.00,,27.58,,"-106,928.41"
,IN,AR,30307472,1005,100,,Invoice,,,,,,08/02/2018,08/02/2018,0.00,,5.17,,"-106,933.58"
,IN,AR,30307529,1005,100,,Invoice,,,,,,08/02/2018,08/02/2018,0.00,,10.93,,"-106,944.51"
,IN,AR,30307559,1005,100,,Invoice,,,,,,08/02/2018,08/02/2018,0.00,,14.58,,"-106,959.09"
,IN,AR,30307603,1005,100,,Invoice,,,,,,08/02/2018,08/02/2018,0.00,,8.47,,"-106,967.56"
,IN,AR,30307605,1005,100,,Invoice,,,,,,08/02/2018,08/02/2018,0.00,,21.86,,"-106,989.42"
,IN,AR,30307620,1005,100,,Invoice,,,,,,08/02/2018,08/02/2018,0.00,,7.29,,"-106,996.71"
,IN,AR,30307632,1005,100,,Invoice,,,,,,08/02/2018,08/02/2018,0.00,,5.51,,"-107,002.22"
,IN,AR,30307637,1005,100,,Invoice,,,,,,08/02/2018,08/02/2018,0.00,,16.47,,"-107,018.69"
,IN,AR,30307676,1005,100,,Invoice,,,,,,08/02/2018,08/02/2018,0.00,,14.00,,"-107,032.69"
,IN,AR,30307723,1005,100,,Invoice,,,,,,08/02/2018,08/02/2018,0.00,,23.90,,"-107,056.59"
,IN,AR,30307726,1005,100,,Invoice,,,,,,08/02/2018,08/02/2018,0.00,,12.71,,"-107,069.30"
,IN,AR,30307752,1005,100,,Invoice,,,,,,08/02/2018,08/02/2018,0.00,,6.97,,"-107,076.27"
,IN,AR,30307762,1005,100,,Invoice,,,,,,08/02/2018,08/02/2018,0.00,,8.77,,"-107,085.04"
,IN,AR,30307773,1005,100,,Invoice,,,,,,08/02/2018,08/02/2018,0.00,,11.02,,"-107,096.06"
,IN,AR,30307800,1005,100,,Invoice,,,,,,08/02/2018,08/02/2018,0.00,,42.69,,"-107,138.75"
,IN,AR,30307832,1005,100,,Invoice,,,,,,08/02/2018,08/02/2018,0.00,,8.25,,"-107,147.00"
,IN,AR,30307839,1005,100,,Invoice,,,,,,08/02/2018,08/02/2018,0.00,,3.88,,"-107,150.88"
,IN,AR,30307840,1005,100,,Invoice,,,,,,08/02/2018,08/02/2018,0.00,,17.47,,"-107,168.35"
,IN,AR,30307844,1005,100,,Invoice,,,,,,08/02/2018,08/02/2018,0.00,,7.63,,"-107,175.98"
,IN,AR,30307858,1005,100,,Invoice,,,,,,08/02/2018,08/02/2018,0.00,,10.00,,"-107,185.98"
,IN,AR,30307891,1005,100,,Invoice,,,,,,08/02/2018,08/02/2018,0.00,,8.81,,"-107,194.79"
,IN,AR,30307910,1005,100,,Invoice,,,,,,08/02/2018,08/02/2018,0.00,,10.93,,"-107,205.72"
,IN,AR,30307918,1005,100,,Invoice,,,,,,08/02/2018,08/02/2018,0.00,,11.36,,"-107,217.08"
,IN,AR,30307922,1005,100,,Invoice,,,,,,08/02/2018,08/02/2018,0.00,,25.32,,"-107,242.40"
,IN,AR,30307938,1005,100,,Invoice,,,,,,08/02/2018,08/02/2018,0.00,,5.17,,"-107,247.57"
,IN,AR,30307955,1005,100,,Invoice,,,,,,08/02/2018,08/02/2018,0.00,,18.22,,"-107,265.79"
,IN,AR,30307956,1005,100,,Invoice,,,,,,08/02/2018,08/02/2018,0.00,,29.15,,"-107,294.94"
,IN,AR,30307973,1005,100,,Invoice,,,,,,08/02/2018,08/02/2018,0.00,,14.58,,"-107,309.52"
,IN,AR,30307986,1005,100,,Invoice,,,,,,08/02/2018,08/02/2018,0.00,,4.08,,"-107,313.60"
,IN,AR,30307993,1005,100,,Invoice,,,,,,08/02/2018,08/02/2018,0.00,,7.29,,"-107,320.89"
,IN,AR,30307997,1005,100,,Invoice,,,,,,08/02/2018,08/02/2018,0.00,,10.17,,"-107,331.06"
,IN,AR,30308012,1005,100,,Invoice,,,,,,08/02/2018,08/02/2018,0.00,,9.76,,"-107,340.82"
,IN,AR,30308013,1005,100,,Invoice,,,,,,08/02/2018,08/02/2018,0.00,,11.39,,"-107,352.21"
,IN,AR,30308014,1005,100,,Invoice,,,,,,08/02/2018,08/02/2018,0.00,,22.78,,"-107,374.99"
,IN,AR,30308015,1005,100,,Invoice,,,,,,08/02/2018,08/02/2018,0.00,,3.25,,"-107,378.24"
,IN,AR,30308029,1005,100,,Invoice,,,,,,08/02/2018,08/02/2018,0.00,,19.08,,"-107,397.32"
,IN,AR,30308030,1005,100,,Invoice,,,,,,08/02/2018,08/02/2018,0.00,,4.77,,"-107,402.09"
,IN,AR,30308059,1005,100,,Invoice,,,,,,08/02/2018,08/02/2018,0.00,,15.71,,"-107,417.80"
,IN,AR,30308097,1005,100,,Invoice,,,,,,08/02/2018,08/02/2018,0.00,,4.32,,"-107,422.12"
,IN,AR,30308120,1005,100,,Invoice,,,,,,08/02/2018,08/02/2018,0.00,,8.02,,"-107,430.14"
,IN,AR,30308121,1005,100,,Invoice,,,,,,08/02/2018,08/02/2018,0.00,,9.62,,"-107,439.76"
,IN,AR,30308177,1005,100,,Invoice,,,,,,08/02/2018,08/02/2018,0.00,,16.40,,"-107,456.16"
,IN,AR,30308209,1005,100,,Invoice,,,,,,08/02/2018,08/02/2018,0.00,,10.93,,"-107,467.09"
,IN,AR,30308220,1005,100,,Invoice,,,,,,08/02/2018,08/02/2018,0.00,,2.54,,"-107,469.63"
,IN,AR,30308230,1005,100,,Invoice,,,,,,08/02/2018,08/02/2018,0.00,,22.01,,"-107,491.64"
,IN,AR,30308242,1005,100,,Invoice,,,,,,08/02/2018,08/02/2018,0.00,,12.00,,"-107,503.64"
,IN,AR,30308251,1005,100,,Invoice,,,,,,08/02/2018,08/02/2018,0.00,,54.66,,"-107,558.30"
,IN,AR,30308256,1005,100,,Invoice,,,,,,08/02/2018,08/02/2018,0.00,,14.58,,"-107,572.88"
,IN,AR,30308265,1005,100,,Invoice,,,,,,08/02/2018,08/02/2018,0.00,,29.15,,"-107,602.03"
,IN,AR,30308292,1005,100,,Invoice,,,,,,08/02/2018,08/02/2018,0.00,,10.52,,"-107,612.55"
,IN,AR,30308324,1005,100,,Invoice,,,,,,08/02/2018,08/02/2018,0.00,,8.42,,"-107,620.97"
,IN,AR,30308337,1005,100,,Invoice,,,,,,08/02/2018,08/02/2018,0.00,,16.02,,"-107,636.99"
,IN,AR,30308342,1005,100,,Invoice,,,,,,08/02/2018,08/02/2018,0.00,,2.84,,"-107,639.83"
,IN,AR,30308416,1005,100,,Invoice,,,,,,08/02/2018,08/02/2018,0.00,,10.93,,"-107,650.76"
,IN,AR,30308445,1005,100,,Invoice,,,,,,08/02/2018,08/02/2018,0.00,,6.37,,"-107,657.13"
,IN,AR,30308446,1005,100,,Invoice,,,,,,08/02/2018,08/02/2018,0.00,,109.93,,"-107,767.06"
,IN,AR,30308447,1005,100,,Invoice,,,,,,08/02/2018,08/02/2018,0.00,,7.97,,"-107,775.03"
,IN,AR,30308448,1005,100,,Invoice,,,,,,08/02/2018,08/02/2018,0.00,,14.34,,"-107,789.37"
,IN,AR,30308449,1005,100,,Invoice,,,,,,08/02/2018,08/02/2018,0.00,,9.56,,"-107,798.93"
,IN,AR,30308497,1005,100,,Invoice,,,,,,08/02/2018,08/02/2018,0.00,,16.27,,"-107,815.20"
,IN,AR,30308558,1005,100,,Invoice,,,,,,08/02/2018,08/02/2018,0.00,,29.15,,"-107,844.35"
,IN,AR,30308583,1005,100,,Invoice,,,,,,08/02/2018,08/02/2018,0.00,,10.93,,"-107,855.28"
,IN,AR,30308651,1005,100,,Invoice,,,,,,08/02/2018,08/02/2018,0.00,,15.79,,"-107,871.07"
,IN,AR,30308652,1005,100,,Invoice,,,,,,08/02/2018,08/02/2018,0.00,,3.51,,"-107,874.58"
,IN,AR,30308653,1005,100,,Invoice,,,,,,08/02/2018,08/02/2018,0.00,,7.02,,"-107,881.60"
,IN,AR,30308654,1005,100,,Invoice,,,,,,08/02/2018,08/02/2018,0.00,,8.77,,"-107,890.37"
,IN,AR,30308675,1005,100,,Invoice,,,,,,08/02/2018,08/02/2018,0.00,,6.13,,"-107,896.50"
,IN,AR,30308683,1005,100,,Invoice,,,,,,08/02/2018,08/02/2018,0.00,,27.46,,"-107,923.96"
,IN,AR,30308732,1005,100,,Invoice,,,,,,08/02/2018,08/02/2018,0.00,,29.15,,"-107,953.11"
,IN,AR,30308736,1005,100,,Invoice,,,,,,08/02/2018,08/02/2018,0.00,,54.66,,"-108,007.77"
,IN,AR,30308737,1005,100,,Invoice,,,,,,08/02/2018,08/02/2018,0.00,,18.22,,"-108,025.99"
,IN,AR,30308739,1005,100,,Invoice,,,,,,08/02/2018,08/02/2018,0.00,,461.44,,"-108,487.43"
,CN,AR,31017298,1005,100,,Credit Note,,,,,,09/02/2018,09/02/2018,16.53,,0.00,,"-108,470.90"
,CS,AR,32000935,1005,100,,Cash sale,,,,,,09/02/2018,09/02/2018,0.00,,2.81,,"-108,473.71"
,CS,AR,32000954,1005,100,,Cash sale,,,,,,09/02/2018,09/02/2018,0.00,,11.86,,"-108,485.57"
,CS,AR,32000959,1005,100,,Cash sale,,,,,,09/02/2018,09/02/2018,0.00,,22.71,,"-108,508.28"
,CS,AR,32000961,1005,100,,Cash sale,,,,,,09/02/2018,09/02/2018,0.00,,10.93,,"-108,519.21"
,CS,AR,32001016,1005,100,,Cash sale,,,,,,09/02/2018,09/02/2018,0.00,,14.58,,"-108,533.79"
,CS,AR,32001024,1005,100,,Cash sale,,,,,,09/02/2018,09/02/2018,0.00,,18.98,,"-108,552.77"
,CS,AR,32001036,1005,100,,Cash sale,,,,,,09/02/2018,09/02/2018,0.00,,12.46,,"-108,565.23"
,CS,AR,32001045,1005,100,,Cash sale,,,,,,09/02/2018,09/02/2018,0.00,,10.93,,"-108,576.16"
,CS,AR,32001106,1005,100,,Cash sale,,,,,,09/02/2018,09/02/2018,0.00,,3.64,,"-108,579.80"
,CS,AR,32001135,1005,100,,Cash sale,,,,,,09/02/2018,09/02/2018,0.00,,18.22,,"-108,598.02"
,CS,AR,32001146,1005,100,,Cash sale,,,,,,09/02/2018,09/02/2018,0.00,,7.63,,"-108,605.65"
,CS,AR,32001152,1005,100,,Cash sale,,,,,,09/02/2018,09/02/2018,0.00,,25.17,,"-108,630.82"
,CS,AR,32001173,1005,100,,Cash sale,,,,,,09/02/2018,09/02/2018,0.00,,46.71,,"-108,677.53"
,CS,AR,32001181,1005,100,,Cash sale,,,,,,09/02/2018,09/02/2018,0.00,,10.93,,"-108,688.46"
,CS,AR,32001185,1005,100,,Cash sale,,,,,,09/02/2018,09/02/2018,0.00,,10.99,,"-108,699.45"
,CS,AR,32001194,1005,100,,Cash sale,,,,,,09/02/2018,09/02/2018,0.00,,7.29,,"-108,706.74"
,CS,AR,32001196,1005,100,,Cash sale,,,,,,09/02/2018,09/02/2018,0.00,,10.93,,"-108,717.67"
,CS,AR,32001199,1005,100,,Cash sale,,,,,,09/02/2018,09/02/2018,0.00,,9.03,,"-108,726.70"
,CS,AR,32001239,1005,100,,Cash sale,,,,,,09/02/2018,09/02/2018,0.00,,17.54,,"-108,744.24"
,CS,AR,32001258,1005,100,,Cash sale,,,,,,09/02/2018,09/02/2018,0.00,,30.08,,"-108,774.32"
,CS,AR,32001300,1005,100,,Cash sale,,,,,,09/02/2018,09/02/2018,0.00,,7.29,,"-108,781.61"
,CS,AR,32001343,1005,100,,Cash sale,,,,,,09/02/2018,09/02/2018,0.00,,18.22,,"-108,799.83"
,CS,AR,32001363,1005,100,,Cash sale,,,,,,09/02/2018,09/02/2018,0.00,,20.48,,"-108,820.31"
,CS,AR,32001365,1005,100,,Cash sale,,,,,,09/02/2018,09/02/2018,0.00,,7.29,,"-108,827.60"
,CS,AR,32001391,1005,100,,Cash sale,,,,,,09/02/2018,09/02/2018,0.00,,7.29,,"-108,834.89"
,CS,AR,32001394,1005,100,,Cash sale,,,,,,09/02/2018,09/02/2018,0.00,,3.64,,"-108,838.53"
,CS,AR,32001399,1005,100,,Cash sale,,,,,,09/02/2018,09/02/2018,0.00,,7.75,,"-108,846.28"
,CS,AR,32001400,1005,100,,Cash sale,,,,,,09/02/2018,09/02/2018,0.00,,12.17,,"-108,858.45"
,CS,AR,32001450,1005,100,,Cash sale,,,,,,09/02/2018,09/02/2018,0.00,,20.34,,"-108,878.79"
,CS,AR,32001461,1005,100,,Cash sale,,,,,,09/02/2018,09/02/2018,0.00,,10.93,,"-108,889.72"
,CS,AR,32001497,1005,100,,Cash sale,,,,,,09/02/2018,09/02/2018,0.00,,28.00,,"-108,917.72"
,CS,AR,32001517,1005,100,,Cash sale,,,,,,09/02/2018,09/02/2018,0.00,,2.54,,"-108,920.26"
,CS,AR,32001528,1005,100,,Cash sale,,,,,,09/02/2018,09/02/2018,0.00,,9.15,,"-108,929.41"
,CS,AR,32001538,1005,100,,Cash sale,,,,,,09/02/2018,09/02/2018,0.00,,6.07,,"-108,935.48"
,CS,AR,32001556,1005,100,,Cash sale,,,,,,09/02/2018,09/02/2018,0.00,,7.63,,"-108,943.11"
,CS,AR,32001593,1005,100,,Cash sale,,,,,,09/02/2018,09/02/2018,0.00,,10.93,,"-108,954.04"
,CS,AR,32001600,1005,100,,Cash sale,,,,,,09/02/2018,09/02/2018,0.00,,7.63,,"-108,961.67"
,CS,AR,32001606,1005,100,,Cash sale,,,,,,09/02/2018,09/02/2018,0.00,,9.15,,"-108,970.82"
,CS,AR,32001622,1005,100,,Cash sale,,,,,,09/02/2018,09/02/2018,0.00,,14.58,,"-108,985.40"
,CS,AR,32001629,1005,100,,Cash sale,,,,,,09/02/2018,09/02/2018,0.00,,18.22,,"-109,003.62"
,CS,AR,32001632,1005,100,,Cash sale,,,,,,09/02/2018,09/02/2018,0.00,,6.08,,"-109,009.70"
,CS,AR,32001658,1005,100,,Cash sale,,,,,,09/02/2018,09/02/2018,0.00,,3.64,,"-109,013.34"
,CS,AR,32001663,1005,100,,Cash sale,,,,,,09/02/2018,09/02/2018,0.00,,8.78,,"-109,022.12"
,CS,AR,32001682,1005,100,,Cash sale,,,,,,09/02/2018,09/02/2018,0.00,,7.29,,"-109,029.41"
,IN,AR,30306672,1005,100,,Invoice,,,,,,09/02/2018,09/02/2018,0.00,,182.20,,"-109,211.61"
,IN,AR,30306680,1005,100,,Invoice,,,,,,09/02/2018,09/02/2018,0.00,,8.90,,"-109,220.51"
,IN,AR,30306681,1005,100,,Invoice,,,,,,09/02/2018,09/02/2018,0.00,,23.73,,"-109,244.24"
,IN,AR,30306693,1005,100,,Invoice,,,,,,09/02/2018,09/02/2018,0.00,,18.22,,"-109,262.46"
,IN,AR,30306710,1005,100,,Invoice,,,,,,09/02/2018,09/02/2018,0.00,,21.86,,"-109,284.32"
,IN,AR,30306733,1005,100,,Invoice,,,,,,09/02/2018,09/02/2018,0.00,,18.22,,"-109,302.54"
,IN,AR,30306749,1005,100,,Invoice,,,,,,09/02/2018,09/02/2018,0.00,,36.44,,"-109,338.98"
,IN,AR,30306763,1005,100,,Invoice,,,,,,09/02/2018,09/02/2018,0.00,,26.57,,"-109,365.55"
,IN,AR,30306802,1005,100,,Invoice,,,,,,09/02/2018,09/02/2018,0.00,,10.93,,"-109,376.48"
,IN,AR,30306812,1005,100,,Invoice,,,,,,09/02/2018,09/02/2018,0.00,,16.08,,"-109,392.56"
,IN,AR,30306818,1005,100,,Invoice,,,,,,09/02/2018,09/02/2018,0.00,,65.98,,"-109,458.54"
,IN,AR,30306825,1005,100,,Invoice,,,,,,09/02/2018,09/02/2018,0.00,,19.90,,"-109,478.44"
,IN,AR,30306833,1005,100,,Invoice,,,,,,09/02/2018,09/02/2018,0.00,,28.47,,"-109,506.91"
,IN,AR,30306857,1005,100,,Invoice,,,,,,09/02/2018,09/02/2018,0.00,,364.41,,"-109,871.32"
,IN,AR,30306864,1005,100,,Invoice,,,,,,09/02/2018,09/02/2018,0.00,,28.00,,"-109,899.32"
,IN,AR,30306892,1005,100,,Invoice,,,,,,09/02/2018,09/02/2018,0.00,,10.93,,"-109,910.25"
,IN,AR,30306907,1005,100,,Invoice,,,,,,09/02/2018,09/02/2018,0.00,,24.00,,"-109,934.25"
,IN,AR,30306953,1005,100,,Invoice,,,,,,09/02/2018,09/02/2018,0.00,,7.78,,"-109,942.03"
,IN,AR,30306970,1005,100,,Invoice,,,,,,09/02/2018,09/02/2018,0.00,,4.75,,"-109,946.78"
,IN,AR,30306977,1005,100,,Invoice,,,,,,09/02/2018,09/02/2018,0.00,,12.00,,"-109,958.78"
,IN,AR,30306978,1005,100,,Invoice,,,,,,09/02/2018,09/02/2018,0.00,,12.00,,"-109,970.78"
,IN,AR,30306988,1005,100,,Invoice,,,,,,09/02/2018,09/02/2018,0.00,,182.20,,"-110,152.98"
,IN,AR,30307003,1005,100,,Invoice,,,,,,09/02/2018,09/02/2018,0.00,,54.66,,"-110,207.64"
,IN,AR,30307026,1005,100,,Invoice,,,,,,09/02/2018,09/02/2018,0.00,,364.41,,"-110,572.05"
,IN,AR,30307030,1005,100,,Invoice,,,,,,09/02/2018,09/02/2018,0.00,,7.76,,"-110,579.81"
,IN,AR,30307044,1005,100,,Invoice,,,,,,09/02/2018,09/02/2018,0.00,,10.93,,"-110,590.74"
,IN,AR,30307062,1005,100,,Invoice,,,,,,09/02/2018,09/02/2018,0.00,,8.39,,"-110,599.13"
,IN,AR,30307092,1005,100,,Invoice,,,,,,09/02/2018,09/02/2018,0.00,,3.19,,"-110,602.32"
,IN,AR,30307112,1005,100,,Invoice,,,,,,09/02/2018,09/02/2018,0.00,,10.34,,"-110,612.66"
,IN,AR,30307175,1005,100,,Invoice,,,,,,09/02/2018,09/02/2018,0.00,,28.47,,"-110,641.13"
,IN,AR,30307176,1005,100,,Invoice,,,,,,09/02/2018,09/02/2018,0.00,,81.36,,"-110,722.49"
,IN,AR,30307206,1005,100,,Invoice,,,,,,09/02/2018,09/02/2018,0.00,,4.78,,"-110,727.27"
,IN,AR,30307209,1005,100,,Invoice,,,,,,09/02/2018,09/02/2018,0.00,,182.20,,"-110,909.47"
,IN,AR,30307210,1005,100,,Invoice,,,,,,09/02/2018,09/02/2018,0.00,,5.17,,"-110,914.64"
,IN,AR,30307216,1005,100,,Invoice,,,,,,09/02/2018,09/02/2018,0.00,,189.94,,"-111,104.58"
,IN,AR,30307258,1005,100,,Invoice,,,,,,09/02/2018,09/02/2018,0.00,,"1,093.22",,"-112,197.80"
,IN,AR,30307271,1005,100,,Invoice,,,,,,09/02/2018,09/02/2018,0.00,,51.27,,"-112,249.07"
,IN,AR,30307362,1005,100,,Invoice,,,,,,09/02/2018,09/02/2018,0.00,,12.92,,"-112,261.99"
,IN,AR,30307397,1005,100,,Invoice,,,,,,09/02/2018,09/02/2018,0.00,,15.25,,"-112,277.24"
,IN,AR,30307426,1005,100,,Invoice,,,,,,09/02/2018,09/02/2018,0.00,,5.08,,"-112,282.32"
,IN,AR,30307466,1005,100,,Invoice,,,,,,09/02/2018,09/02/2018,0.00,,10.53,,"-112,292.85"
,IN,AR,30307527,1005,100,,Invoice,,,,,,09/02/2018,09/02/2018,0.00,,7.17,,"-112,300.02"
,IN,AR,30307534,1005,100,,Invoice,,,,,,09/02/2018,09/02/2018,0.00,,7.29,,"-112,307.31"
,IN,AR,30307542,1005,100,,Invoice,,,,,,09/02/2018,09/02/2018,0.00,,22.88,,"-112,330.19"
,IN,AR,30307646,1005,100,,Invoice,,,,,,09/02/2018,09/02/2018,0.00,,28.05,,"-112,358.24"
,IN,AR,30307684,1005,100,,Invoice,,,,,,09/02/2018,09/02/2018,0.00,,10.93,,"-112,369.17"
,IN,AR,30307702,1005,100,,Invoice,,,,,,09/02/2018,09/02/2018,0.00,,364.41,,"-112,733.58"
,IN,AR,30307756,1005,100,,Invoice,,,,,,09/02/2018,09/02/2018,0.00,,59.62,,"-112,793.20"
,IN,AR,30307768,1005,100,,Invoice,,,,,,09/02/2018,09/02/2018,0.00,,10.93,,"-112,804.13"
,IN,AR,30307914,1005,100,,Invoice,,,,,,09/02/2018,09/02/2018,0.00,,2.42,,"-112,806.55"
,IN,AR,30307941,1005,100,,Invoice,,,,,,09/02/2018,09/02/2018,0.00,,18.22,,"-112,824.77"
,IN,AR,30308048,1005,100,,Invoice,,,,,,09/02/2018,09/02/2018,0.00,,36.91,,"-112,861.68"
,IN,AR,30308069,1005,100,,Invoice,,,,,,09/02/2018,09/02/2018,0.00,,16.03,,"-112,877.71"
,IN,AR,30308122,1005,100,,Invoice,,,,,,09/02/2018,09/02/2018,0.00,,65.74,,"-112,943.45"
,IN,AR,30308184,1005,100,,Invoice,,,,,,09/02/2018,09/02/2018,0.00,,10.19,,"-112,953.64"
,IN,AR,30308205,1005,100,,Invoice,,,,,,09/02/2018,09/02/2018,0.00,,23.91,,"-112,977.55"
,IN,AR,30308221,1005,100,,Invoice,,,,,,09/02/2018,09/02/2018,0.00,,22.88,,"-113,000.43"
,IN,AR,30308287,1005,100,,Invoice,,,,,,09/02/2018,09/02/2018,0.00,,19.16,,"-113,019.59"
,IN,AR,30308333,1005,100,,Invoice,,,,,,09/02/2018,09/02/2018,0.00,,11.48,,"-113,031.07"
,IN,AR,30308344,1005,100,,Invoice,,,,,,09/02/2018,09/02/2018,0.00,,5.59,,"-113,036.66"
,IN,AR,30308368,1005,100,,Invoice,,,,,,09/02/2018,09/02/2018,0.00,,7.29,,"-113,043.95"
,IN,AR,30308412,1005,100,,Invoice,,,,,,09/02/2018,09/02/2018,0.00,,18.22,,"-113,062.17"
,IN,AR,30308423,1005,100,,Invoice,,,,,,09/02/2018,09/02/2018,0.00,,5.68,,"-113,067.85"
,IN,AR,30308425,1005,100,,Invoice,,,,,,09/02/2018,09/02/2018,0.00,,19.32,,"-113,087.17"
,IN,AR,30308470,1005,100,,Invoice,,,,,,09/02/2018,09/02/2018,0.00,,182.20,,"-113,269.37"
,IN,AR,30308482,1005,100,,Invoice,,,,,,09/02/2018,09/02/2018,0.00,,66.36,,"-113,335.73"
,IN,AR,30308505,1005,100,,Invoice,,,,,,09/02/2018,09/02/2018,0.00,,14.00,,"-113,349.73"
,IN,AR,30308549,1005,100,,Invoice,,,,,,09/02/2018,09/02/2018,0.00,,54.66,,"-113,404.39"
,IN,AR,30308575,1005,100,,Invoice,,,,,,09/02/2018,09/02/2018,0.00,,25.42,,"-113,429.81"
,IN,AR,30308578,1005,100,,Invoice,,,,,,09/02/2018,09/02/2018,0.00,,10.95,,"-113,440.76"
,IN,AR,30308586,1005,100,,Invoice,,,,,,09/02/2018,09/02/2018,0.00,,29.15,,"-113,469.91"
,IN,AR,30308589,1005,100,,Invoice,,,,,,09/02/2018,09/02/2018,0.00,,14.58,,"-113,484.49"
,IN,AR,30308592,1005,100,,Invoice,,,,,,09/02/2018,09/02/2018,0.00,,33.90,,"-113,518.39"
,IN,AR,30308658,1005,100,,Invoice,,,,,,09/02/2018,09/02/2018,0.00,,14.83,,"-113,533.22"
,IN,AR,30308668,1005,100,,Invoice,,,,,,09/02/2018,09/02/2018,0.00,,6.13,,"-113,539.35"
,IN,AR,30308735,1005,100,,Invoice,,,,,,09/02/2018,09/02/2018,0.00,,10.93,,"-113,550.28"
,CS,AR,32001502,1005,100,,Cash sale,,,,,,11/02/2018,11/02/2018,0.00,,29.15,,"-113,579.43"
,CN,AR,31017215,1005,100,,Credit Note,,,,,,12/02/2018,12/02/2018,136.66,,0.00,,"-113,442.77"
,CN,AR,31017232,1005,100,,Credit Note,,,,,,12/02/2018,12/02/2018,298.07,,0.00,,"-113,144.70"
,CN,AR,31017243,1005,100,,Credit Note,,,,,,12/02/2018,12/02/2018,"1,053.19",,0.00,,"-112,091.51"
,CN,AR,31017248,1005,100,,Credit Note,,,,,,12/02/2018,12/02/2018,10.93,,0.00,,"-112,080.58"
,CN,AR,31017290,1005,100,,Credit Note,,,,,,12/02/2018,12/02/2018,257.52,,0.00,,"-111,823.06"
,CN,AR,31017295,1005,100,,Credit Note,,,,,,12/02/2018,12/02/2018,10.93,,0.00,,"-111,812.13"
,CN,AR,31017360,1005,100,,Credit Note,,,,,,12/02/2018,12/02/2018,18.22,,0.00,,"-111,793.91"
,CN,AR,31017378,1005,100,,Credit Note,,,,,,12/02/2018,12/02/2018,14.58,,0.00,,"-111,779.33"
,CS,AR,32000955,1005,100,,Cash sale,,,,,,12/02/2018,12/02/2018,0.00,,7.12,,"-111,786.45"
,CS,AR,32001037,1005,100,,Cash sale,,,,,,12/02/2018,12/02/2018,0.00,,12.46,,"-111,798.91"
,CS,AR,32001059,1005,100,,Cash sale,,,,,,12/02/2018,12/02/2018,0.00,,11.69,,"-111,810.60"
,CS,AR,32001085,1005,100,,Cash sale,,,,,,12/02/2018,12/02/2018,0.00,,14.58,,"-111,825.18"
,CS,AR,32001110,1005,100,,Cash sale,,,,,,12/02/2018,12/02/2018,0.00,,10.34,,"-111,835.52"
,CS,AR,32001147,1005,100,,Cash sale,,,,,,12/02/2018,12/02/2018,0.00,,12.71,,"-111,848.23"
,CS,AR,32001157,1005,100,,Cash sale,,,,,,12/02/2018,12/02/2018,0.00,,3.64,,"-111,851.87"
,CS,AR,32001158,1005,100,,Cash sale,,,,,,12/02/2018,12/02/2018,0.00,,14.58,,"-111,866.45"
,CS,AR,32001169,1005,100,,Cash sale,,,,,,12/02/2018,12/02/2018,0.00,,20.68,,"-111,887.13"
,CS,AR,32001186,1005,100,,Cash sale,,,,,,12/02/2018,12/02/2018,0.00,,13.74,,"-111,900.87"
,CS,AR,32001197,1005,100,,Cash sale,,,,,,12/02/2018,12/02/2018,0.00,,3.64,,"-111,904.51"
,CS,AR,32001209,1005,100,,Cash sale,,,,,,12/02/2018,12/02/2018,0.00,,3.64,,"-111,908.15"
,CS,AR,32001216,1005,100,,Cash sale,,,,,,12/02/2018,12/02/2018,0.00,,6.02,,"-111,914.17"
,CS,AR,32001240,1005,100,,Cash sale,,,,,,12/02/2018,12/02/2018,0.00,,11.69,,"-111,925.86"
,CS,AR,32001250,1005,100,,Cash sale,,,,,,12/02/2018,12/02/2018,0.00,,6.02,,"-111,931.88"
,CS,AR,32001259,1005,100,,Cash sale,,,,,,12/02/2018,12/02/2018,0.00,,24.07,,"-111,955.95"
,CS,AR,32001267,1005,100,,Cash sale,,,,,,12/02/2018,12/02/2018,0.00,,6.48,,"-111,962.43"
,CS,AR,32001275,1005,100,,Cash sale,,,,,,12/02/2018,12/02/2018,0.00,,7.29,,"-111,969.72"
,CS,AR,32001310,1005,100,,Cash sale,,,,,,12/02/2018,12/02/2018,0.00,,5.25,,"-111,974.97"
,CS,AR,32001333,1005,100,,Cash sale,,,,,,12/02/2018,12/02/2018,0.00,,29.15,,"-112,004.12"
,CS,AR,32001356,1005,100,,Cash sale,,,,,,12/02/2018,12/02/2018,0.00,,6.02,,"-112,010.14"
,CS,AR,32001373,1005,100,,Cash sale,,,,,,12/02/2018,12/02/2018,0.00,,3.64,,"-112,013.78"
,CS,AR,32001419,1005,100,,Cash sale,,,,,,12/02/2018,12/02/2018,0.00,,18.22,,"-112,032.00"
,CS,AR,32001437,1005,100,,Cash sale,,,,,,12/02/2018,12/02/2018,0.00,,3.64,,"-112,035.64"
,CS,AR,32001455,1005,100,,Cash sale,,,,,,12/02/2018,12/02/2018,0.00,,18.22,,"-112,053.86"
,CS,AR,32001458,1005,100,,Cash sale,,,,,,12/02/2018,12/02/2018,0.00,,25.51,,"-112,079.37"
,CS,AR,32001512,1005,100,,Cash sale,,,,,,12/02/2018,12/02/2018,0.00,,8.20,,"-112,087.57"
,CS,AR,32001529,1005,100,,Cash sale,,,,,,12/02/2018,12/02/2018,0.00,,11.44,,"-112,099.01"
,CS,AR,32001578,1005,100,,Cash sale,,,,,,12/02/2018,12/02/2018,0.00,,7.29,,"-112,106.30"
,CS,AR,32001594,1005,100,,Cash sale,,,,,,12/02/2018,12/02/2018,0.00,,10.93,,"-112,117.23"
,CS,AR,32001626,1005,100,,Cash sale,,,,,,12/02/2018,12/02/2018,0.00,,3.64,,"-112,120.87"
,CS,AR,32001638,1005,100,,Cash sale,,,,,,12/02/2018,12/02/2018,0.00,,14.58,,"-112,135.45"
,CS,AR,32001668,1005,100,,Cash sale,,,,,,12/02/2018,12/02/2018,0.00,,10.93,,"-112,146.38"
,CS,AR,32001673,1005,100,,Cash sale,,,,,,12/02/2018,12/02/2018,0.00,,6.56,,"-112,152.94"
,CS,AR,32001689,1005,100,,Cash sale,,,,,,12/02/2018,12/02/2018,0.00,,7.97,,"-112,160.91"
,IN,AR,30306701,1005,100,,Invoice,,,,,,12/02/2018,12/02/2018,0.00,,7.29,,"-112,168.20"
,IN,AR,30306706,1005,100,,Invoice,,,,,,12/02/2018,12/02/2018,0.00,,182.20,,"-112,350.40"
,IN,AR,30306739,1005,100,,Invoice,,,,,,12/02/2018,12/02/2018,0.00,,182.20,,"-112,532.60"
,IN,AR,30306767,1005,100,,Invoice,,,,,,12/02/2018,12/02/2018,0.00,,54.66,,"-112,587.26"
,IN,AR,30306790,1005,100,,Invoice,,,,,,12/02/2018,12/02/2018,0.00,,52.84,,"-112,640.10"
,IN,AR,30306801,1005,100,,Invoice,,,,,,12/02/2018,12/02/2018,0.00,,5.59,,"-112,645.69"
,IN,AR,30306803,1005,100,,Invoice,,,,,,12/02/2018,12/02/2018,0.00,,182.20,,"-112,827.89"
,IN,AR,30306822,1005,100,,Invoice,,,,,,12/02/2018,12/02/2018,0.00,,10.93,,"-112,838.82"
,IN,AR,30306834,1005,100,,Invoice,,,,,,12/02/2018,12/02/2018,0.00,,147.12,,"-112,985.94"
,IN,AR,30306849,1005,100,,Invoice,,,,,,12/02/2018,12/02/2018,0.00,,24.79,,"-113,010.73"
,IN,AR,30306865,1005,100,,Invoice,,,,,,12/02/2018,12/02/2018,0.00,,36.00,,"-113,046.73"
,IN,AR,30306882,1005,100,,Invoice,,,,,,12/02/2018,12/02/2018,0.00,,"1,093.22",,"-114,139.95"
,IN,AR,30306902,1005,100,,Invoice,,,,,,12/02/2018,12/02/2018,0.00,,54.66,,"-114,194.61"
,IN,AR,30306908,1005,100,,Invoice,,,,,,12/02/2018,12/02/2018,0.00,,24.00,,"-114,218.61"
,IN,AR,30306917,1005,100,,Invoice,,,,,,12/02/2018,12/02/2018,0.00,,182.20,,"-114,400.81"
,IN,AR,30306929,1005,100,,Invoice,,,,,,12/02/2018,12/02/2018,0.00,,5.51,,"-114,406.32"
,IN,AR,30306934,1005,100,,Invoice,,,,,,12/02/2018,12/02/2018,0.00,,15.25,,"-114,421.57"
,IN,AR,30306941,1005,100,,Invoice,,,,,,12/02/2018,12/02/2018,0.00,,7.29,,"-114,428.86"
,IN,AR,30306954,1005,100,,Invoice,,,,,,12/02/2018,12/02/2018,0.00,,7.78,,"-114,436.64"
,IN,AR,30306962,1005,100,,Invoice,,,,,,12/02/2018,12/02/2018,0.00,,546.61,,"-114,983.25"
,IN,AR,30306979,1005,100,,Invoice,,,,,,12/02/2018,12/02/2018,0.00,,8.00,,"-114,991.25"
,IN,AR,30306990,1005,100,,Invoice,,,,,,12/02/2018,12/02/2018,0.00,,10.93,,"-115,002.18"
,IN,AR,30306991,1005,100,,Invoice,,,,,,12/02/2018,12/02/2018,0.00,,10.93,,"-115,013.11"
,IN,AR,30306994,1005,100,,Invoice,,,,,,12/02/2018,12/02/2018,0.00,,54.66,,"-115,067.77"
,IN,AR,30307009,1005,100,,Invoice,,,,,,12/02/2018,12/02/2018,0.00,,54.66,,"-115,122.43"
,IN,AR,30307037,1005,100,,Invoice,,,,,,12/02/2018,12/02/2018,0.00,,7.29,,"-115,129.72"
,IN,AR,30307066,1005,100,,Invoice,,,,,,12/02/2018,12/02/2018,0.00,,9.66,,"-115,139.38"
,IN,AR,30307079,1005,100,,Invoice,,,,,,12/02/2018,12/02/2018,0.00,,25.55,,"-115,164.93"
,IN,AR,30307093,1005,100,,Invoice,,,,,,12/02/2018,12/02/2018,0.00,,4.78,,"-115,169.71"
,IN,AR,30307115,1005,100,,Invoice,,,,,,12/02/2018,12/02/2018,0.00,,7.75,,"-115,177.46"
,IN,AR,30307131,1005,100,,Invoice,,,,,,12/02/2018,12/02/2018,0.00,,182.20,,"-115,359.66"
,IN,AR,30307132,1005,100,,Invoice,,,,,,12/02/2018,12/02/2018,0.00,,29.15,,"-115,388.81"
,IN,AR,30307140,1005,100,,Invoice,,,,,,12/02/2018,12/02/2018,0.00,,13.78,,"-115,402.59"
,IN,AR,30307143,1005,100,,Invoice,,,,,,12/02/2018,12/02/2018,0.00,,54.66,,"-115,457.25"
,IN,AR,30307192,1005,100,,Invoice,,,,,,12/02/2018,12/02/2018,0.00,,182.20,,"-115,639.45"
,IN,AR,30307200,1005,100,,Invoice,,,,,,12/02/2018,12/02/2018,0.00,,23.26,,"-115,662.71"
,IN,AR,30307225,1005,100,,Invoice,,,,,,12/02/2018,12/02/2018,0.00,,10.35,,"-115,673.06"
,IN,AR,30307272,1005,100,,Invoice,,,,,,12/02/2018,12/02/2018,0.00,,90.24,,"-115,763.30"
,IN,AR,30307284,1005,100,,Invoice,,,,,,12/02/2018,12/02/2018,0.00,,35.59,,"-115,798.89"
,IN,AR,30307309,1005,100,,Invoice,,,,,,12/02/2018,12/02/2018,0.00,,19.12,,"-115,818.01"
,IN,AR,30307310,1005,100,,Invoice,,,,,,12/02/2018,12/02/2018,0.00,,9.56,,"-115,827.57"
,IN,AR,30307334,1005,100,,Invoice,,,,,,12/02/2018,12/02/2018,0.00,,21.06,,"-115,848.63"
,IN,AR,30307345,1005,100,,Invoice,,,,,,12/02/2018,12/02/2018,0.00,,10.93,,"-115,859.56"
,IN,AR,30307349,1005,100,,Invoice,,,,,,12/02/2018,12/02/2018,0.00,,6.36,,"-115,865.92"
,IN,AR,30307364,1005,100,,Invoice,,,,,,12/02/2018,12/02/2018,0.00,,75.00,,"-115,940.92"
,IN,AR,30307427,1005,100,,Invoice,,,,,,12/02/2018,12/02/2018,0.00,,7.63,,"-115,948.55"
,IN,AR,30307483,1005,100,,Invoice,,,,,,12/02/2018,12/02/2018,0.00,,7.29,,"-115,955.84"
,IN,AR,30307543,1005,100,,Invoice,,,,,,12/02/2018,12/02/2018,0.00,,20.34,,"-115,976.18"
,IN,AR,30307551,1005,100,,Invoice,,,,,,12/02/2018,12/02/2018,0.00,,30.00,,"-116,006.18"
,IN,AR,30307555,1005,100,,Invoice,,,,,,12/02/2018,12/02/2018,0.00,,28.47,,"-116,034.65"
,IN,AR,30307566,1005,100,,Invoice,,,,,,12/02/2018,12/02/2018,0.00,,54.66,,"-116,089.31"
,IN,AR,30307567,1005,100,,Invoice,,,,,,12/02/2018,12/02/2018,0.00,,10.93,,"-116,100.24"
,IN,AR,30307616,1005,100,,Invoice,,,,,,12/02/2018,12/02/2018,0.00,,11.02,,"-116,111.26"
,IN,AR,30307624,1005,100,,Invoice,,,,,,12/02/2018,12/02/2018,0.00,,13.77,,"-116,125.03"
,IN,AR,30307647,1005,100,,Invoice,,,,,,12/02/2018,12/02/2018,0.00,,11.22,,"-116,136.25"
,IN,AR,30307654,1005,100,,Invoice,,,,,,12/02/2018,12/02/2018,0.00,,2.54,,"-116,138.79"
,IN,AR,30307678,1005,100,,Invoice,,,,,,12/02/2018,12/02/2018,0.00,,54.66,,"-116,193.45"
,IN,AR,30307682,1005,100,,Invoice,,,,,,12/02/2018,12/02/2018,0.00,,182.20,,"-116,375.65"
,IN,AR,30307708,1005,100,,Invoice,,,,,,12/02/2018,12/02/2018,0.00,,9.03,,"-116,384.68"
,IN,AR,30307718,1005,100,,Invoice,,,,,,12/02/2018,12/02/2018,0.00,,43.93,,"-116,428.61"
,IN,AR,30307729,1005,100,,Invoice,,,,,,12/02/2018,12/02/2018,0.00,,182.20,,"-116,610.81"
,IN,AR,30307734,1005,100,,Invoice,,,,,,12/02/2018,12/02/2018,0.00,,24.00,,"-116,634.81"
,IN,AR,30307783,1005,100,,Invoice,,,,,,12/02/2018,12/02/2018,0.00,,7.75,,"-116,642.56"
,IN,AR,30307866,1005,100,,Invoice,,,,,,12/02/2018,12/02/2018,0.00,,55.75,,"-116,698.31"
,IN,AR,30307883,1005,100,,Invoice,,,,,,12/02/2018,12/02/2018,0.00,,29.15,,"-116,727.46"
,IN,AR,30307975,1005,100,,Invoice,,,,,,12/02/2018,12/02/2018,0.00,,7.29,,"-116,734.75"
,IN,AR,30308005,1005,100,,Invoice,,,,,,12/02/2018,12/02/2018,0.00,,54.66,,"-116,789.41"
,IN,AR,30308070,1005,100,,Invoice,,,,,,12/02/2018,12/02/2018,0.00,,6.02,,"-116,795.43"
,IN,AR,30308084,1005,100,,Invoice,,,,,,12/02/2018,12/02/2018,0.00,,8.21,,"-116,803.64"
,IN,AR,30308087,1005,100,,Invoice,,,,,,12/02/2018,12/02/2018,0.00,,182.20,,"-116,985.84"
,IN,AR,30308123,1005,100,,Invoice,,,,,,12/02/2018,12/02/2018,0.00,,6.42,,"-116,992.26"
,IN,AR,30308155,1005,100,,Invoice,,,,,,12/02/2018,12/02/2018,0.00,,9.84,,"-117,002.10"
,IN,AR,30308160,1005,100,,Invoice,,,,,,12/02/2018,12/02/2018,0.00,,34.15,,"-117,036.25"
,IN,AR,30308164,1005,100,,Invoice,,,,,,12/02/2018,12/02/2018,0.00,,54.66,,"-117,090.91"
,IN,AR,30308168,1005,100,,Invoice,,,,,,12/02/2018,12/02/2018,0.00,,14.58,,"-117,105.49"
,IN,AR,30308169,1005,100,,Invoice,,,,,,12/02/2018,12/02/2018,0.00,,29.15,,"-117,134.64"
,IN,AR,30308187,1005,100,,Invoice,,,,,,12/02/2018,12/02/2018,0.00,,6.56,,"-117,141.20"
,IN,AR,30308192,1005,100,,Invoice,,,,,,12/02/2018,12/02/2018,0.00,,182.20,,"-117,323.40"
,IN,AR,30308234,1005,100,,Invoice,,,,,,12/02/2018,12/02/2018,0.00,,12.00,,"-117,335.40"
,IN,AR,30308248,1005,100,,Invoice,,,,,,12/02/2018,12/02/2018,0.00,,14.58,,"-117,349.98"
,IN,AR,30308264,1005,100,,Invoice,,,,,,12/02/2018,12/02/2018,0.00,,14.58,,"-117,364.56"
,IN,AR,30308299,1005,100,,Invoice,,,,,,12/02/2018,12/02/2018,0.00,,14.58,,"-117,379.14"
,IN,AR,30308309,1005,100,,Invoice,,,,,,12/02/2018,12/02/2018,0.00,,36.24,,"-117,415.38"
,IN,AR,30308325,1005,100,,Invoice,,,,,,12/02/2018,12/02/2018,0.00,,30.86,,"-117,446.24"
,IN,AR,30308336,1005,100,,Invoice,,,,,,12/02/2018,12/02/2018,0.00,,218.64,,"-117,664.88"
,IN,AR,30308369,1005,100,,Invoice,,,,,,12/02/2018,12/02/2018,0.00,,54.66,,"-117,719.54"
,IN,AR,30308370,1005,100,,Invoice,,,,,,12/02/2018,12/02/2018,0.00,,54.66,,"-117,774.20"
,IN,AR,30308450,1005,100,,Invoice,,,,,,12/02/2018,12/02/2018,0.00,,12.75,,"-117,786.95"
,IN,AR,30308451,1005,100,,Invoice,,,,,,12/02/2018,12/02/2018,0.00,,7.97,,"-117,794.92"
,IN,AR,30308480,1005,100,,Invoice,,,,,,12/02/2018,12/02/2018,0.00,,29.15,,"-117,824.07"
,IN,AR,30308517,1005,100,,Invoice,,,,,,12/02/2018,12/02/2018,0.00,,7.53,,"-117,831.60"
,IN,AR,30308548,1005,100,,Invoice,,,,,,12/02/2018,12/02/2018,0.00,,29.15,,"-117,860.75"
,IN,AR,30308570,1005,100,,Invoice,,,,,,12/02/2018,12/02/2018,0.00,,29.15,,"-117,889.90"
,IN,AR,30308574,1005,100,,Invoice,,,,,,12/02/2018,12/02/2018,0.00,,54.66,,"-117,944.56"
,IN,AR,30308609,1005,100,,Invoice,,,,,,12/02/2018,12/02/2018,0.00,,54.66,,"-117,999.22"
,IN,AR,30308659,1005,100,,Invoice,,,,,,12/02/2018,12/02/2018,0.00,,7.29,,"-118,006.51"
,IN,AR,30308669,1005,100,,Invoice,,,,,,12/02/2018,12/02/2018,0.00,,8.17,,"-118,014.68"
,IN,AR,30308699,1005,100,,Invoice,,,,,,12/02/2018,12/02/2018,0.00,,36.44,,"-118,051.12"
,IN,AR,30308709,1005,100,,Invoice,,,,,,12/02/2018,12/02/2018,0.00,,13.73,,"-118,064.85"
,IN,AR,30308744,1005,100,,Invoice,,,,,,12/02/2018,12/02/2018,0.00,,7.17,,"-118,072.02"
,IN,AR,30308745,1005,100,,Invoice,,,,,,12/02/2018,12/02/2018,0.00,,72.88,,"-118,144.90"
,IN,AR,30308748,1005,100,,Invoice,,,,,,12/02/2018,12/02/2018,0.00,,29.15,,"-118,174.05"
,CN,AR,31017318,1005,100,,Credit Note,,,,,,13/02/2018,13/02/2018,5.51,,0.00,,"-118,168.54"
,CN,AR,31017319,1005,100,,Credit Note,,,,,,13/02/2018,13/02/2018,8.26,,0.00,,"-118,160.28"
,CN,AR,31017320,1005,100,,Credit Note,,,,,,13/02/2018,13/02/2018,5.51,,0.00,,"-118,154.77"
,CS,AR,32001013,1005,100,,Cash sale,,,,,,13/02/2018,13/02/2018,0.00,,3.01,,"-118,157.78"
,CS,AR,32001020,1005,100,,Cash sale,,,,,,13/02/2018,13/02/2018,0.00,,10.93,,"-118,168.71"
,CS,AR,32001053,1005,100,,Cash sale,,,,,,13/02/2018,13/02/2018,0.00,,3.64,,"-118,172.35"
,CS,AR,32001062,1005,100,,Cash sale,,,,,,13/02/2018,13/02/2018,0.00,,3.64,,"-118,175.99"
,CS,AR,32001068,1005,100,,Cash sale,,,,,,13/02/2018,13/02/2018,0.00,,14.58,,"-118,190.57"
,CS,AR,32001116,1005,100,,Cash sale,,,,,,13/02/2018,13/02/2018,0.00,,10.17,,"-118,200.74"
,CS,AR,32001132,1005,100,,Cash sale,,,,,,13/02/2018,13/02/2018,0.00,,10.93,,"-118,211.67"
,CS,AR,32001155,1005,100,,Cash sale,,,,,,13/02/2018,13/02/2018,0.00,,5.17,,"-118,216.84"
,CS,AR,32001214,1005,100,,Cash sale,,,,,,13/02/2018,13/02/2018,0.00,,4.29,,"-118,221.13"
,CS,AR,32001245,1005,100,,Cash sale,,,,,,13/02/2018,13/02/2018,0.00,,8.16,,"-118,229.29"
,CS,AR,32001254,1005,100,,Cash sale,,,,,,13/02/2018,13/02/2018,0.00,,11.69,,"-118,240.98"
,CS,AR,32001282,1005,100,,Cash sale,,,,,,13/02/2018,13/02/2018,0.00,,5.17,,"-118,246.15"
,CS,AR,32001287,1005,100,,Cash sale,,,,,,13/02/2018,13/02/2018,0.00,,7.29,,"-118,253.44"
,CS,AR,32001296,1005,100,,Cash sale,,,,,,13/02/2018,13/02/2018,0.00,,5.08,,"-118,258.52"
,CS,AR,32001303,1005,100,,Cash sale,,,,,,13/02/2018,13/02/2018,0.00,,10.34,,"-118,268.86"
,CS,AR,32001318,1005,100,,Cash sale,,,,,,13/02/2018,13/02/2018,0.00,,7.75,,"-118,276.61"
,CS,AR,32001344,1005,100,,Cash sale,,,,,,13/02/2018,13/02/2018,0.00,,14.58,,"-118,291.19"
,CS,AR,32001347,1005,100,,Cash sale,,,,,,13/02/2018,13/02/2018,0.00,,7.29,,"-118,298.48"
,CS,AR,32001360,1005,100,,Cash sale,,,,,,13/02/2018,13/02/2018,0.00,,12.88,,"-118,311.36"
,CS,AR,32001411,1005,100,,Cash sale,,,,,,13/02/2018,13/02/2018,0.00,,12.86,,"-118,324.22"
,CS,AR,32001473,1005,100,,Cash sale,,,,,,13/02/2018,13/02/2018,0.00,,7.75,,"-118,331.97"
,CS,AR,32001491,1005,100,,Cash sale,,,,,,13/02/2018,13/02/2018,0.00,,5.08,,"-118,337.05"
,CS,AR,32001493,1005,100,,Cash sale,,,,,,13/02/2018,13/02/2018,0.00,,30.00,,"-118,367.05"
,CS,AR,32001500,1005,100,,Cash sale,,,,,,13/02/2018,13/02/2018,0.00,,2.62,,"-118,369.67"
,CS,AR,32001520,1005,100,,Cash sale,,,,,,13/02/2018,13/02/2018,0.00,,2.74,,"-118,372.41"
,CS,AR,32001544,1005,100,,Cash sale,,,,,,13/02/2018,13/02/2018,0.00,,8.90,,"-118,381.31"
,CS,AR,32001581,1005,100,,Cash sale,,,,,,13/02/2018,13/02/2018,0.00,,18.22,,"-118,399.53"
,CS,AR,32001609,1005,100,,Cash sale,,,,,,13/02/2018,13/02/2018,0.00,,10.93,,"-118,410.46"
,CS,AR,32001627,1005,100,,Cash sale,,,,,,13/02/2018,13/02/2018,0.00,,3.64,,"-118,414.10"
,CS,AR,32001636,1005,100,,Cash sale,,,,,,13/02/2018,13/02/2018,0.00,,3.64,,"-118,417.74"
,CS,AR,32001653,1005,100,,Cash sale,,,,,,13/02/2018,13/02/2018,0.00,,16.42,,"-118,434.16"
,CS,AR,32001672,1005,100,,Cash sale,,,,,,13/02/2018,13/02/2018,0.00,,7.29,,"-118,441.45"
,CS,AR,32001676,1005,100,,Cash sale,,,,,,13/02/2018,13/02/2018,0.00,,7.29,,"-118,448.74"
,IN,AR,30306667,1005,100,,Invoice,,,,,,13/02/2018,13/02/2018,0.00,,6.02,,"-118,454.76"
,IN,AR,30306682,1005,100,,Invoice,,,,,,13/02/2018,13/02/2018,0.00,,62.29,,"-118,517.05"
,IN,AR,30306725,1005,100,,Invoice,,,,,,13/02/2018,13/02/2018,0.00,,364.41,,"-118,881.46"
,IN,AR,30306780,1005,100,,Invoice,,,,,,13/02/2018,13/02/2018,0.00,,7.00,,"-118,888.46"
,IN,AR,30306835,1005,100,,Invoice,,,,,,13/02/2018,13/02/2018,0.00,,23.73,,"-118,912.19"
,IN,AR,30306846,1005,100,,Invoice,,,,,,13/02/2018,13/02/2018,0.00,,21.86,,"-118,934.05"
,IN,AR,30306878,1005,100,,Invoice,,,,,,13/02/2018,13/02/2018,0.00,,14.58,,"-118,948.63"
,IN,AR,30306900,1005,100,,Invoice,,,,,,13/02/2018,13/02/2018,0.00,,7.29,,"-118,955.92"
,IN,AR,30306924,1005,100,,Invoice,,,,,,13/02/2018,13/02/2018,0.00,,3.64,,"-118,959.56"
,IN,AR,30307022,1005,100,,Invoice,,,,,,13/02/2018,13/02/2018,0.00,,585.72,,"-119,545.28"
,IN,AR,30307048,1005,100,,Invoice,,,,,,13/02/2018,13/02/2018,0.00,,19.24,,"-119,564.52"
,IN,AR,30307050,1005,100,,Invoice,,,,,,13/02/2018,13/02/2018,0.00,,7.29,,"-119,571.81"
,IN,AR,30307103,1005,100,,Invoice,,,,,,13/02/2018,13/02/2018,0.00,,364.41,,"-119,936.22"
,IN,AR,30307104,1005,100,,Invoice,,,,,,13/02/2018,13/02/2018,0.00,,7.29,,"-119,943.51"
,IN,AR,30307122,1005,100,,Invoice,,,,,,13/02/2018,13/02/2018,0.00,,2.32,,"-119,945.83"
,IN,AR,30307123,1005,100,,Invoice,,,,,,13/02/2018,13/02/2018,0.00,,6.97,,"-119,952.80"
,IN,AR,30307148,1005,100,,Invoice,,,,,,13/02/2018,13/02/2018,0.00,,13.14,,"-119,965.94"
,IN,AR,30307163,1005,100,,Invoice,,,,,,13/02/2018,13/02/2018,0.00,,14.83,,"-119,980.77"
,IN,AR,30307170,1005,100,,Invoice,,,,,,13/02/2018,13/02/2018,0.00,,10.59,,"-119,991.36"
,IN,AR,30307197,1005,100,,Invoice,,,,,,13/02/2018,13/02/2018,0.00,,2.12,,"-119,993.48"
,IN,AR,30307247,1005,100,,Invoice,,,,,,13/02/2018,13/02/2018,0.00,,24.07,,"-120,017.55"
,IN,AR,30307359,1005,100,,Invoice,,,,,,13/02/2018,13/02/2018,0.00,,"1,093.22",,"-121,110.77"
,IN,AR,30307360,1005,100,,Invoice,,,,,,13/02/2018,13/02/2018,0.00,,3.64,,"-121,114.41"
,IN,AR,30307368,1005,100,,Invoice,,,,,,13/02/2018,13/02/2018,0.00,,29.15,,"-121,143.56"
,IN,AR,30307370,1005,100,,Invoice,,,,,,13/02/2018,13/02/2018,0.00,,55.14,,"-121,198.70"
,IN,AR,30307438,1005,100,,Invoice,,,,,,13/02/2018,13/02/2018,0.00,,7.29,,"-121,205.99"
,IN,AR,30307440,1005,100,,Invoice,,,,,,13/02/2018,13/02/2018,0.00,,5.08,,"-121,211.07"
,IN,AR,30307478,1005,100,,Invoice,,,,,,13/02/2018,13/02/2018,0.00,,10.17,,"-121,221.24"
,IN,AR,30307508,1005,100,,Invoice,,,,,,13/02/2018,13/02/2018,0.00,,6.13,,"-121,227.37"
,IN,AR,30307524,1005,100,,Invoice,,,,,,13/02/2018,13/02/2018,0.00,,10.93,,"-121,238.30"
,IN,AR,30307528,1005,100,,Invoice,,,,,,13/02/2018,13/02/2018,0.00,,5.85,,"-121,244.15"
,IN,AR,30307561,1005,100,,Invoice,,,,,,13/02/2018,13/02/2018,0.00,,14.87,,"-121,259.02"
,IN,AR,30307565,1005,100,,Invoice,,,,,,13/02/2018,13/02/2018,0.00,,2.39,,"-121,261.41"
,IN,AR,30307571,1005,100,,Invoice,,,,,,13/02/2018,13/02/2018,0.00,,15.25,,"-121,276.66"
,IN,AR,30307578,1005,100,,Invoice,,,,,,13/02/2018,13/02/2018,0.00,,10.53,,"-121,287.19"
,IN,AR,30307591,1005,100,,Invoice,,,,,,13/02/2018,13/02/2018,0.00,,14.58,,"-121,301.77"
,IN,AR,30307598,1005,100,,Invoice,,,,,,13/02/2018,13/02/2018,0.00,,8.47,,"-121,310.24"
,IN,AR,30307607,1005,100,,Invoice,,,,,,13/02/2018,13/02/2018,0.00,,6.36,,"-121,316.60"
,IN,AR,30307622,1005,100,,Invoice,,,,,,13/02/2018,13/02/2018,0.00,,6.43,,"-121,323.03"
,IN,AR,30307662,1005,100,,Invoice,,,,,,13/02/2018,13/02/2018,0.00,,11.86,,"-121,334.89"
,IN,AR,30307677,1005,100,,Invoice,,,,,,13/02/2018,13/02/2018,0.00,,3.01,,"-121,337.90"
,IN,AR,30307714,1005,100,,Invoice,,,,,,13/02/2018,13/02/2018,0.00,,47.54,,"-121,385.44"
,IN,AR,30307738,1005,100,,Invoice,,,,,,13/02/2018,13/02/2018,0.00,,24.56,,"-121,410.00"
,IN,AR,30307757,1005,100,,Invoice,,,,,,13/02/2018,13/02/2018,0.00,,65.30,,"-121,475.30"
,IN,AR,30307780,1005,100,,Invoice,,,,,,13/02/2018,13/02/2018,0.00,,5.59,,"-121,480.89"
,IN,AR,30307792,1005,100,,Invoice,,,,,,13/02/2018,13/02/2018,0.00,,8.52,,"-121,489.41"
,IN,AR,30307836,1005,100,,Invoice,,,,,,13/02/2018,13/02/2018,0.00,,83.05,,"-121,572.46"
,IN,AR,30307867,1005,100,,Invoice,,,,,,13/02/2018,13/02/2018,0.00,,23.58,,"-121,596.04"
,IN,AR,30307892,1005,100,,Invoice,,,,,,13/02/2018,13/02/2018,0.00,,7.05,,"-121,603.09"
,IN,AR,30307926,1005,100,,Invoice,,,,,,13/02/2018,13/02/2018,0.00,,63.56,,"-121,666.65"
,IN,AR,30307946,1005,100,,Invoice,,,,,,13/02/2018,13/02/2018,0.00,,10.17,,"-121,676.82"
,IN,AR,30308031,1005,100,,Invoice,,,,,,13/02/2018,13/02/2018,0.00,,267.12,,"-121,943.94"
,IN,AR,30308032,1005,100,,Invoice,,,,,,13/02/2018,13/02/2018,0.00,,1.59,,"-121,945.53"
,IN,AR,30308049,1005,100,,Invoice,,,,,,13/02/2018,13/02/2018,0.00,,34.07,,"-121,979.60"
,IN,AR,30308101,1005,100,,Invoice,,,,,,13/02/2018,13/02/2018,0.00,,193.86,,"-122,173.46"
,IN,AR,30308124,1005,100,,Invoice,,,,,,13/02/2018,13/02/2018,0.00,,6.42,,"-122,179.88"
,IN,AR,30308213,1005,100,,Invoice,,,,,,13/02/2018,13/02/2018,0.00,,10.93,,"-122,190.81"
,IN,AR,30308222,1005,100,,Invoice,,,,,,13/02/2018,13/02/2018,0.00,,17.80,,"-122,208.61"
,IN,AR,30308284,1005,100,,Invoice,,,,,,13/02/2018,13/02/2018,0.00,,14.58,,"-122,223.19"
,IN,AR,30308317,1005,100,,Invoice,,,,,,13/02/2018,13/02/2018,0.00,,7.29,,"-122,230.48"
,IN,AR,30308319,1005,100,,Invoice,,,,,,13/02/2018,13/02/2018,0.00,,10.95,,"-122,241.43"
,IN,AR,30308358,1005,100,,Invoice,,,,,,13/02/2018,13/02/2018,0.00,,122.00,,"-122,363.43"
,IN,AR,30308362,1005,100,,Invoice,,,,,,13/02/2018,13/02/2018,0.00,,27.31,,"-122,390.74"
,IN,AR,30308375,1005,100,,Invoice,,,,,,13/02/2018,13/02/2018,0.00,,29.15,,"-122,419.89"
,IN,AR,30308387,1005,100,,Invoice,,,,,,13/02/2018,13/02/2018,0.00,,18.98,,"-122,438.87"
,IN,AR,30308467,1005,100,,Invoice,,,,,,13/02/2018,13/02/2018,0.00,,75.93,,"-122,514.80"
,IN,AR,30308487,1005,100,,Invoice,,,,,,13/02/2018,13/02/2018,0.00,,21.36,,"-122,536.16"
,IN,AR,30308488,1005,100,,Invoice,,,,,,13/02/2018,13/02/2018,0.00,,16.61,,"-122,552.77"
,IN,AR,30308489,1005,100,,Invoice,,,,,,13/02/2018,13/02/2018,0.00,,106.79,,"-122,659.56"
,IN,AR,30308525,1005,100,,Invoice,,,,,,13/02/2018,13/02/2018,0.00,,5.26,,"-122,664.82"
,IN,AR,30308528,1005,100,,Invoice,,,,,,13/02/2018,13/02/2018,0.00,,5.51,,"-122,670.33"
,IN,AR,30308529,1005,100,,Invoice,,,,,,13/02/2018,13/02/2018,0.00,,8.26,,"-122,678.59"
,IN,AR,30308530,1005,100,,Invoice,,,,,,13/02/2018,13/02/2018,0.00,,5.51,,"-122,684.10"
,IN,AR,30308532,1005,100,,Invoice,,,,,,13/02/2018,13/02/2018,0.00,,8.00,,"-122,692.10"
,IN,AR,30308543,1005,100,,Invoice,,,,,,13/02/2018,13/02/2018,0.00,,102.86,,"-122,794.96"
,IN,AR,30308563,1005,100,,Invoice,,,,,,13/02/2018,13/02/2018,0.00,,8.77,,"-122,803.73"
,IN,AR,30308602,1005,100,,Invoice,,,,,,13/02/2018,13/02/2018,0.00,,15.17,,"-122,818.90"
,IN,AR,30308693,1005,100,,Invoice,,,,,,13/02/2018,13/02/2018,0.00,,10.93,,"-122,829.83"
,IN,AR,30308700,1005,100,,Invoice,,,,,,13/02/2018,13/02/2018,0.00,,25.51,,"-122,855.34"
,IN,AR,30308749,1005,100,,Invoice,,,,,,13/02/2018,13/02/2018,0.00,,29.15,,"-122,884.49"
,CN,AR,31017349,1005,100,,Credit Note,,,,,,14/02/2018,14/02/2018,5.17,,0.00,,"-122,879.32"
,CS,AR,32000946,1005,100,,Cash sale,,,,,,14/02/2018,14/02/2018,0.00,,3.64,,"-122,882.96"
,CS,AR,32000949,1005,100,,Cash sale,,,,,,14/02/2018,14/02/2018,0.00,,37.63,,"-122,920.59"
,CS,AR,32000968,1005,100,,Cash sale,,,,,,14/02/2018,14/02/2018,0.00,,7.29,,"-122,927.88"
,CS,AR,32000983,1005,100,,Cash sale,,,,,,14/02/2018,14/02/2018,0.00,,3.64,,"-122,931.52"
,CS,AR,32001003,1005,100,,Cash sale,,,,,,14/02/2018,14/02/2018,0.00,,48.14,,"-122,979.66"
,CS,AR,32001027,1005,100,,Cash sale,,,,,,14/02/2018,14/02/2018,0.00,,3.64,,"-122,983.30"
,CS,AR,32001063,1005,100,,Cash sale,,,,,,14/02/2018,14/02/2018,0.00,,3.64,,"-122,986.94"
,CS,AR,32001099,1005,100,,Cash sale,,,,,,14/02/2018,14/02/2018,0.00,,5.86,,"-122,992.80"
,CS,AR,32001177,1005,100,,Cash sale,,,,,,14/02/2018,14/02/2018,0.00,,7.29,,"-123,000.09"
,CS,AR,32001207,1005,100,,Cash sale,,,,,,14/02/2018,14/02/2018,0.00,,18.22,,"-123,018.31"
,CS,AR,32001220,1005,100,,Cash sale,,,,,,14/02/2018,14/02/2018,0.00,,5.08,,"-123,023.39"
,CS,AR,32001226,1005,100,,Cash sale,,,,,,14/02/2018,14/02/2018,0.00,,5.08,,"-123,028.47"
,CS,AR,32001243,1005,100,,Cash sale,,,,,,14/02/2018,14/02/2018,0.00,,4.49,,"-123,032.96"
,CS,AR,32001280,1005,100,,Cash sale,,,,,,14/02/2018,14/02/2018,0.00,,7.29,,"-123,040.25"
,CS,AR,32001301,1005,100,,Cash sale,,,,,,14/02/2018,14/02/2018,0.00,,7.29,,"-123,047.54"
,CS,AR,32001339,1005,100,,Cash sale,,,,,,14/02/2018,14/02/2018,0.00,,14.58,,"-123,062.12"
,CS,AR,32001422,1005,100,,Cash sale,,,,,,14/02/2018,14/02/2018,0.00,,7.29,,"-123,069.41"
,CS,AR,32001425,1005,100,,Cash sale,,,,,,14/02/2018,14/02/2018,0.00,,13.35,,"-123,082.76"
,CS,AR,32001432,1005,100,,Cash sale,,,,,,14/02/2018,14/02/2018,0.00,,11.86,,"-123,094.62"
,CS,AR,32001511,1005,100,,Cash sale,,,,,,14/02/2018,14/02/2018,0.00,,10.93,,"-123,105.55"
,CS,AR,32001530,1005,100,,Cash sale,,,,,,14/02/2018,14/02/2018,0.00,,9.15,,"-123,114.70"
,CS,AR,32001534,1005,100,,Cash sale,,,,,,14/02/2018,14/02/2018,0.00,,25.51,,"-123,140.21"
,CS,AR,32001569,1005,100,,Cash sale,,,,,,14/02/2018,14/02/2018,0.00,,51.60,,"-123,191.81"
,CS,AR,32001572,1005,100,,Cash sale,,,,,,14/02/2018,14/02/2018,0.00,,9.03,,"-123,200.84"
,CS,AR,32001624,1005,100,,Cash sale,,,,,,14/02/2018,14/02/2018,0.00,,12.14,,"-123,212.98"
,CS,AR,32001665,1005,100,,Cash sale,,,,,,14/02/2018,14/02/2018,0.00,,6.07,,"-123,219.05"
,CS,AR,32001678,1005,100,,Cash sale,,,,,,14/02/2018,14/02/2018,0.00,,8.25,,"-123,227.30"
,IN,AR,30306669,1005,100,,Invoice,,,,,,14/02/2018,14/02/2018,0.00,,84.54,,"-123,311.84"
,IN,AR,30306718,1005,100,,Invoice,,,,,,14/02/2018,14/02/2018,0.00,,68.34,,"-123,380.18"
,IN,AR,30306719,1005,100,,Invoice,,,,,,14/02/2018,14/02/2018,0.00,,19.53,,"-123,399.71"
,IN,AR,30306735,1005,100,,Invoice,,,,,,14/02/2018,14/02/2018,0.00,,11.36,,"-123,411.07"
,IN,AR,30306737,1005,100,,Invoice,,,,,,14/02/2018,14/02/2018,0.00,,7.29,,"-123,418.36"
,IN,AR,30306742,1005,100,,Invoice,,,,,,14/02/2018,14/02/2018,0.00,,19.92,,"-123,438.28"
,IN,AR,30306754,1005,100,,Invoice,,,,,,14/02/2018,14/02/2018,0.00,,18.39,,"-123,456.67"
,IN,AR,30306755,1005,100,,Invoice,,,,,,14/02/2018,14/02/2018,0.00,,70.93,,"-123,527.60"
,IN,AR,30306778,1005,100,,Invoice,,,,,,14/02/2018,14/02/2018,0.00,,54.66,,"-123,582.26"
,IN,AR,30306793,1005,100,,Invoice,,,,,,14/02/2018,14/02/2018,0.00,,364.41,,"-123,946.67"
,IN,AR,30306798,1005,100,,Invoice,,,,,,14/02/2018,14/02/2018,0.00,,54.03,,"-124,000.70"
,IN,AR,30306836,1005,100,,Invoice,,,,,,14/02/2018,14/02/2018,0.00,,40.34,,"-124,041.04"
,IN,AR,30306886,1005,100,,Invoice,,,,,,14/02/2018,14/02/2018,0.00,,55.14,,"-124,096.18"
,IN,AR,30306909,1005,100,,Invoice,,,,,,14/02/2018,14/02/2018,0.00,,14.00,,"-124,110.18"
,IN,AR,30306958,1005,100,,Invoice,,,,,,14/02/2018,14/02/2018,0.00,,24.00,,"-124,134.18"
,IN,AR,30306971,1005,100,,Invoice,,,,,,14/02/2018,14/02/2018,0.00,,78.31,,"-124,212.49"
,IN,AR,30306980,1005,100,,Invoice,,,,,,14/02/2018,14/02/2018,0.00,,8.00,,"-124,220.49"
,IN,AR,30307010,1005,100,,Invoice,,,,,,14/02/2018,14/02/2018,0.00,,29.15,,"-124,249.64"
,IN,AR,30307015,1005,100,,Invoice,,,,,,14/02/2018,14/02/2018,0.00,,182.20,,"-124,431.84"
,IN,AR,30307017,1005,100,,Invoice,,,,,,14/02/2018,14/02/2018,0.00,,177.37,,"-124,609.21"
,IN,AR,30307053,1005,100,,Invoice,,,,,,14/02/2018,14/02/2018,0.00,,6.02,,"-124,615.23"
,IN,AR,30307072,1005,100,,Invoice,,,,,,14/02/2018,14/02/2018,0.00,,18.57,,"-124,633.80"
,IN,AR,30307094,1005,100,,Invoice,,,,,,14/02/2018,14/02/2018,0.00,,7.97,,"-124,641.77"
,IN,AR,30307167,1005,100,,Invoice,,,,,,14/02/2018,14/02/2018,0.00,,6.36,,"-124,648.13"
,IN,AR,30307185,1005,100,,Invoice,,,,,,14/02/2018,14/02/2018,0.00,,2.12,,"-124,650.25"
,IN,AR,30307193,1005,100,,Invoice,,,,,,14/02/2018,14/02/2018,0.00,,29.15,,"-124,679.40"
,IN,AR,30307195,1005,100,,Invoice,,,,,,14/02/2018,14/02/2018,0.00,,5.59,,"-124,684.99"
,IN,AR,30307250,1005,100,,Invoice,,,,,,14/02/2018,14/02/2018,0.00,,3.64,,"-124,688.63"
,IN,AR,30307273,1005,100,,Invoice,,,,,,14/02/2018,14/02/2018,0.00,,53.32,,"-124,741.95"
,IN,AR,30307285,1005,100,,Invoice,,,,,,14/02/2018,14/02/2018,0.00,,12.71,,"-124,754.66"
,IN,AR,30307300,1005,100,,Invoice,,,,,,14/02/2018,14/02/2018,0.00,,6.43,,"-124,761.09"
,IN,AR,30307365,1005,100,,Invoice,,,,,,14/02/2018,14/02/2018,0.00,,54.66,,"-124,815.75"
,IN,AR,30307367,1005,100,,Invoice,,,,,,14/02/2018,14/02/2018,0.00,,2.12,,"-124,817.87"
,IN,AR,30307379,1005,100,,Invoice,,,,,,14/02/2018,14/02/2018,0.00,,78.03,,"-124,895.90"
,IN,AR,30307586,1005,100,,Invoice,,,,,,14/02/2018,14/02/2018,0.00,,3.64,,"-124,899.54"
,IN,AR,30307668,1005,100,,Invoice,,,,,,14/02/2018,14/02/2018,0.00,,16.02,,"-124,915.56"
,IN,AR,30307711,1005,100,,Invoice,,,,,,14/02/2018,14/02/2018,0.00,,10.93,,"-124,926.49"
,IN,AR,30307758,1005,100,,Invoice,,,,,,14/02/2018,14/02/2018,0.00,,364.41,,"-125,290.90"
,IN,AR,30307819,1005,100,,Invoice,,,,,,14/02/2018,14/02/2018,0.00,,18.05,,"-125,308.95"
,IN,AR,30307820,1005,100,,Invoice,,,,,,14/02/2018,14/02/2018,0.00,,18.05,,"-125,327.00"
,IN,AR,30307828,1005,100,,Invoice,,,,,,14/02/2018,14/02/2018,0.00,,15.04,,"-125,342.04"
,IN,AR,30307868,1005,100,,Invoice,,,,,,14/02/2018,14/02/2018,0.00,,23.58,,"-125,365.62"
,IN,AR,30307875,1005,100,,Invoice,,,,,,14/02/2018,14/02/2018,0.00,,29.15,,"-125,394.77"
,IN,AR,30307893,1005,100,,Invoice,,,,,,14/02/2018,14/02/2018,0.00,,10.57,,"-125,405.34"
,IN,AR,30307950,1005,100,,Invoice,,,,,,14/02/2018,14/02/2018,0.00,,12.00,,"-125,417.34"
,IN,AR,30307967,1005,100,,Invoice,,,,,,14/02/2018,14/02/2018,0.00,,18.22,,"-125,435.56"
,IN,AR,30307992,1005,100,,Invoice,,,,,,14/02/2018,14/02/2018,0.00,,364.41,,"-125,799.97"
,IN,AR,30308002,1005,100,,Invoice,,,,,,14/02/2018,14/02/2018,0.00,,6.86,,"-125,806.83"
,IN,AR,30308054,1005,100,,Invoice,,,,,,14/02/2018,14/02/2018,0.00,,24.00,,"-125,830.83"
,IN,AR,30308064,1005,100,,Invoice,,,,,,14/02/2018,14/02/2018,0.00,,54.12,,"-125,884.95"
,IN,AR,30308079,1005,100,,Invoice,,,,,,14/02/2018,14/02/2018,0.00,,43.73,,"-125,928.68"
,IN,AR,30308083,1005,100,,Invoice,,,,,,14/02/2018,14/02/2018,0.00,,54.66,,"-125,983.34"
,IN,AR,30308092,1005,100,,Invoice,,,,,,14/02/2018,14/02/2018,0.00,,18.05,,"-126,001.39"
,IN,AR,30308125,1005,100,,Invoice,,,,,,14/02/2018,14/02/2018,0.00,,8.02,,"-126,009.41"
,IN,AR,30308126,1005,100,,Invoice,,,,,,14/02/2018,14/02/2018,0.00,,17.64,,"-126,027.05"
,IN,AR,30308127,1005,100,,Invoice,,,,,,14/02/2018,14/02/2018,0.00,,3.20,,"-126,030.25"
,IN,AR,30308128,1005,100,,Invoice,,,,,,14/02/2018,14/02/2018,0.00,,3.20,,"-126,033.45"
,IN,AR,30308129,1005,100,,Invoice,,,,,,14/02/2018,14/02/2018,0.00,,9.62,,"-126,043.07"
,IN,AR,30308166,1005,100,,Invoice,,,,,,14/02/2018,14/02/2018,0.00,,4.58,,"-126,047.65"
,IN,AR,30308199,1005,100,,Invoice,,,,,,14/02/2018,14/02/2018,0.00,,36.22,,"-126,083.87"
,IN,AR,30308257,1005,100,,Invoice,,,,,,14/02/2018,14/02/2018,0.00,,8.75,,"-126,092.62"
,IN,AR,30308258,1005,100,,Invoice,,,,,,14/02/2018,14/02/2018,0.00,,17.49,,"-126,110.11"
,IN,AR,30308267,1005,100,,Invoice,,,,,,14/02/2018,14/02/2018,0.00,,56.78,,"-126,166.89"
,IN,AR,30308273,1005,100,,Invoice,,,,,,14/02/2018,14/02/2018,0.00,,7.54,,"-126,174.43"
,IN,AR,30308274,1005,100,,Invoice,,,,,,14/02/2018,14/02/2018,0.00,,72.41,,"-126,246.84"
,IN,AR,30308293,1005,100,,Invoice,,,,,,14/02/2018,14/02/2018,0.00,,23.13,,"-126,269.97"
,IN,AR,30308298,1005,100,,Invoice,,,,,,14/02/2018,14/02/2018,0.00,,29.87,,"-126,299.84"
,IN,AR,30308314,1005,100,,Invoice,,,,,,14/02/2018,14/02/2018,0.00,,251.69,,"-126,551.53"
,IN,AR,30308345,1005,100,,Invoice,,,,,,14/02/2018,14/02/2018,0.00,,5.59,,"-126,557.12"
,IN,AR,30308365,1005,100,,Invoice,,,,,,14/02/2018,14/02/2018,0.00,,5.08,,"-126,562.20"
,IN,AR,30308408,1005,100,,Invoice,,,,,,14/02/2018,14/02/2018,0.00,,12.14,,"-126,574.34"
,IN,AR,30308452,1005,100,,Invoice,,,,,,14/02/2018,14/02/2018,0.00,,7.97,,"-126,582.31"
,IN,AR,30308506,1005,100,,Invoice,,,,,,14/02/2018,14/02/2018,0.00,,14.00,,"-126,596.31"
,IN,AR,30308521,1005,100,,Invoice,,,,,,14/02/2018,14/02/2018,0.00,,3.51,,"-126,599.82"
,IN,AR,30308572,1005,100,,Invoice,,,,,,14/02/2018,14/02/2018,0.00,,10.93,,"-126,610.75"
,IN,AR,30308598,1005,100,,Invoice,,,,,,14/02/2018,14/02/2018,0.00,,5.64,,"-126,616.39"
,IN,AR,30308611,1005,100,,Invoice,,,,,,14/02/2018,14/02/2018,0.00,,10.93,,"-126,627.32"
,IN,AR,30308663,1005,100,,Invoice,,,,,,14/02/2018,14/02/2018,0.00,,11.19,,"-126,638.51"
,IN,AR,30308687,1005,100,,Invoice,,,,,,14/02/2018,14/02/2018,0.00,,19.22,,"-126,657.73"
,IN,AR,30308710,1005,100,,Invoice,,,,,,14/02/2018,14/02/2018,0.00,,52.17,,"-126,709.90"
,IN,AR,30308711,1005,100,,Invoice,,,,,,14/02/2018,14/02/2018,0.00,,5.49,,"-126,715.39"
,CN,AR,31017286,1005,100,,Credit Note,,,,,,15/02/2018,15/02/2018,19.07,,0.00,,"-126,696.32"
,CN,AR,31017287,1005,100,,Credit Note,,,,,,15/02/2018,15/02/2018,12.71,,0.00,,"-126,683.61"
,CS,AR,32000931,1005,100,,Cash sale,,,,,,15/02/2018,15/02/2018,0.00,,18.05,,"-126,701.66"
,CS,AR,32000942,1005,100,,Cash sale,,,,,,15/02/2018,15/02/2018,0.00,,3.64,,"-126,705.30"
,CS,AR,32000986,1005,100,,Cash sale,,,,,,15/02/2018,15/02/2018,0.00,,10.93,,"-126,716.23"
,CS,AR,32001103,1005,100,,Cash sale,,,,,,15/02/2018,15/02/2018,0.00,,7.29,,"-126,723.52"
,CS,AR,32001114,1005,100,,Cash sale,,,,,,15/02/2018,15/02/2018,0.00,,7.75,,"-126,731.27"
,CS,AR,32001142,1005,100,,Cash sale,,,,,,15/02/2018,15/02/2018,0.00,,15.53,,"-126,746.80"
,CS,AR,32001163,1005,100,,Cash sale,,,,,,15/02/2018,15/02/2018,0.00,,10.34,,"-126,757.14"
,CS,AR,32001291,1005,100,,Cash sale,,,,,,15/02/2018,15/02/2018,0.00,,14.58,,"-126,771.72"
,CS,AR,32001317,1005,100,,Cash sale,,,,,,15/02/2018,15/02/2018,0.00,,3.64,,"-126,775.36"
,CS,AR,32001328,1005,100,,Cash sale,,,,,,15/02/2018,15/02/2018,0.00,,3.64,,"-126,779.00"
,CS,AR,32001342,1005,100,,Cash sale,,,,,,15/02/2018,15/02/2018,0.00,,10.93,,"-126,789.93"
,CS,AR,32001350,1005,100,,Cash sale,,,,,,15/02/2018,15/02/2018,0.00,,10.93,,"-126,800.86"
,CS,AR,32001362,1005,100,,Cash sale,,,,,,15/02/2018,15/02/2018,0.00,,3.64,,"-126,804.50"
,CS,AR,32001368,1005,100,,Cash sale,,,,,,15/02/2018,15/02/2018,0.00,,7.29,,"-126,811.79"
,CS,AR,32001377,1005,100,,Cash sale,,,,,,15/02/2018,15/02/2018,0.00,,2.58,,"-126,814.37"
,CS,AR,32001392,1005,100,,Cash sale,,,,,,15/02/2018,15/02/2018,0.00,,16.53,,"-126,830.90"
,CS,AR,32001445,1005,100,,Cash sale,,,,,,15/02/2018,15/02/2018,0.00,,7.29,,"-126,838.19"
,CS,AR,32001483,1005,100,,Cash sale,,,,,,15/02/2018,15/02/2018,0.00,,7.29,,"-126,845.48"
,CS,AR,32001487,1005,100,,Cash sale,,,,,,15/02/2018,15/02/2018,0.00,,32.80,,"-126,878.28"
,CS,AR,32001489,1005,100,,Cash sale,,,,,,15/02/2018,15/02/2018,0.00,,7.29,,"-126,885.57"
,CS,AR,32001559,1005,100,,Cash sale,,,,,,15/02/2018,15/02/2018,0.00,,12.14,,"-126,897.71"
,CS,AR,32001575,1005,100,,Cash sale,,,,,,15/02/2018,15/02/2018,0.00,,14.58,,"-126,912.29"
,CS,AR,32001580,1005,100,,Cash sale,,,,,,15/02/2018,15/02/2018,0.00,,7.29,,"-126,919.58"
,CS,AR,32001613,1005,100,,Cash sale,,,,,,15/02/2018,15/02/2018,0.00,,3.64,,"-126,923.22"
,CS,AR,32001631,1005,100,,Cash sale,,,,,,15/02/2018,15/02/2018,0.00,,7.29,,"-126,930.51"
,CS,AR,32001649,1005,100,,Cash sale,,,,,,15/02/2018,15/02/2018,0.00,,7.29,,"-126,937.80"
,CS,AR,32001683,1005,100,,Cash sale,,,,,,15/02/2018,15/02/2018,0.00,,10.93,,"-126,948.73"
,IN,AR,30306698,1005,100,,Invoice,,,,,,15/02/2018,15/02/2018,0.00,,3.64,,"-126,952.37"
,IN,AR,30306715,1005,100,,Invoice,,,,,,15/02/2018,15/02/2018,0.00,,10.93,,"-126,963.30"
,IN,AR,30306787,1005,100,,Invoice,,,,,,15/02/2018,15/02/2018,0.00,,2.03,,"-126,965.33"
,IN,AR,30306809,1005,100,,Invoice,,,,,,15/02/2018,15/02/2018,0.00,,25.51,,"-126,990.84"
,IN,AR,30306826,1005,100,,Invoice,,,,,,15/02/2018,15/02/2018,0.00,,7.97,,"-126,998.81"
,IN,AR,30306837,1005,100,,Invoice,,,,,,15/02/2018,15/02/2018,0.00,,18.98,,"-127,017.79"
,IN,AR,30306872,1005,100,,Invoice,,,,,,15/02/2018,15/02/2018,0.00,,692.37,,"-127,710.16"
,IN,AR,30306895,1005,100,,Invoice,,,,,,15/02/2018,15/02/2018,0.00,,21.86,,"-127,732.02"
,IN,AR,30306938,1005,100,,Invoice,,,,,,15/02/2018,15/02/2018,0.00,,13.77,,"-127,745.79"
,IN,AR,30306943,1005,100,,Invoice,,,,,,15/02/2018,15/02/2018,0.00,,7.29,,"-127,753.08"
,IN,AR,30306999,1005,100,,Invoice,,,,,,15/02/2018,15/02/2018,0.00,,30.20,,"-127,783.28"
,IN,AR,30307023,1005,100,,Invoice,,,,,,15/02/2018,15/02/2018,0.00,,30.51,,"-127,813.79"
,IN,AR,30307041,1005,100,,Invoice,,,,,,15/02/2018,15/02/2018,0.00,,70.00,,"-127,883.79"
,IN,AR,30307057,1005,100,,Invoice,,,,,,15/02/2018,15/02/2018,0.00,,21.86,,"-127,905.65"
,IN,AR,30307086,1005,100,,Invoice,,,,,,15/02/2018,15/02/2018,0.00,,14.58,,"-127,920.23"
,IN,AR,30307099,1005,100,,Invoice,,,,,,15/02/2018,15/02/2018,0.00,,21.86,,"-127,942.09"
,IN,AR,30307101,1005,100,,Invoice,,,,,,15/02/2018,15/02/2018,0.00,,10.93,,"-127,953.02"
,IN,AR,30307108,1005,100,,Invoice,,,,,,15/02/2018,15/02/2018,0.00,,14.00,,"-127,967.02"
,IN,AR,30307111,1005,100,,Invoice,,,,,,15/02/2018,15/02/2018,0.00,,18.22,,"-127,985.24"
,IN,AR,30307125,1005,100,,Invoice,,,,,,15/02/2018,15/02/2018,0.00,,7.29,,"-127,992.53"
,IN,AR,30307145,1005,100,,Invoice,,,,,,15/02/2018,15/02/2018,0.00,,14.58,,"-128,007.11"
,IN,AR,30307161,1005,100,,Invoice,,,,,,15/02/2018,15/02/2018,0.00,,12.03,,"-128,019.14"
,IN,AR,30307222,1005,100,,Invoice,,,,,,15/02/2018,15/02/2018,0.00,,10.38,,"-128,029.52"
,IN,AR,30307237,1005,100,,Invoice,,,,,,15/02/2018,15/02/2018,0.00,,18.22,,"-128,047.74"
,IN,AR,30307244,1005,100,,Invoice,,,,,,15/02/2018,15/02/2018,0.00,,23.90,,"-128,071.64"
,IN,AR,30307253,1005,100,,Invoice,,,,,,15/02/2018,15/02/2018,0.00,,26.29,,"-128,097.93"
,IN,AR,30307266,1005,100,,Invoice,,,,,,15/02/2018,15/02/2018,0.00,,16.95,,"-128,114.88"
,IN,AR,30307293,1005,100,,Invoice,,,,,,15/02/2018,15/02/2018,0.00,,32.80,,"-128,147.68"
,IN,AR,30307311,1005,100,,Invoice,,,,,,15/02/2018,15/02/2018,0.00,,14.34,,"-128,162.02"
,IN,AR,30307319,1005,100,,Invoice,,,,,,15/02/2018,15/02/2018,0.00,,25.76,,"-128,187.78"
,IN,AR,30307327,1005,100,,Invoice,,,,,,15/02/2018,15/02/2018,0.00,,6.44,,"-128,194.22"
,IN,AR,30307374,1005,100,,Invoice,,,,,,15/02/2018,15/02/2018,0.00,,10.93,,"-128,205.15"
,IN,AR,30307400,1005,100,,Invoice,,,,,,15/02/2018,15/02/2018,0.00,,3.64,,"-128,208.79"
,IN,AR,30307413,1005,100,,Invoice,,,,,,15/02/2018,15/02/2018,0.00,,4.78,,"-128,213.57"
,IN,AR,30307428,1005,100,,Invoice,,,,,,15/02/2018,15/02/2018,0.00,,7.63,,"-128,221.20"
,IN,AR,30307429,1005,100,,Invoice,,,,,,15/02/2018,15/02/2018,0.00,,7.63,,"-128,228.83"
,IN,AR,30307452,1005,100,,Invoice,,,,,,15/02/2018,15/02/2018,0.00,,43.02,,"-128,271.85"
,IN,AR,30307453,1005,100,,Invoice,,,,,,15/02/2018,15/02/2018,0.00,,54.17,,"-128,326.02"
,IN,AR,30307462,1005,100,,Invoice,,,,,,15/02/2018,15/02/2018,0.00,,18.39,,"-128,344.41"
,IN,AR,30307468,1005,100,,Invoice,,,,,,15/02/2018,15/02/2018,0.00,,84.20,,"-128,428.61"
,IN,AR,30307473,1005,100,,Invoice,,,,,,15/02/2018,15/02/2018,0.00,,2.58,,"-128,431.19"
,IN,AR,30307475,1005,100,,Invoice,,,,,,15/02/2018,15/02/2018,0.00,,8.47,,"-128,439.66"
,IN,AR,30307482,1005,100,,Invoice,,,,,,15/02/2018,15/02/2018,0.00,,4.32,,"-128,443.98"
,IN,AR,30307533,1005,100,,Invoice,,,,,,15/02/2018,15/02/2018,0.00,,10.34,,"-128,454.32"
,IN,AR,30307572,1005,100,,Invoice,,,,,,15/02/2018,15/02/2018,0.00,,5.08,,"-128,459.40"
,IN,AR,30307581,1005,100,,Invoice,,,,,,15/02/2018,15/02/2018,0.00,,54.66,,"-128,514.06"
,IN,AR,30307628,1005,100,,Invoice,,,,,,15/02/2018,15/02/2018,0.00,,7.29,,"-128,521.35"
,IN,AR,30307634,1005,100,,Invoice,,,,,,15/02/2018,15/02/2018,0.00,,8.17,,"-128,529.52"
,IN,AR,30307638,1005,100,,Invoice,,,,,,15/02/2018,15/02/2018,0.00,,10.98,,"-128,540.50"
,IN,AR,30307641,1005,100,,Invoice,,,,,,15/02/2018,15/02/2018,0.00,,6.89,,"-128,547.39"
,IN,AR,30307653,1005,100,,Invoice,,,,,,15/02/2018,15/02/2018,0.00,,30.08,,"-128,577.47"
,IN,AR,30307656,1005,100,,Invoice,,,,,,15/02/2018,15/02/2018,0.00,,3.64,,"-128,581.11"
,IN,AR,30307669,1005,100,,Invoice,,,,,,15/02/2018,15/02/2018,0.00,,6.86,,"-128,587.97"
,IN,AR,30307727,1005,100,,Invoice,,,,,,15/02/2018,15/02/2018,0.00,,12.71,,"-128,600.68"
,IN,AR,30307763,1005,100,,Invoice,,,,,,15/02/2018,15/02/2018,0.00,,5.85,,"-128,606.53"
,IN,AR,30307767,1005,100,,Invoice,,,,,,15/02/2018,15/02/2018,0.00,,10.93,,"-128,617.46"
,IN,AR,30307769,1005,100,,Invoice,,,,,,15/02/2018,15/02/2018,0.00,,18.22,,"-128,635.68"
,IN,AR,30307774,1005,100,,Invoice,,,,,,15/02/2018,15/02/2018,0.00,,11.02,,"-128,646.70"
,IN,AR,30307814,1005,100,,Invoice,,,,,,15/02/2018,15/02/2018,0.00,,11.23,,"-128,657.93"
,IN,AR,30307841,1005,100,,Invoice,,,,,,15/02/2018,15/02/2018,0.00,,13.58,,"-128,671.51"
,IN,AR,30307845,1005,100,,Invoice,,,,,,15/02/2018,15/02/2018,0.00,,7.63,,"-128,679.14"
,IN,AR,30307847,1005,100,,Invoice,,,,,,15/02/2018,15/02/2018,0.00,,6.53,,"-128,685.67"
,IN,AR,30307854,1005,100,,Invoice,,,,,,15/02/2018,15/02/2018,0.00,,28.39,,"-128,714.06"
,IN,AR,30307859,1005,100,,Invoice,,,,,,15/02/2018,15/02/2018,0.00,,8.00,,"-128,722.06"
,IN,AR,30307887,1005,100,,Invoice,,,,,,15/02/2018,15/02/2018,0.00,,11.19,,"-128,733.25"
,IN,AR,30307894,1005,100,,Invoice,,,,,,15/02/2018,15/02/2018,0.00,,3.53,,"-128,736.78"
,IN,AR,30307895,1005,100,,Invoice,,,,,,15/02/2018,15/02/2018,0.00,,5.29,,"-128,742.07"
,IN,AR,30307902,1005,100,,Invoice,,,,,,15/02/2018,15/02/2018,0.00,,21.06,,"-128,763.13"
,IN,AR,30307911,1005,100,,Invoice,,,,,,15/02/2018,15/02/2018,0.00,,7.29,,"-128,770.42"
,IN,AR,30307919,1005,100,,Invoice,,,,,,15/02/2018,15/02/2018,0.00,,4.54,,"-128,774.96"
,IN,AR,30307936,1005,100,,Invoice,,,,,,15/02/2018,15/02/2018,0.00,,5.17,,"-128,780.13"
,IN,AR,30307957,1005,100,,Invoice,,,,,,15/02/2018,15/02/2018,0.00,,18.22,,"-128,798.35"
,IN,AR,30307958,1005,100,,Invoice,,,,,,15/02/2018,15/02/2018,0.00,,25.51,,"-128,823.86"
,IN,AR,30307972,1005,100,,Invoice,,,,,,15/02/2018,15/02/2018,0.00,,8.52,,"-128,832.38"
,IN,AR,30307994,1005,100,,Invoice,,,,,,15/02/2018,15/02/2018,0.00,,14.58,,"-128,846.96"
,IN,AR,30307998,1005,100,,Invoice,,,,,,15/02/2018,15/02/2018,0.00,,7.63,,"-128,854.59"
,IN,AR,30308016,1005,100,,Invoice,,,,,,15/02/2018,15/02/2018,0.00,,9.76,,"-128,864.35"
,IN,AR,30308017,1005,100,,Invoice,,,,,,15/02/2018,15/02/2018,0.00,,4.88,,"-128,869.23"
,IN,AR,30308018,1005,100,,Invoice,,,,,,15/02/2018,15/02/2018,0.00,,4.88,,"-128,874.11"
,IN,AR,30308019,1005,100,,Invoice,,,,,,15/02/2018,15/02/2018,0.00,,29.29,,"-128,903.40"
,IN,AR,30308033,1005,100,,Invoice,,,,,,15/02/2018,15/02/2018,0.00,,15.90,,"-128,919.30"
,IN,AR,30308034,1005,100,,Invoice,,,,,,15/02/2018,15/02/2018,0.00,,14.31,,"-128,933.61"
,IN,AR,30308035,1005,100,,Invoice,,,,,,15/02/2018,15/02/2018,0.00,,9.54,,"-128,943.15"
,IN,AR,30308036,1005,100,,Invoice,,,,,,15/02/2018,15/02/2018,0.00,,27.03,,"-128,970.18"
,IN,AR,30308060,1005,100,,Invoice,,,,,,15/02/2018,15/02/2018,0.00,,13.09,,"-128,983.27"
,IN,AR,30308089,1005,100,,Invoice,,,,,,15/02/2018,15/02/2018,0.00,,3.64,,"-128,986.91"
,IN,AR,30308098,1005,100,,Invoice,,,,,,15/02/2018,15/02/2018,0.00,,19.45,,"-129,006.36"
,IN,AR,30308130,1005,100,,Invoice,,,,,,15/02/2018,15/02/2018,0.00,,9.62,,"-129,015.98"
,IN,AR,30308131,1005,100,,Invoice,,,,,,15/02/2018,15/02/2018,0.00,,3.20,,"-129,019.18"
,IN,AR,30308132,1005,100,,Invoice,,,,,,15/02/2018,15/02/2018,0.00,,12.83,,"-129,032.01"
,IN,AR,30308133,1005,100,,Invoice,,,,,,15/02/2018,15/02/2018,0.00,,3.20,,"-129,035.21"
,IN,AR,30308170,1005,100,,Invoice,,,,,,15/02/2018,15/02/2018,0.00,,12.71,,"-129,047.92"
,IN,AR,30308223,1005,100,,Invoice,,,,,,15/02/2018,15/02/2018,0.00,,2.54,,"-129,050.46"
,IN,AR,30308231,1005,100,,Invoice,,,,,,15/02/2018,15/02/2018,0.00,,22.01,,"-129,072.47"
,IN,AR,30308259,1005,100,,Invoice,,,,,,15/02/2018,15/02/2018,0.00,,14.58,,"-129,087.05"
,IN,AR,30308260,1005,100,,Invoice,,,,,,15/02/2018,15/02/2018,0.00,,11.66,,"-129,098.71"
,IN,AR,30308326,1005,100,,Invoice,,,,,,15/02/2018,15/02/2018,0.00,,16.83,,"-129,115.54"
,IN,AR,30308338,1005,100,,Invoice,,,,,,15/02/2018,15/02/2018,0.00,,13.73,,"-129,129.27"
,IN,AR,30308372,1005,100,,Invoice,,,,,,15/02/2018,15/02/2018,0.00,,8.17,,"-129,137.44"
,IN,AR,30308380,1005,100,,Invoice,,,,,,15/02/2018,15/02/2018,0.00,,54.66,,"-129,192.10"
,IN,AR,30308415,1005,100,,Invoice,,,,,,15/02/2018,15/02/2018,0.00,,14.58,,"-129,206.68"
,IN,AR,30308417,1005,100,,Invoice,,,,,,15/02/2018,15/02/2018,0.00,,21.86,,"-129,228.54"
,IN,AR,30308429,1005,100,,Invoice,,,,,,15/02/2018,15/02/2018,0.00,,21.36,,"-129,249.90"
,IN,AR,30308453,1005,100,,Invoice,,,,,,15/02/2018,15/02/2018,0.00,,3.19,,"-129,253.09"
,IN,AR,30308454,1005,100,,Invoice,,,,,,15/02/2018,15/02/2018,0.00,,130.64,,"-129,383.73"
,IN,AR,30308455,1005,100,,Invoice,,,,,,15/02/2018,15/02/2018,0.00,,9.56,,"-129,393.29"
,IN,AR,30308456,1005,100,,Invoice,,,,,,15/02/2018,15/02/2018,0.00,,14.34,,"-129,407.63"
,IN,AR,30308498,1005,100,,Invoice,,,,,,15/02/2018,15/02/2018,0.00,,14.24,,"-129,421.87"
,IN,AR,30308639,1005,100,,Invoice,,,,,,15/02/2018,15/02/2018,0.00,,279.66,,"-129,701.53"
,IN,AR,30308657,1005,100,,Invoice,,,,,,15/02/2018,15/02/2018,0.00,,10.93,,"-129,712.46"
,IN,AR,30308676,1005,100,,Invoice,,,,,,15/02/2018,15/02/2018,0.00,,6.13,,"-129,718.59"
,IN,AR,30308701,1005,100,,Invoice,,,,,,15/02/2018,15/02/2018,0.00,,7.29,,"-129,725.88"
,IN,AR,30308712,1005,100,,Invoice,,,,,,15/02/2018,15/02/2018,0.00,,16.47,,"-129,742.35"
,IN,AR,30308713,1005,100,,Invoice,,,,,,15/02/2018,15/02/2018,0.00,,13.73,,"-129,756.08"
,IN,AR,30308753,1005,100,,Invoice,,,,,,15/02/2018,15/02/2018,0.00,,29.15,,"-129,785.23"
,IN,AR,30308754,1005,100,,Invoice,,,,,,15/02/2018,15/02/2018,0.00,,455.51,,"-130,240.74"
,CN,AR,31017364,1005,100,,Credit Note,,,,,,16/02/2018,16/02/2018,419.07,,0.00,,"-129,821.67"
,CN,AR,31017442,1005,100,,Credit Note,,,,,,16/02/2018,16/02/2018,461.44,,0.00,,"-129,360.23"
,CN,AR,31017443,1005,100,,Credit Note,,,,,,16/02/2018,16/02/2018,419.07,,0.00,,"-128,941.16"
,CS,AR,32000928,1005,100,,Cash sale,,,,,,16/02/2018,16/02/2018,0.00,,10.93,,"-128,952.09"
,CS,AR,32000939,1005,100,,Cash sale,,,,,,16/02/2018,16/02/2018,0.00,,22.37,,"-128,974.46"
,CS,AR,32000970,1005,100,,Cash sale,,,,,,16/02/2018,16/02/2018,0.00,,10.93,,"-128,985.39"
,CS,AR,32000981,1005,100,,Cash sale,,,,,,16/02/2018,16/02/2018,0.00,,14.58,,"-128,999.97"
,CS,AR,32000991,1005,100,,Cash sale,,,,,,16/02/2018,16/02/2018,0.00,,3.64,,"-129,003.61"
,CS,AR,32001010,1005,100,,Cash sale,,,,,,16/02/2018,16/02/2018,0.00,,14.49,,"-129,018.10"
,CS,AR,32001025,1005,100,,Cash sale,,,,,,16/02/2018,16/02/2018,0.00,,21.36,,"-129,039.46"
,CS,AR,32001038,1005,100,,Cash sale,,,,,,16/02/2018,16/02/2018,0.00,,16.61,,"-129,056.07"
,CS,AR,32001082,1005,100,,Cash sale,,,,,,16/02/2018,16/02/2018,0.00,,23.29,,"-129,079.36"
,CS,AR,32001123,1005,100,,Cash sale,,,,,,16/02/2018,16/02/2018,0.00,,4.78,,"-129,084.14"
,CS,AR,32001148,1005,100,,Cash sale,,,,,,16/02/2018,16/02/2018,0.00,,7.63,,"-129,091.77"
,CS,AR,32001174,1005,100,,Cash sale,,,,,,16/02/2018,16/02/2018,0.00,,21.98,,"-129,113.75"
,CS,AR,32001200,1005,100,,Cash sale,,,,,,16/02/2018,16/02/2018,0.00,,9.03,,"-129,122.78"
,CS,AR,32001227,1005,100,,Cash sale,,,,,,16/02/2018,16/02/2018,0.00,,12.71,,"-129,135.49"
,CS,AR,32001260,1005,100,,Cash sale,,,,,,16/02/2018,16/02/2018,0.00,,18.05,,"-129,153.54"
,CS,AR,32001277,1005,100,,Cash sale,,,,,,16/02/2018,16/02/2018,0.00,,7.29,,"-129,160.83"
,CS,AR,32001293,1005,100,,Cash sale,,,,,,16/02/2018,16/02/2018,0.00,,3.64,,"-129,164.47"
,CS,AR,32001335,1005,100,,Cash sale,,,,,,16/02/2018,16/02/2018,0.00,,3.64,,"-129,168.11"
,CS,AR,32001354,1005,100,,Cash sale,,,,,,16/02/2018,16/02/2018,0.00,,7.29,,"-129,175.40"
,CS,AR,32001428,1005,100,,Cash sale,,,,,,16/02/2018,16/02/2018,0.00,,7.29,,"-129,182.69"
,CS,AR,32001433,1005,100,,Cash sale,,,,,,16/02/2018,16/02/2018,0.00,,7.12,,"-129,189.81"
,CS,AR,32001440,1005,100,,Cash sale,,,,,,16/02/2018,16/02/2018,0.00,,21.90,,"-129,211.71"
,CS,AR,32001451,1005,100,,Cash sale,,,,,,16/02/2018,16/02/2018,0.00,,22.88,,"-129,234.59"
,CS,AR,32001463,1005,100,,Cash sale,,,,,,16/02/2018,16/02/2018,0.00,,14.58,,"-129,249.17"
,CS,AR,32001464,1005,100,,Cash sale,,,,,,16/02/2018,16/02/2018,0.00,,7.29,,"-129,256.46"
,CS,AR,32001466,1005,100,,Cash sale,,,,,,16/02/2018,16/02/2018,0.00,,7.29,,"-129,263.75"
,CS,AR,32001475,1005,100,,Cash sale,,,,,,16/02/2018,16/02/2018,0.00,,3.64,,"-129,267.39"
,CS,AR,32001478,1005,100,,Cash sale,,,,,,16/02/2018,16/02/2018,0.00,,15.25,,"-129,282.64"
,CS,AR,32001498,1005,100,,Cash sale,,,,,,16/02/2018,16/02/2018,0.00,,28.00,,"-129,310.64"
,CS,AR,32001505,1005,100,,Cash sale,,,,,,16/02/2018,16/02/2018,0.00,,12.71,,"-129,323.35"
,CS,AR,32001539,1005,100,,Cash sale,,,,,,16/02/2018,16/02/2018,0.00,,3.03,,"-129,326.38"
,CS,AR,32001550,1005,100,,Cash sale,,,,,,16/02/2018,16/02/2018,0.00,,10.93,,"-129,337.31"
,CS,AR,32001570,1005,100,,Cash sale,,,,,,16/02/2018,16/02/2018,0.00,,18.22,,"-129,355.53"
,CS,AR,32001595,1005,100,,Cash sale,,,,,,16/02/2018,16/02/2018,0.00,,14.58,,"-129,370.11"
,CS,AR,32001602,1005,100,,Cash sale,,,,,,16/02/2018,16/02/2018,0.00,,3.64,,"-129,373.75"
,CS,AR,32001607,1005,100,,Cash sale,,,,,,16/02/2018,16/02/2018,0.00,,9.15,,"-129,382.90"
,CS,AR,32001623,1005,100,,Cash sale,,,,,,16/02/2018,16/02/2018,0.00,,14.58,,"-129,397.48"
,CS,AR,32001660,1005,100,,Cash sale,,,,,,16/02/2018,16/02/2018,0.00,,7.29,,"-129,404.77"
,CS,AR,32001693,1005,100,,Cash sale,,,,,,16/02/2018,16/02/2018,0.00,,3.64,,"-129,408.41"
,IN,AR,30306683,1005,100,,Invoice,,,,,,16/02/2018,16/02/2018,0.00,,17.80,,"-129,426.21"
,IN,AR,30306691,1005,100,,Invoice,,,,,,16/02/2018,16/02/2018,0.00,,6.02,,"-129,432.23"
,IN,AR,30306694,1005,100,,Invoice,,,,,,16/02/2018,16/02/2018,0.00,,7.29,,"-129,439.52"
,IN,AR,30306704,1005,100,,Invoice,,,,,,16/02/2018,16/02/2018,0.00,,182.20,,"-129,621.72"
,IN,AR,30306713,1005,100,,Invoice,,,,,,16/02/2018,16/02/2018,0.00,,36.44,,"-129,658.16"
,IN,AR,30306728,1005,100,,Invoice,,,,,,16/02/2018,16/02/2018,0.00,,9.49,,"-129,667.65"
,IN,AR,30306764,1005,100,,Invoice,,,,,,16/02/2018,16/02/2018,0.00,,16.91,,"-129,684.56"
,IN,AR,30306772,1005,100,,Invoice,,,,,,16/02/2018,16/02/2018,0.00,,182.20,,"-129,866.76"
,IN,AR,30306784,1005,100,,Invoice,,,,,,16/02/2018,16/02/2018,0.00,,3.64,,"-129,870.40"
,IN,AR,30306813,1005,100,,Invoice,,,,,,16/02/2018,16/02/2018,0.00,,9.19,,"-129,879.59"
,IN,AR,30306819,1005,100,,Invoice,,,,,,16/02/2018,16/02/2018,0.00,,69.86,,"-129,949.45"
,IN,AR,30306838,1005,100,,Invoice,,,,,,16/02/2018,16/02/2018,0.00,,85.42,,"-130,034.87"
,IN,AR,30306859,1005,100,,Invoice,,,,,,16/02/2018,16/02/2018,0.00,,10.93,,"-130,045.80"
,IN,AR,30306866,1005,100,,Invoice,,,,,,16/02/2018,16/02/2018,0.00,,40.00,,"-130,085.80"
,IN,AR,30306876,1005,100,,Invoice,,,,,,16/02/2018,16/02/2018,0.00,,11.86,,"-130,097.66"
,IN,AR,30306910,1005,100,,Invoice,,,,,,16/02/2018,16/02/2018,0.00,,14.00,,"-130,111.66"
,IN,AR,30306955,1005,100,,Invoice,,,,,,16/02/2018,16/02/2018,0.00,,3.89,,"-130,115.55"
,IN,AR,30306981,1005,100,,Invoice,,,,,,16/02/2018,16/02/2018,0.00,,22.00,,"-130,137.55"
,IN,AR,30306985,1005,100,,Invoice,,,,,,16/02/2018,16/02/2018,0.00,,364.41,,"-130,501.96"
,IN,AR,30307031,1005,100,,Invoice,,,,,,16/02/2018,16/02/2018,0.00,,9.70,,"-130,511.66"
,IN,AR,30307060,1005,100,,Invoice,,,,,,16/02/2018,16/02/2018,0.00,,364.41,,"-130,876.07"
,IN,AR,30307063,1005,100,,Invoice,,,,,,16/02/2018,16/02/2018,0.00,,19.58,,"-130,895.65"
,IN,AR,30307134,1005,100,,Invoice,,,,,,16/02/2018,16/02/2018,0.00,,7.19,,"-130,902.84"
,IN,AR,30307135,1005,100,,Invoice,,,,,,16/02/2018,16/02/2018,0.00,,2.40,,"-130,905.24"
,IN,AR,30307201,1005,100,,Invoice,,,,,,16/02/2018,16/02/2018,0.00,,15.51,,"-130,920.75"
,IN,AR,30307207,1005,100,,Invoice,,,,,,16/02/2018,16/02/2018,0.00,,4.78,,"-130,925.53"
,IN,AR,30307217,1005,100,,Invoice,,,,,,16/02/2018,16/02/2018,0.00,,163.39,,"-131,088.92"
,IN,AR,30307248,1005,100,,Invoice,,,,,,16/02/2018,16/02/2018,0.00,,9.03,,"-131,097.95"
,IN,AR,30307260,1005,100,,Invoice,,,,,,16/02/2018,16/02/2018,0.00,,124.99,,"-131,222.94"
,IN,AR,30307274,1005,100,,Invoice,,,,,,16/02/2018,16/02/2018,0.00,,55.37,,"-131,278.31"
,IN,AR,30307280,1005,100,,Invoice,,,,,,16/02/2018,16/02/2018,0.00,,33.66,,"-131,311.97"
,IN,AR,30307290,1005,100,,Invoice,,,,,,16/02/2018,16/02/2018,0.00,,13.74,,"-131,325.71"
,IN,AR,30307312,1005,100,,Invoice,,,,,,16/02/2018,16/02/2018,0.00,,7.17,,"-131,332.88"
,IN,AR,30307430,1005,100,,Invoice,,,,,,16/02/2018,16/02/2018,0.00,,7.63,,"-131,340.51"
,IN,AR,30307441,1005,100,,Invoice,,,,,,16/02/2018,16/02/2018,0.00,,5.08,,"-131,345.59"
,IN,AR,30307444,1005,100,,Invoice,,,,,,16/02/2018,16/02/2018,0.00,,11.69,,"-131,357.28"
,IN,AR,30307518,1005,100,,Invoice,,,,,,16/02/2018,16/02/2018,0.00,,15.25,,"-131,372.53"
,IN,AR,30307544,1005,100,,Invoice,,,,,,16/02/2018,16/02/2018,0.00,,30.51,,"-131,403.04"
,IN,AR,30307583,1005,100,,Invoice,,,,,,16/02/2018,16/02/2018,0.00,,7.29,,"-131,410.33"
,IN,AR,30307599,1005,100,,Invoice,,,,,,16/02/2018,16/02/2018,0.00,,14.83,,"-131,425.16"
,IN,AR,30307609,1005,100,,Invoice,,,,,,16/02/2018,16/02/2018,0.00,,16.95,,"-131,442.11"
,IN,AR,30307648,1005,100,,Invoice,,,,,,16/02/2018,16/02/2018,0.00,,30.86,,"-131,472.97"
,IN,AR,30307689,1005,100,,Invoice,,,,,,16/02/2018,16/02/2018,0.00,,14.58,,"-131,487.55"
,IN,AR,30307713,1005,100,,Invoice,,,,,,16/02/2018,16/02/2018,0.00,,8.47,,"-131,496.02"
,IN,AR,30307748,1005,100,,Invoice,,,,,,16/02/2018,16/02/2018,0.00,,54.66,,"-131,550.68"
,IN,AR,30307759,1005,100,,Invoice,,,,,,16/02/2018,16/02/2018,0.00,,62.46,,"-131,613.14"
,IN,AR,30307765,1005,100,,Invoice,,,,,,16/02/2018,16/02/2018,0.00,,3.64,,"-131,616.78"
,IN,AR,30307834,1005,100,,Invoice,,,,,,16/02/2018,16/02/2018,0.00,,54.66,,"-131,671.44"
,IN,AR,30307869,1005,100,,Invoice,,,,,,16/02/2018,16/02/2018,0.00,,64.32,,"-131,735.76"
,IN,AR,30307879,1005,100,,Invoice,,,,,,16/02/2018,16/02/2018,0.00,,7.29,,"-131,743.05"
,IN,AR,30307915,1005,100,,Invoice,,,,,,16/02/2018,16/02/2018,0.00,,2.42,,"-131,745.47"
,IN,AR,30307923,1005,100,,Invoice,,,,,,16/02/2018,16/02/2018,0.00,,8.24,,"-131,753.71"
,IN,AR,30307924,1005,100,,Invoice,,,,,,16/02/2018,16/02/2018,0.00,,419.07,,"-132,172.78"
,IN,AR,30307934,1005,100,,Invoice,,,,,,16/02/2018,16/02/2018,0.00,,364.41,,"-132,537.19"
,IN,AR,30307940,1005,100,,Invoice,,,,,,16/02/2018,16/02/2018,0.00,,54.66,,"-132,591.85"
,IN,AR,30308066,1005,100,,Invoice,,,,,,16/02/2018,16/02/2018,0.00,,8.52,,"-132,600.37"
,IN,AR,30308071,1005,100,,Invoice,,,,,,16/02/2018,16/02/2018,0.00,,38.08,,"-132,638.45"
,IN,AR,30308080,1005,100,,Invoice,,,,,,16/02/2018,16/02/2018,0.00,,14.58,,"-132,653.03"
,IN,AR,30308093,1005,100,,Invoice,,,,,,16/02/2018,16/02/2018,0.00,,12.03,,"-132,665.06"
,IN,AR,30308134,1005,100,,Invoice,,,,,,16/02/2018,16/02/2018,0.00,,49.70,,"-132,714.76"
,IN,AR,30308194,1005,100,,Invoice,,,,,,16/02/2018,16/02/2018,0.00,,6.86,,"-132,721.62"
,IN,AR,30308206,1005,100,,Invoice,,,,,,16/02/2018,16/02/2018,0.00,,9.56,,"-132,731.18"
,IN,AR,30308224,1005,100,,Invoice,,,,,,16/02/2018,16/02/2018,0.00,,20.34,,"-132,751.52"
,IN,AR,30308239,1005,100,,Invoice,,,,,,16/02/2018,16/02/2018,0.00,,18.01,,"-132,769.53"
,IN,AR,30308250,1005,100,,Invoice,,,,,,16/02/2018,16/02/2018,0.00,,54.66,,"-132,824.19"
,IN,AR,30308252,1005,100,,Invoice,,,,,,16/02/2018,16/02/2018,0.00,,185.85,,"-133,010.04"
,IN,AR,30308288,1005,100,,Invoice,,,,,,16/02/2018,16/02/2018,0.00,,30.11,,"-133,040.15"
,IN,AR,30308294,1005,100,,Invoice,,,,,,16/02/2018,16/02/2018,0.00,,25.23,,"-133,065.38"
,IN,AR,30308334,1005,100,,Invoice,,,,,,16/02/2018,16/02/2018,0.00,,4.59,,"-133,069.97"
,IN,AR,30308354,1005,100,,Invoice,,,,,,16/02/2018,16/02/2018,0.00,,16.06,,"-133,086.03"
,IN,AR,30308361,1005,100,,Invoice,,,,,,16/02/2018,16/02/2018,0.00,,9.08,,"-133,095.11"
,IN,AR,30308367,1005,100,,Invoice,,,,,,16/02/2018,16/02/2018,0.00,,9.10,,"-133,104.21"
,IN,AR,30308481,1005,100,,Invoice,,,,,,16/02/2018,16/02/2018,0.00,,18.22,,"-133,122.43"
,IN,AR,30308507,1005,100,,Invoice,,,,,,16/02/2018,16/02/2018,0.00,,4.00,,"-133,126.43"
,IN,AR,30308593,1005,100,,Invoice,,,,,,16/02/2018,16/02/2018,0.00,,46.61,,"-133,173.04"
,IN,AR,30308644,1005,100,,Invoice,,,,,,16/02/2018,16/02/2018,0.00,,7.29,,"-133,180.33"
,IN,AR,30308670,1005,100,,Invoice,,,,,,16/02/2018,16/02/2018,0.00,,6.13,,"-133,186.46"
,IN,AR,30308721,1005,100,,Invoice,,,,,,16/02/2018,16/02/2018,0.00,,18.22,,"-133,204.68"
,IN,AR,30308741,1005,100,,Invoice,,,,,,16/02/2018,16/02/2018,0.00,,419.07,,"-133,623.75"
,IN,AR,30308742,1005,100,,Invoice,,,,,,16/02/2018,16/02/2018,0.00,,419.07,,"-134,042.82"
,IN,AR,30308756,1005,100,,Invoice,,,,,,16/02/2018,16/02/2018,0.00,,72.88,,"-134,115.70"
,IN,AR,30308758,1005,100,,Invoice,,,,,,16/02/2018,16/02/2018,0.00,,29.24,,"-134,144.94"
,CN,AR,31017218,1005,100,,Credit Note,,,,,,17/02/2018,17/02/2018,134.65,,0.00,,"-134,010.29"
,CN,AR,31017273,1005,100,,Credit Note,,,,,,17/02/2018,17/02/2018,494.54,,0.00,,"-133,515.75"
,CS,AR,32001004,1005,100,,Cash sale,,,,,,17/02/2018,17/02/2018,0.00,,10.93,,"-133,526.68"
,CS,AR,32001072,1005,100,,Cash sale,,,,,,17/02/2018,17/02/2018,0.00,,10.93,,"-133,537.61"
,CS,AR,32001193,1005,100,,Cash sale,,,,,,17/02/2018,17/02/2018,0.00,,3.64,,"-133,541.25"
,CS,AR,32001201,1005,100,,Cash sale,,,,,,17/02/2018,17/02/2018,0.00,,6.02,,"-133,547.27"
,CS,AR,32001276,1005,100,,Cash sale,,,,,,17/02/2018,17/02/2018,0.00,,3.64,,"-133,550.91"
,CS,AR,32001557,1005,100,,Cash sale,,,,,,17/02/2018,17/02/2018,0.00,,4.24,,"-133,555.15"
,IN,AR,30306760,1005,100,,Invoice,,,,,,17/02/2018,17/02/2018,0.00,,6.02,,"-133,561.17"
,IN,AR,30307034,1005,100,,Invoice,,,,,,17/02/2018,17/02/2018,0.00,,83.64,,"-133,644.81"
,IN,AR,30307261,1005,100,,Invoice,,,,,,17/02/2018,17/02/2018,0.00,,612.20,,"-134,257.01"
,IN,AR,30307373,1005,100,,Invoice,,,,,,17/02/2018,17/02/2018,0.00,,6.02,,"-134,263.03"
,IN,AR,30307799,1005,100,,Invoice,,,,,,17/02/2018,17/02/2018,0.00,,7.29,,"-134,270.32"
,IN,AR,30308331,1005,100,,Invoice,,,,,,17/02/2018,17/02/2018,0.00,,10.93,,"-134,281.25"
,IN,AR,30308573,1005,100,,Invoice,,,,,,17/02/2018,17/02/2018,0.00,,8.25,,"-134,289.50"
,IN,AR,30308702,1005,100,,Invoice,,,,,,17/02/2018,17/02/2018,0.00,,32.80,,"-134,322.30"
,CN,AR,31017323,1005,100,,Credit Note,,,,,,19/02/2018,19/02/2018,84.66,,0.00,,"-134,237.64"
,CN,AR,31017324,1005,100,,Credit Note,,,,,,19/02/2018,19/02/2018,22.88,,0.00,,"-134,214.76"
,CN,AR,31017406,1005,100,,Credit Note,,,,,,19/02/2018,19/02/2018,18.22,,0.00,,"-134,196.54"
,CS,AR,32000974,1005,100,,Cash sale,,,,,,19/02/2018,19/02/2018,0.00,,7.29,,"-134,203.83"
,CS,AR,32000998,1005,100,,Cash sale,,,,,,19/02/2018,19/02/2018,0.00,,3.64,,"-134,207.47"
,CS,AR,32001039,1005,100,,Cash sale,,,,,,19/02/2018,19/02/2018,0.00,,8.31,,"-134,215.78"
,CS,AR,32001048,1005,100,,Cash sale,,,,,,19/02/2018,19/02/2018,0.00,,7.29,,"-134,223.07"
,CS,AR,32001060,1005,100,,Cash sale,,,,,,19/02/2018,19/02/2018,0.00,,14.62,,"-134,237.69"
,CS,AR,32001086,1005,100,,Cash sale,,,,,,19/02/2018,19/02/2018,0.00,,14.58,,"-134,252.27"
,CS,AR,32001111,1005,100,,Cash sale,,,,,,19/02/2018,19/02/2018,0.00,,10.34,,"-134,262.61"
,CS,AR,32001133,1005,100,,Cash sale,,,,,,19/02/2018,19/02/2018,0.00,,3.64,,"-134,266.25"
,CS,AR,32001149,1005,100,,Cash sale,,,,,,19/02/2018,19/02/2018,0.00,,7.63,,"-134,273.88"
,CS,AR,32001170,1005,100,,Cash sale,,,,,,19/02/2018,19/02/2018,0.00,,31.02,,"-134,304.90"
,CS,AR,32001198,1005,100,,Cash sale,,,,,,19/02/2018,19/02/2018,0.00,,3.64,,"-134,308.54"
,CS,AR,32001210,1005,100,,Cash sale,,,,,,19/02/2018,19/02/2018,0.00,,7.29,,"-134,315.83"
,CS,AR,32001228,1005,100,,Cash sale,,,,,,19/02/2018,19/02/2018,0.00,,7.63,,"-134,323.46"
,CS,AR,32001246,1005,100,,Cash sale,,,,,,19/02/2018,19/02/2018,0.00,,8.16,,"-134,331.62"
,CS,AR,32001249,1005,100,,Cash sale,,,,,,19/02/2018,19/02/2018,0.00,,3.64,,"-134,335.26"
,CS,AR,32001272,1005,100,,Cash sale,,,,,,19/02/2018,19/02/2018,0.00,,7.29,,"-134,342.55"
,CS,AR,32001311,1005,100,,Cash sale,,,,,,19/02/2018,19/02/2018,0.00,,5.25,,"-134,347.80"
,CS,AR,32001348,1005,100,,Cash sale,,,,,,19/02/2018,19/02/2018,0.00,,7.29,,"-134,355.09"
,CS,AR,32001380,1005,100,,Cash sale,,,,,,19/02/2018,19/02/2018,0.00,,11.11,,"-134,366.20"
,CS,AR,32001382,1005,100,,Cash sale,,,,,,19/02/2018,19/02/2018,0.00,,12.03,,"-134,378.23"
,CS,AR,32001390,1005,100,,Cash sale,,,,,,19/02/2018,19/02/2018,0.00,,5.17,,"-134,383.40"
,CS,AR,32001401,1005,100,,Cash sale,,,,,,19/02/2018,19/02/2018,0.00,,12.17,,"-134,395.57"
,CS,AR,32001429,1005,100,,Cash sale,,,,,,19/02/2018,19/02/2018,0.00,,10.93,,"-134,406.50"
,CS,AR,32001459,1005,100,,Cash sale,,,,,,19/02/2018,19/02/2018,0.00,,25.51,,"-134,432.01"
,CS,AR,32001469,1005,100,,Cash sale,,,,,,19/02/2018,19/02/2018,0.00,,7.29,,"-134,439.30"
,CS,AR,32001515,1005,100,,Cash sale,,,,,,19/02/2018,19/02/2018,0.00,,6.56,,"-134,445.86"
,CS,AR,32001579,1005,100,,Cash sale,,,,,,19/02/2018,19/02/2018,0.00,,7.29,,"-134,453.15"
,CS,AR,32001596,1005,100,,Cash sale,,,,,,19/02/2018,19/02/2018,0.00,,10.93,,"-134,464.08"
,CS,AR,32001639,1005,100,,Cash sale,,,,,,19/02/2018,19/02/2018,0.00,,18.22,,"-134,482.30"
,IN,AR,30306684,1005,100,,Invoice,,,,,,19/02/2018,19/02/2018,0.00,,65.25,,"-134,547.55"
,IN,AR,30306702,1005,100,,Invoice,,,,,,19/02/2018,19/02/2018,0.00,,7.29,,"-134,554.84"
,IN,AR,30306729,1005,100,,Invoice,,,,,,19/02/2018,19/02/2018,0.00,,4.75,,"-134,559.59"
,IN,AR,30306791,1005,100,,Invoice,,,,,,19/02/2018,19/02/2018,0.00,,50.73,,"-134,610.32"
,IN,AR,30306839,1005,100,,Invoice,,,,,,19/02/2018,19/02/2018,0.00,,121.02,,"-134,731.34"
,IN,AR,30306850,1005,100,,Invoice,,,,,,19/02/2018,19/02/2018,0.00,,2.75,,"-134,734.09"
,IN,AR,30306867,1005,100,,Invoice,,,,,,19/02/2018,19/02/2018,0.00,,50.00,,"-134,784.09"
,IN,AR,30306911,1005,100,,Invoice,,,,,,19/02/2018,19/02/2018,0.00,,30.00,,"-134,814.09"
,IN,AR,30306912,1005,100,,Invoice,,,,,,19/02/2018,19/02/2018,0.00,,26.00,,"-134,840.09"
,IN,AR,30306930,1005,100,,Invoice,,,,,,19/02/2018,19/02/2018,0.00,,2.75,,"-134,842.84"
,IN,AR,30306935,1005,100,,Invoice,,,,,,19/02/2018,19/02/2018,0.00,,17.80,,"-134,860.64"
,IN,AR,30306939,1005,100,,Invoice,,,,,,19/02/2018,19/02/2018,0.00,,2.75,,"-134,863.39"
,IN,AR,30306946,1005,100,,Invoice,,,,,,19/02/2018,19/02/2018,0.00,,3.64,,"-134,867.03"
,IN,AR,30307067,1005,100,,Invoice,,,,,,19/02/2018,19/02/2018,0.00,,8.05,,"-134,875.08"
,IN,AR,30307080,1005,100,,Invoice,,,,,,19/02/2018,19/02/2018,0.00,,28.39,,"-134,903.47"
,IN,AR,30307085,1005,100,,Invoice,,,,,,19/02/2018,19/02/2018,0.00,,10.93,,"-134,914.40"
,IN,AR,30307095,1005,100,,Invoice,,,,,,19/02/2018,19/02/2018,0.00,,11.15,,"-134,925.55"
,IN,AR,30307116,1005,100,,Invoice,,,,,,19/02/2018,19/02/2018,0.00,,5.17,,"-134,930.72"
,IN,AR,30307130,1005,100,,Invoice,,,,,,19/02/2018,19/02/2018,0.00,,7.29,,"-134,938.01"
,IN,AR,30307141,1005,100,,Invoice,,,,,,19/02/2018,19/02/2018,0.00,,6.89,,"-134,944.90"
,IN,AR,30307149,1005,100,,Invoice,,,,,,19/02/2018,19/02/2018,0.00,,2.63,,"-134,947.53"
,IN,AR,30307202,1005,100,,Invoice,,,,,,19/02/2018,19/02/2018,0.00,,15.51,,"-134,963.04"
,IN,AR,30307240,1005,100,,Invoice,,,,,,19/02/2018,19/02/2018,0.00,,7.29,,"-134,970.33"
,IN,AR,30307275,1005,100,,Invoice,,,,,,19/02/2018,19/02/2018,0.00,,90.24,,"-135,060.57"
,IN,AR,30307286,1005,100,,Invoice,,,,,,19/02/2018,19/02/2018,0.00,,30.51,,"-135,091.08"
,IN,AR,30307313,1005,100,,Invoice,,,,,,19/02/2018,19/02/2018,0.00,,26.29,,"-135,117.37"
,IN,AR,30307335,1005,100,,Invoice,,,,,,19/02/2018,19/02/2018,0.00,,9.03,,"-135,126.40"
,IN,AR,30307355,1005,100,,Invoice,,,,,,19/02/2018,19/02/2018,0.00,,5.51,,"-135,131.91"
,IN,AR,30307431,1005,100,,Invoice,,,,,,19/02/2018,19/02/2018,0.00,,10.17,,"-135,142.08"
,IN,AR,30307470,1005,100,,Invoice,,,,,,19/02/2018,19/02/2018,0.00,,29.15,,"-135,171.23"
,IN,AR,30307545,1005,100,,Invoice,,,,,,19/02/2018,19/02/2018,0.00,,20.34,,"-135,191.57"
,IN,AR,30307556,1005,100,,Invoice,,,,,,19/02/2018,19/02/2018,0.00,,30.51,,"-135,222.08"
,IN,AR,30307592,1005,100,,Invoice,,,,,,19/02/2018,19/02/2018,0.00,,10.93,,"-135,233.01"
,IN,AR,30307617,1005,100,,Invoice,,,,,,19/02/2018,19/02/2018,0.00,,8.26,,"-135,241.27"
,IN,AR,30307625,1005,100,,Invoice,,,,,,19/02/2018,19/02/2018,0.00,,16.53,,"-135,257.80"
,IN,AR,30307649,1005,100,,Invoice,,,,,,19/02/2018,19/02/2018,0.00,,19.64,,"-135,277.44"
,IN,AR,30307655,1005,100,,Invoice,,,,,,19/02/2018,19/02/2018,0.00,,2.54,,"-135,279.98"
,IN,AR,30307719,1005,100,,Invoice,,,,,,19/02/2018,19/02/2018,0.00,,41.49,,"-135,321.47"
,IN,AR,30307735,1005,100,,Invoice,,,,,,19/02/2018,19/02/2018,0.00,,22.00,,"-135,343.47"
,IN,AR,30307743,1005,100,,Invoice,,,,,,19/02/2018,19/02/2018,0.00,,29.15,,"-135,372.62"
,IN,AR,30307784,1005,100,,Invoice,,,,,,19/02/2018,19/02/2018,0.00,,5.17,,"-135,377.79"
,IN,AR,30307801,1005,100,,Invoice,,,,,,19/02/2018,19/02/2018,0.00,,52.53,,"-135,430.32"
,IN,AR,30307805,1005,100,,Invoice,,,,,,19/02/2018,19/02/2018,0.00,,3.64,,"-135,433.96"
,IN,AR,30307826,1005,100,,Invoice,,,,,,19/02/2018,19/02/2018,0.00,,9.62,,"-135,443.58"
,IN,AR,30307856,1005,100,,Invoice,,,,,,19/02/2018,19/02/2018,0.00,,42.12,,"-135,485.70"
,IN,AR,30307870,1005,100,,Invoice,,,,,,19/02/2018,19/02/2018,0.00,,64.32,,"-135,550.02"
,IN,AR,30307906,1005,100,,Invoice,,,,,,19/02/2018,19/02/2018,0.00,,7.29,,"-135,557.31"
,IN,AR,30307928,1005,100,,Invoice,,,,,,19/02/2018,19/02/2018,0.00,,10.93,,"-135,568.24"
,IN,AR,30307969,1005,100,,Invoice,,,,,,19/02/2018,19/02/2018,0.00,,6.43,,"-135,574.67"
,IN,AR,30308045,1005,100,,Invoice,,,,,,19/02/2018,19/02/2018,0.00,,9.74,,"-135,584.41"
,IN,AR,30308050,1005,100,,Invoice,,,,,,19/02/2018,19/02/2018,0.00,,36.91,,"-135,621.32"
,IN,AR,30308072,1005,100,,Invoice,,,,,,19/02/2018,19/02/2018,0.00,,16.03,,"-135,637.35"
,IN,AR,30308075,1005,100,,Invoice,,,,,,19/02/2018,19/02/2018,0.00,,7.29,,"-135,644.64"
,IN,AR,30308135,1005,100,,Invoice,,,,,,19/02/2018,19/02/2018,0.00,,9.62,,"-135,654.26"
,IN,AR,30308161,1005,100,,Invoice,,,,,,19/02/2018,19/02/2018,0.00,,26.27,,"-135,680.53"
,IN,AR,30308188,1005,100,,Invoice,,,,,,19/02/2018,19/02/2018,0.00,,6.56,,"-135,687.09"
,IN,AR,30308195,1005,100,,Invoice,,,,,,19/02/2018,19/02/2018,0.00,,11.44,,"-135,698.53"
,IN,AR,30308235,1005,100,,Invoice,,,,,,19/02/2018,19/02/2018,0.00,,14.00,,"-135,712.53"
,IN,AR,30308300,1005,100,,Invoice,,,,,,19/02/2018,19/02/2018,0.00,,14.58,,"-135,727.11"
,IN,AR,30308310,1005,100,,Invoice,,,,,,19/02/2018,19/02/2018,0.00,,36.24,,"-135,763.35"
,IN,AR,30308327,1005,100,,Invoice,,,,,,19/02/2018,19/02/2018,0.00,,5.61,,"-135,768.96"
,IN,AR,30308410,1005,100,,Invoice,,,,,,19/02/2018,19/02/2018,0.00,,29.15,,"-135,798.11"
,IN,AR,30308421,1005,100,,Invoice,,,,,,19/02/2018,19/02/2018,0.00,,21.86,,"-135,819.97"
,IN,AR,30308430,1005,100,,Invoice,,,,,,19/02/2018,19/02/2018,0.00,,26.69,,"-135,846.66"
,IN,AR,30308457,1005,100,,Invoice,,,,,,19/02/2018,19/02/2018,0.00,,19.12,,"-135,865.78"
,IN,AR,30308471,1005,100,,Invoice,,,,,,19/02/2018,19/02/2018,0.00,,378.98,,"-136,244.76"
,IN,AR,30308472,1005,100,,Invoice,,,,,,19/02/2018,19/02/2018,0.00,,25.51,,"-136,270.27"
,IN,AR,30308508,1005,100,,Invoice,,,,,,19/02/2018,19/02/2018,0.00,,10.00,,"-136,280.27"
,IN,AR,30308540,1005,100,,Invoice,,,,,,19/02/2018,19/02/2018,0.00,,11.36,,"-136,291.63"
,IN,AR,30308560,1005,100,,Invoice,,,,,,19/02/2018,19/02/2018,0.00,,13.12,,"-136,304.75"
,IN,AR,30308655,1005,100,,Invoice,,,,,,19/02/2018,19/02/2018,0.00,,8.77,,"-136,313.52"
,IN,AR,30308671,1005,100,,Invoice,,,,,,19/02/2018,19/02/2018,0.00,,6.13,,"-136,319.65"
,IN,AR,30308681,1005,100,,Invoice,,,,,,19/02/2018,19/02/2018,0.00,,182.20,,"-136,501.85"
,IN,AR,30308690,1005,100,,Invoice,,,,,,19/02/2018,19/02/2018,0.00,,25.51,,"-136,527.36"
,IN,AR,30308703,1005,100,,Invoice,,,,,,19/02/2018,19/02/2018,0.00,,18.22,,"-136,545.58"
,IN,AR,30308766,1005,100,,Invoice,,,,,,19/02/2018,19/02/2018,0.00,,9.15,,"-136,554.73"
,IN,AR,30308767,1005,100,,Invoice,,,,,,19/02/2018,19/02/2018,0.00,,13.73,,"-136,568.46"
,IN,AR,30308768,1005,100,,Invoice,,,,,,19/02/2018,19/02/2018,0.00,,11.44,,"-136,579.90"
,IN,AR,30308769,1005,100,,Invoice,,,,,,19/02/2018,19/02/2018,0.00,,13.73,,"-136,593.63"
,IN,AR,30308770,1005,100,,Invoice,,,,,,19/02/2018,19/02/2018,0.00,,22.88,,"-136,616.51"
,IN,AR,30308771,1005,100,,Invoice,,,,,,19/02/2018,19/02/2018,0.00,,11.44,,"-136,627.95"
,IN,AR,30308772,1005,100,,Invoice,,,,,,19/02/2018,19/02/2018,0.00,,9.15,,"-136,637.10"
,IN,AR,30308773,1005,100,,Invoice,,,,,,19/02/2018,19/02/2018,0.00,,16.02,,"-136,653.12"
,IN,AR,30308774,1005,100,,Invoice,,,,,,19/02/2018,19/02/2018,0.00,,29.15,,"-136,682.27"
,CS,AR,32000943,1005,100,,Cash sale,,,,,,20/02/2018,20/02/2018,0.00,,3.64,,"-136,685.91"
,CS,AR,32000964,1005,100,,Cash sale,,,,,,20/02/2018,20/02/2018,0.00,,10.93,,"-136,696.84"
,CS,AR,32000980,1005,100,,Cash sale,,,,,,20/02/2018,20/02/2018,0.00,,7.29,,"-136,704.13"
,CS,AR,32001014,1005,100,,Cash sale,,,,,,20/02/2018,20/02/2018,0.00,,3.01,,"-136,707.14"
,CS,AR,32001021,1005,100,,Cash sale,,,,,,20/02/2018,20/02/2018,0.00,,7.29,,"-136,714.43"
,CS,AR,32001031,1005,100,,Cash sale,,,,,,20/02/2018,20/02/2018,0.00,,3.64,,"-136,718.07"
,CS,AR,32001069,1005,100,,Cash sale,,,,,,20/02/2018,20/02/2018,0.00,,18.22,,"-136,736.29"
,CS,AR,32001078,1005,100,,Cash sale,,,,,,20/02/2018,20/02/2018,0.00,,7.29,,"-136,743.58"
,CS,AR,32001091,1005,100,,Cash sale,,,,,,20/02/2018,20/02/2018,0.00,,3.64,,"-136,747.22"
,CS,AR,32001117,1005,100,,Cash sale,,,,,,20/02/2018,20/02/2018,0.00,,10.17,,"-136,757.39"
,CS,AR,32001120,1005,100,,Cash sale,,,,,,20/02/2018,20/02/2018,0.00,,3.64,,"-136,761.03"
,CS,AR,32001128,1005,100,,Cash sale,,,,,,20/02/2018,20/02/2018,0.00,,2.16,,"-136,763.19"
,CS,AR,32001156,1005,100,,Cash sale,,,,,,20/02/2018,20/02/2018,0.00,,10.34,,"-136,773.53"
,CS,AR,32001160,1005,100,,Cash sale,,,,,,20/02/2018,20/02/2018,0.00,,11.36,,"-136,784.89"
,CS,AR,32001212,1005,100,,Cash sale,,,,,,20/02/2018,20/02/2018,0.00,,6.86,,"-136,791.75"
,CS,AR,32001261,1005,100,,Cash sale,,,,,,20/02/2018,20/02/2018,0.00,,33.09,,"-136,824.84"
,CS,AR,32001264,1005,100,,Cash sale,,,,,,20/02/2018,20/02/2018,0.00,,21.61,,"-136,846.45"
,CS,AR,32001270,1005,100,,Cash sale,,,,,,20/02/2018,20/02/2018,0.00,,5.85,,"-136,852.30"
,CS,AR,32001304,1005,100,,Cash sale,,,,,,20/02/2018,20/02/2018,0.00,,7.75,,"-136,860.05"
,CS,AR,32001316,1005,100,,Cash sale,,,,,,20/02/2018,20/02/2018,0.00,,3.64,,"-136,863.69"
,CS,AR,32001319,1005,100,,Cash sale,,,,,,20/02/2018,20/02/2018,0.00,,7.75,,"-136,871.44"
,CS,AR,32001325,1005,100,,Cash sale,,,,,,20/02/2018,20/02/2018,0.00,,7.63,,"-136,879.07"
,CS,AR,32001332,1005,100,,Cash sale,,,,,,20/02/2018,20/02/2018,0.00,,3.64,,"-136,882.71"
,CS,AR,32001337,1005,100,,Cash sale,,,,,,20/02/2018,20/02/2018,0.00,,8.77,,"-136,891.48"
,CS,AR,32001389,1005,100,,Cash sale,,,,,,20/02/2018,20/02/2018,0.00,,7.29,,"-136,898.77"
,CS,AR,32001407,1005,100,,Cash sale,,,,,,20/02/2018,20/02/2018,0.00,,10.93,,"-136,909.70"
,CS,AR,32001412,1005,100,,Cash sale,,,,,,20/02/2018,20/02/2018,0.00,,15.01,,"-136,924.71"
,CS,AR,32001421,1005,100,,Cash sale,,,,,,20/02/2018,20/02/2018,0.00,,5.64,,"-136,930.35"
,CS,AR,32001454,1005,100,,Cash sale,,,,,,20/02/2018,20/02/2018,0.00,,15.04,,"-136,945.39"
,CS,AR,32001472,1005,100,,Cash sale,,,,,,20/02/2018,20/02/2018,0.00,,5.17,,"-136,950.56"
,CS,AR,32001494,1005,100,,Cash sale,,,,,,20/02/2018,20/02/2018,0.00,,30.00,,"-136,980.56"
,CS,AR,32001507,1005,100,,Cash sale,,,,,,20/02/2018,20/02/2018,0.00,,3.64,,"-136,984.20"
,CS,AR,32001521,1005,100,,Cash sale,,,,,,20/02/2018,20/02/2018,0.00,,2.74,,"-136,986.94"
,CS,AR,32001563,1005,100,,Cash sale,,,,,,20/02/2018,20/02/2018,0.00,,2.75,,"-136,989.69"
,CS,AR,32001567,1005,100,,Cash sale,,,,,,20/02/2018,20/02/2018,0.00,,14.58,,"-137,004.27"
,CS,AR,32001589,1005,100,,Cash sale,,,,,,20/02/2018,20/02/2018,0.00,,5.47,,"-137,009.74"
,CS,AR,32001616,1005,100,,Cash sale,,,,,,20/02/2018,20/02/2018,0.00,,6.56,,"-137,016.30"
,CS,AR,32001634,1005,100,,Cash sale,,,,,,20/02/2018,20/02/2018,0.00,,10.93,,"-137,027.23"
,CS,AR,32001650,1005,100,,Cash sale,,,,,,20/02/2018,20/02/2018,0.00,,10.93,,"-137,038.16"
,CS,AR,32001652,1005,100,,Cash sale,,,,,,20/02/2018,20/02/2018,0.00,,14.58,,"-137,052.74"
,IN,AR,30306726,1005,100,,Invoice,,,,,,20/02/2018,20/02/2018,0.00,,54.95,,"-137,107.69"
,IN,AR,30306745,1005,100,,Invoice,,,,,,20/02/2018,20/02/2018,0.00,,54.66,,"-137,162.35"
,IN,AR,30306750,1005,100,,Invoice,,,,,,20/02/2018,20/02/2018,0.00,,7.29,,"-137,169.64"
,IN,AR,30306777,1005,100,,Invoice,,,,,,20/02/2018,20/02/2018,0.00,,7.29,,"-137,176.93"
,IN,AR,30306781,1005,100,,Invoice,,,,,,20/02/2018,20/02/2018,0.00,,3.50,,"-137,180.43"
,IN,AR,30306800,1005,100,,Invoice,,,,,,20/02/2018,20/02/2018,0.00,,7.29,,"-137,187.72"
,IN,AR,30306840,1005,100,,Invoice,,,,,,20/02/2018,20/02/2018,0.00,,28.47,,"-137,216.19"
,IN,AR,30306854,1005,100,,Invoice,,,,,,20/02/2018,20/02/2018,0.00,,10.93,,"-137,227.12"
,IN,AR,30306879,1005,100,,Invoice,,,,,,20/02/2018,20/02/2018,0.00,,10.93,,"-137,238.05"
,IN,AR,30306887,1005,100,,Invoice,,,,,,20/02/2018,20/02/2018,0.00,,38.18,,"-137,276.23"
,IN,AR,30306922,1005,100,,Invoice,,,,,,20/02/2018,20/02/2018,0.00,,14.24,,"-137,290.47"
,IN,AR,30306925,1005,100,,Invoice,,,,,,20/02/2018,20/02/2018,0.00,,7.29,,"-137,297.76"
,IN,AR,30306956,1005,100,,Invoice,,,,,,20/02/2018,20/02/2018,0.00,,3.89,,"-137,301.65"
,IN,AR,30307005,1005,100,,Invoice,,,,,,20/02/2018,20/02/2018,0.00,,14.58,,"-137,316.23"
,IN,AR,30307025,1005,100,,Invoice,,,,,,20/02/2018,20/02/2018,0.00,,10.34,,"-137,326.57"
,IN,AR,30307049,1005,100,,Invoice,,,,,,20/02/2018,20/02/2018,0.00,,8.25,,"-137,334.82"
,IN,AR,30307136,1005,100,,Invoice,,,,,,20/02/2018,20/02/2018,0.00,,16.79,,"-137,351.61"
,IN,AR,30307151,1005,100,,Invoice,,,,,,20/02/2018,20/02/2018,0.00,,25.42,,"-137,377.03"
,IN,AR,30307160,1005,100,,Invoice,,,,,,20/02/2018,20/02/2018,0.00,,4.32,,"-137,381.35"
,IN,AR,30307164,1005,100,,Invoice,,,,,,20/02/2018,20/02/2018,0.00,,12.71,,"-137,394.06"
,IN,AR,30307190,1005,100,,Invoice,,,,,,20/02/2018,20/02/2018,0.00,,8.47,,"-137,402.53"
,IN,AR,30307223,1005,100,,Invoice,,,,,,20/02/2018,20/02/2018,0.00,,5.93,,"-137,408.46"
,IN,AR,30307235,1005,100,,Invoice,,,,,,20/02/2018,20/02/2018,0.00,,3.90,,"-137,412.36"
,IN,AR,30307263,1005,100,,Invoice,,,,,,20/02/2018,20/02/2018,0.00,,11.69,,"-137,424.05"
,IN,AR,30307291,1005,100,,Invoice,,,,,,20/02/2018,20/02/2018,0.00,,10.99,,"-137,435.04"
,IN,AR,30307320,1005,100,,Invoice,,,,,,20/02/2018,20/02/2018,0.00,,6.44,,"-137,441.48"
,IN,AR,30307321,1005,100,,Invoice,,,,,,20/02/2018,20/02/2018,0.00,,16.10,,"-137,457.58"
,IN,AR,30307353,1005,100,,Invoice,,,,,,20/02/2018,20/02/2018,0.00,,9.03,,"-137,466.61"
,IN,AR,30307371,1005,100,,Invoice,,,,,,20/02/2018,20/02/2018,0.00,,44.93,,"-137,511.54"
,IN,AR,30307417,1005,100,,Invoice,,,,,,20/02/2018,20/02/2018,0.00,,5.85,,"-137,517.39"
,IN,AR,30307445,1005,100,,Invoice,,,,,,20/02/2018,20/02/2018,0.00,,29.24,,"-137,546.63"
,IN,AR,30307479,1005,100,,Invoice,,,,,,20/02/2018,20/02/2018,0.00,,17.80,,"-137,564.43"
,IN,AR,30307520,1005,100,,Invoice,,,,,,20/02/2018,20/02/2018,0.00,,7.29,,"-137,571.72"
,IN,AR,30307525,1005,100,,Invoice,,,,,,20/02/2018,20/02/2018,0.00,,7.29,,"-137,579.01"
,IN,AR,30307532,1005,100,,Invoice,,,,,,20/02/2018,20/02/2018,0.00,,11.19,,"-137,590.20"
,IN,AR,30307538,1005,100,,Invoice,,,,,,20/02/2018,20/02/2018,0.00,,51.61,,"-137,641.81"
,IN,AR,30307563,1005,100,,Invoice,,,,,,20/02/2018,20/02/2018,0.00,,11.57,,"-137,653.38"
,IN,AR,30307573,1005,100,,Invoice,,,,,,20/02/2018,20/02/2018,0.00,,10.17,,"-137,663.55"
,IN,AR,30307576,1005,100,,Invoice,,,,,,20/02/2018,20/02/2018,0.00,,3.90,,"-137,667.45"
,IN,AR,30307579,1005,100,,Invoice,,,,,,20/02/2018,20/02/2018,0.00,,10.53,,"-137,677.98"
,IN,AR,30307601,1005,100,,Invoice,,,,,,20/02/2018,20/02/2018,0.00,,8.47,,"-137,686.45"
,IN,AR,30307621,1005,100,,Invoice,,,,,,20/02/2018,20/02/2018,0.00,,12.71,,"-137,699.16"
,IN,AR,30307629,1005,100,,Invoice,,,,,,20/02/2018,20/02/2018,0.00,,3.64,,"-137,702.80"
,IN,AR,30307642,1005,100,,Invoice,,,,,,20/02/2018,20/02/2018,0.00,,6.89,,"-137,709.69"
,IN,AR,30307657,1005,100,,Invoice,,,,,,20/02/2018,20/02/2018,0.00,,4.24,,"-137,713.93"
,IN,AR,30307679,1005,100,,Invoice,,,,,,20/02/2018,20/02/2018,0.00,,14.58,,"-137,728.51"
,IN,AR,30307715,1005,100,,Invoice,,,,,,20/02/2018,20/02/2018,0.00,,27.97,,"-137,756.48"
,IN,AR,30307739,1005,100,,Invoice,,,,,,20/02/2018,20/02/2018,0.00,,21.05,,"-137,777.53"
,IN,AR,30307775,1005,100,,Invoice,,,,,,20/02/2018,20/02/2018,0.00,,8.26,,"-137,785.79"
,IN,AR,30307787,1005,100,,Invoice,,,,,,20/02/2018,20/02/2018,0.00,,11.70,,"-137,797.49"
,IN,AR,30307794,1005,100,,Invoice,,,,,,20/02/2018,20/02/2018,0.00,,5.68,,"-137,803.17"
,IN,AR,30307795,1005,100,,Invoice,,,,,,20/02/2018,20/02/2018,0.00,,2.84,,"-137,806.01"
,IN,AR,30307810,1005,100,,Invoice,,,,,,20/02/2018,20/02/2018,0.00,,5.17,,"-137,811.18"
,IN,AR,30307811,1005,100,,Invoice,,,,,,20/02/2018,20/02/2018,0.00,,51.02,,"-137,862.20"
,IN,AR,30307815,1005,100,,Invoice,,,,,,20/02/2018,20/02/2018,0.00,,2.25,,"-137,864.45"
,IN,AR,30307831,1005,100,,Invoice,,,,,,20/02/2018,20/02/2018,0.00,,29.15,,"-137,893.60"
,IN,AR,30307852,1005,100,,Invoice,,,,,,20/02/2018,20/02/2018,0.00,,7.29,,"-137,900.89"
,IN,AR,30307871,1005,100,,Invoice,,,,,,20/02/2018,20/02/2018,0.00,,32.16,,"-137,933.05"
,IN,AR,30307884,1005,100,,Invoice,,,,,,20/02/2018,20/02/2018,0.00,,19.70,,"-137,952.75"
,IN,AR,30307896,1005,100,,Invoice,,,,,,20/02/2018,20/02/2018,0.00,,7.05,,"-137,959.80"
,IN,AR,30307925,1005,100,,Invoice,,,,,,20/02/2018,20/02/2018,0.00,,10.34,,"-137,970.14"
,IN,AR,30307943,1005,100,,Invoice,,,,,,20/02/2018,20/02/2018,0.00,,10.93,,"-137,981.07"
,IN,AR,30308037,1005,100,,Invoice,,,,,,20/02/2018,20/02/2018,0.00,,1.59,,"-137,982.66"
,IN,AR,30308038,1005,100,,Invoice,,,,,,20/02/2018,20/02/2018,0.00,,23.85,,"-138,006.51"
,IN,AR,30308102,1005,100,,Invoice,,,,,,20/02/2018,20/02/2018,0.00,,198.97,,"-138,205.48"
,IN,AR,30308136,1005,100,,Invoice,,,,,,20/02/2018,20/02/2018,0.00,,4.81,,"-138,210.29"
,IN,AR,30308156,1005,100,,Invoice,,,,,,20/02/2018,20/02/2018,0.00,,13.12,,"-138,223.41"
,IN,AR,30308167,1005,100,,Invoice,,,,,,20/02/2018,20/02/2018,0.00,,2.29,,"-138,225.70"
,IN,AR,30308172,1005,100,,Invoice,,,,,,20/02/2018,20/02/2018,0.00,,54.66,,"-138,280.36"
,IN,AR,30308178,1005,100,,Invoice,,,,,,20/02/2018,20/02/2018,0.00,,13.12,,"-138,293.48"
,IN,AR,30308211,1005,100,,Invoice,,,,,,20/02/2018,20/02/2018,0.00,,11.86,,"-138,305.34"
,IN,AR,30308225,1005,100,,Invoice,,,,,,20/02/2018,20/02/2018,0.00,,25.42,,"-138,330.76"
,IN,AR,30308268,1005,100,,Invoice,,,,,,20/02/2018,20/02/2018,0.00,,51.10,,"-138,381.86"
,IN,AR,30308275,1005,100,,Invoice,,,,,,20/02/2018,20/02/2018,0.00,,40.73,,"-138,422.59"
,IN,AR,30308315,1005,100,,Invoice,,,,,,20/02/2018,20/02/2018,0.00,,116.53,,"-138,539.12"
,IN,AR,30308320,1005,100,,Invoice,,,,,,20/02/2018,20/02/2018,0.00,,8.21,,"-138,547.33"
,IN,AR,30308359,1005,100,,Invoice,,,,,,20/02/2018,20/02/2018,0.00,,164.00,,"-138,711.33"
,IN,AR,30308363,1005,100,,Invoice,,,,,,20/02/2018,20/02/2018,0.00,,15.17,,"-138,726.50"
,IN,AR,30308373,1005,100,,Invoice,,,,,,20/02/2018,20/02/2018,0.00,,4.08,,"-138,730.58"
,IN,AR,30308393,1005,100,,Invoice,,,,,,20/02/2018,20/02/2018,0.00,,18.98,,"-138,749.56"
,IN,AR,30308404,1005,100,,Invoice,,,,,,20/02/2018,20/02/2018,0.00,,3.64,,"-138,753.20"
,IN,AR,30308418,1005,100,,Invoice,,,,,,20/02/2018,20/02/2018,0.00,,7.63,,"-138,760.83"
,IN,AR,30308468,1005,100,,Invoice,,,,,,20/02/2018,20/02/2018,0.00,,84.07,,"-138,844.90"
,IN,AR,30308490,1005,100,,Invoice,,,,,,20/02/2018,20/02/2018,0.00,,28.47,,"-138,873.37"
,IN,AR,30308491,1005,100,,Invoice,,,,,,20/02/2018,20/02/2018,0.00,,28.47,,"-138,901.84"
,IN,AR,30308492,1005,100,,Invoice,,,,,,20/02/2018,20/02/2018,0.00,,85.43,,"-138,987.27"
,IN,AR,30308518,1005,100,,Invoice,,,,,,20/02/2018,20/02/2018,0.00,,5.64,,"-138,992.91"
,IN,AR,30308526,1005,100,,Invoice,,,,,,20/02/2018,20/02/2018,0.00,,5.26,,"-138,998.17"
,IN,AR,30308533,1005,100,,Invoice,,,,,,20/02/2018,20/02/2018,0.00,,8.00,,"-139,006.17"
,IN,AR,30308539,1005,100,,Invoice,,,,,,20/02/2018,20/02/2018,0.00,,10.93,,"-139,017.10"
,IN,AR,30308544,1005,100,,Invoice,,,,,,20/02/2018,20/02/2018,0.00,,98.83,,"-139,115.93"
,IN,AR,30308553,1005,100,,Invoice,,,,,,20/02/2018,20/02/2018,0.00,,14.58,,"-139,130.51"
,IN,AR,30308564,1005,100,,Invoice,,,,,,20/02/2018,20/02/2018,0.00,,8.77,,"-139,139.28"
,IN,AR,30308642,1005,100,,Invoice,,,,,,20/02/2018,20/02/2018,0.00,,21.86,,"-139,161.14"
,IN,AR,30308719,1005,100,,Invoice,,,,,,20/02/2018,20/02/2018,0.00,,12.94,,"-139,174.08"
,IN,AR,30308757,1005,100,,Invoice,,,,,,20/02/2018,20/02/2018,0.00,,5.17,,"-139,179.25"
,IN,AR,30308776,1005,100,,Invoice,,,,,,20/02/2018,20/02/2018,0.00,,419.07,,"-139,598.32"
,CN,AR,31017325,1005,100,,Credit Note,,,,,,21/02/2018,21/02/2018,7.76,,0.00,,"-139,590.56"
,CN,AR,31017326,1005,100,,Credit Note,,,,,,21/02/2018,21/02/2018,2.58,,0.00,,"-139,587.98"
,CS,AR,32000950,1005,100,,Cash sale,,,,,,21/02/2018,21/02/2018,0.00,,37.63,,"-139,625.61"
,CS,AR,32000984,1005,100,,Cash sale,,,,,,21/02/2018,21/02/2018,0.00,,3.64,,"-139,629.25"
,CS,AR,32001093,1005,100,,Cash sale,,,,,,21/02/2018,21/02/2018,0.00,,10.93,,"-139,640.18"
,CS,AR,32001100,1005,100,,Cash sale,,,,,,21/02/2018,21/02/2018,0.00,,5.86,,"-139,646.04"
,CS,AR,32001108,1005,100,,Cash sale,,,,,,21/02/2018,21/02/2018,0.00,,7.29,,"-139,653.33"
,CS,AR,32001190,1005,100,,Cash sale,,,,,,21/02/2018,21/02/2018,0.00,,21.06,,"-139,674.39"
,CS,AR,32001195,1005,100,,Cash sale,,,,,,21/02/2018,21/02/2018,0.00,,7.29,,"-139,681.68"
,CS,AR,32001221,1005,100,,Cash sale,,,,,,21/02/2018,21/02/2018,0.00,,2.54,,"-139,684.22"
,CS,AR,32001284,1005,100,,Cash sale,,,,,,21/02/2018,21/02/2018,0.00,,3.64,,"-139,687.86"
,CS,AR,32001299,1005,100,,Cash sale,,,,,,21/02/2018,21/02/2018,0.00,,10.93,,"-139,698.79"
,CS,AR,32001326,1005,100,,Cash sale,,,,,,21/02/2018,21/02/2018,0.00,,21.86,,"-139,720.65"
,CS,AR,32001334,1005,100,,Cash sale,,,,,,21/02/2018,21/02/2018,0.00,,10.93,,"-139,731.58"
,CS,AR,32001340,1005,100,,Cash sale,,,,,,21/02/2018,21/02/2018,0.00,,18.22,,"-139,749.80"
,CS,AR,32001353,1005,100,,Cash sale,,,,,,21/02/2018,21/02/2018,0.00,,7.29,,"-139,757.09"
,CS,AR,32001361,1005,100,,Cash sale,,,,,,21/02/2018,21/02/2018,0.00,,6.44,,"-139,763.53"
,CS,AR,32001369,1005,100,,Cash sale,,,,,,21/02/2018,21/02/2018,0.00,,7.29,,"-139,770.82"
,CS,AR,32001393,1005,100,,Cash sale,,,,,,21/02/2018,21/02/2018,0.00,,7.29,,"-139,778.11"
,CS,AR,32001415,1005,100,,Cash sale,,,,,,21/02/2018,21/02/2018,0.00,,5.34,,"-139,783.45"
,CS,AR,32001456,1005,100,,Cash sale,,,,,,21/02/2018,21/02/2018,0.00,,29.15,,"-139,812.60"
,CS,AR,32001462,1005,100,,Cash sale,,,,,,21/02/2018,21/02/2018,0.00,,10.93,,"-139,823.53"
,CS,AR,32001482,1005,100,,Cash sale,,,,,,21/02/2018,21/02/2018,0.00,,3.64,,"-139,827.17"
,CS,AR,32001501,1005,100,,Cash sale,,,,,,21/02/2018,21/02/2018,0.00,,2.62,,"-139,829.79"
,CS,AR,32001504,1005,100,,Cash sale,,,,,,21/02/2018,21/02/2018,0.00,,3.64,,"-139,833.43"
,CS,AR,32001524,1005,100,,Cash sale,,,,,,21/02/2018,21/02/2018,0.00,,7.29,,"-139,840.72"
,CS,AR,32001536,1005,100,,Cash sale,,,,,,21/02/2018,21/02/2018,0.00,,14.58,,"-139,855.30"
,CS,AR,32001540,1005,100,,Cash sale,,,,,,21/02/2018,21/02/2018,0.00,,9.10,,"-139,864.40"
,CS,AR,32001552,1005,100,,Cash sale,,,,,,21/02/2018,21/02/2018,0.00,,18.22,,"-139,882.62"
,CS,AR,32001573,1005,100,,Cash sale,,,,,,21/02/2018,21/02/2018,0.00,,12.03,,"-139,894.65"
,CS,AR,32001597,1005,100,,Cash sale,,,,,,21/02/2018,21/02/2018,0.00,,14.58,,"-139,909.23"
,CS,AR,32001612,1005,100,,Cash sale,,,,,,21/02/2018,21/02/2018,0.00,,4.15,,"-139,913.38"
,CS,AR,32001617,1005,100,,Cash sale,,,,,,21/02/2018,21/02/2018,0.00,,3.03,,"-139,916.41"
,CS,AR,32001620,1005,100,,Cash sale,,,,,,21/02/2018,21/02/2018,0.00,,7.29,,"-139,923.70"
,CS,AR,32001644,1005,100,,Cash sale,,,,,,21/02/2018,21/02/2018,0.00,,7.29,,"-139,930.99"
,CS,AR,32001669,1005,100,,Cash sale,,,,,,21/02/2018,21/02/2018,0.00,,13.09,,"-139,944.08"
,CS,AR,32001679,1005,100,,Cash sale,,,,,,21/02/2018,21/02/2018,0.00,,13.74,,"-139,957.82"
,IN,AR,30306685,1005,100,,Invoice,,,,,,21/02/2018,21/02/2018,0.00,,17.80,,"-139,975.62"
,IN,AR,30306705,1005,100,,Invoice,,,,,,21/02/2018,21/02/2018,0.00,,23.73,,"-139,999.35"
,IN,AR,30306720,1005,100,,Invoice,,,,,,21/02/2018,21/02/2018,0.00,,46.37,,"-140,045.72"
,IN,AR,30306738,1005,100,,Invoice,,,,,,21/02/2018,21/02/2018,0.00,,7.29,,"-140,053.01"
,IN,AR,30306743,1005,100,,Invoice,,,,,,21/02/2018,21/02/2018,0.00,,13.94,,"-140,066.95"
,IN,AR,30306756,1005,100,,Invoice,,,,,,21/02/2018,21/02/2018,0.00,,39.41,,"-140,106.36"
,IN,AR,30306757,1005,100,,Invoice,,,,,,21/02/2018,21/02/2018,0.00,,78.81,,"-140,185.17"
,IN,AR,30306761,1005,100,,Invoice,,,,,,21/02/2018,21/02/2018,0.00,,21.86,,"-140,207.03"
,IN,AR,30306794,1005,100,,Invoice,,,,,,21/02/2018,21/02/2018,0.00,,10.93,,"-140,217.96"
,IN,AR,30306889,1005,100,,Invoice,,,,,,21/02/2018,21/02/2018,0.00,,10.93,,"-140,228.89"
,IN,AR,30306894,1005,100,,Invoice,,,,,,21/02/2018,21/02/2018,0.00,,21.86,,"-140,250.75"
,IN,AR,30306896,1005,100,,Invoice,,,,,,21/02/2018,21/02/2018,0.00,,14.58,,"-140,265.33"
,IN,AR,30306913,1005,100,,Invoice,,,,,,21/02/2018,21/02/2018,0.00,,22.00,,"-140,287.33"
,IN,AR,30306944,1005,100,,Invoice,,,,,,21/02/2018,21/02/2018,0.00,,18.05,,"-140,305.38"
,IN,AR,30306959,1005,100,,Invoice,,,,,,21/02/2018,21/02/2018,0.00,,20.00,,"-140,325.38"
,IN,AR,30306966,1005,100,,Invoice,,,,,,21/02/2018,21/02/2018,0.00,,7.29,,"-140,332.67"
,IN,AR,30306972,1005,100,,Invoice,,,,,,21/02/2018,21/02/2018,0.00,,47.46,,"-140,380.13"
,IN,AR,30306982,1005,100,,Invoice,,,,,,21/02/2018,21/02/2018,0.00,,12.00,,"-140,392.13"
,IN,AR,30307018,1005,100,,Invoice,,,,,,21/02/2018,21/02/2018,0.00,,158.27,,"-140,550.40"
,IN,AR,30307054,1005,100,,Invoice,,,,,,21/02/2018,21/02/2018,0.00,,6.02,,"-140,556.42"
,IN,AR,30307073,1005,100,,Invoice,,,,,,21/02/2018,21/02/2018,0.00,,18.57,,"-140,574.99"
,IN,AR,30307152,1005,100,,Invoice,,,,,,21/02/2018,21/02/2018,0.00,,12.71,,"-140,587.70"
,IN,AR,30307168,1005,100,,Invoice,,,,,,21/02/2018,21/02/2018,0.00,,4.24,,"-140,591.94"
,IN,AR,30307177,1005,100,,Invoice,,,,,,21/02/2018,21/02/2018,0.00,,81.36,,"-140,673.30"
,IN,AR,30307178,1005,100,,Invoice,,,,,,21/02/2018,21/02/2018,0.00,,61.02,,"-140,734.32"
,IN,AR,30307186,1005,100,,Invoice,,,,,,21/02/2018,21/02/2018,0.00,,2.12,,"-140,736.44"
,IN,AR,30307196,1005,100,,Invoice,,,,,,21/02/2018,21/02/2018,0.00,,5.59,,"-140,742.03"
,IN,AR,30307231,1005,100,,Invoice,,,,,,21/02/2018,21/02/2018,0.00,,35.85,,"-140,777.88"
,IN,AR,30307254,1005,100,,Invoice,,,,,,21/02/2018,21/02/2018,0.00,,11.95,,"-140,789.83"
,IN,AR,30307276,1005,100,,Invoice,,,,,,21/02/2018,21/02/2018,0.00,,53.32,,"-140,843.15"
,IN,AR,30307287,1005,100,,Invoice,,,,,,21/02/2018,21/02/2018,0.00,,12.71,,"-140,855.86"
,IN,AR,30307288,1005,100,,Invoice,,,,,,21/02/2018,21/02/2018,0.00,,144.92,,"-141,000.78"
,IN,AR,30307351,1005,100,,Invoice,,,,,,21/02/2018,21/02/2018,0.00,,18.27,,"-141,019.05"
,IN,AR,30307357,1005,100,,Invoice,,,,,,21/02/2018,21/02/2018,0.00,,10.93,,"-141,029.98"
,IN,AR,30307363,1005,100,,Invoice,,,,,,21/02/2018,21/02/2018,0.00,,12.92,,"-141,042.90"
,IN,AR,30307380,1005,100,,Invoice,,,,,,21/02/2018,21/02/2018,0.00,,250.08,,"-141,292.98"
,IN,AR,30307432,1005,100,,Invoice,,,,,,21/02/2018,21/02/2018,0.00,,5.08,,"-141,298.06"
,IN,AR,30307454,1005,100,,Invoice,,,,,,21/02/2018,21/02/2018,0.00,,3.19,,"-141,301.25"
,IN,AR,30307469,1005,100,,Invoice,,,,,,21/02/2018,21/02/2018,0.00,,50.87,,"-141,352.12"
,IN,AR,30307536,1005,100,,Invoice,,,,,,21/02/2018,21/02/2018,0.00,,31.80,,"-141,383.92"
,IN,AR,30307553,1005,100,,Invoice,,,,,,21/02/2018,21/02/2018,0.00,,32.50,,"-141,416.42"
,IN,AR,30307663,1005,100,,Invoice,,,,,,21/02/2018,21/02/2018,0.00,,35.59,,"-141,452.01"
,IN,AR,30307672,1005,100,,Invoice,,,,,,21/02/2018,21/02/2018,0.00,,13.73,,"-141,465.74"
,IN,AR,30307681,1005,100,,Invoice,,,,,,21/02/2018,21/02/2018,0.00,,22.37,,"-141,488.11"
,IN,AR,30307701,1005,100,,Invoice,,,,,,21/02/2018,21/02/2018,0.00,,1.88,,"-141,489.99"
,IN,AR,30307776,1005,100,,Invoice,,,,,,21/02/2018,21/02/2018,0.00,,16.53,,"-141,506.52"
,IN,AR,30307821,1005,100,,Invoice,,,,,,21/02/2018,21/02/2018,0.00,,24.07,,"-141,530.59"
,IN,AR,30307829,1005,100,,Invoice,,,,,,21/02/2018,21/02/2018,0.00,,18.05,,"-141,548.64"
,IN,AR,30307837,1005,100,,Invoice,,,,,,21/02/2018,21/02/2018,0.00,,31.14,,"-141,579.78"
,IN,AR,30307872,1005,100,,Invoice,,,,,,21/02/2018,21/02/2018,0.00,,49.31,,"-141,629.09"
,IN,AR,30307876,1005,100,,Invoice,,,,,,21/02/2018,21/02/2018,0.00,,10.68,,"-141,639.77"
,IN,AR,30307897,1005,100,,Invoice,,,,,,21/02/2018,21/02/2018,0.00,,12.33,,"-141,652.10"
,IN,AR,30307903,1005,100,,Invoice,,,,,,21/02/2018,21/02/2018,0.00,,6.02,,"-141,658.12"
,IN,AR,30308024,1005,100,,Invoice,,,,,,21/02/2018,21/02/2018,0.00,,7.29,,"-141,665.41"
,IN,AR,30308055,1005,100,,Invoice,,,,,,21/02/2018,21/02/2018,0.00,,20.00,,"-141,685.41"
,IN,AR,30308063,1005,100,,Invoice,,,,,,21/02/2018,21/02/2018,0.00,,14.58,,"-141,699.99"
,IN,AR,30308104,1005,100,,Invoice,,,,,,21/02/2018,21/02/2018,0.00,,14.58,,"-141,714.57"
,IN,AR,30308137,1005,100,,Invoice,,,,,,21/02/2018,21/02/2018,0.00,,8.02,,"-141,722.59"
,IN,AR,30308138,1005,100,,Invoice,,,,,,21/02/2018,21/02/2018,0.00,,22.45,,"-141,745.04"
,IN,AR,30308139,1005,100,,Invoice,,,,,,21/02/2018,21/02/2018,0.00,,9.62,,"-141,754.66"
,IN,AR,30308140,1005,100,,Invoice,,,,,,21/02/2018,21/02/2018,0.00,,3.20,,"-141,757.86"
,IN,AR,30308141,1005,100,,Invoice,,,,,,21/02/2018,21/02/2018,0.00,,6.42,,"-141,764.28"
,IN,AR,30308142,1005,100,,Invoice,,,,,,21/02/2018,21/02/2018,0.00,,6.42,,"-141,770.70"
,IN,AR,30308185,1005,100,,Invoice,,,,,,21/02/2018,21/02/2018,0.00,,10.19,,"-141,780.89"
,IN,AR,30308196,1005,100,,Invoice,,,,,,21/02/2018,21/02/2018,0.00,,9.15,,"-141,790.04"
,IN,AR,30308200,1005,100,,Invoice,,,,,,21/02/2018,21/02/2018,0.00,,36.22,,"-141,826.26"
,IN,AR,30308247,1005,100,,Invoice,,,,,,21/02/2018,21/02/2018,0.00,,24.01,,"-141,850.27"
,IN,AR,30308276,1005,100,,Invoice,,,,,,21/02/2018,21/02/2018,0.00,,3.02,,"-141,853.29"
,IN,AR,30308279,1005,100,,Invoice,,,,,,21/02/2018,21/02/2018,0.00,,2.92,,"-141,856.21"
,IN,AR,30308295,1005,100,,Invoice,,,,,,21/02/2018,21/02/2018,0.00,,21.03,,"-141,877.24"
,IN,AR,30308346,1005,100,,Invoice,,,,,,21/02/2018,21/02/2018,0.00,,8.39,,"-141,885.63"
,IN,AR,30308355,1005,100,,Invoice,,,,,,21/02/2018,21/02/2018,0.00,,9.64,,"-141,895.27"
,IN,AR,30308366,1005,100,,Invoice,,,,,,21/02/2018,21/02/2018,0.00,,2.54,,"-141,897.81"
,IN,AR,30308433,1005,100,,Invoice,,,,,,21/02/2018,21/02/2018,0.00,,40.58,,"-141,938.39"
,IN,AR,30308458,1005,100,,Invoice,,,,,,21/02/2018,21/02/2018,0.00,,7.97,,"-141,946.36"
,IN,AR,30308501,1005,100,,Invoice,,,,,,21/02/2018,21/02/2018,0.00,,54.66,,"-142,001.02"
,IN,AR,30308522,1005,100,,Invoice,,,,,,21/02/2018,21/02/2018,0.00,,5.26,,"-142,006.28"
,IN,AR,30308567,1005,100,,Invoice,,,,,,21/02/2018,21/02/2018,0.00,,3.64,,"-142,009.92"
,IN,AR,30308571,1005,100,,Invoice,,,,,,21/02/2018,21/02/2018,0.00,,6.56,,"-142,016.48"
,IN,AR,30308599,1005,100,,Invoice,,,,,,21/02/2018,21/02/2018,0.00,,7.53,,"-142,024.01"
,IN,AR,30308606,1005,100,,Invoice,,,,,,21/02/2018,21/02/2018,0.00,,54.66,,"-142,078.67"
,IN,AR,30308648,1005,100,,Invoice,,,,,,21/02/2018,21/02/2018,0.00,,54.66,,"-142,133.33"
,IN,AR,30308664,1005,100,,Invoice,,,,,,21/02/2018,21/02/2018,0.00,,8.39,,"-142,141.72"
,IN,AR,30308680,1005,100,,Invoice,,,,,,21/02/2018,21/02/2018,0.00,,7.29,,"-142,149.01"
,IN,AR,30308684,1005,100,,Invoice,,,,,,21/02/2018,21/02/2018,0.00,,24.71,,"-142,173.72"
,IN,AR,30308688,1005,100,,Invoice,,,,,,21/02/2018,21/02/2018,0.00,,2.75,,"-142,176.47"
,IN,AR,30308708,1005,100,,Invoice,,,,,,21/02/2018,21/02/2018,0.00,,7.29,,"-142,183.76"
,IN,AR,30308714,1005,100,,Invoice,,,,,,21/02/2018,21/02/2018,0.00,,32.95,,"-142,216.71"
,IN,AR,30308777,1005,100,,Invoice,,,,,,21/02/2018,21/02/2018,0.00,,419.07,,"-142,635.78"
,CN,AR,31017317,1005,100,,Credit Note,,,,,,22/02/2018,22/02/2018,23.90,,0.00,,"-142,611.88"
,CN,AR,31017407,1005,100,,Credit Note,,,,,,22/02/2018,22/02/2018,21.86,,0.00,,"-142,590.02"
,CN,AR,31017408,1005,100,,Credit Note,,,,,,22/02/2018,22/02/2018,211.36,,0.00,,"-142,378.66"
,CN,AR,31017409,1005,100,,Credit Note,,,,,,22/02/2018,22/02/2018,10.93,,0.00,,"-142,367.73"
,CN,AR,31017410,1005,100,,Credit Note,,,,,,22/02/2018,22/02/2018,25.51,,0.00,,"-142,342.22"
,CN,AR,31017411,1005,100,,Credit Note,,,,,,22/02/2018,22/02/2018,378.98,,0.00,,"-141,963.24"
,CN,AR,31017434,1005,100,,Credit Note,,,,,,22/02/2018,22/02/2018,24.71,,0.00,,"-141,938.53"
,CS,AR,32000927,1005,100,,Cash sale,,,,,,22/02/2018,22/02/2018,0.00,,79.68,,"-142,018.21"
,CS,AR,32000932,1005,100,,Cash sale,,,,,,22/02/2018,22/02/2018,0.00,,18.05,,"-142,036.26"
,CS,AR,32000936,1005,100,,Cash sale,,,,,,22/02/2018,22/02/2018,0.00,,16.83,,"-142,053.09"
,CS,AR,32000967,1005,100,,Cash sale,,,,,,22/02/2018,22/02/2018,0.00,,10.93,,"-142,064.02"
,CS,AR,32000972,1005,100,,Cash sale,,,,,,22/02/2018,22/02/2018,0.00,,7.29,,"-142,071.31"
,CS,AR,32000976,1005,100,,Cash sale,,,,,,22/02/2018,22/02/2018,0.00,,5.17,,"-142,076.48"
,CS,AR,32000989,1005,100,,Cash sale,,,,,,22/02/2018,22/02/2018,0.00,,3.64,,"-142,080.12"
,CS,AR,32001019,1005,100,,Cash sale,,,,,,22/02/2018,22/02/2018,0.00,,3.64,,"-142,083.76"
,CS,AR,32001055,1005,100,,Cash sale,,,,,,22/02/2018,22/02/2018,0.00,,10.93,,"-142,094.69"
,CS,AR,32001121,1005,100,,Cash sale,,,,,,22/02/2018,22/02/2018,0.00,,3.64,,"-142,098.33"
,CS,AR,32001164,1005,100,,Cash sale,,,,,,22/02/2018,22/02/2018,0.00,,7.75,,"-142,106.08"
,CS,AR,32001167,1005,100,,Cash sale,,,,,,22/02/2018,22/02/2018,0.00,,3.64,,"-142,109.72"
,CS,AR,32001273,1005,100,,Cash sale,,,,,,22/02/2018,22/02/2018,0.00,,5.17,,"-142,114.89"
,CS,AR,32001290,1005,100,,Cash sale,,,,,,22/02/2018,22/02/2018,0.00,,19.28,,"-142,134.17"
,CS,AR,32001378,1005,100,,Cash sale,,,,,,22/02/2018,22/02/2018,0.00,,5.17,,"-142,139.34"
,CS,AR,32001439,1005,100,,Cash sale,,,,,,22/02/2018,22/02/2018,0.00,,10.93,,"-142,150.27"
,CS,AR,32001448,1005,100,,Cash sale,,,,,,22/02/2018,22/02/2018,0.00,,7.86,,"-142,158.13"
,CS,AR,32001452,1005,100,,Cash sale,,,,,,22/02/2018,22/02/2018,0.00,,22.88,,"-142,181.01"
,CS,AR,32001509,1005,100,,Cash sale,,,,,,22/02/2018,22/02/2018,0.00,,11.02,,"-142,192.03"
,CS,AR,32001518,1005,100,,Cash sale,,,,,,22/02/2018,22/02/2018,0.00,,6.07,,"-142,198.10"
,CS,AR,32001522,1005,100,,Cash sale,,,,,,22/02/2018,22/02/2018,0.00,,7.29,,"-142,205.39"
,CS,AR,32001548,1005,100,,Cash sale,,,,,,22/02/2018,22/02/2018,0.00,,8.90,,"-142,214.29"
,CS,AR,32001614,1005,100,,Cash sale,,,,,,22/02/2018,22/02/2018,0.00,,3.64,,"-142,217.93"
,CS,AR,32001664,1005,100,,Cash sale,,,,,,22/02/2018,22/02/2018,0.00,,8.78,,"-142,226.71"
,CS,AR,32001694,1005,100,,Cash sale,,,,,,22/02/2018,22/02/2018,0.00,,7.29,,"-142,234.00"
,IN,AR,30306686,1005,100,,Invoice,,,,,,22/02/2018,22/02/2018,0.00,,11.86,,"-142,245.86"
,IN,AR,30306687,1005,100,,Invoice,,,,,,22/02/2018,22/02/2018,0.00,,20.76,,"-142,266.62"
,IN,AR,30306699,1005,100,,Invoice,,,,,,22/02/2018,22/02/2018,0.00,,3.64,,"-142,270.26"
,IN,AR,30306721,1005,100,,Invoice,,,,,,22/02/2018,22/02/2018,0.00,,24.41,,"-142,294.67"
,IN,AR,30306747,1005,100,,Invoice,,,,,,22/02/2018,22/02/2018,0.00,,3.64,,"-142,298.31"
,IN,AR,30306769,1005,100,,Invoice,,,,,,22/02/2018,22/02/2018,0.00,,18.22,,"-142,316.53"
,IN,AR,30306797,1005,100,,Invoice,,,,,,22/02/2018,22/02/2018,0.00,,3.64,,"-142,320.17"
,IN,AR,30306810,1005,100,,Invoice,,,,,,22/02/2018,22/02/2018,0.00,,21.86,,"-142,342.03"
,IN,AR,30306827,1005,100,,Invoice,,,,,,22/02/2018,22/02/2018,0.00,,5.97,,"-142,348.00"
,IN,AR,30306841,1005,100,,Invoice,,,,,,22/02/2018,22/02/2018,0.00,,71.19,,"-142,419.19"
,IN,AR,30306899,1005,100,,Invoice,,,,,,22/02/2018,22/02/2018,0.00,,3.64,,"-142,422.83"
,IN,AR,30306919,1005,100,,Invoice,,,,,,22/02/2018,22/02/2018,0.00,,7.29,,"-142,430.12"
,IN,AR,30306927,1005,100,,Invoice,,,,,,22/02/2018,22/02/2018,0.00,,3.64,,"-142,433.76"
,IN,AR,30306963,1005,100,,Invoice,,,,,,22/02/2018,22/02/2018,0.00,,3.64,,"-142,437.40"
,IN,AR,30307000,1005,100,,Invoice,,,,,,22/02/2018,22/02/2018,0.00,,32.95,,"-142,470.35"
,IN,AR,30307014,1005,100,,Invoice,,,,,,22/02/2018,22/02/2018,0.00,,28.39,,"-142,498.74"
,IN,AR,30307042,1005,100,,Invoice,,,,,,22/02/2018,22/02/2018,0.00,,30.00,,"-142,528.74"
,IN,AR,30307090,1005,100,,Invoice,,,,,,22/02/2018,22/02/2018,0.00,,7.29,,"-142,536.03"
,IN,AR,30307096,1005,100,,Invoice,,,,,,22/02/2018,22/02/2018,0.00,,6.37,,"-142,542.40"
,IN,AR,30307102,1005,100,,Invoice,,,,,,22/02/2018,22/02/2018,0.00,,7.29,,"-142,549.69"
,IN,AR,30307109,1005,100,,Invoice,,,,,,22/02/2018,22/02/2018,0.00,,31.50,,"-142,581.19"
,IN,AR,30307179,1005,100,,Invoice,,,,,,22/02/2018,22/02/2018,0.00,,26.44,,"-142,607.63"
,IN,AR,30307194,1005,100,,Invoice,,,,,,22/02/2018,22/02/2018,0.00,,7.29,,"-142,614.92"
,IN,AR,30307213,1005,100,,Invoice,,,,,,22/02/2018,22/02/2018,0.00,,10.93,,"-142,625.85"
,IN,AR,30307232,1005,100,,Invoice,,,,,,22/02/2018,22/02/2018,0.00,,22.03,,"-142,647.88"
,IN,AR,30307245,1005,100,,Invoice,,,,,,22/02/2018,22/02/2018,0.00,,14.34,,"-142,662.22"
,IN,AR,30307267,1005,100,,Invoice,,,,,,22/02/2018,22/02/2018,0.00,,18.64,,"-142,680.86"
,IN,AR,30307314,1005,100,,Invoice,,,,,,22/02/2018,22/02/2018,0.00,,23.90,,"-142,704.76"
,IN,AR,30307328,1005,100,,Invoice,,,,,,22/02/2018,22/02/2018,0.00,,9.66,,"-142,714.42"
,IN,AR,30307401,1005,100,,Invoice,,,,,,22/02/2018,22/02/2018,0.00,,7.29,,"-142,721.71"
,IN,AR,30307408,1005,100,,Invoice,,,,,,22/02/2018,22/02/2018,0.00,,10.59,,"-142,732.30"
,IN,AR,30307414,1005,100,,Invoice,,,,,,22/02/2018,22/02/2018,0.00,,4.78,,"-142,737.08"
,IN,AR,30307433,1005,100,,Invoice,,,,,,22/02/2018,22/02/2018,0.00,,2.54,,"-142,739.62"
,IN,AR,30307455,1005,100,,Invoice,,,,,,22/02/2018,22/02/2018,0.00,,1.59,,"-142,741.21"
,IN,AR,30307456,1005,100,,Invoice,,,,,,22/02/2018,22/02/2018,0.00,,52.58,,"-142,793.79"
,IN,AR,30307457,1005,100,,Invoice,,,,,,22/02/2018,22/02/2018,0.00,,35.05,,"-142,828.84"
,IN,AR,30307463,1005,100,,Invoice,,,,,,22/02/2018,22/02/2018,0.00,,23.91,,"-142,852.75"
,IN,AR,30307474,1005,100,,Invoice,,,,,,22/02/2018,22/02/2018,0.00,,2.58,,"-142,855.33"
,IN,AR,30307484,1005,100,,Invoice,,,,,,22/02/2018,22/02/2018,0.00,,21.86,,"-142,877.19"
,IN,AR,30307521,1005,100,,Invoice,,,,,,22/02/2018,22/02/2018,0.00,,21.19,,"-142,898.38"
,IN,AR,30307530,1005,100,,Invoice,,,,,,22/02/2018,22/02/2018,0.00,,10.93,,"-142,909.31"
,IN,AR,30307589,1005,100,,Invoice,,,,,,22/02/2018,22/02/2018,0.00,,9.03,,"-142,918.34"
,IN,AR,30307606,1005,100,,Invoice,,,,,,22/02/2018,22/02/2018,0.00,,7.29,,"-142,925.63"
,IN,AR,30307613,1005,100,,Invoice,,,,,,22/02/2018,22/02/2018,0.00,,23.90,,"-142,949.53"
,IN,AR,30307639,1005,100,,Invoice,,,,,,22/02/2018,22/02/2018,0.00,,10.98,,"-142,960.51"
,IN,AR,30307699,1005,100,,Invoice,,,,,,22/02/2018,22/02/2018,0.00,,27.97,,"-142,988.48"
,IN,AR,30307703,1005,100,,Invoice,,,,,,22/02/2018,22/02/2018,0.00,,18.22,,"-143,006.70"
,IN,AR,30307728,1005,100,,Invoice,,,,,,22/02/2018,22/02/2018,0.00,,10.17,,"-143,016.87"
,IN,AR,30307753,1005,100,,Invoice,,,,,,22/02/2018,22/02/2018,0.00,,11.61,,"-143,028.48"
,IN,AR,30307764,1005,100,,Invoice,,,,,,22/02/2018,22/02/2018,0.00,,8.77,,"-143,037.25"
,IN,AR,30307770,1005,100,,Invoice,,,,,,22/02/2018,22/02/2018,0.00,,3.64,,"-143,040.89"
,IN,AR,30307777,1005,100,,Invoice,,,,,,22/02/2018,22/02/2018,0.00,,8.26,,"-143,049.15"
,IN,AR,30307833,1005,100,,Invoice,,,,,,22/02/2018,22/02/2018,0.00,,10.99,,"-143,060.14"
,IN,AR,30307842,1005,100,,Invoice,,,,,,22/02/2018,22/02/2018,0.00,,15.53,,"-143,075.67"
,IN,AR,30307846,1005,100,,Invoice,,,,,,22/02/2018,22/02/2018,0.00,,7.63,,"-143,083.30"
,IN,AR,30307848,1005,100,,Invoice,,,,,,22/02/2018,22/02/2018,0.00,,6.53,,"-143,089.83"
,IN,AR,30307860,1005,100,,Invoice,,,,,,22/02/2018,22/02/2018,0.00,,12.00,,"-143,101.83"
,IN,AR,30307898,1005,100,,Invoice,,,,,,22/02/2018,22/02/2018,0.00,,7.05,,"-143,108.88"
,IN,AR,30307908,1005,100,,Invoice,,,,,,22/02/2018,22/02/2018,0.00,,10.93,,"-143,119.81"
,IN,AR,30307912,1005,100,,Invoice,,,,,,22/02/2018,22/02/2018,0.00,,7.29,,"-143,127.10"
,IN,AR,30307920,1005,100,,Invoice,,,,,,22/02/2018,22/02/2018,0.00,,4.54,,"-143,131.64"
,IN,AR,30307929,1005,100,,Invoice,,,,,,22/02/2018,22/02/2018,0.00,,106.48,,"-143,238.12"
,IN,AR,30307931,1005,100,,Invoice,,,,,,22/02/2018,22/02/2018,0.00,,91.10,,"-143,329.22"
,IN,AR,30307948,1005,100,,Invoice,,,,,,22/02/2018,22/02/2018,0.00,,11.70,,"-143,340.92"
,IN,AR,30307959,1005,100,,Invoice,,,,,,22/02/2018,22/02/2018,0.00,,14.58,,"-143,355.50"
,IN,AR,30307960,1005,100,,Invoice,,,,,,22/02/2018,22/02/2018,0.00,,40.08,,"-143,395.58"
,IN,AR,30307995,1005,100,,Invoice,,,,,,22/02/2018,22/02/2018,0.00,,3.64,,"-143,399.22"
,IN,AR,30307999,1005,100,,Invoice,,,,,,22/02/2018,22/02/2018,0.00,,15.25,,"-143,414.47"
,IN,AR,30308003,1005,100,,Invoice,,,,,,22/02/2018,22/02/2018,0.00,,10.93,,"-143,425.40"
,IN,AR,30308006,1005,100,,Invoice,,,,,,22/02/2018,22/02/2018,0.00,,9.84,,"-143,435.24"
,IN,AR,30308020,1005,100,,Invoice,,,,,,22/02/2018,22/02/2018,0.00,,19.53,,"-143,454.77"
,IN,AR,30308021,1005,100,,Invoice,,,,,,22/02/2018,22/02/2018,0.00,,16.27,,"-143,471.04"
,IN,AR,30308022,1005,100,,Invoice,,,,,,22/02/2018,22/02/2018,0.00,,3.25,,"-143,474.29"
,IN,AR,30308023,1005,100,,Invoice,,,,,,22/02/2018,22/02/2018,0.00,,32.54,,"-143,506.83"
,IN,AR,30308061,1005,100,,Invoice,,,,,,22/02/2018,22/02/2018,0.00,,10.47,,"-143,517.30"
,IN,AR,30308094,1005,100,,Invoice,,,,,,22/02/2018,22/02/2018,0.00,,8.90,,"-143,526.20"
,IN,AR,30308099,1005,100,,Invoice,,,,,,22/02/2018,22/02/2018,0.00,,30.25,,"-143,556.45"
,IN,AR,30308105,1005,100,,Invoice,,,,,,22/02/2018,22/02/2018,0.00,,6.07,,"-143,562.52"
,IN,AR,30308143,1005,100,,Invoice,,,,,,22/02/2018,22/02/2018,0.00,,14.43,,"-143,576.95"
,IN,AR,30308179,1005,100,,Invoice,,,,,,22/02/2018,22/02/2018,0.00,,9.84,,"-143,586.79"
,IN,AR,30308191,1005,100,,Invoice,,,,,,22/02/2018,22/02/2018,0.00,,14.58,,"-143,601.37"
,IN,AR,30308197,1005,100,,Invoice,,,,,,22/02/2018,22/02/2018,0.00,,24.29,,"-143,625.66"
,IN,AR,30308226,1005,100,,Invoice,,,,,,22/02/2018,22/02/2018,0.00,,2.54,,"-143,628.20"
,IN,AR,30308232,1005,100,,Invoice,,,,,,22/02/2018,22/02/2018,0.00,,22.01,,"-143,650.21"
,IN,AR,30308243,1005,100,,Invoice,,,,,,22/02/2018,22/02/2018,0.00,,40.01,,"-143,690.22"
,IN,AR,30308261,1005,100,,Invoice,,,,,,22/02/2018,22/02/2018,0.00,,11.66,,"-143,701.88"
,IN,AR,30308262,1005,100,,Invoice,,,,,,22/02/2018,22/02/2018,0.00,,11.66,,"-143,713.54"
,IN,AR,30308304,1005,100,,Invoice,,,,,,22/02/2018,22/02/2018,0.00,,25.51,,"-143,739.05"
,IN,AR,30308328,1005,100,,Invoice,,,,,,22/02/2018,22/02/2018,0.00,,28.05,,"-143,767.10"
,IN,AR,30308339,1005,100,,Invoice,,,,,,22/02/2018,22/02/2018,0.00,,13.73,,"-143,780.83"
,IN,AR,30308340,1005,100,,Invoice,,,,,,22/02/2018,22/02/2018,0.00,,10.93,,"-143,791.76"
,IN,AR,30308343,1005,100,,Invoice,,,,,,22/02/2018,22/02/2018,0.00,,5.68,,"-143,797.44"
,IN,AR,30308427,1005,100,,Invoice,,,,,,22/02/2018,22/02/2018,0.00,,14.58,,"-143,812.02"
,IN,AR,30308459,1005,100,,Invoice,,,,,,22/02/2018,22/02/2018,0.00,,6.37,,"-143,818.39"
,IN,AR,30308460,1005,100,,Invoice,,,,,,22/02/2018,22/02/2018,0.00,,7.97,,"-143,826.36"
,IN,AR,30308461,1005,100,,Invoice,,,,,,22/02/2018,22/02/2018,0.00,,119.49,,"-143,945.85"
,IN,AR,30308462,1005,100,,Invoice,,,,,,22/02/2018,22/02/2018,0.00,,12.75,,"-143,958.60"
,IN,AR,30308463,1005,100,,Invoice,,,,,,22/02/2018,22/02/2018,0.00,,6.37,,"-143,964.97"
,IN,AR,30308473,1005,100,,Invoice,,,,,,22/02/2018,22/02/2018,0.00,,211.36,,"-144,176.33"
,IN,AR,30308474,1005,100,,Invoice,,,,,,22/02/2018,22/02/2018,0.00,,10.93,,"-144,187.26"
,IN,AR,30308499,1005,100,,Invoice,,,,,,22/02/2018,22/02/2018,0.00,,16.27,,"-144,203.53"
,IN,AR,30308677,1005,100,,Invoice,,,,,,22/02/2018,22/02/2018,0.00,,4.08,,"-144,207.61"
,IN,AR,30308686,1005,100,,Invoice,,,,,,22/02/2018,22/02/2018,0.00,,7.29,,"-144,214.90"
,IN,AR,30308761,1005,100,,Invoice,,,,,,22/02/2018,22/02/2018,0.00,,5.83,,"-144,220.73"
,IN,AR,30308778,1005,100,,Invoice,,,,,,22/02/2018,22/02/2018,0.00,,10.93,,"-144,231.66"
,CN,AR,31017316,1005,100,,Credit Note,,,,,,23/02/2018,23/02/2018,2.12,,0.00,,"-144,229.54"
,CN,AR,31017342,1005,100,,Credit Note,,,,,,23/02/2018,23/02/2018,62.46,,0.00,,"-144,167.08"
,CR,AR,33000059,1005,100,,Cash Return,,,,,,23/02/2018,23/02/2018,3.64,,0.00,,"-144,163.44"
,CS,AR,32000940,1005,100,,Cash sale,,,,,,23/02/2018,23/02/2018,0.00,,8.39,,"-144,171.83"
,CS,AR,32000956,1005,100,,Cash sale,,,,,,23/02/2018,23/02/2018,0.00,,9.49,,"-144,181.32"
,CS,AR,32000995,1005,100,,Cash sale,,,,,,23/02/2018,23/02/2018,0.00,,10.93,,"-144,192.25"
,CS,AR,32001007,1005,100,,Cash sale,,,,,,23/02/2018,23/02/2018,0.00,,14.58,,"-144,206.83"
,CS,AR,32001011,1005,100,,Cash sale,,,,,,23/02/2018,23/02/2018,0.00,,7.25,,"-144,214.08"
,CS,AR,32001026,1005,100,,Cash sale,,,,,,23/02/2018,23/02/2018,0.00,,26.10,,"-144,240.18"
,CS,AR,32001033,1005,100,,Cash sale,,,,,,23/02/2018,23/02/2018,0.00,,7.29,,"-144,247.47"
,CS,AR,32001040,1005,100,,Cash sale,,,,,,23/02/2018,23/02/2018,0.00,,20.76,,"-144,268.23"
,CS,AR,32001083,1005,100,,Cash sale,,,,,,23/02/2018,23/02/2018,0.00,,23.29,,"-144,291.52"
,CS,AR,32001136,1005,100,,Cash sale,,,,,,23/02/2018,23/02/2018,0.00,,29.15,,"-144,320.67"
,CS,AR,32001137,1005,100,,Cash sale,,,,,,23/02/2018,23/02/2018,0.00,,5.17,,"-144,325.84"
,CS,AR,32001150,1005,100,,Cash sale,,,,,,23/02/2018,23/02/2018,0.00,,10.17,,"-144,336.01"
,CS,AR,32001153,1005,100,,Cash sale,,,,,,23/02/2018,23/02/2018,0.00,,11.19,,"-144,347.20"
,CS,AR,32001175,1005,100,,Cash sale,,,,,,23/02/2018,23/02/2018,0.00,,19.24,,"-144,366.44"
,CS,AR,32001187,1005,100,,Cash sale,,,,,,23/02/2018,23/02/2018,0.00,,10.99,,"-144,377.43"
,CS,AR,32001205,1005,100,,Cash sale,,,,,,23/02/2018,23/02/2018,0.00,,14.58,,"-144,392.01"
,CS,AR,32001241,1005,100,,Cash sale,,,,,,23/02/2018,23/02/2018,0.00,,29.24,,"-144,421.25"
,CS,AR,32001253,1005,100,,Cash sale,,,,,,23/02/2018,23/02/2018,0.00,,4.32,,"-144,425.57"
,CS,AR,32001262,1005,100,,Cash sale,,,,,,23/02/2018,23/02/2018,0.00,,21.06,,"-144,446.63"
,CS,AR,32001294,1005,100,,Cash sale,,,,,,23/02/2018,23/02/2018,0.00,,3.64,,"-144,450.27"
,CS,AR,32001297,1005,100,,Cash sale,,,,,,23/02/2018,23/02/2018,0.00,,5.08,,"-144,455.35"
,CS,AR,32001307,1005,100,,Cash sale,,,,,,23/02/2018,23/02/2018,0.00,,42.12,,"-144,497.47"
,CS,AR,32001351,1005,100,,Cash sale,,,,,,23/02/2018,23/02/2018,0.00,,7.29,,"-144,504.76"
,CS,AR,32001364,1005,100,,Cash sale,,,,,,23/02/2018,23/02/2018,0.00,,23.41,,"-144,528.17"
,CS,AR,32001366,1005,100,,Cash sale,,,,,,23/02/2018,23/02/2018,0.00,,7.29,,"-144,535.46"
,CS,AR,32001395,1005,100,,Cash sale,,,,,,23/02/2018,23/02/2018,0.00,,3.64,,"-144,539.10"
,CS,AR,32001398,1005,100,,Cash sale,,,,,,23/02/2018,23/02/2018,0.00,,7.29,,"-144,546.39"
,CS,AR,32001405,1005,100,,Cash sale,,,,,,23/02/2018,23/02/2018,0.00,,13.90,,"-144,560.29"
,CS,AR,32001427,1005,100,,Cash sale,,,,,,23/02/2018,23/02/2018,0.00,,3.64,,"-144,563.93"
,CS,AR,32001470,1005,100,,Cash sale,,,,,,23/02/2018,23/02/2018,0.00,,6.12,,"-144,570.05"
,CS,AR,32001499,1005,100,,Cash sale,,,,,,23/02/2018,23/02/2018,0.00,,26.00,,"-144,596.05"
,CS,AR,32001531,1005,100,,Cash sale,,,,,,23/02/2018,23/02/2018,0.00,,9.15,,"-144,605.20"
,CS,AR,32001541,1005,100,,Cash sale,,,,,,23/02/2018,23/02/2018,0.00,,6.07,,"-144,611.27"
,CS,AR,32001585,1005,100,,Cash sale,,,,,,23/02/2018,23/02/2018,0.00,,3.64,,"-144,614.91"
,CS,AR,32001598,1005,100,,Cash sale,,,,,,23/02/2018,23/02/2018,0.00,,7.29,,"-144,622.20"
,CS,AR,32001608,1005,100,,Cash sale,,,,,,23/02/2018,23/02/2018,0.00,,9.15,,"-144,631.35"
,CS,AR,32001630,1005,100,,Cash sale,,,,,,23/02/2018,23/02/2018,0.00,,7.29,,"-144,638.64"
,CS,AR,32001633,1005,100,,Cash sale,,,,,,23/02/2018,23/02/2018,0.00,,12.17,,"-144,650.81"
,CS,AR,32001659,1005,100,,Cash sale,,,,,,23/02/2018,23/02/2018,0.00,,3.64,,"-144,654.45"
,CS,AR,32001666,1005,100,,Cash sale,,,,,,23/02/2018,23/02/2018,0.00,,7.29,,"-144,661.74"
,CS,AR,32001667,1005,100,,Cash sale,,,,,,23/02/2018,23/02/2018,0.00,,3.64,,"-144,665.38"
,CS,AR,32001674,1005,100,,Cash sale,,,,,,23/02/2018,23/02/2018,0.00,,6.56,,"-144,671.94"
,IN,AR,30306688,1005,100,,Invoice,,,,,,23/02/2018,23/02/2018,0.00,,38.56,,"-144,710.50"
,IN,AR,30306695,1005,100,,Invoice,,,,,,23/02/2018,23/02/2018,0.00,,25.51,,"-144,736.01"
,IN,AR,30306734,1005,100,,Invoice,,,,,,23/02/2018,23/02/2018,0.00,,18.22,,"-144,754.23"
,IN,AR,30306765,1005,100,,Invoice,,,,,,23/02/2018,23/02/2018,0.00,,21.74,,"-144,775.97"
,IN,AR,30306814,1005,100,,Invoice,,,,,,23/02/2018,23/02/2018,0.00,,4.59,,"-144,780.56"
,IN,AR,30306820,1005,100,,Invoice,,,,,,23/02/2018,23/02/2018,0.00,,44.64,,"-144,825.20"
,IN,AR,30306842,1005,100,,Invoice,,,,,,23/02/2018,23/02/2018,0.00,,28.47,,"-144,853.67"
,IN,AR,30306868,1005,100,,Invoice,,,,,,23/02/2018,23/02/2018,0.00,,40.00,,"-144,893.67"
,IN,AR,30306914,1005,100,,Invoice,,,,,,23/02/2018,23/02/2018,0.00,,20.00,,"-144,913.67"
,IN,AR,30306983,1005,100,,Invoice,,,,,,23/02/2018,23/02/2018,0.00,,18.00,,"-144,931.67"
,IN,AR,30307032,1005,100,,Invoice,,,,,,23/02/2018,23/02/2018,0.00,,5.82,,"-144,937.49"
,IN,AR,30307038,1005,100,,Invoice,,,,,,23/02/2018,23/02/2018,0.00,,7.29,,"-144,944.78"
,IN,AR,30307058,1005,100,,Invoice,,,,,,23/02/2018,23/02/2018,0.00,,29.15,,"-144,973.93"
,IN,AR,30307064,1005,100,,Invoice,,,,,,23/02/2018,23/02/2018,0.00,,16.78,,"-144,990.71"
,IN,AR,30307097,1005,100,,Invoice,,,,,,23/02/2018,23/02/2018,0.00,,6.37,,"-144,997.08"
,IN,AR,30307113,1005,100,,Invoice,,,,,,23/02/2018,23/02/2018,0.00,,7.75,,"-145,004.83"
,IN,AR,30307203,1005,100,,Invoice,,,,,,23/02/2018,23/02/2018,0.00,,10.34,,"-145,015.17"
,IN,AR,30307208,1005,100,,Invoice,,,,,,23/02/2018,23/02/2018,0.00,,4.78,,"-145,019.95"
,IN,AR,30307218,1005,100,,Invoice,,,,,,23/02/2018,23/02/2018,0.00,,189.94,,"-145,209.89"
,IN,AR,30307249,1005,100,,Invoice,,,,,,23/02/2018,23/02/2018,0.00,,18.05,,"-145,227.94"
,IN,AR,30307277,1005,100,,Invoice,,,,,,23/02/2018,23/02/2018,0.00,,65.63,,"-145,293.57"
,IN,AR,30307281,1005,100,,Invoice,,,,,,23/02/2018,23/02/2018,0.00,,14.03,,"-145,307.60"
,IN,AR,30307330,1005,100,,Invoice,,,,,,23/02/2018,23/02/2018,0.00,,10.93,,"-145,318.53"
,IN,AR,30307434,1005,100,,Invoice,,,,,,23/02/2018,23/02/2018,0.00,,7.63,,"-145,326.16"
,IN,AR,30307435,1005,100,,Invoice,,,,,,23/02/2018,23/02/2018,0.00,,5.08,,"-145,331.24"
,IN,AR,30307443,1005,100,,Invoice,,,,,,23/02/2018,23/02/2018,0.00,,5.08,,"-145,336.32"
,IN,AR,30307519,1005,100,,Invoice,,,,,,23/02/2018,23/02/2018,0.00,,12.71,,"-145,349.03"
,IN,AR,30307539,1005,100,,Invoice,,,,,,23/02/2018,23/02/2018,0.00,,10.93,,"-145,359.96"
,IN,AR,30307546,1005,100,,Invoice,,,,,,23/02/2018,23/02/2018,0.00,,33.05,,"-145,393.01"
,IN,AR,30307610,1005,100,,Invoice,,,,,,23/02/2018,23/02/2018,0.00,,2.12,,"-145,395.13"
,IN,AR,30307650,1005,100,,Invoice,,,,,,23/02/2018,23/02/2018,0.00,,22.44,,"-145,417.57"
,IN,AR,30307690,1005,100,,Invoice,,,,,,23/02/2018,23/02/2018,0.00,,14.58,,"-145,432.15"
,IN,AR,30307750,1005,100,,Invoice,,,,,,23/02/2018,23/02/2018,0.00,,2.71,,"-145,434.86"
,IN,AR,30307877,1005,100,,Invoice,,,,,,23/02/2018,23/02/2018,0.00,,43.73,,"-145,478.59"
,IN,AR,30307942,1005,100,,Invoice,,,,,,23/02/2018,23/02/2018,0.00,,7.29,,"-145,485.88"
,IN,AR,30308051,1005,100,,Invoice,,,,,,23/02/2018,23/02/2018,0.00,,48.26,,"-145,534.14"
,IN,AR,30308073,1005,100,,Invoice,,,,,,23/02/2018,23/02/2018,0.00,,34.08,,"-145,568.22"
,IN,AR,30308081,1005,100,,Invoice,,,,,,23/02/2018,23/02/2018,0.00,,14.58,,"-145,582.80"
,IN,AR,30308144,1005,100,,Invoice,,,,,,23/02/2018,23/02/2018,0.00,,76.97,,"-145,659.77"
,IN,AR,30308162,1005,100,,Invoice,,,,,,23/02/2018,23/02/2018,0.00,,31.53,,"-145,691.30"
,IN,AR,30308175,1005,100,,Invoice,,,,,,23/02/2018,23/02/2018,0.00,,18.22,,"-145,709.52"
,IN,AR,30308207,1005,100,,Invoice,,,,,,23/02/2018,23/02/2018,0.00,,33.47,,"-145,742.99"
,IN,AR,30308227,1005,100,,Invoice,,,,,,23/02/2018,23/02/2018,0.00,,25.42,,"-145,768.41"
,IN,AR,30308245,1005,100,,Invoice,,,,,,23/02/2018,23/02/2018,0.00,,14.00,,"-145,782.41"
,IN,AR,30308289,1005,100,,Invoice,,,,,,23/02/2018,23/02/2018,0.00,,21.90,,"-145,804.31"
,IN,AR,30308302,1005,100,,Invoice,,,,,,23/02/2018,23/02/2018,0.00,,15.18,,"-145,819.49"
,IN,AR,30308330,1005,100,,Invoice,,,,,,23/02/2018,23/02/2018,0.00,,10.93,,"-145,830.42"
,IN,AR,30308335,1005,100,,Invoice,,,,,,23/02/2018,23/02/2018,0.00,,13.78,,"-145,844.20"
,IN,AR,30308377,1005,100,,Invoice,,,,,,23/02/2018,23/02/2018,0.00,,10.93,,"-145,855.13"
,IN,AR,30308424,1005,100,,Invoice,,,,,,23/02/2018,23/02/2018,0.00,,14.19,,"-145,869.32"
,IN,AR,30308426,1005,100,,Invoice,,,,,,23/02/2018,23/02/2018,0.00,,28.98,,"-145,898.30"
,IN,AR,30308509,1005,100,,Invoice,,,,,,23/02/2018,23/02/2018,0.00,,8.00,,"-145,906.30"
,IN,AR,30308535,1005,100,,Invoice,,,,,,23/02/2018,23/02/2018,0.00,,18.22,,"-145,924.52"
,IN,AR,30308569,1005,100,,Invoice,,,,,,23/02/2018,23/02/2018,0.00,,8.75,,"-145,933.27"
,IN,AR,30308579,1005,100,,Invoice,,,,,,23/02/2018,23/02/2018,0.00,,13.69,,"-145,946.96"
,IN,AR,30308581,1005,100,,Invoice,,,,,,23/02/2018,23/02/2018,0.00,,182.20,,"-146,129.16"
,IN,AR,30308594,1005,100,,Invoice,,,,,,23/02/2018,23/02/2018,0.00,,42.37,,"-146,171.53"
,IN,AR,30308647,1005,100,,Invoice,,,,,,23/02/2018,23/02/2018,0.00,,5.24,,"-146,176.77"
,IN,AR,30308672,1005,100,,Invoice,,,,,,23/02/2018,23/02/2018,0.00,,10.21,,"-146,186.98"
,IN,AR,30308694,1005,100,,Invoice,,,,,,23/02/2018,23/02/2018,0.00,,7.29,,"-146,194.27"
,IN,AR,30308716,1005,100,,Invoice,,,,,,23/02/2018,23/02/2018,0.00,,54.66,,"-146,248.93"
,IN,AR,30308759,1005,100,,Invoice,,,,,,23/02/2018,23/02/2018,0.00,,17.54,,"-146,266.47"
,IN,AR,30308780,1005,100,,Invoice,,,,,,23/02/2018,23/02/2018,0.00,,419.07,,"-146,685.54"
,IN,AR,30308784,1005,100,,Invoice,,,,,,23/02/2018,23/02/2018,0.00,,7.25,,"-146,692.79"
,CS,AR,32001119,1005,100,,Cash sale,,,,,,24/02/2018,24/02/2018,0.00,,10.93,,"-146,703.72"
,CS,AR,32001279,1005,100,,Cash sale,,,,,,24/02/2018,24/02/2018,0.00,,10.00,,"-146,713.72"
,CS,AR,32001327,1005,100,,Cash sale,,,,,,24/02/2018,24/02/2018,0.00,,12.88,,"-146,726.60"
,CS,AR,32001444,1005,100,,Cash sale,,,,,,24/02/2018,24/02/2018,0.00,,14.58,,"-146,741.18"
,CS,AR,32001465,1005,100,,Cash sale,,,,,,24/02/2018,24/02/2018,0.00,,6.53,,"-146,747.71"
,CS,AR,32001513,1005,100,,Cash sale,,,,,,24/02/2018,24/02/2018,0.00,,8.20,,"-146,755.91"
,CS,AR,32001566,1005,100,,Cash sale,,,,,,24/02/2018,24/02/2018,0.00,,17.80,,"-146,773.71"
,CS,AR,32001635,1005,100,,Cash sale,,,,,,24/02/2018,24/02/2018,0.00,,18.22,,"-146,791.93"
,IN,AR,30307024,1005,100,,Invoice,,,,,,24/02/2018,24/02/2018,0.00,,780.96,,"-147,572.89"
,IN,AR,30307036,1005,100,,Invoice,,,,,,24/02/2018,24/02/2018,0.00,,14.58,,"-147,587.47"
,IN,AR,30307045,1005,100,,Invoice,,,,,,24/02/2018,24/02/2018,0.00,,10.93,,"-147,598.40"
,IN,AR,30307229,1005,100,,Invoice,,,,,,24/02/2018,24/02/2018,0.00,,182.20,,"-147,780.60"
,IN,AR,30307332,1005,100,,Invoice,,,,,,24/02/2018,24/02/2018,0.00,,14.58,,"-147,795.18"
,IN,AR,30307631,1005,100,,Invoice,,,,,,24/02/2018,24/02/2018,0.00,,25.42,,"-147,820.60"
,IN,AR,30307916,1005,100,,Invoice,,,,,,24/02/2018,24/02/2018,0.00,,4.85,,"-147,825.45"
,IN,AR,30307789,1005,100,,Invoice,,,,,,25/02/2018,25/02/2018,0.00,,29.15,,"-147,854.60"
,CN,AR,31017311,1005,100,,Credit Note,,,,,,26/02/2018,26/02/2018,7.29,,0.00,,"-147,847.31"
,CN,AR,31017397,1005,100,,Credit Note,,,,,,26/02/2018,26/02/2018,13.78,,0.00,,"-147,833.53"
,CN,AR,31017439,1005,100,,Credit Note,,,,,,26/02/2018,26/02/2018,455.51,,0.00,,"-147,378.02"
,CS,AR,32000957,1005,100,,Cash sale,,,,,,26/02/2018,26/02/2018,0.00,,7.12,,"-147,385.14"
,CS,AR,32001041,1005,100,,Cash sale,,,,,,26/02/2018,26/02/2018,0.00,,12.46,,"-147,397.60"
,CS,AR,32001061,1005,100,,Cash sale,,,,,,26/02/2018,26/02/2018,0.00,,8.77,,"-147,406.37"
,CS,AR,32001076,1005,100,,Cash sale,,,,,,26/02/2018,26/02/2018,0.00,,7.29,,"-147,413.66"
,CS,AR,32001077,1005,100,,Cash sale,,,,,,26/02/2018,26/02/2018,0.00,,7.29,,"-147,420.95"
,CS,AR,32001087,1005,100,,Cash sale,,,,,,26/02/2018,26/02/2018,0.00,,7.29,,"-147,428.24"
,CS,AR,32001096,1005,100,,Cash sale,,,,,,26/02/2018,26/02/2018,0.00,,3.64,,"-147,431.88"
,CS,AR,32001105,1005,100,,Cash sale,,,,,,26/02/2018,26/02/2018,0.00,,3.64,,"-147,435.52"
,CS,AR,32001112,1005,100,,Cash sale,,,,,,26/02/2018,26/02/2018,0.00,,10.34,,"-147,445.86"
,CS,AR,32001151,1005,100,,Cash sale,,,,,,26/02/2018,26/02/2018,0.00,,12.71,,"-147,458.57"
,CS,AR,32001188,1005,100,,Cash sale,,,,,,26/02/2018,26/02/2018,0.00,,5.49,,"-147,464.06"
,CS,AR,32001217,1005,100,,Cash sale,,,,,,26/02/2018,26/02/2018,0.00,,6.02,,"-147,470.08"
,CS,AR,32001229,1005,100,,Cash sale,,,,,,26/02/2018,26/02/2018,0.00,,5.08,,"-147,475.16"
,CS,AR,32001235,1005,100,,Cash sale,,,,,,26/02/2018,26/02/2018,0.00,,10.93,,"-147,486.09"
,CS,AR,32001247,1005,100,,Cash sale,,,,,,26/02/2018,26/02/2018,0.00,,8.16,,"-147,494.25"
,CS,AR,32001263,1005,100,,Cash sale,,,,,,26/02/2018,26/02/2018,0.00,,15.04,,"-147,509.29"
,CS,AR,32001266,1005,100,,Cash sale,,,,,,26/02/2018,26/02/2018,0.00,,10.93,,"-147,520.22"
,CS,AR,32001286,1005,100,,Cash sale,,,,,,26/02/2018,26/02/2018,0.00,,3.64,,"-147,523.86"
,CS,AR,32001312,1005,100,,Cash sale,,,,,,26/02/2018,26/02/2018,0.00,,10.51,,"-147,534.37"
,CS,AR,32001314,1005,100,,Cash sale,,,,,,26/02/2018,26/02/2018,0.00,,5.08,,"-147,539.45"
,CS,AR,32001374,1005,100,,Cash sale,,,,,,26/02/2018,26/02/2018,0.00,,3.64,,"-147,543.09"
,CS,AR,32001384,1005,100,,Cash sale,,,,,,26/02/2018,26/02/2018,0.00,,3.64,,"-147,546.73"
,CS,AR,32001438,1005,100,,Cash sale,,,,,,26/02/2018,26/02/2018,0.00,,3.64,,"-147,550.37"
,CS,AR,32001460,1005,100,,Cash sale,,,,,,26/02/2018,26/02/2018,0.00,,25.51,,"-147,575.88"
,CS,AR,32001474,1005,100,,Cash sale,,,,,,26/02/2018,26/02/2018,0.00,,5.17,,"-147,581.05"
,CS,AR,32001479,1005,100,,Cash sale,,,,,,26/02/2018,26/02/2018,0.00,,22.88,,"-147,603.93"
,CS,AR,32001516,1005,100,,Cash sale,,,,,,26/02/2018,26/02/2018,0.00,,3.28,,"-147,607.21"
,CS,AR,32001532,1005,100,,Cash sale,,,,,,26/02/2018,26/02/2018,0.00,,11.44,,"-147,618.65"
,CS,AR,32001560,1005,100,,Cash sale,,,,,,26/02/2018,26/02/2018,0.00,,9.10,,"-147,627.75"
,CS,AR,32001599,1005,100,,Cash sale,,,,,,26/02/2018,26/02/2018,0.00,,10.93,,"-147,638.68"
,CS,AR,32001628,1005,100,,Cash sale,,,,,,26/02/2018,26/02/2018,0.00,,7.29,,"-147,645.97"
,CS,AR,32001640,1005,100,,Cash sale,,,,,,26/02/2018,26/02/2018,0.00,,14.58,,"-147,660.55"
,CS,AR,32001655,1005,100,,Cash sale,,,,,,26/02/2018,26/02/2018,0.00,,29.15,,"-147,689.70"
,CS,AR,32001695,1005,100,,Cash sale,,,,,,26/02/2018,26/02/2018,0.00,,14.58,,"-147,704.28"
,IN,AR,30306670,1005,100,,Invoice,,,,,,26/02/2018,26/02/2018,0.00,,169.08,,"-147,873.36"
,IN,AR,30306703,1005,100,,Invoice,,,,,,26/02/2018,26/02/2018,0.00,,18.22,,"-147,891.58"
,IN,AR,30306774,1005,100,,Invoice,,,,,,26/02/2018,26/02/2018,0.00,,10.93,,"-147,902.51"
,IN,AR,30306788,1005,100,,Invoice,,,,,,26/02/2018,26/02/2018,0.00,,20.34,,"-147,922.85"
,IN,AR,30306792,1005,100,,Invoice,,,,,,26/02/2018,26/02/2018,0.00,,35.93,,"-147,958.78"
,IN,AR,30306815,1005,100,,Invoice,,,,,,26/02/2018,26/02/2018,0.00,,13.78,,"-147,972.56"
,IN,AR,30306823,1005,100,,Invoice,,,,,,26/02/2018,26/02/2018,0.00,,7.29,,"-147,979.85"
,IN,AR,30306843,1005,100,,Invoice,,,,,,26/02/2018,26/02/2018,0.00,,154.24,,"-148,134.09"
,IN,AR,30306852,1005,100,,Invoice,,,,,,26/02/2018,26/02/2018,0.00,,22.03,,"-148,156.12"
,IN,AR,30306869,1005,100,,Invoice,,,,,,26/02/2018,26/02/2018,0.00,,16.00,,"-148,172.12"
,IN,AR,30306888,1005,100,,Invoice,,,,,,26/02/2018,26/02/2018,0.00,,38.18,,"-148,210.30"
,IN,AR,30306915,1005,100,,Invoice,,,,,,26/02/2018,26/02/2018,0.00,,40.00,,"-148,250.30"
,IN,AR,30306931,1005,100,,Invoice,,,,,,26/02/2018,26/02/2018,0.00,,5.51,,"-148,255.81"
,IN,AR,30306936,1005,100,,Invoice,,,,,,26/02/2018,26/02/2018,0.00,,15.25,,"-148,271.06"
,IN,AR,30306940,1005,100,,Invoice,,,,,,26/02/2018,26/02/2018,0.00,,8.26,,"-148,279.32"
,IN,AR,30306973,1005,100,,Invoice,,,,,,26/02/2018,26/02/2018,0.00,,9.49,,"-148,288.81"
,IN,AR,30306989,1005,100,,Invoice,,,,,,26/02/2018,26/02/2018,0.00,,3.64,,"-148,292.45"
,IN,AR,30306992,1005,100,,Invoice,,,,,,26/02/2018,26/02/2018,0.00,,18.22,,"-148,310.67"
,IN,AR,30307043,1005,100,,Invoice,,,,,,26/02/2018,26/02/2018,0.00,,182.20,,"-148,492.87"
,IN,AR,30307068,1005,100,,Invoice,,,,,,26/02/2018,26/02/2018,0.00,,11.27,,"-148,504.14"
,IN,AR,30307081,1005,100,,Invoice,,,,,,26/02/2018,26/02/2018,0.00,,25.55,,"-148,529.69"
,IN,AR,30307117,1005,100,,Invoice,,,,,,26/02/2018,26/02/2018,0.00,,5.17,,"-148,534.86"
,IN,AR,30307142,1005,100,,Invoice,,,,,,26/02/2018,26/02/2018,0.00,,11.48,,"-148,546.34"
,IN,AR,30307171,1005,100,,Invoice,,,,,,26/02/2018,26/02/2018,0.00,,4.24,,"-148,550.58"
,IN,AR,30307180,1005,100,,Invoice,,,,,,26/02/2018,26/02/2018,0.00,,69.15,,"-148,619.73"
,IN,AR,30307204,1005,100,,Invoice,,,,,,26/02/2018,26/02/2018,0.00,,12.92,,"-148,632.65"
,IN,AR,30307224,1005,100,,Invoice,,,,,,26/02/2018,26/02/2018,0.00,,8.90,,"-148,641.55"
,IN,AR,30307227,1005,100,,Invoice,,,,,,26/02/2018,26/02/2018,0.00,,10.35,,"-148,651.90"
,IN,AR,30307228,1005,100,,Invoice,,,,,,26/02/2018,26/02/2018,0.00,,49.16,,"-148,701.06"
,IN,AR,30307241,1005,100,,Invoice,,,,,,26/02/2018,26/02/2018,0.00,,7.29,,"-148,708.35"
,IN,AR,30307278,1005,100,,Invoice,,,,,,26/02/2018,26/02/2018,0.00,,57.42,,"-148,765.77"
,IN,AR,30307289,1005,100,,Invoice,,,,,,26/02/2018,26/02/2018,0.00,,25.42,,"-148,791.19"
,IN,AR,30307315,1005,100,,Invoice,,,,,,26/02/2018,26/02/2018,0.00,,28.68,,"-148,819.87"
,IN,AR,30307316,1005,100,,Invoice,,,,,,26/02/2018,26/02/2018,0.00,,9.56,,"-148,829.43"
,IN,AR,30307322,1005,100,,Invoice,,,,,,26/02/2018,26/02/2018,0.00,,16.10,,"-148,845.53"
,IN,AR,30307336,1005,100,,Invoice,,,,,,26/02/2018,26/02/2018,0.00,,18.05,,"-148,863.58"
,IN,AR,30307347,1005,100,,Invoice,,,,,,26/02/2018,26/02/2018,0.00,,10.93,,"-148,874.51"
,IN,AR,30307350,1005,100,,Invoice,,,,,,26/02/2018,26/02/2018,0.00,,6.36,,"-148,880.87"
,IN,AR,30307356,1005,100,,Invoice,,,,,,26/02/2018,26/02/2018,0.00,,5.51,,"-148,886.38"
,IN,AR,30307385,1005,100,,Invoice,,,,,,26/02/2018,26/02/2018,0.00,,8.64,,"-148,895.02"
,IN,AR,30307436,1005,100,,Invoice,,,,,,26/02/2018,26/02/2018,0.00,,10.17,,"-148,905.19"
,IN,AR,30307485,1005,100,,Invoice,,,,,,26/02/2018,26/02/2018,0.00,,18.22,,"-148,923.41"
,IN,AR,30307547,1005,100,,Invoice,,,,,,26/02/2018,26/02/2018,0.00,,22.88,,"-148,946.29"
,IN,AR,30307557,1005,100,,Invoice,,,,,,26/02/2018,26/02/2018,0.00,,26.44,,"-148,972.73"
,IN,AR,30307587,1005,100,,Invoice,,,,,,26/02/2018,26/02/2018,0.00,,7.29,,"-148,980.02"
,IN,AR,30307593,1005,100,,Invoice,,,,,,26/02/2018,26/02/2018,0.00,,14.58,,"-148,994.60"
,IN,AR,30307618,1005,100,,Invoice,,,,,,26/02/2018,26/02/2018,0.00,,13.77,,"-149,008.37"
,IN,AR,30307626,1005,100,,Invoice,,,,,,26/02/2018,26/02/2018,0.00,,11.02,,"-149,019.39"
,IN,AR,30307630,1005,100,,Invoice,,,,,,26/02/2018,26/02/2018,0.00,,3.64,,"-149,023.03"
,IN,AR,30307643,1005,100,,Invoice,,,,,,26/02/2018,26/02/2018,0.00,,6.89,,"-149,029.92"
,IN,AR,30307651,1005,100,,Invoice,,,,,,26/02/2018,26/02/2018,0.00,,16.83,,"-149,046.75"
,IN,AR,30307720,1005,100,,Invoice,,,,,,26/02/2018,26/02/2018,0.00,,73.22,,"-149,119.97"
,IN,AR,30307722,1005,100,,Invoice,,,,,,26/02/2018,26/02/2018,0.00,,7.29,,"-149,127.26"
,IN,AR,30307736,1005,100,,Invoice,,,,,,26/02/2018,26/02/2018,0.00,,24.00,,"-149,151.26"
,IN,AR,30307744,1005,100,,Invoice,,,,,,26/02/2018,26/02/2018,0.00,,29.15,,"-149,180.41"
,IN,AR,30307778,1005,100,,Invoice,,,,,,26/02/2018,26/02/2018,0.00,,14.58,,"-149,194.99"
,IN,AR,30307785,1005,100,,Invoice,,,,,,26/02/2018,26/02/2018,0.00,,7.75,,"-149,202.74"
,IN,AR,30307802,1005,100,,Invoice,,,,,,26/02/2018,26/02/2018,0.00,,36.12,,"-149,238.86"
,IN,AR,30307873,1005,100,,Invoice,,,,,,26/02/2018,26/02/2018,0.00,,42.88,,"-149,281.74"
,IN,AR,30307882,1005,100,,Invoice,,,,,,26/02/2018,26/02/2018,0.00,,13.14,,"-149,294.88"
,IN,AR,30307899,1005,100,,Invoice,,,,,,26/02/2018,26/02/2018,0.00,,5.29,,"-149,300.17"
,IN,AR,30307970,1005,100,,Invoice,,,,,,26/02/2018,26/02/2018,0.00,,4.29,,"-149,304.46"
,IN,AR,30308062,1005,100,,Invoice,,,,,,26/02/2018,26/02/2018,0.00,,4.29,,"-149,308.75"
,IN,AR,30308074,1005,100,,Invoice,,,,,,26/02/2018,26/02/2018,0.00,,10.03,,"-149,318.78"
,IN,AR,30308145,1005,100,,Invoice,,,,,,26/02/2018,26/02/2018,0.00,,8.02,,"-149,326.80"
,IN,AR,30308189,1005,100,,Invoice,,,,,,26/02/2018,26/02/2018,0.00,,9.84,,"-149,336.64"
,IN,AR,30308236,1005,100,,Invoice,,,,,,26/02/2018,26/02/2018,0.00,,14.00,,"-149,350.64"
,IN,AR,30308277,1005,100,,Invoice,,,,,,26/02/2018,26/02/2018,0.00,,42.24,,"-149,392.88"
,IN,AR,30308307,1005,100,,Invoice,,,,,,26/02/2018,26/02/2018,0.00,,29.15,,"-149,422.03"
,IN,AR,30308311,1005,100,,Invoice,,,,,,26/02/2018,26/02/2018,0.00,,24.16,,"-149,446.19"
,IN,AR,30308316,1005,100,,Invoice,,,,,,26/02/2018,26/02/2018,0.00,,149.15,,"-149,595.34"
,IN,AR,30308329,1005,100,,Invoice,,,,,,26/02/2018,26/02/2018,0.00,,25.25,,"-149,620.59"
,IN,AR,30308406,1005,100,,Invoice,,,,,,26/02/2018,26/02/2018,0.00,,29.15,,"-149,649.74"
,IN,AR,30308431,1005,100,,Invoice,,,,,,26/02/2018,26/02/2018,0.00,,29.36,,"-149,679.10"
,IN,AR,30308464,1005,100,,Invoice,,,,,,26/02/2018,26/02/2018,0.00,,14.34,,"-149,693.44"
,IN,AR,30308510,1005,100,,Invoice,,,,,,26/02/2018,26/02/2018,0.00,,12.00,,"-149,705.44"
,IN,AR,30308519,1005,100,,Invoice,,,,,,26/02/2018,26/02/2018,0.00,,1.88,,"-149,707.32"
,IN,AR,30308546,1005,100,,Invoice,,,,,,26/02/2018,26/02/2018,0.00,,29.15,,"-149,736.47"
,IN,AR,30308601,1005,100,,Invoice,,,,,,26/02/2018,26/02/2018,0.00,,29.15,,"-149,765.62"
,IN,AR,30308673,1005,100,,Invoice,,,,,,26/02/2018,26/02/2018,0.00,,4.08,,"-149,769.70"
,IN,AR,30308704,1005,100,,Invoice,,,,,,26/02/2018,26/02/2018,0.00,,40.08,,"-149,809.78"
,IN,AR,30308718,1005,100,,Invoice,,,,,,26/02/2018,26/02/2018,0.00,,8.26,,"-149,818.04"
,IN,AR,30308760,1005,100,,Invoice,,,,,,26/02/2018,26/02/2018,0.00,,58.47,,"-149,876.51"
,CS,AR,32000960,1005,100,,Cash sale,,,,,,27/02/2018,27/02/2018,0.00,,17.03,,"-149,893.54"
,CS,AR,32000996,1005,100,,Cash sale,,,,,,27/02/2018,27/02/2018,0.00,,7.29,,"-149,900.83"
,CS,AR,32001015,1005,100,,Cash sale,,,,,,27/02/2018,27/02/2018,0.00,,3.01,,"-149,903.84"
,CS,AR,32001022,1005,100,,Cash sale,,,,,,27/02/2018,27/02/2018,0.00,,7.29,,"-149,911.13"
,CS,AR,32001043,1005,100,,Cash sale,,,,,,27/02/2018,27/02/2018,0.00,,7.29,,"-149,918.42"
,CS,AR,32001044,1005,100,,Cash sale,,,,,,27/02/2018,27/02/2018,0.00,,7.29,,"-149,925.71"
,CS,AR,32001047,1005,100,,Cash sale,,,,,,27/02/2018,27/02/2018,0.00,,10.93,,"-149,936.64"
,CS,AR,32001064,1005,100,,Cash sale,,,,,,27/02/2018,27/02/2018,0.00,,10.93,,"-149,947.57"
,CS,AR,32001065,1005,100,,Cash sale,,,,,,27/02/2018,27/02/2018,0.00,,29.15,,"-149,976.72"
,CS,AR,32001066,1005,100,,Cash sale,,,,,,27/02/2018,27/02/2018,0.00,,18.22,,"-149,994.94"
,CS,AR,32001070,1005,100,,Cash sale,,,,,,27/02/2018,27/02/2018,0.00,,14.58,,"-150,009.52"
,CS,AR,32001089,1005,100,,Cash sale,,,,,,27/02/2018,27/02/2018,0.00,,10.93,,"-150,020.45"
,CS,AR,32001124,1005,100,,Cash sale,,,,,,27/02/2018,27/02/2018,0.00,,2.39,,"-150,022.84"
,CS,AR,32001129,1005,100,,Cash sale,,,,,,27/02/2018,27/02/2018,0.00,,2.16,,"-150,025.00"
,CS,AR,32001130,1005,100,,Cash sale,,,,,,27/02/2018,27/02/2018,0.00,,7.29,,"-150,032.29"
,CS,AR,32001203,1005,100,,Cash sale,,,,,,27/02/2018,27/02/2018,0.00,,7.29,,"-150,039.58"
,CS,AR,32001215,1005,100,,Cash sale,,,,,,27/02/2018,27/02/2018,0.00,,7.29,,"-150,046.87"
,CS,AR,32001232,1005,100,,Cash sale,,,,,,27/02/2018,27/02/2018,0.00,,12.03,,"-150,058.90"
,CS,AR,32001255,1005,100,,Cash sale,,,,,,27/02/2018,27/02/2018,0.00,,7.80,,"-150,066.70"
,CS,AR,32001271,1005,100,,Cash sale,,,,,,27/02/2018,27/02/2018,0.00,,5.85,,"-150,072.55"
,CS,AR,32001283,1005,100,,Cash sale,,,,,,27/02/2018,27/02/2018,0.00,,4.78,,"-150,077.33"
,CS,AR,32001288,1005,100,,Cash sale,,,,,,27/02/2018,27/02/2018,0.00,,3.64,,"-150,080.97"
,CS,AR,32001298,1005,100,,Cash sale,,,,,,27/02/2018,27/02/2018,0.00,,5.08,,"-150,086.05"
,CS,AR,32001305,1005,100,,Cash sale,,,,,,27/02/2018,27/02/2018,0.00,,5.17,,"-150,091.22"
,CS,AR,32001320,1005,100,,Cash sale,,,,,,27/02/2018,27/02/2018,0.00,,18.05,,"-150,109.27"
,CS,AR,32001322,1005,100,,Cash sale,,,,,,27/02/2018,27/02/2018,0.00,,9.75,,"-150,119.02"
,CS,AR,32001349,1005,100,,Cash sale,,,,,,27/02/2018,27/02/2018,0.00,,7.29,,"-150,126.31"
,CS,AR,32001367,1005,100,,Cash sale,,,,,,27/02/2018,27/02/2018,0.00,,18.22,,"-150,144.53"
,CS,AR,32001370,1005,100,,Cash sale,,,,,,27/02/2018,27/02/2018,0.00,,5.59,,"-150,150.12"
,CS,AR,32001387,1005,100,,Cash sale,,,,,,27/02/2018,27/02/2018,0.00,,9.66,,"-150,159.78"
,CS,AR,32001406,1005,100,,Cash sale,,,,,,27/02/2018,27/02/2018,0.00,,10.93,,"-150,170.71"
,CS,AR,32001413,1005,100,,Cash sale,,,,,,27/02/2018,27/02/2018,0.00,,6.43,,"-150,177.14"
,CS,AR,32001441,1005,100,,Cash sale,,,,,,27/02/2018,27/02/2018,0.00,,10.95,,"-150,188.09"
,CS,AR,32001453,1005,100,,Cash sale,,,,,,27/02/2018,27/02/2018,0.00,,22.88,,"-150,210.97"
,CS,AR,32001480,1005,100,,Cash sale,,,,,,27/02/2018,27/02/2018,0.00,,22.88,,"-150,233.85"
,CS,AR,32001495,1005,100,,Cash sale,,,,,,27/02/2018,27/02/2018,0.00,,30.00,,"-150,263.85"
,CS,AR,32001545,1005,100,,Cash sale,,,,,,27/02/2018,27/02/2018,0.00,,5.93,,"-150,269.78"
,CS,AR,32001564,1005,100,,Cash sale,,,,,,27/02/2018,27/02/2018,0.00,,5.50,,"-150,275.28"
,CS,AR,32001647,1005,100,,Cash sale,,,,,,27/02/2018,27/02/2018,0.00,,10.93,,"-150,286.21"
,CS,AR,32001648,1005,100,,Cash sale,,,,,,27/02/2018,27/02/2018,0.00,,54.66,,"-150,340.87"
,CS,AR,32001654,1005,100,,Cash sale,,,,,,27/02/2018,27/02/2018,0.00,,16.42,,"-150,357.29"
,CS,AR,32001662,1005,100,,Cash sale,,,,,,27/02/2018,27/02/2018,0.00,,14.58,,"-150,371.87"
,CS,AR,32001684,1005,100,,Cash sale,,,,,,27/02/2018,27/02/2018,0.00,,7.29,,"-150,379.16"
,CS,AR,32001696,1005,100,,Cash sale,,,,,,27/02/2018,27/02/2018,0.00,,21.86,,"-150,401.02"
,IN,AR,30306782,1005,100,,Invoice,,,,,,27/02/2018,27/02/2018,0.00,,7.00,,"-150,408.02"
,IN,AR,30306844,1005,100,,Invoice,,,,,,27/02/2018,27/02/2018,0.00,,26.10,,"-150,434.12"
,IN,AR,30306880,1005,100,,Invoice,,,,,,27/02/2018,27/02/2018,0.00,,18.22,,"-150,452.34"
,IN,AR,30306993,1005,100,,Invoice,,,,,,27/02/2018,27/02/2018,0.00,,14.58,,"-150,466.92"
,IN,AR,30307051,1005,100,,Invoice,,,,,,27/02/2018,27/02/2018,0.00,,3.64,,"-150,470.56"
,IN,AR,30307059,1005,100,,Invoice,,,,,,27/02/2018,27/02/2018,0.00,,7.29,,"-150,477.85"
,IN,AR,30307105,1005,100,,Invoice,,,,,,27/02/2018,27/02/2018,0.00,,7.29,,"-150,485.14"
,IN,AR,30307124,1005,100,,Invoice,,,,,,27/02/2018,27/02/2018,0.00,,13.93,,"-150,499.07"
,IN,AR,30307137,1005,100,,Invoice,,,,,,27/02/2018,27/02/2018,0.00,,9.59,,"-150,508.66"
,IN,AR,30307144,1005,100,,Invoice,,,,,,27/02/2018,27/02/2018,0.00,,10.17,,"-150,518.83"
,IN,AR,30307165,1005,100,,Invoice,,,,,,27/02/2018,27/02/2018,0.00,,6.36,,"-150,525.19"
,IN,AR,30307191,1005,100,,Invoice,,,,,,27/02/2018,27/02/2018,0.00,,10.59,,"-150,535.78"
,IN,AR,30307214,1005,100,,Invoice,,,,,,27/02/2018,27/02/2018,0.00,,2.58,,"-150,538.36"
,IN,AR,30307298,1005,100,,Invoice,,,,,,27/02/2018,27/02/2018,0.00,,7.75,,"-150,546.11"
,IN,AR,30307301,1005,100,,Invoice,,,,,,27/02/2018,27/02/2018,0.00,,12.86,,"-150,558.97"
,IN,AR,30307317,1005,100,,Invoice,,,,,,27/02/2018,27/02/2018,0.00,,4.78,,"-150,563.75"
,IN,AR,30307372,1005,100,,Invoice,,,,,,27/02/2018,27/02/2018,0.00,,18.38,,"-150,582.13"
,IN,AR,30307412,1005,100,,Invoice,,,,,,27/02/2018,27/02/2018,0.00,,47.37,,"-150,629.50"
,IN,AR,30307458,1005,100,,Invoice,,,,,,27/02/2018,27/02/2018,0.00,,7.97,,"-150,637.47"
,IN,AR,30307480,1005,100,,Invoice,,,,,,27/02/2018,27/02/2018,0.00,,10.17,,"-150,647.64"
,IN,AR,30307526,1005,100,,Invoice,,,,,,27/02/2018,27/02/2018,0.00,,7.29,,"-150,654.93"
,IN,AR,30307531,1005,100,,Invoice,,,,,,27/02/2018,27/02/2018,0.00,,7.29,,"-150,662.22"
,IN,AR,30307550,1005,100,,Invoice,,,,,,27/02/2018,27/02/2018,0.00,,7.29,,"-150,669.51"
,IN,AR,30307564,1005,100,,Invoice,,,,,,27/02/2018,27/02/2018,0.00,,9.92,,"-150,679.43"
,IN,AR,30307574,1005,100,,Invoice,,,,,,27/02/2018,27/02/2018,0.00,,20.34,,"-150,699.77"
,IN,AR,30307580,1005,100,,Invoice,,,,,,27/02/2018,27/02/2018,0.00,,17.54,,"-150,717.31"
,IN,AR,30307602,1005,100,,Invoice,,,,,,27/02/2018,27/02/2018,0.00,,12.71,,"-150,730.02"
,IN,AR,30307608,1005,100,,Invoice,,,,,,27/02/2018,27/02/2018,0.00,,10.59,,"-150,740.61"
,IN,AR,30307664,1005,100,,Invoice,,,,,,27/02/2018,27/02/2018,0.00,,35.59,,"-150,776.20"
,IN,AR,30307691,1005,100,,Invoice,,,,,,27/02/2018,27/02/2018,0.00,,7.29,,"-150,783.49"
,IN,AR,30307716,1005,100,,Invoice,,,,,,27/02/2018,27/02/2018,0.00,,25.17,,"-150,808.66"
,IN,AR,30307740,1005,100,,Invoice,,,,,,27/02/2018,27/02/2018,0.00,,19.30,,"-150,827.96"
,IN,AR,30307788,1005,100,,Invoice,,,,,,27/02/2018,27/02/2018,0.00,,5.86,,"-150,833.82"
,IN,AR,30307796,1005,100,,Invoice,,,,,,27/02/2018,27/02/2018,0.00,,5.68,,"-150,839.50"
,IN,AR,30307853,1005,100,,Invoice,,,,,,27/02/2018,27/02/2018,0.00,,10.93,,"-150,850.43"
,IN,AR,30307874,1005,100,,Invoice,,,,,,27/02/2018,27/02/2018,0.00,,38.59,,"-150,889.02"
,IN,AR,30307900,1005,100,,Invoice,,,,,,27/02/2018,27/02/2018,0.00,,3.53,,"-150,892.55"
,IN,AR,30307927,1005,100,,Invoice,,,,,,27/02/2018,27/02/2018,0.00,,63.56,,"-150,956.11"
,IN,AR,30308039,1005,100,,Invoice,,,,,,27/02/2018,27/02/2018,0.00,,4.77,,"-150,960.88"
,IN,AR,30308040,1005,100,,Invoice,,,,,,27/02/2018,27/02/2018,0.00,,236.91,,"-151,197.79"
,IN,AR,30308041,1005,100,,Invoice,,,,,,27/02/2018,27/02/2018,0.00,,9.54,,"-151,207.33"
,IN,AR,30308042,1005,100,,Invoice,,,,,,27/02/2018,27/02/2018,0.00,,11.13,,"-151,218.46"
,IN,AR,30308052,1005,100,,Invoice,,,,,,27/02/2018,27/02/2018,0.00,,22.71,,"-151,241.17"
,IN,AR,30308103,1005,100,,Invoice,,,,,,27/02/2018,27/02/2018,0.00,,191.31,,"-151,432.48"
,IN,AR,30308146,1005,100,,Invoice,,,,,,27/02/2018,27/02/2018,0.00,,8.02,,"-151,440.50"
,IN,AR,30308212,1005,100,,Invoice,,,,,,27/02/2018,27/02/2018,0.00,,29.15,,"-151,469.65"
,IN,AR,30308228,1005,100,,Invoice,,,,,,27/02/2018,27/02/2018,0.00,,17.80,,"-151,487.45"
,IN,AR,30308240,1005,100,,Invoice,,,,,,27/02/2018,27/02/2018,0.00,,10.00,,"-151,497.45"
,IN,AR,30308321,1005,100,,Invoice,,,,,,27/02/2018,27/02/2018,0.00,,8.21,,"-151,505.66"
,IN,AR,30308360,1005,100,,Invoice,,,,,,27/02/2018,27/02/2018,0.00,,108.00,,"-151,613.66"
,IN,AR,30308364,1005,100,,Invoice,,,,,,27/02/2018,27/02/2018,0.00,,12.14,,"-151,625.80"
,IN,AR,30308400,1005,100,,Invoice,,,,,,27/02/2018,27/02/2018,0.00,,26.10,,"-151,651.90"
,IN,AR,30308469,1005,100,,Invoice,,,,,,27/02/2018,27/02/2018,0.00,,73.22,,"-151,725.12"
,IN,AR,30308493,1005,100,,Invoice,,,,,,27/02/2018,27/02/2018,0.00,,26.10,,"-151,751.22"
,IN,AR,30308494,1005,100,,Invoice,,,,,,27/02/2018,27/02/2018,0.00,,21.36,,"-151,772.58"
,IN,AR,30308495,1005,100,,Invoice,,,,,,27/02/2018,27/02/2018,0.00,,94.92,,"-151,867.50"
,IN,AR,30308527,1005,100,,Invoice,,,,,,27/02/2018,27/02/2018,0.00,,3.51,,"-151,871.01"
,IN,AR,30308534,1005,100,,Invoice,,,,,,27/02/2018,27/02/2018,0.00,,6.00,,"-151,877.01"
,IN,AR,30308545,1005,100,,Invoice,,,,,,27/02/2018,27/02/2018,0.00,,114.97,,"-151,991.98"
,IN,AR,30308565,1005,100,,Invoice,,,,,,27/02/2018,27/02/2018,0.00,,5.26,,"-151,997.24"
,CS,AR,32000947,1005,100,,Cash sale,,,,,,28/02/2018,28/02/2018,0.00,,3.64,,"-152,000.88"
,CS,AR,32000951,1005,100,,Cash sale,,,,,,28/02/2018,28/02/2018,0.00,,37.63,,"-152,038.51"
,CS,AR,32000969,1005,100,,Cash sale,,,,,,28/02/2018,28/02/2018,0.00,,7.29,,"-152,045.80"
,CS,AR,32000985,1005,100,,Cash sale,,,,,,28/02/2018,28/02/2018,0.00,,3.64,,"-152,049.44"
,CS,AR,32001028,1005,100,,Cash sale,,,,,,28/02/2018,28/02/2018,0.00,,3.64,,"-152,053.08"
,CS,AR,32001050,1005,100,,Cash sale,,,,,,28/02/2018,28/02/2018,0.00,,7.29,,"-152,060.37"
,CS,AR,32001052,1005,100,,Cash sale,,,,,,28/02/2018,28/02/2018,0.00,,3.01,,"-152,063.38"
,CS,AR,32001101,1005,100,,Cash sale,,,,,,28/02/2018,28/02/2018,0.00,,5.86,,"-152,069.24"
,CS,AR,32001171,1005,100,,Cash sale,,,,,,28/02/2018,28/02/2018,0.00,,41.36,,"-152,110.60"
,CS,AR,32001178,1005,100,,Cash sale,,,,,,28/02/2018,28/02/2018,0.00,,7.29,,"-152,117.89"
,CS,AR,32001191,1005,100,,Cash sale,,,,,,28/02/2018,28/02/2018,0.00,,21.06,,"-152,138.95"
,CS,AR,32001208,1005,100,,Cash sale,,,,,,28/02/2018,28/02/2018,0.00,,18.22,,"-152,157.17"
,CS,AR,32001211,1005,100,,Cash sale,,,,,,28/02/2018,28/02/2018,0.00,,7.29,,"-152,164.46"
,CS,AR,32001222,1005,100,,Cash sale,,,,,,28/02/2018,28/02/2018,0.00,,2.54,,"-152,167.00"
,CS,AR,32001230,1005,100,,Cash sale,,,,,,28/02/2018,28/02/2018,0.00,,2.54,,"-152,169.54"
,CS,AR,32001251,1005,100,,Cash sale,,,,,,28/02/2018,28/02/2018,0.00,,6.02,,"-152,175.56"
,CS,AR,32001268,1005,100,,Cash sale,,,,,,28/02/2018,28/02/2018,0.00,,4.32,,"-152,179.88"
,CS,AR,32001329,1005,100,,Cash sale,,,,,,28/02/2018,28/02/2018,0.00,,3.64,,"-152,183.52"
,CS,AR,32001341,1005,100,,Cash sale,,,,,,28/02/2018,28/02/2018,0.00,,14.58,,"-152,198.10"
,CS,AR,32001357,1005,100,,Cash sale,,,,,,28/02/2018,28/02/2018,0.00,,3.01,,"-152,201.11"
,CS,AR,32001423,1005,100,,Cash sale,,,,,,28/02/2018,28/02/2018,0.00,,5.17,,"-152,206.28"
,CS,AR,32001434,1005,100,,Cash sale,,,,,,28/02/2018,28/02/2018,0.00,,11.86,,"-152,218.14"
,CS,AR,32001484,1005,100,,Cash sale,,,,,,28/02/2018,28/02/2018,0.00,,7.29,,"-152,225.43"
,CS,AR,32001533,1005,100,,Cash sale,,,,,,28/02/2018,28/02/2018,0.00,,9.15,,"-152,234.58"
,CS,AR,32001535,1005,100,,Cash sale,,,,,,28/02/2018,28/02/2018,0.00,,21.86,,"-152,256.44"
,CS,AR,32001542,1005,100,,Cash sale,,,,,,28/02/2018,28/02/2018,0.00,,6.07,,"-152,262.51"
,CS,AR,32001565,1005,100,,Cash sale,,,,,,28/02/2018,28/02/2018,0.00,,6.86,,"-152,269.37"
,CS,AR,32001574,1005,100,,Cash sale,,,,,,28/02/2018,28/02/2018,0.00,,9.03,,"-152,278.40"
,CS,AR,32001618,1005,100,,Cash sale,,,,,,28/02/2018,28/02/2018,0.00,,12.14,,"-152,290.54"
,CS,AR,32001621,1005,100,,Cash sale,,,,,,28/02/2018,28/02/2018,0.00,,3.64,,"-152,294.18"
,CS,AR,32001680,1005,100,,Cash sale,,,,,,28/02/2018,28/02/2018,0.00,,8.25,,"-152,302.43"
,CS,AR,32001698,1005,100,,Cash sale,,,,,,28/02/2018,28/02/2018,0.00,,3.90,,"-152,306.33"
,IN,AR,30306689,1005,100,,Invoice,,,,,,28/02/2018,28/02/2018,0.00,,29.66,,"-152,335.99"
,IN,AR,30306690,1005,100,,Invoice,,,,,,28/02/2018,28/02/2018,0.00,,53.39,,"-152,389.38"
,IN,AR,30306722,1005,100,,Invoice,,,,,,28/02/2018,28/02/2018,0.00,,97.63,,"-152,487.01"
,IN,AR,30306723,1005,100,,Invoice,,,,,,28/02/2018,28/02/2018,0.00,,12.20,,"-152,499.21"
,IN,AR,30306736,1005,100,,Invoice,,,,,,28/02/2018,28/02/2018,0.00,,11.36,,"-152,510.57"
,IN,AR,30306740,1005,100,,Invoice,,,,,,28/02/2018,28/02/2018,0.00,,"1,447.21",,"-153,957.78"
,IN,AR,30306744,1005,100,,Invoice,,,,,,28/02/2018,28/02/2018,0.00,,21.91,,"-153,979.69"
,IN,AR,30306758,1005,100,,Invoice,,,,,,28/02/2018,28/02/2018,0.00,,21.02,,"-154,000.71"
,IN,AR,30306759,1005,100,,Invoice,,,,,,28/02/2018,28/02/2018,0.00,,70.93,,"-154,071.64"
,IN,AR,30306805,1005,100,,Invoice,,,,,,28/02/2018,28/02/2018,0.00,,14.58,,"-154,086.22"
,IN,AR,30306821,1005,100,,Invoice,,,,,,28/02/2018,28/02/2018,0.00,,11.64,,"-154,097.86"
,IN,AR,30306845,1005,100,,Invoice,,,,,,28/02/2018,28/02/2018,0.00,,11.86,,"-154,109.72"
,IN,AR,30306855,1005,100,,Invoice,,,,,,28/02/2018,28/02/2018,0.00,,"1,426.27",,"-155,535.99"
,IN,AR,30306870,1005,100,,Invoice,,,,,,28/02/2018,28/02/2018,0.00,,14.58,,"-155,550.57"
,IN,AR,30306897,1005,100,,Invoice,,,,,,28/02/2018,28/02/2018,0.00,,14.58,,"-155,565.15"
,IN,AR,30306916,1005,100,,Invoice,,,,,,28/02/2018,28/02/2018,0.00,,14.00,,"-155,579.15"
,IN,AR,30306932,1005,100,,Invoice,,,,,,28/02/2018,28/02/2018,0.00,,10.93,,"-155,590.08"
,IN,AR,30306960,1005,100,,Invoice,,,,,,28/02/2018,28/02/2018,0.00,,28.00,,"-155,618.08"
,IN,AR,30306967,1005,100,,Invoice,,,,,,28/02/2018,28/02/2018,0.00,,7.29,,"-155,625.37"
,IN,AR,30306974,1005,100,,Invoice,,,,,,28/02/2018,28/02/2018,0.00,,56.95,,"-155,682.32"
,IN,AR,30306984,1005,100,,Invoice,,,,,,28/02/2018,28/02/2018,0.00,,14.00,,"-155,696.32"
,IN,AR,30307019,1005,100,,Invoice,,,,,,28/02/2018,28/02/2018,0.00,,90.05,,"-155,786.37"
,IN,AR,30307020,1005,100,,Invoice,,,,,,28/02/2018,28/02/2018,0.00,,73.68,,"-155,860.05"
,IN,AR,30307055,1005,100,,Invoice,,,,,,28/02/2018,28/02/2018,0.00,,3.01,,"-155,863.06"
,IN,AR,30307074,1005,100,,Invoice,,,,,,28/02/2018,28/02/2018,0.00,,21.22,,"-155,884.28"
,IN,AR,30307075,1005,100,,Invoice,,,,,,28/02/2018,28/02/2018,0.00,,84.24,,"-155,968.52"
,IN,AR,30307087,1005,100,,Invoice,,,,,,28/02/2018,28/02/2018,0.00,,10.93,,"-155,979.45"
,IN,AR,30307153,1005,100,,Invoice,,,,,,28/02/2018,28/02/2018,0.00,,15.25,,"-155,994.70"
,IN,AR,30307155,1005,100,,Invoice,,,,,,28/02/2018,28/02/2018,0.00,,"1,406.90",,"-157,401.60"
,IN,AR,30307156,1005,100,,Invoice,,,,,,28/02/2018,28/02/2018,0.00,,57.89,,"-157,459.49"
,IN,AR,30307157,1005,100,,Invoice,,,,,,28/02/2018,28/02/2018,0.00,,14.03,,"-157,473.52"
,IN,AR,30307158,1005,100,,Invoice,,,,,,28/02/2018,28/02/2018,0.00,,73.68,,"-157,547.20"
,IN,AR,30307169,1005,100,,Invoice,,,,,,28/02/2018,28/02/2018,0.00,,6.36,,"-157,553.56"
,IN,AR,30307183,1005,100,,Invoice,,,,,,28/02/2018,28/02/2018,0.00,,205.51,,"-157,759.07"
,IN,AR,30307238,1005,100,,Invoice,,,,,,28/02/2018,28/02/2018,0.00,,21.86,,"-157,780.93"
,IN,AR,30307255,1005,100,,Invoice,,,,,,28/02/2018,28/02/2018,0.00,,38.24,,"-157,819.17"
,IN,AR,30307257,1005,100,,Invoice,,,,,,28/02/2018,28/02/2018,0.00,,"1,488.27",,"-159,307.44"
,IN,AR,30307279,1005,100,,Invoice,,,,,,28/02/2018,28/02/2018,0.00,,36.92,,"-159,344.36"
,IN,AR,30307294,1005,100,,Invoice,,,,,,28/02/2018,28/02/2018,0.00,,10.93,,"-159,355.29"
,IN,AR,30307323,1005,100,,Invoice,,,,,,28/02/2018,28/02/2018,0.00,,9.66,,"-159,364.95"
,IN,AR,30307337,1005,100,,Invoice,,,,,,28/02/2018,28/02/2018,0.00,,741.66,,"-160,106.61"
,IN,AR,30307338,1005,100,,Invoice,,,,,,28/02/2018,28/02/2018,0.00,,30.20,,"-160,136.81"
,IN,AR,30307339,1005,100,,Invoice,,,,,,28/02/2018,28/02/2018,0.00,,16.78,,"-160,153.59"
,IN,AR,30307340,1005,100,,Invoice,,,,,,28/02/2018,28/02/2018,0.00,,41.95,,"-160,195.54"
,IN,AR,30307341,1005,100,,Invoice,,,,,,28/02/2018,28/02/2018,0.00,,45.31,,"-160,240.85"
,IN,AR,30307342,1005,100,,Invoice,,,,,,28/02/2018,28/02/2018,0.00,,6.71,,"-160,247.56"
,IN,AR,30307343,1005,100,,Invoice,,,,,,28/02/2018,28/02/2018,0.00,,10.07,,"-160,257.63"
,IN,AR,30307376,1005,100,,Invoice,,,,,,28/02/2018,28/02/2018,0.00,,105.25,,"-160,362.88"
,IN,AR,30307377,1005,100,,Invoice,,,,,,28/02/2018,28/02/2018,0.00,,157.88,,"-160,520.76"
,IN,AR,30307381,1005,100,,Invoice,,,,,,28/02/2018,28/02/2018,0.00,,72.03,,"-160,592.79"
,IN,AR,30307382,1005,100,,Invoice,,,,,,28/02/2018,28/02/2018,0.00,,39.51,,"-160,632.30"
,IN,AR,30307383,1005,100,,Invoice,,,,,,28/02/2018,28/02/2018,0.00,,56.14,,"-160,688.44"
,IN,AR,30307384,1005,100,,Invoice,,,,,,28/02/2018,28/02/2018,0.00,,161.39,,"-160,849.83"
,IN,AR,30307386,1005,100,,Invoice,,,,,,28/02/2018,28/02/2018,0.00,,36.84,,"-160,886.67"
,IN,AR,30307387,1005,100,,Invoice,,,,,,28/02/2018,28/02/2018,0.00,,11.29,,"-160,897.96"
,IN,AR,30307388,1005,100,,Invoice,,,,,,28/02/2018,28/02/2018,0.00,,37.63,,"-160,935.59"
,IN,AR,30307389,1005,100,,Invoice,,,,,,28/02/2018,28/02/2018,0.00,,50.80,,"-160,986.39"
,IN,AR,30307390,1005,100,,Invoice,,,,,,28/02/2018,28/02/2018,0.00,,31.98,,"-161,018.37"
,IN,AR,30307391,1005,100,,Invoice,,,,,,28/02/2018,28/02/2018,0.00,,28.22,,"-161,046.59"
,IN,AR,30307392,1005,100,,Invoice,,,,,,28/02/2018,28/02/2018,0.00,,11.29,,"-161,057.88"
,IN,AR,30307393,1005,100,,Invoice,,,,,,28/02/2018,28/02/2018,0.00,,47.03,,"-161,104.91"
,IN,AR,30307394,1005,100,,Invoice,,,,,,28/02/2018,28/02/2018,0.00,,73.37,,"-161,178.28"
,IN,AR,30307395,1005,100,,Invoice,,,,,,28/02/2018,28/02/2018,0.00,,1.88,,"-161,180.16"
,IN,AR,30307396,1005,100,,Invoice,,,,,,28/02/2018,28/02/2018,0.00,,5.64,,"-161,185.80"
,IN,AR,30307398,1005,100,,Invoice,,,,,,28/02/2018,28/02/2018,0.00,,342.08,,"-161,527.88"
,IN,AR,30307402,1005,100,,Invoice,,,,,,28/02/2018,28/02/2018,0.00,,43.86,,"-161,571.74"
,IN,AR,30307403,1005,100,,Invoice,,,,,,28/02/2018,28/02/2018,0.00,,38.59,,"-161,610.33"
,IN,AR,30307404,1005,100,,Invoice,,,,,,28/02/2018,28/02/2018,0.00,,18.81,,"-161,629.14"
,IN,AR,30307405,1005,100,,Invoice,,,,,,28/02/2018,28/02/2018,0.00,,17.54,,"-161,646.68"
,IN,AR,30307406,1005,100,,Invoice,,,,,,28/02/2018,28/02/2018,0.00,,35.08,,"-161,681.76"
,IN,AR,30307409,1005,100,,Invoice,,,,,,28/02/2018,28/02/2018,0.00,,14.03,,"-161,695.79"
,IN,AR,30307410,1005,100,,Invoice,,,,,,28/02/2018,28/02/2018,0.00,,49.12,,"-161,744.91"
,IN,AR,30307411,1005,100,,Invoice,,,,,,28/02/2018,28/02/2018,0.00,,22.81,,"-161,767.72"
,IN,AR,30307415,1005,100,,Invoice,,,,,,28/02/2018,28/02/2018,0.00,,3.51,,"-161,771.23"
,IN,AR,30307437,1005,100,,Invoice,,,,,,28/02/2018,28/02/2018,0.00,,19.30,,"-161,790.53"
,IN,AR,30307476,1005,100,,Invoice,,,,,,28/02/2018,28/02/2018,0.00,,8.47,,"-161,799.00"
,IN,AR,30307486,1005,100,,Invoice,,,,,,28/02/2018,28/02/2018,0.00,,103.71,,"-161,902.71"
,IN,AR,30307487,1005,100,,Invoice,,,,,,28/02/2018,28/02/2018,0.00,,30.40,,"-161,933.11"
,IN,AR,30307488,1005,100,,Invoice,,,,,,28/02/2018,28/02/2018,0.00,,10.73,,"-161,943.84"
,IN,AR,30307489,1005,100,,Invoice,,,,,,28/02/2018,28/02/2018,0.00,,66.16,,"-162,010.00"
,IN,AR,30307490,1005,100,,Invoice,,,,,,28/02/2018,28/02/2018,0.00,,33.97,,"-162,043.97"
,IN,AR,30307491,1005,100,,Invoice,,,,,,28/02/2018,28/02/2018,0.00,,19.67,,"-162,063.64"
,IN,AR,30307492,1005,100,,Invoice,,,,,,28/02/2018,28/02/2018,0.00,,46.49,,"-162,110.13"
,IN,AR,30307493,1005,100,,Invoice,,,,,,28/02/2018,28/02/2018,0.00,,32.19,,"-162,142.32"
,IN,AR,30307494,1005,100,,Invoice,,,,,,28/02/2018,28/02/2018,0.00,,203.85,,"-162,346.17"
,IN,AR,30307495,1005,100,,Invoice,,,,,,28/02/2018,28/02/2018,0.00,,3.58,,"-162,349.75"
,IN,AR,30307496,1005,100,,Invoice,,,,,,28/02/2018,28/02/2018,0.00,,17.88,,"-162,367.63"
,IN,AR,30307497,1005,100,,Invoice,,,,,,28/02/2018,28/02/2018,0.00,,14.31,,"-162,381.94"
,IN,AR,30307498,1005,100,,Invoice,,,,,,28/02/2018,28/02/2018,0.00,,14.31,,"-162,396.25"
,IN,AR,30307500,1005,100,,Invoice,,,,,,28/02/2018,28/02/2018,0.00,,25.03,,"-162,421.28"
,IN,AR,30307501,1005,100,,Invoice,,,,,,28/02/2018,28/02/2018,0.00,,69.74,,"-162,491.02"
,IN,AR,30307502,1005,100,,Invoice,,,,,,28/02/2018,28/02/2018,0.00,,14.31,,"-162,505.33"
,IN,AR,30307503,1005,100,,Invoice,,,,,,28/02/2018,28/02/2018,0.00,,14.31,,"-162,519.64"
,IN,AR,30307504,1005,100,,Invoice,,,,,,28/02/2018,28/02/2018,0.00,,7.15,,"-162,526.79"
,IN,AR,30307505,1005,100,,Invoice,,,,,,28/02/2018,28/02/2018,0.00,,28.61,,"-162,555.40"
,IN,AR,30307506,1005,100,,Invoice,,,,,,28/02/2018,28/02/2018,0.00,,3.58,,"-162,558.98"
,IN,AR,30307509,1005,100,,Invoice,,,,,,28/02/2018,28/02/2018,0.00,,85.96,,"-162,644.94"
,IN,AR,30307511,1005,100,,Invoice,,,,,,28/02/2018,28/02/2018,0.00,,173.60,,"-162,818.54"
,IN,AR,30307512,1005,100,,Invoice,,,,,,28/02/2018,28/02/2018,0.00,,106.20,,"-162,924.74"
,IN,AR,30307513,1005,100,,Invoice,,,,,,28/02/2018,28/02/2018,0.00,,18.38,,"-162,943.12"
,IN,AR,30307514,1005,100,,Invoice,,,,,,28/02/2018,28/02/2018,0.00,,120.50,,"-163,063.62"
,IN,AR,30307515,1005,100,,Invoice,,,,,,28/02/2018,28/02/2018,0.00,,22.47,,"-163,086.09"
,IN,AR,30307516,1005,100,,Invoice,,,,,,28/02/2018,28/02/2018,0.00,,155.22,,"-163,241.31"
,IN,AR,30307537,1005,100,,Invoice,,,,,,28/02/2018,28/02/2018,0.00,,18.17,,"-163,259.48"
,IN,AR,30307584,1005,100,,Invoice,,,,,,28/02/2018,28/02/2018,0.00,,14.58,,"-163,274.06"
,IN,AR,30307659,1005,100,,Invoice,,,,,,28/02/2018,28/02/2018,0.00,,72.88,,"-163,346.94"
,IN,AR,30307665,1005,100,,Invoice,,,,,,28/02/2018,28/02/2018,0.00,,17.80,,"-163,364.74"
,IN,AR,30307673,1005,100,,Invoice,,,,,,28/02/2018,28/02/2018,0.00,,11.44,,"-163,376.18"
,IN,AR,30307686,1005,100,,Invoice,,,,,,28/02/2018,28/02/2018,0.00,,"1,012.80",,"-164,388.98"
,IN,AR,30307694,1005,100,,Invoice,,,,,,28/02/2018,28/02/2018,0.00,,281.90,,"-164,670.88"
,IN,AR,30307695,1005,100,,Invoice,,,,,,28/02/2018,28/02/2018,0.00,,67.12,,"-164,738.00"
,IN,AR,30307696,1005,100,,Invoice,,,,,,28/02/2018,28/02/2018,0.00,,33.33,,"-164,771.33"
,IN,AR,30307707,1005,100,,Invoice,,,,,,28/02/2018,28/02/2018,0.00,,10.93,,"-164,782.26"
,IN,AR,30307712,1005,100,,Invoice,,,,,,28/02/2018,28/02/2018,0.00,,10.93,,"-164,793.19"
,IN,AR,30307732,1005,100,,Invoice,,,,,,28/02/2018,28/02/2018,0.00,,18.22,,"-164,811.41"
,IN,AR,30307807,1005,100,,Invoice,,,,,,28/02/2018,28/02/2018,0.00,,25.51,,"-164,836.92"
,IN,AR,30307817,1005,100,,Invoice,,,,,,28/02/2018,28/02/2018,0.00,,100.89,,"-164,937.81"
,IN,AR,30307822,1005,100,,Invoice,,,,,,28/02/2018,28/02/2018,0.00,,18.05,,"-164,955.86"
,IN,AR,30307855,1005,100,,Invoice,,,,,,28/02/2018,28/02/2018,0.00,,70.59,,"-165,026.45"
,IN,AR,30307904,1005,100,,Invoice,,,,,,28/02/2018,28/02/2018,0.00,,15.04,,"-165,041.49"
,IN,AR,30307937,1005,100,,Invoice,,,,,,28/02/2018,28/02/2018,0.00,,12.92,,"-165,054.41"
,IN,AR,30307939,1005,100,,Invoice,,,,,,28/02/2018,28/02/2018,0.00,,2.58,,"-165,056.99"
,IN,AR,30307951,1005,100,,Invoice,,,,,,28/02/2018,28/02/2018,0.00,,18.01,,"-165,075.00"
,IN,AR,30307962,1005,100,,Invoice,,,,,,28/02/2018,28/02/2018,0.00,,382.89,,"-165,457.89"
,IN,AR,30307976,1005,100,,Invoice,,,,,,28/02/2018,28/02/2018,0.00,,23.31,,"-165,481.20"
,IN,AR,30307977,1005,100,,Invoice,,,,,,28/02/2018,28/02/2018,0.00,,13.98,,"-165,495.18"
,IN,AR,30307978,1005,100,,Invoice,,,,,,28/02/2018,28/02/2018,0.00,,46.61,,"-165,541.79"
,IN,AR,30307979,1005,100,,Invoice,,,,,,28/02/2018,28/02/2018,0.00,,16.31,,"-165,558.10"
,IN,AR,30307980,1005,100,,Invoice,,,,,,28/02/2018,28/02/2018,0.00,,37.29,,"-165,595.39"
,IN,AR,30307981,1005,100,,Invoice,,,,,,28/02/2018,28/02/2018,0.00,,46.61,,"-165,642.00"
,IN,AR,30307982,1005,100,,Invoice,,,,,,28/02/2018,28/02/2018,0.00,,30.30,,"-165,672.30"
,IN,AR,30307983,1005,100,,Invoice,,,,,,28/02/2018,28/02/2018,0.00,,44.28,,"-165,716.58"
,IN,AR,30307984,1005,100,,Invoice,,,,,,28/02/2018,28/02/2018,0.00,,44.28,,"-165,760.86"
,IN,AR,30307985,1005,100,,Invoice,,,,,,28/02/2018,28/02/2018,0.00,,23.31,,"-165,784.17"
,IN,AR,30307989,1005,100,,Invoice,,,,,,28/02/2018,28/02/2018,0.00,,788.93,,"-166,573.10"
,IN,AR,30307991,1005,100,,Invoice,,,,,,28/02/2018,28/02/2018,0.00,,7.75,,"-166,580.85"
,IN,AR,30308056,1005,100,,Invoice,,,,,,28/02/2018,28/02/2018,0.00,,28.00,,"-166,608.85"
,IN,AR,30308065,1005,100,,Invoice,,,,,,28/02/2018,28/02/2018,0.00,,70.15,,"-166,679.00"
,IN,AR,30308076,1005,100,,Invoice,,,,,,28/02/2018,28/02/2018,0.00,,232.14,,"-166,911.14"
,IN,AR,30308077,1005,100,,Invoice,,,,,,28/02/2018,28/02/2018,0.00,,289.01,,"-167,200.15"
,IN,AR,30308085,1005,100,,Invoice,,,,,,28/02/2018,28/02/2018,0.00,,8.21,,"-167,208.36"
,IN,AR,30308090,1005,100,,Invoice,,,,,,28/02/2018,28/02/2018,0.00,,11.95,,"-167,220.31"
,IN,AR,30308147,1005,100,,Invoice,,,,,,28/02/2018,28/02/2018,0.00,,3.20,,"-167,223.51"
,IN,AR,30308148,1005,100,,Invoice,,,,,,28/02/2018,28/02/2018,0.00,,22.45,,"-167,245.96"
,IN,AR,30308149,1005,100,,Invoice,,,,,,28/02/2018,28/02/2018,0.00,,9.62,,"-167,255.58"
,IN,AR,30308150,1005,100,,Invoice,,,,,,28/02/2018,28/02/2018,0.00,,17.64,,"-167,273.22"
,IN,AR,30308151,1005,100,,Invoice,,,,,,28/02/2018,28/02/2018,0.00,,6.42,,"-167,279.64"
,IN,AR,30308152,1005,100,,Invoice,,,,,,28/02/2018,28/02/2018,0.00,,3.20,,"-167,282.84"
,IN,AR,30308153,1005,100,,Invoice,,,,,,28/02/2018,28/02/2018,0.00,,6.42,,"-167,289.26"
,IN,AR,30308154,1005,100,,Invoice,,,,,,28/02/2018,28/02/2018,0.00,,3.20,,"-167,292.46"
,IN,AR,30308158,1005,100,,Invoice,,,,,,28/02/2018,28/02/2018,0.00,,28.03,,"-167,320.49"
,IN,AR,30308180,1005,100,,Invoice,,,,,,28/02/2018,28/02/2018,0.00,,209.53,,"-167,530.02"
,IN,AR,30308181,1005,100,,Invoice,,,,,,28/02/2018,28/02/2018,0.00,,30.20,,"-167,560.22"
,IN,AR,30308182,1005,100,,Invoice,,,,,,28/02/2018,28/02/2018,0.00,,35.86,,"-167,596.08"
,IN,AR,30308183,1005,100,,Invoice,,,,,,28/02/2018,28/02/2018,0.00,,22.65,,"-167,618.73"
,IN,AR,30308186,1005,100,,Invoice,,,,,,28/02/2018,28/02/2018,0.00,,5.09,,"-167,623.82"
,IN,AR,30308201,1005,100,,Invoice,,,,,,28/02/2018,28/02/2018,0.00,,36.22,,"-167,660.04"
,IN,AR,30308263,1005,100,,Invoice,,,,,,28/02/2018,28/02/2018,0.00,,11.66,,"-167,671.70"
,IN,AR,30308269,1005,100,,Invoice,,,,,,28/02/2018,28/02/2018,0.00,,85.17,,"-167,756.87"
,IN,AR,30308285,1005,100,,Invoice,,,,,,28/02/2018,28/02/2018,0.00,,58.84,,"-167,815.71"
,IN,AR,30308296,1005,100,,Invoice,,,,,,28/02/2018,28/02/2018,0.00,,14.72,,"-167,830.43"
,IN,AR,30308352,1005,100,,Invoice,,,,,,28/02/2018,28/02/2018,0.00,,3.64,,"-167,834.07"
,IN,AR,30308356,1005,100,,Invoice,,,,,,28/02/2018,28/02/2018,0.00,,12.85,,"-167,846.92"
,IN,AR,30308374,1005,100,,Invoice,,,,,,28/02/2018,28/02/2018,0.00,,8.17,,"-167,855.09"
,IN,AR,30308465,1005,100,,Invoice,,,,,,28/02/2018,28/02/2018,0.00,,7.97,,"-167,863.06"
,IN,AR,30308475,1005,100,,Invoice,,,,,,28/02/2018,28/02/2018,0.00,,452.20,,"-168,315.26"
,IN,AR,30308476,1005,100,,Invoice,,,,,,28/02/2018,28/02/2018,0.00,,46.78,,"-168,362.04"
,IN,AR,30308477,1005,100,,Invoice,,,,,,28/02/2018,28/02/2018,0.00,,7.80,,"-168,369.84"
,IN,AR,30308478,1005,100,,Invoice,,,,,,28/02/2018,28/02/2018,0.00,,5.85,,"-168,375.69"
,IN,AR,30308479,1005,100,,Invoice,,,,,,28/02/2018,28/02/2018,0.00,,155.93,,"-168,531.62"
,IN,AR,30308483,1005,100,,Invoice,,,,,,28/02/2018,28/02/2018,0.00,,34.41,,"-168,566.03"
,IN,AR,30308512,1005,100,,Invoice,,,,,,28/02/2018,28/02/2018,0.00,,7.53,,"-168,573.56"
,IN,AR,30308513,1005,100,,Invoice,,,,,,28/02/2018,28/02/2018,0.00,,5.64,,"-168,579.20"
,IN,AR,30308514,1005,100,,Invoice,,,,,,28/02/2018,28/02/2018,0.00,,15.05,,"-168,594.25"
,IN,AR,30308523,1005,100,,Invoice,,,,,,28/02/2018,28/02/2018,0.00,,5.26,,"-168,599.51"
,IN,AR,30308550,1005,100,,Invoice,,,,,,28/02/2018,28/02/2018,0.00,,664.86,,"-169,264.37"
,IN,AR,30308600,1005,100,,Invoice,,,,,,28/02/2018,28/02/2018,0.00,,7.53,,"-169,271.90"
,IN,AR,30308612,1005,100,,Invoice,,,,,,28/02/2018,28/02/2018,0.00,,380.99,,"-169,652.89"
,IN,AR,30308613,1005,100,,Invoice,,,,,,28/02/2018,28/02/2018,0.00,,8.50,,"-169,661.39"
,IN,AR,30308614,1005,100,,Invoice,,,,,,28/02/2018,28/02/2018,0.00,,5.10,,"-169,666.49"
,IN,AR,30308615,1005,100,,Invoice,,,,,,28/02/2018,28/02/2018,0.00,,20.41,,"-169,686.90"
,IN,AR,30308616,1005,100,,Invoice,,,,,,28/02/2018,28/02/2018,0.00,,3.40,,"-169,690.30"
,IN,AR,30308617,1005,100,,Invoice,,,,,,28/02/2018,28/02/2018,0.00,,11.91,,"-169,702.21"
,IN,AR,30308618,1005,100,,Invoice,,,,,,28/02/2018,28/02/2018,0.00,,6.81,,"-169,709.02"
,IN,AR,30308619,1005,100,,Invoice,,,,,,28/02/2018,28/02/2018,0.00,,3.40,,"-169,712.42"
,IN,AR,30308620,1005,100,,Invoice,,,,,,28/02/2018,28/02/2018,0.00,,5.10,,"-169,717.52"
,IN,AR,30308621,1005,100,,Invoice,,,,,,28/02/2018,28/02/2018,0.00,,8.50,,"-169,726.02"
,IN,AR,30308622,1005,100,,Invoice,,,,,,28/02/2018,28/02/2018,0.00,,1.70,,"-169,727.72"
,IN,AR,30308623,1005,100,,Invoice,,,,,,28/02/2018,28/02/2018,0.00,,11.91,,"-169,739.63"
,IN,AR,30308624,1005,100,,Invoice,,,,,,28/02/2018,28/02/2018,0.00,,5.10,,"-169,744.73"
,IN,AR,30308625,1005,100,,Invoice,,,,,,28/02/2018,28/02/2018,0.00,,6.81,,"-169,751.54"
,IN,AR,30308626,1005,100,,Invoice,,,,,,28/02/2018,28/02/2018,0.00,,8.50,,"-169,760.04"
,IN,AR,30308627,1005,100,,Invoice,,,,,,28/02/2018,28/02/2018,0.00,,3.40,,"-169,763.44"
,IN,AR,30308628,1005,100,,Invoice,,,,,,28/02/2018,28/02/2018,0.00,,23.81,,"-169,787.25"
,IN,AR,30308629,1005,100,,Invoice,,,,,,28/02/2018,28/02/2018,0.00,,6.81,,"-169,794.06"
,IN,AR,30308630,1005,100,,Invoice,,,,,,28/02/2018,28/02/2018,0.00,,3.40,,"-169,797.46"
,IN,AR,30308631,1005,100,,Invoice,,,,,,28/02/2018,28/02/2018,0.00,,10.20,,"-169,807.66"
,IN,AR,30308632,1005,100,,Invoice,,,,,,28/02/2018,28/02/2018,0.00,,11.91,,"-169,819.57"
,IN,AR,30308633,1005,100,,Invoice,,,,,,28/02/2018,28/02/2018,0.00,,6.81,,"-169,826.38"
,IN,AR,30308634,1005,100,,Invoice,,,,,,28/02/2018,28/02/2018,0.00,,5.10,,"-169,831.48"
,IN,AR,30308635,1005,100,,Invoice,,,,,,28/02/2018,28/02/2018,0.00,,3.40,,"-169,834.88"
,IN,AR,30308636,1005,100,,Invoice,,,,,,28/02/2018,28/02/2018,0.00,,11.91,,"-169,846.79"
,IN,AR,30308665,1005,100,,Invoice,,,,,,28/02/2018,28/02/2018,0.00,,11.19,,"-169,857.98"
,IN,AR,30308762,1005,100,,Invoice,,,,,,28/02/2018,28/02/2018,0.00,,13.69,,"-169,871.67"
,IN,AR,30308763,1005,100,,Invoice,,,,,,28/02/2018,28/02/2018,0.00,,8.21,,"-169,879.88"
,IN,AR,30308764,1005,100,,Invoice,,,,,,28/02/2018,28/02/2018,0.00,,8.21,,"-169,888.09"
,IN,AR,30308765,1005,100,,Invoice,,,,,,28/02/2018,28/02/2018,0.00,,8.21,,"-169,896.30"
,CN,AR,31017646,1005,100,,Credit Note,,,,,,01/03/2018,01/03/2018,137.02,,0.00,,"-169,759.28"
,CN,AR,31017677,1005,100,,Credit Note,,,,,,01/03/2018,01/03/2018,21.86,,0.00,,"-169,737.42"
,CS,AR,32001704,1005,100,,Cash sale,,,,,,01/03/2018,01/03/2018,0.00,,18.05,,"-169,755.47"
,CS,AR,32001744,1005,100,,Cash sale,,,,,,01/03/2018,01/03/2018,0.00,,18.22,,"-169,773.69"
,CS,AR,32001800,1005,100,,Cash sale,,,,,,01/03/2018,01/03/2018,0.00,,3.64,,"-169,777.33"
,CS,AR,32001846,1005,100,,Cash sale,,,,,,01/03/2018,01/03/2018,0.00,,3.64,,"-169,780.97"
,CS,AR,32001910,1005,100,,Cash sale,,,,,,01/03/2018,01/03/2018,0.00,,10.34,,"-169,791.31"
,CS,AR,32001917,1005,100,,Cash sale,,,,,,01/03/2018,01/03/2018,0.00,,7.29,,"-169,798.60"
,CS,AR,32001918,1005,100,,Cash sale,,,,,,01/03/2018,01/03/2018,0.00,,5.17,,"-169,803.77"
,CS,AR,32001919,1005,100,,Cash sale,,,,,,01/03/2018,01/03/2018,0.00,,7.29,,"-169,811.06"
,CS,AR,32001930,1005,100,,Cash sale,,,,,,01/03/2018,01/03/2018,0.00,,32.80,,"-169,843.86"
,CS,AR,32001939,1005,100,,Cash sale,,,,,,01/03/2018,01/03/2018,0.00,,12.94,,"-169,856.80"
,CS,AR,32001959,1005,100,,Cash sale,,,,,,01/03/2018,01/03/2018,0.00,,7.75,,"-169,864.55"
,CS,AR,32002009,1005,100,,Cash sale,,,,,,01/03/2018,01/03/2018,0.00,,7.29,,"-169,871.84"
,CS,AR,32002049,1005,100,,Cash sale,,,,,,01/03/2018,01/03/2018,0.00,,6.74,,"-169,878.58"
,CS,AR,32002054,1005,100,,Cash sale,,,,,,01/03/2018,01/03/2018,0.00,,21.86,,"-169,900.44"
,CS,AR,32002189,1005,100,,Cash sale,,,,,,01/03/2018,01/03/2018,0.00,,6.44,,"-169,906.88"
,CS,AR,32002205,1005,100,,Cash sale,,,,,,01/03/2018,01/03/2018,0.00,,5.17,,"-169,912.05"
,CS,AR,32002272,1005,100,,Cash sale,,,,,,01/03/2018,01/03/2018,0.00,,7.29,,"-169,919.34"
,CS,AR,32002275,1005,100,,Cash sale,,,,,,01/03/2018,01/03/2018,0.00,,7.86,,"-169,927.20"
,CS,AR,32002317,1005,100,,Cash sale,,,,,,01/03/2018,01/03/2018,0.00,,29.15,,"-169,956.35"
,CS,AR,32002321,1005,100,,Cash sale,,,,,,01/03/2018,01/03/2018,0.00,,3.64,,"-169,959.99"
,CS,AR,32002422,1005,100,,Cash sale,,,,,,01/03/2018,01/03/2018,0.00,,14.58,,"-169,974.57"
,CS,AR,32002439,1005,100,,Cash sale,,,,,,01/03/2018,01/03/2018,0.00,,10.93,,"-169,985.50"
,CS,AR,32002449,1005,100,,Cash sale,,,,,,01/03/2018,01/03/2018,0.00,,5.47,,"-169,990.97"
,CS,AR,32002516,1005,100,,Cash sale,,,,,,01/03/2018,01/03/2018,0.00,,8.75,,"-169,999.72"
,CS,AR,32002537,1005,100,,Cash sale,,,,,,01/03/2018,01/03/2018,0.00,,14.58,,"-170,014.30"
,CS,AR,32002572,1005,100,,Cash sale,,,,,,01/03/2018,01/03/2018,0.00,,54.66,,"-170,068.96"
,IN,AR,30308828,1005,100,,Invoice,,,,,,01/03/2018,01/03/2018,0.00,,10.93,,"-170,079.89"
,IN,AR,30308835,1005,100,,Invoice,,,,,,01/03/2018,01/03/2018,0.00,,10.93,,"-170,090.82"
,IN,AR,30308895,1005,100,,Invoice,,,,,,01/03/2018,01/03/2018,0.00,,2.03,,"-170,092.85"
,IN,AR,30308915,1005,100,,Invoice,,,,,,01/03/2018,01/03/2018,0.00,,21.86,,"-170,114.71"
,IN,AR,30308932,1005,100,,Invoice,,,,,,01/03/2018,01/03/2018,0.00,,7.97,,"-170,122.68"
,IN,AR,30308940,1005,100,,Invoice,,,,,,01/03/2018,01/03/2018,0.00,,23.73,,"-170,146.41"
,IN,AR,30309010,1005,100,,Invoice,,,,,,01/03/2018,01/03/2018,0.00,,10.93,,"-170,157.34"
,IN,AR,30309075,1005,100,,Invoice,,,,,,01/03/2018,01/03/2018,0.00,,7.29,,"-170,164.63"
,IN,AR,30309134,1005,100,,Invoice,,,,,,01/03/2018,01/03/2018,0.00,,24.71,,"-170,189.34"
,IN,AR,30309146,1005,100,,Invoice,,,,,,01/03/2018,01/03/2018,0.00,,28.39,,"-170,217.73"
,IN,AR,30309183,1005,100,,Invoice,,,,,,01/03/2018,01/03/2018,0.00,,54.00,,"-170,271.73"
,IN,AR,30309246,1005,100,,Invoice,,,,,,01/03/2018,01/03/2018,0.00,,21.86,,"-170,293.59"
,IN,AR,30309253,1005,100,,Invoice,,,,,,01/03/2018,01/03/2018,0.00,,7.29,,"-170,300.88"
,IN,AR,30309260,1005,100,,Invoice,,,,,,01/03/2018,01/03/2018,0.00,,21.00,,"-170,321.88"
,IN,AR,30309403,1005,100,,Invoice,,,,,,01/03/2018,01/03/2018,0.00,,21.06,,"-170,342.94"
,IN,AR,30309421,1005,100,,Invoice,,,,,,01/03/2018,01/03/2018,0.00,,18.64,,"-170,361.58"
,IN,AR,30309457,1005,100,,Invoice,,,,,,01/03/2018,01/03/2018,0.00,,14.34,,"-170,375.92"
,IN,AR,30309480,1005,100,,Invoice,,,,,,01/03/2018,01/03/2018,0.00,,9.66,,"-170,385.58"
,IN,AR,30309578,1005,100,,Invoice,,,,,,01/03/2018,01/03/2018,0.00,,15.25,,"-170,400.83"
,IN,AR,30309579,1005,100,,Invoice,,,,,,01/03/2018,01/03/2018,0.00,,5.08,,"-170,405.91"
,IN,AR,30309611,1005,100,,Invoice,,,,,,01/03/2018,01/03/2018,0.00,,44.61,,"-170,450.52"
,IN,AR,30309612,1005,100,,Invoice,,,,,,01/03/2018,01/03/2018,0.00,,50.98,,"-170,501.50"
,IN,AR,30309626,1005,100,,Invoice,,,,,,01/03/2018,01/03/2018,0.00,,16.55,,"-170,518.05"
,IN,AR,30309633,1005,100,,Invoice,,,,,,01/03/2018,01/03/2018,0.00,,63.15,,"-170,581.20"
,IN,AR,30309638,1005,100,,Invoice,,,,,,01/03/2018,01/03/2018,0.00,,5.17,,"-170,586.37"
,IN,AR,30309650,1005,100,,Invoice,,,,,,01/03/2018,01/03/2018,0.00,,4.32,,"-170,590.69"
,IN,AR,30309708,1005,100,,Invoice,,,,,,01/03/2018,01/03/2018,0.00,,5.17,,"-170,595.86"
,IN,AR,30309739,1005,100,,Invoice,,,,,,01/03/2018,01/03/2018,0.00,,3.64,,"-170,599.50"
,IN,AR,30309790,1005,100,,Invoice,,,,,,01/03/2018,01/03/2018,0.00,,10.93,,"-170,610.43"
,IN,AR,30309819,1005,100,,Invoice,,,,,,01/03/2018,01/03/2018,0.00,,8.17,,"-170,618.60"
,IN,AR,30309823,1005,100,,Invoice,,,,,,01/03/2018,01/03/2018,0.00,,13.73,,"-170,632.33"
,IN,AR,30309863,1005,100,,Invoice,,,,,,01/03/2018,01/03/2018,0.00,,14.00,,"-170,646.33"
,IN,AR,30309885,1005,100,,Invoice,,,,,,01/03/2018,01/03/2018,0.00,,22.37,,"-170,668.70"
,IN,AR,30309893,1005,100,,Invoice,,,,,,01/03/2018,01/03/2018,0.00,,21.19,,"-170,689.89"
,IN,AR,30309932,1005,100,,Invoice,,,,,,01/03/2018,01/03/2018,0.00,,54.66,,"-170,744.55"
,IN,AR,30309936,1005,100,,Invoice,,,,,,01/03/2018,01/03/2018,0.00,,4.64,,"-170,749.19"
,IN,AR,30309944,1005,100,,Invoice,,,,,,01/03/2018,01/03/2018,0.00,,8.77,,"-170,757.96"
,IN,AR,30309949,1005,100,,Invoice,,,,,,01/03/2018,01/03/2018,0.00,,18.22,,"-170,776.18"
,IN,AR,30309958,1005,100,,Invoice,,,,,,01/03/2018,01/03/2018,0.00,,11.02,,"-170,787.20"
,IN,AR,30310022,1005,100,,Invoice,,,,,,01/03/2018,01/03/2018,0.00,,5.49,,"-170,792.69"
,IN,AR,30310031,1005,100,,Invoice,,,,,,01/03/2018,01/03/2018,0.00,,11.64,,"-170,804.33"
,IN,AR,30310037,1005,100,,Invoice,,,,,,01/03/2018,01/03/2018,0.00,,5.08,,"-170,809.41"
,IN,AR,30310062,1005,100,,Invoice,,,,,,01/03/2018,01/03/2018,0.00,,42.88,,"-170,852.29"
,IN,AR,30310077,1005,100,,Invoice,,,,,,01/03/2018,01/03/2018,0.00,,5.29,,"-170,857.58"
,IN,AR,30310103,1005,100,,Invoice,,,,,,01/03/2018,01/03/2018,0.00,,7.29,,"-170,864.87"
,IN,AR,30310112,1005,100,,Invoice,,,,,,01/03/2018,01/03/2018,0.00,,2.27,,"-170,867.14"
,IN,AR,30310158,1005,100,,Invoice,,,,,,01/03/2018,01/03/2018,0.00,,18.22,,"-170,885.36"
,IN,AR,30310159,1005,100,,Invoice,,,,,,01/03/2018,01/03/2018,0.00,,21.86,,"-170,907.22"
,IN,AR,30310177,1005,100,,Invoice,,,,,,01/03/2018,01/03/2018,0.00,,54.66,,"-170,961.88"
,IN,AR,30310210,1005,100,,Invoice,,,,,,01/03/2018,01/03/2018,0.00,,10.93,,"-170,972.81"
,IN,AR,30310227,1005,100,,Invoice,,,,,,01/03/2018,01/03/2018,0.00,,21.15,,"-170,993.96"
,IN,AR,30310228,1005,100,,Invoice,,,,,,01/03/2018,01/03/2018,0.00,,4.88,,"-170,998.84"
,IN,AR,30310229,1005,100,,Invoice,,,,,,01/03/2018,01/03/2018,0.00,,8.14,,"-171,006.98"
,IN,AR,30310230,1005,100,,Invoice,,,,,,01/03/2018,01/03/2018,0.00,,9.76,,"-171,016.74"
,IN,AR,30310246,1005,100,,Invoice,,,,,,01/03/2018,01/03/2018,0.00,,19.08,,"-171,035.82"
,IN,AR,30310247,1005,100,,Invoice,,,,,,01/03/2018,01/03/2018,0.00,,39.75,,"-171,075.57"
,IN,AR,30310283,1005,100,,Invoice,,,,,,01/03/2018,01/03/2018,0.00,,26.19,,"-171,101.76"
,IN,AR,30310316,1005,100,,Invoice,,,,,,01/03/2018,01/03/2018,0.00,,26.69,,"-171,128.45"
,IN,AR,30310322,1005,100,,Invoice,,,,,,01/03/2018,01/03/2018,0.00,,3.64,,"-171,132.09"
,IN,AR,30310331,1005,100,,Invoice,,,,,,01/03/2018,01/03/2018,0.00,,12.97,,"-171,145.06"
,IN,AR,30310342,1005,100,,Invoice,,,,,,01/03/2018,01/03/2018,0.00,,19.24,,"-171,164.30"
,IN,AR,30310343,1005,100,,Invoice,,,,,,01/03/2018,01/03/2018,0.00,,9.62,,"-171,173.92"
,IN,AR,30310467,1005,100,,Invoice,,,,,,01/03/2018,01/03/2018,0.00,,22.01,,"-171,195.93"
,IN,AR,30310481,1005,100,,Invoice,,,,,,01/03/2018,01/03/2018,0.00,,20.01,,"-171,215.94"
,IN,AR,30310494,1005,100,,Invoice,,,,,,01/03/2018,01/03/2018,0.00,,11.66,,"-171,227.60"
,IN,AR,30310495,1005,100,,Invoice,,,,,,01/03/2018,01/03/2018,0.00,,17.49,,"-171,245.09"
,IN,AR,30310548,1005,100,,Invoice,,,,,,01/03/2018,01/03/2018,0.00,,25.89,,"-171,270.98"
,IN,AR,30310589,1005,100,,Invoice,,,,,,01/03/2018,01/03/2018,0.00,,361.02,,"-171,632.00"
,IN,AR,30310590,1005,100,,Invoice,,,,,,01/03/2018,01/03/2018,0.00,,18.31,,"-171,650.31"
,IN,AR,30310651,1005,100,,Invoice,,,,,,01/03/2018,01/03/2018,0.00,,10.93,,"-171,661.24"
,IN,AR,30310682,1005,100,,Invoice,,,,,,01/03/2018,01/03/2018,0.00,,137.02,,"-171,798.26"
,IN,AR,30310683,1005,100,,Invoice,,,,,,01/03/2018,01/03/2018,0.00,,137.02,,"-171,935.28"
,IN,AR,30310684,1005,100,,Invoice,,,,,,01/03/2018,01/03/2018,0.00,,9.56,,"-171,944.84"
,IN,AR,30310685,1005,100,,Invoice,,,,,,01/03/2018,01/03/2018,0.00,,12.75,,"-171,957.59"
,IN,AR,30310686,1005,100,,Invoice,,,,,,01/03/2018,01/03/2018,0.00,,3.19,,"-171,960.78"
,IN,AR,30310769,1005,100,,Invoice,,,,,,01/03/2018,01/03/2018,0.00,,20.34,,"-171,981.12"
,IN,AR,30310835,1005,100,,Invoice,,,,,,01/03/2018,01/03/2018,0.00,,9.84,,"-171,990.96"
,IN,AR,30310858,1005,100,,Invoice,,,,,,01/03/2018,01/03/2018,0.00,,29.15,,"-172,020.11"
,IN,AR,30310925,1005,100,,Invoice,,,,,,01/03/2018,01/03/2018,0.00,,8.17,,"-172,028.28"
,IN,AR,30310931,1005,100,,Invoice,,,,,,01/03/2018,01/03/2018,0.00,,29.15,,"-172,057.43"
,IN,AR,30310952,1005,100,,Invoice,,,,,,01/03/2018,01/03/2018,0.00,,36.44,,"-172,093.87"
,IN,AR,30311000,1005,100,,Invoice,,,,,,01/03/2018,01/03/2018,0.00,,7.29,,"-172,101.16"
,IN,AR,30311002,1005,100,,Invoice,,,,,,01/03/2018,01/03/2018,0.00,,29.15,,"-172,130.31"
,IN,AR,30311011,1005,100,,Invoice,,,,,,01/03/2018,01/03/2018,0.00,,54.66,,"-172,184.97"
,IN,AR,30311012,1005,100,,Invoice,,,,,,01/03/2018,01/03/2018,0.00,,54.66,,"-172,239.63"
,CN,AR,31017480,1005,100,,Credit Note,,,,,,02/03/2018,02/03/2018,4.07,,0.00,,"-172,235.56"
,CN,AR,31017635,1005,100,,Credit Note,,,,,,02/03/2018,02/03/2018,10.93,,0.00,,"-172,224.63"
,CN,AR,31017661,1005,100,,Credit Note,,,,,,02/03/2018,02/03/2018,21.86,,0.00,,"-172,202.77"
,CN,AR,31017679,1005,100,,Credit Note,,,,,,02/03/2018,02/03/2018,54.66,,0.00,,"-172,148.11"
,CS,AR,32001699,1005,100,,Cash sale,,,,,,02/03/2018,02/03/2018,0.00,,49.46,,"-172,197.57"
,CS,AR,32001703,1005,100,,Cash sale,,,,,,02/03/2018,02/03/2018,0.00,,14.58,,"-172,212.15"
,CS,AR,32001709,1005,100,,Cash sale,,,,,,02/03/2018,02/03/2018,0.00,,22.44,,"-172,234.59"
,CS,AR,32001717,1005,100,,Cash sale,,,,,,02/03/2018,02/03/2018,0.00,,13.98,,"-172,248.57"
,CS,AR,32001723,1005,100,,Cash sale,,,,,,02/03/2018,02/03/2018,0.00,,7.29,,"-172,255.86"
,CS,AR,32001730,1005,100,,Cash sale,,,,,,02/03/2018,02/03/2018,0.00,,14.24,,"-172,270.10"
,CS,AR,32001748,1005,100,,Cash sale,,,,,,02/03/2018,02/03/2018,0.00,,6.08,,"-172,276.18"
,CS,AR,32001757,1005,100,,Cash sale,,,,,,02/03/2018,02/03/2018,0.00,,3.64,,"-172,279.82"
,CS,AR,32001775,1005,100,,Cash sale,,,,,,02/03/2018,02/03/2018,0.00,,10.93,,"-172,290.75"
,CS,AR,32001783,1005,100,,Cash sale,,,,,,02/03/2018,02/03/2018,0.00,,3.64,,"-172,294.39"
,CS,AR,32001786,1005,100,,Cash sale,,,,,,02/03/2018,02/03/2018,0.00,,66.19,,"-172,360.58"
,CS,AR,32001794,1005,100,,Cash sale,,,,,,02/03/2018,02/03/2018,0.00,,7.25,,"-172,367.83"
,CS,AR,32001807,1005,100,,Cash sale,,,,,,02/03/2018,02/03/2018,0.00,,18.98,,"-172,386.81"
,CS,AR,32001815,1005,100,,Cash sale,,,,,,02/03/2018,02/03/2018,0.00,,7.29,,"-172,394.10"
,CS,AR,32001819,1005,100,,Cash sale,,,,,,02/03/2018,02/03/2018,0.00,,7.29,,"-172,401.39"
,CS,AR,32001820,1005,100,,Cash sale,,,,,,02/03/2018,02/03/2018,0.00,,14.53,,"-172,415.92"
,CS,AR,32001835,1005,100,,Cash sale,,,,,,02/03/2018,02/03/2018,0.00,,3.64,,"-172,419.56"
,CS,AR,32001871,1005,100,,Cash sale,,,,,,02/03/2018,02/03/2018,0.00,,23.29,,"-172,442.85"
,CS,AR,32001899,1005,100,,Cash sale,,,,,,02/03/2018,02/03/2018,0.00,,14.58,,"-172,457.43"
,CS,AR,32001942,1005,100,,Cash sale,,,,,,02/03/2018,02/03/2018,0.00,,7.63,,"-172,465.06"
,CS,AR,32001969,1005,100,,Cash sale,,,,,,02/03/2018,02/03/2018,0.00,,10.99,,"-172,476.05"
,CS,AR,32001982,1005,100,,Cash sale,,,,,,02/03/2018,02/03/2018,0.00,,10.99,,"-172,487.04"
,CS,AR,32002003,1005,100,,Cash sale,,,,,,02/03/2018,02/03/2018,0.00,,12.03,,"-172,499.07"
,CS,AR,32002029,1005,100,,Cash sale,,,,,,02/03/2018,02/03/2018,0.00,,7.63,,"-172,506.70"
,CS,AR,32002041,1005,100,,Cash sale,,,,,,02/03/2018,02/03/2018,0.00,,29.24,,"-172,535.94"
,CS,AR,32002067,1005,100,,Cash sale,,,,,,02/03/2018,02/03/2018,0.00,,7.17,,"-172,543.11"
,CS,AR,32002068,1005,100,,Cash sale,,,,,,02/03/2018,02/03/2018,0.00,,36.10,,"-172,579.21"
,CS,AR,32002102,1005,100,,Cash sale,,,,,,02/03/2018,02/03/2018,0.00,,10.93,,"-172,590.14"
,CS,AR,32002104,1005,100,,Cash sale,,,,,,02/03/2018,02/03/2018,0.00,,3.64,,"-172,593.78"
,CS,AR,32002115,1005,100,,Cash sale,,,,,,02/03/2018,02/03/2018,0.00,,7.29,,"-172,601.07"
,CS,AR,32002171,1005,100,,Cash sale,,,,,,02/03/2018,02/03/2018,0.00,,36.44,,"-172,637.51"
,CS,AR,32002188,1005,100,,Cash sale,,,,,,02/03/2018,02/03/2018,0.00,,7.29,,"-172,644.80"
,CS,AR,32002194,1005,100,,Cash sale,,,,,,02/03/2018,02/03/2018,0.00,,20.48,,"-172,665.28"
,CS,AR,32002222,1005,100,,Cash sale,,,,,,02/03/2018,02/03/2018,0.00,,3.64,,"-172,668.92"
,CS,AR,32002268,1005,100,,Cash sale,,,,,,02/03/2018,02/03/2018,0.00,,7.29,,"-172,676.21"
,CS,AR,32002278,1005,100,,Cash sale,,,,,,02/03/2018,02/03/2018,0.00,,5.08,,"-172,681.29"
,CS,AR,32002295,1005,100,,Cash sale,,,,,,02/03/2018,02/03/2018,0.00,,14.58,,"-172,695.87"
,CS,AR,32002310,1005,100,,Cash sale,,,,,,02/03/2018,02/03/2018,0.00,,7.29,,"-172,703.16"
,CS,AR,32002325,1005,100,,Cash sale,,,,,,02/03/2018,02/03/2018,0.00,,54.66,,"-172,757.82"
,CS,AR,32002334,1005,100,,Cash sale,,,,,,02/03/2018,02/03/2018,0.00,,24.00,,"-172,781.82"
,CS,AR,32002343,1005,100,,Cash sale,,,,,,02/03/2018,02/03/2018,0.00,,15.17,,"-172,796.99"
,CS,AR,32002350,1005,100,,Cash sale,,,,,,02/03/2018,02/03/2018,0.00,,14.58,,"-172,811.57"
,CS,AR,32002371,1005,100,,Cash sale,,,,,,02/03/2018,02/03/2018,0.00,,9.15,,"-172,820.72"
,CS,AR,32002413,1005,100,,Cash sale,,,,,,02/03/2018,02/03/2018,0.00,,3.64,,"-172,824.36"
,CS,AR,32002418,1005,100,,Cash sale,,,,,,02/03/2018,02/03/2018,0.00,,14.58,,"-172,838.94"
,CS,AR,32002446,1005,100,,Cash sale,,,,,,02/03/2018,02/03/2018,0.00,,7.29,,"-172,846.23"
,CS,AR,32002453,1005,100,,Cash sale,,,,,,02/03/2018,02/03/2018,0.00,,10.93,,"-172,857.16"
,CS,AR,32002466,1005,100,,Cash sale,,,,,,02/03/2018,02/03/2018,0.00,,14.58,,"-172,871.74"
,CS,AR,32002468,1005,100,,Cash sale,,,,,,02/03/2018,02/03/2018,0.00,,6.07,,"-172,877.81"
,CS,AR,32002471,1005,100,,Cash sale,,,,,,02/03/2018,02/03/2018,0.00,,9.15,,"-172,886.96"
,CS,AR,32002479,1005,100,,Cash sale,,,,,,02/03/2018,02/03/2018,0.00,,10.93,,"-172,897.89"
,CS,AR,32002486,1005,100,,Cash sale,,,,,,02/03/2018,02/03/2018,0.00,,21.86,,"-172,919.75"
,CS,AR,32002491,1005,100,,Cash sale,,,,,,02/03/2018,02/03/2018,0.00,,18.22,,"-172,937.97"
,CS,AR,32002534,1005,100,,Cash sale,,,,,,02/03/2018,02/03/2018,0.00,,10.93,,"-172,948.90"
,CS,AR,32002551,1005,100,,Cash sale,,,,,,02/03/2018,02/03/2018,0.00,,7.29,,"-172,956.19"
,CS,AR,32002557,1005,100,,Cash sale,,,,,,02/03/2018,02/03/2018,0.00,,7.29,,"-172,963.48"
,IN,AR,30308793,1005,100,,Invoice,,,,,,02/03/2018,02/03/2018,0.00,,26.69,,"-172,990.17"
,IN,AR,30308808,1005,100,,Invoice,,,,,,02/03/2018,02/03/2018,0.00,,14.58,,"-173,004.75"
,IN,AR,30308853,1005,100,,Invoice,,,,,,02/03/2018,02/03/2018,0.00,,3.64,,"-173,008.39"
,IN,AR,30308881,1005,100,,Invoice,,,,,,02/03/2018,02/03/2018,0.00,,26.57,,"-173,034.96"
,IN,AR,30308920,1005,100,,Invoice,,,,,,02/03/2018,02/03/2018,0.00,,22.97,,"-173,057.93"
,IN,AR,30308924,1005,100,,Invoice,,,,,,02/03/2018,02/03/2018,0.00,,52.40,,"-173,110.33"
,IN,AR,30308941,1005,100,,Invoice,,,,,,02/03/2018,02/03/2018,0.00,,92.54,,"-173,202.87"
,IN,AR,30308973,1005,100,,Invoice,,,,,,02/03/2018,02/03/2018,0.00,,14.58,,"-173,217.45"
,IN,AR,30308976,1005,100,,Invoice,,,,,,02/03/2018,02/03/2018,0.00,,64.00,,"-173,281.45"
,IN,AR,30309012,1005,100,,Invoice,,,,,,02/03/2018,02/03/2018,0.00,,7.29,,"-173,288.74"
,IN,AR,30309034,1005,100,,Invoice,,,,,,02/03/2018,02/03/2018,0.00,,16.00,,"-173,304.74"
,IN,AR,30309081,1005,100,,Invoice,,,,,,02/03/2018,02/03/2018,0.00,,5.84,,"-173,310.58"
,IN,AR,30309113,1005,100,,Invoice,,,,,,02/03/2018,02/03/2018,0.00,,16.00,,"-173,326.58"
,IN,AR,30309139,1005,100,,Invoice,,,,,,02/03/2018,02/03/2018,0.00,,182.20,,"-173,508.78"
,IN,AR,30309158,1005,100,,Invoice,,,,,,02/03/2018,02/03/2018,0.00,,585.72,,"-174,094.50"
,IN,AR,30309165,1005,100,,Invoice,,,,,,02/03/2018,02/03/2018,0.00,,9.70,,"-174,104.20"
,IN,AR,30309177,1005,100,,Invoice,,,,,,02/03/2018,02/03/2018,0.00,,8.39,,"-174,112.59"
,IN,AR,30309199,1005,100,,Invoice,,,,,,02/03/2018,02/03/2018,0.00,,32.80,,"-174,145.39"
,IN,AR,30309204,1005,100,,Invoice,,,,,,02/03/2018,02/03/2018,0.00,,11.19,,"-174,156.58"
,IN,AR,30309270,1005,100,,Invoice,,,,,,02/03/2018,02/03/2018,0.00,,7.75,,"-174,164.33"
,IN,AR,30309292,1005,100,,Invoice,,,,,,02/03/2018,02/03/2018,0.00,,7.19,,"-174,171.52"
,IN,AR,30309360,1005,100,,Invoice,,,,,,02/03/2018,02/03/2018,0.00,,10.34,,"-174,181.86"
,IN,AR,30309371,1005,100,,Invoice,,,,,,02/03/2018,02/03/2018,0.00,,4.78,,"-174,186.64"
,IN,AR,30309377,1005,100,,Invoice,,,,,,02/03/2018,02/03/2018,0.00,,206.28,,"-174,392.92"
,IN,AR,30309426,1005,100,,Invoice,,,,,,02/03/2018,02/03/2018,0.00,,55.37,,"-174,448.29"
,IN,AR,30309438,1005,100,,Invoice,,,,,,02/03/2018,02/03/2018,0.00,,5.08,,"-174,453.37"
,IN,AR,30309458,1005,100,,Invoice,,,,,,02/03/2018,02/03/2018,0.00,,7.17,,"-174,460.54"
,IN,AR,30309459,1005,100,,Invoice,,,,,,02/03/2018,02/03/2018,0.00,,19.12,,"-174,479.66"
,IN,AR,30309580,1005,100,,Invoice,,,,,,02/03/2018,02/03/2018,0.00,,2.54,,"-174,482.20"
,IN,AR,30309581,1005,100,,Invoice,,,,,,02/03/2018,02/03/2018,0.00,,5.08,,"-174,487.28"
,IN,AR,30309687,1005,100,,Invoice,,,,,,02/03/2018,02/03/2018,0.00,,12.71,,"-174,499.99"
,IN,AR,30309692,1005,100,,Invoice,,,,,,02/03/2018,02/03/2018,0.00,,4.24,,"-174,504.23"
,IN,AR,30309718,1005,100,,Invoice,,,,,,02/03/2018,02/03/2018,0.00,,25.42,,"-174,529.65"
,IN,AR,30309728,1005,100,,Invoice,,,,,,02/03/2018,02/03/2018,0.00,,25.00,,"-174,554.65"
,IN,AR,30309751,1005,100,,Invoice,,,,,,02/03/2018,02/03/2018,0.00,,7.63,,"-174,562.28"
,IN,AR,30309768,1005,100,,Invoice,,,,,,02/03/2018,02/03/2018,0.00,,21.98,,"-174,584.26"
,IN,AR,30309832,1005,100,,Invoice,,,,,,02/03/2018,02/03/2018,0.00,,28.05,,"-174,612.31"
,IN,AR,30309868,1005,100,,Invoice,,,,,,02/03/2018,02/03/2018,0.00,,182.20,,"-174,794.51"
,IN,AR,30309903,1005,100,,Invoice,,,,,,02/03/2018,02/03/2018,0.00,,7.29,,"-174,801.80"
,IN,AR,30309994,1005,100,,Invoice,,,,,,02/03/2018,02/03/2018,0.00,,29.15,,"-174,830.95"
,IN,AR,30310027,1005,100,,Invoice,,,,,,02/03/2018,02/03/2018,0.00,,134.96,,"-174,965.91"
,IN,AR,30310032,1005,100,,Invoice,,,,,,02/03/2018,02/03/2018,0.00,,1.94,,"-174,967.85"
,IN,AR,30310071,1005,100,,Invoice,,,,,,02/03/2018,02/03/2018,0.00,,3.64,,"-174,971.49"
,IN,AR,30310078,1005,100,,Invoice,,,,,,02/03/2018,02/03/2018,0.00,,5.29,,"-174,976.78"
,IN,AR,30310079,1005,100,,Invoice,,,,,,02/03/2018,02/03/2018,0.00,,7.05,,"-174,983.83"
,IN,AR,30310111,1005,100,,Invoice,,,,,,02/03/2018,02/03/2018,0.00,,8.01,,"-174,991.84"
,IN,AR,30310143,1005,100,,Invoice,,,,,,02/03/2018,02/03/2018,0.00,,14.58,,"-175,006.42"
,IN,AR,30310185,1005,100,,Invoice,,,,,,02/03/2018,02/03/2018,0.00,,14.58,,"-175,021.00"
,IN,AR,30310266,1005,100,,Invoice,,,,,,02/03/2018,02/03/2018,0.00,,34.07,,"-175,055.07"
,IN,AR,30310296,1005,100,,Invoice,,,,,,02/03/2018,02/03/2018,0.00,,56.12,,"-175,111.19"
,IN,AR,30310309,1005,100,,Invoice,,,,,,02/03/2018,02/03/2018,0.00,,14.58,,"-175,125.77"
,IN,AR,30310326,1005,100,,Invoice,,,,,,02/03/2018,02/03/2018,0.00,,12.03,,"-175,137.80"
,IN,AR,30310340,1005,100,,Invoice,,,,,,02/03/2018,02/03/2018,0.00,,7.29,,"-175,145.09"
,IN,AR,30310344,1005,100,,Invoice,,,,,,02/03/2018,02/03/2018,0.00,,59.32,,"-175,204.41"
,IN,AR,30310394,1005,100,,Invoice,,,,,,02/03/2018,02/03/2018,0.00,,49.92,,"-175,254.33"
,IN,AR,30310430,1005,100,,Invoice,,,,,,02/03/2018,02/03/2018,0.00,,16.74,,"-175,271.07"
,IN,AR,30310451,1005,100,,Invoice,,,,,,02/03/2018,02/03/2018,0.00,,20.34,,"-175,291.41"
,IN,AR,30310489,1005,100,,Invoice,,,,,,02/03/2018,02/03/2018,0.00,,29.15,,"-175,320.56"
,IN,AR,30310512,1005,100,,Invoice,,,,,,02/03/2018,02/03/2018,0.00,,7.54,,"-175,328.10"
,IN,AR,30310532,1005,100,,Invoice,,,,,,02/03/2018,02/03/2018,0.00,,19.16,,"-175,347.26"
,IN,AR,30310537,1005,100,,Invoice,,,,,,02/03/2018,02/03/2018,0.00,,16.82,,"-175,364.08"
,IN,AR,30310660,1005,100,,Invoice,,,,,,02/03/2018,02/03/2018,0.00,,5.68,,"-175,369.76"
,IN,AR,30310665,1005,100,,Invoice,,,,,,02/03/2018,02/03/2018,0.00,,12.08,,"-175,381.84"
,IN,AR,30310778,1005,100,,Invoice,,,,,,02/03/2018,02/03/2018,0.00,,7.29,,"-175,389.13"
,IN,AR,30310783,1005,100,,Invoice,,,,,,02/03/2018,02/03/2018,0.00,,10.00,,"-175,399.13"
,IN,AR,30310854,1005,100,,Invoice,,,,,,02/03/2018,02/03/2018,0.00,,5.47,,"-175,404.60"
,IN,AR,30310860,1005,100,,Invoice,,,,,,02/03/2018,02/03/2018,0.00,,10.93,,"-175,415.53"
,IN,AR,30310862,1005,100,,Invoice,,,,,,02/03/2018,02/03/2018,0.00,,31.78,,"-175,447.31"
,IN,AR,30310892,1005,100,,Invoice,,,,,,02/03/2018,02/03/2018,0.00,,7.29,,"-175,454.60"
,IN,AR,30310901,1005,100,,Invoice,,,,,,02/03/2018,02/03/2018,0.00,,21.86,,"-175,476.46"
,IN,AR,30310907,1005,100,,Invoice,,,,,,02/03/2018,02/03/2018,0.00,,14.83,,"-175,491.29"
,IN,AR,30310916,1005,100,,Invoice,,,,,,02/03/2018,02/03/2018,0.00,,10.21,,"-175,501.50"
,IN,AR,30310966,1005,100,,Invoice,,,,,,02/03/2018,02/03/2018,0.00,,5.51,,"-175,507.01"
,IN,AR,30311014,1005,100,,Invoice,,,,,,02/03/2018,02/03/2018,0.00,,182.20,,"-175,689.21"
,IN,AR,30311019,1005,100,,Invoice,,,,,,02/03/2018,02/03/2018,0.00,,546.61,,"-176,235.82"
,CS,AR,32002088,1005,100,,Cash sale,,,,,,03/03/2018,03/03/2018,0.00,,3.64,,"-176,239.46"
,CS,AR,32002209,1005,100,,Cash sale,,,,,,03/03/2018,03/03/2018,0.00,,10.93,,"-176,250.39"
,CS,AR,32002424,1005,100,,Cash sale,,,,,,03/03/2018,03/03/2018,0.00,,57.68,,"-176,308.07"
,IN,AR,30308875,1005,100,,Invoice,,,,,,03/03/2018,03/03/2018,0.00,,3.01,,"-176,311.08"
,IN,AR,30308942,1005,100,,Invoice,,,,,,03/03/2018,03/03/2018,0.00,,56.95,,"-176,368.03"
,IN,AR,30309078,1005,100,,Invoice,,,,,,03/03/2018,03/03/2018,0.00,,14.58,,"-176,382.61"
,IN,AR,30309497,1005,100,,Invoice,,,,,,03/03/2018,03/03/2018,0.00,,6.02,,"-176,388.63"
,IN,AR,30310886,1005,100,,Invoice,,,,,,03/03/2018,03/03/2018,0.00,,5.86,,"-176,394.49"
,CS,AR,32001710,1005,100,,Cash sale,,,,,,05/03/2018,05/03/2018,0.00,,11.22,,"-176,405.71"
,CS,AR,32001731,1005,100,,Cash sale,,,,,,05/03/2018,05/03/2018,0.00,,9.49,,"-176,415.20"
,CS,AR,32001766,1005,100,,Cash sale,,,,,,05/03/2018,05/03/2018,0.00,,7.29,,"-176,422.49"
,CS,AR,32001821,1005,100,,Cash sale,,,,,,05/03/2018,05/03/2018,0.00,,16.61,,"-176,439.10"
,CS,AR,32001831,1005,100,,Cash sale,,,,,,05/03/2018,05/03/2018,0.00,,14.58,,"-176,453.68"
,CS,AR,32001845,1005,100,,Cash sale,,,,,,05/03/2018,05/03/2018,0.00,,3.64,,"-176,457.32"
,CS,AR,32001851,1005,100,,Cash sale,,,,,,05/03/2018,05/03/2018,0.00,,8.77,,"-176,466.09"
,CS,AR,32001870,1005,100,,Cash sale,,,,,,05/03/2018,05/03/2018,0.00,,7.29,,"-176,473.38"
,CS,AR,32001876,1005,100,,Cash sale,,,,,,05/03/2018,05/03/2018,0.00,,10.93,,"-176,484.31"
,CS,AR,32001905,1005,100,,Cash sale,,,,,,05/03/2018,05/03/2018,0.00,,10.34,,"-176,494.65"
,CS,AR,32001943,1005,100,,Cash sale,,,,,,05/03/2018,05/03/2018,0.00,,12.71,,"-176,507.36"
,CS,AR,32001983,1005,100,,Cash sale,,,,,,05/03/2018,05/03/2018,0.00,,5.49,,"-176,512.85"
,CS,AR,32002001,1005,100,,Cash sale,,,,,,05/03/2018,05/03/2018,0.00,,7.29,,"-176,520.14"
,CS,AR,32002016,1005,100,,Cash sale,,,,,,05/03/2018,05/03/2018,0.00,,7.29,,"-176,527.43"
,CS,AR,32002042,1005,100,,Cash sale,,,,,,05/03/2018,05/03/2018,0.00,,17.54,,"-176,544.97"
,CS,AR,32002055,1005,100,,Cash sale,,,,,,05/03/2018,05/03/2018,0.00,,8.16,,"-176,553.13"
,CS,AR,32002058,1005,100,,Cash sale,,,,,,05/03/2018,05/03/2018,0.00,,7.29,,"-176,560.42"
,CS,AR,32002066,1005,100,,Cash sale,,,,,,05/03/2018,05/03/2018,0.00,,11.86,,"-176,572.28"
,CS,AR,32002069,1005,100,,Cash sale,,,,,,05/03/2018,05/03/2018,0.00,,27.08,,"-176,599.36"
,CS,AR,32002130,1005,100,,Cash sale,,,,,,05/03/2018,05/03/2018,0.00,,13.14,,"-176,612.50"
,CS,AR,32002132,1005,100,,Cash sale,,,,,,05/03/2018,05/03/2018,0.00,,5.08,,"-176,617.58"
,CS,AR,32002136,1005,100,,Cash sale,,,,,,05/03/2018,05/03/2018,0.00,,7.29,,"-176,624.87"
,CS,AR,32002177,1005,100,,Cash sale,,,,,,05/03/2018,05/03/2018,0.00,,7.29,,"-176,632.16"
,CS,AR,32002216,1005,100,,Cash sale,,,,,,05/03/2018,05/03/2018,0.00,,3.64,,"-176,635.80"
,CS,AR,32002226,1005,100,,Cash sale,,,,,,05/03/2018,05/03/2018,0.00,,29.15,,"-176,664.95"
,CS,AR,32002279,1005,100,,Cash sale,,,,,,05/03/2018,05/03/2018,0.00,,10.17,,"-176,675.12"
,CS,AR,32002299,1005,100,,Cash sale,,,,,,05/03/2018,05/03/2018,0.00,,7.29,,"-176,682.41"
,CS,AR,32002339,1005,100,,Cash sale,,,,,,05/03/2018,05/03/2018,0.00,,3.64,,"-176,686.05"
,CS,AR,32002365,1005,100,,Cash sale,,,,,,05/03/2018,05/03/2018,0.00,,6.56,,"-176,692.61"
,CS,AR,32002372,1005,100,,Cash sale,,,,,,05/03/2018,05/03/2018,0.00,,11.44,,"-176,704.05"
,CS,AR,32002410,1005,100,,Cash sale,,,,,,05/03/2018,05/03/2018,0.00,,12.14,,"-176,716.19"
,CS,AR,32002437,1005,100,,Cash sale,,,,,,05/03/2018,05/03/2018,0.00,,14.58,,"-176,730.77"
,CS,AR,32002447,1005,100,,Cash sale,,,,,,05/03/2018,05/03/2018,0.00,,12.71,,"-176,743.48"
,CS,AR,32002454,1005,100,,Cash sale,,,,,,05/03/2018,05/03/2018,0.00,,10.93,,"-176,754.41"
,CS,AR,32002498,1005,100,,Cash sale,,,,,,05/03/2018,05/03/2018,0.00,,10.93,,"-176,765.34"
,CS,AR,32002501,1005,100,,Cash sale,,,,,,05/03/2018,05/03/2018,0.00,,14.58,,"-176,779.92"
,CS,AR,32002505,1005,100,,Cash sale,,,,,,05/03/2018,05/03/2018,0.00,,3.64,,"-176,783.56"
,CS,AR,32002508,1005,100,,Cash sale,,,,,,05/03/2018,05/03/2018,0.00,,29.15,,"-176,812.71"
,CS,AR,32002512,1005,100,,Cash sale,,,,,,05/03/2018,05/03/2018,0.00,,10.93,,"-176,823.64"
,CS,AR,32002562,1005,100,,Cash sale,,,,,,05/03/2018,05/03/2018,0.00,,9.96,,"-176,833.60"
,IN,AR,30308794,1005,100,,Invoice,,,,,,05/03/2018,05/03/2018,0.00,,20.76,,"-176,854.36"
,IN,AR,30308819,1005,100,,Invoice,,,,,,05/03/2018,05/03/2018,0.00,,14.58,,"-176,868.94"
,IN,AR,30308898,1005,100,,Invoice,,,,,,05/03/2018,05/03/2018,0.00,,182.20,,"-177,051.14"
,IN,AR,30308899,1005,100,,Invoice,,,,,,05/03/2018,05/03/2018,0.00,,52.84,,"-177,103.98"
,IN,AR,30308933,1005,100,,Invoice,,,,,,05/03/2018,05/03/2018,0.00,,1.99,,"-177,105.97"
,IN,AR,30308934,1005,100,,Invoice,,,,,,05/03/2018,05/03/2018,0.00,,9.96,,"-177,115.93"
,IN,AR,30308943,1005,100,,Invoice,,,,,,05/03/2018,05/03/2018,0.00,,49.83,,"-177,165.76"
,IN,AR,30308977,1005,100,,Invoice,,,,,,05/03/2018,05/03/2018,0.00,,12.00,,"-177,177.76"
,IN,AR,30308999,1005,100,,Invoice,,,,,,05/03/2018,05/03/2018,0.00,,42.42,,"-177,220.18"
,IN,AR,30309029,1005,100,,Invoice,,,,,,05/03/2018,05/03/2018,0.00,,7.29,,"-177,227.47"
,IN,AR,30309035,1005,100,,Invoice,,,,,,05/03/2018,05/03/2018,0.00,,48.00,,"-177,275.47"
,IN,AR,30309058,1005,100,,Invoice,,,,,,05/03/2018,05/03/2018,0.00,,2.75,,"-177,278.22"
,IN,AR,30309063,1005,100,,Invoice,,,,,,05/03/2018,05/03/2018,0.00,,15.25,,"-177,293.47"
,IN,AR,30309066,1005,100,,Invoice,,,,,,05/03/2018,05/03/2018,0.00,,16.53,,"-177,310.00"
,IN,AR,30309125,1005,100,,Invoice,,,,,,05/03/2018,05/03/2018,0.00,,10.93,,"-177,320.93"
,IN,AR,30309172,1005,100,,Invoice,,,,,,05/03/2018,05/03/2018,0.00,,95.59,,"-177,416.52"
,IN,AR,30309209,1005,100,,Invoice,,,,,,05/03/2018,05/03/2018,0.00,,12.88,,"-177,429.40"
,IN,AR,30309224,1005,100,,Invoice,,,,,,05/03/2018,05/03/2018,0.00,,28.39,,"-177,457.79"
,IN,AR,30309239,1005,100,,Invoice,,,,,,05/03/2018,05/03/2018,0.00,,4.78,,"-177,462.57"
,IN,AR,30309249,1005,100,,Invoice,,,,,,05/03/2018,05/03/2018,0.00,,15.51,,"-177,478.08"
,IN,AR,30309274,1005,100,,Invoice,,,,,,05/03/2018,05/03/2018,0.00,,10.34,,"-177,488.42"
,IN,AR,30309302,1005,100,,Invoice,,,,,,05/03/2018,05/03/2018,0.00,,13.78,,"-177,502.20"
,IN,AR,30309361,1005,100,,Invoice,,,,,,05/03/2018,05/03/2018,0.00,,15.51,,"-177,517.71"
,IN,AR,30309383,1005,100,,Invoice,,,,,,05/03/2018,05/03/2018,0.00,,11.86,,"-177,529.57"
,IN,AR,30309387,1005,100,,Invoice,,,,,,05/03/2018,05/03/2018,0.00,,5.18,,"-177,534.75"
,IN,AR,30309396,1005,100,,Invoice,,,,,,05/03/2018,05/03/2018,0.00,,3.64,,"-177,538.39"
,IN,AR,30309404,1005,100,,Invoice,,,,,,05/03/2018,05/03/2018,0.00,,12.03,,"-177,550.42"
,IN,AR,30309427,1005,100,,Invoice,,,,,,05/03/2018,05/03/2018,0.00,,79.98,,"-177,630.40"
,IN,AR,30309439,1005,100,,Invoice,,,,,,05/03/2018,05/03/2018,0.00,,25.42,,"-177,655.82"
,IN,AR,30309460,1005,100,,Invoice,,,,,,05/03/2018,05/03/2018,0.00,,23.90,,"-177,679.72"
,IN,AR,30309473,1005,100,,Invoice,,,,,,05/03/2018,05/03/2018,0.00,,19.32,,"-177,699.04"
,IN,AR,30309486,1005,100,,Invoice,,,,,,05/03/2018,05/03/2018,0.00,,18.05,,"-177,717.09"
,IN,AR,30309503,1005,100,,Invoice,,,,,,05/03/2018,05/03/2018,0.00,,14.58,,"-177,731.67"
,IN,AR,30309555,1005,100,,Invoice,,,,,,05/03/2018,05/03/2018,0.00,,5.08,,"-177,736.75"
,IN,AR,30309582,1005,100,,Invoice,,,,,,05/03/2018,05/03/2018,0.00,,12.71,,"-177,749.46"
,IN,AR,30309695,1005,100,,Invoice,,,,,,05/03/2018,05/03/2018,0.00,,25.42,,"-177,774.88"
,IN,AR,30309719,1005,100,,Invoice,,,,,,05/03/2018,05/03/2018,0.00,,20.34,,"-177,795.22"
,IN,AR,30309733,1005,100,,Invoice,,,,,,05/03/2018,05/03/2018,0.00,,12.20,,"-177,807.42"
,IN,AR,30309778,1005,100,,Invoice,,,,,,05/03/2018,05/03/2018,0.00,,10.93,,"-177,818.35"
,IN,AR,30309784,1005,100,,Invoice,,,,,,05/03/2018,05/03/2018,0.00,,4.24,,"-177,822.59"
,IN,AR,30309796,1005,100,,Invoice,,,,,,05/03/2018,05/03/2018,0.00,,50.98,,"-177,873.57"
,IN,AR,30309797,1005,100,,Invoice,,,,,,05/03/2018,05/03/2018,0.00,,13.77,,"-177,887.34"
,IN,AR,30309809,1005,100,,Invoice,,,,,,05/03/2018,05/03/2018,0.00,,13.77,,"-177,901.11"
,IN,AR,30309812,1005,100,,Invoice,,,,,,05/03/2018,05/03/2018,0.00,,3.64,,"-177,904.75"
,IN,AR,30309828,1005,100,,Invoice,,,,,,05/03/2018,05/03/2018,0.00,,6.89,,"-177,911.64"
,IN,AR,30309833,1005,100,,Invoice,,,,,,05/03/2018,05/03/2018,0.00,,16.83,,"-177,928.47"
,IN,AR,30309904,1005,100,,Invoice,,,,,,05/03/2018,05/03/2018,0.00,,55.93,,"-177,984.40"
,IN,AR,30309908,1005,100,,Invoice,,,,,,05/03/2018,05/03/2018,0.00,,73.22,,"-178,057.62"
,IN,AR,30309917,1005,100,,Invoice,,,,,,05/03/2018,05/03/2018,0.00,,54.66,,"-178,112.28"
,IN,AR,30309920,1005,100,,Invoice,,,,,,05/03/2018,05/03/2018,0.00,,22.00,,"-178,134.28"
,IN,AR,30309971,1005,100,,Invoice,,,,,,05/03/2018,05/03/2018,0.00,,7.75,,"-178,142.03"
,IN,AR,30309989,1005,100,,Invoice,,,,,,05/03/2018,05/03/2018,0.00,,36.12,,"-178,178.15"
,IN,AR,30310000,1005,100,,Invoice,,,,,,05/03/2018,05/03/2018,0.00,,8.98,,"-178,187.13"
,IN,AR,30310009,1005,100,,Invoice,,,,,,05/03/2018,05/03/2018,0.00,,6.42,,"-178,193.55"
,IN,AR,30310043,1005,100,,Invoice,,,,,,05/03/2018,05/03/2018,0.00,,6.53,,"-178,200.08"
,IN,AR,30310059,1005,100,,Invoice,,,,,,05/03/2018,05/03/2018,0.00,,13.14,,"-178,213.22"
,IN,AR,30310128,1005,100,,Invoice,,,,,,05/03/2018,05/03/2018,0.00,,7.29,,"-178,220.51"
,IN,AR,30310148,1005,100,,Invoice,,,,,,05/03/2018,05/03/2018,0.00,,14.58,,"-178,235.09"
,IN,AR,30310168,1005,100,,Invoice,,,,,,05/03/2018,05/03/2018,0.00,,21.86,,"-178,256.95"
,IN,AR,30310182,1005,100,,Invoice,,,,,,05/03/2018,05/03/2018,0.00,,4.29,,"-178,261.24"
,IN,AR,30310297,1005,100,,Invoice,,,,,,05/03/2018,05/03/2018,0.00,,20.04,,"-178,281.28"
,IN,AR,30310304,1005,100,,Invoice,,,,,,05/03/2018,05/03/2018,0.00,,7.29,,"-178,288.57"
,IN,AR,30310310,1005,100,,Invoice,,,,,,05/03/2018,05/03/2018,0.00,,54.66,,"-178,343.23"
,IN,AR,30310345,1005,100,,Invoice,,,,,,05/03/2018,05/03/2018,0.00,,8.02,,"-178,351.25"
,IN,AR,30310391,1005,100,,Invoice,,,,,,05/03/2018,05/03/2018,0.00,,3.28,,"-178,354.53"
,IN,AR,30310438,1005,100,,Invoice,,,,,,05/03/2018,05/03/2018,0.00,,25.51,,"-178,380.04"
,IN,AR,30310472,1005,100,,Invoice,,,,,,05/03/2018,05/03/2018,0.00,,14.00,,"-178,394.04"
,IN,AR,30310513,1005,100,,Invoice,,,,,,05/03/2018,05/03/2018,0.00,,43.75,,"-178,437.79"
,IN,AR,30310522,1005,100,,Invoice,,,,,,05/03/2018,05/03/2018,0.00,,14.58,,"-178,452.37"
,IN,AR,30310563,1005,100,,Invoice,,,,,,05/03/2018,05/03/2018,0.00,,36.24,,"-178,488.61"
,IN,AR,30310567,1005,100,,Invoice,,,,,,05/03/2018,05/03/2018,0.00,,174.79,,"-178,663.40"
,IN,AR,30310577,1005,100,,Invoice,,,,,,05/03/2018,05/03/2018,0.00,,28.05,,"-178,691.45"
,IN,AR,30310606,1005,100,,Invoice,,,,,,05/03/2018,05/03/2018,0.00,,22.37,,"-178,713.82"
,IN,AR,30310622,1005,100,,Invoice,,,,,,05/03/2018,05/03/2018,0.00,,2.04,,"-178,715.86"
,IN,AR,30310671,1005,100,,Invoice,,,,,,05/03/2018,05/03/2018,0.00,,34.70,,"-178,750.56"
,IN,AR,30310687,1005,100,,Invoice,,,,,,05/03/2018,05/03/2018,0.00,,19.12,,"-178,769.68"
,IN,AR,30310688,1005,100,,Invoice,,,,,,05/03/2018,05/03/2018,0.00,,14.34,,"-178,784.02"
,IN,AR,30310784,1005,100,,Invoice,,,,,,05/03/2018,05/03/2018,0.00,,12.00,,"-178,796.02"
,IN,AR,30310798,1005,100,,Invoice,,,,,,05/03/2018,05/03/2018,0.00,,9.41,,"-178,805.43"
,IN,AR,30310799,1005,100,,Invoice,,,,,,05/03/2018,05/03/2018,0.00,,3.76,,"-178,809.19"
,IN,AR,30310894,1005,100,,Invoice,,,,,,05/03/2018,05/03/2018,0.00,,7.86,,"-178,817.05"
,IN,AR,30310897,1005,100,,Invoice,,,,,,05/03/2018,05/03/2018,0.00,,14.03,,"-178,831.08"
,IN,AR,30310917,1005,100,,Invoice,,,,,,05/03/2018,05/03/2018,0.00,,4.08,,"-178,835.16"
,IN,AR,30310953,1005,100,,Invoice,,,,,,05/03/2018,05/03/2018,0.00,,36.44,,"-178,871.60"
,IN,AR,30310984,1005,100,,Invoice,,,,,,05/03/2018,05/03/2018,0.00,,38.01,,"-178,909.61"
,CN,AR,31017510,1005,100,,Credit Note,,,,,,06/03/2018,06/03/2018,27.87,,0.00,,"-178,881.74"
,CN,AR,31017511,1005,100,,Credit Note,,,,,,06/03/2018,06/03/2018,27.87,,0.00,,"-178,853.87"
,CN,AR,31017592,1005,100,,Credit Note,,,,,,06/03/2018,06/03/2018,7.29,,0.00,,"-178,846.58"
,CN,AR,31017593,1005,100,,Credit Note,,,,,,06/03/2018,06/03/2018,7.29,,0.00,,"-178,839.29"
,CS,AR,32001764,1005,100,,Cash sale,,,,,,06/03/2018,06/03/2018,0.00,,3.64,,"-178,842.93"
,CS,AR,32001772,1005,100,,Cash sale,,,,,,06/03/2018,06/03/2018,0.00,,7.29,,"-178,850.22"
,CS,AR,32001804,1005,100,,Cash sale,,,,,,06/03/2018,06/03/2018,0.00,,7.29,,"-178,857.51"
,CS,AR,32001829,1005,100,,Cash sale,,,,,,06/03/2018,06/03/2018,0.00,,3.64,,"-178,861.15"
,CS,AR,32001839,1005,100,,Cash sale,,,,,,06/03/2018,06/03/2018,0.00,,7.29,,"-178,868.44"
,CS,AR,32001855,1005,100,,Cash sale,,,,,,06/03/2018,06/03/2018,0.00,,21.86,,"-178,890.30"
,CS,AR,32001861,1005,100,,Cash sale,,,,,,06/03/2018,06/03/2018,0.00,,14.58,,"-178,904.88"
,CS,AR,32001921,1005,100,,Cash sale,,,,,,06/03/2018,06/03/2018,0.00,,5.17,,"-178,910.05"
,CS,AR,32001922,1005,100,,Cash sale,,,,,,06/03/2018,06/03/2018,0.00,,4.32,,"-178,914.37"
,CS,AR,32001953,1005,100,,Cash sale,,,,,,06/03/2018,06/03/2018,0.00,,5.17,,"-178,919.54"
,CS,AR,32001957,1005,100,,Cash sale,,,,,,06/03/2018,06/03/2018,0.00,,11.36,,"-178,930.90"
,CS,AR,32001980,1005,100,,Cash sale,,,,,,06/03/2018,06/03/2018,0.00,,7.75,,"-178,938.65"
,CS,AR,32002039,1005,100,,Cash sale,,,,,,06/03/2018,06/03/2018,0.00,,6.74,,"-178,945.39"
,CS,AR,32002063,1005,100,,Cash sale,,,,,,06/03/2018,06/03/2018,0.00,,5.85,,"-178,951.24"
,CS,AR,32002078,1005,100,,Cash sale,,,,,,06/03/2018,06/03/2018,0.00,,8.17,,"-178,959.41"
,CS,AR,32002079,1005,100,,Cash sale,,,,,,06/03/2018,06/03/2018,0.00,,18.22,,"-178,977.63"
,CS,AR,32002083,1005,100,,Cash sale,,,,,,06/03/2018,06/03/2018,0.00,,5.85,,"-178,983.48"
,CS,AR,32002092,1005,100,,Cash sale,,,,,,06/03/2018,06/03/2018,0.00,,7.29,,"-178,990.77"
,CS,AR,32002098,1005,100,,Cash sale,,,,,,06/03/2018,06/03/2018,0.00,,7.80,,"-178,998.57"
,CS,AR,32002119,1005,100,,Cash sale,,,,,,06/03/2018,06/03/2018,0.00,,5.17,,"-179,003.74"
,CS,AR,32002124,1005,100,,Cash sale,,,,,,06/03/2018,06/03/2018,0.00,,10.93,,"-179,014.67"
,CS,AR,32002143,1005,100,,Cash sale,,,,,,06/03/2018,06/03/2018,0.00,,3.90,,"-179,018.57"
,CS,AR,32002190,1005,100,,Cash sale,,,,,,06/03/2018,06/03/2018,0.00,,6.44,,"-179,025.01"
,CS,AR,32002204,1005,100,,Cash sale,,,,,,06/03/2018,06/03/2018,0.00,,29.15,,"-179,054.16"
,CS,AR,32002218,1005,100,,Cash sale,,,,,,06/03/2018,06/03/2018,0.00,,7.29,,"-179,061.45"
,CS,AR,32002240,1005,100,,Cash sale,,,,,,06/03/2018,06/03/2018,0.00,,10.72,,"-179,072.17"
,CS,AR,32002248,1005,100,,Cash sale,,,,,,06/03/2018,06/03/2018,0.00,,3.76,,"-179,075.93"
,CS,AR,32002252,1005,100,,Cash sale,,,,,,06/03/2018,06/03/2018,0.00,,7.29,,"-179,083.22"
,CS,AR,32002254,1005,100,,Cash sale,,,,,,06/03/2018,06/03/2018,0.00,,29.15,,"-179,112.37"
,CS,AR,32002292,1005,100,,Cash sale,,,,,,06/03/2018,06/03/2018,0.00,,6.53,,"-179,118.90"
,CS,AR,32002305,1005,100,,Cash sale,,,,,,06/03/2018,06/03/2018,0.00,,7.29,,"-179,126.19"
,CS,AR,32002327,1005,100,,Cash sale,,,,,,06/03/2018,06/03/2018,0.00,,7.63,,"-179,133.82"
,CS,AR,32002331,1005,100,,Cash sale,,,,,,06/03/2018,06/03/2018,0.00,,28.00,,"-179,161.82"
,CS,AR,32002338,1005,100,,Cash sale,,,,,,06/03/2018,06/03/2018,0.00,,2.62,,"-179,164.44"
,CS,AR,32002392,1005,100,,Cash sale,,,,,,06/03/2018,06/03/2018,0.00,,5.93,,"-179,170.37"
,CS,AR,32002415,1005,100,,Cash sale,,,,,,06/03/2018,06/03/2018,0.00,,5.50,,"-179,175.87"
,CS,AR,32002428,1005,100,,Cash sale,,,,,,06/03/2018,06/03/2018,0.00,,14.58,,"-179,190.45"
,CS,AR,32002442,1005,100,,Cash sale,,,,,,06/03/2018,06/03/2018,0.00,,3.64,,"-179,194.09"
,CS,AR,32002476,1005,100,,Cash sale,,,,,,06/03/2018,06/03/2018,0.00,,54.66,,"-179,248.75"
,CS,AR,32002477,1005,100,,Cash sale,,,,,,06/03/2018,06/03/2018,0.00,,14.58,,"-179,263.33"
,CS,AR,32002523,1005,100,,Cash sale,,,,,,06/03/2018,06/03/2018,0.00,,8.21,,"-179,271.54"
,CS,AR,32002529,1005,100,,Cash sale,,,,,,06/03/2018,06/03/2018,0.00,,8.75,,"-179,280.29"
,CS,AR,32002536,1005,100,,Cash sale,,,,,,06/03/2018,06/03/2018,0.00,,7.29,,"-179,287.58"
,CS,AR,32002546,1005,100,,Cash sale,,,,,,06/03/2018,06/03/2018,0.00,,7.29,,"-179,294.87"
,CS,AR,32002569,1005,100,,Cash sale,,,,,,06/03/2018,06/03/2018,0.00,,7.75,,"-179,302.62"
,IN,AR,30308795,1005,100,,Invoice,,,,,,06/03/2018,06/03/2018,0.00,,53.39,,"-179,356.01"
,IN,AR,30308847,1005,100,,Invoice,,,,,,06/03/2018,06/03/2018,0.00,,43.97,,"-179,399.98"
,IN,AR,30308890,1005,100,,Invoice,,,,,,06/03/2018,06/03/2018,0.00,,10.50,,"-179,410.48"
,IN,AR,30308908,1005,100,,Invoice,,,,,,06/03/2018,06/03/2018,0.00,,364.41,,"-179,774.89"
,IN,AR,30308935,1005,100,,Invoice,,,,,,06/03/2018,06/03/2018,0.00,,5.97,,"-179,780.86"
,IN,AR,30308944,1005,100,,Invoice,,,,,,06/03/2018,06/03/2018,0.00,,49.83,,"-179,830.69"
,IN,AR,30308989,1005,100,,Invoice,,,,,,06/03/2018,06/03/2018,0.00,,21.86,,"-179,852.55"
,IN,AR,30308997,1005,100,,Invoice,,,,,,06/03/2018,06/03/2018,0.00,,7.29,,"-179,859.84"
,IN,AR,30309018,1005,100,,Invoice,,,,,,06/03/2018,06/03/2018,0.00,,3.01,,"-179,862.85"
,IN,AR,30309126,1005,100,,Invoice,,,,,,06/03/2018,06/03/2018,0.00,,14.58,,"-179,877.43"
,IN,AR,30309133,1005,100,,Invoice,,,,,,06/03/2018,06/03/2018,0.00,,10.93,,"-179,888.36"
,IN,AR,30309166,1005,100,,Invoice,,,,,,06/03/2018,06/03/2018,0.00,,5.82,,"-179,894.18"
,IN,AR,30309191,1005,100,,Invoice,,,,,,06/03/2018,06/03/2018,0.00,,21.98,,"-179,916.16"
,IN,AR,30309240,1005,100,,Invoice,,,,,,06/03/2018,06/03/2018,0.00,,12.75,,"-179,928.91"
,IN,AR,30309268,1005,100,,Invoice,,,,,,06/03/2018,06/03/2018,0.00,,18.22,,"-179,947.13"
,IN,AR,30309281,1005,100,,Invoice,,,,,,06/03/2018,06/03/2018,0.00,,4.64,,"-179,951.77"
,IN,AR,30309299,1005,100,,Invoice,,,,,,06/03/2018,06/03/2018,0.00,,364.41,,"-180,316.18"
,IN,AR,30309305,1005,100,,Invoice,,,,,,06/03/2018,06/03/2018,0.00,,10.17,,"-180,326.35"
,IN,AR,30309323,1005,100,,Invoice,,,,,,06/03/2018,06/03/2018,0.00,,2.16,,"-180,328.51"
,IN,AR,30309328,1005,100,,Invoice,,,,,,06/03/2018,06/03/2018,0.00,,8.47,,"-180,336.98"
,IN,AR,30309339,1005,100,,Invoice,,,,,,06/03/2018,06/03/2018,0.00,,81.36,,"-180,418.34"
,IN,AR,30309340,1005,100,,Invoice,,,,,,06/03/2018,06/03/2018,0.00,,40.68,,"-180,459.02"
,IN,AR,30309341,1005,100,,Invoice,,,,,,06/03/2018,06/03/2018,0.00,,24.41,,"-180,483.43"
,IN,AR,30309392,1005,100,,Invoice,,,,,,06/03/2018,06/03/2018,0.00,,3.90,,"-180,487.33"
,IN,AR,30309419,1005,100,,Invoice,,,,,,06/03/2018,06/03/2018,0.00,,17.54,,"-180,504.87"
,IN,AR,30309440,1005,100,,Invoice,,,,,,06/03/2018,06/03/2018,0.00,,195.76,,"-180,700.63"
,IN,AR,30309441,1005,100,,Invoice,,,,,,06/03/2018,06/03/2018,0.00,,12.71,,"-180,713.34"
,IN,AR,30309526,1005,100,,Invoice,,,,,,06/03/2018,06/03/2018,0.00,,42.89,,"-180,756.23"
,IN,AR,30309646,1005,100,,Invoice,,,,,,06/03/2018,06/03/2018,0.00,,12.71,,"-180,768.94"
,IN,AR,30309715,1005,100,,Invoice,,,,,,06/03/2018,06/03/2018,0.00,,5.34,,"-180,774.28"
,IN,AR,30309727,1005,100,,Invoice,,,,,,06/03/2018,06/03/2018,0.00,,11.70,,"-180,785.98"
,IN,AR,30309729,1005,100,,Invoice,,,,,,06/03/2018,06/03/2018,0.00,,12.50,,"-180,798.48"
,IN,AR,30309743,1005,100,,Invoice,,,,,,06/03/2018,06/03/2018,0.00,,4.96,,"-180,803.44"
,IN,AR,30309752,1005,100,,Invoice,,,,,,06/03/2018,06/03/2018,0.00,,5.08,,"-180,808.52"
,IN,AR,30309762,1005,100,,Invoice,,,,,,06/03/2018,06/03/2018,0.00,,14.03,,"-180,822.55"
,IN,AR,30309785,1005,100,,Invoice,,,,,,06/03/2018,06/03/2018,0.00,,6.36,,"-180,828.91"
,IN,AR,30309822,1005,100,,Invoice,,,,,,06/03/2018,06/03/2018,0.00,,24.34,,"-180,853.25"
,IN,AR,30309854,1005,100,,Invoice,,,,,,06/03/2018,06/03/2018,0.00,,9.15,,"-180,862.40"
,IN,AR,30309894,1005,100,,Invoice,,,,,,06/03/2018,06/03/2018,0.00,,10.93,,"-180,873.33"
,IN,AR,30309924,1005,100,,Invoice,,,,,,06/03/2018,06/03/2018,0.00,,26.31,,"-180,899.64"
,IN,AR,30309929,1005,100,,Invoice,,,,,,06/03/2018,06/03/2018,0.00,,3.64,,"-180,903.28"
,IN,AR,30309941,1005,100,,Invoice,,,,,,06/03/2018,06/03/2018,0.00,,18.22,,"-180,921.50"
,IN,AR,30309966,1005,100,,Invoice,,,,,,06/03/2018,06/03/2018,0.00,,8.39,,"-180,929.89"
,IN,AR,30309975,1005,100,,Invoice,,,,,,06/03/2018,06/03/2018,0.00,,2.92,,"-180,932.81"
,IN,AR,30309982,1005,100,,Invoice,,,,,,06/03/2018,06/03/2018,0.00,,5.68,,"-180,938.49"
,IN,AR,30310046,1005,100,,Invoice,,,,,,06/03/2018,06/03/2018,0.00,,3.64,,"-180,942.13"
,IN,AR,30310063,1005,100,,Invoice,,,,,,06/03/2018,06/03/2018,0.00,,23.58,,"-180,965.71"
,IN,AR,30310080,1005,100,,Invoice,,,,,,06/03/2018,06/03/2018,0.00,,7.05,,"-180,972.76"
,IN,AR,30310122,1005,100,,Invoice,,,,,,06/03/2018,06/03/2018,0.00,,43.73,,"-181,016.49"
,IN,AR,30310123,1005,100,,Invoice,,,,,,06/03/2018,06/03/2018,0.00,,5.17,,"-181,021.66"
,IN,AR,30310202,1005,100,,Invoice,,,,,,06/03/2018,06/03/2018,0.00,,7.29,,"-181,028.95"
,IN,AR,30310267,1005,100,,Invoice,,,,,,06/03/2018,06/03/2018,0.00,,34.07,,"-181,063.02"
,IN,AR,30310336,1005,100,,Invoice,,,,,,06/03/2018,06/03/2018,0.00,,176.01,,"-181,239.03"
,IN,AR,30310346,1005,100,,Invoice,,,,,,06/03/2018,06/03/2018,0.00,,6.42,,"-181,245.45"
,IN,AR,30310452,1005,100,,Invoice,,,,,,06/03/2018,06/03/2018,0.00,,20.34,,"-181,265.79"
,IN,AR,30310508,1005,100,,Invoice,,,,,,06/03/2018,06/03/2018,0.00,,68.14,,"-181,333.93"
,IN,AR,30310527,1005,100,,Invoice,,,,,,06/03/2018,06/03/2018,0.00,,10.93,,"-181,344.86"
,IN,AR,30310538,1005,100,,Invoice,,,,,,06/03/2018,06/03/2018,0.00,,37.85,,"-181,382.71"
,IN,AR,30310572,1005,100,,Invoice,,,,,,06/03/2018,06/03/2018,0.00,,7.29,,"-181,390.00"
,IN,AR,30310573,1005,100,,Invoice,,,,,,06/03/2018,06/03/2018,0.00,,8.21,,"-181,398.21"
,IN,AR,30310611,1005,100,,Invoice,,,,,,06/03/2018,06/03/2018,0.00,,94.00,,"-181,492.21"
,IN,AR,30310617,1005,100,,Invoice,,,,,,06/03/2018,06/03/2018,0.00,,9.10,,"-181,501.31"
,IN,AR,30310635,1005,100,,Invoice,,,,,,06/03/2018,06/03/2018,0.00,,18.98,,"-181,520.29"
,IN,AR,30310718,1005,100,,Invoice,,,,,,06/03/2018,06/03/2018,0.00,,78.64,,"-181,598.93"
,IN,AR,30310755,1005,100,,Invoice,,,,,,06/03/2018,06/03/2018,0.00,,31.95,,"-181,630.88"
,IN,AR,30310757,1005,100,,Invoice,,,,,,06/03/2018,06/03/2018,0.00,,23.73,,"-181,654.61"
,IN,AR,30310758,1005,100,,Invoice,,,,,,06/03/2018,06/03/2018,0.00,,18.98,,"-181,673.59"
,IN,AR,30310759,1005,100,,Invoice,,,,,,06/03/2018,06/03/2018,0.00,,83.06,,"-181,756.65"
,IN,AR,30310808,1005,100,,Invoice,,,,,,06/03/2018,06/03/2018,0.00,,1.75,,"-181,758.40"
,IN,AR,30310813,1005,100,,Invoice,,,,,,06/03/2018,06/03/2018,0.00,,10.00,,"-181,768.40"
,IN,AR,30310822,1005,100,,Invoice,,,,,,06/03/2018,06/03/2018,0.00,,133.12,,"-181,901.52"
,IN,AR,30310837,1005,100,,Invoice,,,,,,06/03/2018,06/03/2018,0.00,,7.02,,"-181,908.54"
,IN,AR,30310867,1005,100,,Invoice,,,,,,06/03/2018,06/03/2018,0.00,,7.29,,"-181,915.83"
,IN,AR,30310909,1005,100,,Invoice,,,,,,06/03/2018,06/03/2018,0.00,,14.58,,"-181,930.41"
,IN,AR,30310918,1005,100,,Invoice,,,,,,06/03/2018,06/03/2018,0.00,,16.34,,"-181,946.75"
,IN,AR,30311021,1005,100,,Invoice,,,,,,06/03/2018,06/03/2018,0.00,,7.29,,"-181,954.04"
,IN,AR,30311022,1005,100,,Invoice,,,,,,06/03/2018,06/03/2018,0.00,,29.15,,"-181,983.19"
,IN,AR,30311024,1005,100,,Invoice,,,,,,06/03/2018,06/03/2018,0.00,,29.15,,"-182,012.34"
,CN,AR,31017460,1005,100,,Credit Note,,,,,,07/03/2018,07/03/2018,54.66,,0.00,,"-181,957.68"
,CS,AR,32001724,1005,100,,Cash sale,,,,,,07/03/2018,07/03/2018,0.00,,3.64,,"-181,961.32"
,CS,AR,32001726,1005,100,,Cash sale,,,,,,07/03/2018,07/03/2018,0.00,,37.63,,"-181,998.95"
,CS,AR,32001768,1005,100,,Cash sale,,,,,,07/03/2018,07/03/2018,0.00,,7.29,,"-182,006.24"
,CS,AR,32001841,1005,100,,Cash sale,,,,,,07/03/2018,07/03/2018,0.00,,6.02,,"-182,012.26"
,CS,AR,32001884,1005,100,,Cash sale,,,,,,07/03/2018,07/03/2018,0.00,,3.64,,"-182,015.90"
,CS,AR,32001889,1005,100,,Cash sale,,,,,,07/03/2018,07/03/2018,0.00,,5.86,,"-182,021.76"
,CS,AR,32001964,1005,100,,Cash sale,,,,,,07/03/2018,07/03/2018,0.00,,28.43,,"-182,050.19"
,CS,AR,32001990,1005,100,,Cash sale,,,,,,07/03/2018,07/03/2018,0.00,,18.05,,"-182,068.24"
,CS,AR,32001993,1005,100,,Cash sale,,,,,,07/03/2018,07/03/2018,0.00,,10.72,,"-182,078.96"
,CS,AR,32002012,1005,100,,Cash sale,,,,,,07/03/2018,07/03/2018,0.00,,10.93,,"-182,089.89"
,CS,AR,32002024,1005,100,,Cash sale,,,,,,07/03/2018,07/03/2018,0.00,,3.64,,"-182,093.53"
,CS,AR,32002034,1005,100,,Cash sale,,,,,,07/03/2018,07/03/2018,0.00,,7.00,,"-182,100.53"
,CS,AR,32002109,1005,100,,Cash sale,,,,,,07/03/2018,07/03/2018,0.00,,10.93,,"-182,111.46"
,CS,AR,32002146,1005,100,,Cash sale,,,,,,07/03/2018,07/03/2018,0.00,,7.63,,"-182,119.09"
,CS,AR,32002165,1005,100,,Cash sale,,,,,,07/03/2018,07/03/2018,0.00,,7.29,,"-182,126.38"
,CS,AR,32002182,1005,100,,Cash sale,,,,,,07/03/2018,07/03/2018,0.00,,4.32,,"-182,130.70"
,CS,AR,32002185,1005,100,,Cash sale,,,,,,07/03/2018,07/03/2018,0.00,,6.02,,"-182,136.72"
,CS,AR,32002193,1005,100,,Cash sale,,,,,,07/03/2018,07/03/2018,0.00,,2.71,,"-182,139.43"
,CS,AR,32002201,1005,100,,Cash sale,,,,,,07/03/2018,07/03/2018,0.00,,7.29,,"-182,146.72"
,CS,AR,32002245,1005,100,,Cash sale,,,,,,07/03/2018,07/03/2018,0.00,,8.02,,"-182,154.74"
,CS,AR,32002286,1005,100,,Cash sale,,,,,,07/03/2018,07/03/2018,0.00,,7.29,,"-182,162.03"
,CS,AR,32002314,1005,100,,Cash sale,,,,,,07/03/2018,07/03/2018,0.00,,3.64,,"-182,165.67"
,CS,AR,32002354,1005,100,,Cash sale,,,,,,07/03/2018,07/03/2018,0.00,,8.20,,"-182,173.87"
,CS,AR,32002373,1005,100,,Cash sale,,,,,,07/03/2018,07/03/2018,0.00,,9.15,,"-182,183.02"
,CS,AR,32002386,1005,100,,Cash sale,,,,,,07/03/2018,07/03/2018,0.00,,2.97,,"-182,185.99"
,CS,AR,32002389,1005,100,,Cash sale,,,,,,07/03/2018,07/03/2018,0.00,,9.10,,"-182,195.09"
,CS,AR,32002396,1005,100,,Cash sale,,,,,,07/03/2018,07/03/2018,0.00,,8.90,,"-182,203.99"
,CS,AR,32002399,1005,100,,Cash sale,,,,,,07/03/2018,07/03/2018,0.00,,25.51,,"-182,229.50"
,CS,AR,32002402,1005,100,,Cash sale,,,,,,07/03/2018,07/03/2018,0.00,,10.93,,"-182,240.43"
,CS,AR,32002417,1005,100,,Cash sale,,,,,,07/03/2018,07/03/2018,0.00,,7.29,,"-182,247.72"
,CS,AR,32002429,1005,100,,Cash sale,,,,,,07/03/2018,07/03/2018,0.00,,9.03,,"-182,256.75"
,CS,AR,32002455,1005,100,,Cash sale,,,,,,07/03/2018,07/03/2018,0.00,,10.93,,"-182,267.68"
,CS,AR,32002482,1005,100,,Cash sale,,,,,,07/03/2018,07/03/2018,0.00,,9.10,,"-182,276.78"
,CS,AR,32002548,1005,100,,Cash sale,,,,,,07/03/2018,07/03/2018,0.00,,6.56,,"-182,283.34"
,CS,AR,32002553,1005,100,,Cash sale,,,,,,07/03/2018,07/03/2018,0.00,,10.99,,"-182,294.33"
,CS,AR,32002558,1005,100,,Cash sale,,,,,,07/03/2018,07/03/2018,0.00,,7.29,,"-182,301.62"
,IN,AR,30308826,1005,100,,Invoice,,,,,,07/03/2018,07/03/2018,0.00,,329.71,,"-182,631.33"
,IN,AR,30308832,1005,100,,Invoice,,,,,,07/03/2018,07/03/2018,0.00,,36.44,,"-182,667.77"
,IN,AR,30308837,1005,100,,Invoice,,,,,,07/03/2018,07/03/2018,0.00,,34.17,,"-182,701.94"
,IN,AR,30308838,1005,100,,Invoice,,,,,,07/03/2018,07/03/2018,0.00,,56.14,,"-182,758.08"
,IN,AR,30308849,1005,100,,Invoice,,,,,,07/03/2018,07/03/2018,0.00,,24.41,,"-182,782.49"
,IN,AR,30308850,1005,100,,Invoice,,,,,,07/03/2018,07/03/2018,0.00,,2.71,,"-182,785.20"
,IN,AR,30308867,1005,100,,Invoice,,,,,,07/03/2018,07/03/2018,0.00,,23.64,,"-182,808.84"
,IN,AR,30308868,1005,100,,Invoice,,,,,,07/03/2018,07/03/2018,0.00,,84.07,,"-182,892.91"
,IN,AR,30308888,1005,100,,Invoice,,,,,,07/03/2018,07/03/2018,0.00,,3.64,,"-182,896.55"
,IN,AR,30308911,1005,100,,Invoice,,,,,,07/03/2018,07/03/2018,0.00,,3.64,,"-182,900.19"
,IN,AR,30308945,1005,100,,Invoice,,,,,,07/03/2018,07/03/2018,0.00,,56.95,,"-182,957.14"
,IN,AR,30309016,1005,100,,Invoice,,,,,,07/03/2018,07/03/2018,0.00,,10.93,,"-182,968.07"
,IN,AR,30309036,1005,100,,Invoice,,,,,,07/03/2018,07/03/2018,0.00,,24.00,,"-182,992.07"
,IN,AR,30309088,1005,100,,Invoice,,,,,,07/03/2018,07/03/2018,0.00,,28.00,,"-183,020.07"
,IN,AR,30309100,1005,100,,Invoice,,,,,,07/03/2018,07/03/2018,0.00,,68.81,,"-183,088.88"
,IN,AR,30309114,1005,100,,Invoice,,,,,,07/03/2018,07/03/2018,0.00,,12.00,,"-183,100.88"
,IN,AR,30309150,1005,100,,Invoice,,,,,,07/03/2018,07/03/2018,0.00,,161.00,,"-183,261.88"
,IN,AR,30309196,1005,100,,Invoice,,,,,,07/03/2018,07/03/2018,0.00,,9.03,,"-183,270.91"
,IN,AR,30309218,1005,100,,Invoice,,,,,,07/03/2018,07/03/2018,0.00,,15.92,,"-183,286.83"
,IN,AR,30309235,1005,100,,Invoice,,,,,,07/03/2018,07/03/2018,0.00,,218.64,,"-183,505.47"
,IN,AR,30309241,1005,100,,Invoice,,,,,,07/03/2018,07/03/2018,0.00,,9.56,,"-183,515.03"
,IN,AR,30309312,1005,100,,Invoice,,,,,,07/03/2018,07/03/2018,0.00,,15.25,,"-183,530.28"
,IN,AR,30309332,1005,100,,Invoice,,,,,,07/03/2018,07/03/2018,0.00,,8.47,,"-183,538.75"
,IN,AR,30309334,1005,100,,Invoice,,,,,,07/03/2018,07/03/2018,0.00,,4.24,,"-183,542.99"
,IN,AR,30309350,1005,100,,Invoice,,,,,,07/03/2018,07/03/2018,0.00,,4.24,,"-183,547.23"
,IN,AR,30309390,1005,100,,Invoice,,,,,,07/03/2018,07/03/2018,0.00,,38.24,,"-183,585.47"
,IN,AR,30309410,1005,100,,Invoice,,,,,,07/03/2018,07/03/2018,0.00,,45.41,,"-183,630.88"
,IN,AR,30309428,1005,100,,Invoice,,,,,,07/03/2018,07/03/2018,0.00,,38.97,,"-183,669.85"
,IN,AR,30309505,1005,100,,Invoice,,,,,,07/03/2018,07/03/2018,0.00,,9.03,,"-183,678.88"
,IN,AR,30309507,1005,100,,Invoice,,,,,,07/03/2018,07/03/2018,0.00,,8.26,,"-183,687.14"
,IN,AR,30309518,1005,100,,Invoice,,,,,,07/03/2018,07/03/2018,0.00,,12.92,,"-183,700.06"
,IN,AR,30309537,1005,100,,Invoice,,,,,,07/03/2018,07/03/2018,0.00,,252.08,,"-183,952.14"
,IN,AR,30309613,1005,100,,Invoice,,,,,,07/03/2018,07/03/2018,0.00,,3.19,,"-183,955.33"
,IN,AR,30309711,1005,100,,Invoice,,,,,,07/03/2018,07/03/2018,0.00,,11.36,,"-183,966.69"
,IN,AR,30309753,1005,100,,Invoice,,,,,,07/03/2018,07/03/2018,0.00,,7.63,,"-183,974.32"
,IN,AR,30309803,1005,100,,Invoice,,,,,,07/03/2018,07/03/2018,0.00,,18.22,,"-183,992.54"
,IN,AR,30309834,1005,100,,Invoice,,,,,,07/03/2018,07/03/2018,0.00,,11.22,,"-184,003.76"
,IN,AR,30309848,1005,100,,Invoice,,,,,,07/03/2018,07/03/2018,0.00,,23.73,,"-184,027.49"
,IN,AR,30309870,1005,100,,Invoice,,,,,,07/03/2018,07/03/2018,0.00,,8.39,,"-184,035.88"
,IN,AR,30309895,1005,100,,Invoice,,,,,,07/03/2018,07/03/2018,0.00,,18.22,,"-184,054.10"
,IN,AR,30310005,1005,100,,Invoice,,,,,,07/03/2018,07/03/2018,0.00,,21.06,,"-184,075.16"
,IN,AR,30310081,1005,100,,Invoice,,,,,,07/03/2018,07/03/2018,0.00,,1.76,,"-184,076.92"
,IN,AR,30310082,1005,100,,Invoice,,,,,,07/03/2018,07/03/2018,0.00,,15.86,,"-184,092.78"
,IN,AR,30310095,1005,100,,Invoice,,,,,,07/03/2018,07/03/2018,0.00,,6.02,,"-184,098.80"
,IN,AR,30310156,1005,100,,Invoice,,,,,,07/03/2018,07/03/2018,0.00,,8.00,,"-184,106.80"
,IN,AR,30310276,1005,100,,Invoice,,,,,,07/03/2018,07/03/2018,0.00,,36.00,,"-184,142.80"
,IN,AR,30310292,1005,100,,Invoice,,,,,,07/03/2018,07/03/2018,0.00,,30.07,,"-184,172.87"
,IN,AR,30310311,1005,100,,Invoice,,,,,,07/03/2018,07/03/2018,0.00,,14.58,,"-184,187.45"
,IN,AR,30310318,1005,100,,Invoice,,,,,,07/03/2018,07/03/2018,0.00,,7.29,,"-184,194.74"
,IN,AR,30310323,1005,100,,Invoice,,,,,,07/03/2018,07/03/2018,0.00,,3.64,,"-184,198.38"
,IN,AR,30310347,1005,100,,Invoice,,,,,,07/03/2018,07/03/2018,0.00,,1.60,,"-184,199.98"
,IN,AR,30310348,1005,100,,Invoice,,,,,,07/03/2018,07/03/2018,0.00,,16.03,,"-184,216.01"
,IN,AR,30310349,1005,100,,Invoice,,,,,,07/03/2018,07/03/2018,0.00,,4.81,,"-184,220.82"
,IN,AR,30310350,1005,100,,Invoice,,,,,,07/03/2018,07/03/2018,0.00,,25.65,,"-184,246.47"
,IN,AR,30310351,1005,100,,Invoice,,,,,,07/03/2018,07/03/2018,0.00,,6.42,,"-184,252.89"
,IN,AR,30310352,1005,100,,Invoice,,,,,,07/03/2018,07/03/2018,0.00,,1.60,,"-184,254.49"
,IN,AR,30310353,1005,100,,Invoice,,,,,,07/03/2018,07/03/2018,0.00,,4.81,,"-184,259.30"
,IN,AR,30310354,1005,100,,Invoice,,,,,,07/03/2018,07/03/2018,0.00,,3.20,,"-184,262.50"
,IN,AR,30310400,1005,100,,Invoice,,,,,,07/03/2018,07/03/2018,0.00,,6.86,,"-184,269.36"
,IN,AR,30310413,1005,100,,Invoice,,,,,,07/03/2018,07/03/2018,0.00,,5.09,,"-184,274.45"
,IN,AR,30310424,1005,100,,Invoice,,,,,,07/03/2018,07/03/2018,0.00,,33.63,,"-184,308.08"
,IN,AR,30310476,1005,100,,Invoice,,,,,,07/03/2018,07/03/2018,0.00,,14.00,,"-184,322.08"
,IN,AR,30310491,1005,100,,Invoice,,,,,,07/03/2018,07/03/2018,0.00,,229.58,,"-184,551.66"
,IN,AR,30310492,1005,100,,Invoice,,,,,,07/03/2018,07/03/2018,0.00,,"1,093.22",,"-185,644.88"
,IN,AR,30310514,1005,100,,Invoice,,,,,,07/03/2018,07/03/2018,0.00,,3.02,,"-185,647.90"
,IN,AR,30310599,1005,100,,Invoice,,,,,,07/03/2018,07/03/2018,0.00,,8.39,,"-185,656.29"
,IN,AR,30310629,1005,100,,Invoice,,,,,,07/03/2018,07/03/2018,0.00,,8.31,,"-185,664.60"
,IN,AR,30310649,1005,100,,Invoice,,,,,,07/03/2018,07/03/2018,0.00,,10.93,,"-185,675.53"
,IN,AR,30310676,1005,100,,Invoice,,,,,,07/03/2018,07/03/2018,0.00,,81.15,,"-185,756.68"
,IN,AR,30310689,1005,100,,Invoice,,,,,,07/03/2018,07/03/2018,0.00,,4.78,,"-185,761.46"
,IN,AR,30310804,1005,100,,Invoice,,,,,,07/03/2018,07/03/2018,0.00,,3.51,,"-185,764.97"
,IN,AR,30310846,1005,100,,Invoice,,,,,,07/03/2018,07/03/2018,0.00,,6.56,,"-185,771.53"
,IN,AR,30310870,1005,100,,Invoice,,,,,,07/03/2018,07/03/2018,0.00,,5.64,,"-185,777.17"
,IN,AR,30310911,1005,100,,Invoice,,,,,,07/03/2018,07/03/2018,0.00,,13.98,,"-185,791.15"
,IN,AR,30310935,1005,100,,Invoice,,,,,,07/03/2018,07/03/2018,0.00,,40.08,,"-185,831.23"
,IN,AR,30311006,1005,100,,Invoice,,,,,,07/03/2018,07/03/2018,0.00,,5.85,,"-185,837.08"
,IN,AR,30311029,1005,100,,Invoice,,,,,,07/03/2018,07/03/2018,0.00,,419.07,,"-186,256.15"
,CS,AR,32001705,1005,100,,Cash sale,,,,,,08/03/2018,08/03/2018,0.00,,12.03,,"-186,268.18"
,CS,AR,32001761,1005,100,,Cash sale,,,,,,08/03/2018,08/03/2018,0.00,,5.17,,"-186,273.35"
,CS,AR,32001781,1005,100,,Cash sale,,,,,,08/03/2018,08/03/2018,0.00,,7.29,,"-186,280.64"
,CS,AR,32001787,1005,100,,Cash sale,,,,,,08/03/2018,08/03/2018,0.00,,30.08,,"-186,310.72"
,CS,AR,32001801,1005,100,,Cash sale,,,,,,08/03/2018,08/03/2018,0.00,,3.64,,"-186,314.36"
,CS,AR,32001833,1005,100,,Cash sale,,,,,,08/03/2018,08/03/2018,0.00,,3.64,,"-186,318.00"
,CS,AR,32001847,1005,100,,Cash sale,,,,,,08/03/2018,08/03/2018,0.00,,3.64,,"-186,321.64"
,CS,AR,32001857,1005,100,,Cash sale,,,,,,08/03/2018,08/03/2018,0.00,,21.86,,"-186,343.50"
,CS,AR,32001893,1005,100,,Cash sale,,,,,,08/03/2018,08/03/2018,0.00,,10.93,,"-186,354.43"
,CS,AR,32001897,1005,100,,Cash sale,,,,,,08/03/2018,08/03/2018,0.00,,3.64,,"-186,358.07"
,CS,AR,32001900,1005,100,,Cash sale,,,,,,08/03/2018,08/03/2018,0.00,,7.29,,"-186,365.36"
,CS,AR,32001924,1005,100,,Cash sale,,,,,,08/03/2018,08/03/2018,0.00,,7.29,,"-186,372.65"
,CS,AR,32001961,1005,100,,Cash sale,,,,,,08/03/2018,08/03/2018,0.00,,10.93,,"-186,383.58"
,CS,AR,32002033,1005,100,,Cash sale,,,,,,08/03/2018,08/03/2018,0.00,,18.09,,"-186,401.67"
,CS,AR,32002100,1005,100,,Cash sale,,,,,,08/03/2018,08/03/2018,0.00,,19.28,,"-186,420.95"
,CS,AR,32002117,1005,100,,Cash sale,,,,,,08/03/2018,08/03/2018,0.00,,14.58,,"-186,435.53"
,CS,AR,32002137,1005,100,,Cash sale,,,,,,08/03/2018,08/03/2018,0.00,,7.29,,"-186,442.82"
,CS,AR,32002156,1005,100,,Cash sale,,,,,,08/03/2018,08/03/2018,0.00,,12.92,,"-186,455.74"
,CS,AR,32002157,1005,100,,Cash sale,,,,,,08/03/2018,08/03/2018,0.00,,38.77,,"-186,494.51"
,CS,AR,32002184,1005,100,,Cash sale,,,,,,08/03/2018,08/03/2018,0.00,,25.51,,"-186,520.02"
,CS,AR,32002206,1005,100,,Cash sale,,,,,,08/03/2018,08/03/2018,0.00,,2.58,,"-186,522.60"
,CS,AR,32002237,1005,100,,Cash sale,,,,,,08/03/2018,08/03/2018,0.00,,10.93,,"-186,533.53"
,CS,AR,32002247,1005,100,,Cash sale,,,,,,08/03/2018,08/03/2018,0.00,,48.14,,"-186,581.67"
,CS,AR,32002266,1005,100,,Cash sale,,,,,,08/03/2018,08/03/2018,0.00,,14.58,,"-186,596.25"
,CS,AR,32002318,1005,100,,Cash sale,,,,,,08/03/2018,08/03/2018,0.00,,32.80,,"-186,629.05"
,CS,AR,32002322,1005,100,,Cash sale,,,,,,08/03/2018,08/03/2018,0.00,,7.29,,"-186,636.34"
,CS,AR,32002347,1005,100,,Cash sale,,,,,,08/03/2018,08/03/2018,0.00,,11.02,,"-186,647.36"
,CS,AR,32002351,1005,100,,Cash sale,,,,,,08/03/2018,08/03/2018,0.00,,8.90,,"-186,656.26"
,CS,AR,32002397,1005,100,,Cash sale,,,,,,08/03/2018,08/03/2018,0.00,,10.93,,"-186,667.19"
,CS,AR,32002463,1005,100,,Cash sale,,,,,,08/03/2018,08/03/2018,0.00,,10.93,,"-186,678.12"
,CS,AR,32002507,1005,100,,Cash sale,,,,,,08/03/2018,08/03/2018,0.00,,10.93,,"-186,689.05"
,CS,AR,32002509,1005,100,,Cash sale,,,,,,08/03/2018,08/03/2018,0.00,,7.29,,"-186,696.34"
,CS,AR,32002514,1005,100,,Cash sale,,,,,,08/03/2018,08/03/2018,0.00,,3.64,,"-186,699.98"
,CS,AR,32002518,1005,100,,Cash sale,,,,,,08/03/2018,08/03/2018,0.00,,7.29,,"-186,707.27"
,CS,AR,32002543,1005,100,,Cash sale,,,,,,08/03/2018,08/03/2018,0.00,,3.64,,"-186,710.91"
,CS,AR,32002566,1005,100,,Cash sale,,,,,,08/03/2018,08/03/2018,0.00,,7.29,,"-186,718.20"
,IN,AR,30308796,1005,100,,Invoice,,,,,,08/03/2018,08/03/2018,0.00,,5.93,,"-186,724.13"
,IN,AR,30308813,1005,100,,Invoice,,,,,,08/03/2018,08/03/2018,0.00,,3.64,,"-186,727.77"
,IN,AR,30308816,1005,100,,Invoice,,,,,,08/03/2018,08/03/2018,0.00,,54.66,,"-186,782.43"
,IN,AR,30308914,1005,100,,Invoice,,,,,,08/03/2018,08/03/2018,0.00,,14.58,,"-186,797.01"
,IN,AR,30308916,1005,100,,Invoice,,,,,,08/03/2018,08/03/2018,0.00,,29.15,,"-186,826.16"
,IN,AR,30308936,1005,100,,Invoice,,,,,,08/03/2018,08/03/2018,0.00,,3.98,,"-186,830.14"
,IN,AR,30308946,1005,100,,Invoice,,,,,,08/03/2018,08/03/2018,0.00,,40.34,,"-186,870.48"
,IN,AR,30308987,1005,100,,Invoice,,,,,,08/03/2018,08/03/2018,0.00,,54.66,,"-186,925.14"
,IN,AR,30309019,1005,100,,Invoice,,,,,,08/03/2018,08/03/2018,0.00,,7.29,,"-186,932.43"
,IN,AR,30309051,1005,100,,Invoice,,,,,,08/03/2018,08/03/2018,0.00,,3.64,,"-186,936.07"
,IN,AR,30309123,1005,100,,Invoice,,,,,,08/03/2018,08/03/2018,0.00,,"1,093.22",,"-188,029.29"
,IN,AR,30309135,1005,100,,Invoice,,,,,,08/03/2018,08/03/2018,0.00,,41.19,,"-188,070.48"
,IN,AR,30309184,1005,100,,Invoice,,,,,,08/03/2018,08/03/2018,0.00,,38.00,,"-188,108.48"
,IN,AR,30309254,1005,100,,Invoice,,,,,,08/03/2018,08/03/2018,0.00,,7.29,,"-188,115.77"
,IN,AR,30309261,1005,100,,Invoice,,,,,,08/03/2018,08/03/2018,0.00,,21.00,,"-188,136.77"
,IN,AR,30309282,1005,100,,Invoice,,,,,,08/03/2018,08/03/2018,0.00,,4.64,,"-188,141.41"
,IN,AR,30309326,1005,100,,Invoice,,,,,,08/03/2018,08/03/2018,0.00,,12.03,,"-188,153.44"
,IN,AR,30309399,1005,100,,Invoice,,,,,,08/03/2018,08/03/2018,0.00,,19.12,,"-188,172.56"
,IN,AR,30309411,1005,100,,Invoice,,,,,,08/03/2018,08/03/2018,0.00,,2.39,,"-188,174.95"
,IN,AR,30309422,1005,100,,Invoice,,,,,,08/03/2018,08/03/2018,0.00,,22.03,,"-188,196.98"
,IN,AR,30309474,1005,100,,Invoice,,,,,,08/03/2018,08/03/2018,0.00,,6.44,,"-188,203.42"
,IN,AR,30309475,1005,100,,Invoice,,,,,,08/03/2018,08/03/2018,0.00,,9.66,,"-188,213.08"
,IN,AR,30309481,1005,100,,Invoice,,,,,,08/03/2018,08/03/2018,0.00,,16.10,,"-188,229.18"
,IN,AR,30309559,1005,100,,Invoice,,,,,,08/03/2018,08/03/2018,0.00,,10.93,,"-188,240.11"
,IN,AR,30309574,1005,100,,Invoice,,,,,,08/03/2018,08/03/2018,0.00,,4.78,,"-188,244.89"
,IN,AR,30309583,1005,100,,Invoice,,,,,,08/03/2018,08/03/2018,0.00,,5.08,,"-188,249.97"
,IN,AR,30309584,1005,100,,Invoice,,,,,,08/03/2018,08/03/2018,0.00,,10.17,,"-188,260.14"
,IN,AR,30309614,1005,100,,Invoice,,,,,,08/03/2018,08/03/2018,0.00,,57.36,,"-188,317.50"
,IN,AR,30309615,1005,100,,Invoice,,,,,,08/03/2018,08/03/2018,0.00,,47.80,,"-188,365.30"
,IN,AR,30309634,1005,100,,Invoice,,,,,,08/03/2018,08/03/2018,0.00,,61.40,,"-188,426.70"
,IN,AR,30309639,1005,100,,Invoice,,,,,,08/03/2018,08/03/2018,0.00,,2.58,,"-188,429.28"
,IN,AR,30309703,1005,100,,Invoice,,,,,,08/03/2018,08/03/2018,0.00,,10.93,,"-188,440.21"
,IN,AR,30309740,1005,100,,Invoice,,,,,,08/03/2018,08/03/2018,0.00,,3.64,,"-188,443.85"
,IN,AR,30309776,1005,100,,Invoice,,,,,,08/03/2018,08/03/2018,0.00,,9.03,,"-188,452.88"
,IN,AR,30309791,1005,100,,Invoice,,,,,,08/03/2018,08/03/2018,0.00,,18.22,,"-188,471.10"
,IN,AR,30309798,1005,100,,Invoice,,,,,,08/03/2018,08/03/2018,0.00,,24.79,,"-188,495.89"
,IN,AR,30309804,1005,100,,Invoice,,,,,,08/03/2018,08/03/2018,0.00,,18.22,,"-188,514.11"
,IN,AR,30309824,1005,100,,Invoice,,,,,,08/03/2018,08/03/2018,0.00,,13.73,,"-188,527.84"
,IN,AR,30309886,1005,100,,Invoice,,,,,,08/03/2018,08/03/2018,0.00,,33.56,,"-188,561.40"
,IN,AR,30309913,1005,100,,Invoice,,,,,,08/03/2018,08/03/2018,0.00,,20.34,,"-188,581.74"
,IN,AR,30309937,1005,100,,Invoice,,,,,,08/03/2018,08/03/2018,0.00,,4.64,,"-188,586.38"
,IN,AR,30309945,1005,100,,Invoice,,,,,,08/03/2018,08/03/2018,0.00,,5.85,,"-188,592.23"
,IN,AR,30309956,1005,100,,Invoice,,,,,,08/03/2018,08/03/2018,0.00,,10.93,,"-188,603.16"
,IN,AR,30309959,1005,100,,Invoice,,,,,,08/03/2018,08/03/2018,0.00,,16.53,,"-188,619.69"
,IN,AR,30310033,1005,100,,Invoice,,,,,,08/03/2018,08/03/2018,0.00,,19.41,,"-188,639.10"
,IN,AR,30310038,1005,100,,Invoice,,,,,,08/03/2018,08/03/2018,0.00,,10.17,,"-188,649.27"
,IN,AR,30310049,1005,100,,Invoice,,,,,,08/03/2018,08/03/2018,0.00,,28.39,,"-188,677.66"
,IN,AR,30310055,1005,100,,Invoice,,,,,,08/03/2018,08/03/2018,0.00,,16.01,,"-188,693.67"
,IN,AR,30310083,1005,100,,Invoice,,,,,,08/03/2018,08/03/2018,0.00,,3.53,,"-188,697.20"
,IN,AR,30310084,1005,100,,Invoice,,,,,,08/03/2018,08/03/2018,0.00,,1.76,,"-188,698.96"
,IN,AR,30310106,1005,100,,Invoice,,,,,,08/03/2018,08/03/2018,0.00,,14.58,,"-188,713.54"
,IN,AR,30310113,1005,100,,Invoice,,,,,,08/03/2018,08/03/2018,0.00,,6.81,,"-188,720.35"
,IN,AR,30310141,1005,100,,Invoice,,,,,,08/03/2018,08/03/2018,0.00,,7.29,,"-188,727.64"
,IN,AR,30310160,1005,100,,Invoice,,,,,,08/03/2018,08/03/2018,0.00,,18.22,,"-188,745.86"
,IN,AR,30310161,1005,100,,Invoice,,,,,,08/03/2018,08/03/2018,0.00,,32.80,,"-188,778.66"
,IN,AR,30310206,1005,100,,Invoice,,,,,,08/03/2018,08/03/2018,0.00,,11.25,,"-188,789.91"
,IN,AR,30310213,1005,100,,Invoice,,,,,,08/03/2018,08/03/2018,0.00,,27.97,,"-188,817.88"
,IN,AR,30310231,1005,100,,Invoice,,,,,,08/03/2018,08/03/2018,0.00,,16.27,,"-188,834.15"
,IN,AR,30310232,1005,100,,Invoice,,,,,,08/03/2018,08/03/2018,0.00,,11.39,,"-188,845.54"
,IN,AR,30310233,1005,100,,Invoice,,,,,,08/03/2018,08/03/2018,0.00,,27.66,,"-188,873.20"
,IN,AR,30310234,1005,100,,Invoice,,,,,,08/03/2018,08/03/2018,0.00,,3.25,,"-188,876.45"
,IN,AR,30310284,1005,100,,Invoice,,,,,,08/03/2018,08/03/2018,0.00,,20.95,,"-188,897.40"
,IN,AR,30310332,1005,100,,Invoice,,,,,,08/03/2018,08/03/2018,0.00,,23.77,,"-188,921.17"
,IN,AR,30310355,1005,100,,Invoice,,,,,,08/03/2018,08/03/2018,0.00,,11.22,,"-188,932.39"
,IN,AR,30310356,1005,100,,Invoice,,,,,,08/03/2018,08/03/2018,0.00,,6.42,,"-188,938.81"
,IN,AR,30310407,1005,100,,Invoice,,,,,,08/03/2018,08/03/2018,0.00,,9.84,,"-188,948.65"
,IN,AR,30310418,1005,100,,Invoice,,,,,,08/03/2018,08/03/2018,0.00,,7.29,,"-188,955.94"
,IN,AR,30310435,1005,100,,Invoice,,,,,,08/03/2018,08/03/2018,0.00,,13.67,,"-188,969.61"
,IN,AR,30310448,1005,100,,Invoice,,,,,,08/03/2018,08/03/2018,0.00,,182.20,,"-189,151.81"
,IN,AR,30310453,1005,100,,Invoice,,,,,,08/03/2018,08/03/2018,0.00,,12.71,,"-189,164.52"
,IN,AR,30310454,1005,100,,Invoice,,,,,,08/03/2018,08/03/2018,0.00,,7.63,,"-189,172.15"
,IN,AR,30310468,1005,100,,Invoice,,,,,,08/03/2018,08/03/2018,0.00,,24.01,,"-189,196.16"
,IN,AR,30310482,1005,100,,Invoice,,,,,,08/03/2018,08/03/2018,0.00,,20.01,,"-189,216.17"
,IN,AR,30310496,1005,100,,Invoice,,,,,,08/03/2018,08/03/2018,0.00,,11.66,,"-189,227.83"
,IN,AR,30310497,1005,100,,Invoice,,,,,,08/03/2018,08/03/2018,0.00,,8.75,,"-189,236.58"
,IN,AR,30310553,1005,100,,Invoice,,,,,,08/03/2018,08/03/2018,0.00,,4.66,,"-189,241.24"
,IN,AR,30310560,1005,100,,Invoice,,,,,,08/03/2018,08/03/2018,0.00,,18.22,,"-189,259.46"
,IN,AR,30310578,1005,100,,Invoice,,,,,,08/03/2018,08/03/2018,0.00,,14.03,,"-189,273.49"
,IN,AR,30310591,1005,100,,Invoice,,,,,,08/03/2018,08/03/2018,0.00,,13.73,,"-189,287.22"
,IN,AR,30310596,1005,100,,Invoice,,,,,,08/03/2018,08/03/2018,0.00,,5.68,,"-189,292.90"
,IN,AR,30310607,1005,100,,Invoice,,,,,,08/03/2018,08/03/2018,0.00,,9.64,,"-189,302.54"
,IN,AR,30310680,1005,100,,Invoice,,,,,,08/03/2018,08/03/2018,0.00,,7.29,,"-189,309.83"
,IN,AR,30310690,1005,100,,Invoice,,,,,,08/03/2018,08/03/2018,0.00,,7.97,,"-189,317.80"
,IN,AR,30310691,1005,100,,Invoice,,,,,,08/03/2018,08/03/2018,0.00,,4.78,,"-189,322.58"
,IN,AR,30310692,1005,100,,Invoice,,,,,,08/03/2018,08/03/2018,0.00,,1.59,,"-189,324.17"
,IN,AR,30310693,1005,100,,Invoice,,,,,,08/03/2018,08/03/2018,0.00,,100.37,,"-189,424.54"
,IN,AR,30310694,1005,100,,Invoice,,,,,,08/03/2018,08/03/2018,0.00,,12.75,,"-189,437.29"
,IN,AR,30310695,1005,100,,Invoice,,,,,,08/03/2018,08/03/2018,0.00,,11.15,,"-189,448.44"
,IN,AR,30310696,1005,100,,Invoice,,,,,,08/03/2018,08/03/2018,0.00,,7.97,,"-189,456.41"
,IN,AR,30310770,1005,100,,Invoice,,,,,,08/03/2018,08/03/2018,0.00,,20.34,,"-189,476.75"
,IN,AR,30310853,1005,100,,Invoice,,,,,,08/03/2018,08/03/2018,0.00,,"1,093.22",,"-190,569.97"
,IN,AR,30310887,1005,100,,Invoice,,,,,,08/03/2018,08/03/2018,0.00,,8.78,,"-190,578.75"
,IN,AR,30310926,1005,100,,Invoice,,,,,,08/03/2018,08/03/2018,0.00,,4.08,,"-190,582.83"
,IN,AR,30310954,1005,100,,Invoice,,,,,,08/03/2018,08/03/2018,0.00,,36.44,,"-190,619.27"
,IN,AR,30310955,1005,100,,Invoice,,,,,,08/03/2018,08/03/2018,0.00,,36.44,,"-190,655.71"
,IN,AR,30310980,1005,100,,Invoice,,,,,,08/03/2018,08/03/2018,0.00,,29.15,,"-190,684.86"
,CS,AR,32001718,1005,100,,Cash sale,,,,,,09/03/2018,09/03/2018,0.00,,8.39,,"-190,693.25"
,CS,AR,32001732,1005,100,,Cash sale,,,,,,09/03/2018,09/03/2018,0.00,,9.49,,"-190,702.74"
,CS,AR,32001741,1005,100,,Cash sale,,,,,,09/03/2018,09/03/2018,0.00,,14.19,,"-190,716.93"
,CS,AR,32001795,1005,100,,Cash sale,,,,,,09/03/2018,09/03/2018,0.00,,7.25,,"-190,724.18"
,CS,AR,32001808,1005,100,,Cash sale,,,,,,09/03/2018,09/03/2018,0.00,,21.36,,"-190,745.54"
,CS,AR,32001822,1005,100,,Cash sale,,,,,,09/03/2018,09/03/2018,0.00,,12.46,,"-190,758.00"
,CS,AR,32001836,1005,100,,Cash sale,,,,,,09/03/2018,09/03/2018,0.00,,3.64,,"-190,761.64"
,CS,AR,32001872,1005,100,,Cash sale,,,,,,09/03/2018,09/03/2018,0.00,,23.29,,"-190,784.93"
,CS,AR,32001931,1005,100,,Cash sale,,,,,,09/03/2018,09/03/2018,0.00,,21.86,,"-190,806.79"
,CS,AR,32001935,1005,100,,Cash sale,,,,,,09/03/2018,09/03/2018,0.00,,5.17,,"-190,811.96"
,CS,AR,32001944,1005,100,,Cash sale,,,,,,09/03/2018,09/03/2018,0.00,,12.71,,"-190,824.67"
,CS,AR,32001970,1005,100,,Cash sale,,,,,,09/03/2018,09/03/2018,0.00,,30.22,,"-190,854.89"
,CS,AR,32001984,1005,100,,Cash sale,,,,,,09/03/2018,09/03/2018,0.00,,13.74,,"-190,868.63"
,CS,AR,32001998,1005,100,,Cash sale,,,,,,09/03/2018,09/03/2018,0.00,,7.29,,"-190,875.92"
,CS,AR,32002004,1005,100,,Cash sale,,,,,,09/03/2018,09/03/2018,0.00,,6.02,,"-190,881.94"
,CS,AR,32002010,1005,100,,Cash sale,,,,,,09/03/2018,09/03/2018,0.00,,14.58,,"-190,896.52"
,CS,AR,32002030,1005,100,,Cash sale,,,,,,09/03/2018,09/03/2018,0.00,,10.17,,"-190,906.69"
,CS,AR,32002043,1005,100,,Cash sale,,,,,,09/03/2018,09/03/2018,0.00,,17.54,,"-190,924.23"
,CS,AR,32002070,1005,100,,Cash sale,,,,,,09/03/2018,09/03/2018,0.00,,39.11,,"-190,963.34"
,CS,AR,32002094,1005,100,,Cash sale,,,,,,09/03/2018,09/03/2018,0.00,,10.93,,"-190,974.27"
,CS,AR,32002105,1005,100,,Cash sale,,,,,,09/03/2018,09/03/2018,0.00,,3.64,,"-190,977.91"
,CS,AR,32002162,1005,100,,Cash sale,,,,,,09/03/2018,09/03/2018,0.00,,7.29,,"-190,985.20"
,CS,AR,32002163,1005,100,,Cash sale,,,,,,09/03/2018,09/03/2018,0.00,,8.77,,"-190,993.97"
,CS,AR,32002181,1005,100,,Cash sale,,,,,,09/03/2018,09/03/2018,0.00,,3.64,,"-190,997.61"
,CS,AR,32002213,1005,100,,Cash sale,,,,,,09/03/2018,09/03/2018,0.00,,19.44,,"-191,017.05"
,CS,AR,32002234,1005,100,,Cash sale,,,,,,09/03/2018,09/03/2018,0.00,,11.12,,"-191,028.17"
,CS,AR,32002261,1005,100,,Cash sale,,,,,,09/03/2018,09/03/2018,0.00,,10.93,,"-191,039.10"
,CS,AR,32002267,1005,100,,Cash sale,,,,,,09/03/2018,09/03/2018,0.00,,7.29,,"-191,046.39"
,CS,AR,32002280,1005,100,,Cash sale,,,,,,09/03/2018,09/03/2018,0.00,,12.71,,"-191,059.10"
,CS,AR,32002374,1005,100,,Cash sale,,,,,,09/03/2018,09/03/2018,0.00,,9.15,,"-191,068.25"
,CS,AR,32002382,1005,100,,Cash sale,,,,,,09/03/2018,09/03/2018,0.00,,7.29,,"-191,075.54"
,CS,AR,32002450,1005,100,,Cash sale,,,,,,09/03/2018,09/03/2018,0.00,,5.47,,"-191,081.01"
,CS,AR,32002456,1005,100,,Cash sale,,,,,,09/03/2018,09/03/2018,0.00,,10.93,,"-191,091.94"
,CS,AR,32002462,1005,100,,Cash sale,,,,,,09/03/2018,09/03/2018,0.00,,7.63,,"-191,099.57"
,CS,AR,32002472,1005,100,,Cash sale,,,,,,09/03/2018,09/03/2018,0.00,,9.15,,"-191,108.72"
,CS,AR,32002480,1005,100,,Cash sale,,,,,,09/03/2018,09/03/2018,0.00,,3.64,,"-191,112.36"
,CS,AR,32002506,1005,100,,Cash sale,,,,,,09/03/2018,09/03/2018,0.00,,13.12,,"-191,125.48"
,CS,AR,32002542,1005,100,,Cash sale,,,,,,09/03/2018,09/03/2018,0.00,,18.22,,"-191,143.70"
,CS,AR,32002564,1005,100,,Cash sale,,,,,,09/03/2018,09/03/2018,0.00,,7.29,,"-191,150.99"
,CS,AR,32002576,1005,100,,Cash sale,,,,,,09/03/2018,09/03/2018,0.00,,14.58,,"-191,165.57"
,CS,AR,32002579,1005,100,,Cash sale,,,,,,09/03/2018,09/03/2018,0.00,,6.02,,"-191,171.59"
,IN,AR,30308797,1005,100,,Invoice,,,,,,09/03/2018,09/03/2018,0.00,,68.22,,"-191,239.81"
,IN,AR,30308809,1005,100,,Invoice,,,,,,09/03/2018,09/03/2018,0.00,,18.22,,"-191,258.03"
,IN,AR,30308854,1005,100,,Invoice,,,,,,09/03/2018,09/03/2018,0.00,,10.93,,"-191,268.96"
,IN,AR,30308882,1005,100,,Invoice,,,,,,09/03/2018,09/03/2018,0.00,,24.15,,"-191,293.11"
,IN,AR,30308894,1005,100,,Invoice,,,,,,09/03/2018,09/03/2018,0.00,,18.22,,"-191,311.33"
,IN,AR,30308921,1005,100,,Invoice,,,,,,09/03/2018,09/03/2018,0.00,,13.78,,"-191,325.11"
,IN,AR,30308925,1005,100,,Invoice,,,,,,09/03/2018,09/03/2018,0.00,,65.98,,"-191,391.09"
,IN,AR,30308947,1005,100,,Invoice,,,,,,09/03/2018,09/03/2018,0.00,,28.47,,"-191,419.56"
,IN,AR,30308978,1005,100,,Invoice,,,,,,09/03/2018,09/03/2018,0.00,,66.00,,"-191,485.56"
,IN,AR,30308993,1005,100,,Invoice,,,,,,09/03/2018,09/03/2018,0.00,,7.29,,"-191,492.85"
,IN,AR,30309022,1005,100,,Invoice,,,,,,09/03/2018,09/03/2018,0.00,,10.93,,"-191,503.78"
,IN,AR,30309037,1005,100,,Invoice,,,,,,09/03/2018,09/03/2018,0.00,,30.00,,"-191,533.78"
,IN,AR,30309038,1005,100,,Invoice,,,,,,09/03/2018,09/03/2018,0.00,,28.00,,"-191,561.78"
,IN,AR,30309067,1005,100,,Invoice,,,,,,09/03/2018,09/03/2018,0.00,,13.77,,"-191,575.55"
,IN,AR,30309082,1005,100,,Invoice,,,,,,09/03/2018,09/03/2018,0.00,,5.84,,"-191,581.39"
,IN,AR,30309097,1005,100,,Invoice,,,,,,09/03/2018,09/03/2018,0.00,,7.29,,"-191,588.68"
,IN,AR,30309101,1005,100,,Invoice,,,,,,09/03/2018,09/03/2018,0.00,,4.75,,"-191,593.43"
,IN,AR,30309115,1005,100,,Invoice,,,,,,09/03/2018,09/03/2018,0.00,,16.00,,"-191,609.43"
,IN,AR,30309124,1005,100,,Invoice,,,,,,09/03/2018,09/03/2018,0.00,,14.58,,"-191,624.01"
,IN,AR,30309147,1005,100,,Invoice,,,,,,09/03/2018,09/03/2018,0.00,,28.39,,"-191,652.40"
,IN,AR,30309167,1005,100,,Invoice,,,,,,09/03/2018,09/03/2018,0.00,,11.64,,"-191,664.04"
,IN,AR,30309205,1005,100,,Invoice,,,,,,09/03/2018,09/03/2018,0.00,,8.39,,"-191,672.43"
,IN,AR,30309234,1005,100,,Invoice,,,,,,09/03/2018,09/03/2018,0.00,,3.64,,"-191,676.07"
,IN,AR,30309242,1005,100,,Invoice,,,,,,09/03/2018,09/03/2018,0.00,,6.37,,"-191,682.44"
,IN,AR,30309271,1005,100,,Invoice,,,,,,09/03/2018,09/03/2018,0.00,,2.58,,"-191,685.02"
,IN,AR,30309351,1005,100,,Invoice,,,,,,09/03/2018,09/03/2018,0.00,,54.66,,"-191,739.68"
,IN,AR,30309362,1005,100,,Invoice,,,,,,09/03/2018,09/03/2018,0.00,,10.34,,"-191,750.02"
,IN,AR,30309372,1005,100,,Invoice,,,,,,09/03/2018,09/03/2018,0.00,,2.39,,"-191,752.41"
,IN,AR,30309378,1005,100,,Invoice,,,,,,09/03/2018,09/03/2018,0.00,,189.94,,"-191,942.35"
,IN,AR,30309429,1005,100,,Invoice,,,,,,09/03/2018,09/03/2018,0.00,,63.58,,"-192,005.93"
,IN,AR,30309498,1005,100,,Invoice,,,,,,09/03/2018,09/03/2018,0.00,,7.29,,"-192,013.22"
,IN,AR,30309532,1005,100,,Invoice,,,,,,09/03/2018,09/03/2018,0.00,,14.83,,"-192,028.05"
,IN,AR,30309568,1005,100,,Invoice,,,,,,09/03/2018,09/03/2018,0.00,,8.47,,"-192,036.52"
,IN,AR,30309605,1005,100,,Invoice,,,,,,09/03/2018,09/03/2018,0.00,,10.17,,"-192,046.69"
,IN,AR,30309627,1005,100,,Invoice,,,,,,09/03/2018,09/03/2018,0.00,,16.55,,"-192,063.24"
,IN,AR,30309720,1005,100,,Invoice,,,,,,09/03/2018,09/03/2018,0.00,,27.97,,"-192,091.21"
,IN,AR,30309748,1005,100,,Invoice,,,,,,09/03/2018,09/03/2018,0.00,,14.58,,"-192,105.79"
,IN,AR,30309769,1005,100,,Invoice,,,,,,09/03/2018,09/03/2018,0.00,,7.29,,"-192,113.08"
,IN,AR,30309805,1005,100,,Invoice,,,,,,09/03/2018,09/03/2018,0.00,,10.93,,"-192,124.01"
,IN,AR,30309843,1005,100,,Invoice,,,,,,09/03/2018,09/03/2018,0.00,,60.17,,"-192,184.18"
,IN,AR,30309874,1005,100,,Invoice,,,,,,09/03/2018,09/03/2018,0.00,,10.93,,"-192,195.11"
,IN,AR,30309876,1005,100,,Invoice,,,,,,09/03/2018,09/03/2018,0.00,,14.58,,"-192,209.69"
,IN,AR,30309943,1005,100,,Invoice,,,,,,09/03/2018,09/03/2018,0.00,,20.48,,"-192,230.17"
,IN,AR,30309992,1005,100,,Invoice,,,,,,09/03/2018,09/03/2018,0.00,,5.51,,"-192,235.68"
,IN,AR,30310010,1005,100,,Invoice,,,,,,09/03/2018,09/03/2018,0.00,,24.07,,"-192,259.75"
,IN,AR,30310014,1005,100,,Invoice,,,,,,09/03/2018,09/03/2018,0.00,,7.75,,"-192,267.50"
,IN,AR,30310064,1005,100,,Invoice,,,,,,09/03/2018,09/03/2018,0.00,,53.60,,"-192,321.10"
,IN,AR,30310107,1005,100,,Invoice,,,,,,09/03/2018,09/03/2018,0.00,,4.85,,"-192,325.95"
,IN,AR,30310139,1005,100,,Invoice,,,,,,09/03/2018,09/03/2018,0.00,,5.49,,"-192,331.44"
,IN,AR,30310178,1005,100,,Invoice,,,,,,09/03/2018,09/03/2018,0.00,,7.29,,"-192,338.73"
,IN,AR,30310189,1005,100,,Invoice,,,,,,09/03/2018,09/03/2018,0.00,,18.22,,"-192,356.95"
,IN,AR,30310201,1005,100,,Invoice,,,,,,09/03/2018,09/03/2018,0.00,,4.08,,"-192,361.03"
,IN,AR,30310205,1005,100,,Invoice,,,,,,09/03/2018,09/03/2018,0.00,,5.17,,"-192,366.20"
,IN,AR,30310268,1005,100,,Invoice,,,,,,09/03/2018,09/03/2018,0.00,,19.87,,"-192,386.07"
,IN,AR,30310280,1005,100,,Invoice,,,,,,09/03/2018,09/03/2018,0.00,,36.00,,"-192,422.07"
,IN,AR,30310282,1005,100,,Invoice,,,,,,09/03/2018,09/03/2018,0.00,,182.20,,"-192,604.27"
,IN,AR,30310298,1005,100,,Invoice,,,,,,09/03/2018,09/03/2018,0.00,,26.06,,"-192,630.33"
,IN,AR,30310330,1005,100,,Invoice,,,,,,09/03/2018,09/03/2018,0.00,,7.29,,"-192,637.62"
,IN,AR,30310357,1005,100,,Invoice,,,,,,09/03/2018,09/03/2018,0.00,,78.57,,"-192,716.19"
,IN,AR,30310395,1005,100,,Invoice,,,,,,09/03/2018,09/03/2018,0.00,,39.41,,"-192,755.60"
,IN,AR,30310431,1005,100,,Invoice,,,,,,09/03/2018,09/03/2018,0.00,,19.13,,"-192,774.73"
,IN,AR,30310455,1005,100,,Invoice,,,,,,09/03/2018,09/03/2018,0.00,,27.97,,"-192,802.70"
,IN,AR,30310485,1005,100,,Invoice,,,,,,09/03/2018,09/03/2018,0.00,,16.01,,"-192,818.71"
,IN,AR,30310490,1005,100,,Invoice,,,,,,09/03/2018,09/03/2018,0.00,,22.88,,"-192,841.59"
,IN,AR,30310523,1005,100,,Invoice,,,,,,09/03/2018,09/03/2018,0.00,,8.75,,"-192,850.34"
,IN,AR,30310533,1005,100,,Invoice,,,,,,09/03/2018,09/03/2018,0.00,,24.64,,"-192,874.98"
,IN,AR,30310539,1005,100,,Invoice,,,,,,09/03/2018,09/03/2018,0.00,,16.82,,"-192,891.80"
,IN,AR,30310554,1005,100,,Invoice,,,,,,09/03/2018,09/03/2018,0.00,,26.24,,"-192,918.04"
,IN,AR,30310586,1005,100,,Invoice,,,,,,09/03/2018,09/03/2018,0.00,,6.89,,"-192,924.93"
,IN,AR,30310632,1005,100,,Invoice,,,,,,09/03/2018,09/03/2018,0.00,,8.90,,"-192,933.83"
,IN,AR,30310645,1005,100,,Invoice,,,,,,09/03/2018,09/03/2018,0.00,,14.58,,"-192,948.41"
,IN,AR,30310653,1005,100,,Invoice,,,,,,09/03/2018,09/03/2018,0.00,,10.93,,"-192,959.34"
,IN,AR,30310661,1005,100,,Invoice,,,,,,09/03/2018,09/03/2018,0.00,,11.36,,"-192,970.70"
,IN,AR,30310666,1005,100,,Invoice,,,,,,09/03/2018,09/03/2018,0.00,,14.49,,"-192,985.19"
,IN,AR,30310722,1005,100,,Invoice,,,,,,09/03/2018,09/03/2018,0.00,,12.17,,"-192,997.36"
,IN,AR,30310753,1005,100,,Invoice,,,,,,09/03/2018,09/03/2018,0.00,,21.86,,"-193,019.22"
,IN,AR,30310785,1005,100,,Invoice,,,,,,09/03/2018,09/03/2018,0.00,,10.00,,"-193,029.22"
,IN,AR,30310812,1005,100,,Invoice,,,,,,09/03/2018,09/03/2018,0.00,,16.53,,"-193,045.75"
,IN,AR,30310843,1005,100,,Invoice,,,,,,09/03/2018,09/03/2018,0.00,,2.92,,"-193,048.67"
,IN,AR,30310848,1005,100,,Invoice,,,,,,09/03/2018,09/03/2018,0.00,,10.99,,"-193,059.66"
,IN,AR,30310855,1005,100,,Invoice,,,,,,09/03/2018,09/03/2018,0.00,,8.21,,"-193,067.87"
,IN,AR,30310863,1005,100,,Invoice,,,,,,09/03/2018,09/03/2018,0.00,,44.49,,"-193,112.36"
,IN,AR,30310866,1005,100,,Invoice,,,,,,09/03/2018,09/03/2018,0.00,,3.64,,"-193,116.00"
,IN,AR,30310893,1005,100,,Invoice,,,,,,09/03/2018,09/03/2018,0.00,,7.29,,"-193,123.29"
,IN,AR,30310919,1005,100,,Invoice,,,,,,09/03/2018,09/03/2018,0.00,,12.25,,"-193,135.54"
,IN,AR,30310974,1005,100,,Invoice,,,,,,09/03/2018,09/03/2018,0.00,,11.95,,"-193,147.49"
,IN,AR,30310978,1005,100,,Invoice,,,,,,09/03/2018,09/03/2018,0.00,,7.17,,"-193,154.66"
,IN,AR,30311008,1005,100,,Invoice,,,,,,09/03/2018,09/03/2018,0.00,,9.11,,"-193,163.77"
,IN,AR,30311023,1005,100,,Invoice,,,,,,09/03/2018,09/03/2018,0.00,,3.64,,"-193,167.41"
,CS,AR,32001778,1005,100,,Cash sale,,,,,,10/03/2018,10/03/2018,0.00,,7.29,,"-193,174.70"
,CS,AR,32001852,1005,100,,Cash sale,,,,,,10/03/2018,10/03/2018,0.00,,14.58,,"-193,189.28"
,CS,AR,32002089,1005,100,,Cash sale,,,,,,10/03/2018,10/03/2018,0.00,,3.64,,"-193,192.92"
,CS,AR,32002527,1005,100,,Cash sale,,,,,,10/03/2018,10/03/2018,0.00,,10.93,,"-193,203.85"
,IN,AR,30308948,1005,100,,Invoice,,,,,,10/03/2018,10/03/2018,0.00,,33.22,,"-193,237.07"
,IN,AR,30309175,1005,100,,Invoice,,,,,,10/03/2018,10/03/2018,0.00,,10.93,,"-193,248.00"
,IN,AR,30309179,1005,100,,Invoice,,,,,,10/03/2018,10/03/2018,0.00,,7.29,,"-193,255.29"
,IN,AR,30309188,1005,100,,Invoice,,,,,,10/03/2018,10/03/2018,0.00,,7.29,,"-193,262.58"
,IN,AR,30309452,1005,100,,Invoice,,,,,,10/03/2018,10/03/2018,0.00,,36.44,,"-193,299.02"
,IN,AR,30309835,1005,100,,Invoice,,,,,,10/03/2018,10/03/2018,0.00,,22.44,,"-193,321.46"
,IN,AR,30310874,1005,100,,Invoice,,,,,,10/03/2018,10/03/2018,0.00,,15.17,,"-193,336.63"
,IN,AR,30311034,1005,100,,Invoice,,,,,,10/03/2018,10/03/2018,0.00,,7.29,,"-193,343.92"
,CN,AR,31017570,1005,100,,Credit Note,,,,,,12/03/2018,12/03/2018,1.22,,0.00,,"-193,342.70"
,CN,AR,31017683,1005,100,,Credit Note,,,,,,12/03/2018,12/03/2018,419.07,,0.00,,"-192,923.63"
,CS,AR,32001733,1005,100,,Cash sale,,,,,,12/03/2018,12/03/2018,0.00,,9.49,,"-192,933.12"
,CS,AR,32001759,1005,100,,Cash sale,,,,,,12/03/2018,12/03/2018,0.00,,14.58,,"-192,947.70"
,CS,AR,32001823,1005,100,,Cash sale,,,,,,12/03/2018,12/03/2018,0.00,,14.53,,"-192,962.23"
,CS,AR,32001877,1005,100,,Cash sale,,,,,,12/03/2018,12/03/2018,0.00,,14.58,,"-192,976.81"
,CS,AR,32001885,1005,100,,Cash sale,,,,,,12/03/2018,12/03/2018,0.00,,3.64,,"-192,980.45"
,CS,AR,32001906,1005,100,,Cash sale,,,,,,12/03/2018,12/03/2018,0.00,,10.34,,"-192,990.79"
,CS,AR,32001926,1005,100,,Cash sale,,,,,,12/03/2018,12/03/2018,0.00,,10.93,,"-193,001.72"
,CS,AR,32001928,1005,100,,Cash sale,,,,,,12/03/2018,12/03/2018,0.00,,7.29,,"-193,009.01"
,CS,AR,32001945,1005,100,,Cash sale,,,,,,12/03/2018,12/03/2018,0.00,,12.71,,"-193,021.72"
,CS,AR,32001965,1005,100,,Cash sale,,,,,,12/03/2018,12/03/2018,0.00,,15.51,,"-193,037.23"
,CS,AR,32001985,1005,100,,Cash sale,,,,,,12/03/2018,12/03/2018,0.00,,13.74,,"-193,050.97"
,CS,AR,32001996,1005,100,,Cash sale,,,,,,12/03/2018,12/03/2018,0.00,,10.93,,"-193,061.90"
,CS,AR,32002017,1005,100,,Cash sale,,,,,,12/03/2018,12/03/2018,0.00,,3.64,,"-193,065.54"
,CS,AR,32002031,1005,100,,Cash sale,,,,,,12/03/2018,12/03/2018,0.00,,5.08,,"-193,070.62"
,CS,AR,32002044,1005,100,,Cash sale,,,,,,12/03/2018,12/03/2018,0.00,,29.24,,"-193,099.86"
,CS,AR,32002060,1005,100,,Cash sale,,,,,,12/03/2018,12/03/2018,0.00,,6.02,,"-193,105.88"
,CS,AR,32002071,1005,100,,Cash sale,,,,,,12/03/2018,12/03/2018,0.00,,24.07,,"-193,129.95"
,CS,AR,32002131,1005,100,,Cash sale,,,,,,12/03/2018,12/03/2018,0.00,,7.88,,"-193,137.83"
,CS,AR,32002133,1005,100,,Cash sale,,,,,,12/03/2018,12/03/2018,0.00,,2.54,,"-193,140.37"
,CS,AR,32002178,1005,100,,Cash sale,,,,,,12/03/2018,12/03/2018,0.00,,7.29,,"-193,147.66"
,CS,AR,32002203,1005,100,,Cash sale,,,,,,12/03/2018,12/03/2018,0.00,,10.93,,"-193,158.59"
,CS,AR,32002211,1005,100,,Cash sale,,,,,,12/03/2018,12/03/2018,0.00,,14.58,,"-193,173.17"
,CS,AR,32002217,1005,100,,Cash sale,,,,,,12/03/2018,12/03/2018,0.00,,5.17,,"-193,178.34"
,CS,AR,32002225,1005,100,,Cash sale,,,,,,12/03/2018,12/03/2018,0.00,,3.20,,"-193,181.54"
,CS,AR,32002257,1005,100,,Cash sale,,,,,,12/03/2018,12/03/2018,0.00,,10.93,,"-193,192.47"
,CS,AR,32002263,1005,100,,Cash sale,,,,,,12/03/2018,12/03/2018,0.00,,10.93,,"-193,203.40"
,CS,AR,32002264,1005,100,,Cash sale,,,,,,12/03/2018,12/03/2018,0.00,,7.29,,"-193,210.69"
,CS,AR,32002287,1005,100,,Cash sale,,,,,,12/03/2018,12/03/2018,0.00,,21.86,,"-193,232.55"
,CS,AR,32002300,1005,100,,Cash sale,,,,,,12/03/2018,12/03/2018,0.00,,7.29,,"-193,239.84"
,CS,AR,32002304,1005,100,,Cash sale,,,,,,12/03/2018,12/03/2018,0.00,,7.29,,"-193,247.13"
,CS,AR,32002312,1005,100,,Cash sale,,,,,,12/03/2018,12/03/2018,0.00,,17.80,,"-193,264.93"
,CS,AR,32002342,1005,100,,Cash sale,,,,,,12/03/2018,12/03/2018,0.00,,7.29,,"-193,272.22"
,CS,AR,32002355,1005,100,,Cash sale,,,,,,12/03/2018,12/03/2018,0.00,,8.20,,"-193,280.42"
,CS,AR,32002375,1005,100,,Cash sale,,,,,,12/03/2018,12/03/2018,0.00,,11.44,,"-193,291.86"
,CS,AR,32002384,1005,100,,Cash sale,,,,,,12/03/2018,12/03/2018,0.00,,7.29,,"-193,299.15"
,CS,AR,32002502,1005,100,,Cash sale,,,,,,12/03/2018,12/03/2018,0.00,,10.93,,"-193,310.08"
,CS,AR,32002565,1005,100,,Cash sale,,,,,,12/03/2018,12/03/2018,0.00,,32.16,,"-193,342.24"
,IN,AR,30308792,1005,100,,Invoice,,,,,,12/03/2018,12/03/2018,0.00,,54.66,,"-193,396.90"
,IN,AR,30308798,1005,100,,Invoice,,,,,,12/03/2018,12/03/2018,0.00,,32.63,,"-193,429.53"
,IN,AR,30308820,1005,100,,Invoice,,,,,,12/03/2018,12/03/2018,0.00,,18.22,,"-193,447.75"
,IN,AR,30308900,1005,100,,Invoice,,,,,,12/03/2018,12/03/2018,0.00,,33.81,,"-193,481.56"
,IN,AR,30308929,1005,100,,Invoice,,,,,,12/03/2018,12/03/2018,0.00,,3.64,,"-193,485.20"
,IN,AR,30308949,1005,100,,Invoice,,,,,,12/03/2018,12/03/2018,0.00,,71.19,,"-193,556.39"
,IN,AR,30308964,1005,100,,Invoice,,,,,,12/03/2018,12/03/2018,0.00,,11.02,,"-193,567.41"
,IN,AR,30308979,1005,100,,Invoice,,,,,,12/03/2018,12/03/2018,0.00,,46.00,,"-193,613.41"
,IN,AR,30308986,1005,100,,Invoice,,,,,,12/03/2018,12/03/2018,0.00,,364.41,,"-193,977.82"
,IN,AR,30309000,1005,100,,Invoice,,,,,,12/03/2018,12/03/2018,0.00,,63.63,,"-194,041.45"
,IN,AR,30309005,1005,100,,Invoice,,,,,,12/03/2018,12/03/2018,0.00,,"1,093.22",,"-195,134.67"
,IN,AR,30309023,1005,100,,Invoice,,,,,,12/03/2018,12/03/2018,0.00,,182.20,,"-195,316.87"
,IN,AR,30309027,1005,100,,Invoice,,,,,,12/03/2018,12/03/2018,0.00,,14.58,,"-195,331.45"
,IN,AR,30309039,1005,100,,Invoice,,,,,,12/03/2018,12/03/2018,0.00,,42.00,,"-195,373.45"
,IN,AR,30309040,1005,100,,Invoice,,,,,,12/03/2018,12/03/2018,0.00,,8.00,,"-195,381.45"
,IN,AR,30309059,1005,100,,Invoice,,,,,,12/03/2018,12/03/2018,0.00,,5.51,,"-195,386.96"
,IN,AR,30309064,1005,100,,Invoice,,,,,,12/03/2018,12/03/2018,0.00,,15.25,,"-195,402.21"
,IN,AR,30309070,1005,100,,Invoice,,,,,,12/03/2018,12/03/2018,0.00,,182.20,,"-195,584.41"
,IN,AR,30309083,1005,100,,Invoice,,,,,,12/03/2018,12/03/2018,0.00,,5.84,,"-195,590.25"
,IN,AR,30309093,1005,100,,Invoice,,,,,,12/03/2018,12/03/2018,0.00,,182.20,,"-195,772.45"
,IN,AR,30309094,1005,100,,Invoice,,,,,,12/03/2018,12/03/2018,0.00,,8.77,,"-195,781.22"
,IN,AR,30309116,1005,100,,Invoice,,,,,,12/03/2018,12/03/2018,0.00,,14.00,,"-195,795.22"
,IN,AR,30309131,1005,100,,Invoice,,,,,,12/03/2018,12/03/2018,0.00,,182.20,,"-195,977.42"
,IN,AR,30309144,1005,100,,Invoice,,,,,,12/03/2018,12/03/2018,0.00,,"1,093.22",,"-197,070.64"
,IN,AR,30309182,1005,100,,Invoice,,,,,,12/03/2018,12/03/2018,0.00,,364.41,,"-197,435.05"
,IN,AR,30309210,1005,100,,Invoice,,,,,,12/03/2018,12/03/2018,0.00,,11.27,,"-197,446.32"
,IN,AR,30309225,1005,100,,Invoice,,,,,,12/03/2018,12/03/2018,0.00,,28.39,,"-197,474.71"
,IN,AR,30309230,1005,100,,Invoice,,,,,,12/03/2018,12/03/2018,0.00,,182.20,,"-197,656.91"
,IN,AR,30309250,1005,100,,Invoice,,,,,,12/03/2018,12/03/2018,0.00,,25.85,,"-197,682.76"
,IN,AR,30309267,1005,100,,Invoice,,,,,,12/03/2018,12/03/2018,0.00,,54.66,,"-197,737.42"
,IN,AR,30309275,1005,100,,Invoice,,,,,,12/03/2018,12/03/2018,0.00,,5.17,,"-197,742.59"
,IN,AR,30309286,1005,100,,Invoice,,,,,,12/03/2018,12/03/2018,0.00,,7.29,,"-197,749.88"
,IN,AR,30309290,1005,100,,Invoice,,,,,,12/03/2018,12/03/2018,0.00,,364.41,,"-198,114.29"
,IN,AR,30309303,1005,100,,Invoice,,,,,,12/03/2018,12/03/2018,0.00,,11.48,,"-198,125.77"
,IN,AR,30309309,1005,100,,Invoice,,,,,,12/03/2018,12/03/2018,0.00,,"1,093.22",,"-199,218.99"
,IN,AR,30309338,1005,100,,Invoice,,,,,,12/03/2018,12/03/2018,0.00,,8.47,,"-199,227.46"
,IN,AR,30309359,1005,100,,Invoice,,,,,,12/03/2018,12/03/2018,0.00,,91.10,,"-199,318.56"
,IN,AR,30309363,1005,100,,Invoice,,,,,,12/03/2018,12/03/2018,0.00,,18.09,,"-199,336.65"
,IN,AR,30309384,1005,100,,Invoice,,,,,,12/03/2018,12/03/2018,0.00,,8.90,,"-199,345.55"
,IN,AR,30309430,1005,100,,Invoice,,,,,,12/03/2018,12/03/2018,0.00,,86.14,,"-199,431.69"
,IN,AR,30309442,1005,100,,Invoice,,,,,,12/03/2018,12/03/2018,0.00,,20.34,,"-199,452.03"
,IN,AR,30309461,1005,100,,Invoice,,,,,,12/03/2018,12/03/2018,0.00,,9.56,,"-199,461.59"
,IN,AR,30309476,1005,100,,Invoice,,,,,,12/03/2018,12/03/2018,0.00,,19.32,,"-199,480.91"
,IN,AR,30309487,1005,100,,Invoice,,,,,,12/03/2018,12/03/2018,0.00,,12.03,,"-199,492.94"
,IN,AR,30309500,1005,100,,Invoice,,,,,,12/03/2018,12/03/2018,0.00,,7.29,,"-199,500.23"
,IN,AR,30309502,1005,100,,Invoice,,,,,,12/03/2018,12/03/2018,0.00,,4.24,,"-199,504.47"
,IN,AR,30309508,1005,100,,Invoice,,,,,,12/03/2018,12/03/2018,0.00,,2.75,,"-199,507.22"
,IN,AR,30309511,1005,100,,Invoice,,,,,,12/03/2018,12/03/2018,0.00,,364.41,,"-199,871.63"
,IN,AR,30309515,1005,100,,Invoice,,,,,,12/03/2018,12/03/2018,0.00,,364.41,,"-200,236.04"
,IN,AR,30309516,1005,100,,Invoice,,,,,,12/03/2018,12/03/2018,0.00,,48.94,,"-200,284.98"
,IN,AR,30309523,1005,100,,Invoice,,,,,,12/03/2018,12/03/2018,0.00,,6.36,,"-200,291.34"
,IN,AR,30309585,1005,100,,Invoice,,,,,,12/03/2018,12/03/2018,0.00,,10.17,,"-200,301.51"
,IN,AR,30309586,1005,100,,Invoice,,,,,,12/03/2018,12/03/2018,0.00,,12.71,,"-200,314.22"
,IN,AR,30309652,1005,100,,Invoice,,,,,,12/03/2018,12/03/2018,0.00,,10.93,,"-200,325.15"
,IN,AR,30309701,1005,100,,Invoice,,,,,,12/03/2018,12/03/2018,0.00,,7.17,,"-200,332.32"
,IN,AR,30309721,1005,100,,Invoice,,,,,,12/03/2018,12/03/2018,0.00,,22.88,,"-200,355.20"
,IN,AR,30309734,1005,100,,Invoice,,,,,,12/03/2018,12/03/2018,0.00,,24.41,,"-200,379.61"
,IN,AR,30309749,1005,100,,Invoice,,,,,,12/03/2018,12/03/2018,0.00,,14.58,,"-200,394.19"
,IN,AR,30309774,1005,100,,Invoice,,,,,,12/03/2018,12/03/2018,0.00,,3.64,,"-200,397.83"
,IN,AR,30309799,1005,100,,Invoice,,,,,,12/03/2018,12/03/2018,0.00,,8.26,,"-200,406.09"
,IN,AR,30309810,1005,100,,Invoice,,,,,,12/03/2018,12/03/2018,0.00,,16.53,,"-200,422.62"
,IN,AR,30309829,1005,100,,Invoice,,,,,,12/03/2018,12/03/2018,0.00,,9.19,,"-200,431.81"
,IN,AR,30309889,1005,100,,Invoice,,,,,,12/03/2018,12/03/2018,0.00,,54.66,,"-200,486.47"
,IN,AR,30309909,1005,100,,Invoice,,,,,,12/03/2018,12/03/2018,0.00,,58.58,,"-200,545.05"
,IN,AR,30309921,1005,100,,Invoice,,,,,,12/03/2018,12/03/2018,0.00,,12.00,,"-200,557.05"
,IN,AR,30309942,1005,100,,Invoice,,,,,,12/03/2018,12/03/2018,0.00,,364.41,,"-200,921.46"
,IN,AR,30309953,1005,100,,Invoice,,,,,,12/03/2018,12/03/2018,0.00,,54.66,,"-200,976.12"
,IN,AR,30309972,1005,100,,Invoice,,,,,,12/03/2018,12/03/2018,0.00,,10.34,,"-200,986.46"
,IN,AR,30309990,1005,100,,Invoice,,,,,,12/03/2018,12/03/2018,0.00,,39.40,,"-201,025.86"
,IN,AR,30310016,1005,100,,Invoice,,,,,,12/03/2018,12/03/2018,0.00,,14.58,,"-201,040.44"
,IN,AR,30310017,1005,100,,Invoice,,,,,,12/03/2018,12/03/2018,0.00,,2.92,,"-201,043.36"
,IN,AR,30310020,1005,100,,Invoice,,,,,,12/03/2018,12/03/2018,0.00,,54.66,,"-201,098.02"
,IN,AR,30310042,1005,100,,Invoice,,,,,,12/03/2018,12/03/2018,0.00,,54.66,,"-201,152.68"
,IN,AR,30310044,1005,100,,Invoice,,,,,,12/03/2018,12/03/2018,0.00,,6.53,,"-201,159.21"
,IN,AR,30310052,1005,100,,Invoice,,,,,,12/03/2018,12/03/2018,0.00,,54.66,,"-201,213.87"
,IN,AR,30310069,1005,100,,Invoice,,,,,,12/03/2018,12/03/2018,0.00,,2.44,,"-201,216.31"
,IN,AR,30310099,1005,100,,Invoice,,,,,,12/03/2018,12/03/2018,0.00,,10.93,,"-201,227.24"
,IN,AR,30310125,1005,100,,Invoice,,,,,,12/03/2018,12/03/2018,0.00,,29.15,,"-201,256.39"
,IN,AR,30310133,1005,100,,Invoice,,,,,,12/03/2018,12/03/2018,0.00,,364.41,,"-201,620.80"
,IN,AR,30310172,1005,100,,Invoice,,,,,,12/03/2018,12/03/2018,0.00,,546.61,,"-202,167.41"
,IN,AR,30310183,1005,100,,Invoice,,,,,,12/03/2018,12/03/2018,0.00,,2.14,,"-202,169.55"
,IN,AR,30310225,1005,100,,Invoice,,,,,,12/03/2018,12/03/2018,0.00,,364.41,,"-202,533.96"
,IN,AR,30310299,1005,100,,Invoice,,,,,,12/03/2018,12/03/2018,0.00,,12.03,,"-202,545.99"
,IN,AR,30310358,1005,100,,Invoice,,,,,,12/03/2018,12/03/2018,0.00,,9.62,,"-202,555.61"
,IN,AR,30310399,1005,100,,Invoice,,,,,,12/03/2018,12/03/2018,0.00,,29.15,,"-202,584.76"
,IN,AR,30310421,1005,100,,Invoice,,,,,,12/03/2018,12/03/2018,0.00,,29.15,,"-202,613.91"
,IN,AR,30310436,1005,100,,Invoice,,,,,,12/03/2018,12/03/2018,0.00,,182.20,,"-202,796.11"
,IN,AR,30310437,1005,100,,Invoice,,,,,,12/03/2018,12/03/2018,0.00,,54.66,,"-202,850.77"
,IN,AR,30310439,1005,100,,Invoice,,,,,,12/03/2018,12/03/2018,0.00,,"1,093.22",,"-203,943.99"
,IN,AR,30310473,1005,100,,Invoice,,,,,,12/03/2018,12/03/2018,0.00,,16.01,,"-203,960.00"
,IN,AR,30310515,1005,100,,Invoice,,,,,,12/03/2018,12/03/2018,0.00,,33.19,,"-203,993.19"
,IN,AR,30310546,1005,100,,Invoice,,,,,,12/03/2018,12/03/2018,0.00,,182.20,,"-204,175.39"
,IN,AR,30310568,1005,100,,Invoice,,,,,,12/03/2018,12/03/2018,0.00,,158.47,,"-204,333.86"
,IN,AR,30310579,1005,100,,Invoice,,,,,,12/03/2018,12/03/2018,0.00,,16.83,,"-204,350.69"
,IN,AR,30310585,1005,100,,Invoice,,,,,,12/03/2018,12/03/2018,0.00,,29.15,,"-204,379.84"
,IN,AR,30310610,1005,100,,Invoice,,,,,,12/03/2018,12/03/2018,0.00,,182.20,,"-204,562.04"
,IN,AR,30310623,1005,100,,Invoice,,,,,,12/03/2018,12/03/2018,0.00,,6.13,,"-204,568.17"
,IN,AR,30310628,1005,100,,Invoice,,,,,,12/03/2018,12/03/2018,0.00,,11.64,,"-204,579.81"
,IN,AR,30310672,1005,100,,Invoice,,,,,,12/03/2018,12/03/2018,0.00,,26.69,,"-204,606.50"
,IN,AR,30310697,1005,100,,Invoice,,,,,,12/03/2018,12/03/2018,0.00,,17.53,,"-204,624.03"
,IN,AR,30310777,1005,100,,Invoice,,,,,,12/03/2018,12/03/2018,0.00,,54.66,,"-204,678.69"
,IN,AR,30310780,1005,100,,Invoice,,,,,,12/03/2018,12/03/2018,0.00,,54.66,,"-204,733.35"
,IN,AR,30310786,1005,100,,Invoice,,,,,,12/03/2018,12/03/2018,0.00,,12.00,,"-204,745.35"
,IN,AR,30310800,1005,100,,Invoice,,,,,,12/03/2018,12/03/2018,0.00,,1.88,,"-204,747.23"
,IN,AR,30310818,1005,100,,Invoice,,,,,,12/03/2018,12/03/2018,0.00,,29.15,,"-204,776.38"
,IN,AR,30310828,1005,100,,Invoice,,,,,,12/03/2018,12/03/2018,0.00,,29.15,,"-204,805.53"
,IN,AR,30310844,1005,100,,Invoice,,,,,,12/03/2018,12/03/2018,0.00,,54.66,,"-204,860.19"
,IN,AR,30310847,1005,100,,Invoice,,,,,,12/03/2018,12/03/2018,0.00,,54.66,,"-204,914.85"
,IN,AR,30310852,1005,100,,Invoice,,,,,,12/03/2018,12/03/2018,0.00,,29.15,,"-204,944.00"
,IN,AR,30310885,1005,100,,Invoice,,,,,,12/03/2018,12/03/2018,0.00,,29.15,,"-204,973.15"
,IN,AR,30310920,1005,100,,Invoice,,,,,,12/03/2018,12/03/2018,0.00,,4.08,,"-204,977.23"
,IN,AR,30310956,1005,100,,Invoice,,,,,,12/03/2018,12/03/2018,0.00,,29.15,,"-205,006.38"
,IN,AR,30311031,1005,100,,Invoice,,,,,,12/03/2018,12/03/2018,0.00,,29.15,,"-205,035.53"
,CN,AR,31017545,1005,100,,Credit Note,,,,,,13/03/2018,13/03/2018,7.75,,0.00,,"-205,027.78"
,CS,AR,32001722,1005,100,,Cash sale,,,,,,13/03/2018,13/03/2018,0.00,,7.29,,"-205,035.07"
,CS,AR,32001746,1005,100,,Cash sale,,,,,,13/03/2018,13/03/2018,0.00,,3.64,,"-205,038.71"
,CS,AR,32001756,1005,100,,Cash sale,,,,,,13/03/2018,13/03/2018,0.00,,7.29,,"-205,046.00"
,CS,AR,32001782,1005,100,,Cash sale,,,,,,13/03/2018,13/03/2018,0.00,,3.64,,"-205,049.64"
,CS,AR,32001797,1005,100,,Cash sale,,,,,,13/03/2018,13/03/2018,0.00,,6.02,,"-205,055.66"
,CS,AR,32001805,1005,100,,Cash sale,,,,,,13/03/2018,13/03/2018,0.00,,7.29,,"-205,062.95"
,CS,AR,32001814,1005,100,,Cash sale,,,,,,13/03/2018,13/03/2018,0.00,,7.29,,"-205,070.24"
,CS,AR,32001844,1005,100,,Cash sale,,,,,,13/03/2018,13/03/2018,0.00,,3.64,,"-205,073.88"
,CS,AR,32001862,1005,100,,Cash sale,,,,,,13/03/2018,13/03/2018,0.00,,14.58,,"-205,088.46"
,CS,AR,32001912,1005,100,,Cash sale,,,,,,13/03/2018,13/03/2018,0.00,,7.29,,"-205,095.75"
,CS,AR,32001923,1005,100,,Cash sale,,,,,,13/03/2018,13/03/2018,0.00,,2.16,,"-205,097.91"
,CS,AR,32001954,1005,100,,Cash sale,,,,,,13/03/2018,13/03/2018,0.00,,7.75,,"-205,105.66"
,CS,AR,32001975,1005,100,,Cash sale,,,,,,13/03/2018,13/03/2018,0.00,,14.58,,"-205,120.24"
,CS,AR,32002018,1005,100,,Cash sale,,,,,,13/03/2018,13/03/2018,0.00,,10.72,,"-205,130.96"
,CS,AR,32002035,1005,100,,Cash sale,,,,,,13/03/2018,13/03/2018,0.00,,18.05,,"-205,149.01"
,CS,AR,32002040,1005,100,,Cash sale,,,,,,13/03/2018,13/03/2018,0.00,,7.29,,"-205,156.30"
,CS,AR,32002062,1005,100,,Cash sale,,,,,,13/03/2018,13/03/2018,0.00,,4.32,,"-205,160.62"
,CS,AR,32002064,1005,100,,Cash sale,,,,,,13/03/2018,13/03/2018,0.00,,7.80,,"-205,168.42"
,CS,AR,32002084,1005,100,,Cash sale,,,,,,13/03/2018,13/03/2018,0.00,,5.85,,"-205,174.27"
,CS,AR,32002099,1005,100,,Cash sale,,,,,,13/03/2018,13/03/2018,0.00,,3.64,,"-205,177.91"
,CS,AR,32002120,1005,100,,Cash sale,,,,,,13/03/2018,13/03/2018,0.00,,10.34,,"-205,188.25"
,CS,AR,32002138,1005,100,,Cash sale,,,,,,13/03/2018,13/03/2018,0.00,,10.34,,"-205,198.59"
,CS,AR,32002142,1005,100,,Cash sale,,,,,,13/03/2018,13/03/2018,0.00,,18.22,,"-205,216.81"
,CS,AR,32002241,1005,100,,Cash sale,,,,,,13/03/2018,13/03/2018,0.00,,17.15,,"-205,233.96"
,CS,AR,32002309,1005,100,,Cash sale,,,,,,13/03/2018,13/03/2018,0.00,,18.22,,"-205,252.18"
,CS,AR,32002328,1005,100,,Cash sale,,,,,,13/03/2018,13/03/2018,0.00,,7.63,,"-205,259.81"
,CS,AR,32002332,1005,100,,Cash sale,,,,,,13/03/2018,13/03/2018,0.00,,26.00,,"-205,285.81"
,CS,AR,32002346,1005,100,,Cash sale,,,,,,13/03/2018,13/03/2018,0.00,,3.64,,"-205,289.45"
,CS,AR,32002349,1005,100,,Cash sale,,,,,,13/03/2018,13/03/2018,0.00,,7.29,,"-205,296.74"
,CS,AR,32002362,1005,100,,Cash sale,,,,,,13/03/2018,13/03/2018,0.00,,10.93,,"-205,307.67"
,CS,AR,32002393,1005,100,,Cash sale,,,,,,13/03/2018,13/03/2018,0.00,,5.93,,"-205,313.60"
,CS,AR,32002426,1005,100,,Cash sale,,,,,,13/03/2018,13/03/2018,0.00,,18.22,,"-205,331.82"
,CS,AR,32002441,1005,100,,Cash sale,,,,,,13/03/2018,13/03/2018,0.00,,10.93,,"-205,342.75"
,CS,AR,32002492,1005,100,,Cash sale,,,,,,13/03/2018,13/03/2018,0.00,,7.29,,"-205,350.04"
,CS,AR,32002522,1005,100,,Cash sale,,,,,,13/03/2018,13/03/2018,0.00,,14.58,,"-205,364.62"
,CS,AR,32002524,1005,100,,Cash sale,,,,,,13/03/2018,13/03/2018,0.00,,16.42,,"-205,381.04"
,CS,AR,32002580,1005,100,,Cash sale,,,,,,13/03/2018,13/03/2018,0.00,,14.58,,"-205,395.62"
,IN,AR,30308787,1005,100,,Invoice,,,,,,13/03/2018,13/03/2018,0.00,,3.01,,"-205,398.63"
,IN,AR,30308823,1005,100,,Invoice,,,,,,13/03/2018,13/03/2018,0.00,,14.03,,"-205,412.66"
,IN,AR,30308852,1005,100,,Invoice,,,,,,13/03/2018,13/03/2018,0.00,,10.93,,"-205,423.59"
,IN,AR,30308950,1005,100,,Invoice,,,,,,13/03/2018,13/03/2018,0.00,,56.95,,"-205,480.54"
,IN,AR,30308963,1005,100,,Invoice,,,,,,13/03/2018,13/03/2018,0.00,,18.22,,"-205,498.76"
,IN,AR,30308990,1005,100,,Invoice,,,,,,13/03/2018,13/03/2018,0.00,,18.22,,"-205,516.98"
,IN,AR,30309003,1005,100,,Invoice,,,,,,13/03/2018,13/03/2018,0.00,,29.15,,"-205,546.13"
,IN,AR,30309080,1005,100,,Invoice,,,,,,13/03/2018,13/03/2018,0.00,,18.22,,"-205,564.35"
,IN,AR,30309127,1005,100,,Invoice,,,,,,13/03/2018,13/03/2018,0.00,,10.93,,"-205,575.28"
,IN,AR,30309142,1005,100,,Invoice,,,,,,13/03/2018,13/03/2018,0.00,,21.86,,"-205,597.14"
,IN,AR,30309173,1005,100,,Invoice,,,,,,13/03/2018,13/03/2018,0.00,,90.81,,"-205,687.95"
,IN,AR,30309192,1005,100,,Invoice,,,,,,13/03/2018,13/03/2018,0.00,,10.99,,"-205,698.94"
,IN,AR,30309228,1005,100,,Invoice,,,,,,13/03/2018,13/03/2018,0.00,,3.64,,"-205,702.58"
,IN,AR,30309257,1005,100,,Invoice,,,,,,13/03/2018,13/03/2018,0.00,,10.93,,"-205,713.51"
,IN,AR,30309277,1005,100,,Invoice,,,,,,13/03/2018,13/03/2018,0.00,,41.19,,"-205,754.70"
,IN,AR,30309279,1005,100,,Invoice,,,,,,13/03/2018,13/03/2018,0.00,,29.15,,"-205,783.85"
,IN,AR,30309283,1005,100,,Invoice,,,,,,13/03/2018,13/03/2018,0.00,,4.64,,"-205,788.49"
,IN,AR,30309293,1005,100,,Invoice,,,,,,13/03/2018,13/03/2018,0.00,,7.19,,"-205,795.68"
,IN,AR,30309329,1005,100,,Invoice,,,,,,13/03/2018,13/03/2018,0.00,,10.59,,"-205,806.27"
,IN,AR,30309354,1005,100,,Invoice,,,,,,13/03/2018,13/03/2018,0.00,,10.59,,"-205,816.86"
,IN,AR,30309405,1005,100,,Invoice,,,,,,13/03/2018,13/03/2018,0.00,,15.04,,"-205,831.90"
,IN,AR,30309451,1005,100,,Invoice,,,,,,13/03/2018,13/03/2018,0.00,,9.43,,"-205,841.33"
,IN,AR,30309462,1005,100,,Invoice,,,,,,13/03/2018,13/03/2018,0.00,,4.78,,"-205,846.11"
,IN,AR,30309527,1005,100,,Invoice,,,,,,13/03/2018,13/03/2018,0.00,,24.51,,"-205,870.62"
,IN,AR,30309535,1005,100,,Invoice,,,,,,13/03/2018,13/03/2018,0.00,,12.92,,"-205,883.54"
,IN,AR,30309577,1005,100,,Invoice,,,,,,13/03/2018,13/03/2018,0.00,,3.90,,"-205,887.44"
,IN,AR,30309647,1005,100,,Invoice,,,,,,13/03/2018,13/03/2018,0.00,,10.17,,"-205,897.61"
,IN,AR,30309697,1005,100,,Invoice,,,,,,13/03/2018,13/03/2018,0.00,,7.29,,"-205,904.90"
,IN,AR,30309716,1005,100,,Invoice,,,,,,13/03/2018,13/03/2018,0.00,,56.95,,"-205,961.85"
,IN,AR,30309744,1005,100,,Invoice,,,,,,13/03/2018,13/03/2018,0.00,,11.57,,"-205,973.42"
,IN,AR,30309754,1005,100,,Invoice,,,,,,13/03/2018,13/03/2018,0.00,,10.17,,"-205,983.59"
,IN,AR,30309763,1005,100,,Invoice,,,,,,13/03/2018,13/03/2018,0.00,,10.53,,"-205,994.12"
,IN,AR,30309779,1005,100,,Invoice,,,,,,13/03/2018,13/03/2018,0.00,,14.58,,"-206,008.70"
,IN,AR,30309786,1005,100,,Invoice,,,,,,13/03/2018,13/03/2018,0.00,,10.59,,"-206,019.29"
,IN,AR,30309869,1005,100,,Invoice,,,,,,13/03/2018,13/03/2018,0.00,,14.58,,"-206,033.87"
,IN,AR,30309888,1005,100,,Invoice,,,,,,13/03/2018,13/03/2018,0.00,,7.75,,"-206,041.62"
,IN,AR,30309899,1005,100,,Invoice,,,,,,13/03/2018,13/03/2018,0.00,,22.68,,"-206,064.30"
,IN,AR,30309925,1005,100,,Invoice,,,,,,13/03/2018,13/03/2018,0.00,,19.30,,"-206,083.60"
,IN,AR,30309960,1005,100,,Invoice,,,,,,13/03/2018,13/03/2018,0.00,,2.75,,"-206,086.35"
,IN,AR,30309976,1005,100,,Invoice,,,,,,13/03/2018,13/03/2018,0.00,,5.86,,"-206,092.21"
,IN,AR,30309983,1005,100,,Invoice,,,,,,13/03/2018,13/03/2018,0.00,,8.52,,"-206,100.73"
,IN,AR,30310003,1005,100,,Invoice,,,,,,13/03/2018,13/03/2018,0.00,,29.15,,"-206,129.88"
,IN,AR,30310047,1005,100,,Invoice,,,,,,13/03/2018,13/03/2018,0.00,,10.93,,"-206,140.81"
,IN,AR,30310065,1005,100,,Invoice,,,,,,13/03/2018,13/03/2018,0.00,,32.16,,"-206,172.97"
,IN,AR,30310085,1005,100,,Invoice,,,,,,13/03/2018,13/03/2018,0.00,,3.53,,"-206,176.50"
,IN,AR,30310126,1005,100,,Invoice,,,,,,13/03/2018,13/03/2018,0.00,,63.56,,"-206,240.06"
,IN,AR,30310179,1005,100,,Invoice,,,,,,13/03/2018,13/03/2018,0.00,,7.29,,"-206,247.35"
,IN,AR,30310187,1005,100,,Invoice,,,,,,13/03/2018,13/03/2018,0.00,,11.36,,"-206,258.71"
,IN,AR,30310248,1005,100,,Invoice,,,,,,13/03/2018,13/03/2018,0.00,,23.85,,"-206,282.56"
,IN,AR,30310249,1005,100,,Invoice,,,,,,13/03/2018,13/03/2018,0.00,,4.77,,"-206,287.33"
,IN,AR,30310250,1005,100,,Invoice,,,,,,13/03/2018,13/03/2018,0.00,,14.31,,"-206,301.64"
,IN,AR,30310251,1005,100,,Invoice,,,,,,13/03/2018,13/03/2018,0.00,,255.99,,"-206,557.63"
,IN,AR,30310269,1005,100,,Invoice,,,,,,13/03/2018,13/03/2018,0.00,,36.91,,"-206,594.54"
,IN,AR,30310327,1005,100,,Invoice,,,,,,13/03/2018,13/03/2018,0.00,,15.04,,"-206,609.58"
,IN,AR,30310337,1005,100,,Invoice,,,,,,13/03/2018,13/03/2018,0.00,,176.01,,"-206,785.59"
,IN,AR,30310359,1005,100,,Invoice,,,,,,13/03/2018,13/03/2018,0.00,,8.02,,"-206,793.61"
,IN,AR,30310417,1005,100,,Invoice,,,,,,13/03/2018,13/03/2018,0.00,,10.93,,"-206,804.54"
,IN,AR,30310441,1005,100,,Invoice,,,,,,13/03/2018,13/03/2018,0.00,,10.93,,"-206,815.47"
,IN,AR,30310456,1005,100,,Invoice,,,,,,13/03/2018,13/03/2018,0.00,,22.88,,"-206,838.35"
,IN,AR,30310559,1005,100,,Invoice,,,,,,13/03/2018,13/03/2018,0.00,,7.29,,"-206,845.64"
,IN,AR,30310574,1005,100,,Invoice,,,,,,13/03/2018,13/03/2018,0.00,,5.47,,"-206,851.11"
,IN,AR,30310618,1005,100,,Invoice,,,,,,13/03/2018,13/03/2018,0.00,,15.17,,"-206,866.28"
,IN,AR,30310638,1005,100,,Invoice,,,,,,13/03/2018,13/03/2018,0.00,,23.73,,"-206,890.01"
,IN,AR,30310656,1005,100,,Invoice,,,,,,13/03/2018,13/03/2018,0.00,,5.08,,"-206,895.09"
,IN,AR,30310719,1005,100,,Invoice,,,,,,13/03/2018,13/03/2018,0.00,,100.34,,"-206,995.43"
,IN,AR,30310760,1005,100,,Invoice,,,,,,13/03/2018,13/03/2018,0.00,,28.47,,"-207,023.90"
,IN,AR,30310761,1005,100,,Invoice,,,,,,13/03/2018,13/03/2018,0.00,,26.10,,"-207,050.00"
,IN,AR,30310762,1005,100,,Invoice,,,,,,13/03/2018,13/03/2018,0.00,,102.04,,"-207,152.04"
,IN,AR,30310763,1005,100,,Invoice,,,,,,13/03/2018,13/03/2018,0.00,,4.75,,"-207,156.79"
,IN,AR,30310809,1005,100,,Invoice,,,,,,13/03/2018,13/03/2018,0.00,,3.51,,"-207,160.30"
,IN,AR,30310814,1005,100,,Invoice,,,,,,13/03/2018,13/03/2018,0.00,,6.00,,"-207,166.30"
,IN,AR,30310823,1005,100,,Invoice,,,,,,13/03/2018,13/03/2018,0.00,,121.02,,"-207,287.32"
,IN,AR,30310826,1005,100,,Invoice,,,,,,13/03/2018,13/03/2018,0.00,,14.58,,"-207,301.90"
,IN,AR,30310829,1005,100,,Invoice,,,,,,13/03/2018,13/03/2018,0.00,,29.15,,"-207,331.05"
,IN,AR,30310832,1005,100,,Invoice,,,,,,13/03/2018,13/03/2018,0.00,,18.22,,"-207,349.27"
,IN,AR,30310838,1005,100,,Invoice,,,,,,13/03/2018,13/03/2018,0.00,,8.77,,"-207,358.04"
,IN,AR,30310851,1005,100,,Invoice,,,,,,13/03/2018,13/03/2018,0.00,,29.15,,"-207,387.19"
,IN,AR,30310949,1005,100,,Invoice,,,,,,13/03/2018,13/03/2018,0.00,,182.20,,"-207,569.39"
,IN,AR,30311001,1005,100,,Invoice,,,,,,13/03/2018,13/03/2018,0.00,,4.83,,"-207,574.22"
,CS,AR,32001727,1005,100,,Cash sale,,,,,,14/03/2018,14/03/2018,0.00,,42.64,,"-207,616.86"
,CS,AR,32001765,1005,100,,Cash sale,,,,,,14/03/2018,14/03/2018,0.00,,7.29,,"-207,624.15"
,CS,AR,32001769,1005,100,,Cash sale,,,,,,14/03/2018,14/03/2018,0.00,,3.64,,"-207,627.79"
,CS,AR,32001789,1005,100,,Cash sale,,,,,,14/03/2018,14/03/2018,0.00,,3.64,,"-207,631.43"
,CS,AR,32001813,1005,100,,Cash sale,,,,,,14/03/2018,14/03/2018,0.00,,7.29,,"-207,638.72"
,CS,AR,32001890,1005,100,,Cash sale,,,,,,14/03/2018,14/03/2018,0.00,,8.78,,"-207,647.50"
,CS,AR,32002013,1005,100,,Cash sale,,,,,,14/03/2018,14/03/2018,0.00,,14.58,,"-207,662.08"
,CS,AR,32002023,1005,100,,Cash sale,,,,,,14/03/2018,14/03/2018,0.00,,10.34,,"-207,672.42"
,CS,AR,32002027,1005,100,,Cash sale,,,,,,14/03/2018,14/03/2018,0.00,,5.08,,"-207,677.50"
,CS,AR,32002056,1005,100,,Cash sale,,,,,,14/03/2018,14/03/2018,0.00,,13.60,,"-207,691.10"
,CS,AR,32002081,1005,100,,Cash sale,,,,,,14/03/2018,14/03/2018,0.00,,4.32,,"-207,695.42"
,CS,AR,32002153,1005,100,,Cash sale,,,,,,14/03/2018,14/03/2018,0.00,,3.64,,"-207,699.06"
,CS,AR,32002186,1005,100,,Cash sale,,,,,,14/03/2018,14/03/2018,0.00,,6.02,,"-207,705.08"
,CS,AR,32002220,1005,100,,Cash sale,,,,,,14/03/2018,14/03/2018,0.00,,5.17,,"-207,710.25"
,CS,AR,32002250,1005,100,,Cash sale,,,,,,14/03/2018,14/03/2018,0.00,,5.17,,"-207,715.42"
,CS,AR,32002315,1005,100,,Cash sale,,,,,,14/03/2018,14/03/2018,0.00,,10.93,,"-207,726.35"
,CS,AR,32002369,1005,100,,Cash sale,,,,,,14/03/2018,14/03/2018,0.00,,7.29,,"-207,733.64"
,CS,AR,32002376,1005,100,,Cash sale,,,,,,14/03/2018,14/03/2018,0.00,,11.44,,"-207,745.08"
,CS,AR,32002390,1005,100,,Cash sale,,,,,,14/03/2018,14/03/2018,0.00,,6.07,,"-207,751.15"
,CS,AR,32002430,1005,100,,Cash sale,,,,,,14/03/2018,14/03/2018,0.00,,15.04,,"-207,766.19"
,CS,AR,32002467,1005,100,,Cash sale,,,,,,14/03/2018,14/03/2018,0.00,,14.58,,"-207,780.77"
,CS,AR,32002483,1005,100,,Cash sale,,,,,,14/03/2018,14/03/2018,0.00,,9.10,,"-207,789.87"
,CS,AR,32002532,1005,100,,Cash sale,,,,,,14/03/2018,14/03/2018,0.00,,7.29,,"-207,797.16"
,CS,AR,32002544,1005,100,,Cash sale,,,,,,14/03/2018,14/03/2018,0.00,,10.93,,"-207,808.09"
,CS,AR,32002554,1005,100,,Cash sale,,,,,,14/03/2018,14/03/2018,0.00,,10.99,,"-207,819.08"
,IN,AR,30308790,1005,100,,Invoice,,,,,,14/03/2018,14/03/2018,0.00,,84.54,,"-207,903.62"
,IN,AR,30308839,1005,100,,Invoice,,,,,,14/03/2018,14/03/2018,0.00,,78.10,,"-207,981.72"
,IN,AR,30308840,1005,100,,Invoice,,,,,,14/03/2018,14/03/2018,0.00,,17.08,,"-207,998.80"
,IN,AR,30308857,1005,100,,Invoice,,,,,,14/03/2018,14/03/2018,0.00,,8.52,,"-208,007.32"
,IN,AR,30308859,1005,100,,Invoice,,,,,,14/03/2018,14/03/2018,0.00,,14.58,,"-208,021.90"
,IN,AR,30308862,1005,100,,Invoice,,,,,,14/03/2018,14/03/2018,0.00,,27.88,,"-208,049.78"
,IN,AR,30308869,1005,100,,Invoice,,,,,,14/03/2018,14/03/2018,0.00,,76.19,,"-208,125.97"
,IN,AR,30308870,1005,100,,Invoice,,,,,,14/03/2018,14/03/2018,0.00,,23.64,,"-208,149.61"
,IN,AR,30308951,1005,100,,Invoice,,,,,,14/03/2018,14/03/2018,0.00,,56.95,,"-208,206.56"
,IN,AR,30308980,1005,100,,Invoice,,,,,,14/03/2018,14/03/2018,0.00,,38.00,,"-208,244.56"
,IN,AR,30309014,1005,100,,Invoice,,,,,,14/03/2018,14/03/2018,0.00,,43.73,,"-208,288.29"
,IN,AR,30309017,1005,100,,Invoice,,,,,,14/03/2018,14/03/2018,0.00,,7.29,,"-208,295.58"
,IN,AR,30309041,1005,100,,Invoice,,,,,,14/03/2018,14/03/2018,0.00,,30.00,,"-208,325.58"
,IN,AR,30309072,1005,100,,Invoice,,,,,,14/03/2018,14/03/2018,0.00,,7.29,,"-208,332.87"
,IN,AR,30309089,1005,100,,Invoice,,,,,,14/03/2018,14/03/2018,0.00,,26.00,,"-208,358.87"
,IN,AR,30309098,1005,100,,Invoice,,,,,,14/03/2018,14/03/2018,0.00,,10.93,,"-208,369.80"
,IN,AR,30309102,1005,100,,Invoice,,,,,,14/03/2018,14/03/2018,0.00,,83.05,,"-208,452.85"
,IN,AR,30309151,1005,100,,Invoice,,,,,,14/03/2018,14/03/2018,0.00,,95.51,,"-208,548.36"
,IN,AR,30309152,1005,100,,Invoice,,,,,,14/03/2018,14/03/2018,0.00,,103.69,,"-208,652.05"
,IN,AR,30309211,1005,100,,Invoice,,,,,,14/03/2018,14/03/2018,0.00,,6.44,,"-208,658.49"
,IN,AR,30309219,1005,100,,Invoice,,,,,,14/03/2018,14/03/2018,0.00,,23.87,,"-208,682.36"
,IN,AR,30309232,1005,100,,Invoice,,,,,,14/03/2018,14/03/2018,0.00,,10.93,,"-208,693.29"
,IN,AR,30309259,1005,100,,Invoice,,,,,,14/03/2018,14/03/2018,0.00,,3.64,,"-208,696.93"
,IN,AR,30309335,1005,100,,Invoice,,,,,,14/03/2018,14/03/2018,0.00,,4.24,,"-208,701.17"
,IN,AR,30309356,1005,100,,Invoice,,,,,,14/03/2018,14/03/2018,0.00,,11.19,,"-208,712.36"
,IN,AR,30309388,1005,100,,Invoice,,,,,,14/03/2018,14/03/2018,0.00,,29.15,,"-208,741.51"
,IN,AR,30309394,1005,100,,Invoice,,,,,,14/03/2018,14/03/2018,0.00,,10.93,,"-208,752.44"
,IN,AR,30309412,1005,100,,Invoice,,,,,,14/03/2018,14/03/2018,0.00,,14.34,,"-208,766.78"
,IN,AR,30309431,1005,100,,Invoice,,,,,,14/03/2018,14/03/2018,0.00,,47.17,,"-208,813.95"
,IN,AR,30309443,1005,100,,Invoice,,,,,,14/03/2018,14/03/2018,0.00,,91.53,,"-208,905.48"
,IN,AR,30309444,1005,100,,Invoice,,,,,,14/03/2018,14/03/2018,0.00,,33.05,,"-208,938.53"
,IN,AR,30309519,1005,100,,Invoice,,,,,,14/03/2018,14/03/2018,0.00,,12.92,,"-208,951.45"
,IN,AR,30309538,1005,100,,Invoice,,,,,,14/03/2018,14/03/2018,0.00,,144.04,,"-209,095.49"
,IN,AR,30309587,1005,100,,Invoice,,,,,,14/03/2018,14/03/2018,0.00,,5.08,,"-209,100.57"
,IN,AR,30309616,1005,100,,Invoice,,,,,,14/03/2018,14/03/2018,0.00,,1.59,,"-209,102.16"
,IN,AR,30309643,1005,100,,Invoice,,,,,,14/03/2018,14/03/2018,0.00,,8.47,,"-209,110.63"
,IN,AR,30309712,1005,100,,Invoice,,,,,,14/03/2018,14/03/2018,0.00,,18.17,,"-209,128.80"
,IN,AR,30309730,1005,100,,Invoice,,,,,,14/03/2018,14/03/2018,0.00,,30.00,,"-209,158.80"
,IN,AR,30309755,1005,100,,Invoice,,,,,,14/03/2018,14/03/2018,0.00,,5.08,,"-209,163.88"
,IN,AR,30309760,1005,100,,Invoice,,,,,,14/03/2018,14/03/2018,0.00,,14.58,,"-209,178.46"
,IN,AR,30309820,1005,100,,Invoice,,,,,,14/03/2018,14/03/2018,0.00,,8.17,,"-209,186.63"
,IN,AR,30309836,1005,100,,Invoice,,,,,,14/03/2018,14/03/2018,0.00,,25.25,,"-209,211.88"
,IN,AR,30309849,1005,100,,Invoice,,,,,,14/03/2018,14/03/2018,0.00,,14.83,,"-209,226.71"
,IN,AR,30309855,1005,100,,Invoice,,,,,,14/03/2018,14/03/2018,0.00,,18.31,,"-209,245.02"
,IN,AR,30309884,1005,100,,Invoice,,,,,,14/03/2018,14/03/2018,0.00,,3.64,,"-209,248.66"
,IN,AR,30309887,1005,100,,Invoice,,,,,,14/03/2018,14/03/2018,0.00,,1.88,,"-209,250.54"
,IN,AR,30309896,1005,100,,Invoice,,,,,,14/03/2018,14/03/2018,0.00,,10.93,,"-209,261.47"
,IN,AR,30309905,1005,100,,Invoice,,,,,,14/03/2018,14/03/2018,0.00,,50.34,,"-209,311.81"
,IN,AR,30309999,1005,100,,Invoice,,,,,,14/03/2018,14/03/2018,0.00,,7.29,,"-209,319.10"
,IN,AR,30310006,1005,100,,Invoice,,,,,,14/03/2018,14/03/2018,0.00,,24.07,,"-209,343.17"
,IN,AR,30310011,1005,100,,Invoice,,,,,,14/03/2018,14/03/2018,0.00,,6.02,,"-209,349.19"
,IN,AR,30310028,1005,100,,Invoice,,,,,,14/03/2018,14/03/2018,0.00,,62.29,,"-209,411.48"
,IN,AR,30310061,1005,100,,Invoice,,,,,,14/03/2018,14/03/2018,0.00,,7.29,,"-209,418.77"
,IN,AR,30310070,1005,100,,Invoice,,,,,,14/03/2018,14/03/2018,0.00,,10.68,,"-209,429.45"
,IN,AR,30310086,1005,100,,Invoice,,,,,,14/03/2018,14/03/2018,0.00,,1.76,,"-209,431.21"
,IN,AR,30310087,1005,100,,Invoice,,,,,,14/03/2018,14/03/2018,0.00,,8.81,,"-209,440.02"
,IN,AR,30310096,1005,100,,Invoice,,,,,,14/03/2018,14/03/2018,0.00,,9.03,,"-209,449.05"
,IN,AR,30310118,1005,100,,Invoice,,,,,,14/03/2018,14/03/2018,0.00,,21.86,,"-209,470.91"
,IN,AR,30310130,1005,100,,Invoice,,,,,,14/03/2018,14/03/2018,0.00,,21.90,,"-209,492.81"
,IN,AR,30310136,1005,100,,Invoice,,,,,,14/03/2018,14/03/2018,0.00,,18.09,,"-209,510.90"
,IN,AR,30310145,1005,100,,Invoice,,,,,,14/03/2018,14/03/2018,0.00,,10.93,,"-209,521.83"
,IN,AR,30310149,1005,100,,Invoice,,,,,,14/03/2018,14/03/2018,0.00,,15.71,,"-209,537.54"
,IN,AR,30310221,1005,100,,Invoice,,,,,,14/03/2018,14/03/2018,0.00,,7.29,,"-209,544.83"
,IN,AR,30310277,1005,100,,Invoice,,,,,,14/03/2018,14/03/2018,0.00,,36.00,,"-209,580.83"
,IN,AR,30310290,1005,100,,Invoice,,,,,,14/03/2018,14/03/2018,0.00,,10.93,,"-209,591.76"
,IN,AR,30310324,1005,100,,Invoice,,,,,,14/03/2018,14/03/2018,0.00,,3.64,,"-209,595.40"
,IN,AR,30310341,1005,100,,Invoice,,,,,,14/03/2018,14/03/2018,0.00,,7.29,,"-209,602.69"
,IN,AR,30310360,1005,100,,Invoice,,,,,,14/03/2018,14/03/2018,0.00,,9.62,,"-209,612.31"
,IN,AR,30310361,1005,100,,Invoice,,,,,,14/03/2018,14/03/2018,0.00,,16.03,,"-209,628.34"
,IN,AR,30310362,1005,100,,Invoice,,,,,,14/03/2018,14/03/2018,0.00,,8.02,,"-209,636.36"
,IN,AR,30310363,1005,100,,Invoice,,,,,,14/03/2018,14/03/2018,0.00,,3.20,,"-209,639.56"
,IN,AR,30310364,1005,100,,Invoice,,,,,,14/03/2018,14/03/2018,0.00,,4.81,,"-209,644.37"
,IN,AR,30310415,1005,100,,Invoice,,,,,,14/03/2018,14/03/2018,0.00,,9.84,,"-209,654.21"
,IN,AR,30310425,1005,100,,Invoice,,,,,,14/03/2018,14/03/2018,0.00,,38.81,,"-209,693.02"
,IN,AR,30310477,1005,100,,Invoice,,,,,,14/03/2018,14/03/2018,0.00,,18.01,,"-209,711.03"
,IN,AR,30310487,1005,100,,Invoice,,,,,,14/03/2018,14/03/2018,0.00,,22.01,,"-209,733.04"
,IN,AR,30310509,1005,100,,Invoice,,,,,,14/03/2018,14/03/2018,0.00,,79.49,,"-209,812.53"
,IN,AR,30310516,1005,100,,Invoice,,,,,,14/03/2018,14/03/2018,0.00,,4.53,,"-209,817.06"
,IN,AR,30310540,1005,100,,Invoice,,,,,,14/03/2018,14/03/2018,0.00,,21.03,,"-209,838.09"
,IN,AR,30310549,1005,100,,Invoice,,,,,,14/03/2018,14/03/2018,0.00,,29.87,,"-209,867.96"
,IN,AR,30310565,1005,100,,Invoice,,,,,,14/03/2018,14/03/2018,0.00,,53.15,,"-209,921.11"
,IN,AR,30310608,1005,100,,Invoice,,,,,,14/03/2018,14/03/2018,0.00,,9.64,,"-209,930.75"
,IN,AR,30310612,1005,100,,Invoice,,,,,,14/03/2018,14/03/2018,0.00,,112.00,,"-210,042.75"
,IN,AR,30310658,1005,100,,Invoice,,,,,,14/03/2018,14/03/2018,0.00,,9.10,,"-210,051.85"
,IN,AR,30310677,1005,100,,Invoice,,,,,,14/03/2018,14/03/2018,0.00,,81.15,,"-210,133.00"
,IN,AR,30310699,1005,100,,Invoice,,,,,,14/03/2018,14/03/2018,0.00,,4.78,,"-210,137.78"
,IN,AR,30310781,1005,100,,Invoice,,,,,,14/03/2018,14/03/2018,0.00,,5.49,,"-210,143.27"
,IN,AR,30310805,1005,100,,Invoice,,,,,,14/03/2018,14/03/2018,0.00,,5.26,,"-210,148.53"
,IN,AR,30310871,1005,100,,Invoice,,,,,,14/03/2018,14/03/2018,0.00,,7.53,,"-210,156.06"
,IN,AR,30310912,1005,100,,Invoice,,,,,,14/03/2018,14/03/2018,0.00,,11.19,,"-210,167.25"
,IN,AR,30310950,1005,100,,Invoice,,,,,,14/03/2018,14/03/2018,0.00,,10.93,,"-210,178.18"
,IN,AR,30310970,1005,100,,Invoice,,,,,,14/03/2018,14/03/2018,0.00,,18.22,,"-210,196.40"
,IN,AR,30311033,1005,100,,Invoice,,,,,,14/03/2018,14/03/2018,0.00,,18.22,,"-210,214.62"
,IN,AR,30311035,1005,100,,Invoice,,,,,,14/03/2018,14/03/2018,0.00,,7.29,,"-210,221.91"
,IN,AR,30311045,1005,100,,Invoice,,,,,,14/03/2018,14/03/2018,0.00,,29.15,,"-210,251.06"
,IN,AR,30311046,1005,100,,Invoice,,,,,,14/03/2018,14/03/2018,0.00,,29.15,,"-210,280.21"
,CS,AR,32001706,1005,100,,Cash sale,,,,,,15/03/2018,15/03/2018,0.00,,21.06,,"-210,301.27"
,CS,AR,32001751,1005,100,,Cash sale,,,,,,15/03/2018,15/03/2018,0.00,,3.64,,"-210,304.91"
,CS,AR,32001767,1005,100,,Cash sale,,,,,,15/03/2018,15/03/2018,0.00,,21.86,,"-210,326.77"
,CS,AR,32001784,1005,100,,Cash sale,,,,,,15/03/2018,15/03/2018,0.00,,3.64,,"-210,330.41"
,CS,AR,32001802,1005,100,,Cash sale,,,,,,15/03/2018,15/03/2018,0.00,,3.64,,"-210,334.05"
,CS,AR,32001830,1005,100,,Cash sale,,,,,,15/03/2018,15/03/2018,0.00,,3.64,,"-210,337.69"
,CS,AR,32001848,1005,100,,Cash sale,,,,,,15/03/2018,15/03/2018,0.00,,3.64,,"-210,341.33"
,CS,AR,32001894,1005,100,,Cash sale,,,,,,15/03/2018,15/03/2018,0.00,,7.29,,"-210,348.62"
,CS,AR,32001911,1005,100,,Cash sale,,,,,,15/03/2018,15/03/2018,0.00,,10.34,,"-210,358.96"
,CS,AR,32001940,1005,100,,Cash sale,,,,,,15/03/2018,15/03/2018,0.00,,2.58,,"-210,361.54"
,CS,AR,32001960,1005,100,,Cash sale,,,,,,15/03/2018,15/03/2018,0.00,,20.68,,"-210,382.22"
,CS,AR,32001973,1005,100,,Cash sale,,,,,,15/03/2018,15/03/2018,0.00,,14.58,,"-210,396.80"
,CS,AR,32002020,1005,100,,Cash sale,,,,,,15/03/2018,15/03/2018,0.00,,10.93,,"-210,407.73"
,CS,AR,32002080,1005,100,,Cash sale,,,,,,15/03/2018,15/03/2018,0.00,,8.47,,"-210,416.20"
,CS,AR,32002097,1005,100,,Cash sale,,,,,,15/03/2018,15/03/2018,0.00,,7.29,,"-210,423.49"
,CS,AR,32002125,1005,100,,Cash sale,,,,,,15/03/2018,15/03/2018,0.00,,3.64,,"-210,427.13"
,CS,AR,32002158,1005,100,,Cash sale,,,,,,15/03/2018,15/03/2018,0.00,,7.75,,"-210,434.88"
,CS,AR,32002191,1005,100,,Cash sale,,,,,,15/03/2018,15/03/2018,0.00,,6.44,,"-210,441.32"
,CS,AR,32002221,1005,100,,Cash sale,,,,,,15/03/2018,15/03/2018,0.00,,7.29,,"-210,448.61"
,CS,AR,32002227,1005,100,,Cash sale,,,,,,15/03/2018,15/03/2018,0.00,,12.17,,"-210,460.78"
,CS,AR,32002269,1005,100,,Cash sale,,,,,,15/03/2018,15/03/2018,0.00,,3.64,,"-210,464.42"
,CS,AR,32002276,1005,100,,Cash sale,,,,,,15/03/2018,15/03/2018,0.00,,7.86,,"-210,472.28"
,CS,AR,32002281,1005,100,,Cash sale,,,,,,15/03/2018,15/03/2018,0.00,,22.88,,"-210,495.16"
,CS,AR,32002306,1005,100,,Cash sale,,,,,,15/03/2018,15/03/2018,0.00,,2.58,,"-210,497.74"
,CS,AR,32002319,1005,100,,Cash sale,,,,,,15/03/2018,15/03/2018,0.00,,25.51,,"-210,523.25"
,CS,AR,32002323,1005,100,,Cash sale,,,,,,15/03/2018,15/03/2018,0.00,,7.29,,"-210,530.54"
,CS,AR,32002352,1005,100,,Cash sale,,,,,,15/03/2018,15/03/2018,0.00,,2.97,,"-210,533.51"
,CS,AR,32002357,1005,100,,Cash sale,,,,,,15/03/2018,15/03/2018,0.00,,12.14,,"-210,545.65"
,CS,AR,32002411,1005,100,,Cash sale,,,,,,15/03/2018,15/03/2018,0.00,,12.14,,"-210,557.79"
,CS,AR,32002473,1005,100,,Cash sale,,,,,,15/03/2018,15/03/2018,0.00,,9.15,,"-210,566.94"
,CS,AR,32002519,1005,100,,Cash sale,,,,,,15/03/2018,15/03/2018,0.00,,3.64,,"-210,570.58"
,CS,AR,32002552,1005,100,,Cash sale,,,,,,15/03/2018,15/03/2018,0.00,,10.93,,"-210,581.51"
,CS,AR,32002584,1005,100,,Cash sale,,,,,,15/03/2018,15/03/2018,0.00,,3.64,,"-210,585.15"
,IN,AR,30308799,1005,100,,Invoice,,,,,,15/03/2018,15/03/2018,0.00,,11.86,,"-210,597.01"
,IN,AR,30308814,1005,100,,Invoice,,,,,,15/03/2018,15/03/2018,0.00,,7.29,,"-210,604.30"
,IN,AR,30308917,1005,100,,Invoice,,,,,,15/03/2018,15/03/2018,0.00,,40.08,,"-210,644.38"
,IN,AR,30308937,1005,100,,Invoice,,,,,,15/03/2018,15/03/2018,0.00,,3.98,,"-210,648.36"
,IN,AR,30308952,1005,100,,Invoice,,,,,,15/03/2018,15/03/2018,0.00,,52.20,,"-210,700.56"
,IN,AR,30308967,1005,100,,Invoice,,,,,,15/03/2018,15/03/2018,0.00,,7.29,,"-210,707.85"
,IN,AR,30308995,1005,100,,Invoice,,,,,,15/03/2018,15/03/2018,0.00,,54.66,,"-210,762.51"
,IN,AR,30309011,1005,100,,Invoice,,,,,,15/03/2018,15/03/2018,0.00,,3.64,,"-210,766.15"
,IN,AR,30309013,1005,100,,Invoice,,,,,,15/03/2018,15/03/2018,0.00,,3.64,,"-210,769.79"
,IN,AR,30309028,1005,100,,Invoice,,,,,,15/03/2018,15/03/2018,0.00,,14.58,,"-210,784.37"
,IN,AR,30309076,1005,100,,Invoice,,,,,,15/03/2018,15/03/2018,0.00,,7.29,,"-210,791.66"
,IN,AR,30309136,1005,100,,Invoice,,,,,,15/03/2018,15/03/2018,0.00,,35.69,,"-210,827.35"
,IN,AR,30309148,1005,100,,Invoice,,,,,,15/03/2018,15/03/2018,0.00,,22.71,,"-210,850.06"
,IN,AR,30309185,1005,100,,Invoice,,,,,,15/03/2018,15/03/2018,0.00,,62.00,,"-210,912.06"
,IN,AR,30309190,1005,100,,Invoice,,,,,,15/03/2018,15/03/2018,0.00,,14.58,,"-210,926.64"
,IN,AR,30309200,1005,100,,Invoice,,,,,,15/03/2018,15/03/2018,0.00,,65.59,,"-210,992.23"
,IN,AR,30309247,1005,100,,Invoice,,,,,,15/03/2018,15/03/2018,0.00,,21.86,,"-211,014.09"
,IN,AR,30309255,1005,100,,Invoice,,,,,,15/03/2018,15/03/2018,0.00,,14.58,,"-211,028.67"
,IN,AR,30309262,1005,100,,Invoice,,,,,,15/03/2018,15/03/2018,0.00,,17.50,,"-211,046.17"
,IN,AR,30309289,1005,100,,Invoice,,,,,,15/03/2018,15/03/2018,0.00,,6.02,,"-211,052.19"
,IN,AR,30309291,1005,100,,Invoice,,,,,,15/03/2018,15/03/2018,0.00,,7.29,,"-211,059.48"
,IN,AR,30309325,1005,100,,Invoice,,,,,,15/03/2018,15/03/2018,0.00,,12.03,,"-211,071.51"
,IN,AR,30309423,1005,100,,Invoice,,,,,,15/03/2018,15/03/2018,0.00,,15.25,,"-211,086.76"
,IN,AR,30309482,1005,100,,Invoice,,,,,,15/03/2018,15/03/2018,0.00,,6.44,,"-211,093.20"
,IN,AR,30309588,1005,100,,Invoice,,,,,,15/03/2018,15/03/2018,0.00,,7.63,,"-211,100.83"
,IN,AR,30309589,1005,100,,Invoice,,,,,,15/03/2018,15/03/2018,0.00,,7.63,,"-211,108.46"
,IN,AR,30309617,1005,100,,Invoice,,,,,,15/03/2018,15/03/2018,0.00,,66.92,,"-211,175.38"
,IN,AR,30309618,1005,100,,Invoice,,,,,,15/03/2018,15/03/2018,0.00,,38.24,,"-211,213.62"
,IN,AR,30309628,1005,100,,Invoice,,,,,,15/03/2018,15/03/2018,0.00,,25.75,,"-211,239.37"
,IN,AR,30309702,1005,100,,Invoice,,,,,,15/03/2018,15/03/2018,0.00,,18.22,,"-211,257.59"
,IN,AR,30309741,1005,100,,Invoice,,,,,,15/03/2018,15/03/2018,0.00,,3.64,,"-211,261.23"
,IN,AR,30309792,1005,100,,Invoice,,,,,,15/03/2018,15/03/2018,0.00,,10.93,,"-211,272.16"
,IN,AR,30309825,1005,100,,Invoice,,,,,,15/03/2018,15/03/2018,0.00,,19.22,,"-211,291.38"
,IN,AR,30309856,1005,100,,Invoice,,,,,,15/03/2018,15/03/2018,0.00,,9.15,,"-211,300.53"
,IN,AR,30309914,1005,100,,Invoice,,,,,,15/03/2018,15/03/2018,0.00,,10.17,,"-211,310.70"
,IN,AR,30309938,1005,100,,Invoice,,,,,,15/03/2018,15/03/2018,0.00,,6.97,,"-211,317.67"
,IN,AR,30309946,1005,100,,Invoice,,,,,,15/03/2018,15/03/2018,0.00,,5.85,,"-211,323.52"
,IN,AR,30309950,1005,100,,Invoice,,,,,,15/03/2018,15/03/2018,0.00,,14.58,,"-211,338.10"
,IN,AR,30309957,1005,100,,Invoice,,,,,,15/03/2018,15/03/2018,0.00,,7.29,,"-211,345.39"
,IN,AR,30309961,1005,100,,Invoice,,,,,,15/03/2018,15/03/2018,0.00,,13.77,,"-211,359.16"
,IN,AR,30309986,1005,100,,Invoice,,,,,,15/03/2018,15/03/2018,0.00,,74.24,,"-211,433.40"
,IN,AR,30310001,1005,100,,Invoice,,,,,,15/03/2018,15/03/2018,0.00,,11.23,,"-211,444.63"
,IN,AR,30310019,1005,100,,Invoice,,,,,,15/03/2018,15/03/2018,0.00,,15.17,,"-211,459.80"
,IN,AR,30310034,1005,100,,Invoice,,,,,,15/03/2018,15/03/2018,0.00,,13.58,,"-211,473.38"
,IN,AR,30310039,1005,100,,Invoice,,,,,,15/03/2018,15/03/2018,0.00,,10.17,,"-211,483.55"
,IN,AR,30310056,1005,100,,Invoice,,,,,,15/03/2018,15/03/2018,0.00,,20.01,,"-211,503.56"
,IN,AR,30310104,1005,100,,Invoice,,,,,,15/03/2018,15/03/2018,0.00,,18.22,,"-211,521.78"
,IN,AR,30310162,1005,100,,Invoice,,,,,,15/03/2018,15/03/2018,0.00,,21.86,,"-211,543.64"
,IN,AR,30310163,1005,100,,Invoice,,,,,,15/03/2018,15/03/2018,0.00,,29.15,,"-211,572.79"
,IN,AR,30310211,1005,100,,Invoice,,,,,,15/03/2018,15/03/2018,0.00,,10.93,,"-211,583.72"
,IN,AR,30310214,1005,100,,Invoice,,,,,,15/03/2018,15/03/2018,0.00,,10.17,,"-211,593.89"
,IN,AR,30310235,1005,100,,Invoice,,,,,,15/03/2018,15/03/2018,0.00,,8.14,,"-211,602.03"
,IN,AR,30310236,1005,100,,Invoice,,,,,,15/03/2018,15/03/2018,0.00,,11.39,,"-211,613.42"
,IN,AR,30310237,1005,100,,Invoice,,,,,,15/03/2018,15/03/2018,0.00,,24.41,,"-211,637.83"
,IN,AR,30310238,1005,100,,Invoice,,,,,,15/03/2018,15/03/2018,0.00,,3.25,,"-211,641.08"
,IN,AR,30310252,1005,100,,Invoice,,,,,,15/03/2018,15/03/2018,0.00,,33.39,,"-211,674.47"
,IN,AR,30310285,1005,100,,Invoice,,,,,,15/03/2018,15/03/2018,0.00,,26.19,,"-211,700.66"
,IN,AR,30310333,1005,100,,Invoice,,,,,,15/03/2018,15/03/2018,0.00,,38.90,,"-211,739.56"
,IN,AR,30310365,1005,100,,Invoice,,,,,,15/03/2018,15/03/2018,0.00,,9.62,,"-211,749.18"
,IN,AR,30310366,1005,100,,Invoice,,,,,,15/03/2018,15/03/2018,0.00,,6.42,,"-211,755.60"
,IN,AR,30310422,1005,100,,Invoice,,,,,,15/03/2018,15/03/2018,0.00,,18.21,,"-211,773.81"
,IN,AR,30310428,1005,100,,Invoice,,,,,,15/03/2018,15/03/2018,0.00,,25.51,,"-211,799.32"
,IN,AR,30310442,1005,100,,Invoice,,,,,,15/03/2018,15/03/2018,0.00,,8.90,,"-211,808.22"
,IN,AR,30310457,1005,100,,Invoice,,,,,,15/03/2018,15/03/2018,0.00,,2.54,,"-211,810.76"
,IN,AR,30310469,1005,100,,Invoice,,,,,,15/03/2018,15/03/2018,0.00,,16.01,,"-211,826.77"
,IN,AR,30310498,1005,100,,Invoice,,,,,,15/03/2018,15/03/2018,0.00,,11.66,,"-211,838.43"
,IN,AR,30310499,1005,100,,Invoice,,,,,,15/03/2018,15/03/2018,0.00,,11.66,,"-211,850.09"
,IN,AR,30310531,1005,100,,Invoice,,,,,,15/03/2018,15/03/2018,0.00,,54.66,,"-211,904.75"
,IN,AR,30310580,1005,100,,Invoice,,,,,,15/03/2018,15/03/2018,0.00,,14.03,,"-211,918.78"
,IN,AR,30310597,1005,100,,Invoice,,,,,,15/03/2018,15/03/2018,0.00,,5.68,,"-211,924.46"
,IN,AR,30310670,1005,100,,Invoice,,,,,,15/03/2018,15/03/2018,0.00,,14.58,,"-211,939.04"
,IN,AR,30310700,1005,100,,Invoice,,,,,,15/03/2018,15/03/2018,0.00,,9.56,,"-211,948.60"
,IN,AR,30310701,1005,100,,Invoice,,,,,,15/03/2018,15/03/2018,0.00,,121.08,,"-212,069.68"
,IN,AR,30310702,1005,100,,Invoice,,,,,,15/03/2018,15/03/2018,0.00,,9.56,,"-212,079.24"
,IN,AR,30310703,1005,100,,Invoice,,,,,,15/03/2018,15/03/2018,0.00,,12.75,,"-212,091.99"
,IN,AR,30310772,1005,100,,Invoice,,,,,,15/03/2018,15/03/2018,0.00,,18.31,,"-212,110.30"
,IN,AR,30310820,1005,100,,Invoice,,,,,,15/03/2018,15/03/2018,0.00,,11.36,,"-212,121.66"
,IN,AR,30310957,1005,100,,Invoice,,,,,,15/03/2018,15/03/2018,0.00,,14.58,,"-212,136.24"
,IN,AR,30310975,1005,100,,Invoice,,,,,,15/03/2018,15/03/2018,0.00,,15.93,,"-212,152.17"
,IN,AR,30311054,1005,100,,Invoice,,,,,,15/03/2018,15/03/2018,0.00,,7.29,,"-212,159.46"
,CN,AR,31017526,1005,100,,Credit Note,,,,,,16/03/2018,16/03/2018,7.29,,0.00,,"-212,152.17"
,CN,AR,31017527,1005,100,,Credit Note,,,,,,16/03/2018,16/03/2018,7.29,,0.00,,"-212,144.88"
,CN,AR,31017634,1005,100,,Credit Note,,,,,,16/03/2018,16/03/2018,12.14,,0.00,,"-212,132.74"
,CS,AR,32001711,1005,100,,Cash sale,,,,,,16/03/2018,16/03/2018,0.00,,16.83,,"-212,149.57"
,CS,AR,32001719,1005,100,,Cash sale,,,,,,16/03/2018,16/03/2018,0.00,,13.98,,"-212,163.55"
,CS,AR,32001809,1005,100,,Cash sale,,,,,,16/03/2018,16/03/2018,0.00,,21.36,,"-212,184.91"
,CS,AR,32001824,1005,100,,Cash sale,,,,,,16/03/2018,16/03/2018,0.00,,16.61,,"-212,201.52"
,CS,AR,32001837,1005,100,,Cash sale,,,,,,16/03/2018,16/03/2018,0.00,,3.64,,"-212,205.16"
,CS,AR,32001842,1005,100,,Cash sale,,,,,,16/03/2018,16/03/2018,0.00,,6.02,,"-212,211.18"
,CS,AR,32001927,1005,100,,Cash sale,,,,,,16/03/2018,16/03/2018,0.00,,10.93,,"-212,222.11"
,CS,AR,32001932,1005,100,,Cash sale,,,,,,16/03/2018,16/03/2018,0.00,,36.44,,"-212,258.55"
,CS,AR,32001946,1005,100,,Cash sale,,,,,,16/03/2018,16/03/2018,0.00,,12.71,,"-212,271.26"
,CS,AR,32001951,1005,100,,Cash sale,,,,,,16/03/2018,16/03/2018,0.00,,8.39,,"-212,279.65"
,CS,AR,32001971,1005,100,,Cash sale,,,,,,16/03/2018,16/03/2018,0.00,,30.22,,"-212,309.87"
,CS,AR,32001986,1005,100,,Cash sale,,,,,,16/03/2018,16/03/2018,0.00,,16.48,,"-212,326.35"
,CS,AR,32001991,1005,100,,Cash sale,,,,,,16/03/2018,16/03/2018,0.00,,18.05,,"-212,344.40"
,CS,AR,32001994,1005,100,,Cash sale,,,,,,16/03/2018,16/03/2018,0.00,,10.72,,"-212,355.12"
,CS,AR,32002005,1005,100,,Cash sale,,,,,,16/03/2018,16/03/2018,0.00,,9.03,,"-212,364.15"
,CS,AR,32002006,1005,100,,Cash sale,,,,,,16/03/2018,16/03/2018,0.00,,6.02,,"-212,370.17"
,CS,AR,32002025,1005,100,,Cash sale,,,,,,16/03/2018,16/03/2018,0.00,,6.02,,"-212,376.19"
,CS,AR,32002045,1005,100,,Cash sale,,,,,,16/03/2018,16/03/2018,0.00,,14.62,,"-212,390.81"
,CS,AR,32002072,1005,100,,Cash sale,,,,,,16/03/2018,16/03/2018,0.00,,39.11,,"-212,429.92"
,CS,AR,32002118,1005,100,,Cash sale,,,,,,16/03/2018,16/03/2018,0.00,,3.64,,"-212,433.56"
,CS,AR,32002128,1005,100,,Cash sale,,,,,,16/03/2018,16/03/2018,0.00,,7.29,,"-212,440.85"
,CS,AR,32002161,1005,100,,Cash sale,,,,,,16/03/2018,16/03/2018,0.00,,10.93,,"-212,451.78"
,CS,AR,32002166,1005,100,,Cash sale,,,,,,16/03/2018,16/03/2018,0.00,,18.22,,"-212,470.00"
,CS,AR,32002172,1005,100,,Cash sale,,,,,,16/03/2018,16/03/2018,0.00,,21.86,,"-212,491.86"
,CS,AR,32002223,1005,100,,Cash sale,,,,,,16/03/2018,16/03/2018,0.00,,3.64,,"-212,495.50"
,CS,AR,32002284,1005,100,,Cash sale,,,,,,16/03/2018,16/03/2018,0.00,,9.03,,"-212,504.53"
,CS,AR,32002291,1005,100,,Cash sale,,,,,,16/03/2018,16/03/2018,0.00,,10.93,,"-212,515.46"
,CS,AR,32002293,1005,100,,Cash sale,,,,,,16/03/2018,16/03/2018,0.00,,6.53,,"-212,521.99"
,CS,AR,32002296,1005,100,,Cash sale,,,,,,16/03/2018,16/03/2018,0.00,,7.29,,"-212,529.28"
,CS,AR,32002335,1005,100,,Cash sale,,,,,,16/03/2018,16/03/2018,0.00,,38.00,,"-212,567.28"
,CS,AR,32002340,1005,100,,Cash sale,,,,,,16/03/2018,16/03/2018,0.00,,3.64,,"-212,570.92"
,CS,AR,32002360,1005,100,,Cash sale,,,,,,16/03/2018,16/03/2018,0.00,,5.08,,"-212,576.00"
,CS,AR,32002434,1005,100,,Cash sale,,,,,,16/03/2018,16/03/2018,0.00,,10.93,,"-212,586.93"
,CS,AR,32002457,1005,100,,Cash sale,,,,,,16/03/2018,16/03/2018,0.00,,10.93,,"-212,597.86"
,CS,AR,32002469,1005,100,,Cash sale,,,,,,16/03/2018,16/03/2018,0.00,,18.20,,"-212,616.06"
,CS,AR,32002488,1005,100,,Cash sale,,,,,,16/03/2018,16/03/2018,0.00,,7.29,,"-212,623.35"
,CS,AR,32002530,1005,100,,Cash sale,,,,,,16/03/2018,16/03/2018,0.00,,14.58,,"-212,637.93"
,CS,AR,32002582,1005,100,,Cash sale,,,,,,16/03/2018,16/03/2018,0.00,,25.51,,"-212,663.44"
,IN,AR,30308800,1005,100,,Invoice,,,,,,16/03/2018,16/03/2018,0.00,,83.05,,"-212,746.49"
,IN,AR,30308810,1005,100,,Invoice,,,,,,16/03/2018,16/03/2018,0.00,,14.58,,"-212,761.07"
,IN,AR,30308953,1005,100,,Invoice,,,,,,16/03/2018,16/03/2018,0.00,,47.46,,"-212,808.53"
,IN,AR,30308974,1005,100,,Invoice,,,,,,16/03/2018,16/03/2018,0.00,,10.93,,"-212,819.46"
,IN,AR,30308981,1005,100,,Invoice,,,,,,16/03/2018,16/03/2018,0.00,,22.00,,"-212,841.46"
,IN,AR,30309042,1005,100,,Invoice,,,,,,16/03/2018,16/03/2018,0.00,,12.00,,"-212,853.46"
,IN,AR,30309103,1005,100,,Invoice,,,,,,16/03/2018,16/03/2018,0.00,,4.75,,"-212,858.21"
,IN,AR,30309117,1005,100,,Invoice,,,,,,16/03/2018,16/03/2018,0.00,,18.00,,"-212,876.21"
,IN,AR,30309132,1005,100,,Invoice,,,,,,16/03/2018,16/03/2018,0.00,,54.66,,"-212,930.87"
,IN,AR,30309168,1005,100,,Invoice,,,,,,16/03/2018,16/03/2018,0.00,,9.70,,"-212,940.57"
,IN,AR,30309197,1005,100,,Invoice,,,,,,16/03/2018,16/03/2018,0.00,,6.02,,"-212,946.59"
,IN,AR,30309206,1005,100,,Invoice,,,,,,16/03/2018,16/03/2018,0.00,,16.78,,"-212,963.37"
,IN,AR,30309272,1005,100,,Invoice,,,,,,16/03/2018,16/03/2018,0.00,,7.75,,"-212,971.12"
,IN,AR,30309284,1005,100,,Invoice,,,,,,16/03/2018,16/03/2018,0.00,,2.32,,"-212,973.44"
,IN,AR,30309294,1005,100,,Invoice,,,,,,16/03/2018,16/03/2018,0.00,,9.59,,"-212,983.03"
,IN,AR,30309313,1005,100,,Invoice,,,,,,16/03/2018,16/03/2018,0.00,,25.42,,"-213,008.45"
,IN,AR,30309364,1005,100,,Invoice,,,,,,16/03/2018,16/03/2018,0.00,,15.51,,"-213,023.96"
,IN,AR,30309379,1005,100,,Invoice,,,,,,16/03/2018,16/03/2018,0.00,,202.19,,"-213,226.15"
,IN,AR,30309432,1005,100,,Invoice,,,,,,16/03/2018,16/03/2018,0.00,,43.07,,"-213,269.22"
,IN,AR,30309463,1005,100,,Invoice,,,,,,16/03/2018,16/03/2018,0.00,,7.17,,"-213,276.39"
,IN,AR,30309464,1005,100,,Invoice,,,,,,16/03/2018,16/03/2018,0.00,,35.85,,"-213,312.24"
,IN,AR,30309530,1005,100,,Invoice,,,,,,16/03/2018,16/03/2018,0.00,,9.03,,"-213,321.27"
,IN,AR,30309590,1005,100,,Invoice,,,,,,16/03/2018,16/03/2018,0.00,,5.08,,"-213,326.35"
,IN,AR,30309591,1005,100,,Invoice,,,,,,16/03/2018,16/03/2018,0.00,,12.71,,"-213,339.06"
,IN,AR,30309592,1005,100,,Invoice,,,,,,16/03/2018,16/03/2018,0.00,,5.08,,"-213,344.14"
,IN,AR,30309606,1005,100,,Invoice,,,,,,16/03/2018,16/03/2018,0.00,,10.17,,"-213,354.31"
,IN,AR,30309635,1005,100,,Invoice,,,,,,16/03/2018,16/03/2018,0.00,,73.68,,"-213,427.99"
,IN,AR,30309688,1005,100,,Invoice,,,,,,16/03/2018,16/03/2018,0.00,,30.51,,"-213,458.50"
,IN,AR,30309693,1005,100,,Invoice,,,,,,16/03/2018,16/03/2018,0.00,,10.59,,"-213,469.09"
,IN,AR,30309722,1005,100,,Invoice,,,,,,16/03/2018,16/03/2018,0.00,,27.97,,"-213,497.06"
,IN,AR,30309770,1005,100,,Invoice,,,,,,16/03/2018,16/03/2018,0.00,,10.93,,"-213,507.99"
,IN,AR,30309781,1005,100,,Invoice,,,,,,16/03/2018,16/03/2018,0.00,,7.29,,"-213,515.28"
,IN,AR,30309813,1005,100,,Invoice,,,,,,16/03/2018,16/03/2018,0.00,,14.58,,"-213,529.86"
,IN,AR,30309837,1005,100,,Invoice,,,,,,16/03/2018,16/03/2018,0.00,,14.03,,"-213,543.89"
,IN,AR,30309877,1005,100,,Invoice,,,,,,16/03/2018,16/03/2018,0.00,,21.86,,"-213,565.75"
,IN,AR,30309901,1005,100,,Invoice,,,,,,16/03/2018,16/03/2018,0.00,,6.36,,"-213,572.11"
,IN,AR,30309955,1005,100,,Invoice,,,,,,16/03/2018,16/03/2018,0.00,,10.93,,"-213,583.04"
,IN,AR,30310018,1005,100,,Invoice,,,,,,16/03/2018,16/03/2018,0.00,,14.63,,"-213,597.67"
,IN,AR,30310135,1005,100,,Invoice,,,,,,16/03/2018,16/03/2018,0.00,,54.66,,"-213,652.33"
,IN,AR,30310224,1005,100,,Invoice,,,,,,16/03/2018,16/03/2018,0.00,,54.66,,"-213,706.99"
,IN,AR,30310253,1005,100,,Invoice,,,,,,16/03/2018,16/03/2018,0.00,,19.08,,"-213,726.07"
,IN,AR,30310264,1005,100,,Invoice,,,,,,16/03/2018,16/03/2018,0.00,,18.04,,"-213,744.11"
,IN,AR,30310270,1005,100,,Invoice,,,,,,16/03/2018,16/03/2018,0.00,,48.26,,"-213,792.37"
,IN,AR,30310291,1005,100,,Invoice,,,,,,16/03/2018,16/03/2018,0.00,,60.57,,"-213,852.94"
,IN,AR,30310295,1005,100,,Invoice,,,,,,16/03/2018,16/03/2018,0.00,,8.52,,"-213,861.46"
,IN,AR,30310300,1005,100,,Invoice,,,,,,16/03/2018,16/03/2018,0.00,,54.12,,"-213,915.58"
,IN,AR,30310312,1005,100,,Invoice,,,,,,16/03/2018,16/03/2018,0.00,,10.93,,"-213,926.51"
,IN,AR,30310321,1005,100,,Invoice,,,,,,16/03/2018,16/03/2018,0.00,,8.21,,"-213,934.72"
,IN,AR,30310367,1005,100,,Invoice,,,,,,16/03/2018,16/03/2018,0.00,,67.34,,"-214,002.06"
,IN,AR,30310396,1005,100,,Invoice,,,,,,16/03/2018,16/03/2018,0.00,,44.66,,"-214,046.72"
,IN,AR,30310401,1005,100,,Invoice,,,,,,16/03/2018,16/03/2018,0.00,,9.15,,"-214,055.87"
,IN,AR,30310403,1005,100,,Invoice,,,,,,16/03/2018,16/03/2018,0.00,,14.58,,"-214,070.45"
,IN,AR,30310419,1005,100,,Invoice,,,,,,16/03/2018,16/03/2018,0.00,,11.44,,"-214,081.89"
,IN,AR,30310432,1005,100,,Invoice,,,,,,16/03/2018,16/03/2018,0.00,,16.74,,"-214,098.63"
,IN,AR,30310500,1005,100,,Invoice,,,,,,16/03/2018,16/03/2018,0.00,,5.83,,"-214,104.46"
,IN,AR,30310501,1005,100,,Invoice,,,,,,16/03/2018,16/03/2018,0.00,,8.75,,"-214,113.21"
,IN,AR,30310517,1005,100,,Invoice,,,,,,16/03/2018,16/03/2018,0.00,,7.54,,"-214,120.75"
,IN,AR,30310524,1005,100,,Invoice,,,,,,16/03/2018,16/03/2018,0.00,,11.66,,"-214,132.41"
,IN,AR,30310534,1005,100,,Invoice,,,,,,16/03/2018,16/03/2018,0.00,,27.37,,"-214,159.78"
,IN,AR,30310541,1005,100,,Invoice,,,,,,16/03/2018,16/03/2018,0.00,,12.62,,"-214,172.40"
,IN,AR,30310542,1005,100,,Invoice,,,,,,16/03/2018,16/03/2018,0.00,,39.95,,"-214,212.35"
,IN,AR,30310551,1005,100,,Invoice,,,,,,16/03/2018,16/03/2018,0.00,,14.58,,"-214,226.93"
,IN,AR,30310592,1005,100,,Invoice,,,,,,16/03/2018,16/03/2018,0.00,,18.31,,"-214,245.24"
,IN,AR,30310613,1005,100,,Invoice,,,,,,16/03/2018,16/03/2018,0.00,,86.00,,"-214,331.24"
,IN,AR,30310621,1005,100,,Invoice,,,,,,16/03/2018,16/03/2018,0.00,,7.29,,"-214,338.53"
,IN,AR,30310654,1005,100,,Invoice,,,,,,16/03/2018,16/03/2018,0.00,,7.29,,"-214,345.82"
,IN,AR,30310662,1005,100,,Invoice,,,,,,16/03/2018,16/03/2018,0.00,,11.36,,"-214,357.18"
,IN,AR,30310667,1005,100,,Invoice,,,,,,16/03/2018,16/03/2018,0.00,,14.49,,"-214,371.67"
,IN,AR,30310787,1005,100,,Invoice,,,,,,16/03/2018,16/03/2018,0.00,,10.00,,"-214,381.67"
,IN,AR,30310801,1005,100,,Invoice,,,,,,16/03/2018,16/03/2018,0.00,,7.53,,"-214,389.20"
,IN,AR,30310817,1005,100,,Invoice,,,,,,16/03/2018,16/03/2018,0.00,,5.93,,"-214,395.13"
,IN,AR,30310856,1005,100,,Invoice,,,,,,16/03/2018,16/03/2018,0.00,,8.21,,"-214,403.34"
,IN,AR,30310864,1005,100,,Invoice,,,,,,16/03/2018,16/03/2018,0.00,,52.97,,"-214,456.31"
,IN,AR,30310879,1005,100,,Invoice,,,,,,16/03/2018,16/03/2018,0.00,,10.93,,"-214,467.24"
,IN,AR,30310895,1005,100,,Invoice,,,,,,16/03/2018,16/03/2018,0.00,,15.71,,"-214,482.95"
,IN,AR,30310921,1005,100,,Invoice,,,,,,16/03/2018,16/03/2018,0.00,,4.08,,"-214,487.03"
,IN,AR,30311009,1005,100,,Invoice,,,,,,16/03/2018,16/03/2018,0.00,,9.11,,"-214,496.14"
,IN,AR,30311036,1005,100,,Invoice,,,,,,16/03/2018,16/03/2018,0.00,,4.00,,"-214,500.14"
,IN,AR,30311037,1005,100,,Invoice,,,,,,16/03/2018,16/03/2018,0.00,,4.00,,"-214,504.14"
,IN,AR,30311047,1005,100,,Invoice,,,,,,16/03/2018,16/03/2018,0.00,,20.76,,"-214,524.90"
,IN,AR,30311048,1005,100,,Invoice,,,,,,16/03/2018,16/03/2018,0.00,,107.97,,"-214,632.87"
,CS,AR,32001700,1005,100,,Cash sale,,,,,,17/03/2018,17/03/2018,0.00,,76.93,,"-214,709.80"
,CS,AR,32001734,1005,100,,Cash sale,,,,,,17/03/2018,17/03/2018,0.00,,14.24,,"-214,724.04"
,CS,AR,32001739,1005,100,,Cash sale,,,,,,17/03/2018,17/03/2018,0.00,,9.03,,"-214,733.07"
,CS,AR,32001750,1005,100,,Cash sale,,,,,,17/03/2018,17/03/2018,0.00,,10.93,,"-214,744.00"
,CS,AR,32001753,1005,100,,Cash sale,,,,,,17/03/2018,17/03/2018,0.00,,7.29,,"-214,751.29"
,CS,AR,32001859,1005,100,,Cash sale,,,,,,17/03/2018,17/03/2018,0.00,,14.58,,"-214,765.87"
,CS,AR,32001864,1005,100,,Cash sale,,,,,,17/03/2018,17/03/2018,0.00,,3.64,,"-214,769.51"
,CS,AR,32001873,1005,100,,Cash sale,,,,,,17/03/2018,17/03/2018,0.00,,23.29,,"-214,792.80"
,CS,AR,32001879,1005,100,,Cash sale,,,,,,17/03/2018,17/03/2018,0.00,,7.29,,"-214,800.09"
,CS,AR,32001903,1005,100,,Cash sale,,,,,,17/03/2018,17/03/2018,0.00,,7.29,,"-214,807.38"
,CS,AR,32002090,1005,100,,Cash sale,,,,,,17/03/2018,17/03/2018,0.00,,7.29,,"-214,814.67"
,CS,AR,32002175,1005,100,,Cash sale,,,,,,17/03/2018,17/03/2018,0.00,,10.93,,"-214,825.60"
,CS,AR,32002183,1005,100,,Cash sale,,,,,,17/03/2018,17/03/2018,0.00,,10.93,,"-214,836.53"
,CS,AR,32002197,1005,100,,Cash sale,,,,,,17/03/2018,17/03/2018,0.00,,10.93,,"-214,847.46"
,CS,AR,32002207,1005,100,,Cash sale,,,,,,17/03/2018,17/03/2018,0.00,,5.17,,"-214,852.63"
,CS,AR,32002212,1005,100,,Cash sale,,,,,,17/03/2018,17/03/2018,0.00,,14.58,,"-214,867.21"
,CS,AR,32002255,1005,100,,Cash sale,,,,,,17/03/2018,17/03/2018,0.00,,16.78,,"-214,883.99"
,CS,AR,32002271,1005,100,,Cash sale,,,,,,17/03/2018,17/03/2018,0.00,,18.22,,"-214,902.21"
,CS,AR,32002289,1005,100,,Cash sale,,,,,,17/03/2018,17/03/2018,0.00,,21.86,,"-214,924.07"
,CS,AR,32002383,1005,100,,Cash sale,,,,,,17/03/2018,17/03/2018,0.00,,10.93,,"-214,935.00"
,CS,AR,32002401,1005,100,,Cash sale,,,,,,17/03/2018,17/03/2018,0.00,,10.93,,"-214,945.93"
,CS,AR,32002427,1005,100,,Cash sale,,,,,,17/03/2018,17/03/2018,0.00,,14.58,,"-214,960.51"
,CS,AR,32002464,1005,100,,Cash sale,,,,,,17/03/2018,17/03/2018,0.00,,7.29,,"-214,967.80"
,CS,AR,32002547,1005,100,,Cash sale,,,,,,17/03/2018,17/03/2018,0.00,,7.29,,"-214,975.09"
,IN,AR,30308865,1005,100,,Invoice,,,,,,17/03/2018,17/03/2018,0.00,,6.08,,"-214,981.17"
,IN,AR,30308883,1005,100,,Invoice,,,,,,17/03/2018,17/03/2018,0.00,,14.49,,"-214,995.66"
,IN,AR,30308954,1005,100,,Invoice,,,,,,17/03/2018,17/03/2018,0.00,,40.34,,"-215,036.00"
,IN,AR,30308972,1005,100,,Invoice,,,,,,17/03/2018,17/03/2018,0.00,,36.10,,"-215,072.10"
,IN,AR,30309008,1005,100,,Invoice,,,,,,17/03/2018,17/03/2018,0.00,,12.08,,"-215,084.18"
,IN,AR,30309053,1005,100,,Invoice,,,,,,17/03/2018,17/03/2018,0.00,,10.93,,"-215,095.11"
,IN,AR,30309145,1005,100,,Invoice,,,,,,17/03/2018,17/03/2018,0.00,,18.22,,"-215,113.33"
,IN,AR,30309342,1005,100,,Invoice,,,,,,17/03/2018,17/03/2018,0.00,,81.36,,"-215,194.69"
,IN,AR,30309369,1005,100,,Invoice,,,,,,17/03/2018,17/03/2018,0.00,,5.83,,"-215,200.52"
,IN,AR,30309892,1005,100,,Invoice,,,,,,17/03/2018,17/03/2018,0.00,,10.93,,"-215,211.45"
,IN,AR,30310068,1005,100,,Invoice,,,,,,17/03/2018,17/03/2018,0.00,,29.15,,"-215,240.60"
,IN,AR,30310186,1005,100,,Invoice,,,,,,17/03/2018,17/03/2018,0.00,,18.22,,"-215,258.82"
,IN,AR,30310226,1005,100,,Invoice,,,,,,17/03/2018,17/03/2018,0.00,,7.29,,"-215,266.11"
,IN,AR,30310444,1005,100,,Invoice,,,,,,17/03/2018,17/03/2018,0.00,,7.29,,"-215,273.40"
,IN,AR,30310493,1005,100,,Invoice,,,,,,17/03/2018,17/03/2018,0.00,,7.29,,"-215,280.69"
,IN,AR,30310506,1005,100,,Invoice,,,,,,17/03/2018,17/03/2018,0.00,,10.93,,"-215,291.62"
,IN,AR,30310646,1005,100,,Invoice,,,,,,17/03/2018,17/03/2018,0.00,,36.44,,"-215,328.06"
,IN,AR,30311058,1005,100,,Invoice,,,,,,17/03/2018,17/03/2018,0.00,,29.15,,"-215,357.21"
,CS,AR,32001735,1005,100,,Cash sale,,,,,,19/03/2018,19/03/2018,0.00,,4.75,,"-215,361.96"
,CS,AR,32001747,1005,100,,Cash sale,,,,,,19/03/2018,19/03/2018,0.00,,3.64,,"-215,365.60"
,CS,AR,32001763,1005,100,,Cash sale,,,,,,19/03/2018,19/03/2018,0.00,,7.29,,"-215,372.89"
,CS,AR,32001812,1005,100,,Cash sale,,,,,,19/03/2018,19/03/2018,0.00,,3.64,,"-215,376.53"
,CS,AR,32001825,1005,100,,Cash sale,,,,,,19/03/2018,19/03/2018,0.00,,10.38,,"-215,386.91"
,CS,AR,32001840,1005,100,,Cash sale,,,,,,19/03/2018,19/03/2018,0.00,,7.29,,"-215,394.20"
,CS,AR,32001907,1005,100,,Cash sale,,,,,,19/03/2018,19/03/2018,0.00,,10.34,,"-215,404.54"
,CS,AR,32001966,1005,100,,Cash sale,,,,,,19/03/2018,19/03/2018,0.00,,18.09,,"-215,422.63"
,CS,AR,32001967,1005,100,,Cash sale,,,,,,19/03/2018,19/03/2018,0.00,,5.17,,"-215,427.80"
,CS,AR,32001981,1005,100,,Cash sale,,,,,,19/03/2018,19/03/2018,0.00,,5.17,,"-215,432.97"
,CS,AR,32001987,1005,100,,Cash sale,,,,,,19/03/2018,19/03/2018,0.00,,2.75,,"-215,435.72"
,CS,AR,32002046,1005,100,,Cash sale,,,,,,19/03/2018,19/03/2018,0.00,,14.62,,"-215,450.34"
,CS,AR,32002059,1005,100,,Cash sale,,,,,,19/03/2018,19/03/2018,0.00,,7.29,,"-215,457.63"
,CS,AR,32002073,1005,100,,Cash sale,,,,,,19/03/2018,19/03/2018,0.00,,24.07,,"-215,481.70"
,CS,AR,32002106,1005,100,,Cash sale,,,,,,19/03/2018,19/03/2018,0.00,,3.64,,"-215,485.34"
,CS,AR,32002134,1005,100,,Cash sale,,,,,,19/03/2018,19/03/2018,0.00,,2.54,,"-215,487.88"
,CS,AR,32002139,1005,100,,Cash sale,,,,,,19/03/2018,19/03/2018,0.00,,2.58,,"-215,490.46"
,CS,AR,32002179,1005,100,,Cash sale,,,,,,19/03/2018,19/03/2018,0.00,,3.64,,"-215,494.10"
,CS,AR,32002228,1005,100,,Cash sale,,,,,,19/03/2018,19/03/2018,0.00,,3.04,,"-215,497.14"
,CS,AR,32002274,1005,100,,Cash sale,,,,,,19/03/2018,19/03/2018,0.00,,10.99,,"-215,508.13"
,CS,AR,32002301,1005,100,,Cash sale,,,,,,19/03/2018,19/03/2018,0.00,,3.64,,"-215,511.77"
,CS,AR,32002377,1005,100,,Cash sale,,,,,,19/03/2018,19/03/2018,0.00,,11.44,,"-215,523.21"
,CS,AR,32002503,1005,100,,Cash sale,,,,,,19/03/2018,19/03/2018,0.00,,10.93,,"-215,534.14"
,IN,AR,30308877,1005,100,,Invoice,,,,,,19/03/2018,19/03/2018,0.00,,10.93,,"-215,545.07"
,IN,AR,30308970,1005,100,,Invoice,,,,,,19/03/2018,19/03/2018,0.00,,3.64,,"-215,548.71"
,IN,AR,30309043,1005,100,,Invoice,,,,,,19/03/2018,19/03/2018,0.00,,32.00,,"-215,580.71"
,IN,AR,30309044,1005,100,,Invoice,,,,,,19/03/2018,19/03/2018,0.00,,12.00,,"-215,592.71"
,IN,AR,30309084,1005,100,,Invoice,,,,,,19/03/2018,19/03/2018,0.00,,3.89,,"-215,596.60"
,IN,AR,30309095,1005,100,,Invoice,,,,,,19/03/2018,19/03/2018,0.00,,11.69,,"-215,608.29"
,IN,AR,30309118,1005,100,,Invoice,,,,,,19/03/2018,19/03/2018,0.00,,12.00,,"-215,620.29"
,IN,AR,30309160,1005,100,,Invoice,,,,,,19/03/2018,19/03/2018,0.00,,764.69,,"-216,384.98"
,IN,AR,30309212,1005,100,,Invoice,,,,,,19/03/2018,19/03/2018,0.00,,8.05,,"-216,393.03"
,IN,AR,30309226,1005,100,,Invoice,,,,,,19/03/2018,19/03/2018,0.00,,28.39,,"-216,421.42"
,IN,AR,30309231,1005,100,,Invoice,,,,,,19/03/2018,19/03/2018,0.00,,7.29,,"-216,428.71"
,IN,AR,30309251,1005,100,,Invoice,,,,,,19/03/2018,19/03/2018,0.00,,15.51,,"-216,444.22"
,IN,AR,30309397,1005,100,,Invoice,,,,,,19/03/2018,19/03/2018,0.00,,7.29,,"-216,451.51"
,IN,AR,30309445,1005,100,,Invoice,,,,,,19/03/2018,19/03/2018,0.00,,25.42,,"-216,476.93"
,IN,AR,30309446,1005,100,,Invoice,,,,,,19/03/2018,19/03/2018,0.00,,61.02,,"-216,537.95"
,IN,AR,30309465,1005,100,,Invoice,,,,,,19/03/2018,19/03/2018,0.00,,38.24,,"-216,576.19"
,IN,AR,30309485,1005,100,,Invoice,,,,,,19/03/2018,19/03/2018,0.00,,10.93,,"-216,587.12"
,IN,AR,30309593,1005,100,,Invoice,,,,,,19/03/2018,19/03/2018,0.00,,10.17,,"-216,597.29"
,IN,AR,30309723,1005,100,,Invoice,,,,,,19/03/2018,19/03/2018,0.00,,22.88,,"-216,620.17"
,IN,AR,30309766,1005,100,,Invoice,,,,,,19/03/2018,19/03/2018,0.00,,3.64,,"-216,623.81"
,IN,AR,30309838,1005,100,,Invoice,,,,,,19/03/2018,19/03/2018,0.00,,14.03,,"-216,637.84"
,IN,AR,30309995,1005,100,,Invoice,,,,,,19/03/2018,19/03/2018,0.00,,3.64,,"-216,641.48"
,IN,AR,30310072,1005,100,,Invoice,,,,,,19/03/2018,19/03/2018,0.00,,14.58,,"-216,656.06"
,IN,AR,30310169,1005,100,,Invoice,,,,,,19/03/2018,19/03/2018,0.00,,21.86,,"-216,677.92"
,IN,AR,30310390,1005,100,,Invoice,,,,,,19/03/2018,19/03/2018,0.00,,6.56,,"-216,684.48"
,IN,AR,30310416,1005,100,,Invoice,,,,,,19/03/2018,19/03/2018,0.00,,6.56,,"-216,691.04"
,IN,AR,30310474,1005,100,,Invoice,,,,,,19/03/2018,19/03/2018,0.00,,16.01,,"-216,707.05"
,IN,AR,30310478,1005,100,,Invoice,,,,,,19/03/2018,19/03/2018,0.00,,14.00,,"-216,721.05"
,IN,AR,30310673,1005,100,,Invoice,,,,,,19/03/2018,19/03/2018,0.00,,26.69,,"-216,747.74"
,IN,AR,30310764,1005,100,,Invoice,,,,,,19/03/2018,19/03/2018,0.00,,23.73,,"-216,771.47"
,IN,AR,30310765,1005,100,,Invoice,,,,,,19/03/2018,19/03/2018,0.00,,92.55,,"-216,864.02"
,IN,AR,30310792,1005,100,,Invoice,,,,,,19/03/2018,19/03/2018,0.00,,3.64,,"-216,867.66"
,IN,AR,30310922,1005,100,,Invoice,,,,,,19/03/2018,19/03/2018,0.00,,6.13,,"-216,873.79"
,IN,AR,30310958,1005,100,,Invoice,,,,,,19/03/2018,19/03/2018,0.00,,36.44,,"-216,910.23"
,CN,AR,31017497,1005,100,,Credit Note,,,,,,20/03/2018,20/03/2018,364.41,,0.00,,"-216,545.82"
,CN,AR,31017590,1005,100,,Credit Note,,,,,,20/03/2018,20/03/2018,18.22,,0.00,,"-216,527.60"
,CN,AR,31017608,1005,100,,Credit Note,,,,,,20/03/2018,20/03/2018,14.58,,0.00,,"-216,513.02"
,CS,AR,32001712,1005,100,,Cash sale,,,,,,20/03/2018,20/03/2018,0.00,,22.44,,"-216,535.46"
,CS,AR,32001779,1005,100,,Cash sale,,,,,,20/03/2018,20/03/2018,0.00,,7.29,,"-216,542.75"
,CS,AR,32001798,1005,100,,Cash sale,,,,,,20/03/2018,20/03/2018,0.00,,3.01,,"-216,545.76"
,CS,AR,32001806,1005,100,,Cash sale,,,,,,20/03/2018,20/03/2018,0.00,,7.29,,"-216,553.05"
,CS,AR,32001863,1005,100,,Cash sale,,,,,,20/03/2018,20/03/2018,0.00,,18.22,,"-216,571.27"
,CS,AR,32001886,1005,100,,Cash sale,,,,,,20/03/2018,20/03/2018,0.00,,3.64,,"-216,574.91"
,CS,AR,32001904,1005,100,,Cash sale,,,,,,20/03/2018,20/03/2018,0.00,,7.29,,"-216,582.20"
,CS,AR,32001913,1005,100,,Cash sale,,,,,,20/03/2018,20/03/2018,0.00,,3.64,,"-216,585.84"
,CS,AR,32001914,1005,100,,Cash sale,,,,,,20/03/2018,20/03/2018,0.00,,10.17,,"-216,596.01"
,CS,AR,32001955,1005,100,,Cash sale,,,,,,20/03/2018,20/03/2018,0.00,,7.75,,"-216,603.76"
,CS,AR,32001963,1005,100,,Cash sale,,,,,,20/03/2018,20/03/2018,0.00,,3.64,,"-216,607.40"
,CS,AR,32001976,1005,100,,Cash sale,,,,,,20/03/2018,20/03/2018,0.00,,21.86,,"-216,629.26"
,CS,AR,32002021,1005,100,,Cash sale,,,,,,20/03/2018,20/03/2018,0.00,,7.29,,"-216,636.55"
,CS,AR,32002065,1005,100,,Cash sale,,,,,,20/03/2018,20/03/2018,0.00,,10.93,,"-216,647.48"
,CS,AR,32002085,1005,100,,Cash sale,,,,,,20/03/2018,20/03/2018,0.00,,3.90,,"-216,651.38"
,CS,AR,32002110,1005,100,,Cash sale,,,,,,20/03/2018,20/03/2018,0.00,,7.63,,"-216,659.01"
,CS,AR,32002121,1005,100,,Cash sale,,,,,,20/03/2018,20/03/2018,0.00,,5.17,,"-216,664.18"
,CS,AR,32002144,1005,100,,Cash sale,,,,,,20/03/2018,20/03/2018,0.00,,7.80,,"-216,671.98"
,CS,AR,32002169,1005,100,,Cash sale,,,,,,20/03/2018,20/03/2018,0.00,,18.22,,"-216,690.20"
,CS,AR,32002174,1005,100,,Cash sale,,,,,,20/03/2018,20/03/2018,0.00,,3.64,,"-216,693.84"
,CS,AR,32002199,1005,100,,Cash sale,,,,,,20/03/2018,20/03/2018,0.00,,8.39,,"-216,702.23"
,CS,AR,32002219,1005,100,,Cash sale,,,,,,20/03/2018,20/03/2018,0.00,,7.29,,"-216,709.52"
,CS,AR,32002236,1005,100,,Cash sale,,,,,,20/03/2018,20/03/2018,0.00,,10.93,,"-216,720.45"
,CS,AR,32002242,1005,100,,Cash sale,,,,,,20/03/2018,20/03/2018,0.00,,15.01,,"-216,735.46"
,CS,AR,32002249,1005,100,,Cash sale,,,,,,20/03/2018,20/03/2018,0.00,,7.29,,"-216,742.75"
,CS,AR,32002285,1005,100,,Cash sale,,,,,,20/03/2018,20/03/2018,0.00,,14.58,,"-216,757.33"
,CS,AR,32002297,1005,100,,Cash sale,,,,,,20/03/2018,20/03/2018,0.00,,7.29,,"-216,764.62"
,CS,AR,32002329,1005,100,,Cash sale,,,,,,20/03/2018,20/03/2018,0.00,,7.63,,"-216,772.25"
,CS,AR,32002394,1005,100,,Cash sale,,,,,,20/03/2018,20/03/2018,0.00,,8.90,,"-216,781.15"
,CS,AR,32002416,1005,100,,Cash sale,,,,,,20/03/2018,20/03/2018,0.00,,5.50,,"-216,786.65"
,CS,AR,32002425,1005,100,,Cash sale,,,,,,20/03/2018,20/03/2018,0.00,,60.71,,"-216,847.36"
,CS,AR,32002451,1005,100,,Cash sale,,,,,,20/03/2018,20/03/2018,0.00,,5.47,,"-216,852.83"
,CS,AR,32002458,1005,100,,Cash sale,,,,,,20/03/2018,20/03/2018,0.00,,10.93,,"-216,863.76"
,CS,AR,32002478,1005,100,,Cash sale,,,,,,20/03/2018,20/03/2018,0.00,,10.93,,"-216,874.69"
,CS,AR,32002525,1005,100,,Cash sale,,,,,,20/03/2018,20/03/2018,0.00,,2.74,,"-216,877.43"
,CS,AR,32002549,1005,100,,Cash sale,,,,,,20/03/2018,20/03/2018,0.00,,6.56,,"-216,883.99"
,CS,AR,32002559,1005,100,,Cash sale,,,,,,20/03/2018,20/03/2018,0.00,,7.29,,"-216,891.28"
,CS,AR,32002568,1005,100,,Cash sale,,,,,,20/03/2018,20/03/2018,0.00,,5.85,,"-216,897.13"
,CS,AR,32002570,1005,100,,Cash sale,,,,,,20/03/2018,20/03/2018,0.00,,10.34,,"-216,907.47"
,CS,AR,32002583,1005,100,,Cash sale,,,,,,20/03/2018,20/03/2018,0.00,,7.29,,"-216,914.76"
,IN,AR,30308801,1005,100,,Invoice,,,,,,20/03/2018,20/03/2018,0.00,,47.46,,"-216,962.22"
,IN,AR,30308848,1005,100,,Invoice,,,,,,20/03/2018,20/03/2018,0.00,,10.99,,"-216,973.21"
,IN,AR,30308891,1005,100,,Invoice,,,,,,20/03/2018,20/03/2018,0.00,,7.00,,"-216,980.21"
,IN,AR,30308904,1005,100,,Invoice,,,,,,20/03/2018,20/03/2018,0.00,,7.29,,"-216,987.50"
,IN,AR,30308905,1005,100,,Invoice,,,,,,20/03/2018,20/03/2018,0.00,,3.64,,"-216,991.14"
,IN,AR,30308955,1005,100,,Invoice,,,,,,20/03/2018,20/03/2018,0.00,,154.24,,"-217,145.38"
,IN,AR,30308965,1005,100,,Invoice,,,,,,20/03/2018,20/03/2018,0.00,,5.51,,"-217,150.89"
,IN,AR,30308982,1005,100,,Invoice,,,,,,20/03/2018,20/03/2018,0.00,,48.00,,"-217,198.89"
,IN,AR,30308991,1005,100,,Invoice,,,,,,20/03/2018,20/03/2018,0.00,,14.58,,"-217,213.47"
,IN,AR,30308998,1005,100,,Invoice,,,,,,20/03/2018,20/03/2018,0.00,,7.29,,"-217,220.76"
,IN,AR,30309030,1005,100,,Invoice,,,,,,20/03/2018,20/03/2018,0.00,,10.93,,"-217,231.69"
,IN,AR,30309056,1005,100,,Invoice,,,,,,20/03/2018,20/03/2018,0.00,,10.93,,"-217,242.62"
,IN,AR,30309060,1005,100,,Invoice,,,,,,20/03/2018,20/03/2018,0.00,,5.51,,"-217,248.13"
,IN,AR,30309068,1005,100,,Invoice,,,,,,20/03/2018,20/03/2018,0.00,,11.02,,"-217,259.15"
,IN,AR,30309128,1005,100,,Invoice,,,,,,20/03/2018,20/03/2018,0.00,,7.29,,"-217,266.44"
,IN,AR,30309169,1005,100,,Invoice,,,,,,20/03/2018,20/03/2018,0.00,,7.76,,"-217,274.20"
,IN,AR,30309193,1005,100,,Invoice,,,,,,20/03/2018,20/03/2018,0.00,,10.99,,"-217,285.19"
,IN,AR,30309195,1005,100,,Invoice,,,,,,20/03/2018,20/03/2018,0.00,,7.29,,"-217,292.48"
,IN,AR,30309202,1005,100,,Invoice,,,,,,20/03/2018,20/03/2018,0.00,,7.29,,"-217,299.77"
,IN,AR,30309203,1005,100,,Invoice,,,,,,20/03/2018,20/03/2018,0.00,,7.29,,"-217,307.06"
,IN,AR,30309278,1005,100,,Invoice,,,,,,20/03/2018,20/03/2018,0.00,,16.47,,"-217,323.53"
,IN,AR,30309288,1005,100,,Invoice,,,,,,20/03/2018,20/03/2018,0.00,,364.41,,"-217,687.94"
,IN,AR,30309295,1005,100,,Invoice,,,,,,20/03/2018,20/03/2018,0.00,,7.19,,"-217,695.13"
,IN,AR,30309308,1005,100,,Invoice,,,,,,20/03/2018,20/03/2018,0.00,,7.29,,"-217,702.42"
,IN,AR,30309324,1005,100,,Invoice,,,,,,20/03/2018,20/03/2018,0.00,,4.32,,"-217,706.74"
,IN,AR,30309330,1005,100,,Invoice,,,,,,20/03/2018,20/03/2018,0.00,,8.47,,"-217,715.21"
,IN,AR,30309343,1005,100,,Invoice,,,,,,20/03/2018,20/03/2018,0.00,,20.34,,"-217,735.55"
,IN,AR,30309344,1005,100,,Invoice,,,,,,20/03/2018,20/03/2018,0.00,,40.68,,"-217,776.23"
,IN,AR,30309345,1005,100,,Invoice,,,,,,20/03/2018,20/03/2018,0.00,,61.02,,"-217,837.25"
,IN,AR,30309346,1005,100,,Invoice,,,,,,20/03/2018,20/03/2018,0.00,,52.88,,"-217,890.13"
,IN,AR,30309352,1005,100,,Invoice,,,,,,20/03/2018,20/03/2018,0.00,,4.24,,"-217,894.37"
,IN,AR,30309365,1005,100,,Invoice,,,,,,20/03/2018,20/03/2018,0.00,,20.68,,"-217,915.05"
,IN,AR,30309376,1005,100,,Invoice,,,,,,20/03/2018,20/03/2018,0.00,,5.17,,"-217,920.22"
,IN,AR,30309393,1005,100,,Invoice,,,,,,20/03/2018,20/03/2018,0.00,,3.90,,"-217,924.12"
,IN,AR,30309402,1005,100,,Invoice,,,,,,20/03/2018,20/03/2018,0.00,,11.36,,"-217,935.48"
,IN,AR,30309420,1005,100,,Invoice,,,,,,20/03/2018,20/03/2018,0.00,,11.69,,"-217,947.17"
,IN,AR,30309433,1005,100,,Invoice,,,,,,20/03/2018,20/03/2018,0.00,,121.00,,"-218,068.17"
,IN,AR,30309477,1005,100,,Invoice,,,,,,20/03/2018,20/03/2018,0.00,,25.76,,"-218,093.93"
,IN,AR,30309509,1005,100,,Invoice,,,,,,20/03/2018,20/03/2018,0.00,,2.75,,"-218,096.68"
,IN,AR,30309528,1005,100,,Invoice,,,,,,20/03/2018,20/03/2018,0.00,,44.93,,"-218,141.61"
,IN,AR,30309556,1005,100,,Invoice,,,,,,20/03/2018,20/03/2018,0.00,,2.54,,"-218,144.15"
,IN,AR,30309648,1005,100,,Invoice,,,,,,20/03/2018,20/03/2018,0.00,,15.25,,"-218,159.40"
,IN,AR,30309690,1005,100,,Invoice,,,,,,20/03/2018,20/03/2018,0.00,,3.64,,"-218,163.04"
,IN,AR,30309698,1005,100,,Invoice,,,,,,20/03/2018,20/03/2018,0.00,,7.29,,"-218,170.33"
,IN,AR,30309707,1005,100,,Invoice,,,,,,20/03/2018,20/03/2018,0.00,,8.39,,"-218,178.72"
,IN,AR,30309745,1005,100,,Invoice,,,,,,20/03/2018,20/03/2018,0.00,,6.61,,"-218,185.33"
,IN,AR,30309747,1005,100,,Invoice,,,,,,20/03/2018,20/03/2018,0.00,,4.78,,"-218,190.11"
,IN,AR,30309756,1005,100,,Invoice,,,,,,20/03/2018,20/03/2018,0.00,,2.54,,"-218,192.65"
,IN,AR,30309761,1005,100,,Invoice,,,,,,20/03/2018,20/03/2018,0.00,,3.90,,"-218,196.55"
,IN,AR,30309764,1005,100,,Invoice,,,,,,20/03/2018,20/03/2018,0.00,,14.03,,"-218,210.58"
,IN,AR,30309787,1005,100,,Invoice,,,,,,20/03/2018,20/03/2018,0.00,,8.47,,"-218,219.05"
,IN,AR,30309801,1005,100,,Invoice,,,,,,20/03/2018,20/03/2018,0.00,,8.26,,"-218,227.31"
,IN,AR,30309815,1005,100,,Invoice,,,,,,20/03/2018,20/03/2018,0.00,,3.64,,"-218,230.95"
,IN,AR,30309830,1005,100,,Invoice,,,,,,20/03/2018,20/03/2018,0.00,,13.78,,"-218,244.73"
,IN,AR,30309845,1005,100,,Invoice,,,,,,20/03/2018,20/03/2018,0.00,,7.29,,"-218,252.02"
,IN,AR,30309847,1005,100,,Invoice,,,,,,20/03/2018,20/03/2018,0.00,,6.36,,"-218,258.38"
,IN,AR,30309850,1005,100,,Invoice,,,,,,20/03/2018,20/03/2018,0.00,,17.80,,"-218,276.18"
,IN,AR,30309890,1005,100,,Invoice,,,,,,20/03/2018,20/03/2018,0.00,,14.58,,"-218,290.76"
,IN,AR,30309910,1005,100,,Invoice,,,,,,20/03/2018,20/03/2018,0.00,,63.46,,"-218,354.22"
,IN,AR,30309918,1005,100,,Invoice,,,,,,20/03/2018,20/03/2018,0.00,,7.29,,"-218,361.51"
,IN,AR,30309926,1005,100,,Invoice,,,,,,20/03/2018,20/03/2018,0.00,,17.54,,"-218,379.05"
,IN,AR,30309962,1005,100,,Invoice,,,,,,20/03/2018,20/03/2018,0.00,,8.26,,"-218,387.31"
,IN,AR,30309977,1005,100,,Invoice,,,,,,20/03/2018,20/03/2018,0.00,,5.86,,"-218,393.17"
,IN,AR,30309984,1005,100,,Invoice,,,,,,20/03/2018,20/03/2018,0.00,,2.84,,"-218,396.01"
,IN,AR,30309991,1005,100,,Invoice,,,,,,20/03/2018,20/03/2018,0.00,,29.55,,"-218,425.56"
,IN,AR,30310048,1005,100,,Invoice,,,,,,20/03/2018,20/03/2018,0.00,,7.29,,"-218,432.85"
,IN,AR,30310060,1005,100,,Invoice,,,,,,20/03/2018,20/03/2018,0.00,,5.64,,"-218,438.49"
,IN,AR,30310066,1005,100,,Invoice,,,,,,20/03/2018,20/03/2018,0.00,,23.58,,"-218,462.07"
,IN,AR,30310074,1005,100,,Invoice,,,,,,20/03/2018,20/03/2018,0.00,,9.29,,"-218,471.36"
,IN,AR,30310076,1005,100,,Invoice,,,,,,20/03/2018,20/03/2018,0.00,,29.15,,"-218,500.51"
,IN,AR,30310088,1005,100,,Invoice,,,,,,20/03/2018,20/03/2018,0.00,,3.53,,"-218,504.04"
,IN,AR,30310100,1005,100,,Invoice,,,,,,20/03/2018,20/03/2018,0.00,,7.29,,"-218,511.33"
,IN,AR,30310119,1005,100,,Invoice,,,,,,20/03/2018,20/03/2018,0.00,,8.24,,"-218,519.57"
,IN,AR,30310124,1005,100,,Invoice,,,,,,20/03/2018,20/03/2018,0.00,,5.17,,"-218,524.74"
,IN,AR,30310140,1005,100,,Invoice,,,,,,20/03/2018,20/03/2018,0.00,,7.29,,"-218,532.03"
,IN,AR,30310146,1005,100,,Invoice,,,,,,20/03/2018,20/03/2018,0.00,,10.93,,"-218,542.96"
,IN,AR,30310254,1005,100,,Invoice,,,,,,20/03/2018,20/03/2018,0.00,,3.18,,"-218,546.14"
,IN,AR,30310255,1005,100,,Invoice,,,,,,20/03/2018,20/03/2018,0.00,,7.95,,"-218,554.09"
,IN,AR,30310271,1005,100,,Invoice,,,,,,20/03/2018,20/03/2018,0.00,,48.26,,"-218,602.35"
,IN,AR,30310275,1005,100,,Invoice,,,,,,20/03/2018,20/03/2018,0.00,,30.00,,"-218,632.35"
,IN,AR,30310338,1005,100,,Invoice,,,,,,20/03/2018,20/03/2018,0.00,,168.36,,"-218,800.71"
,IN,AR,30310368,1005,100,,Invoice,,,,,,20/03/2018,20/03/2018,0.00,,4.81,,"-218,805.52"
,IN,AR,30310458,1005,100,,Invoice,,,,,,20/03/2018,20/03/2018,0.00,,12.71,,"-218,818.23"
,IN,AR,30310569,1005,100,,Invoice,,,,,,20/03/2018,20/03/2018,0.00,,160.81,,"-218,979.04"
,IN,AR,30310575,1005,100,,Invoice,,,,,,20/03/2018,20/03/2018,0.00,,10.95,,"-218,989.99"
,IN,AR,30310581,1005,100,,Invoice,,,,,,20/03/2018,20/03/2018,0.00,,25.25,,"-219,015.24"
,IN,AR,30310619,1005,100,,Invoice,,,,,,20/03/2018,20/03/2018,0.00,,9.10,,"-219,024.34"
,IN,AR,30310720,1005,100,,Invoice,,,,,,20/03/2018,20/03/2018,0.00,,75.93,,"-219,100.27"
,IN,AR,30310788,1005,100,,Invoice,,,,,,20/03/2018,20/03/2018,0.00,,10.00,,"-219,110.27"
,IN,AR,30310802,1005,100,,Invoice,,,,,,20/03/2018,20/03/2018,0.00,,3.76,,"-219,114.03"
,IN,AR,30310810,1005,100,,Invoice,,,,,,20/03/2018,20/03/2018,0.00,,5.26,,"-219,119.29"
,IN,AR,30310815,1005,100,,Invoice,,,,,,20/03/2018,20/03/2018,0.00,,6.00,,"-219,125.29"
,IN,AR,30310824,1005,100,,Invoice,,,,,,20/03/2018,20/03/2018,0.00,,106.90,,"-219,232.19"
,IN,AR,30310836,1005,100,,Invoice,,,,,,20/03/2018,20/03/2018,0.00,,16.40,,"-219,248.59"
,IN,AR,30310839,1005,100,,Invoice,,,,,,20/03/2018,20/03/2018,0.00,,7.02,,"-219,255.61"
,IN,AR,30310859,1005,100,,Invoice,,,,,,20/03/2018,20/03/2018,0.00,,10.93,,"-219,266.54"
,IN,AR,30310877,1005,100,,Invoice,,,,,,20/03/2018,20/03/2018,0.00,,10.93,,"-219,277.47"
,IN,AR,30311038,1005,100,,Invoice,,,,,,20/03/2018,20/03/2018,0.00,,4.00,,"-219,281.47"
,IN,AR,30311039,1005,100,,Invoice,,,,,,20/03/2018,20/03/2018,0.00,,2.00,,"-219,283.47"
,IN,AR,30317171,1005,100,,Invoice,,,,,,20/03/2018,20/03/2018,0.00,,23.73,,"-219,307.20"
,CN,AR,31017487,1005,100,,Credit Note,,,,,,21/03/2018,21/03/2018,7.29,,0.00,,"-219,299.91"
,CN,AR,31017499,1005,100,,Credit Note,,,,,,21/03/2018,21/03/2018,7.19,,0.00,,"-219,292.72"
,CN,AR,31017567,1005,100,,Credit Note,,,,,,21/03/2018,21/03/2018,7.29,,0.00,,"-219,285.43"
,CN,AR,31017577,1005,100,,Credit Note,,,,,,21/03/2018,21/03/2018,8.24,,0.00,,"-219,277.19"
,CN,AR,31017585,1005,100,,Credit Note,,,,,,21/03/2018,21/03/2018,10.93,,0.00,,"-219,266.26"
,CN,AR,31017656,1005,100,,Credit Note,,,,,,21/03/2018,21/03/2018,10.93,,0.00,,"-219,255.33"
,CN,AR,31017678,1005,100,,Credit Note,,,,,,21/03/2018,21/03/2018,5.85,,0.00,,"-219,249.48"
,CN,AR,31017684,1005,100,,Credit Note,,,,,,21/03/2018,21/03/2018,7.29,,0.00,,"-219,242.19"
,CS,AR,32001713,1005,100,,Cash sale,,,,,,21/03/2018,21/03/2018,0.00,,5.61,,"-219,247.80"
,CS,AR,32001716,1005,100,,Cash sale,,,,,,21/03/2018,21/03/2018,0.00,,28.47,,"-219,276.27"
,CS,AR,32001725,1005,100,,Cash sale,,,,,,21/03/2018,21/03/2018,0.00,,3.64,,"-219,279.91"
,CS,AR,32001728,1005,100,,Cash sale,,,,,,21/03/2018,21/03/2018,0.00,,45.15,,"-219,325.06"
,CS,AR,32001770,1005,100,,Cash sale,,,,,,21/03/2018,21/03/2018,0.00,,3.64,,"-219,328.70"
,CS,AR,32001891,1005,100,,Cash sale,,,,,,21/03/2018,21/03/2018,0.00,,5.86,,"-219,334.56"
,CS,AR,32001947,1005,100,,Cash sale,,,,,,21/03/2018,21/03/2018,0.00,,22.88,,"-219,357.44"
,CS,AR,32001978,1005,100,,Cash sale,,,,,,21/03/2018,21/03/2018,0.00,,7.29,,"-219,364.73"
,CS,AR,32002014,1005,100,,Cash sale,,,,,,21/03/2018,21/03/2018,0.00,,10.93,,"-219,375.66"
,CS,AR,32002112,1005,100,,Cash sale,,,,,,21/03/2018,21/03/2018,0.00,,7.29,,"-219,382.95"
,CS,AR,32002148,1005,100,,Cash sale,,,,,,21/03/2018,21/03/2018,0.00,,18.22,,"-219,401.17"
,CS,AR,32002155,1005,100,,Cash sale,,,,,,21/03/2018,21/03/2018,0.00,,29.15,,"-219,430.32"
,CS,AR,32002187,1005,100,,Cash sale,,,,,,21/03/2018,21/03/2018,0.00,,6.02,,"-219,436.34"
,CS,AR,32002246,1005,100,,Cash sale,,,,,,21/03/2018,21/03/2018,0.00,,5.34,,"-219,441.68"
,CS,AR,32002253,1005,100,,Cash sale,,,,,,21/03/2018,21/03/2018,0.00,,5.34,,"-219,447.02"
,CS,AR,32002262,1005,100,,Cash sale,,,,,,21/03/2018,21/03/2018,0.00,,21.36,,"-219,468.38"
,CS,AR,32002316,1005,100,,Cash sale,,,,,,21/03/2018,21/03/2018,0.00,,7.29,,"-219,475.67"
,CS,AR,32002378,1005,100,,Cash sale,,,,,,21/03/2018,21/03/2018,0.00,,9.15,,"-219,484.82"
,CS,AR,32002387,1005,100,,Cash sale,,,,,,21/03/2018,21/03/2018,0.00,,14.58,,"-219,499.40"
,CS,AR,32002391,1005,100,,Cash sale,,,,,,21/03/2018,21/03/2018,0.00,,9.10,,"-219,508.50"
,CS,AR,32002435,1005,100,,Cash sale,,,,,,21/03/2018,21/03/2018,0.00,,15.18,,"-219,523.68"
,CS,AR,32002459,1005,100,,Cash sale,,,,,,21/03/2018,21/03/2018,0.00,,7.29,,"-219,530.97"
,CS,AR,32002484,1005,100,,Cash sale,,,,,,21/03/2018,21/03/2018,0.00,,9.10,,"-219,540.07"
,CS,AR,32002489,1005,100,,Cash sale,,,,,,21/03/2018,21/03/2018,0.00,,3.64,,"-219,543.71"
,CS,AR,32002495,1005,100,,Cash sale,,,,,,21/03/2018,21/03/2018,0.00,,18.22,,"-219,561.93"
,CS,AR,32002535,1005,100,,Cash sale,,,,,,21/03/2018,21/03/2018,0.00,,10.93,,"-219,572.86"
,CS,AR,32002555,1005,100,,Cash sale,,,,,,21/03/2018,21/03/2018,0.00,,8.25,,"-219,581.11"
,IN,AR,30308821,1005,100,,Invoice,,,,,,21/03/2018,21/03/2018,0.00,,25.51,,"-219,606.62"
,IN,AR,30308834,1005,100,,Invoice,,,,,,21/03/2018,21/03/2018,0.00,,32.80,,"-219,639.42"
,IN,AR,30308841,1005,100,,Invoice,,,,,,21/03/2018,21/03/2018,0.00,,58.58,,"-219,698.00"
,IN,AR,30308851,1005,100,,Invoice,,,,,,21/03/2018,21/03/2018,0.00,,10.85,,"-219,708.85"
,IN,AR,30308871,1005,100,,Invoice,,,,,,21/03/2018,21/03/2018,0.00,,63.05,,"-219,771.90"
,IN,AR,30308872,1005,100,,Invoice,,,,,,21/03/2018,21/03/2018,0.00,,21.02,,"-219,792.92"
,IN,AR,30308878,1005,100,,Invoice,,,,,,21/03/2018,21/03/2018,0.00,,36.44,,"-219,829.36"
,IN,AR,30308912,1005,100,,Invoice,,,,,,21/03/2018,21/03/2018,0.00,,7.29,,"-219,836.65"
,IN,AR,30308922,1005,100,,Invoice,,,,,,21/03/2018,21/03/2018,0.00,,18.37,,"-219,855.02"
,IN,AR,30308926,1005,100,,Invoice,,,,,,21/03/2018,21/03/2018,0.00,,98.97,,"-219,953.99"
,IN,AR,30308956,1005,100,,Invoice,,,,,,21/03/2018,21/03/2018,0.00,,52.20,,"-220,006.19"
,IN,AR,30309001,1005,100,,Invoice,,,,,,21/03/2018,21/03/2018,0.00,,55.14,,"-220,061.33"
,IN,AR,30309045,1005,100,,Invoice,,,,,,21/03/2018,21/03/2018,0.00,,26.00,,"-220,087.33"
,IN,AR,30309074,1005,100,,Invoice,,,,,,21/03/2018,21/03/2018,0.00,,7.29,,"-220,094.62"
,IN,AR,30309090,1005,100,,Invoice,,,,,,21/03/2018,21/03/2018,0.00,,36.00,,"-220,130.62"
,IN,AR,30309099,1005,100,,Invoice,,,,,,21/03/2018,21/03/2018,0.00,,3.64,,"-220,134.26"
,IN,AR,30309104,1005,100,,Invoice,,,,,,21/03/2018,21/03/2018,0.00,,71.19,,"-220,205.45"
,IN,AR,30309153,1005,100,,Invoice,,,,,,21/03/2018,21/03/2018,0.00,,171.92,,"-220,377.37"
,IN,AR,30309220,1005,100,,Invoice,,,,,,21/03/2018,21/03/2018,0.00,,7.96,,"-220,385.33"
,IN,AR,30309243,1005,100,,Invoice,,,,,,21/03/2018,21/03/2018,0.00,,9.56,,"-220,394.89"
,IN,AR,30309333,1005,100,,Invoice,,,,,,21/03/2018,21/03/2018,0.00,,2.12,,"-220,397.01"
,IN,AR,30309336,1005,100,,Invoice,,,,,,21/03/2018,21/03/2018,0.00,,4.24,,"-220,401.25"
,IN,AR,30309357,1005,100,,Invoice,,,,,,21/03/2018,21/03/2018,0.00,,2.80,,"-220,404.05"
,IN,AR,30309385,1005,100,,Invoice,,,,,,21/03/2018,21/03/2018,0.00,,14.83,,"-220,418.88"
,IN,AR,30309391,1005,100,,Invoice,,,,,,21/03/2018,21/03/2018,0.00,,33.46,,"-220,452.34"
,IN,AR,30309406,1005,100,,Invoice,,,,,,21/03/2018,21/03/2018,0.00,,15.04,,"-220,467.38"
,IN,AR,30309413,1005,100,,Invoice,,,,,,21/03/2018,21/03/2018,0.00,,9.56,,"-220,476.94"
,IN,AR,30309447,1005,100,,Invoice,,,,,,21/03/2018,21/03/2018,0.00,,25.42,,"-220,502.36"
,IN,AR,30309453,1005,100,,Invoice,,,,,,21/03/2018,21/03/2018,0.00,,18.22,,"-220,520.58"
,IN,AR,30309488,1005,100,,Invoice,,,,,,21/03/2018,21/03/2018,0.00,,24.07,,"-220,544.65"
,IN,AR,30309520,1005,100,,Invoice,,,,,,21/03/2018,21/03/2018,0.00,,7.75,,"-220,552.40"
,IN,AR,30309524,1005,100,,Invoice,,,,,,21/03/2018,21/03/2018,0.00,,4.24,,"-220,556.64"
,IN,AR,30309619,1005,100,,Invoice,,,,,,21/03/2018,21/03/2018,0.00,,1.59,,"-220,558.23"
,IN,AR,30309644,1005,100,,Invoice,,,,,,21/03/2018,21/03/2018,0.00,,4.24,,"-220,562.47"
,IN,AR,30309713,1005,100,,Invoice,,,,,,21/03/2018,21/03/2018,0.00,,13.63,,"-220,576.10"
,IN,AR,30309731,1005,100,,Invoice,,,,,,21/03/2018,21/03/2018,0.00,,15.00,,"-220,591.10"
,IN,AR,30309757,1005,100,,Invoice,,,,,,21/03/2018,21/03/2018,0.00,,15.25,,"-220,606.35"
,IN,AR,30309839,1005,100,,Invoice,,,,,,21/03/2018,21/03/2018,0.00,,5.61,,"-220,611.96"
,IN,AR,30309851,1005,100,,Invoice,,,,,,21/03/2018,21/03/2018,0.00,,32.63,,"-220,644.59"
,IN,AR,30309857,1005,100,,Invoice,,,,,,21/03/2018,21/03/2018,0.00,,13.73,,"-220,658.32"
,IN,AR,30309871,1005,100,,Invoice,,,,,,21/03/2018,21/03/2018,0.00,,25.17,,"-220,683.49"
,IN,AR,30309897,1005,100,,Invoice,,,,,,21/03/2018,21/03/2018,0.00,,10.93,,"-220,694.42"
,IN,AR,30309906,1005,100,,Invoice,,,,,,21/03/2018,21/03/2018,0.00,,36.36,,"-220,730.78"
,IN,AR,30309922,1005,100,,Invoice,,,,,,21/03/2018,21/03/2018,0.00,,32.00,,"-220,762.78"
,IN,AR,30309935,1005,100,,Invoice,,,,,,21/03/2018,21/03/2018,0.00,,8.14,,"-220,770.92"
,IN,AR,30309987,1005,100,,Invoice,,,,,,21/03/2018,21/03/2018,0.00,,11.14,,"-220,782.06"
,IN,AR,30310007,1005,100,,Invoice,,,,,,21/03/2018,21/03/2018,0.00,,18.05,,"-220,800.11"
,IN,AR,30310021,1005,100,,Invoice,,,,,,21/03/2018,21/03/2018,0.00,,29.15,,"-220,829.26"
,IN,AR,30310075,1005,100,,Invoice,,,,,,21/03/2018,21/03/2018,0.00,,13.14,,"-220,842.40"
,IN,AR,30310089,1005,100,,Invoice,,,,,,21/03/2018,21/03/2018,0.00,,1.76,,"-220,844.16"
,IN,AR,30310090,1005,100,,Invoice,,,,,,21/03/2018,21/03/2018,0.00,,7.05,,"-220,851.21"
,IN,AR,30310097,1005,100,,Invoice,,,,,,21/03/2018,21/03/2018,0.00,,6.02,,"-220,857.23"
,IN,AR,30310120,1005,100,,Invoice,,,,,,21/03/2018,21/03/2018,0.00,,8.24,,"-220,865.47"
,IN,AR,30310152,1005,100,,Invoice,,,,,,21/03/2018,21/03/2018,0.00,,11.70,,"-220,877.17"
,IN,AR,30310208,1005,100,,Invoice,,,,,,21/03/2018,21/03/2018,0.00,,5.17,,"-220,882.34"
,IN,AR,30310278,1005,100,,Invoice,,,,,,21/03/2018,21/03/2018,0.00,,36.00,,"-220,918.34"
,IN,AR,30310293,1005,100,,Invoice,,,,,,21/03/2018,21/03/2018,0.00,,58.13,,"-220,976.47"
,IN,AR,30310319,1005,100,,Invoice,,,,,,21/03/2018,21/03/2018,0.00,,3.64,,"-220,980.11"
,IN,AR,30310325,1005,100,,Invoice,,,,,,21/03/2018,21/03/2018,0.00,,3.64,,"-220,983.75"
,IN,AR,30310369,1005,100,,Invoice,,,,,,21/03/2018,21/03/2018,0.00,,3.20,,"-220,986.95"
,IN,AR,30310370,1005,100,,Invoice,,,,,,21/03/2018,21/03/2018,0.00,,19.24,,"-221,006.19"
,IN,AR,30310371,1005,100,,Invoice,,,,,,21/03/2018,21/03/2018,0.00,,4.81,,"-221,011.00"
,IN,AR,30310372,1005,100,,Invoice,,,,,,21/03/2018,21/03/2018,0.00,,22.45,,"-221,033.45"
,IN,AR,30310373,1005,100,,Invoice,,,,,,21/03/2018,21/03/2018,0.00,,3.20,,"-221,036.65"
,IN,AR,30310374,1005,100,,Invoice,,,,,,21/03/2018,21/03/2018,0.00,,4.81,,"-221,041.46"
,IN,AR,30310375,1005,100,,Invoice,,,,,,21/03/2018,21/03/2018,0.00,,4.81,,"-221,046.27"
,IN,AR,30310376,1005,100,,Invoice,,,,,,21/03/2018,21/03/2018,0.00,,9.62,,"-221,055.89"
,IN,AR,30310397,1005,100,,Invoice,,,,,,21/03/2018,21/03/2018,0.00,,26.27,,"-221,082.16"
,IN,AR,30310402,1005,100,,Invoice,,,,,,21/03/2018,21/03/2018,0.00,,2.29,,"-221,084.45"
,IN,AR,30310414,1005,100,,Invoice,,,,,,21/03/2018,21/03/2018,0.00,,12.73,,"-221,097.18"
,IN,AR,30310426,1005,100,,Invoice,,,,,,21/03/2018,21/03/2018,0.00,,23.28,,"-221,120.46"
,IN,AR,30310510,1005,100,,Invoice,,,,,,21/03/2018,21/03/2018,0.00,,48.26,,"-221,168.72"
,IN,AR,30310518,1005,100,,Invoice,,,,,,21/03/2018,21/03/2018,0.00,,4.53,,"-221,173.25"
,IN,AR,30310543,1005,100,,Invoice,,,,,,21/03/2018,21/03/2018,0.00,,14.72,,"-221,187.97"
,IN,AR,30310547,1005,100,,Invoice,,,,,,21/03/2018,21/03/2018,0.00,,9.03,,"-221,197.00"
,IN,AR,30310587,1005,100,,Invoice,,,,,,21/03/2018,21/03/2018,0.00,,4.59,,"-221,201.59"
,IN,AR,30310600,1005,100,,Invoice,,,,,,21/03/2018,21/03/2018,0.00,,11.19,,"-221,212.78"
,IN,AR,30310609,1005,100,,Invoice,,,,,,21/03/2018,21/03/2018,0.00,,12.85,,"-221,225.63"
,IN,AR,30310624,1005,100,,Invoice,,,,,,21/03/2018,21/03/2018,0.00,,8.17,,"-221,233.80"
,IN,AR,30310650,1005,100,,Invoice,,,,,,21/03/2018,21/03/2018,0.00,,10.93,,"-221,244.73"
,IN,AR,30310678,1005,100,,Invoice,,,,,,21/03/2018,21/03/2018,0.00,,81.15,,"-221,325.88"
,IN,AR,30310704,1005,100,,Invoice,,,,,,21/03/2018,21/03/2018,0.00,,7.97,,"-221,333.85"
,IN,AR,30310705,1005,100,,Invoice,,,,,,21/03/2018,21/03/2018,0.00,,4.78,,"-221,338.63"
,IN,AR,30310806,1005,100,,Invoice,,,,,,21/03/2018,21/03/2018,0.00,,3.51,,"-221,342.14"
,IN,AR,30310872,1005,100,,Invoice,,,,,,21/03/2018,21/03/2018,0.00,,7.53,,"-221,349.67"
,IN,AR,30310914,1005,100,,Invoice,,,,,,21/03/2018,21/03/2018,0.00,,11.19,,"-221,360.86"
,IN,AR,30310962,1005,100,,Invoice,,,,,,21/03/2018,21/03/2018,0.00,,3.64,,"-221,364.50"
,IN,AR,30310976,1005,100,,Invoice,,,,,,21/03/2018,21/03/2018,0.00,,13.94,,"-221,378.44"
,CN,AR,31017482,1005,100,,Credit Note,,,,,,22/03/2018,22/03/2018,"1,580.20",,0.00,,"-219,798.24"
,CN,AR,31017483,1005,100,,Credit Note,,,,,,22/03/2018,22/03/2018,"1,580.20",,0.00,,"-218,218.04"
,CN,AR,31017485,1005,100,,Credit Note,,,,,,22/03/2018,22/03/2018,"1,580.20",,0.00,,"-216,637.84"
,CN,AR,31017550,1005,100,,Credit Note,,,,,,22/03/2018,22/03/2018,20.71,,0.00,,"-216,617.13"
,CN,AR,31017603,1005,100,,Credit Note,,,,,,22/03/2018,22/03/2018,7.29,,0.00,,"-216,609.84"
,CN,AR,31017605,1005,100,,Credit Note,,,,,,22/03/2018,22/03/2018,15.61,,0.00,,"-216,594.23"
,CS,AR,32001707,1005,100,,Cash sale,,,,,,22/03/2018,22/03/2018,0.00,,15.04,,"-216,609.27"
,CS,AR,32001740,1005,100,,Cash sale,,,,,,22/03/2018,22/03/2018,0.00,,3.64,,"-216,612.91"
,CS,AR,32001762,1005,100,,Cash sale,,,,,,22/03/2018,22/03/2018,0.00,,5.17,,"-216,618.08"
,CS,AR,32001773,1005,100,,Cash sale,,,,,,22/03/2018,22/03/2018,0.00,,10.93,,"-216,629.01"
,CS,AR,32001774,1005,100,,Cash sale,,,,,,22/03/2018,22/03/2018,0.00,,3.64,,"-216,632.65"
,CS,AR,32001785,1005,100,,Cash sale,,,,,,22/03/2018,22/03/2018,0.00,,3.64,,"-216,636.29"
,CS,AR,32001803,1005,100,,Cash sale,,,,,,22/03/2018,22/03/2018,0.00,,3.64,,"-216,639.93"
,CS,AR,32001849,1005,100,,Cash sale,,,,,,22/03/2018,22/03/2018,0.00,,3.64,,"-216,643.57"
,CS,AR,32001856,1005,100,,Cash sale,,,,,,22/03/2018,22/03/2018,0.00,,3.64,,"-216,647.21"
,CS,AR,32001869,1005,100,,Cash sale,,,,,,22/03/2018,22/03/2018,0.00,,10.93,,"-216,658.14"
,CS,AR,32001883,1005,100,,Cash sale,,,,,,22/03/2018,22/03/2018,0.00,,6.02,,"-216,664.16"
,CS,AR,32001895,1005,100,,Cash sale,,,,,,22/03/2018,22/03/2018,0.00,,10.93,,"-216,675.09"
,CS,AR,32001925,1005,100,,Cash sale,,,,,,22/03/2018,22/03/2018,0.00,,7.29,,"-216,682.38"
,CS,AR,32001962,1005,100,,Cash sale,,,,,,22/03/2018,22/03/2018,0.00,,7.29,,"-216,689.67"
,CS,AR,32001979,1005,100,,Cash sale,,,,,,22/03/2018,22/03/2018,0.00,,10.93,,"-216,700.60"
,CS,AR,32002037,1005,100,,Cash sale,,,,,,22/03/2018,22/03/2018,0.00,,12.97,,"-216,713.57"
,CS,AR,32002050,1005,100,,Cash sale,,,,,,22/03/2018,22/03/2018,0.00,,6.74,,"-216,720.31"
,CS,AR,32002053,1005,100,,Cash sale,,,,,,22/03/2018,22/03/2018,0.00,,13.47,,"-216,733.78"
,CS,AR,32002077,1005,100,,Cash sale,,,,,,22/03/2018,22/03/2018,0.00,,19.58,,"-216,753.36"
,CS,AR,32002101,1005,100,,Cash sale,,,,,,22/03/2018,22/03/2018,0.00,,13.77,,"-216,767.13"
,CS,AR,32002103,1005,100,,Cash sale,,,,,,22/03/2018,22/03/2018,0.00,,10.93,,"-216,778.06"
,CS,AR,32002108,1005,100,,Cash sale,,,,,,22/03/2018,22/03/2018,0.00,,7.29,,"-216,785.35"
,CS,AR,32002129,1005,100,,Cash sale,,,,,,22/03/2018,22/03/2018,0.00,,54.15,,"-216,839.50"
,CS,AR,32002149,1005,100,,Cash sale,,,,,,22/03/2018,22/03/2018,0.00,,9.66,,"-216,849.16"
,CS,AR,32002151,1005,100,,Cash sale,,,,,,22/03/2018,22/03/2018,0.00,,36.36,,"-216,885.52"
,CS,AR,32002159,1005,100,,Cash sale,,,,,,22/03/2018,22/03/2018,0.00,,12.92,,"-216,898.44"
,CS,AR,32002164,1005,100,,Cash sale,,,,,,22/03/2018,22/03/2018,0.00,,8.77,,"-216,907.21"
,CS,AR,32002192,1005,100,,Cash sale,,,,,,22/03/2018,22/03/2018,0.00,,6.44,,"-216,913.65"
,CS,AR,32002208,1005,100,,Cash sale,,,,,,22/03/2018,22/03/2018,0.00,,5.17,,"-216,918.82"
,CS,AR,32002238,1005,100,,Cash sale,,,,,,22/03/2018,22/03/2018,0.00,,10.93,,"-216,929.75"
,CS,AR,32002244,1005,100,,Cash sale,,,,,,22/03/2018,22/03/2018,0.00,,54.66,,"-216,984.41"
,CS,AR,32002307,1005,100,,Cash sale,,,,,,22/03/2018,22/03/2018,0.00,,2.58,,"-216,986.99"
,CS,AR,32002320,1005,100,,Cash sale,,,,,,22/03/2018,22/03/2018,0.00,,36.44,,"-217,023.43"
,CS,AR,32002348,1005,100,,Cash sale,,,,,,22/03/2018,22/03/2018,0.00,,8.26,,"-217,031.69"
,CS,AR,32002358,1005,100,,Cash sale,,,,,,22/03/2018,22/03/2018,0.00,,6.07,,"-217,037.76"
,CS,AR,32002361,1005,100,,Cash sale,,,,,,22/03/2018,22/03/2018,0.00,,6.07,,"-217,043.83"
,CS,AR,32002368,1005,100,,Cash sale,,,,,,22/03/2018,22/03/2018,0.00,,3.64,,"-217,047.47"
,CS,AR,32002421,1005,100,,Cash sale,,,,,,22/03/2018,22/03/2018,0.00,,14.58,,"-217,062.05"
,CS,AR,32002423,1005,100,,Cash sale,,,,,,22/03/2018,22/03/2018,0.00,,18.22,,"-217,080.27"
,CS,AR,32002440,1005,100,,Cash sale,,,,,,22/03/2018,22/03/2018,0.00,,7.29,,"-217,087.56"
,CS,AR,32002493,1005,100,,Cash sale,,,,,,22/03/2018,22/03/2018,0.00,,3.64,,"-217,091.20"
,CS,AR,32002496,1005,100,,Cash sale,,,,,,22/03/2018,22/03/2018,0.00,,7.29,,"-217,098.49"
,CS,AR,32002510,1005,100,,Cash sale,,,,,,22/03/2018,22/03/2018,0.00,,10.93,,"-217,109.42"
,CS,AR,32002515,1005,100,,Cash sale,,,,,,22/03/2018,22/03/2018,0.00,,3.64,,"-217,113.06"
,CS,AR,32002520,1005,100,,Cash sale,,,,,,22/03/2018,22/03/2018,0.00,,3.64,,"-217,116.70"
,CS,AR,32002521,1005,100,,Cash sale,,,,,,22/03/2018,22/03/2018,0.00,,10.93,,"-217,127.63"
,CS,AR,32002538,1005,100,,Cash sale,,,,,,22/03/2018,22/03/2018,0.00,,14.58,,"-217,142.21"
,CS,AR,32002539,1005,100,,Cash sale,,,,,,22/03/2018,22/03/2018,0.00,,5.86,,"-217,148.07"
,CS,AR,32002545,1005,100,,Cash sale,,,,,,22/03/2018,22/03/2018,0.00,,7.29,,"-217,155.36"
,CS,AR,32002567,1005,100,,Cash sale,,,,,,22/03/2018,22/03/2018,0.00,,10.93,,"-217,166.29"
,CS,AR,32002586,1005,100,,Cash sale,,,,,,22/03/2018,22/03/2018,0.00,,7.29,,"-217,173.58"
,IN,AR,30308802,1005,100,,Invoice,,,,,,22/03/2018,22/03/2018,0.00,,47.46,,"-217,221.04"
,IN,AR,30308803,1005,100,,Invoice,,,,,,22/03/2018,22/03/2018,0.00,,35.59,,"-217,256.63"
,IN,AR,30308815,1005,100,,Invoice,,,,,,22/03/2018,22/03/2018,0.00,,3.64,,"-217,260.27"
,IN,AR,30308829,1005,100,,Invoice,,,,,,22/03/2018,22/03/2018,0.00,,21.86,,"-217,282.13"
,IN,AR,30308836,1005,100,,Invoice,,,,,,22/03/2018,22/03/2018,0.00,,10.93,,"-217,293.06"
,IN,AR,30308842,1005,100,,Invoice,,,,,,22/03/2018,22/03/2018,0.00,,19.53,,"-217,312.59"
,IN,AR,30308863,1005,100,,Invoice,,,,,,22/03/2018,22/03/2018,0.00,,3.64,,"-217,316.23"
,IN,AR,30308886,1005,100,,Invoice,,,,,,22/03/2018,22/03/2018,0.00,,10.93,,"-217,327.16"
,IN,AR,30308889,1005,100,,Invoice,,,,,,22/03/2018,22/03/2018,0.00,,11.22,,"-217,338.38"
,IN,AR,30308896,1005,100,,Invoice,,,,,,22/03/2018,22/03/2018,0.00,,8.14,,"-217,346.52"
,IN,AR,30308901,1005,100,,Invoice,,,,,,22/03/2018,22/03/2018,0.00,,73.97,,"-217,420.49"
,IN,AR,30308918,1005,100,,Invoice,,,,,,22/03/2018,22/03/2018,0.00,,18.22,,"-217,438.71"
,IN,AR,30308957,1005,100,,Invoice,,,,,,22/03/2018,22/03/2018,0.00,,42.71,,"-217,481.42"
,IN,AR,30309020,1005,100,,Invoice,,,,,,22/03/2018,22/03/2018,0.00,,3.64,,"-217,485.06"
,IN,AR,30309052,1005,100,,Invoice,,,,,,22/03/2018,22/03/2018,0.00,,3.64,,"-217,488.70"
,IN,AR,30309137,1005,100,,Invoice,,,,,,22/03/2018,22/03/2018,0.00,,35.69,,"-217,524.39"
,IN,AR,30309163,1005,100,,Invoice,,,,,,22/03/2018,22/03/2018,0.00,,"1,580.20",,"-219,104.59"
,IN,AR,30309186,1005,100,,Invoice,,,,,,22/03/2018,22/03/2018,0.00,,46.00,,"-219,150.59"
,IN,AR,30309264,1005,100,,Invoice,,,,,,22/03/2018,22/03/2018,0.00,,21.00,,"-219,171.59"
,IN,AR,30309375,1005,100,,Invoice,,,,,,22/03/2018,22/03/2018,0.00,,10.93,,"-219,182.52"
,IN,AR,30309400,1005,100,,Invoice,,,,,,22/03/2018,22/03/2018,0.00,,19.12,,"-219,201.64"
,IN,AR,30309424,1005,100,,Invoice,,,,,,22/03/2018,22/03/2018,0.00,,11.86,,"-219,213.50"
,IN,AR,30309454,1005,100,,Invoice,,,,,,22/03/2018,22/03/2018,0.00,,18.05,,"-219,231.55"
,IN,AR,30309466,1005,100,,Invoice,,,,,,22/03/2018,22/03/2018,0.00,,7.17,,"-219,238.72"
,IN,AR,30309483,1005,100,,Invoice,,,,,,22/03/2018,22/03/2018,0.00,,22.54,,"-219,261.26"
,IN,AR,30309501,1005,100,,Invoice,,,,,,22/03/2018,22/03/2018,0.00,,4.24,,"-219,265.50"
,IN,AR,30309560,1005,100,,Invoice,,,,,,22/03/2018,22/03/2018,0.00,,7.29,,"-219,272.79"
,IN,AR,30309569,1005,100,,Invoice,,,,,,22/03/2018,22/03/2018,0.00,,6.36,,"-219,279.15"
,IN,AR,30309575,1005,100,,Invoice,,,,,,22/03/2018,22/03/2018,0.00,,4.78,,"-219,283.93"
,IN,AR,30309594,1005,100,,Invoice,,,,,,22/03/2018,22/03/2018,0.00,,10.17,,"-219,294.10"
,IN,AR,30309595,1005,100,,Invoice,,,,,,22/03/2018,22/03/2018,0.00,,7.63,,"-219,301.73"
,IN,AR,30309620,1005,100,,Invoice,,,,,,22/03/2018,22/03/2018,0.00,,46.20,,"-219,347.93"
,IN,AR,30309621,1005,100,,Invoice,,,,,,22/03/2018,22/03/2018,0.00,,39.83,,"-219,387.76"
,IN,AR,30309629,1005,100,,Invoice,,,,,,22/03/2018,22/03/2018,0.00,,16.55,,"-219,404.31"
,IN,AR,30309640,1005,100,,Invoice,,,,,,22/03/2018,22/03/2018,0.00,,5.17,,"-219,409.48"
,IN,AR,30309694,1005,100,,Invoice,,,,,,22/03/2018,22/03/2018,0.00,,12.71,,"-219,422.19"
,IN,AR,30309696,1005,100,,Invoice,,,,,,22/03/2018,22/03/2018,0.00,,21.19,,"-219,443.38"
,IN,AR,30309704,1005,100,,Invoice,,,,,,22/03/2018,22/03/2018,0.00,,7.29,,"-219,450.67"
,IN,AR,30309706,1005,100,,Invoice,,,,,,22/03/2018,22/03/2018,0.00,,7.29,,"-219,457.96"
,IN,AR,30309777,1005,100,,Invoice,,,,,,22/03/2018,22/03/2018,0.00,,9.03,,"-219,466.99"
,IN,AR,30309793,1005,100,,Invoice,,,,,,22/03/2018,22/03/2018,0.00,,10.93,,"-219,477.92"
,IN,AR,30309794,1005,100,,Invoice,,,,,,22/03/2018,22/03/2018,0.00,,8.47,,"-219,486.39"
,IN,AR,30309817,1005,100,,Invoice,,,,,,22/03/2018,22/03/2018,0.00,,54.66,,"-219,541.05"
,IN,AR,30309826,1005,100,,Invoice,,,,,,22/03/2018,22/03/2018,0.00,,13.73,,"-219,554.78"
,IN,AR,30309865,1005,100,,Invoice,,,,,,22/03/2018,22/03/2018,0.00,,14.00,,"-219,568.78"
,IN,AR,30309915,1005,100,,Invoice,,,,,,22/03/2018,22/03/2018,0.00,,10.17,,"-219,578.95"
,IN,AR,30309939,1005,100,,Invoice,,,,,,22/03/2018,22/03/2018,0.00,,4.64,,"-219,583.59"
,IN,AR,30309947,1005,100,,Invoice,,,,,,22/03/2018,22/03/2018,0.00,,5.85,,"-219,589.44"
,IN,AR,30309963,1005,100,,Invoice,,,,,,22/03/2018,22/03/2018,0.00,,11.02,,"-219,600.46"
,IN,AR,30310023,1005,100,,Invoice,,,,,,22/03/2018,22/03/2018,0.00,,10.99,,"-219,611.45"
,IN,AR,30310035,1005,100,,Invoice,,,,,,22/03/2018,22/03/2018,0.00,,17.47,,"-219,628.92"
,IN,AR,30310040,1005,100,,Invoice,,,,,,22/03/2018,22/03/2018,0.00,,5.08,,"-219,634.00"
,IN,AR,30310045,1005,100,,Invoice,,,,,,22/03/2018,22/03/2018,0.00,,6.53,,"-219,640.53"
,IN,AR,30310050,1005,100,,Invoice,,,,,,22/03/2018,22/03/2018,0.00,,28.39,,"-219,668.92"
,IN,AR,30310057,1005,100,,Invoice,,,,,,22/03/2018,22/03/2018,0.00,,8.00,,"-219,676.92"
,IN,AR,30310091,1005,100,,Invoice,,,,,,22/03/2018,22/03/2018,0.00,,3.53,,"-219,680.45"
,IN,AR,30310092,1005,100,,Invoice,,,,,,22/03/2018,22/03/2018,0.00,,3.53,,"-219,683.98"
,IN,AR,30310093,1005,100,,Invoice,,,,,,22/03/2018,22/03/2018,0.00,,3.53,,"-219,687.51"
,IN,AR,30310102,1005,100,,Invoice,,,,,,22/03/2018,22/03/2018,0.00,,10.93,,"-219,698.44"
,IN,AR,30310114,1005,100,,Invoice,,,,,,22/03/2018,22/03/2018,0.00,,11.36,,"-219,709.80"
,IN,AR,30310116,1005,100,,Invoice,,,,,,22/03/2018,22/03/2018,0.00,,7.29,,"-219,717.09"
,IN,AR,30310129,1005,100,,Invoice,,,,,,22/03/2018,22/03/2018,0.00,,10.93,,"-219,728.02"
,IN,AR,30310164,1005,100,,Invoice,,,,,,22/03/2018,22/03/2018,0.00,,10.93,,"-219,738.95"
,IN,AR,30310165,1005,100,,Invoice,,,,,,22/03/2018,22/03/2018,0.00,,36.44,,"-219,775.39"
,IN,AR,30310212,1005,100,,Invoice,,,,,,22/03/2018,22/03/2018,0.00,,10.93,,"-219,786.32"
,IN,AR,30310215,1005,100,,Invoice,,,,,,22/03/2018,22/03/2018,0.00,,10.17,,"-219,796.49"
,IN,AR,30310239,1005,100,,Invoice,,,,,,22/03/2018,22/03/2018,0.00,,13.02,,"-219,809.51"
,IN,AR,30310240,1005,100,,Invoice,,,,,,22/03/2018,22/03/2018,0.00,,11.39,,"-219,820.90"
,IN,AR,30310241,1005,100,,Invoice,,,,,,22/03/2018,22/03/2018,0.00,,4.88,,"-219,825.78"
,IN,AR,30310242,1005,100,,Invoice,,,,,,22/03/2018,22/03/2018,0.00,,21.15,,"-219,846.93"
,IN,AR,30310256,1005,100,,Invoice,,,,,,22/03/2018,22/03/2018,0.00,,7.95,,"-219,854.88"
,IN,AR,30310286,1005,100,,Invoice,,,,,,22/03/2018,22/03/2018,0.00,,31.42,,"-219,886.30"
,IN,AR,30310334,1005,100,,Invoice,,,,,,22/03/2018,22/03/2018,0.00,,28.09,,"-219,914.39"
,IN,AR,30310377,1005,100,,Invoice,,,,,,22/03/2018,22/03/2018,0.00,,9.62,,"-219,924.01"
,IN,AR,30310378,1005,100,,Invoice,,,,,,22/03/2018,22/03/2018,0.00,,6.42,,"-219,930.43"
,IN,AR,30310408,1005,100,,Invoice,,,,,,22/03/2018,22/03/2018,0.00,,13.12,,"-219,943.55"
,IN,AR,30310423,1005,100,,Invoice,,,,,,22/03/2018,22/03/2018,0.00,,12.14,,"-219,955.69"
,IN,AR,30310459,1005,100,,Invoice,,,,,,22/03/2018,22/03/2018,0.00,,5.08,,"-219,960.77"
,IN,AR,30310466,1005,100,,Invoice,,,,,,22/03/2018,22/03/2018,0.00,,14.58,,"-219,975.35"
,IN,AR,30310470,1005,100,,Invoice,,,,,,22/03/2018,22/03/2018,0.00,,26.01,,"-220,001.36"
,IN,AR,30310483,1005,100,,Invoice,,,,,,22/03/2018,22/03/2018,0.00,,20.01,,"-220,021.37"
,IN,AR,30310502,1005,100,,Invoice,,,,,,22/03/2018,22/03/2018,0.00,,8.75,,"-220,030.12"
,IN,AR,30310503,1005,100,,Invoice,,,,,,22/03/2018,22/03/2018,0.00,,11.66,,"-220,041.78"
,IN,AR,30310529,1005,100,,Invoice,,,,,,22/03/2018,22/03/2018,0.00,,14.58,,"-220,056.36"
,IN,AR,30310552,1005,100,,Invoice,,,,,,22/03/2018,22/03/2018,0.00,,25.51,,"-220,081.87"
,IN,AR,30310582,1005,100,,Invoice,,,,,,22/03/2018,22/03/2018,0.00,,8.42,,"-220,090.29"
,IN,AR,30310593,1005,100,,Invoice,,,,,,22/03/2018,22/03/2018,0.00,,13.73,,"-220,104.02"
,IN,AR,30310706,1005,100,,Invoice,,,,,,22/03/2018,22/03/2018,0.00,,3.19,,"-220,107.21"
,IN,AR,30310707,1005,100,,Invoice,,,,,,22/03/2018,22/03/2018,0.00,,129.05,,"-220,236.26"
,IN,AR,30310708,1005,100,,Invoice,,,,,,22/03/2018,22/03/2018,0.00,,11.15,,"-220,247.41"
,IN,AR,30310709,1005,100,,Invoice,,,,,,22/03/2018,22/03/2018,0.00,,7.97,,"-220,255.38"
,IN,AR,30310775,1005,100,,Invoice,,,,,,22/03/2018,22/03/2018,0.00,,16.27,,"-220,271.65"
,IN,AR,30310850,1005,100,,Invoice,,,,,,22/03/2018,22/03/2018,0.00,,10.59,,"-220,282.24"
,IN,AR,30310861,1005,100,,Invoice,,,,,,22/03/2018,22/03/2018,0.00,,10.93,,"-220,293.17"
,IN,AR,30310875,1005,100,,Invoice,,,,,,22/03/2018,22/03/2018,0.00,,29.15,,"-220,322.32"
,IN,AR,30310891,1005,100,,Invoice,,,,,,22/03/2018,22/03/2018,0.00,,21.86,,"-220,344.18"
,IN,AR,30310908,1005,100,,Invoice,,,,,,22/03/2018,22/03/2018,0.00,,14.83,,"-220,359.01"
,IN,AR,30310930,1005,100,,Invoice,,,,,,22/03/2018,22/03/2018,0.00,,29.15,,"-220,388.16"
,IN,AR,30310936,1005,100,,Invoice,,,,,,22/03/2018,22/03/2018,0.00,,25.51,,"-220,413.67"
,IN,AR,30310959,1005,100,,Invoice,,,,,,22/03/2018,22/03/2018,0.00,,25.51,,"-220,439.18"
,IN,AR,30311056,1005,100,,Invoice,,,,,,22/03/2018,22/03/2018,0.00,,72.88,,"-220,512.06"
,IN,AR,30311063,1005,100,,Invoice,,,,,,22/03/2018,22/03/2018,0.00,,182.20,,"-220,694.26"
,CN,AR,31017478,1005,100,,Credit Note,,,,,,23/03/2018,23/03/2018,66.10,,0.00,,"-220,628.16"
,CS,AR,32001736,1005,100,,Cash sale,,,,,,23/03/2018,23/03/2018,0.00,,14.24,,"-220,642.40"
,CS,AR,32001742,1005,100,,Cash sale,,,,,,23/03/2018,23/03/2018,0.00,,8.52,,"-220,650.92"
,CS,AR,32001749,1005,100,,Cash sale,,,,,,23/03/2018,23/03/2018,0.00,,3.04,,"-220,653.96"
,CS,AR,32001776,1005,100,,Cash sale,,,,,,23/03/2018,23/03/2018,0.00,,14.58,,"-220,668.54"
,CS,AR,32001788,1005,100,,Cash sale,,,,,,23/03/2018,23/03/2018,0.00,,18.05,,"-220,686.59"
,CS,AR,32001790,1005,100,,Cash sale,,,,,,23/03/2018,23/03/2018,0.00,,18.22,,"-220,704.81"
,CS,AR,32001796,1005,100,,Cash sale,,,,,,23/03/2018,23/03/2018,0.00,,9.66,,"-220,714.47"
,CS,AR,32001810,1005,100,,Cash sale,,,,,,23/03/2018,23/03/2018,0.00,,21.36,,"-220,735.83"
,CS,AR,32001816,1005,100,,Cash sale,,,,,,23/03/2018,23/03/2018,0.00,,10.93,,"-220,746.76"
,CS,AR,32001826,1005,100,,Cash sale,,,,,,23/03/2018,23/03/2018,0.00,,18.69,,"-220,765.45"
,CS,AR,32001865,1005,100,,Cash sale,,,,,,23/03/2018,23/03/2018,0.00,,8.39,,"-220,773.84"
,CS,AR,32001874,1005,100,,Cash sale,,,,,,23/03/2018,23/03/2018,0.00,,23.29,,"-220,797.13"
,CS,AR,32001881,1005,100,,Cash sale,,,,,,23/03/2018,23/03/2018,0.00,,21.86,,"-220,818.99"
,CS,AR,32001909,1005,100,,Cash sale,,,,,,23/03/2018,23/03/2018,0.00,,29.15,,"-220,848.14"
,CS,AR,32001933,1005,100,,Cash sale,,,,,,23/03/2018,23/03/2018,0.00,,29.15,,"-220,877.29"
,CS,AR,32001936,1005,100,,Cash sale,,,,,,23/03/2018,23/03/2018,0.00,,5.17,,"-220,882.46"
,CS,AR,32001948,1005,100,,Cash sale,,,,,,23/03/2018,23/03/2018,0.00,,2.54,,"-220,885.00"
,CS,AR,32001952,1005,100,,Cash sale,,,,,,23/03/2018,23/03/2018,0.00,,5.59,,"-220,890.59"
,CS,AR,32001972,1005,100,,Cash sale,,,,,,23/03/2018,23/03/2018,0.00,,10.99,,"-220,901.58"
,CS,AR,32001988,1005,100,,Cash sale,,,,,,23/03/2018,23/03/2018,0.00,,21.98,,"-220,923.56"
,CS,AR,32001999,1005,100,,Cash sale,,,,,,23/03/2018,23/03/2018,0.00,,3.64,,"-220,927.20"
,CS,AR,32002007,1005,100,,Cash sale,,,,,,23/03/2018,23/03/2018,0.00,,9.03,,"-220,936.23"
,CS,AR,32002008,1005,100,,Cash sale,,,,,,23/03/2018,23/03/2018,0.00,,3.01,,"-220,939.24"
,CS,AR,32002011,1005,100,,Cash sale,,,,,,23/03/2018,23/03/2018,0.00,,14.58,,"-220,953.82"
,CS,AR,32002026,1005,100,,Cash sale,,,,,,23/03/2018,23/03/2018,0.00,,3.01,,"-220,956.83"
,CS,AR,32002047,1005,100,,Cash sale,,,,,,23/03/2018,23/03/2018,0.00,,23.39,,"-220,980.22"
,CS,AR,32002061,1005,100,,Cash sale,,,,,,23/03/2018,23/03/2018,0.00,,6.02,,"-220,986.24"
,CS,AR,32002074,1005,100,,Cash sale,,,,,,23/03/2018,23/03/2018,0.00,,36.10,,"-221,022.34"
,CS,AR,32002095,1005,100,,Cash sale,,,,,,23/03/2018,23/03/2018,0.00,,10.93,,"-221,033.27"
,CS,AR,32002107,1005,100,,Cash sale,,,,,,23/03/2018,23/03/2018,0.00,,3.64,,"-221,036.91"
,CS,AR,32002167,1005,100,,Cash sale,,,,,,23/03/2018,23/03/2018,0.00,,25.51,,"-221,062.42"
,CS,AR,32002196,1005,100,,Cash sale,,,,,,23/03/2018,23/03/2018,0.00,,7.29,,"-221,069.71"
,CS,AR,32002235,1005,100,,Cash sale,,,,,,23/03/2018,23/03/2018,0.00,,11.12,,"-221,080.83"
,CS,AR,32002256,1005,100,,Cash sale,,,,,,23/03/2018,23/03/2018,0.00,,7.29,,"-221,088.12"
,CS,AR,32002282,1005,100,,Cash sale,,,,,,23/03/2018,23/03/2018,0.00,,22.88,,"-221,111.00"
,CS,AR,32002303,1005,100,,Cash sale,,,,,,23/03/2018,23/03/2018,0.00,,4.08,,"-221,115.08"
,CS,AR,32002311,1005,100,,Cash sale,,,,,,23/03/2018,23/03/2018,0.00,,7.29,,"-221,122.37"
,CS,AR,32002336,1005,100,,Cash sale,,,,,,23/03/2018,23/03/2018,0.00,,34.00,,"-221,156.37"
,CS,AR,32002341,1005,100,,Cash sale,,,,,,23/03/2018,23/03/2018,0.00,,3.64,,"-221,160.01"
,CS,AR,32002345,1005,100,,Cash sale,,,,,,23/03/2018,23/03/2018,0.00,,10.17,,"-221,170.18"
,CS,AR,32002379,1005,100,,Cash sale,,,,,,23/03/2018,23/03/2018,0.00,,6.86,,"-221,177.04"
,CS,AR,32002407,1005,100,,Cash sale,,,,,,23/03/2018,23/03/2018,0.00,,8.90,,"-221,185.94"
,CS,AR,32002408,1005,100,,Cash sale,,,,,,23/03/2018,23/03/2018,0.00,,7.63,,"-221,193.57"
,CS,AR,32002414,1005,100,,Cash sale,,,,,,23/03/2018,23/03/2018,0.00,,7.29,,"-221,200.86"
,CS,AR,32002433,1005,100,,Cash sale,,,,,,23/03/2018,23/03/2018,0.00,,18.22,,"-221,219.08"
,CS,AR,32002474,1005,100,,Cash sale,,,,,,23/03/2018,23/03/2018,0.00,,9.15,,"-221,228.23"
,CS,AR,32002511,1005,100,,Cash sale,,,,,,23/03/2018,23/03/2018,0.00,,7.29,,"-221,235.52"
,CS,AR,32002528,1005,100,,Cash sale,,,,,,23/03/2018,23/03/2018,0.00,,10.93,,"-221,246.45"
,CS,AR,32002540,1005,100,,Cash sale,,,,,,23/03/2018,23/03/2018,0.00,,6.07,,"-221,252.52"
,CS,AR,32002577,1005,100,,Cash sale,,,,,,23/03/2018,23/03/2018,0.00,,14.58,,"-221,267.10"
,IN,AR,30308804,1005,100,,Invoice,,,,,,23/03/2018,23/03/2018,0.00,,44.49,,"-221,311.59"
,IN,AR,30308811,1005,100,,Invoice,,,,,,23/03/2018,23/03/2018,0.00,,7.29,,"-221,318.88"
,IN,AR,30308855,1005,100,,Invoice,,,,,,23/03/2018,23/03/2018,0.00,,18.22,,"-221,337.10"
,IN,AR,30308866,1005,100,,Invoice,,,,,,23/03/2018,23/03/2018,0.00,,7.29,,"-221,344.39"
,IN,AR,30308884,1005,100,,Invoice,,,,,,23/03/2018,23/03/2018,0.00,,16.91,,"-221,361.30"
,IN,AR,30308897,1005,100,,Invoice,,,,,,23/03/2018,23/03/2018,0.00,,28.47,,"-221,389.77"
,IN,AR,30308927,1005,100,,Invoice,,,,,,23/03/2018,23/03/2018,0.00,,17.47,,"-221,407.24"
,IN,AR,30308938,1005,100,,Invoice,,,,,,23/03/2018,23/03/2018,0.00,,15.93,,"-221,423.17"
,IN,AR,30308958,1005,100,,Invoice,,,,,,23/03/2018,23/03/2018,0.00,,56.95,,"-221,480.12"
,IN,AR,30308983,1005,100,,Invoice,,,,,,23/03/2018,23/03/2018,0.00,,44.00,,"-221,524.12"
,IN,AR,30309025,1005,100,,Invoice,,,,,,23/03/2018,23/03/2018,0.00,,29.15,,"-221,553.27"
,IN,AR,30309046,1005,100,,Invoice,,,,,,23/03/2018,23/03/2018,0.00,,34.00,,"-221,587.27"
,IN,AR,30309085,1005,100,,Invoice,,,,,,23/03/2018,23/03/2018,0.00,,3.89,,"-221,591.16"
,IN,AR,30309105,1005,100,,Invoice,,,,,,23/03/2018,23/03/2018,0.00,,7.12,,"-221,598.28"
,IN,AR,30309108,1005,100,,Invoice,,,,,,23/03/2018,23/03/2018,0.00,,58.25,,"-221,656.53"
,IN,AR,30309109,1005,100,,Invoice,,,,,,23/03/2018,23/03/2018,0.00,,19.45,,"-221,675.98"
,IN,AR,30309110,1005,100,,Invoice,,,,,,23/03/2018,23/03/2018,0.00,,26.82,,"-221,702.80"
,IN,AR,30309111,1005,100,,Invoice,,,,,,23/03/2018,23/03/2018,0.00,,22.35,,"-221,725.15"
,IN,AR,30309119,1005,100,,Invoice,,,,,,23/03/2018,23/03/2018,0.00,,18.00,,"-221,743.15"
,IN,AR,30309170,1005,100,,Invoice,,,,,,23/03/2018,23/03/2018,0.00,,11.64,,"-221,754.79"
,IN,AR,30309174,1005,100,,Invoice,,,,,,23/03/2018,23/03/2018,0.00,,83.64,,"-221,838.43"
,IN,AR,30309178,1005,100,,Invoice,,,,,,23/03/2018,23/03/2018,0.00,,2.80,,"-221,841.23"
,IN,AR,30309181,1005,100,,Invoice,,,,,,23/03/2018,23/03/2018,0.00,,7.29,,"-221,848.52"
,IN,AR,30309189,1005,100,,Invoice,,,,,,23/03/2018,23/03/2018,0.00,,7.29,,"-221,855.81"
,IN,AR,30309207,1005,100,,Invoice,,,,,,23/03/2018,23/03/2018,0.00,,19.58,,"-221,875.39"
,IN,AR,30309244,1005,100,,Invoice,,,,,,23/03/2018,23/03/2018,0.00,,22.31,,"-221,897.70"
,IN,AR,30309273,1005,100,,Invoice,,,,,,23/03/2018,23/03/2018,0.00,,5.17,,"-221,902.87"
,IN,AR,30309296,1005,100,,Invoice,,,,,,23/03/2018,23/03/2018,0.00,,16.79,,"-221,919.66"
,IN,AR,30309314,1005,100,,Invoice,,,,,,23/03/2018,23/03/2018,0.00,,25.42,,"-221,945.08"
,IN,AR,30309366,1005,100,,Invoice,,,,,,23/03/2018,23/03/2018,0.00,,10.34,,"-221,955.42"
,IN,AR,30309373,1005,100,,Invoice,,,,,,23/03/2018,23/03/2018,0.00,,7.17,,"-221,962.59"
,IN,AR,30309380,1005,100,,Invoice,,,,,,23/03/2018,23/03/2018,0.00,,181.77,,"-222,144.36"
,IN,AR,30309434,1005,100,,Invoice,,,,,,23/03/2018,23/03/2018,0.00,,67.68,,"-222,212.04"
,IN,AR,30309437,1005,100,,Invoice,,,,,,23/03/2018,23/03/2018,0.00,,16.83,,"-222,228.87"
,IN,AR,30309467,1005,100,,Invoice,,,,,,23/03/2018,23/03/2018,0.00,,14.34,,"-222,243.21"
,IN,AR,30309499,1005,100,,Invoice,,,,,,23/03/2018,23/03/2018,0.00,,7.29,,"-222,250.50"
,IN,AR,30309512,1005,100,,Invoice,,,,,,23/03/2018,23/03/2018,0.00,,10.93,,"-222,261.43"
,IN,AR,30309533,1005,100,,Invoice,,,,,,23/03/2018,23/03/2018,0.00,,21.19,,"-222,282.62"
,IN,AR,30309557,1005,100,,Invoice,,,,,,23/03/2018,23/03/2018,0.00,,10.17,,"-222,292.79"
,IN,AR,30309596,1005,100,,Invoice,,,,,,23/03/2018,23/03/2018,0.00,,7.63,,"-222,300.42"
,IN,AR,30309597,1005,100,,Invoice,,,,,,23/03/2018,23/03/2018,0.00,,2.54,,"-222,302.96"
,IN,AR,30309607,1005,100,,Invoice,,,,,,23/03/2018,23/03/2018,0.00,,5.08,,"-222,308.04"
,IN,AR,30309636,1005,100,,Invoice,,,,,,23/03/2018,23/03/2018,0.00,,54.38,,"-222,362.42"
,IN,AR,30309724,1005,100,,Invoice,,,,,,23/03/2018,23/03/2018,0.00,,22.88,,"-222,385.30"
,IN,AR,30309771,1005,100,,Invoice,,,,,,23/03/2018,23/03/2018,0.00,,7.29,,"-222,392.59"
,IN,AR,30309878,1005,100,,Invoice,,,,,,23/03/2018,23/03/2018,0.00,,14.58,,"-222,407.17"
,IN,AR,30309973,1005,100,,Invoice,,,,,,23/03/2018,23/03/2018,0.00,,12.92,,"-222,420.09"
,IN,AR,30309996,1005,100,,Invoice,,,,,,23/03/2018,23/03/2018,0.00,,18.22,,"-222,438.31"
,IN,AR,30310012,1005,100,,Invoice,,,,,,23/03/2018,23/03/2018,0.00,,27.08,,"-222,465.39"
,IN,AR,30310108,1005,100,,Invoice,,,,,,23/03/2018,23/03/2018,0.00,,7.27,,"-222,472.66"
,IN,AR,30310110,1005,100,,Invoice,,,,,,23/03/2018,23/03/2018,0.00,,54.66,,"-222,527.32"
,IN,AR,30310218,1005,100,,Invoice,,,,,,23/03/2018,23/03/2018,0.00,,17.80,,"-222,545.12"
,IN,AR,30310265,1005,100,,Invoice,,,,,,23/03/2018,23/03/2018,0.00,,12.98,,"-222,558.10"
,IN,AR,30310272,1005,100,,Invoice,,,,,,23/03/2018,23/03/2018,0.00,,25.55,,"-222,583.65"
,IN,AR,30310301,1005,100,,Invoice,,,,,,23/03/2018,23/03/2018,0.00,,54.12,,"-222,637.77"
,IN,AR,30310328,1005,100,,Invoice,,,,,,23/03/2018,23/03/2018,0.00,,18.05,,"-222,655.82"
,IN,AR,30310379,1005,100,,Invoice,,,,,,23/03/2018,23/03/2018,0.00,,54.52,,"-222,710.34"
,IN,AR,30310392,1005,100,,Invoice,,,,,,23/03/2018,23/03/2018,0.00,,28.03,,"-222,738.37"
,IN,AR,30310433,1005,100,,Invoice,,,,,,23/03/2018,23/03/2018,0.00,,21.52,,"-222,759.89"
,IN,AR,30310460,1005,100,,Invoice,,,,,,23/03/2018,23/03/2018,0.00,,25.42,,"-222,785.31"
,IN,AR,30310486,1005,100,,Invoice,,,,,,23/03/2018,23/03/2018,0.00,,18.01,,"-222,803.32"
,IN,AR,30310535,1005,100,,Invoice,,,,,,23/03/2018,23/03/2018,0.00,,24.64,,"-222,827.96"
,IN,AR,30310544,1005,100,,Invoice,,,,,,23/03/2018,23/03/2018,0.00,,10.52,,"-222,838.48"
,IN,AR,30310614,1005,100,,Invoice,,,,,,23/03/2018,23/03/2018,0.00,,132.00,,"-222,970.48"
,IN,AR,30310630,1005,100,,Invoice,,,,,,23/03/2018,23/03/2018,0.00,,2.08,,"-222,972.56"
,IN,AR,30310663,1005,100,,Invoice,,,,,,23/03/2018,23/03/2018,0.00,,11.36,,"-222,983.92"
,IN,AR,30310668,1005,100,,Invoice,,,,,,23/03/2018,23/03/2018,0.00,,12.08,,"-222,996.00"
,IN,AR,30310723,1005,100,,Invoice,,,,,,23/03/2018,23/03/2018,0.00,,9.13,,"-223,005.13"
,IN,AR,30310756,1005,100,,Invoice,,,,,,23/03/2018,23/03/2018,0.00,,44.24,,"-223,049.37"
,IN,AR,30310789,1005,100,,Invoice,,,,,,23/03/2018,23/03/2018,0.00,,8.00,,"-223,057.37"
,IN,AR,30310865,1005,100,,Invoice,,,,,,23/03/2018,23/03/2018,0.00,,46.61,,"-223,103.98"
,IN,AR,30310923,1005,100,,Invoice,,,,,,23/03/2018,23/03/2018,0.00,,12.25,,"-223,116.23"
,IN,AR,30310981,1005,100,,Invoice,,,,,,23/03/2018,23/03/2018,0.00,,182.20,,"-223,298.43"
,IN,AR,30310985,1005,100,,Invoice,,,,,,23/03/2018,23/03/2018,0.00,,58.47,,"-223,356.90"
,IN,AR,30311040,1005,100,,Invoice,,,,,,23/03/2018,23/03/2018,0.00,,4.00,,"-223,360.90"
,IN,AR,30311041,1005,100,,Invoice,,,,,,23/03/2018,23/03/2018,0.00,,4.00,,"-223,364.90"
,IN,AR,30311049,1005,100,,Invoice,,,,,,23/03/2018,23/03/2018,0.00,,103.81,,"-223,468.71"
,IN,AR,30311050,1005,100,,Invoice,,,,,,23/03/2018,23/03/2018,0.00,,41.53,,"-223,510.24"
,IN,AR,30311062,1005,100,,Invoice,,,,,,23/03/2018,23/03/2018,0.00,,6.42,,"-223,516.66"
,IN,AR,30311066,1005,100,,Invoice,,,,,,23/03/2018,23/03/2018,0.00,,419.07,,"-223,935.73"
,CS,AR,32001755,1005,100,,Cash sale,,,,,,24/03/2018,24/03/2018,0.00,,12.03,,"-223,947.76"
,CS,AR,32002051,1005,100,,Cash sale,,,,,,24/03/2018,24/03/2018,0.00,,6.74,,"-223,954.50"
,CS,AR,32002091,1005,100,,Cash sale,,,,,,24/03/2018,24/03/2018,0.00,,7.29,,"-223,961.79"
,CS,AR,32002140,1005,100,,Cash sale,,,,,,24/03/2018,24/03/2018,0.00,,6.02,,"-223,967.81"
,CS,AR,32002210,1005,100,,Cash sale,,,,,,24/03/2018,24/03/2018,0.00,,10.93,,"-223,978.74"
,CS,AR,32002215,1005,100,,Cash sale,,,,,,24/03/2018,24/03/2018,0.00,,9.03,,"-223,987.77"
,CS,AR,32002419,1005,100,,Cash sale,,,,,,24/03/2018,24/03/2018,0.00,,10.93,,"-223,998.70"
,CS,AR,32002420,1005,100,,Cash sale,,,,,,24/03/2018,24/03/2018,0.00,,25.51,,"-224,024.21"
,IN,AR,30308807,1005,100,,Invoice,,,,,,24/03/2018,24/03/2018,0.00,,15.04,,"-224,039.25"
,IN,AR,30309316,1005,100,,Invoice,,,,,,24/03/2018,24/03/2018,0.00,,9.03,,"-224,048.28"
,IN,AR,30309416,1005,100,,Invoice,,,,,,24/03/2018,24/03/2018,0.00,,204.07,,"-224,252.35"
,IN,AR,30309840,1005,100,,Invoice,,,,,,24/03/2018,24/03/2018,0.00,,19.64,,"-224,271.99"
,IN,AR,30309954,1005,100,,Invoice,,,,,,24/03/2018,24/03/2018,0.00,,29.15,,"-224,301.14"
,IN,AR,30309979,1005,100,,Invoice,,,,,,24/03/2018,24/03/2018,0.00,,12.97,,"-224,314.11"
,IN,AR,30310627,1005,100,,Invoice,,,,,,24/03/2018,24/03/2018,0.00,,10.93,,"-224,325.04"
,CN,AR,31017536,1005,100,,Credit Note,,,,,,26/03/2018,26/03/2018,54.66,,0.00,,"-224,270.38"
,CN,AR,31017546,1005,100,,Credit Note,,,,,,26/03/2018,26/03/2018,29.15,,0.00,,"-224,241.23"
,CN,AR,31017551,1005,100,,Credit Note,,,,,,26/03/2018,26/03/2018,29.15,,0.00,,"-224,212.08"
,CS,AR,32001737,1005,100,,Cash sale,,,,,,26/03/2018,26/03/2018,0.00,,9.49,,"-224,221.57"
,CS,AR,32001752,1005,100,,Cash sale,,,,,,26/03/2018,26/03/2018,0.00,,10.93,,"-224,232.50"
,CS,AR,32001827,1005,100,,Cash sale,,,,,,26/03/2018,26/03/2018,0.00,,14.53,,"-224,247.03"
,CS,AR,32001832,1005,100,,Cash sale,,,,,,26/03/2018,26/03/2018,0.00,,7.29,,"-224,254.32"
,CS,AR,32001866,1005,100,,Cash sale,,,,,,26/03/2018,26/03/2018,0.00,,3.64,,"-224,257.96"
,CS,AR,32001878,1005,100,,Cash sale,,,,,,26/03/2018,26/03/2018,0.00,,14.58,,"-224,272.54"
,CS,AR,32001887,1005,100,,Cash sale,,,,,,26/03/2018,26/03/2018,0.00,,3.64,,"-224,276.18"
,CS,AR,32001898,1005,100,,Cash sale,,,,,,26/03/2018,26/03/2018,0.00,,7.29,,"-224,283.47"
,CS,AR,32001908,1005,100,,Cash sale,,,,,,26/03/2018,26/03/2018,0.00,,10.34,,"-224,293.81"
,CS,AR,32001929,1005,100,,Cash sale,,,,,,26/03/2018,26/03/2018,0.00,,7.29,,"-224,301.10"
,CS,AR,32001949,1005,100,,Cash sale,,,,,,26/03/2018,26/03/2018,0.00,,10.17,,"-224,311.27"
,CS,AR,32001968,1005,100,,Cash sale,,,,,,26/03/2018,26/03/2018,0.00,,15.51,,"-224,326.78"
,CS,AR,32001997,1005,100,,Cash sale,,,,,,26/03/2018,26/03/2018,0.00,,2.58,,"-224,329.36"
,CS,AR,32002002,1005,100,,Cash sale,,,,,,26/03/2018,26/03/2018,0.00,,3.64,,"-224,333.00"
,CS,AR,32002019,1005,100,,Cash sale,,,,,,26/03/2018,26/03/2018,0.00,,3.64,,"-224,336.64"
,CS,AR,32002048,1005,100,,Cash sale,,,,,,26/03/2018,26/03/2018,0.00,,14.62,,"-224,351.26"
,CS,AR,32002057,1005,100,,Cash sale,,,,,,26/03/2018,26/03/2018,0.00,,13.60,,"-224,364.86"
,CS,AR,32002075,1005,100,,Cash sale,,,,,,26/03/2018,26/03/2018,0.00,,18.05,,"-224,382.91"
,CS,AR,32002082,1005,100,,Cash sale,,,,,,26/03/2018,26/03/2018,0.00,,4.32,,"-224,387.23"
,CS,AR,32002114,1005,100,,Cash sale,,,,,,26/03/2018,26/03/2018,0.00,,5.08,,"-224,392.31"
,CS,AR,32002135,1005,100,,Cash sale,,,,,,26/03/2018,26/03/2018,0.00,,5.08,,"-224,397.39"
,CS,AR,32002229,1005,100,,Cash sale,,,,,,26/03/2018,26/03/2018,0.00,,6.08,,"-224,403.47"
,CS,AR,32002233,1005,100,,Cash sale,,,,,,26/03/2018,26/03/2018,0.00,,7.29,,"-224,410.76"
,CS,AR,32002258,1005,100,,Cash sale,,,,,,26/03/2018,26/03/2018,0.00,,7.29,,"-224,418.05"
,CS,AR,32002265,1005,100,,Cash sale,,,,,,26/03/2018,26/03/2018,0.00,,10.93,,"-224,428.98"
,CS,AR,32002273,1005,100,,Cash sale,,,,,,26/03/2018,26/03/2018,0.00,,2.58,,"-224,431.56"
,CS,AR,32002288,1005,100,,Cash sale,,,,,,26/03/2018,26/03/2018,0.00,,25.51,,"-224,457.07"
,CS,AR,32002302,1005,100,,Cash sale,,,,,,26/03/2018,26/03/2018,0.00,,7.29,,"-224,464.36"
,CS,AR,32002313,1005,100,,Cash sale,,,,,,26/03/2018,26/03/2018,0.00,,25.42,,"-224,489.78"
,CS,AR,32002356,1005,100,,Cash sale,,,,,,26/03/2018,26/03/2018,0.00,,10.93,,"-224,500.71"
,CS,AR,32002359,1005,100,,Cash sale,,,,,,26/03/2018,26/03/2018,0.00,,6.56,,"-224,507.27"
,CS,AR,32002380,1005,100,,Cash sale,,,,,,26/03/2018,26/03/2018,0.00,,11.44,,"-224,518.71"
,CS,AR,32002385,1005,100,,Cash sale,,,,,,26/03/2018,26/03/2018,0.00,,54.66,,"-224,573.37"
,CS,AR,32002448,1005,100,,Cash sale,,,,,,26/03/2018,26/03/2018,0.00,,12.71,,"-224,586.08"
,CS,AR,32002460,1005,100,,Cash sale,,,,,,26/03/2018,26/03/2018,0.00,,10.93,,"-224,597.01"
,CS,AR,32002504,1005,100,,Cash sale,,,,,,26/03/2018,26/03/2018,0.00,,21.86,,"-224,618.87"
,IN,AR,30308805,1005,100,,Invoice,,,,,,26/03/2018,26/03/2018,0.00,,20.76,,"-224,639.63"
,IN,AR,30308822,1005,100,,Invoice,,,,,,26/03/2018,26/03/2018,0.00,,7.29,,"-224,646.92"
,IN,AR,30308902,1005,100,,Invoice,,,,,,26/03/2018,26/03/2018,0.00,,52.84,,"-224,699.76"
,IN,AR,30308930,1005,100,,Invoice,,,,,,26/03/2018,26/03/2018,0.00,,3.64,,"-224,703.40"
,IN,AR,30308959,1005,100,,Invoice,,,,,,26/03/2018,26/03/2018,0.00,,121.02,,"-224,824.42"
,IN,AR,30308966,1005,100,,Invoice,,,,,,26/03/2018,26/03/2018,0.00,,5.51,,"-224,829.93"
,IN,AR,30308971,1005,100,,Invoice,,,,,,26/03/2018,26/03/2018,0.00,,3.64,,"-224,833.57"
,IN,AR,30308984,1005,100,,Invoice,,,,,,26/03/2018,26/03/2018,0.00,,32.00,,"-224,865.57"
,IN,AR,30309002,1005,100,,Invoice,,,,,,26/03/2018,26/03/2018,0.00,,33.93,,"-224,899.50"
,IN,AR,30309024,1005,100,,Invoice,,,,,,26/03/2018,26/03/2018,0.00,,21.86,,"-224,921.36"
,IN,AR,30309032,1005,100,,Invoice,,,,,,26/03/2018,26/03/2018,0.00,,3.64,,"-224,925.00"
,IN,AR,30309047,1005,100,,Invoice,,,,,,26/03/2018,26/03/2018,0.00,,16.00,,"-224,941.00"
,IN,AR,30309048,1005,100,,Invoice,,,,,,26/03/2018,26/03/2018,0.00,,14.00,,"-224,955.00"
,IN,AR,30309061,1005,100,,Invoice,,,,,,26/03/2018,26/03/2018,0.00,,2.75,,"-224,957.75"
,IN,AR,30309065,1005,100,,Invoice,,,,,,26/03/2018,26/03/2018,0.00,,33.05,,"-224,990.80"
,IN,AR,30309069,1005,100,,Invoice,,,,,,26/03/2018,26/03/2018,0.00,,8.26,,"-224,999.06"
,IN,AR,30309086,1005,100,,Invoice,,,,,,26/03/2018,26/03/2018,0.00,,3.89,,"-225,002.95"
,IN,AR,30309096,1005,100,,Invoice,,,,,,26/03/2018,26/03/2018,0.00,,8.77,,"-225,011.72"
,IN,AR,30309120,1005,100,,Invoice,,,,,,26/03/2018,26/03/2018,0.00,,28.00,,"-225,039.72"
,IN,AR,30309129,1005,100,,Invoice,,,,,,26/03/2018,26/03/2018,0.00,,14.58,,"-225,054.30"
,IN,AR,30309213,1005,100,,Invoice,,,,,,26/03/2018,26/03/2018,0.00,,11.27,,"-225,065.57"
,IN,AR,30309227,1005,100,,Invoice,,,,,,26/03/2018,26/03/2018,0.00,,22.71,,"-225,088.28"
,IN,AR,30309245,1005,100,,Invoice,,,,,,26/03/2018,26/03/2018,0.00,,3.19,,"-225,091.47"
,IN,AR,30309252,1005,100,,Invoice,,,,,,26/03/2018,26/03/2018,0.00,,15.51,,"-225,106.98"
,IN,AR,30309276,1005,100,,Invoice,,,,,,26/03/2018,26/03/2018,0.00,,10.34,,"-225,117.32"
,IN,AR,30309304,1005,100,,Invoice,,,,,,26/03/2018,26/03/2018,0.00,,20.67,,"-225,137.99"
,IN,AR,30309367,1005,100,,Invoice,,,,,,26/03/2018,26/03/2018,0.00,,10.34,,"-225,148.33"
,IN,AR,30309386,1005,100,,Invoice,,,,,,26/03/2018,26/03/2018,0.00,,5.93,,"-225,154.26"
,IN,AR,30309398,1005,100,,Invoice,,,,,,26/03/2018,26/03/2018,0.00,,3.64,,"-225,157.90"
,IN,AR,30309417,1005,100,,Invoice,,,,,,26/03/2018,26/03/2018,0.00,,5.10,,"-225,163.00"
,IN,AR,30309435,1005,100,,Invoice,,,,,,26/03/2018,26/03/2018,0.00,,100.49,,"-225,263.49"
,IN,AR,30309448,1005,100,,Invoice,,,,,,26/03/2018,26/03/2018,0.00,,55.93,,"-225,319.42"
,IN,AR,30309456,1005,100,,Invoice,,,,,,26/03/2018,26/03/2018,0.00,,10.93,,"-225,330.35"
,IN,AR,30309468,1005,100,,Invoice,,,,,,26/03/2018,26/03/2018,0.00,,16.73,,"-225,347.08"
,IN,AR,30309469,1005,100,,Invoice,,,,,,26/03/2018,26/03/2018,0.00,,7.17,,"-225,354.25"
,IN,AR,30309478,1005,100,,Invoice,,,,,,26/03/2018,26/03/2018,0.00,,25.76,,"-225,380.01"
,IN,AR,30309489,1005,100,,Invoice,,,,,,26/03/2018,26/03/2018,0.00,,12.03,,"-225,392.04"
,IN,AR,30309504,1005,100,,Invoice,,,,,,26/03/2018,26/03/2018,0.00,,7.29,,"-225,399.33"
,IN,AR,30309506,1005,100,,Invoice,,,,,,26/03/2018,26/03/2018,0.00,,9.03,,"-225,408.36"
,IN,AR,30309510,1005,100,,Invoice,,,,,,26/03/2018,26/03/2018,0.00,,5.51,,"-225,413.87"
,IN,AR,30309513,1005,100,,Invoice,,,,,,26/03/2018,26/03/2018,0.00,,3.64,,"-225,417.51"
,IN,AR,30309525,1005,100,,Invoice,,,,,,26/03/2018,26/03/2018,0.00,,2.12,,"-225,419.63"
,IN,AR,30309543,1005,100,,Invoice,,,,,,26/03/2018,26/03/2018,0.00,,4.32,,"-225,423.95"
,IN,AR,30309573,1005,100,,Invoice,,,,,,26/03/2018,26/03/2018,0.00,,51.02,,"-225,474.97"
,IN,AR,30309598,1005,100,,Invoice,,,,,,26/03/2018,26/03/2018,0.00,,15.25,,"-225,490.22"
,IN,AR,30309700,1005,100,,Invoice,,,,,,26/03/2018,26/03/2018,0.00,,10.93,,"-225,501.15"
,IN,AR,30309725,1005,100,,Invoice,,,,,,26/03/2018,26/03/2018,0.00,,27.97,,"-225,529.12"
,IN,AR,30309735,1005,100,,Invoice,,,,,,26/03/2018,26/03/2018,0.00,,8.14,,"-225,537.26"
,IN,AR,30309750,1005,100,,Invoice,,,,,,26/03/2018,26/03/2018,0.00,,10.93,,"-225,548.19"
,IN,AR,30309767,1005,100,,Invoice,,,,,,26/03/2018,26/03/2018,0.00,,10.93,,"-225,559.12"
,IN,AR,30309775,1005,100,,Invoice,,,,,,26/03/2018,26/03/2018,0.00,,7.29,,"-225,566.41"
,IN,AR,30309795,1005,100,,Invoice,,,,,,26/03/2018,26/03/2018,0.00,,14.83,,"-225,581.24"
,IN,AR,30309802,1005,100,,Invoice,,,,,,26/03/2018,26/03/2018,0.00,,11.02,,"-225,592.26"
,IN,AR,30309811,1005,100,,Invoice,,,,,,26/03/2018,26/03/2018,0.00,,24.79,,"-225,617.05"
,IN,AR,30309814,1005,100,,Invoice,,,,,,26/03/2018,26/03/2018,0.00,,3.64,,"-225,620.69"
,IN,AR,30309831,1005,100,,Invoice,,,,,,26/03/2018,26/03/2018,0.00,,6.89,,"-225,627.58"
,IN,AR,30309841,1005,100,,Invoice,,,,,,26/03/2018,26/03/2018,0.00,,11.22,,"-225,638.80"
,IN,AR,30309844,1005,100,,Invoice,,,,,,26/03/2018,26/03/2018,0.00,,21.02,,"-225,659.82"
,IN,AR,30309846,1005,100,,Invoice,,,,,,26/03/2018,26/03/2018,0.00,,7.20,,"-225,667.02"
,IN,AR,30309891,1005,100,,Invoice,,,,,,26/03/2018,26/03/2018,0.00,,7.20,,"-225,674.22"
,IN,AR,30309923,1005,100,,Invoice,,,,,,26/03/2018,26/03/2018,0.00,,16.00,,"-225,690.22"
,IN,AR,30309965,1005,100,,Invoice,,,,,,26/03/2018,26/03/2018,0.00,,14.58,,"-225,704.80"
,IN,AR,30309974,1005,100,,Invoice,,,,,,26/03/2018,26/03/2018,0.00,,2.58,,"-225,707.38"
,IN,AR,30309981,1005,100,,Invoice,,,,,,26/03/2018,26/03/2018,0.00,,3.64,,"-225,711.02"
,IN,AR,30310002,1005,100,,Invoice,,,,,,26/03/2018,26/03/2018,0.00,,4.49,,"-225,715.51"
,IN,AR,30310101,1005,100,,Invoice,,,,,,26/03/2018,26/03/2018,0.00,,3.64,,"-225,719.15"
,IN,AR,30310207,1005,100,,Invoice,,,,,,26/03/2018,26/03/2018,0.00,,11.25,,"-225,730.40"
,IN,AR,30310273,1005,100,,Invoice,,,,,,26/03/2018,26/03/2018,0.00,,31.23,,"-225,761.63"
,IN,AR,30310289,1005,100,,Invoice,,,,,,26/03/2018,26/03/2018,0.00,,4.29,,"-225,765.92"
,IN,AR,30310302,1005,100,,Invoice,,,,,,26/03/2018,26/03/2018,0.00,,18.04,,"-225,783.96"
,IN,AR,30310380,1005,100,,Invoice,,,,,,26/03/2018,26/03/2018,0.00,,12.83,,"-225,796.79"
,IN,AR,30310398,1005,100,,Invoice,,,,,,26/03/2018,26/03/2018,0.00,,36.78,,"-225,833.57"
,IN,AR,30310475,1005,100,,Invoice,,,,,,26/03/2018,26/03/2018,0.00,,20.01,,"-225,853.58"
,IN,AR,30310479,1005,100,,Invoice,,,,,,26/03/2018,26/03/2018,0.00,,22.01,,"-225,875.59"
,IN,AR,30310488,1005,100,,Invoice,,,,,,26/03/2018,26/03/2018,0.00,,22.01,,"-225,897.60"
,IN,AR,30310519,1005,100,,Invoice,,,,,,26/03/2018,26/03/2018,0.00,,92.02,,"-225,989.62"
,IN,AR,30310556,1005,100,,Invoice,,,,,,26/03/2018,26/03/2018,0.00,,419.07,,"-226,408.69"
,IN,AR,30310562,1005,100,,Invoice,,,,,,26/03/2018,26/03/2018,0.00,,21.86,,"-226,430.55"
,IN,AR,30310566,1005,100,,Invoice,,,,,,26/03/2018,26/03/2018,0.00,,48.32,,"-226,478.87"
,IN,AR,30310570,1005,100,,Invoice,,,,,,26/03/2018,26/03/2018,0.00,,163.14,,"-226,642.01"
,IN,AR,30310583,1005,100,,Invoice,,,,,,26/03/2018,26/03/2018,0.00,,8.42,,"-226,650.43"
,IN,AR,30310620,1005,100,,Invoice,,,,,,26/03/2018,26/03/2018,0.00,,6.07,,"-226,656.50"
,IN,AR,30310625,1005,100,,Invoice,,,,,,26/03/2018,26/03/2018,0.00,,4.08,,"-226,660.58"
,IN,AR,30310674,1005,100,,Invoice,,,,,,26/03/2018,26/03/2018,0.00,,26.69,,"-226,687.27"
,IN,AR,30310710,1005,100,,Invoice,,,,,,26/03/2018,26/03/2018,0.00,,46.20,,"-226,733.47"
,IN,AR,30310790,1005,100,,Invoice,,,,,,26/03/2018,26/03/2018,0.00,,12.00,,"-226,745.47"
,IN,AR,30310793,1005,100,,Invoice,,,,,,26/03/2018,26/03/2018,0.00,,3.64,,"-226,749.11"
,IN,AR,30310803,1005,100,,Invoice,,,,,,26/03/2018,26/03/2018,0.00,,1.88,,"-226,750.99"
,IN,AR,30310883,1005,100,,Invoice,,,,,,26/03/2018,26/03/2018,0.00,,279.66,,"-227,030.65"
,IN,AR,30310896,1005,100,,Invoice,,,,,,26/03/2018,26/03/2018,0.00,,5.24,,"-227,035.89"
,IN,AR,30310898,1005,100,,Invoice,,,,,,26/03/2018,26/03/2018,0.00,,10.53,,"-227,046.42"
,IN,AR,30310924,1005,100,,Invoice,,,,,,26/03/2018,26/03/2018,0.00,,6.13,,"-227,052.55"
,IN,AR,30310929,1005,100,,Invoice,,,,,,26/03/2018,26/03/2018,0.00,,29.15,,"-227,081.70"
,IN,AR,30310932,1005,100,,Invoice,,,,,,26/03/2018,26/03/2018,0.00,,7.29,,"-227,088.99"
,IN,AR,30310960,1005,100,,Invoice,,,,,,26/03/2018,26/03/2018,0.00,,36.44,,"-227,125.43"
,IN,AR,30310986,1005,100,,Invoice,,,,,,26/03/2018,26/03/2018,0.00,,17.54,,"-227,142.97"
,IN,AR,30311051,1005,100,,Invoice,,,,,,26/03/2018,26/03/2018,0.00,,6.23,,"-227,149.20"
,IN,AR,30311068,1005,100,,Invoice,,,,,,26/03/2018,26/03/2018,0.00,,54.66,,"-227,203.86"
,CN,AR,31017522,1005,100,,Credit Note,,,,,,27/03/2018,27/03/2018,10.93,,0.00,,"-227,192.93"
,CN,AR,31017525,1005,100,,Credit Note,,,,,,27/03/2018,27/03/2018,18.70,,0.00,,"-227,174.23"
,CN,AR,31017532,1005,100,,Credit Note,,,,,,27/03/2018,27/03/2018,54.66,,0.00,,"-227,119.57"
,CN,AR,31017534,1005,100,,Credit Note,,,,,,27/03/2018,27/03/2018,182.20,,0.00,,"-226,937.37"
,CN,AR,31017535,1005,100,,Credit Note,,,,,,27/03/2018,27/03/2018,23.70,,0.00,,"-226,913.67"
,CN,AR,31017537,1005,100,,Credit Note,,,,,,27/03/2018,27/03/2018,7.20,,0.00,,"-226,906.47"
,CN,AR,31017543,1005,100,,Credit Note,,,,,,27/03/2018,27/03/2018,6.64,,0.00,,"-226,899.83"
,CN,AR,31017547,1005,100,,Credit Note,,,,,,27/03/2018,27/03/2018,7.20,,0.00,,"-226,892.63"
,CN,AR,31017549,1005,100,,Credit Note,,,,,,27/03/2018,27/03/2018,21.86,,0.00,,"-226,870.77"
,CN,AR,31017563,1005,100,,Credit Note,,,,,,27/03/2018,27/03/2018,10.93,,0.00,,"-226,859.84"
,CN,AR,31017571,1005,100,,Credit Note,,,,,,27/03/2018,27/03/2018,34.02,,0.00,,"-226,825.82"
,CN,AR,31017578,1005,100,,Credit Note,,,,,,27/03/2018,27/03/2018,5.49,,0.00,,"-226,820.33"
,CN,AR,31017581,1005,100,,Credit Note,,,,,,27/03/2018,27/03/2018,10.93,,0.00,,"-226,809.40"
,CN,AR,31017582,1005,100,,Credit Note,,,,,,27/03/2018,27/03/2018,2.58,,0.00,,"-226,806.82"
,CN,AR,31017685,1005,100,,Credit Note,,,,,,27/03/2018,27/03/2018,7.29,,0.00,,"-226,799.53"
,CS,AR,32001799,1005,100,,Cash sale,,,,,,27/03/2018,27/03/2018,0.00,,3.01,,"-226,802.54"
,CS,AR,32001817,1005,100,,Cash sale,,,,,,27/03/2018,27/03/2018,0.00,,7.29,,"-226,809.83"
,CS,AR,32001818,1005,100,,Cash sale,,,,,,27/03/2018,27/03/2018,0.00,,7.29,,"-226,817.12"
,CS,AR,32001838,1005,100,,Cash sale,,,,,,27/03/2018,27/03/2018,0.00,,7.29,,"-226,824.41"
,CS,AR,32001860,1005,100,,Cash sale,,,,,,27/03/2018,27/03/2018,0.00,,10.93,,"-226,835.34"
,CS,AR,32001867,1005,100,,Cash sale,,,,,,27/03/2018,27/03/2018,0.00,,7.29,,"-226,842.63"
,CS,AR,32001956,1005,100,,Cash sale,,,,,,27/03/2018,27/03/2018,0.00,,7.75,,"-226,850.38"
,CS,AR,32001958,1005,100,,Cash sale,,,,,,27/03/2018,27/03/2018,0.00,,5.68,,"-226,856.06"
,CS,AR,32002022,1005,100,,Cash sale,,,,,,27/03/2018,27/03/2018,0.00,,3.64,,"-226,859.70"
,CS,AR,32002036,1005,100,,Cash sale,,,,,,27/03/2018,27/03/2018,0.00,,9.03,,"-226,868.73"
,CS,AR,32002086,1005,100,,Cash sale,,,,,,27/03/2018,27/03/2018,0.00,,5.85,,"-226,874.58"
,CS,AR,32002093,1005,100,,Cash sale,,,,,,27/03/2018,27/03/2018,0.00,,38.77,,"-226,913.35"
,CS,AR,32002122,1005,100,,Cash sale,,,,,,27/03/2018,27/03/2018,0.00,,5.17,,"-226,918.52"
,CS,AR,32002145,1005,100,,Cash sale,,,,,,27/03/2018,27/03/2018,0.00,,3.90,,"-226,922.42"
,CS,AR,32002154,1005,100,,Cash sale,,,,,,27/03/2018,27/03/2018,0.00,,3.64,,"-226,926.06"
,CS,AR,32002239,1005,100,,Cash sale,,,,,,27/03/2018,27/03/2018,0.00,,10.93,,"-226,936.99"
,CS,AR,32002243,1005,100,,Cash sale,,,,,,27/03/2018,27/03/2018,0.00,,12.86,,"-226,949.85"
,CS,AR,32002330,1005,100,,Cash sale,,,,,,27/03/2018,27/03/2018,0.00,,7.63,,"-226,957.48"
,CS,AR,32002333,1005,100,,Cash sale,,,,,,27/03/2018,27/03/2018,0.00,,24.00,,"-226,981.48"
,CS,AR,32002363,1005,100,,Cash sale,,,,,,27/03/2018,27/03/2018,0.00,,5.47,,"-226,986.95"
,CS,AR,32002366,1005,100,,Cash sale,,,,,,27/03/2018,27/03/2018,0.00,,9.84,,"-226,996.79"
,CS,AR,32002395,1005,100,,Cash sale,,,,,,27/03/2018,27/03/2018,0.00,,14.83,,"-227,011.62"
,CS,AR,32002485,1005,100,,Cash sale,,,,,,27/03/2018,27/03/2018,0.00,,9.10,,"-227,020.72"
,CS,AR,32002500,1005,100,,Cash sale,,,,,,27/03/2018,27/03/2018,0.00,,3.64,,"-227,024.36"
,CS,AR,32002513,1005,100,,Cash sale,,,,,,27/03/2018,27/03/2018,0.00,,7.29,,"-227,031.65"
,CS,AR,32002526,1005,100,,Cash sale,,,,,,27/03/2018,27/03/2018,0.00,,19.16,,"-227,050.81"
,CS,AR,32002533,1005,100,,Cash sale,,,,,,27/03/2018,27/03/2018,0.00,,14.58,,"-227,065.39"
,CS,AR,32002581,1005,100,,Cash sale,,,,,,27/03/2018,27/03/2018,0.00,,29.15,,"-227,094.54"
,CS,AR,32002587,1005,100,,Cash sale,,,,,,27/03/2018,27/03/2018,0.00,,7.29,,"-227,101.83"
,IN,AR,30308788,1005,100,,Invoice,,,,,,27/03/2018,27/03/2018,0.00,,6.02,,"-227,107.85"
,IN,AR,30308843,1005,100,,Invoice,,,,,,27/03/2018,27/03/2018,0.00,,4.88,,"-227,112.73"
,IN,AR,30308844,1005,100,,Invoice,,,,,,27/03/2018,27/03/2018,0.00,,31.73,,"-227,144.46"
,IN,AR,30308860,1005,100,,Invoice,,,,,,27/03/2018,27/03/2018,0.00,,3.64,,"-227,148.10"
,IN,AR,30308864,1005,100,,Invoice,,,,,,27/03/2018,27/03/2018,0.00,,3.64,,"-227,151.74"
,IN,AR,30308873,1005,100,,Invoice,,,,,,27/03/2018,27/03/2018,0.00,,18.39,,"-227,170.13"
,IN,AR,30308874,1005,100,,Invoice,,,,,,27/03/2018,27/03/2018,0.00,,55.17,,"-227,225.30"
,IN,AR,30308919,1005,100,,Invoice,,,,,,27/03/2018,27/03/2018,0.00,,25.51,,"-227,250.81"
,IN,AR,30308960,1005,100,,Invoice,,,,,,27/03/2018,27/03/2018,0.00,,47.46,,"-227,298.27"
,IN,AR,30308992,1005,100,,Invoice,,,,,,27/03/2018,27/03/2018,0.00,,18.22,,"-227,316.49"
,IN,AR,30309009,1005,100,,Invoice,,,,,,27/03/2018,27/03/2018,0.00,,7.25,,"-227,323.74"
,IN,AR,30309057,1005,100,,Invoice,,,,,,27/03/2018,27/03/2018,0.00,,7.29,,"-227,331.03"
,IN,AR,30309130,1005,100,,Invoice,,,,,,27/03/2018,27/03/2018,0.00,,3.64,,"-227,334.67"
,IN,AR,30309138,1005,100,,Invoice,,,,,,27/03/2018,27/03/2018,0.00,,19.22,,"-227,353.89"
,IN,AR,30309154,1005,100,,Invoice,,,,,,27/03/2018,27/03/2018,0.00,,73.68,,"-227,427.57"
,IN,AR,30309155,1005,100,,Invoice,,,,,,27/03/2018,27/03/2018,0.00,,79.14,,"-227,506.71"
,IN,AR,30309156,1005,100,,Invoice,,,,,,27/03/2018,27/03/2018,0.00,,14.58,,"-227,521.29"
,IN,AR,30309180,1005,100,,Invoice,,,,,,27/03/2018,27/03/2018,0.00,,7.29,,"-227,528.58"
,IN,AR,30309194,1005,100,,Invoice,,,,,,27/03/2018,27/03/2018,0.00,,10.99,,"-227,539.57"
,IN,AR,30309229,1005,100,,Invoice,,,,,,27/03/2018,27/03/2018,0.00,,7.29,,"-227,546.86"
,IN,AR,30309248,1005,100,,Invoice,,,,,,27/03/2018,27/03/2018,0.00,,25.51,,"-227,572.37"
,IN,AR,30309258,1005,100,,Invoice,,,,,,27/03/2018,27/03/2018,0.00,,7.29,,"-227,579.66"
,IN,AR,30309285,1005,100,,Invoice,,,,,,27/03/2018,27/03/2018,0.00,,4.64,,"-227,584.30"
,IN,AR,30309297,1005,100,,Invoice,,,,,,27/03/2018,27/03/2018,0.00,,4.80,,"-227,589.10"
,IN,AR,30309298,1005,100,,Invoice,,,,,,27/03/2018,27/03/2018,0.00,,4.80,,"-227,593.90"
,IN,AR,30309306,1005,100,,Invoice,,,,,,27/03/2018,27/03/2018,0.00,,10.17,,"-227,604.07"
,IN,AR,30309321,1005,100,,Invoice,,,,,,27/03/2018,27/03/2018,0.00,,4.78,,"-227,608.85"
,IN,AR,30309331,1005,100,,Invoice,,,,,,27/03/2018,27/03/2018,0.00,,6.36,,"-227,615.21"
,IN,AR,30309353,1005,100,,Invoice,,,,,,27/03/2018,27/03/2018,0.00,,12.71,,"-227,627.92"
,IN,AR,30309355,1005,100,,Invoice,,,,,,27/03/2018,27/03/2018,0.00,,6.36,,"-227,634.28"
,IN,AR,30309407,1005,100,,Invoice,,,,,,27/03/2018,27/03/2018,0.00,,18.05,,"-227,652.33"
,IN,AR,30309449,1005,100,,Invoice,,,,,,27/03/2018,27/03/2018,0.00,,109.32,,"-227,761.65"
,IN,AR,30309450,1005,100,,Invoice,,,,,,27/03/2018,27/03/2018,0.00,,7.63,,"-227,769.28"
,IN,AR,30309470,1005,100,,Invoice,,,,,,27/03/2018,27/03/2018,0.00,,4.78,,"-227,774.06"
,IN,AR,30309514,1005,100,,Invoice,,,,,,27/03/2018,27/03/2018,0.00,,4.29,,"-227,778.35"
,IN,AR,30309529,1005,100,,Invoice,,,,,,27/03/2018,27/03/2018,0.00,,34.72,,"-227,813.07"
,IN,AR,30309642,1005,100,,Invoice,,,,,,27/03/2018,27/03/2018,0.00,,5.85,,"-227,818.92"
,IN,AR,30309678,1005,100,,Invoice,,,,,,27/03/2018,27/03/2018,0.00,,6.86,,"-227,825.78"
,IN,AR,30309679,1005,100,,Invoice,,,,,,27/03/2018,27/03/2018,0.00,,8.17,,"-227,833.95"
,IN,AR,30309691,1005,100,,Invoice,,,,,,27/03/2018,27/03/2018,0.00,,3.64,,"-227,837.59"
,IN,AR,30309699,1005,100,,Invoice,,,,,,27/03/2018,27/03/2018,0.00,,7.29,,"-227,844.88"
,IN,AR,30309732,1005,100,,Invoice,,,,,,27/03/2018,27/03/2018,0.00,,15.00,,"-227,859.88"
,IN,AR,30309736,1005,100,,Invoice,,,,,,27/03/2018,27/03/2018,0.00,,4.08,,"-227,863.96"
,IN,AR,30309746,1005,100,,Invoice,,,,,,27/03/2018,27/03/2018,0.00,,13.22,,"-227,877.18"
,IN,AR,30309758,1005,100,,Invoice,,,,,,27/03/2018,27/03/2018,0.00,,15.25,,"-227,892.43"
,IN,AR,30309765,1005,100,,Invoice,,,,,,27/03/2018,27/03/2018,0.00,,10.53,,"-227,902.96"
,IN,AR,30309780,1005,100,,Invoice,,,,,,27/03/2018,27/03/2018,0.00,,21.86,,"-227,924.82"
,IN,AR,30309788,1005,100,,Invoice,,,,,,27/03/2018,27/03/2018,0.00,,8.47,,"-227,933.29"
,IN,AR,30309807,1005,100,,Invoice,,,,,,27/03/2018,27/03/2018,0.00,,4.29,,"-227,937.58"
,IN,AR,30309827,1005,100,,Invoice,,,,,,27/03/2018,27/03/2018,0.00,,10.98,,"-227,948.56"
,IN,AR,30309852,1005,100,,Invoice,,,,,,27/03/2018,27/03/2018,0.00,,5.93,,"-227,954.49"
,IN,AR,30309853,1005,100,,Invoice,,,,,,27/03/2018,27/03/2018,0.00,,11.86,,"-227,966.35"
,IN,AR,30309879,1005,100,,Invoice,,,,,,27/03/2018,27/03/2018,0.00,,3.64,,"-227,969.99"
,IN,AR,30309912,1005,100,,Invoice,,,,,,27/03/2018,27/03/2018,0.00,,7.29,,"-227,977.28"
,IN,AR,30309927,1005,100,,Invoice,,,,,,27/03/2018,27/03/2018,0.00,,19.30,,"-227,996.58"
,IN,AR,30309934,1005,100,,Invoice,,,,,,27/03/2018,27/03/2018,0.00,,29.15,,"-228,025.73"
,IN,AR,30309967,1005,100,,Invoice,,,,,,27/03/2018,27/03/2018,0.00,,5.59,,"-228,031.32"
,IN,AR,30309968,1005,100,,Invoice,,,,,,27/03/2018,27/03/2018,0.00,,3.64,,"-228,034.96"
,IN,AR,30309985,1005,100,,Invoice,,,,,,27/03/2018,27/03/2018,0.00,,5.68,,"-228,040.64"
,IN,AR,30310054,1005,100,,Invoice,,,,,,27/03/2018,27/03/2018,0.00,,57.16,,"-228,097.80"
,IN,AR,30310067,1005,100,,Invoice,,,,,,27/03/2018,27/03/2018,0.00,,32.16,,"-228,129.96"
,IN,AR,30310094,1005,100,,Invoice,,,,,,27/03/2018,27/03/2018,0.00,,1.76,,"-228,131.72"
,IN,AR,30310117,1005,100,,Invoice,,,,,,27/03/2018,27/03/2018,0.00,,29.15,,"-228,160.87"
,IN,AR,30310121,1005,100,,Invoice,,,,,,27/03/2018,27/03/2018,0.00,,5.49,,"-228,166.36"
,IN,AR,30310127,1005,100,,Invoice,,,,,,27/03/2018,27/03/2018,0.00,,63.56,,"-228,229.92"
,IN,AR,30310131,1005,100,,Invoice,,,,,,27/03/2018,27/03/2018,0.00,,19.16,,"-228,249.08"
,IN,AR,30310134,1005,100,,Invoice,,,,,,27/03/2018,27/03/2018,0.00,,29.15,,"-228,278.23"
,IN,AR,30310138,1005,100,,Invoice,,,,,,27/03/2018,27/03/2018,0.00,,2.58,,"-228,280.81"
,IN,AR,30310142,1005,100,,Invoice,,,,,,27/03/2018,27/03/2018,0.00,,7.29,,"-228,288.10"
,IN,AR,30310184,1005,100,,Invoice,,,,,,27/03/2018,27/03/2018,0.00,,6.43,,"-228,294.53"
,IN,AR,30310257,1005,100,,Invoice,,,,,,27/03/2018,27/03/2018,0.00,,23.85,,"-228,318.38"
,IN,AR,30310258,1005,100,,Invoice,,,,,,27/03/2018,27/03/2018,0.00,,1.59,,"-228,319.97"
,IN,AR,30310259,1005,100,,Invoice,,,,,,27/03/2018,27/03/2018,0.00,,3.18,,"-228,323.15"
,IN,AR,30310260,1005,100,,Invoice,,,,,,27/03/2018,27/03/2018,0.00,,228.96,,"-228,552.11"
,IN,AR,30310339,1005,100,,Invoice,,,,,,27/03/2018,27/03/2018,0.00,,178.56,,"-228,730.67"
,IN,AR,30310381,1005,100,,Invoice,,,,,,27/03/2018,27/03/2018,0.00,,6.42,,"-228,737.09"
,IN,AR,30310393,1005,100,,Invoice,,,,,,27/03/2018,27/03/2018,0.00,,54.66,,"-228,791.75"
,IN,AR,30310427,1005,100,,Invoice,,,,,,27/03/2018,27/03/2018,0.00,,28.46,,"-228,820.21"
,IN,AR,30310443,1005,100,,Invoice,,,,,,27/03/2018,27/03/2018,0.00,,10.93,,"-228,831.14"
,IN,AR,30310461,1005,100,,Invoice,,,,,,27/03/2018,27/03/2018,0.00,,15.25,,"-228,846.39"
,IN,AR,30310462,1005,100,,Invoice,,,,,,27/03/2018,27/03/2018,0.00,,5.08,,"-228,851.47"
,IN,AR,30310504,1005,100,,Invoice,,,,,,27/03/2018,27/03/2018,0.00,,5.83,,"-228,857.30"
,IN,AR,30310505,1005,100,,Invoice,,,,,,27/03/2018,27/03/2018,0.00,,11.66,,"-228,868.96"
,IN,AR,30310576,1005,100,,Invoice,,,,,,27/03/2018,27/03/2018,0.00,,2.74,,"-228,871.70"
,IN,AR,30310615,1005,100,,Invoice,,,,,,27/03/2018,27/03/2018,0.00,,64.00,,"-228,935.70"
,IN,AR,30310641,1005,100,,Invoice,,,,,,27/03/2018,27/03/2018,0.00,,23.73,,"-228,959.43"
,IN,AR,30310657,1005,100,,Invoice,,,,,,27/03/2018,27/03/2018,0.00,,7.63,,"-228,967.06"
,IN,AR,30310721,1005,100,,Invoice,,,,,,27/03/2018,27/03/2018,0.00,,94.92,,"-229,061.98"
,IN,AR,30310766,1005,100,,Invoice,,,,,,27/03/2018,27/03/2018,0.00,,33.22,,"-229,095.20"
,IN,AR,30310767,1005,100,,Invoice,,,,,,27/03/2018,27/03/2018,0.00,,59.32,,"-229,154.52"
,IN,AR,30310768,1005,100,,Invoice,,,,,,27/03/2018,27/03/2018,0.00,,130.52,,"-229,285.04"
,IN,AR,30310807,1005,100,,Invoice,,,,,,27/03/2018,27/03/2018,0.00,,3.51,,"-229,288.55"
,IN,AR,30310811,1005,100,,Invoice,,,,,,27/03/2018,27/03/2018,0.00,,3.51,,"-229,292.06"
,IN,AR,30310816,1005,100,,Invoice,,,,,,27/03/2018,27/03/2018,0.00,,8.00,,"-229,300.06"
,IN,AR,30310825,1005,100,,Invoice,,,,,,27/03/2018,27/03/2018,0.00,,100.85,,"-229,400.91"
,IN,AR,30310840,1005,100,,Invoice,,,,,,27/03/2018,27/03/2018,0.00,,5.26,,"-229,406.17"
,IN,AR,30310873,1005,100,,Invoice,,,,,,27/03/2018,27/03/2018,0.00,,5.64,,"-229,411.81"
,IN,AR,30310878,1005,100,,Invoice,,,,,,27/03/2018,27/03/2018,0.00,,18.22,,"-229,430.03"
,IN,AR,30310934,1005,100,,Invoice,,,,,,27/03/2018,27/03/2018,0.00,,7.29,,"-229,437.32"
,IN,AR,30310969,1005,100,,Invoice,,,,,,27/03/2018,27/03/2018,0.00,,11.19,,"-229,448.51"
,IN,AR,30310977,1005,100,,Invoice,,,,,,27/03/2018,27/03/2018,0.00,,13.94,,"-229,462.45"
,IN,AR,30311010,1005,100,,Invoice,,,,,,27/03/2018,27/03/2018,0.00,,12.14,,"-229,474.59"
,IN,AR,30311055,1005,100,,Invoice,,,,,,27/03/2018,27/03/2018,0.00,,7.29,,"-229,481.88"
,IN,AR,30311071,1005,100,,Invoice,,,,,,27/03/2018,27/03/2018,0.00,,10.93,,"-229,492.81"
,IN,AR,30311073,1005,100,,Invoice,,,,,,27/03/2018,27/03/2018,0.00,,10.93,,"-229,503.74"
,CN,AR,31017468,1005,100,,Credit Note,,,,,,28/03/2018,28/03/2018,10.93,,0.00,,"-229,492.81"
,CN,AR,31017492,1005,100,,Credit Note,,,,,,28/03/2018,28/03/2018,29.15,,0.00,,"-229,463.66"
,CN,AR,31017515,1005,100,,Credit Note,,,,,,28/03/2018,28/03/2018,5.17,,0.00,,"-229,458.49"
,CN,AR,31017530,1005,100,,Credit Note,,,,,,28/03/2018,28/03/2018,8.47,,0.00,,"-229,450.02"
,CN,AR,31017579,1005,100,,Credit Note,,,,,,28/03/2018,28/03/2018,7.29,,0.00,,"-229,442.73"
,CN,AR,31017586,1005,100,,Credit Note,,,,,,28/03/2018,28/03/2018,20.34,,0.00,,"-229,422.39"
,CN,AR,31017670,1005,100,,Credit Note,,,,,,28/03/2018,28/03/2018,3.64,,0.00,,"-229,418.75"
,CN,AR,31017687,1005,100,,Credit Note,,,,,,28/03/2018,28/03/2018,419.07,,0.00,,"-228,999.68"
,CS,AR,32001714,1005,100,,Cash sale,,,,,,28/03/2018,28/03/2018,0.00,,28.05,,"-229,027.73"
,CS,AR,32001729,1005,100,,Cash sale,,,,,,28/03/2018,28/03/2018,0.00,,32.61,,"-229,060.34"
,CS,AR,32001745,1005,100,,Cash sale,,,,,,28/03/2018,28/03/2018,0.00,,14.58,,"-229,074.92"
,CS,AR,32001754,1005,100,,Cash sale,,,,,,28/03/2018,28/03/2018,0.00,,3.64,,"-229,078.56"
,CS,AR,32001760,1005,100,,Cash sale,,,,,,28/03/2018,28/03/2018,0.00,,18.22,,"-229,096.78"
,CS,AR,32001771,1005,100,,Cash sale,,,,,,28/03/2018,28/03/2018,0.00,,3.64,,"-229,100.42"
,CS,AR,32001780,1005,100,,Cash sale,,,,,,28/03/2018,28/03/2018,0.00,,10.93,,"-229,111.35"
,CS,AR,32001791,1005,100,,Cash sale,,,,,,28/03/2018,28/03/2018,0.00,,3.64,,"-229,114.99"
,CS,AR,32001793,1005,100,,Cash sale,,,,,,28/03/2018,28/03/2018,0.00,,7.29,,"-229,122.28"
,CS,AR,32001843,1005,100,,Cash sale,,,,,,28/03/2018,28/03/2018,0.00,,15.04,,"-229,137.32"
,CS,AR,32001853,1005,100,,Cash sale,,,,,,28/03/2018,28/03/2018,0.00,,7.29,,"-229,144.61"
,CS,AR,32001854,1005,100,,Cash sale,,,,,,28/03/2018,28/03/2018,0.00,,10.93,,"-229,155.54"
,CS,AR,32001868,1005,100,,Cash sale,,,,,,28/03/2018,28/03/2018,0.00,,10.93,,"-229,166.47"
,CS,AR,32001875,1005,100,,Cash sale,,,,,,28/03/2018,28/03/2018,0.00,,23.29,,"-229,189.76"
,CS,AR,32001892,1005,100,,Cash sale,,,,,,28/03/2018,28/03/2018,0.00,,2.92,,"-229,192.68"
,CS,AR,32001934,1005,100,,Cash sale,,,,,,28/03/2018,28/03/2018,0.00,,14.58,,"-229,207.26"
,CS,AR,32001974,1005,100,,Cash sale,,,,,,28/03/2018,28/03/2018,0.00,,3.64,,"-229,210.90"
,CS,AR,32001992,1005,100,,Cash sale,,,,,,28/03/2018,28/03/2018,0.00,,12.03,,"-229,222.93"
,CS,AR,32001995,1005,100,,Cash sale,,,,,,28/03/2018,28/03/2018,0.00,,10.72,,"-229,233.65"
,CS,AR,32002015,1005,100,,Cash sale,,,,,,28/03/2018,28/03/2018,0.00,,14.58,,"-229,248.23"
,CS,AR,32002028,1005,100,,Cash sale,,,,,,28/03/2018,28/03/2018,0.00,,5.08,,"-229,253.31"
,CS,AR,32002032,1005,100,,Cash sale,,,,,,28/03/2018,28/03/2018,0.00,,5.08,,"-229,258.39"
,CS,AR,32002087,1005,100,,Cash sale,,,,,,28/03/2018,28/03/2018,0.00,,7.75,,"-229,266.14"
,CS,AR,32002150,1005,100,,Cash sale,,,,,,28/03/2018,28/03/2018,0.00,,3.64,,"-229,269.78"
,CS,AR,32002160,1005,100,,Cash sale,,,,,,28/03/2018,28/03/2018,0.00,,7.75,,"-229,277.53"
,CS,AR,32002168,1005,100,,Cash sale,,,,,,28/03/2018,28/03/2018,0.00,,10.93,,"-229,288.46"
,CS,AR,32002170,1005,100,,Cash sale,,,,,,28/03/2018,28/03/2018,0.00,,10.93,,"-229,299.39"
,CS,AR,32002180,1005,100,,Cash sale,,,,,,28/03/2018,28/03/2018,0.00,,14.58,,"-229,313.97"
,CS,AR,32002202,1005,100,,Cash sale,,,,,,28/03/2018,28/03/2018,0.00,,7.29,,"-229,321.26"
,CS,AR,32002270,1005,100,,Cash sale,,,,,,28/03/2018,28/03/2018,0.00,,7.29,,"-229,328.55"
,CS,AR,32002277,1005,100,,Cash sale,,,,,,28/03/2018,28/03/2018,0.00,,7.86,,"-229,336.41"
,CS,AR,32002294,1005,100,,Cash sale,,,,,,28/03/2018,28/03/2018,0.00,,6.53,,"-229,342.94"
,CS,AR,32002308,1005,100,,Cash sale,,,,,,28/03/2018,28/03/2018,0.00,,29.15,,"-229,372.09"
,CS,AR,32002337,1005,100,,Cash sale,,,,,,28/03/2018,28/03/2018,0.00,,26.00,,"-229,398.09"
,CS,AR,32002364,1005,100,,Cash sale,,,,,,28/03/2018,28/03/2018,0.00,,5.18,,"-229,403.27"
,CS,AR,32002367,1005,100,,Cash sale,,,,,,28/03/2018,28/03/2018,0.00,,3.64,,"-229,406.91"
,CS,AR,32002370,1005,100,,Cash sale,,,,,,28/03/2018,28/03/2018,0.00,,7.29,,"-229,414.20"
,CS,AR,32002400,1005,100,,Cash sale,,,,,,28/03/2018,28/03/2018,0.00,,10.93,,"-229,425.13"
,CS,AR,32002412,1005,100,,Cash sale,,,,,,28/03/2018,28/03/2018,0.00,,21.86,,"-229,446.99"
,CS,AR,32002431,1005,100,,Cash sale,,,,,,28/03/2018,28/03/2018,0.00,,9.03,,"-229,456.02"
,CS,AR,32002438,1005,100,,Cash sale,,,,,,28/03/2018,28/03/2018,0.00,,14.58,,"-229,470.60"
,CS,AR,32002461,1005,100,,Cash sale,,,,,,28/03/2018,28/03/2018,0.00,,14.58,,"-229,485.18"
,CS,AR,32002465,1005,100,,Cash sale,,,,,,28/03/2018,28/03/2018,0.00,,3.64,,"-229,488.82"
,CS,AR,32002490,1005,100,,Cash sale,,,,,,28/03/2018,28/03/2018,0.00,,7.29,,"-229,496.11"
,CS,AR,32002494,1005,100,,Cash sale,,,,,,28/03/2018,28/03/2018,0.00,,7.29,,"-229,503.40"
,CS,AR,32002517,1005,100,,Cash sale,,,,,,28/03/2018,28/03/2018,0.00,,8.75,,"-229,512.15"
,CS,AR,32002556,1005,100,,Cash sale,,,,,,28/03/2018,28/03/2018,0.00,,10.99,,"-229,523.14"
,CS,AR,32002560,1005,100,,Cash sale,,,,,,28/03/2018,28/03/2018,0.00,,10.93,,"-229,534.07"
,CS,AR,32002585,1005,100,,Cash sale,,,,,,28/03/2018,28/03/2018,0.00,,7.29,,"-229,541.36"
,IN,AR,30308791,1005,100,,Invoice,,,,,,28/03/2018,28/03/2018,0.00,,84.54,,"-229,625.90"
,IN,AR,30308806,1005,100,,Invoice,,,,,,28/03/2018,28/03/2018,0.00,,5.93,,"-229,631.83"
,IN,AR,30308845,1005,100,,Invoice,,,,,,28/03/2018,28/03/2018,0.00,,9.76,,"-229,641.59"
,IN,AR,30308858,1005,100,,Invoice,,,,,,28/03/2018,28/03/2018,0.00,,11.36,,"-229,652.95"
,IN,AR,30308876,1005,100,,Invoice,,,,,,28/03/2018,28/03/2018,0.00,,7.29,,"-229,660.24"
,IN,AR,30308887,1005,100,,Invoice,,,,,,28/03/2018,28/03/2018,0.00,,7.29,,"-229,667.53"
,IN,AR,30308892,1005,100,,Invoice,,,,,,28/03/2018,28/03/2018,0.00,,10.50,,"-229,678.03"
,IN,AR,30308913,1005,100,,Invoice,,,,,,28/03/2018,28/03/2018,0.00,,7.29,,"-229,685.32"
,IN,AR,30308939,1005,100,,Invoice,,,,,,28/03/2018,28/03/2018,0.00,,3.98,,"-229,689.30"
,IN,AR,30308961,1005,100,,Invoice,,,,,,28/03/2018,28/03/2018,0.00,,68.81,,"-229,758.11"
,IN,AR,30308968,1005,100,,Invoice,,,,,,28/03/2018,28/03/2018,0.00,,3.64,,"-229,761.75"
,IN,AR,30308985,1005,100,,Invoice,,,,,,28/03/2018,28/03/2018,0.00,,20.00,,"-229,781.75"
,IN,AR,30309015,1005,100,,Invoice,,,,,,28/03/2018,28/03/2018,0.00,,18.22,,"-229,799.97"
,IN,AR,30309026,1005,100,,Invoice,,,,,,28/03/2018,28/03/2018,0.00,,3.64,,"-229,803.61"
,IN,AR,30309049,1005,100,,Invoice,,,,,,28/03/2018,28/03/2018,0.00,,32.00,,"-229,835.61"
,IN,AR,30309050,1005,100,,Invoice,,,,,,28/03/2018,28/03/2018,0.00,,4.00,,"-229,839.61"
,IN,AR,30309091,1005,100,,Invoice,,,,,,28/03/2018,28/03/2018,0.00,,36.00,,"-229,875.61"
,IN,AR,30309106,1005,100,,Invoice,,,,,,28/03/2018,28/03/2018,0.00,,54.58,,"-229,930.19"
,IN,AR,30309121,1005,100,,Invoice,,,,,,28/03/2018,28/03/2018,0.00,,6.00,,"-229,936.19"
,IN,AR,30309122,1005,100,,Invoice,,,,,,28/03/2018,28/03/2018,0.00,,8.00,,"-229,944.19"
,IN,AR,30309176,1005,100,,Invoice,,,,,,28/03/2018,28/03/2018,0.00,,14.58,,"-229,958.77"
,IN,AR,30309187,1005,100,,Invoice,,,,,,28/03/2018,28/03/2018,0.00,,44.00,,"-230,002.77"
,IN,AR,30309198,1005,100,,Invoice,,,,,,28/03/2018,28/03/2018,0.00,,6.02,,"-230,008.79"
,IN,AR,30309201,1005,100,,Invoice,,,,,,28/03/2018,28/03/2018,0.00,,40.08,,"-230,048.87"
,IN,AR,30309208,1005,100,,Invoice,,,,,,28/03/2018,28/03/2018,0.00,,8.39,,"-230,057.26"
,IN,AR,30309221,1005,100,,Invoice,,,,,,28/03/2018,28/03/2018,0.00,,13.26,,"-230,070.52"
,IN,AR,30309233,1005,100,,Invoice,,,,,,28/03/2018,28/03/2018,0.00,,10.93,,"-230,081.45"
,IN,AR,30309265,1005,100,,Invoice,,,,,,28/03/2018,28/03/2018,0.00,,17.50,,"-230,098.95"
,IN,AR,30309307,1005,100,,Invoice,,,,,,28/03/2018,28/03/2018,0.00,,29.15,,"-230,128.10"
,IN,AR,30309311,1005,100,,Invoice,,,,,,28/03/2018,28/03/2018,0.00,,13.14,,"-230,141.24"
,IN,AR,30309315,1005,100,,Invoice,,,,,,28/03/2018,28/03/2018,0.00,,17.80,,"-230,159.04"
,IN,AR,30309327,1005,100,,Invoice,,,,,,28/03/2018,28/03/2018,0.00,,12.03,,"-230,171.07"
,IN,AR,30309337,1005,100,,Invoice,,,,,,28/03/2018,28/03/2018,0.00,,6.36,,"-230,177.43"
,IN,AR,30309358,1005,100,,Invoice,,,,,,28/03/2018,28/03/2018,0.00,,8.39,,"-230,185.82"
,IN,AR,30309395,1005,100,,Invoice,,,,,,28/03/2018,28/03/2018,0.00,,21.86,,"-230,207.68"
,IN,AR,30309401,1005,100,,Invoice,,,,,,28/03/2018,28/03/2018,0.00,,28.68,,"-230,236.36"
,IN,AR,30309408,1005,100,,Invoice,,,,,,28/03/2018,28/03/2018,0.00,,6.02,,"-230,242.38"
,IN,AR,30309414,1005,100,,Invoice,,,,,,28/03/2018,28/03/2018,0.00,,21.51,,"-230,263.89"
,IN,AR,30309418,1005,100,,Invoice,,,,,,28/03/2018,28/03/2018,0.00,,510.17,,"-230,774.06"
,IN,AR,30309455,1005,100,,Invoice,,,,,,28/03/2018,28/03/2018,0.00,,14.58,,"-230,788.64"
,IN,AR,30309471,1005,100,,Invoice,,,,,,28/03/2018,28/03/2018,0.00,,9.56,,"-230,798.20"
,IN,AR,30309521,1005,100,,Invoice,,,,,,28/03/2018,28/03/2018,0.00,,5.17,,"-230,803.37"
,IN,AR,30309539,1005,100,,Invoice,,,,,,28/03/2018,28/03/2018,0.00,,252.08,,"-231,055.45"
,IN,AR,30309599,1005,100,,Invoice,,,,,,28/03/2018,28/03/2018,0.00,,5.08,,"-231,060.53"
,IN,AR,30309600,1005,100,,Invoice,,,,,,28/03/2018,28/03/2018,0.00,,5.08,,"-231,065.61"
,IN,AR,30309601,1005,100,,Invoice,,,,,,28/03/2018,28/03/2018,0.00,,5.08,,"-231,070.69"
,IN,AR,30309602,1005,100,,Invoice,,,,,,28/03/2018,28/03/2018,0.00,,5.08,,"-231,075.77"
,IN,AR,30309622,1005,100,,Invoice,,,,,,28/03/2018,28/03/2018,0.00,,1.59,,"-231,077.36"
,IN,AR,30309623,1005,100,,Invoice,,,,,,28/03/2018,28/03/2018,0.00,,39.83,,"-231,117.19"
,IN,AR,30309624,1005,100,,Invoice,,,,,,28/03/2018,28/03/2018,0.00,,41.42,,"-231,158.61"
,IN,AR,30309630,1005,100,,Invoice,,,,,,28/03/2018,28/03/2018,0.00,,12.87,,"-231,171.48"
,IN,AR,30309631,1005,100,,Invoice,,,,,,28/03/2018,28/03/2018,0.00,,14.71,,"-231,186.19"
,IN,AR,30309645,1005,100,,Invoice,,,,,,28/03/2018,28/03/2018,0.00,,2.12,,"-231,188.31"
,IN,AR,30309714,1005,100,,Invoice,,,,,,28/03/2018,28/03/2018,0.00,,13.63,,"-231,201.94"
,IN,AR,30309759,1005,100,,Invoice,,,,,,28/03/2018,28/03/2018,0.00,,5.08,,"-231,207.02"
,IN,AR,30309773,1005,100,,Invoice,,,,,,28/03/2018,28/03/2018,0.00,,3.64,,"-231,210.66"
,IN,AR,30309806,1005,100,,Invoice,,,,,,28/03/2018,28/03/2018,0.00,,8.47,,"-231,219.13"
,IN,AR,30309842,1005,100,,Invoice,,,,,,28/03/2018,28/03/2018,0.00,,14.03,,"-231,233.16"
,IN,AR,30309858,1005,100,,Invoice,,,,,,28/03/2018,28/03/2018,0.00,,9.15,,"-231,242.31"
,IN,AR,30309866,1005,100,,Invoice,,,,,,28/03/2018,28/03/2018,0.00,,14.00,,"-231,256.31"
,IN,AR,30309898,1005,100,,Invoice,,,,,,28/03/2018,28/03/2018,0.00,,14.58,,"-231,270.89"
,IN,AR,30309907,1005,100,,Invoice,,,,,,28/03/2018,28/03/2018,0.00,,25.17,,"-231,296.06"
,IN,AR,30309911,1005,100,,Invoice,,,,,,28/03/2018,28/03/2018,0.00,,65.90,,"-231,361.96"
,IN,AR,30309919,1005,100,,Invoice,,,,,,28/03/2018,28/03/2018,0.00,,7.29,,"-231,369.25"
,IN,AR,30309930,1005,100,,Invoice,,,,,,28/03/2018,28/03/2018,0.00,,7.29,,"-231,376.54"
,IN,AR,30309940,1005,100,,Invoice,,,,,,28/03/2018,28/03/2018,0.00,,4.64,,"-231,381.18"
,IN,AR,30309948,1005,100,,Invoice,,,,,,28/03/2018,28/03/2018,0.00,,5.85,,"-231,387.03"
,IN,AR,30310008,1005,100,,Invoice,,,,,,28/03/2018,28/03/2018,0.00,,18.05,,"-231,405.08"
,IN,AR,30310024,1005,100,,Invoice,,,,,,28/03/2018,28/03/2018,0.00,,364.41,,"-231,769.49"
,IN,AR,30310036,1005,100,,Invoice,,,,,,28/03/2018,28/03/2018,0.00,,9.70,,"-231,779.19"
,IN,AR,30310058,1005,100,,Invoice,,,,,,28/03/2018,28/03/2018,0.00,,8.00,,"-231,787.19"
,IN,AR,30310073,1005,100,,Invoice,,,,,,28/03/2018,28/03/2018,0.00,,3.64,,"-231,790.83"
,IN,AR,30310098,1005,100,,Invoice,,,,,,28/03/2018,28/03/2018,0.00,,24.07,,"-231,814.90"
,IN,AR,30310105,1005,100,,Invoice,,,,,,28/03/2018,28/03/2018,0.00,,10.93,,"-231,825.83"
,IN,AR,30310115,1005,100,,Invoice,,,,,,28/03/2018,28/03/2018,0.00,,2.27,,"-231,828.10"
,IN,AR,30310137,1005,100,,Invoice,,,,,,28/03/2018,28/03/2018,0.00,,7.75,,"-231,835.85"
,IN,AR,30310144,1005,100,,Invoice,,,,,,28/03/2018,28/03/2018,0.00,,21.86,,"-231,857.71"
,IN,AR,30310150,1005,100,,Invoice,,,,,,28/03/2018,28/03/2018,0.00,,20.34,,"-231,878.05"
,IN,AR,30310151,1005,100,,Invoice,,,,,,28/03/2018,28/03/2018,0.00,,20.34,,"-231,898.39"
,IN,AR,30310157,1005,100,,Invoice,,,,,,28/03/2018,28/03/2018,0.00,,30.01,,"-231,928.40"
,IN,AR,30310166,1005,100,,Invoice,,,,,,28/03/2018,28/03/2018,0.00,,21.86,,"-231,950.26"
,IN,AR,30310181,1005,100,,Invoice,,,,,,28/03/2018,28/03/2018,0.00,,54.66,,"-232,004.92"
,IN,AR,30310188,1005,100,,Invoice,,,,,,28/03/2018,28/03/2018,0.00,,5.68,,"-232,010.60"
,IN,AR,30310209,1005,100,,Invoice,,,,,,28/03/2018,28/03/2018,0.00,,5.17,,"-232,015.77"
,IN,AR,30310219,1005,100,,Invoice,,,,,,28/03/2018,28/03/2018,0.00,,7.29,,"-232,023.06"
,IN,AR,30310222,1005,100,,Invoice,,,,,,28/03/2018,28/03/2018,0.00,,7.29,,"-232,030.35"
,IN,AR,30310223,1005,100,,Invoice,,,,,,28/03/2018,28/03/2018,0.00,,11.44,,"-232,041.79"
,IN,AR,30310261,1005,100,,Invoice,,,,,,28/03/2018,28/03/2018,0.00,,6.36,,"-232,048.15"
,IN,AR,30310262,1005,100,,Invoice,,,,,,28/03/2018,28/03/2018,0.00,,39.75,,"-232,087.90"
,IN,AR,30310279,1005,100,,Invoice,,,,,,28/03/2018,28/03/2018,0.00,,30.00,,"-232,117.90"
,IN,AR,30310287,1005,100,,Invoice,,,,,,28/03/2018,28/03/2018,0.00,,20.95,,"-232,138.85"
,IN,AR,30310288,1005,100,,Invoice,,,,,,28/03/2018,28/03/2018,0.00,,10.47,,"-232,149.32"
,IN,AR,30310294,1005,100,,Invoice,,,,,,28/03/2018,28/03/2018,0.00,,56.12,,"-232,205.44"
,IN,AR,30310303,1005,100,,Invoice,,,,,,28/03/2018,28/03/2018,0.00,,28.06,,"-232,233.50"
,IN,AR,30310305,1005,100,,Invoice,,,,,,28/03/2018,28/03/2018,0.00,,7.29,,"-232,240.79"
,IN,AR,30310313,1005,100,,Invoice,,,,,,28/03/2018,28/03/2018,0.00,,21.86,,"-232,262.65"
,IN,AR,30310317,1005,100,,Invoice,,,,,,28/03/2018,28/03/2018,0.00,,34.70,,"-232,297.35"
,IN,AR,30310335,1005,100,,Invoice,,,,,,28/03/2018,28/03/2018,0.00,,23.77,,"-232,321.12"
,IN,AR,30310382,1005,100,,Invoice,,,,,,28/03/2018,28/03/2018,0.00,,12.83,,"-232,333.95"
,IN,AR,30310383,1005,100,,Invoice,,,,,,28/03/2018,28/03/2018,0.00,,6.42,,"-232,340.37"
,IN,AR,30310384,1005,100,,Invoice,,,,,,28/03/2018,28/03/2018,0.00,,11.22,,"-232,351.59"
,IN,AR,30310385,1005,100,,Invoice,,,,,,28/03/2018,28/03/2018,0.00,,16.03,,"-232,367.62"
,IN,AR,30310386,1005,100,,Invoice,,,,,,28/03/2018,28/03/2018,0.00,,3.20,,"-232,370.82"
,IN,AR,30310420,1005,100,,Invoice,,,,,,28/03/2018,28/03/2018,0.00,,16.02,,"-232,386.84"
,IN,AR,30310429,1005,100,,Invoice,,,,,,28/03/2018,28/03/2018,0.00,,21.86,,"-232,408.70"
,IN,AR,30310434,1005,100,,Invoice,,,,,,28/03/2018,28/03/2018,0.00,,14.34,,"-232,423.04"
,IN,AR,30310445,1005,100,,Invoice,,,,,,28/03/2018,28/03/2018,0.00,,7.29,,"-232,430.33"
,IN,AR,30310463,1005,100,,Invoice,,,,,,28/03/2018,28/03/2018,0.00,,5.08,,"-232,435.41"
,IN,AR,30310464,1005,100,,Invoice,,,,,,28/03/2018,28/03/2018,0.00,,12.71,,"-232,448.12"
,IN,AR,30310520,1005,100,,Invoice,,,,,,28/03/2018,28/03/2018,0.00,,4.53,,"-232,452.65"
,IN,AR,30310525,1005,100,,Invoice,,,,,,28/03/2018,28/03/2018,0.00,,2.92,,"-232,455.57"
,IN,AR,30310536,1005,100,,Invoice,,,,,,28/03/2018,28/03/2018,0.00,,19.16,,"-232,474.73"
,IN,AR,30310550,1005,100,,Invoice,,,,,,28/03/2018,28/03/2018,0.00,,21.91,,"-232,496.64"
,IN,AR,30310555,1005,100,,Invoice,,,,,,28/03/2018,28/03/2018,0.00,,14.58,,"-232,511.22"
,IN,AR,30310601,1005,100,,Invoice,,,,,,28/03/2018,28/03/2018,0.00,,16.78,,"-232,528.00"
,IN,AR,30310675,1005,100,,Invoice,,,,,,28/03/2018,28/03/2018,0.00,,29.15,,"-232,557.15"
,IN,AR,30310679,1005,100,,Invoice,,,,,,28/03/2018,28/03/2018,0.00,,81.15,,"-232,638.30"
,IN,AR,30310711,1005,100,,Invoice,,,,,,28/03/2018,28/03/2018,0.00,,6.37,,"-232,644.67"
,IN,AR,30310712,1005,100,,Invoice,,,,,,28/03/2018,28/03/2018,0.00,,73.29,,"-232,717.96"
,IN,AR,30310713,1005,100,,Invoice,,,,,,28/03/2018,28/03/2018,0.00,,4.78,,"-232,722.74"
,IN,AR,30310714,1005,100,,Invoice,,,,,,28/03/2018,28/03/2018,0.00,,4.78,,"-232,727.52"
,IN,AR,30310715,1005,100,,Invoice,,,,,,28/03/2018,28/03/2018,0.00,,14.34,,"-232,741.86"
,IN,AR,30310791,1005,100,,Invoice,,,,,,28/03/2018,28/03/2018,0.00,,6.00,,"-232,747.86"
,IN,AR,30310841,1005,100,,Invoice,,,,,,28/03/2018,28/03/2018,0.00,,3.64,,"-232,751.50"
,IN,AR,30310910,1005,100,,Invoice,,,,,,28/03/2018,28/03/2018,0.00,,26.19,,"-232,777.69"
,IN,AR,30310915,1005,100,,Invoice,,,,,,28/03/2018,28/03/2018,0.00,,16.78,,"-232,794.47"
,IN,AR,30310937,1005,100,,Invoice,,,,,,28/03/2018,28/03/2018,0.00,,14.58,,"-232,809.05"
,IN,AR,30310961,1005,100,,Invoice,,,,,,28/03/2018,28/03/2018,0.00,,14.58,,"-232,823.63"
,IN,AR,30311007,1005,100,,Invoice,,,,,,28/03/2018,28/03/2018,0.00,,7.80,,"-232,831.43"
,IN,AR,30311042,1005,100,,Invoice,,,,,,28/03/2018,28/03/2018,0.00,,2.00,,"-232,833.43"
,IN,AR,30311043,1005,100,,Invoice,,,,,,28/03/2018,28/03/2018,0.00,,2.00,,"-232,835.43"
,IN,AR,30311052,1005,100,,Invoice,,,,,,28/03/2018,28/03/2018,0.00,,33.22,,"-232,868.65"
,IN,AR,30311053,1005,100,,Invoice,,,,,,28/03/2018,28/03/2018,0.00,,6.23,,"-232,874.88"
,IN,AR,30311067,1005,100,,Invoice,,,,,,28/03/2018,28/03/2018,0.00,,29.15,,"-232,904.03"
,IN,AR,30311070,1005,100,,Invoice,,,,,,28/03/2018,28/03/2018,0.00,,9.84,,"-232,913.87"
,CN,AR,31017490,1005,100,,Credit Note,,,,,,29/03/2018,29/03/2018,36.44,,0.00,,"-232,877.43"
,CN,AR,31017538,1005,100,,Credit Note,,,,,,29/03/2018,29/03/2018,20.59,,0.00,,"-232,856.84"
,CN,AR,31017539,1005,100,,Credit Note,,,,,,29/03/2018,29/03/2018,25.17,,0.00,,"-232,831.67"
,CN,AR,31017540,1005,100,,Credit Note,,,,,,29/03/2018,29/03/2018,22.88,,0.00,,"-232,808.79"
,CN,AR,31017665,1005,100,,Credit Note,,,,,,29/03/2018,29/03/2018,34.63,,0.00,,"-232,774.16"
,CS,AR,32001701,1005,100,,Cash sale,,,,,,29/03/2018,29/03/2018,0.00,,57.70,,"-232,831.86"
,CS,AR,32001708,1005,100,,Cash sale,,,,,,29/03/2018,29/03/2018,0.00,,15.04,,"-232,846.90"
,CS,AR,32001715,1005,100,,Cash sale,,,,,,29/03/2018,29/03/2018,0.00,,2.81,,"-232,849.71"
,CS,AR,32001720,1005,100,,Cash sale,,,,,,29/03/2018,29/03/2018,0.00,,25.17,,"-232,874.88"
,CS,AR,32001721,1005,100,,Cash sale,,,,,,29/03/2018,29/03/2018,0.00,,21.86,,"-232,896.74"
,CS,AR,32001738,1005,100,,Cash sale,,,,,,29/03/2018,29/03/2018,0.00,,9.49,,"-232,906.23"
,CS,AR,32001743,1005,100,,Cash sale,,,,,,29/03/2018,29/03/2018,0.00,,8.52,,"-232,914.75"
,CS,AR,32001811,1005,100,,Cash sale,,,,,,29/03/2018,29/03/2018,0.00,,21.36,,"-232,936.11"
,CS,AR,32001828,1005,100,,Cash sale,,,,,,29/03/2018,29/03/2018,0.00,,10.38,,"-232,946.49"
,CS,AR,32001850,1005,100,,Cash sale,,,,,,29/03/2018,29/03/2018,0.00,,3.64,,"-232,950.13"
,CS,AR,32001858,1005,100,,Cash sale,,,,,,29/03/2018,29/03/2018,0.00,,14.58,,"-232,964.71"
,CS,AR,32001882,1005,100,,Cash sale,,,,,,29/03/2018,29/03/2018,0.00,,10.93,,"-232,975.64"
,CS,AR,32001888,1005,100,,Cash sale,,,,,,29/03/2018,29/03/2018,0.00,,3.64,,"-232,979.28"
,CS,AR,32001901,1005,100,,Cash sale,,,,,,29/03/2018,29/03/2018,0.00,,7.29,,"-232,986.57"
,CS,AR,32001902,1005,100,,Cash sale,,,,,,29/03/2018,29/03/2018,0.00,,7.29,,"-232,993.86"
,CS,AR,32001915,1005,100,,Cash sale,,,,,,29/03/2018,29/03/2018,0.00,,7.29,,"-233,001.15"
,CS,AR,32001916,1005,100,,Cash sale,,,,,,29/03/2018,29/03/2018,0.00,,3.64,,"-233,004.79"
,CS,AR,32001950,1005,100,,Cash sale,,,,,,29/03/2018,29/03/2018,0.00,,7.63,,"-233,012.42"
,CS,AR,32001977,1005,100,,Cash sale,,,,,,29/03/2018,29/03/2018,0.00,,5.61,,"-233,018.03"
,CS,AR,32001989,1005,100,,Cash sale,,,,,,29/03/2018,29/03/2018,0.00,,10.99,,"-233,029.02"
,CS,AR,32002000,1005,100,,Cash sale,,,,,,29/03/2018,29/03/2018,0.00,,3.64,,"-233,032.66"
,CS,AR,32002038,1005,100,,Cash sale,,,,,,29/03/2018,29/03/2018,0.00,,7.29,,"-233,039.95"
,CS,AR,32002052,1005,100,,Cash sale,,,,,,29/03/2018,29/03/2018,0.00,,2.25,,"-233,042.20"
,CS,AR,32002076,1005,100,,Cash sale,,,,,,29/03/2018,29/03/2018,0.00,,27.08,,"-233,069.28"
,CS,AR,32002096,1005,100,,Cash sale,,,,,,29/03/2018,29/03/2018,0.00,,3.64,,"-233,072.92"
,CS,AR,32002113,1005,100,,Cash sale,,,,,,29/03/2018,29/03/2018,0.00,,20.34,,"-233,093.26"
,CS,AR,32002116,1005,100,,Cash sale,,,,,,29/03/2018,29/03/2018,0.00,,7.29,,"-233,100.55"
,CS,AR,32002126,1005,100,,Cash sale,,,,,,29/03/2018,29/03/2018,0.00,,7.29,,"-233,107.84"
,CS,AR,32002152,1005,100,,Cash sale,,,,,,29/03/2018,29/03/2018,0.00,,58.73,,"-233,166.57"
,CS,AR,32002173,1005,100,,Cash sale,,,,,,29/03/2018,29/03/2018,0.00,,14.58,,"-233,181.15"
,CS,AR,32002176,1005,100,,Cash sale,,,,,,29/03/2018,29/03/2018,0.00,,29.15,,"-233,210.30"
,CS,AR,32002195,1005,100,,Cash sale,,,,,,29/03/2018,29/03/2018,0.00,,20.48,,"-233,230.78"
,CS,AR,32002198,1005,100,,Cash sale,,,,,,29/03/2018,29/03/2018,0.00,,18.22,,"-233,249.00"
,CS,AR,32002259,1005,100,,Cash sale,,,,,,29/03/2018,29/03/2018,0.00,,3.64,,"-233,252.64"
,CS,AR,32002283,1005,100,,Cash sale,,,,,,29/03/2018,29/03/2018,0.00,,5.08,,"-233,257.72"
,CS,AR,32002298,1005,100,,Cash sale,,,,,,29/03/2018,29/03/2018,0.00,,7.29,,"-233,265.01"
,CS,AR,32002324,1005,100,,Cash sale,,,,,,29/03/2018,29/03/2018,0.00,,14.58,,"-233,279.59"
,CS,AR,32002344,1005,100,,Cash sale,,,,,,29/03/2018,29/03/2018,0.00,,15.17,,"-233,294.76"
,CS,AR,32002353,1005,100,,Cash sale,,,,,,29/03/2018,29/03/2018,0.00,,5.93,,"-233,300.69"
,CS,AR,32002388,1005,100,,Cash sale,,,,,,29/03/2018,29/03/2018,0.00,,21.86,,"-233,322.55"
,CS,AR,32002406,1005,100,,Cash sale,,,,,,29/03/2018,29/03/2018,0.00,,5.47,,"-233,328.02"
,CS,AR,32002409,1005,100,,Cash sale,,,,,,29/03/2018,29/03/2018,0.00,,7.29,,"-233,335.31"
,CS,AR,32002436,1005,100,,Cash sale,,,,,,29/03/2018,29/03/2018,0.00,,18.21,,"-233,353.52"
,CS,AR,32002445,1005,100,,Cash sale,,,,,,29/03/2018,29/03/2018,0.00,,3.64,,"-233,357.16"
,CS,AR,32002452,1005,100,,Cash sale,,,,,,29/03/2018,29/03/2018,0.00,,5.47,,"-233,362.63"
,CS,AR,32002470,1005,100,,Cash sale,,,,,,29/03/2018,29/03/2018,0.00,,9.10,,"-233,371.73"
,CS,AR,32002475,1005,100,,Cash sale,,,,,,29/03/2018,29/03/2018,0.00,,9.15,,"-233,380.88"
,CS,AR,32002481,1005,100,,Cash sale,,,,,,29/03/2018,29/03/2018,0.00,,6.56,,"-233,387.44"
,CS,AR,32002487,1005,100,,Cash sale,,,,,,29/03/2018,29/03/2018,0.00,,18.22,,"-233,405.66"
,CS,AR,32002497,1005,100,,Cash sale,,,,,,29/03/2018,29/03/2018,0.00,,12.17,,"-233,417.83"
,CS,AR,32002499,1005,100,,Cash sale,,,,,,29/03/2018,29/03/2018,0.00,,10.93,,"-233,428.76"
,CS,AR,32002541,1005,100,,Cash sale,,,,,,29/03/2018,29/03/2018,0.00,,7.29,,"-233,436.05"
,CS,AR,32002550,1005,100,,Cash sale,,,,,,29/03/2018,29/03/2018,0.00,,6.56,,"-233,442.61"
,CS,AR,32002575,1005,100,,Cash sale,,,,,,29/03/2018,29/03/2018,0.00,,7.29,,"-233,449.90"
,CS,AR,32002588,1005,100,,Cash sale,,,,,,29/03/2018,29/03/2018,0.00,,7.29,,"-233,457.19"
,IN,AR,30308812,1005,100,,Invoice,,,,,,29/03/2018,29/03/2018,0.00,,10.93,,"-233,468.12"
,IN,AR,30308856,1005,100,,Invoice,,,,,,29/03/2018,29/03/2018,0.00,,36.44,,"-233,504.56"
,IN,AR,30308885,1005,100,,Invoice,,,,,,29/03/2018,29/03/2018,0.00,,16.91,,"-233,521.47"
,IN,AR,30308923,1005,100,,Invoice,,,,,,29/03/2018,29/03/2018,0.00,,18.37,,"-233,539.84"
,IN,AR,30308928,1005,100,,Invoice,,,,,,29/03/2018,29/03/2018,0.00,,64.04,,"-233,603.88"
,IN,AR,30308962,1005,100,,Invoice,,,,,,29/03/2018,29/03/2018,0.00,,47.46,,"-233,651.34"
,IN,AR,30308975,1005,100,,Invoice,,,,,,29/03/2018,29/03/2018,0.00,,10.93,,"-233,662.27"
,IN,AR,30309054,1005,100,,Invoice,,,,,,29/03/2018,29/03/2018,0.00,,7.29,,"-233,669.56"
,IN,AR,30309055,1005,100,,Invoice,,,,,,29/03/2018,29/03/2018,0.00,,182.20,,"-233,851.76"
,IN,AR,30309077,1005,100,,Invoice,,,,,,29/03/2018,29/03/2018,0.00,,7.29,,"-233,859.05"
,IN,AR,30309087,1005,100,,Invoice,,,,,,29/03/2018,29/03/2018,0.00,,3.89,,"-233,862.94"
,IN,AR,30309107,1005,100,,Invoice,,,,,,29/03/2018,29/03/2018,0.00,,4.75,,"-233,867.69"
,IN,AR,30309149,1005,100,,Invoice,,,,,,29/03/2018,29/03/2018,0.00,,36.91,,"-233,904.60"
,IN,AR,30309171,1005,100,,Invoice,,,,,,29/03/2018,29/03/2018,0.00,,5.82,,"-233,910.42"
,IN,AR,30309216,1005,100,,Invoice,,,,,,29/03/2018,29/03/2018,0.00,,29.15,,"-233,939.57"
,IN,AR,30309256,1005,100,,Invoice,,,,,,29/03/2018,29/03/2018,0.00,,14.58,,"-233,954.15"
,IN,AR,30309368,1005,100,,Invoice,,,,,,29/03/2018,29/03/2018,0.00,,20.68,,"-233,974.83"
,IN,AR,30309370,1005,100,,Invoice,,,,,,29/03/2018,29/03/2018,0.00,,23.32,,"-233,998.15"
,IN,AR,30309374,1005,100,,Invoice,,,,,,29/03/2018,29/03/2018,0.00,,2.39,,"-234,000.54"
,IN,AR,30309381,1005,100,,Invoice,,,,,,29/03/2018,29/03/2018,0.00,,161.35,,"-234,161.89"
,IN,AR,30309425,1005,100,,Invoice,,,,,,29/03/2018,29/03/2018,0.00,,28.81,,"-234,190.70"
,IN,AR,30309436,1005,100,,Invoice,,,,,,29/03/2018,29/03/2018,0.00,,59.47,,"-234,250.17"
,IN,AR,30309472,1005,100,,Invoice,,,,,,29/03/2018,29/03/2018,0.00,,4.78,,"-234,254.95"
,IN,AR,30309479,1005,100,,Invoice,,,,,,29/03/2018,29/03/2018,0.00,,32.20,,"-234,287.15"
,IN,AR,30309484,1005,100,,Invoice,,,,,,29/03/2018,29/03/2018,0.00,,9.66,,"-234,296.81"
,IN,AR,30309603,1005,100,,Invoice,,,,,,29/03/2018,29/03/2018,0.00,,5.08,,"-234,301.89"
,IN,AR,30309608,1005,100,,Invoice,,,,,,29/03/2018,29/03/2018,0.00,,5.08,,"-234,306.97"
,IN,AR,30309610,1005,100,,Invoice,,,,,,29/03/2018,29/03/2018,0.00,,11.69,,"-234,318.66"
,IN,AR,30309625,1005,100,,Invoice,,,,,,29/03/2018,29/03/2018,0.00,,12.75,,"-234,331.41"
,IN,AR,30309632,1005,100,,Invoice,,,,,,29/03/2018,29/03/2018,0.00,,14.58,,"-234,345.99"
,IN,AR,30309637,1005,100,,Invoice,,,,,,29/03/2018,29/03/2018,0.00,,42.10,,"-234,388.09"
,IN,AR,30309641,1005,100,,Invoice,,,,,,29/03/2018,29/03/2018,0.00,,2.58,,"-234,390.67"
,IN,AR,30309649,1005,100,,Invoice,,,,,,29/03/2018,29/03/2018,0.00,,18.09,,"-234,408.76"
,IN,AR,30309689,1005,100,,Invoice,,,,,,29/03/2018,29/03/2018,0.00,,15.25,,"-234,424.01"
,IN,AR,30309705,1005,100,,Invoice,,,,,,29/03/2018,29/03/2018,0.00,,7.29,,"-234,431.30"
,IN,AR,30309709,1005,100,,Invoice,,,,,,29/03/2018,29/03/2018,0.00,,10.34,,"-234,441.64"
,IN,AR,30309717,1005,100,,Invoice,,,,,,29/03/2018,29/03/2018,0.00,,48.05,,"-234,489.69"
,IN,AR,30309726,1005,100,,Invoice,,,,,,29/03/2018,29/03/2018,0.00,,20.34,,"-234,510.03"
,IN,AR,30309742,1005,100,,Invoice,,,,,,29/03/2018,29/03/2018,0.00,,10.93,,"-234,520.96"
,IN,AR,30309772,1005,100,,Invoice,,,,,,29/03/2018,29/03/2018,0.00,,3.64,,"-234,524.60"
,IN,AR,30309821,1005,100,,Invoice,,,,,,29/03/2018,29/03/2018,0.00,,8.17,,"-234,532.77"
,IN,AR,30309862,1005,100,,Invoice,,,,,,29/03/2018,29/03/2018,0.00,,48.05,,"-234,580.82"
,IN,AR,30309875,1005,100,,Invoice,,,,,,29/03/2018,29/03/2018,0.00,,661.35,,"-235,242.17"
,IN,AR,30309916,1005,100,,Invoice,,,,,,29/03/2018,29/03/2018,0.00,,10.17,,"-235,252.34"
,IN,AR,30309951,1005,100,,Invoice,,,,,,29/03/2018,29/03/2018,0.00,,18.22,,"-235,270.56"
,IN,AR,30309964,1005,100,,Invoice,,,,,,29/03/2018,29/03/2018,0.00,,13.77,,"-235,284.33"
,IN,AR,30309988,1005,100,,Invoice,,,,,,29/03/2018,29/03/2018,0.00,,2.58,,"-235,286.91"
,IN,AR,30310013,1005,100,,Invoice,,,,,,29/03/2018,29/03/2018,0.00,,15.04,,"-235,301.95"
,IN,AR,30310029,1005,100,,Invoice,,,,,,29/03/2018,29/03/2018,0.00,,56.06,,"-235,358.01"
,IN,AR,30310030,1005,100,,Invoice,,,,,,29/03/2018,29/03/2018,0.00,,62.29,,"-235,420.30"
,IN,AR,30310041,1005,100,,Invoice,,,,,,29/03/2018,29/03/2018,0.00,,7.63,,"-235,427.93"
,IN,AR,30310051,1005,100,,Invoice,,,,,,29/03/2018,29/03/2018,0.00,,17.03,,"-235,444.96"
,IN,AR,30310109,1005,100,,Invoice,,,,,,29/03/2018,29/03/2018,0.00,,2.42,,"-235,447.38"
,IN,AR,30310147,1005,100,,Invoice,,,,,,29/03/2018,29/03/2018,0.00,,7.29,,"-235,454.67"
,IN,AR,30310190,1005,100,,Invoice,,,,,,29/03/2018,29/03/2018,0.00,,14.58,,"-235,469.25"
,IN,AR,30310216,1005,100,,Invoice,,,,,,29/03/2018,29/03/2018,0.00,,5.08,,"-235,474.33"
,IN,AR,30310243,1005,100,,Invoice,,,,,,29/03/2018,29/03/2018,0.00,,11.39,,"-235,485.72"
,IN,AR,30310244,1005,100,,Invoice,,,,,,29/03/2018,29/03/2018,0.00,,11.39,,"-235,497.11"
,IN,AR,30310245,1005,100,,Invoice,,,,,,29/03/2018,29/03/2018,0.00,,4.88,,"-235,501.99"
,IN,AR,30310263,1005,100,,Invoice,,,,,,29/03/2018,29/03/2018,0.00,,22.26,,"-235,524.25"
,IN,AR,30310274,1005,100,,Invoice,,,,,,29/03/2018,29/03/2018,0.00,,56.78,,"-235,581.03"
,IN,AR,30310314,1005,100,,Invoice,,,,,,29/03/2018,29/03/2018,0.00,,58.31,,"-235,639.34"
,IN,AR,30310315,1005,100,,Invoice,,,,,,29/03/2018,29/03/2018,0.00,,5.51,,"-235,644.85"
,IN,AR,30310329,1005,100,,Invoice,,,,,,29/03/2018,29/03/2018,0.00,,12.03,,"-235,656.88"
,IN,AR,30310387,1005,100,,Invoice,,,,,,29/03/2018,29/03/2018,0.00,,9.62,,"-235,666.50"
,IN,AR,30310388,1005,100,,Invoice,,,,,,29/03/2018,29/03/2018,0.00,,38.48,,"-235,704.98"
,IN,AR,30310389,1005,100,,Invoice,,,,,,29/03/2018,29/03/2018,0.00,,52.92,,"-235,757.90"
,IN,AR,30310465,1005,100,,Invoice,,,,,,29/03/2018,29/03/2018,0.00,,30.51,,"-235,788.41"
,IN,AR,30310471,1005,100,,Invoice,,,,,,29/03/2018,29/03/2018,0.00,,16.01,,"-235,804.42"
,IN,AR,30310480,1005,100,,Invoice,,,,,,29/03/2018,29/03/2018,0.00,,8.00,,"-235,812.42"
,IN,AR,30310484,1005,100,,Invoice,,,,,,29/03/2018,29/03/2018,0.00,,20.01,,"-235,832.43"
,IN,AR,30310511,1005,100,,Invoice,,,,,,29/03/2018,29/03/2018,0.00,,68.14,,"-235,900.57"
,IN,AR,30310521,1005,100,,Invoice,,,,,,29/03/2018,29/03/2018,0.00,,12.07,,"-235,912.64"
,IN,AR,30310545,1005,100,,Invoice,,,,,,29/03/2018,29/03/2018,0.00,,8.41,,"-235,921.05"
,IN,AR,30310561,1005,100,,Invoice,,,,,,29/03/2018,29/03/2018,0.00,,29.15,,"-235,950.20"
,IN,AR,30310571,1005,100,,Invoice,,,,,,29/03/2018,29/03/2018,0.00,,18.64,,"-235,968.84"
,IN,AR,30310584,1005,100,,Invoice,,,,,,29/03/2018,29/03/2018,0.00,,19.64,,"-235,988.48"
,IN,AR,30310588,1005,100,,Invoice,,,,,,29/03/2018,29/03/2018,0.00,,4.59,,"-235,993.07"
,IN,AR,30310594,1005,100,,Invoice,,,,,,29/03/2018,29/03/2018,0.00,,20.59,,"-236,013.66"
,IN,AR,30310595,1005,100,,Invoice,,,,,,29/03/2018,29/03/2018,0.00,,22.88,,"-236,036.54"
,IN,AR,30310598,1005,100,,Invoice,,,,,,29/03/2018,29/03/2018,0.00,,5.68,,"-236,042.22"
,IN,AR,30310605,1005,100,,Invoice,,,,,,29/03/2018,29/03/2018,0.00,,29.15,,"-236,071.37"
,IN,AR,30310647,1005,100,,Invoice,,,,,,29/03/2018,29/03/2018,0.00,,10.93,,"-236,082.30"
,IN,AR,30310655,1005,100,,Invoice,,,,,,29/03/2018,29/03/2018,0.00,,10.93,,"-236,093.23"
,IN,AR,30310664,1005,100,,Invoice,,,,,,29/03/2018,29/03/2018,0.00,,8.52,,"-236,101.75"
,IN,AR,30310669,1005,100,,Invoice,,,,,,29/03/2018,29/03/2018,0.00,,14.49,,"-236,116.24"
,IN,AR,30310716,1005,100,,Invoice,,,,,,29/03/2018,29/03/2018,0.00,,6.37,,"-236,122.61"
,IN,AR,30310717,1005,100,,Invoice,,,,,,29/03/2018,29/03/2018,0.00,,11.15,,"-236,133.76"
,IN,AR,30310776,1005,100,,Invoice,,,,,,29/03/2018,29/03/2018,0.00,,18.31,,"-236,152.07"
,IN,AR,30310821,1005,100,,Invoice,,,,,,29/03/2018,29/03/2018,0.00,,7.29,,"-236,159.36"
,IN,AR,30310849,1005,100,,Invoice,,,,,,29/03/2018,29/03/2018,0.00,,8.25,,"-236,167.61"
,IN,AR,30310857,1005,100,,Invoice,,,,,,29/03/2018,29/03/2018,0.00,,8.21,,"-236,175.82"
,IN,AR,30310888,1005,100,,Invoice,,,,,,29/03/2018,29/03/2018,0.00,,5.86,,"-236,181.68"
,IN,AR,30310927,1005,100,,Invoice,,,,,,29/03/2018,29/03/2018,0.00,,8.17,,"-236,189.85"
,IN,AR,30310928,1005,100,,Invoice,,,,,,29/03/2018,29/03/2018,0.00,,6.13,,"-236,195.98"
,IN,AR,30310964,1005,100,,Invoice,,,,,,29/03/2018,29/03/2018,0.00,,7.29,,"-236,203.27"
,IN,AR,30310967,1005,100,,Invoice,,,,,,29/03/2018,29/03/2018,0.00,,8.26,,"-236,211.53"
,IN,AR,30310991,1005,100,,Invoice,,,,,,29/03/2018,29/03/2018,0.00,,20.59,,"-236,232.12"
,IN,AR,30310992,1005,100,,Invoice,,,,,,29/03/2018,29/03/2018,0.00,,25.17,,"-236,257.29"
,IN,AR,30311028,1005,100,,Invoice,,,,,,29/03/2018,29/03/2018,0.00,,29.15,,"-236,286.44"
,IN,AR,30311076,1005,100,,Invoice,,,,,,29/03/2018,29/03/2018,0.00,,7.29,,"-236,293.73"
,IN,AR,30311077,1005,100,,Invoice,,,,,,29/03/2018,29/03/2018,0.00,,54.66,,"-236,348.39"
,CS,AR,32001834,1005,100,,Cash sale,,,,,,31/03/2018,31/03/2018,0.00,,14.58,,"-236,362.97"
,CS,AR,32001896,1005,100,,Cash sale,,,,,,31/03/2018,31/03/2018,0.00,,10.93,,"-236,373.90"
,CS,AR,32001941,1005,100,,Cash sale,,,,,,31/03/2018,31/03/2018,0.00,,7.29,,"-236,381.19"
,CS,AR,32002381,1005,100,,Cash sale,,,,,,31/03/2018,31/03/2018,0.00,,9.15,,"-236,390.34"
,IN,AR,30308861,1005,100,,Invoice,,,,,,31/03/2018,31/03/2018,0.00,,940.56,,"-237,330.90"
,IN,AR,30308969,1005,100,,Invoice,,,,,,31/03/2018,31/03/2018,0.00,,"1,375.00",,"-238,705.90"
,IN,AR,30309021,1005,100,,Invoice,,,,,,31/03/2018,31/03/2018,0.00,,7.29,,"-238,713.19"
,IN,AR,30309079,1005,100,,Invoice,,,,,,31/03/2018,31/03/2018,0.00,,40.08,,"-238,753.27"
,IN,AR,30309112,1005,100,,Invoice,,,,,,31/03/2018,31/03/2018,0.00,,30.30,,"-238,783.57"
,IN,AR,30309222,1005,100,,Invoice,,,,,,31/03/2018,31/03/2018,0.00,,84.24,,"-238,867.81"
,IN,AR,30309317,1005,100,,Invoice,,,,,,31/03/2018,31/03/2018,0.00,,"1,398.13",,"-240,265.94"
,IN,AR,30309318,1005,100,,Invoice,,,,,,31/03/2018,31/03/2018,0.00,,47.36,,"-240,313.30"
,IN,AR,30309319,1005,100,,Invoice,,,,,,31/03/2018,31/03/2018,0.00,,21.05,,"-240,334.35"
,IN,AR,30309320,1005,100,,Invoice,,,,,,31/03/2018,31/03/2018,0.00,,59.64,,"-240,393.99"
,IN,AR,30309349,1005,100,,Invoice,,,,,,31/03/2018,31/03/2018,0.00,,203.39,,"-240,597.38"
,IN,AR,30309415,1005,100,,Invoice,,,,,,31/03/2018,31/03/2018,0.00,,"1,825.46",,"-242,422.84"
,IN,AR,30309490,1005,100,,Invoice,,,,,,31/03/2018,31/03/2018,0.00,,624.20,,"-243,047.04"
,IN,AR,30309491,1005,100,,Invoice,,,,,,31/03/2018,31/03/2018,0.00,,28.53,,"-243,075.57"
,IN,AR,30309492,1005,100,,Invoice,,,,,,31/03/2018,31/03/2018,0.00,,20.14,,"-243,095.71"
,IN,AR,30309493,1005,100,,Invoice,,,,,,31/03/2018,31/03/2018,0.00,,41.95,,"-243,137.66"
,IN,AR,30309494,1005,100,,Invoice,,,,,,31/03/2018,31/03/2018,0.00,,16.78,,"-243,154.44"
,IN,AR,30309495,1005,100,,Invoice,,,,,,31/03/2018,31/03/2018,0.00,,13.42,,"-243,167.86"
,IN,AR,30309496,1005,100,,Invoice,,,,,,31/03/2018,31/03/2018,0.00,,16.78,,"-243,184.64"
,IN,AR,30309534,1005,100,,Invoice,,,,,,31/03/2018,31/03/2018,0.00,,105.25,,"-243,289.89"
,IN,AR,30309536,1005,100,,Invoice,,,,,,31/03/2018,31/03/2018,0.00,,143.85,,"-243,433.74"
,IN,AR,30309540,1005,100,,Invoice,,,,,,31/03/2018,31/03/2018,0.00,,35.75,,"-243,469.49"
,IN,AR,30309541,1005,100,,Invoice,,,,,,31/03/2018,31/03/2018,0.00,,54.38,,"-243,523.87"
,IN,AR,30309542,1005,100,,Invoice,,,,,,31/03/2018,31/03/2018,0.00,,150.86,,"-243,674.73"
,IN,AR,30309544,1005,100,,Invoice,,,,,,31/03/2018,31/03/2018,0.00,,28.07,,"-243,702.80"
,IN,AR,30309545,1005,100,,Invoice,,,,,,31/03/2018,31/03/2018,0.00,,9.41,,"-243,712.21"
,IN,AR,30309546,1005,100,,Invoice,,,,,,31/03/2018,31/03/2018,0.00,,1.88,,"-243,714.09"
,IN,AR,30309547,1005,100,,Invoice,,,,,,31/03/2018,31/03/2018,0.00,,30.10,,"-243,744.19"
,IN,AR,30309548,1005,100,,Invoice,,,,,,31/03/2018,31/03/2018,0.00,,45.15,,"-243,789.34"
,IN,AR,30309549,1005,100,,Invoice,,,,,,31/03/2018,31/03/2018,0.00,,5.64,,"-243,794.98"
,IN,AR,30309550,1005,100,,Invoice,,,,,,31/03/2018,31/03/2018,0.00,,18.81,,"-243,813.79"
,IN,AR,30309551,1005,100,,Invoice,,,,,,31/03/2018,31/03/2018,0.00,,58.32,,"-243,872.11"
,IN,AR,30309552,1005,100,,Invoice,,,,,,31/03/2018,31/03/2018,0.00,,5.64,,"-243,877.75"
,IN,AR,30309553,1005,100,,Invoice,,,,,,31/03/2018,31/03/2018,0.00,,1.88,,"-243,879.63"
,IN,AR,30309554,1005,100,,Invoice,,,,,,31/03/2018,31/03/2018,0.00,,3.76,,"-243,883.39"
,IN,AR,30309558,1005,100,,Invoice,,,,,,31/03/2018,31/03/2018,0.00,,384.18,,"-244,267.57"
,IN,AR,30309561,1005,100,,Invoice,,,,,,31/03/2018,31/03/2018,0.00,,7.29,,"-244,274.86"
,IN,AR,30309562,1005,100,,Invoice,,,,,,31/03/2018,31/03/2018,0.00,,68.42,,"-244,343.28"
,IN,AR,30309563,1005,100,,Invoice,,,,,,31/03/2018,31/03/2018,0.00,,36.84,,"-244,380.12"
,IN,AR,30309565,1005,100,,Invoice,,,,,,31/03/2018,31/03/2018,0.00,,15.05,,"-244,395.17"
,IN,AR,30309566,1005,100,,Invoice,,,,,,31/03/2018,31/03/2018,0.00,,50.87,,"-244,446.04"
,IN,AR,30309567,1005,100,,Invoice,,,,,,31/03/2018,31/03/2018,0.00,,29.82,,"-244,475.86"
,IN,AR,30309570,1005,100,,Invoice,,,,,,31/03/2018,31/03/2018,0.00,,21.05,,"-244,496.91"
,IN,AR,30309571,1005,100,,Invoice,,,,,,31/03/2018,31/03/2018,0.00,,35.08,,"-244,531.99"
,IN,AR,30309572,1005,100,,Invoice,,,,,,31/03/2018,31/03/2018,0.00,,19.30,,"-244,551.29"
,IN,AR,30309576,1005,100,,Invoice,,,,,,31/03/2018,31/03/2018,0.00,,3.51,,"-244,554.80"
,IN,AR,30309604,1005,100,,Invoice,,,,,,31/03/2018,31/03/2018,0.00,,15.79,,"-244,570.59"
,IN,AR,30309653,1005,100,,Invoice,,,,,,31/03/2018,31/03/2018,0.00,,137.69,,"-244,708.28"
,IN,AR,30309654,1005,100,,Invoice,,,,,,31/03/2018,31/03/2018,0.00,,32.19,,"-244,740.47"
,IN,AR,30309655,1005,100,,Invoice,,,,,,31/03/2018,31/03/2018,0.00,,5.36,,"-244,745.83"
,IN,AR,30309656,1005,100,,Invoice,,,,,,31/03/2018,31/03/2018,0.00,,69.74,,"-244,815.57"
,IN,AR,30309657,1005,100,,Invoice,,,,,,31/03/2018,31/03/2018,0.00,,33.97,,"-244,849.54"
,IN,AR,30309658,1005,100,,Invoice,,,,,,31/03/2018,31/03/2018,0.00,,17.88,,"-244,867.42"
,IN,AR,30309659,1005,100,,Invoice,,,,,,31/03/2018,31/03/2018,0.00,,37.55,,"-244,904.97"
,IN,AR,30309660,1005,100,,Invoice,,,,,,31/03/2018,31/03/2018,0.00,,3.58,,"-244,908.55"
,IN,AR,30309661,1005,100,,Invoice,,,,,,31/03/2018,31/03/2018,0.00,,51.86,,"-244,960.41"
,IN,AR,30309662,1005,100,,Invoice,,,,,,31/03/2018,31/03/2018,0.00,,1.79,,"-244,962.20"
,IN,AR,30309663,1005,100,,Invoice,,,,,,31/03/2018,31/03/2018,0.00,,219.94,,"-245,182.14"
,IN,AR,30309664,1005,100,,Invoice,,,,,,31/03/2018,31/03/2018,0.00,,7.15,,"-245,189.29"
,IN,AR,30309665,1005,100,,Invoice,,,,,,31/03/2018,31/03/2018,0.00,,8.94,,"-245,198.23"
,IN,AR,30309666,1005,100,,Invoice,,,,,,31/03/2018,31/03/2018,0.00,,10.73,,"-245,208.96"
,IN,AR,30309667,1005,100,,Invoice,,,,,,31/03/2018,31/03/2018,0.00,,19.67,,"-245,228.63"
,IN,AR,30309669,1005,100,,Invoice,,,,,,31/03/2018,31/03/2018,0.00,,23.25,,"-245,251.88"
,IN,AR,30309670,1005,100,,Invoice,,,,,,31/03/2018,31/03/2018,0.00,,32.19,,"-245,284.07"
,IN,AR,30309671,1005,100,,Invoice,,,,,,31/03/2018,31/03/2018,0.00,,21.46,,"-245,305.53"
,IN,AR,30309672,1005,100,,Invoice,,,,,,31/03/2018,31/03/2018,0.00,,7.15,,"-245,312.68"
,IN,AR,30309673,1005,100,,Invoice,,,,,,31/03/2018,31/03/2018,0.00,,16.09,,"-245,328.77"
,IN,AR,30309674,1005,100,,Invoice,,,,,,31/03/2018,31/03/2018,0.00,,5.36,,"-245,334.13"
,IN,AR,30309675,1005,100,,Invoice,,,,,,31/03/2018,31/03/2018,0.00,,10.73,,"-245,344.86"
,IN,AR,30309676,1005,100,,Invoice,,,,,,31/03/2018,31/03/2018,0.00,,25.03,,"-245,369.89"
,IN,AR,30309677,1005,100,,Invoice,,,,,,31/03/2018,31/03/2018,0.00,,14.31,,"-245,384.20"
,IN,AR,30309680,1005,100,,Invoice,,,,,,31/03/2018,31/03/2018,0.00,,98.24,,"-245,482.44"
,IN,AR,30309681,1005,100,,Invoice,,,,,,31/03/2018,31/03/2018,0.00,,165.43,,"-245,647.87"
,IN,AR,30309682,1005,100,,Invoice,,,,,,31/03/2018,31/03/2018,0.00,,108.25,,"-245,756.12"
,IN,AR,30309683,1005,100,,Invoice,,,,,,31/03/2018,31/03/2018,0.00,,10.21,,"-245,766.33"
,IN,AR,30309684,1005,100,,Invoice,,,,,,31/03/2018,31/03/2018,0.00,,120.50,,"-245,886.83"
,IN,AR,30309685,1005,100,,Invoice,,,,,,31/03/2018,31/03/2018,0.00,,24.51,,"-245,911.34"
,IN,AR,30309686,1005,100,,Invoice,,,,,,31/03/2018,31/03/2018,0.00,,138.88,,"-246,050.22"
,IN,AR,30309873,1005,100,,Invoice,,,,,,31/03/2018,31/03/2018,0.00,,"1,030.04",,"-247,080.26"
,IN,AR,30309880,1005,100,,Invoice,,,,,,31/03/2018,31/03/2018,0.00,,305.39,,"-247,385.65"
,IN,AR,30309881,1005,100,,Invoice,,,,,,31/03/2018,31/03/2018,0.00,,58.73,,"-247,444.38"
,IN,AR,30309882,1005,100,,Invoice,,,,,,31/03/2018,31/03/2018,0.00,,33.33,,"-247,477.71"
,IN,AR,30310004,1005,100,,Invoice,,,,,,31/03/2018,31/03/2018,0.00,,72.43,,"-247,550.14"
,IN,AR,30310170,1005,100,,Invoice,,,,,,31/03/2018,31/03/2018,0.00,,530.82,,"-248,080.96"
,IN,AR,30310192,1005,100,,Invoice,,,,,,31/03/2018,31/03/2018,0.00,,69.92,,"-248,150.88"
,IN,AR,30310193,1005,100,,Invoice,,,,,,31/03/2018,31/03/2018,0.00,,20.97,,"-248,171.85"
,IN,AR,30310194,1005,100,,Invoice,,,,,,31/03/2018,31/03/2018,0.00,,51.27,,"-248,223.12"
,IN,AR,30310195,1005,100,,Invoice,,,,,,31/03/2018,31/03/2018,0.00,,11.65,,"-248,234.77"
,IN,AR,30310196,1005,100,,Invoice,,,,,,31/03/2018,31/03/2018,0.00,,48.94,,"-248,283.71"
,IN,AR,30310197,1005,100,,Invoice,,,,,,31/03/2018,31/03/2018,0.00,,39.62,,"-248,323.33"
,IN,AR,30310198,1005,100,,Invoice,,,,,,31/03/2018,31/03/2018,0.00,,39.62,,"-248,362.95"
,IN,AR,30310199,1005,100,,Invoice,,,,,,31/03/2018,31/03/2018,0.00,,55.93,,"-248,418.88"
,IN,AR,30310200,1005,100,,Invoice,,,,,,31/03/2018,31/03/2018,0.00,,23.31,,"-248,442.19"
,IN,AR,30310204,1005,100,,Invoice,,,,,,31/03/2018,31/03/2018,0.00,,730.10,,"-249,172.29"
,IN,AR,30310306,1005,100,,Invoice,,,,,,31/03/2018,31/03/2018,0.00,,160.59,,"-249,332.88"
,IN,AR,30310307,1005,100,,Invoice,,,,,,31/03/2018,31/03/2018,0.00,,401.96,,"-249,734.84"
,IN,AR,30310409,1005,100,,Invoice,,,,,,31/03/2018,31/03/2018,0.00,,211.42,,"-249,946.26"
,IN,AR,30310410,1005,100,,Invoice,,,,,,31/03/2018,31/03/2018,0.00,,24.54,,"-249,970.80"
,IN,AR,30310411,1005,100,,Invoice,,,,,,31/03/2018,31/03/2018,0.00,,22.65,,"-249,993.45"
,IN,AR,30310412,1005,100,,Invoice,,,,,,31/03/2018,31/03/2018,0.00,,22.65,,"-250,016.10"
,IN,AR,30310530,1005,100,,Invoice,,,,,,31/03/2018,31/03/2018,0.00,,58.84,,"-250,074.94"
,IN,AR,30310724,1005,100,,Invoice,,,,,,31/03/2018,31/03/2018,0.00,,"1,161.69",,"-251,236.63"
,IN,AR,30310725,1005,100,,Invoice,,,,,,31/03/2018,31/03/2018,0.00,,15.59,,"-251,252.22"
,IN,AR,30310726,1005,100,,Invoice,,,,,,31/03/2018,31/03/2018,0.00,,9.75,,"-251,261.97"
,IN,AR,30310727,1005,100,,Invoice,,,,,,31/03/2018,31/03/2018,0.00,,27.29,,"-251,289.26"
,IN,AR,30310728,1005,100,,Invoice,,,,,,31/03/2018,31/03/2018,0.00,,5.85,,"-251,295.11"
,IN,AR,30310729,1005,100,,Invoice,,,,,,31/03/2018,31/03/2018,0.00,,7.80,,"-251,302.91"
,IN,AR,30310730,1005,100,,Invoice,,,,,,31/03/2018,31/03/2018,0.00,,15.59,,"-251,318.50"
,IN,AR,30310731,1005,100,,Invoice,,,,,,31/03/2018,31/03/2018,0.00,,13.64,,"-251,332.14"
,IN,AR,30310732,1005,100,,Invoice,,,,,,31/03/2018,31/03/2018,0.00,,3.90,,"-251,336.04"
,IN,AR,30310733,1005,100,,Invoice,,,,,,31/03/2018,31/03/2018,0.00,,11.69,,"-251,347.73"
,IN,AR,30310734,1005,100,,Invoice,,,,,,31/03/2018,31/03/2018,0.00,,15.59,,"-251,363.32"
,IN,AR,30310735,1005,100,,Invoice,,,,,,31/03/2018,31/03/2018,0.00,,17.54,,"-251,380.86"
,IN,AR,30310736,1005,100,,Invoice,,,,,,31/03/2018,31/03/2018,0.00,,31.19,,"-251,412.05"
,IN,AR,30310737,1005,100,,Invoice,,,,,,31/03/2018,31/03/2018,0.00,,3.90,,"-251,415.95"
,IN,AR,30310738,1005,100,,Invoice,,,,,,31/03/2018,31/03/2018,0.00,,9.75,,"-251,425.70"
,IN,AR,30310739,1005,100,,Invoice,,,,,,31/03/2018,31/03/2018,0.00,,5.85,,"-251,431.55"
,IN,AR,30310740,1005,100,,Invoice,,,,,,31/03/2018,31/03/2018,0.00,,13.64,,"-251,445.19"
,IN,AR,30310741,1005,100,,Invoice,,,,,,31/03/2018,31/03/2018,0.00,,13.64,,"-251,458.83"
,IN,AR,30310742,1005,100,,Invoice,,,,,,31/03/2018,31/03/2018,0.00,,31.19,,"-251,490.02"
,IN,AR,30310743,1005,100,,Invoice,,,,,,31/03/2018,31/03/2018,0.00,,15.59,,"-251,505.61"
,IN,AR,30310744,1005,100,,Invoice,,,,,,31/03/2018,31/03/2018,0.00,,13.64,,"-251,519.25"
,IN,AR,30310745,1005,100,,Invoice,,,,,,31/03/2018,31/03/2018,0.00,,9.75,,"-251,529.00"
,IN,AR,30310746,1005,100,,Invoice,,,,,,31/03/2018,31/03/2018,0.00,,74.07,,"-251,603.07"
,IN,AR,30310747,1005,100,,Invoice,,,,,,31/03/2018,31/03/2018,0.00,,21.44,,"-251,624.51"
,IN,AR,30310748,1005,100,,Invoice,,,,,,31/03/2018,31/03/2018,0.00,,29.24,,"-251,653.75"
,IN,AR,30310749,1005,100,,Invoice,,,,,,31/03/2018,31/03/2018,0.00,,853.73,,"-252,507.48"
,IN,AR,30310750,1005,100,,Invoice,,,,,,31/03/2018,31/03/2018,0.00,,21.44,,"-252,528.92"
,IN,AR,30310751,1005,100,,Invoice,,,,,,31/03/2018,31/03/2018,0.00,,372.29,,"-252,901.21"
,IN,AR,30310752,1005,100,,Invoice,,,,,,31/03/2018,31/03/2018,0.00,,46.78,,"-252,947.99"
,IN,AR,30310794,1005,100,,Invoice,,,,,,31/03/2018,31/03/2018,0.00,,16.93,,"-252,964.92"
,IN,AR,30310795,1005,100,,Invoice,,,,,,31/03/2018,31/03/2018,0.00,,11.29,,"-252,976.21"
,IN,AR,30310796,1005,100,,Invoice,,,,,,31/03/2018,31/03/2018,0.00,,16.93,,"-252,993.14"
,IN,AR,30310797,1005,100,,Invoice,,,,,,31/03/2018,31/03/2018,0.00,,7.53,,"-253,000.67"
,IN,AR,30310830,1005,100,,Invoice,,,,,,31/03/2018,31/03/2018,0.00,,822.74,,"-253,823.41"
,IN,AR,30310880,1005,100,,Invoice,,,,,,31/03/2018,31/03/2018,0.00,,505.15,,"-254,328.56"
,IN,AR,30310881,1005,100,,Invoice,,,,,,31/03/2018,31/03/2018,0.00,,168.38,,"-254,496.94"
,IN,AR,30310968,1005,100,,Invoice,,,,,,31/03/2018,31/03/2018,0.00,,12.94,,"-254,509.88"
,IN,AR,30310987,1005,100,,Invoice,,,,,,31/03/2018,31/03/2018,0.00,,46.53,,"-254,556.41"
,IN,AR,30310988,1005,100,,Invoice,,,,,,31/03/2018,31/03/2018,0.00,,16.42,,"-254,572.83"
,IN,AR,30310989,1005,100,,Invoice,,,,,,31/03/2018,31/03/2018,0.00,,5.47,,"-254,578.30"
,IN,AR,30310990,1005,100,,Invoice,,,,,,31/03/2018,31/03/2018,0.00,,8.21,,"-254,586.51"
,CS,AR,32002596,1005,100,,Cash sale,,,,,,02/04/2018,02/04/2018,0.00,,19.64,,"-254,606.15"
,CS,AR,32002614,1005,100,,Cash sale,,,,,,02/04/2018,02/04/2018,0.00,,14.24,,"-254,620.39"
,CS,AR,32002679,1005,100,,Cash sale,,,,,,02/04/2018,02/04/2018,0.00,,60.17,,"-254,680.56"
,CS,AR,32002706,1005,100,,Cash sale,,,,,,02/04/2018,02/04/2018,0.00,,3.64,,"-254,684.20"
,CS,AR,32002712,1005,100,,Cash sale,,,,,,02/04/2018,02/04/2018,0.00,,14.53,,"-254,698.73"
,CS,AR,32002756,1005,100,,Cash sale,,,,,,02/04/2018,02/04/2018,0.00,,3.64,,"-254,702.37"
,CS,AR,32002784,1005,100,,Cash sale,,,,,,02/04/2018,02/04/2018,0.00,,10.34,,"-254,712.71"
,CS,AR,32002811,1005,100,,Cash sale,,,,,,02/04/2018,02/04/2018,0.00,,10.93,,"-254,723.64"
,CS,AR,32002813,1005,100,,Cash sale,,,,,,02/04/2018,02/04/2018,0.00,,7.29,,"-254,730.93"
,CS,AR,32002824,1005,100,,Cash sale,,,,,,02/04/2018,02/04/2018,0.00,,17.80,,"-254,748.73"
,CS,AR,32002863,1005,100,,Cash sale,,,,,,02/04/2018,02/04/2018,0.00,,10.99,,"-254,759.72"
,CS,AR,32002879,1005,100,,Cash sale,,,,,,02/04/2018,02/04/2018,0.00,,10.93,,"-254,770.65"
,CS,AR,32002899,1005,100,,Cash sale,,,,,,02/04/2018,02/04/2018,0.00,,14.58,,"-254,785.23"
,CS,AR,32002918,1005,100,,Cash sale,,,,,,02/04/2018,02/04/2018,0.00,,29.24,,"-254,814.47"
,CS,AR,32002926,1005,100,,Cash sale,,,,,,02/04/2018,02/04/2018,0.00,,2.72,,"-254,817.19"
,CS,AR,32002933,1005,100,,Cash sale,,,,,,02/04/2018,02/04/2018,0.00,,11.86,,"-254,829.05"
,CS,AR,32002934,1005,100,,Cash sale,,,,,,02/04/2018,02/04/2018,0.00,,48.14,,"-254,877.19"
,CS,AR,32002946,1005,100,,Cash sale,,,,,,02/04/2018,02/04/2018,0.00,,10.93,,"-254,888.12"
,CS,AR,32002989,1005,100,,Cash sale,,,,,,02/04/2018,02/04/2018,0.00,,2.63,,"-254,890.75"
,CS,AR,32002992,1005,100,,Cash sale,,,,,,02/04/2018,02/04/2018,0.00,,2.54,,"-254,893.29"
,CS,AR,32003020,1005,100,,Cash sale,,,,,,02/04/2018,02/04/2018,0.00,,5.17,,"-254,898.46"
,CS,AR,32003024,1005,100,,Cash sale,,,,,,02/04/2018,02/04/2018,0.00,,5.85,,"-254,904.31"
,CS,AR,32003037,1005,100,,Cash sale,,,,,,02/04/2018,02/04/2018,0.00,,7.29,,"-254,911.60"
,CS,AR,32003040,1005,100,,Cash sale,,,,,,02/04/2018,02/04/2018,0.00,,7.29,,"-254,918.89"
,CS,AR,32003075,1005,100,,Cash sale,,,,,,02/04/2018,02/04/2018,0.00,,5.17,,"-254,924.06"
,CS,AR,32003087,1005,100,,Cash sale,,,,,,02/04/2018,02/04/2018,0.00,,6.42,,"-254,930.48"
,CS,AR,32003133,1005,100,,Cash sale,,,,,,02/04/2018,02/04/2018,0.00,,5.17,,"-254,935.65"
,CS,AR,32003156,1005,100,,Cash sale,,,,,,02/04/2018,02/04/2018,0.00,,3.64,,"-254,939.29"
,CS,AR,32003166,1005,100,,Cash sale,,,,,,02/04/2018,02/04/2018,0.00,,12.71,,"-254,952.00"
,CS,AR,32003207,1005,100,,Cash sale,,,,,,02/04/2018,02/04/2018,0.00,,9.84,,"-254,961.84"
,CS,AR,32003210,1005,100,,Cash sale,,,,,,02/04/2018,02/04/2018,0.00,,3.64,,"-254,965.48"
,CS,AR,32003219,1005,100,,Cash sale,,,,,,02/04/2018,02/04/2018,0.00,,9.84,,"-254,975.32"
,CS,AR,32003226,1005,100,,Cash sale,,,,,,02/04/2018,02/04/2018,0.00,,9.15,,"-254,984.47"
,CS,AR,32003331,1005,100,,Cash sale,,,,,,02/04/2018,02/04/2018,0.00,,3.64,,"-254,988.11"
,CS,AR,32003400,1005,100,,Cash sale,,,,,,02/04/2018,02/04/2018,0.00,,3.64,,"-254,991.75"
,CS,AR,32003404,1005,100,,Cash sale,,,,,,02/04/2018,02/04/2018,0.00,,18.22,,"-255,009.97"
,CS,AR,32003405,1005,100,,Cash sale,,,,,,02/04/2018,02/04/2018,0.00,,72.88,,"-255,082.85"
,IN,AR,30311086,1005,100,,Invoice,,,,,,02/04/2018,02/04/2018,0.00,,112.71,,"-255,195.56"
,IN,AR,30311106,1005,100,,Invoice,,,,,,02/04/2018,02/04/2018,0.00,,364.41,,"-255,559.97"
,IN,AR,30311107,1005,100,,Invoice,,,,,,02/04/2018,02/04/2018,0.00,,14.58,,"-255,574.55"
,IN,AR,30311190,1005,100,,Invoice,,,,,,02/04/2018,02/04/2018,0.00,,50.73,,"-255,625.28"
,IN,AR,30311228,1005,100,,Invoice,,,,,,02/04/2018,02/04/2018,0.00,,116.27,,"-255,741.55"
,IN,AR,30311249,1005,100,,Invoice,,,,,,02/04/2018,02/04/2018,0.00,,8.26,,"-255,749.81"
,IN,AR,30311258,1005,100,,Invoice,,,,,,02/04/2018,02/04/2018,0.00,,58.00,,"-255,807.81"
,IN,AR,30311283,1005,100,,Invoice,,,,,,02/04/2018,02/04/2018,0.00,,38.18,,"-255,845.99"
,IN,AR,30311305,1005,100,,Invoice,,,,,,02/04/2018,02/04/2018,0.00,,42.00,,"-255,887.99"
,IN,AR,30311306,1005,100,,Invoice,,,,,,02/04/2018,02/04/2018,0.00,,12.00,,"-255,899.99"
,IN,AR,30311332,1005,100,,Invoice,,,,,,02/04/2018,02/04/2018,0.00,,2.75,,"-255,902.74"
,IN,AR,30311336,1005,100,,Invoice,,,,,,02/04/2018,02/04/2018,0.00,,15.25,,"-255,917.99"
,IN,AR,30311338,1005,100,,Invoice,,,,,,02/04/2018,02/04/2018,0.00,,5.51,,"-255,923.50"
,IN,AR,30311350,1005,100,,Invoice,,,,,,02/04/2018,02/04/2018,0.00,,5.84,,"-255,929.34"
,IN,AR,30311361,1005,100,,Invoice,,,,,,02/04/2018,02/04/2018,0.00,,8.77,,"-255,938.11"
,IN,AR,30311371,1005,100,,Invoice,,,,,,02/04/2018,02/04/2018,0.00,,14.00,,"-255,952.11"
,IN,AR,30311380,1005,100,,Invoice,,,,,,02/04/2018,02/04/2018,0.00,,7.29,,"-255,959.40"
,IN,AR,30311413,1005,100,,Invoice,,,,,,02/04/2018,02/04/2018,0.00,,780.96,,"-256,740.36"
,IN,AR,30311457,1005,100,,Invoice,,,,,,02/04/2018,02/04/2018,0.00,,12.88,,"-256,753.24"
,IN,AR,30311462,1005,100,,Invoice,,,,,,02/04/2018,02/04/2018,0.00,,364.41,,"-257,117.65"
,IN,AR,30311463,1005,100,,Invoice,,,,,,02/04/2018,02/04/2018,0.00,,7.29,,"-257,124.94"
,IN,AR,30311464,1005,100,,Invoice,,,,,,02/04/2018,02/04/2018,0.00,,7.29,,"-257,132.23"
,IN,AR,30311473,1005,100,,Invoice,,,,,,02/04/2018,02/04/2018,0.00,,19.87,,"-257,152.10"
,IN,AR,30311480,1005,100,,Invoice,,,,,,02/04/2018,02/04/2018,0.00,,10.93,,"-257,163.03"
,IN,AR,30311486,1005,100,,Invoice,,,,,,02/04/2018,02/04/2018,0.00,,364.41,,"-257,527.44"
,IN,AR,30311497,1005,100,,Invoice,,,,,,02/04/2018,02/04/2018,0.00,,18.09,,"-257,545.53"
,IN,AR,30311515,1005,100,,Invoice,,,,,,02/04/2018,02/04/2018,0.00,,15.51,,"-257,561.04"
,IN,AR,30311535,1005,100,,Invoice,,,,,,02/04/2018,02/04/2018,0.00,,11.48,,"-257,572.52"
,IN,AR,30311563,1005,100,,Invoice,,,,,,02/04/2018,02/04/2018,0.00,,61.02,,"-257,633.54"
,IN,AR,30311583,1005,100,,Invoice,,,,,,02/04/2018,02/04/2018,0.00,,182.20,,"-257,815.74"
,IN,AR,30311585,1005,100,,Invoice,,,,,,02/04/2018,02/04/2018,0.00,,12.92,,"-257,828.66"
,IN,AR,30311596,1005,100,,Invoice,,,,,,02/04/2018,02/04/2018,0.00,,364.41,,"-258,193.07"
,IN,AR,30311609,1005,100,,Invoice,,,,,,02/04/2018,02/04/2018,0.00,,15.53,,"-258,208.60"
,IN,AR,30311648,1005,100,,Invoice,,,,,,02/04/2018,02/04/2018,0.00,,108.69,,"-258,317.29"
,IN,AR,30311663,1005,100,,Invoice,,,,,,02/04/2018,02/04/2018,0.00,,33.05,,"-258,350.34"
,IN,AR,30311682,1005,100,,Invoice,,,,,,02/04/2018,02/04/2018,0.00,,19.12,,"-258,369.46"
,IN,AR,30311696,1005,100,,Invoice,,,,,,02/04/2018,02/04/2018,0.00,,6.44,,"-258,375.90"
,IN,AR,30311697,1005,100,,Invoice,,,,,,02/04/2018,02/04/2018,0.00,,12.88,,"-258,388.78"
,IN,AR,30311712,1005,100,,Invoice,,,,,,02/04/2018,02/04/2018,0.00,,15.04,,"-258,403.82"
,IN,AR,30311724,1005,100,,Invoice,,,,,,02/04/2018,02/04/2018,0.00,,20.88,,"-258,424.70"
,IN,AR,30311727,1005,100,,Invoice,,,,,,02/04/2018,02/04/2018,0.00,,2.75,,"-258,427.45"
,IN,AR,30311729,1005,100,,Invoice,,,,,,02/04/2018,02/04/2018,0.00,,3.64,,"-258,431.09"
,IN,AR,30311755,1005,100,,Invoice,,,,,,02/04/2018,02/04/2018,0.00,,5.08,,"-258,436.17"
,IN,AR,30311766,1005,100,,Invoice,,,,,,02/04/2018,02/04/2018,0.00,,10.17,,"-258,446.34"
,IN,AR,30311821,1005,100,,Invoice,,,,,,02/04/2018,02/04/2018,0.00,,8.64,,"-258,454.98"
,IN,AR,30311855,1005,100,,Invoice,,,,,,02/04/2018,02/04/2018,0.00,,27.97,,"-258,482.95"
,IN,AR,30311870,1005,100,,Invoice,,,,,,02/04/2018,02/04/2018,0.00,,22.37,,"-258,505.32"
,IN,AR,30311909,1005,100,,Invoice,,,,,,02/04/2018,02/04/2018,0.00,,14.58,,"-258,519.90"
,IN,AR,30311914,1005,100,,Invoice,,,,,,02/04/2018,02/04/2018,0.00,,3.64,,"-258,523.54"
,IN,AR,30311934,1005,100,,Invoice,,,,,,02/04/2018,02/04/2018,0.00,,31.86,,"-258,555.40"
,IN,AR,30311935,1005,100,,Invoice,,,,,,02/04/2018,02/04/2018,0.00,,13.77,,"-258,569.17"
,IN,AR,30311936,1005,100,,Invoice,,,,,,02/04/2018,02/04/2018,0.00,,11.02,,"-258,580.19"
,IN,AR,30311939,1005,100,,Invoice,,,,,,02/04/2018,02/04/2018,0.00,,13.77,,"-258,593.96"
,IN,AR,30311943,1005,100,,Invoice,,,,,,02/04/2018,02/04/2018,0.00,,3.64,,"-258,597.60"
,IN,AR,30311960,1005,100,,Invoice,,,,,,02/04/2018,02/04/2018,0.00,,9.19,,"-258,606.79"
,IN,AR,30311964,1005,100,,Invoice,,,,,,02/04/2018,02/04/2018,0.00,,22.44,,"-258,629.23"
,IN,AR,30311979,1005,100,,Invoice,,,,,,02/04/2018,02/04/2018,0.00,,3.64,,"-258,632.87"
,IN,AR,30311998,1005,100,,Invoice,,,,,,02/04/2018,02/04/2018,0.00,,14.58,,"-258,647.45"
,IN,AR,30312013,1005,100,,Invoice,,,,,,02/04/2018,02/04/2018,0.00,,"1,093.22",,"-259,740.67"
,IN,AR,30312019,1005,100,,Invoice,,,,,,02/04/2018,02/04/2018,0.00,,"1,093.22",,"-260,833.89"
,IN,AR,30312055,1005,100,,Invoice,,,,,,02/04/2018,02/04/2018,0.00,,10.00,,"-260,843.89"
,IN,AR,30312075,1005,100,,Invoice,,,,,,02/04/2018,02/04/2018,0.00,,364.41,,"-261,208.30"
,IN,AR,30312101,1005,100,,Invoice,,,,,,02/04/2018,02/04/2018,0.00,,2.58,,"-261,210.88"
,IN,AR,30312118,1005,100,,Invoice,,,,,,02/04/2018,02/04/2018,0.00,,42.69,,"-261,253.57"
,IN,AR,30312123,1005,100,,Invoice,,,,,,02/04/2018,02/04/2018,0.00,,3.64,,"-261,257.21"
,IN,AR,30312126,1005,100,,Invoice,,,,,,02/04/2018,02/04/2018,0.00,,4.49,,"-261,261.70"
,IN,AR,30312165,1005,100,,Invoice,,,,,,02/04/2018,02/04/2018,0.00,,6.53,,"-261,268.23"
,IN,AR,30312212,1005,100,,Invoice,,,,,,02/04/2018,02/04/2018,0.00,,7.29,,"-261,275.52"
,IN,AR,30312216,1005,100,,Invoice,,,,,,02/04/2018,02/04/2018,0.00,,182.20,,"-261,457.72"
,IN,AR,30312237,1005,100,,Invoice,,,,,,02/04/2018,02/04/2018,0.00,,7.29,,"-261,465.01"
,IN,AR,30312275,1005,100,,Invoice,,,,,,02/04/2018,02/04/2018,0.00,,54.66,,"-261,519.67"
,IN,AR,30312276,1005,100,,Invoice,,,,,,02/04/2018,02/04/2018,0.00,,54.66,,"-261,574.33"
,IN,AR,30312285,1005,100,,Invoice,,,,,,02/04/2018,02/04/2018,0.00,,4.29,,"-261,578.62"
,IN,AR,30312353,1005,100,,Invoice,,,,,,02/04/2018,02/04/2018,0.00,,28.39,,"-261,607.01"
,IN,AR,30312373,1005,100,,Invoice,,,,,,02/04/2018,02/04/2018,0.00,,196.83,,"-261,803.84"
,IN,AR,30312381,1005,100,,Invoice,,,,,,02/04/2018,02/04/2018,0.00,,30.07,,"-261,833.91"
,IN,AR,30312392,1005,100,,Invoice,,,,,,02/04/2018,02/04/2018,0.00,,18.22,,"-261,852.13"
,IN,AR,30312423,1005,100,,Invoice,,,,,,02/04/2018,02/04/2018,0.00,,8.02,,"-261,860.15"
,IN,AR,30312473,1005,100,,Invoice,,,,,,02/04/2018,02/04/2018,0.00,,42.03,,"-261,902.18"
,IN,AR,30312536,1005,100,,Invoice,,,,,,02/04/2018,02/04/2018,0.00,,18.01,,"-261,920.19"
,IN,AR,30312558,1005,100,,Invoice,,,,,,02/04/2018,02/04/2018,0.00,,189.49,,"-262,109.68"
,IN,AR,30312579,1005,100,,Invoice,,,,,,02/04/2018,02/04/2018,0.00,,37.71,,"-262,147.39"
,IN,AR,30312593,1005,100,,Invoice,,,,,,02/04/2018,02/04/2018,0.00,,364.41,,"-262,511.80"
,IN,AR,30312624,1005,100,,Invoice,,,,,,02/04/2018,02/04/2018,0.00,,28.99,,"-262,540.79"
,IN,AR,30312628,1005,100,,Invoice,,,,,,02/04/2018,02/04/2018,0.00,,109.53,,"-262,650.32"
,IN,AR,30312639,1005,100,,Invoice,,,,,,02/04/2018,02/04/2018,0.00,,19.64,,"-262,669.96"
,IN,AR,30312665,1005,100,,Invoice,,,,,,02/04/2018,02/04/2018,0.00,,9.64,,"-262,679.60"
,IN,AR,30312680,1005,100,,Invoice,,,,,,02/04/2018,02/04/2018,0.00,,4.08,,"-262,683.68"
,IN,AR,30312726,1005,100,,Invoice,,,,,,02/04/2018,02/04/2018,0.00,,21.36,,"-262,705.04"
,IN,AR,30312734,1005,100,,Invoice,,,,,,02/04/2018,02/04/2018,0.00,,11.15,,"-262,716.19"
,IN,AR,30312800,1005,100,,Invoice,,,,,,02/04/2018,02/04/2018,0.00,,16.00,,"-262,732.19"
,IN,AR,30312807,1005,100,,Invoice,,,,,,02/04/2018,02/04/2018,0.00,,3.76,,"-262,735.95"
,IN,AR,30312808,1005,100,,Invoice,,,,,,02/04/2018,02/04/2018,0.00,,7.53,,"-262,743.48"
,IN,AR,30312872,1005,100,,Invoice,,,,,,02/04/2018,02/04/2018,0.00,,5.47,,"-262,748.95"
,IN,AR,30312932,1005,100,,Invoice,,,,,,02/04/2018,02/04/2018,0.00,,10.21,,"-262,759.16"
,IN,AR,30312979,1005,100,,Invoice,,,,,,02/04/2018,02/04/2018,0.00,,17.92,,"-262,777.08"
,IN,AR,30312988,1005,100,,Invoice,,,,,,02/04/2018,02/04/2018,0.00,,40.93,,"-262,818.01"
,IN,AR,30313013,1005,100,,Invoice,,,,,,02/04/2018,02/04/2018,0.00,,6.23,,"-262,824.24"
,IN,AR,30313014,1005,100,,Invoice,,,,,,02/04/2018,02/04/2018,0.00,,6.23,,"-262,830.47"
,IN,AR,30313015,1005,100,,Invoice,,,,,,02/04/2018,02/04/2018,0.00,,6.23,,"-262,836.70"
,IN,AR,30313016,1005,100,,Invoice,,,,,,02/04/2018,02/04/2018,0.00,,2.08,,"-262,838.78"
,IN,AR,30313017,1005,100,,Invoice,,,,,,02/04/2018,02/04/2018,0.00,,4.15,,"-262,842.93"
,IN,AR,30313018,1005,100,,Invoice,,,,,,02/04/2018,02/04/2018,0.00,,14.53,,"-262,857.46"
,IN,AR,30313019,1005,100,,Invoice,,,,,,02/04/2018,02/04/2018,0.00,,2.08,,"-262,859.54"
,IN,AR,30313020,1005,100,,Invoice,,,,,,02/04/2018,02/04/2018,0.00,,20.76,,"-262,880.30"
,IN,AR,30313021,1005,100,,Invoice,,,,,,02/04/2018,02/04/2018,0.00,,2.08,,"-262,882.38"
,IN,AR,30313022,1005,100,,Invoice,,,,,,02/04/2018,02/04/2018,0.00,,2.08,,"-262,884.46"
,IN,AR,30313023,1005,100,,Invoice,,,,,,02/04/2018,02/04/2018,0.00,,2.08,,"-262,886.54"
,IN,AR,30313024,1005,100,,Invoice,,,,,,02/04/2018,02/04/2018,0.00,,26.99,,"-262,913.53"
,IN,AR,30313074,1005,100,,Invoice,,,,,,02/04/2018,02/04/2018,0.00,,7.63,,"-262,921.16"
,IN,AR,30313077,1005,100,,Invoice,,,,,,02/04/2018,02/04/2018,0.00,,182.20,,"-263,103.36"
,CN,AR,31017703,1005,100,,Credit Note,,,,,,03/04/2018,03/04/2018,3.64,,0.00,,"-263,099.72"
,CN,AR,31017729,1005,100,,Credit Note,,,,,,03/04/2018,03/04/2018,20.34,,0.00,,"-263,079.38"
,CN,AR,31017787,1005,100,,Credit Note,,,,,,03/04/2018,03/04/2018,5.17,,0.00,,"-263,074.21"
,CN,AR,31017788,1005,100,,Credit Note,,,,,,03/04/2018,03/04/2018,10.93,,0.00,,"-263,063.28"
,CN,AR,31017848,1005,100,,Credit Note,,,,,,03/04/2018,03/04/2018,7.80,,0.00,,"-263,055.48"
,CS,AR,32002630,1005,100,,Cash sale,,,,,,03/04/2018,03/04/2018,0.00,,3.64,,"-263,059.12"
,CS,AR,32002641,1005,100,,Cash sale,,,,,,03/04/2018,03/04/2018,0.00,,10.93,,"-263,070.05"
,CS,AR,32002672,1005,100,,Cash sale,,,,,,03/04/2018,03/04/2018,0.00,,7.29,,"-263,077.34"
,CS,AR,32002682,1005,100,,Cash sale,,,,,,03/04/2018,03/04/2018,0.00,,7.29,,"-263,084.63"
,CS,AR,32002688,1005,100,,Cash sale,,,,,,03/04/2018,03/04/2018,0.00,,3.01,,"-263,087.64"
,CS,AR,32002695,1005,100,,Cash sale,,,,,,03/04/2018,03/04/2018,0.00,,10.93,,"-263,098.57"
,CS,AR,32002733,1005,100,,Cash sale,,,,,,03/04/2018,03/04/2018,0.00,,17.54,,"-263,116.11"
,CS,AR,32002757,1005,100,,Cash sale,,,,,,03/04/2018,03/04/2018,0.00,,7.29,,"-263,123.40"
,CS,AR,32002761,1005,100,,Cash sale,,,,,,03/04/2018,03/04/2018,0.00,,54.66,,"-263,178.06"
,CS,AR,32002796,1005,100,,Cash sale,,,,,,03/04/2018,03/04/2018,0.00,,7.29,,"-263,185.35"
,CS,AR,32002798,1005,100,,Cash sale,,,,,,03/04/2018,03/04/2018,0.00,,14.58,,"-263,199.93"
,CS,AR,32002806,1005,100,,Cash sale,,,,,,03/04/2018,03/04/2018,0.00,,6.48,,"-263,206.41"
,CS,AR,32002808,1005,100,,Cash sale,,,,,,03/04/2018,03/04/2018,0.00,,10.93,,"-263,217.34"
,CS,AR,32002831,1005,100,,Cash sale,,,,,,03/04/2018,03/04/2018,0.00,,1.95,,"-263,219.29"
,CS,AR,32002835,1005,100,,Cash sale,,,,,,03/04/2018,03/04/2018,0.00,,7.75,,"-263,227.04"
,CS,AR,32002845,1005,100,,Cash sale,,,,,,03/04/2018,03/04/2018,0.00,,7.29,,"-263,234.33"
,CS,AR,32002888,1005,100,,Cash sale,,,,,,03/04/2018,03/04/2018,0.00,,7.29,,"-263,241.62"
,CS,AR,32002923,1005,100,,Cash sale,,,,,,03/04/2018,03/04/2018,0.00,,4.49,,"-263,246.11"
,CS,AR,32002942,1005,100,,Cash sale,,,,,,03/04/2018,03/04/2018,0.00,,21.61,,"-263,267.72"
,CS,AR,32002971,1005,100,,Cash sale,,,,,,03/04/2018,03/04/2018,0.00,,5.08,,"-263,272.80"
,CS,AR,32002976,1005,100,,Cash sale,,,,,,03/04/2018,03/04/2018,0.00,,7.75,,"-263,280.55"
,CS,AR,32002985,1005,100,,Cash sale,,,,,,03/04/2018,03/04/2018,0.00,,57.16,,"-263,337.71"
,CS,AR,32002996,1005,100,,Cash sale,,,,,,03/04/2018,03/04/2018,0.00,,10.34,,"-263,348.05"
,CS,AR,32003033,1005,100,,Cash sale,,,,,,03/04/2018,03/04/2018,0.00,,7.29,,"-263,355.34"
,CS,AR,32003048,1005,100,,Cash sale,,,,,,03/04/2018,03/04/2018,0.00,,6.02,,"-263,361.36"
,CS,AR,32003068,1005,100,,Cash sale,,,,,,03/04/2018,03/04/2018,0.00,,2.58,,"-263,363.94"
,CS,AR,32003100,1005,100,,Cash sale,,,,,,03/04/2018,03/04/2018,0.00,,12.86,,"-263,376.80"
,CS,AR,32003108,1005,100,,Cash sale,,,,,,03/04/2018,03/04/2018,0.00,,3.76,,"-263,380.56"
,CS,AR,32003119,1005,100,,Cash sale,,,,,,03/04/2018,03/04/2018,0.00,,5.18,,"-263,385.74"
,CS,AR,32003125,1005,100,,Cash sale,,,,,,03/04/2018,03/04/2018,0.00,,10.95,,"-263,396.69"
,CS,AR,32003131,1005,100,,Cash sale,,,,,,03/04/2018,03/04/2018,0.00,,10.93,,"-263,407.62"
,CS,AR,32003135,1005,100,,Cash sale,,,,,,03/04/2018,03/04/2018,0.00,,29.15,,"-263,436.77"
,CS,AR,32003136,1005,100,,Cash sale,,,,,,03/04/2018,03/04/2018,0.00,,7.29,,"-263,444.06"
,CS,AR,32003147,1005,100,,Cash sale,,,,,,03/04/2018,03/04/2018,0.00,,29.15,,"-263,473.21"
,CS,AR,32003180,1005,100,,Cash sale,,,,,,03/04/2018,03/04/2018,0.00,,26.00,,"-263,499.21"
,CS,AR,32003245,1005,100,,Cash sale,,,,,,03/04/2018,03/04/2018,0.00,,5.93,,"-263,505.14"
,CS,AR,32003263,1005,100,,Cash sale,,,,,,03/04/2018,03/04/2018,0.00,,2.75,,"-263,507.89"
,CS,AR,32003288,1005,100,,Cash sale,,,,,,03/04/2018,03/04/2018,0.00,,3.64,,"-263,511.53"
,CS,AR,32003289,1005,100,,Cash sale,,,,,,03/04/2018,03/04/2018,0.00,,3.64,,"-263,515.17"
,CS,AR,32003314,1005,100,,Cash sale,,,,,,03/04/2018,03/04/2018,0.00,,10.93,,"-263,526.10"
,CS,AR,32003320,1005,100,,Cash sale,,,,,,03/04/2018,03/04/2018,0.00,,8.00,,"-263,534.10"
,CS,AR,32003360,1005,100,,Cash sale,,,,,,03/04/2018,03/04/2018,0.00,,14.58,,"-263,548.68"
,CS,AR,32003362,1005,100,,Cash sale,,,,,,03/04/2018,03/04/2018,0.00,,2.74,,"-263,551.42"
,CS,AR,32003367,1005,100,,Cash sale,,,,,,03/04/2018,03/04/2018,0.00,,8.75,,"-263,560.17"
,CS,AR,32003376,1005,100,,Cash sale,,,,,,03/04/2018,03/04/2018,0.00,,10.93,,"-263,571.10"
,CS,AR,32003389,1005,100,,Cash sale,,,,,,03/04/2018,03/04/2018,0.00,,7.80,,"-263,578.90"
,CS,AR,32003392,1005,100,,Cash sale,,,,,,03/04/2018,03/04/2018,0.00,,7.75,,"-263,586.65"
,IN,AR,30311138,1005,100,,Invoice,,,,,,03/04/2018,03/04/2018,0.00,,27.47,,"-263,614.12"
,IN,AR,30311154,1005,100,,Invoice,,,,,,03/04/2018,03/04/2018,0.00,,10.51,,"-263,624.63"
,IN,AR,30311175,1005,100,,Invoice,,,,,,03/04/2018,03/04/2018,0.00,,7.00,,"-263,631.63"
,IN,AR,30311201,1005,100,,Invoice,,,,,,03/04/2018,03/04/2018,0.00,,3.64,,"-263,635.27"
,IN,AR,30311212,1005,100,,Invoice,,,,,,03/04/2018,03/04/2018,0.00,,18.22,,"-263,653.49"
,IN,AR,30311247,1005,100,,Invoice,,,,,,03/04/2018,03/04/2018,0.00,,14.58,,"-263,668.07"
,IN,AR,30311270,1005,100,,Invoice,,,,,,03/04/2018,03/04/2018,0.00,,54.66,,"-263,722.73"
,IN,AR,30311273,1005,100,,Invoice,,,,,,03/04/2018,03/04/2018,0.00,,18.22,,"-263,740.95"
,IN,AR,30311327,1005,100,,Invoice,,,,,,03/04/2018,03/04/2018,0.00,,3.64,,"-263,744.59"
,IN,AR,30311393,1005,100,,Invoice,,,,,,03/04/2018,03/04/2018,0.00,,25.51,,"-263,770.10"
,IN,AR,30311410,1005,100,,Invoice,,,,,,03/04/2018,03/04/2018,0.00,,14.58,,"-263,784.68"
,IN,AR,30311420,1005,100,,Invoice,,,,,,03/04/2018,03/04/2018,0.00,,12.92,,"-263,797.60"
,IN,AR,30311427,1005,100,,Invoice,,,,,,03/04/2018,03/04/2018,0.00,,78.86,,"-263,876.46"
,IN,AR,30311440,1005,100,,Invoice,,,,,,03/04/2018,03/04/2018,0.00,,8.25,,"-263,884.71"
,IN,AR,30311450,1005,100,,Invoice,,,,,,03/04/2018,03/04/2018,0.00,,7.29,,"-263,892.00"
,IN,AR,30311519,1005,100,,Invoice,,,,,,03/04/2018,03/04/2018,0.00,,24.71,,"-263,916.71"
,IN,AR,30311540,1005,100,,Invoice,,,,,,03/04/2018,03/04/2018,0.00,,10.17,,"-263,926.88"
,IN,AR,30311550,1005,100,,Invoice,,,,,,03/04/2018,03/04/2018,0.00,,2.16,,"-263,929.04"
,IN,AR,30311552,1005,100,,Invoice,,,,,,03/04/2018,03/04/2018,0.00,,8.47,,"-263,937.51"
,IN,AR,30311564,1005,100,,Invoice,,,,,,03/04/2018,03/04/2018,0.00,,40.68,,"-263,978.19"
,IN,AR,30311574,1005,100,,Invoice,,,,,,03/04/2018,03/04/2018,0.00,,6.36,,"-263,984.55"
,IN,AR,30311599,1005,100,,Invoice,,,,,,03/04/2018,03/04/2018,0.00,,2.58,,"-263,987.13"
,IN,AR,30311629,1005,100,,Invoice,,,,,,03/04/2018,03/04/2018,0.00,,2.84,,"-263,989.97"
,IN,AR,30311630,1005,100,,Invoice,,,,,,03/04/2018,03/04/2018,0.00,,21.06,,"-264,011.03"
,IN,AR,30311641,1005,100,,Invoice,,,,,,03/04/2018,03/04/2018,0.00,,15.59,,"-264,026.62"
,IN,AR,30311676,1005,100,,Invoice,,,,,,03/04/2018,03/04/2018,0.00,,7.75,,"-264,034.37"
,IN,AR,30311677,1005,100,,Invoice,,,,,,03/04/2018,03/04/2018,0.00,,9.43,,"-264,043.80"
,IN,AR,30311683,1005,100,,Invoice,,,,,,03/04/2018,03/04/2018,0.00,,4.78,,"-264,048.58"
,IN,AR,30311698,1005,100,,Invoice,,,,,,03/04/2018,03/04/2018,0.00,,6.44,,"-264,055.02"
,IN,AR,30311742,1005,100,,Invoice,,,,,,03/04/2018,03/04/2018,0.00,,14.30,,"-264,069.32"
,IN,AR,30311749,1005,100,,Invoice,,,,,,03/04/2018,03/04/2018,0.00,,18.09,,"-264,087.41"
,IN,AR,30311789,1005,100,,Invoice,,,,,,03/04/2018,03/04/2018,0.00,,6.37,,"-264,093.78"
,IN,AR,30311814,1005,100,,Invoice,,,,,,03/04/2018,03/04/2018,0.00,,5.85,,"-264,099.63"
,IN,AR,30311817,1005,100,,Invoice,,,,,,03/04/2018,03/04/2018,0.00,,5.08,,"-264,104.71"
,IN,AR,30311836,1005,100,,Invoice,,,,,,03/04/2018,03/04/2018,0.00,,3.64,,"-264,108.35"
,IN,AR,30311840,1005,100,,Invoice,,,,,,03/04/2018,03/04/2018,0.00,,5.85,,"-264,114.20"
,IN,AR,30311865,1005,100,,Invoice,,,,,,03/04/2018,03/04/2018,0.00,,10.93,,"-264,125.13"
,IN,AR,30311871,1005,100,,Invoice,,,,,,03/04/2018,03/04/2018,0.00,,20.34,,"-264,145.47"
,IN,AR,30311881,1005,100,,Invoice,,,,,,03/04/2018,03/04/2018,0.00,,6.61,,"-264,152.08"
,IN,AR,30311891,1005,100,,Invoice,,,,,,03/04/2018,03/04/2018,0.00,,7.63,,"-264,159.71"
,IN,AR,30311897,1005,100,,Invoice,,,,,,03/04/2018,03/04/2018,0.00,,3.90,,"-264,163.61"
,IN,AR,30311899,1005,100,,Invoice,,,,,,03/04/2018,03/04/2018,0.00,,10.53,,"-264,174.14"
,IN,AR,30311904,1005,100,,Invoice,,,,,,03/04/2018,03/04/2018,0.00,,7.29,,"-264,181.43"
,IN,AR,30311923,1005,100,,Invoice,,,,,,03/04/2018,03/04/2018,0.00,,8.47,,"-264,189.90"
,IN,AR,30311931,1005,100,,Invoice,,,,,,03/04/2018,03/04/2018,0.00,,2.12,,"-264,192.02"
,IN,AR,30311984,1005,100,,Invoice,,,,,,03/04/2018,03/04/2018,0.00,,17.80,,"-264,209.82"
,IN,AR,30311985,1005,100,,Invoice,,,,,,03/04/2018,03/04/2018,0.00,,38.56,,"-264,248.38"
,IN,AR,30312010,1005,100,,Invoice,,,,,,03/04/2018,03/04/2018,0.00,,10.93,,"-264,259.31"
,IN,AR,30312059,1005,100,,Invoice,,,,,,03/04/2018,03/04/2018,0.00,,14.03,,"-264,273.34"
,IN,AR,30312066,1005,100,,Invoice,,,,,,03/04/2018,03/04/2018,0.00,,7.29,,"-264,280.63"
,IN,AR,30312067,1005,100,,Invoice,,,,,,03/04/2018,03/04/2018,0.00,,6.44,,"-264,287.07"
,IN,AR,30312095,1005,100,,Invoice,,,,,,03/04/2018,03/04/2018,0.00,,5.59,,"-264,292.66"
,IN,AR,30312106,1005,100,,Invoice,,,,,,03/04/2018,03/04/2018,0.00,,8.78,,"-264,301.44"
,IN,AR,30312109,1005,100,,Invoice,,,,,,03/04/2018,03/04/2018,0.00,,5.68,,"-264,307.12"
,IN,AR,30312168,1005,100,,Invoice,,,,,,03/04/2018,03/04/2018,0.00,,18.22,,"-264,325.34"
,IN,AR,30312183,1005,100,,Invoice,,,,,,03/04/2018,03/04/2018,0.00,,17.15,,"-264,342.49"
,IN,AR,30312188,1005,100,,Invoice,,,,,,03/04/2018,03/04/2018,0.00,,10.68,,"-264,353.17"
,IN,AR,30312231,1005,100,,Invoice,,,,,,03/04/2018,03/04/2018,0.00,,182.20,,"-264,535.37"
,IN,AR,30312232,1005,100,,Invoice,,,,,,03/04/2018,03/04/2018,0.00,,5.17,,"-264,540.54"
,IN,AR,30312250,1005,100,,Invoice,,,,,,03/04/2018,03/04/2018,0.00,,5.17,,"-264,545.71"
,IN,AR,30312253,1005,100,,Invoice,,,,,,03/04/2018,03/04/2018,0.00,,10.93,,"-264,556.64"
,IN,AR,30312297,1005,100,,Invoice,,,,,,03/04/2018,03/04/2018,0.00,,7.29,,"-264,563.93"
,IN,AR,30312354,1005,100,,Invoice,,,,,,03/04/2018,03/04/2018,0.00,,42.58,,"-264,606.51"
,IN,AR,30312402,1005,100,,Invoice,,,,,,03/04/2018,03/04/2018,0.00,,12.03,,"-264,618.54"
,IN,AR,30312416,1005,100,,Invoice,,,,,,03/04/2018,03/04/2018,0.00,,178.56,,"-264,797.10"
,IN,AR,30312424,1005,100,,Invoice,,,,,,03/04/2018,03/04/2018,0.00,,9.62,,"-264,806.72"
,IN,AR,30312519,1005,100,,Invoice,,,,,,03/04/2018,03/04/2018,0.00,,17.80,,"-264,824.52"
,IN,AR,30312571,1005,100,,Invoice,,,,,,03/04/2018,03/04/2018,0.00,,25.51,,"-264,850.03"
,IN,AR,30312573,1005,100,,Invoice,,,,,,03/04/2018,03/04/2018,0.00,,29.15,,"-264,879.18"
,IN,AR,30312634,1005,100,,Invoice,,,,,,03/04/2018,03/04/2018,0.00,,8.21,,"-264,887.39"
,IN,AR,30312670,1005,100,,Invoice,,,,,,03/04/2018,03/04/2018,0.00,,100.00,,"-264,987.39"
,IN,AR,30312675,1005,100,,Invoice,,,,,,03/04/2018,03/04/2018,0.00,,15.17,,"-265,002.56"
,IN,AR,30312688,1005,100,,Invoice,,,,,,03/04/2018,03/04/2018,0.00,,18.98,,"-265,021.54"
,IN,AR,30312699,1005,100,,Invoice,,,,,,03/04/2018,03/04/2018,0.00,,29.15,,"-265,050.69"
,IN,AR,30312712,1005,100,,Invoice,,,,,,03/04/2018,03/04/2018,0.00,,2.54,,"-265,053.23"
,IN,AR,30312715,1005,100,,Invoice,,,,,,03/04/2018,03/04/2018,0.00,,7.29,,"-265,060.52"
,IN,AR,30312765,1005,100,,Invoice,,,,,,03/04/2018,03/04/2018,0.00,,65.08,,"-265,125.60"
,IN,AR,30312772,1005,100,,Invoice,,,,,,03/04/2018,03/04/2018,0.00,,11.86,,"-265,137.46"
,IN,AR,30312773,1005,100,,Invoice,,,,,,03/04/2018,03/04/2018,0.00,,26.10,,"-265,163.56"
,IN,AR,30312774,1005,100,,Invoice,,,,,,03/04/2018,03/04/2018,0.00,,106.79,,"-265,270.35"
,IN,AR,30312817,1005,100,,Invoice,,,,,,03/04/2018,03/04/2018,0.00,,1.75,,"-265,272.10"
,IN,AR,30312823,1005,100,,Invoice,,,,,,03/04/2018,03/04/2018,0.00,,4.00,,"-265,276.10"
,IN,AR,30312830,1005,100,,Invoice,,,,,,03/04/2018,03/04/2018,0.00,,18.20,,"-265,294.30"
,IN,AR,30312831,1005,100,,Invoice,,,,,,03/04/2018,03/04/2018,0.00,,10.93,,"-265,305.23"
,IN,AR,30312834,1005,100,,Invoice,,,,,,03/04/2018,03/04/2018,0.00,,106.90,,"-265,412.13"
,IN,AR,30312845,1005,100,,Invoice,,,,,,03/04/2018,03/04/2018,0.00,,18.22,,"-265,430.35"
,IN,AR,30312856,1005,100,,Invoice,,,,,,03/04/2018,03/04/2018,0.00,,7.02,,"-265,437.37"
,IN,AR,30312933,1005,100,,Invoice,,,,,,03/04/2018,03/04/2018,0.00,,32.68,,"-265,470.05"
,IN,AR,30312946,1005,100,,Invoice,,,,,,03/04/2018,03/04/2018,0.00,,7.29,,"-265,477.34"
,IN,AR,30312975,1005,100,,Invoice,,,,,,03/04/2018,03/04/2018,0.00,,14.58,,"-265,491.92"
,IN,AR,30313084,1005,100,,Invoice,,,,,,03/04/2018,03/04/2018,0.00,,29.15,,"-265,521.07"
,CS,AR,32002597,1005,100,,Cash sale,,,,,,04/04/2018,04/04/2018,0.00,,11.22,,"-265,532.29"
,CS,AR,32002608,1005,100,,Cash sale,,,,,,04/04/2018,04/04/2018,0.00,,3.64,,"-265,535.93"
,CS,AR,32002610,1005,100,,Cash sale,,,,,,04/04/2018,04/04/2018,0.00,,35.12,,"-265,571.05"
,CS,AR,32002665,1005,100,,Cash sale,,,,,,04/04/2018,04/04/2018,0.00,,6.48,,"-265,577.53"
,CS,AR,32002666,1005,100,,Cash sale,,,,,,04/04/2018,04/04/2018,0.00,,47.37,,"-265,624.90"
,CS,AR,32002683,1005,100,,Cash sale,,,,,,04/04/2018,04/04/2018,0.00,,3.64,,"-265,628.54"
,CS,AR,32002728,1005,100,,Cash sale,,,,,,04/04/2018,04/04/2018,0.00,,6.02,,"-265,634.56"
,CS,AR,32002743,1005,100,,Cash sale,,,,,,04/04/2018,04/04/2018,0.00,,7.29,,"-265,641.85"
,CS,AR,32002765,1005,100,,Cash sale,,,,,,04/04/2018,04/04/2018,0.00,,3.64,,"-265,645.49"
,CS,AR,32002770,1005,100,,Cash sale,,,,,,04/04/2018,04/04/2018,0.00,,5.86,,"-265,651.35"
,CS,AR,32002789,1005,100,,Cash sale,,,,,,04/04/2018,04/04/2018,0.00,,10.34,,"-265,661.69"
,CS,AR,32002848,1005,100,,Cash sale,,,,,,04/04/2018,04/04/2018,0.00,,25.85,,"-265,687.54"
,CS,AR,32002854,1005,100,,Cash sale,,,,,,04/04/2018,04/04/2018,0.00,,7.29,,"-265,694.83"
,CS,AR,32002858,1005,100,,Cash sale,,,,,,04/04/2018,04/04/2018,0.00,,3.64,,"-265,698.47"
,CS,AR,32002870,1005,100,,Cash sale,,,,,,04/04/2018,04/04/2018,0.00,,21.06,,"-265,719.53"
,CS,AR,32002874,1005,100,,Cash sale,,,,,,04/04/2018,04/04/2018,0.00,,8.58,,"-265,728.11"
,CS,AR,32002878,1005,100,,Cash sale,,,,,,04/04/2018,04/04/2018,0.00,,10.93,,"-265,739.04"
,CS,AR,32002891,1005,100,,Cash sale,,,,,,04/04/2018,04/04/2018,0.00,,10.93,,"-265,749.97"
,CS,AR,32002904,1005,100,,Cash sale,,,,,,04/04/2018,04/04/2018,0.00,,3.64,,"-265,753.61"
,CS,AR,32002988,1005,100,,Cash sale,,,,,,04/04/2018,04/04/2018,0.00,,25.51,,"-265,779.12"
,CS,AR,32003028,1005,100,,Cash sale,,,,,,04/04/2018,04/04/2018,0.00,,21.86,,"-265,800.98"
,CS,AR,32003045,1005,100,,Cash sale,,,,,,04/04/2018,04/04/2018,0.00,,25.51,,"-265,826.49"
,CS,AR,32003052,1005,100,,Cash sale,,,,,,04/04/2018,04/04/2018,0.00,,5.42,,"-265,831.91"
,CS,AR,32003074,1005,100,,Cash sale,,,,,,04/04/2018,04/04/2018,0.00,,9.66,,"-265,841.57"
,CS,AR,32003082,1005,100,,Cash sale,,,,,,04/04/2018,04/04/2018,0.00,,16.53,,"-265,858.10"
,CS,AR,32003103,1005,100,,Cash sale,,,,,,04/04/2018,04/04/2018,0.00,,8.02,,"-265,866.12"
,CS,AR,32003140,1005,100,,Cash sale,,,,,,04/04/2018,04/04/2018,0.00,,17.80,,"-265,883.92"
,CS,AR,32003169,1005,100,,Cash sale,,,,,,04/04/2018,04/04/2018,0.00,,7.29,,"-265,891.21"
,CS,AR,32003227,1005,100,,Cash sale,,,,,,04/04/2018,04/04/2018,0.00,,11.44,,"-265,902.65"
,CS,AR,32003242,1005,100,,Cash sale,,,,,,04/04/2018,04/04/2018,0.00,,9.10,,"-265,911.75"
,CS,AR,32003297,1005,100,,Cash sale,,,,,,04/04/2018,04/04/2018,0.00,,10.93,,"-265,922.68"
,CS,AR,32003321,1005,100,,Cash sale,,,,,,04/04/2018,04/04/2018,0.00,,12.14,,"-265,934.82"
,CS,AR,32003326,1005,100,,Cash sale,,,,,,04/04/2018,04/04/2018,0.00,,7.29,,"-265,942.11"
,CS,AR,32003357,1005,100,,Cash sale,,,,,,04/04/2018,04/04/2018,0.00,,7.29,,"-265,949.40"
,CS,AR,32003381,1005,100,,Cash sale,,,,,,04/04/2018,04/04/2018,0.00,,8.25,,"-265,957.65"
,CS,AR,32003385,1005,100,,Cash sale,,,,,,04/04/2018,04/04/2018,0.00,,10.93,,"-265,968.58"
,IN,AR,30311082,1005,100,,Invoice,,,,,,04/04/2018,04/04/2018,0.00,,84.54,,"-266,053.12"
,IN,AR,30311087,1005,100,,Invoice,,,,,,04/04/2018,04/04/2018,0.00,,59.32,,"-266,112.44"
,IN,AR,30311088,1005,100,,Invoice,,,,,,04/04/2018,04/04/2018,0.00,,59.32,,"-266,171.76"
,IN,AR,30311116,1005,100,,Invoice,,,,,,04/04/2018,04/04/2018,0.00,,364.41,,"-266,536.17"
,IN,AR,30311120,1005,100,,Invoice,,,,,,04/04/2018,04/04/2018,0.00,,18.22,,"-266,554.39"
,IN,AR,30311127,1005,100,,Invoice,,,,,,04/04/2018,04/04/2018,0.00,,12.20,,"-266,566.59"
,IN,AR,30311128,1005,100,,Invoice,,,,,,04/04/2018,04/04/2018,0.00,,63.46,,"-266,630.05"
,IN,AR,30311140,1005,100,,Invoice,,,,,,04/04/2018,04/04/2018,0.00,,16.27,,"-266,646.32"
,IN,AR,30311150,1005,100,,Invoice,,,,,,04/04/2018,04/04/2018,0.00,,27.88,,"-266,674.20"
,IN,AR,30311155,1005,100,,Invoice,,,,,,04/04/2018,04/04/2018,0.00,,73.56,,"-266,747.76"
,IN,AR,30311156,1005,100,,Invoice,,,,,,04/04/2018,04/04/2018,0.00,,26.27,,"-266,774.03"
,IN,AR,30311229,1005,100,,Invoice,,,,,,04/04/2018,04/04/2018,0.00,,106.78,,"-266,880.81"
,IN,AR,30311256,1005,100,,Invoice,,,,,,04/04/2018,04/04/2018,0.00,,54.66,,"-266,935.47"
,IN,AR,30311257,1005,100,,Invoice,,,,,,04/04/2018,04/04/2018,0.00,,10.93,,"-266,946.40"
,IN,AR,30311259,1005,100,,Invoice,,,,,,04/04/2018,04/04/2018,0.00,,52.00,,"-266,998.40"
,IN,AR,30311291,1005,100,,Invoice,,,,,,04/04/2018,04/04/2018,0.00,,7.29,,"-267,005.69"
,IN,AR,30311294,1005,100,,Invoice,,,,,,04/04/2018,04/04/2018,0.00,,21.86,,"-267,027.55"
,IN,AR,30311307,1005,100,,Invoice,,,,,,04/04/2018,04/04/2018,0.00,,14.00,,"-267,041.55"
,IN,AR,30311357,1005,100,,Invoice,,,,,,04/04/2018,04/04/2018,0.00,,48.00,,"-267,089.55"
,IN,AR,30311362,1005,100,,Invoice,,,,,,04/04/2018,04/04/2018,0.00,,10.93,,"-267,100.48"
,IN,AR,30311363,1005,100,,Invoice,,,,,,04/04/2018,04/04/2018,0.00,,75.93,,"-267,176.41"
,IN,AR,30311396,1005,100,,Invoice,,,,,,04/04/2018,04/04/2018,0.00,,18.22,,"-267,194.63"
,IN,AR,30311401,1005,100,,Invoice,,,,,,04/04/2018,04/04/2018,0.00,,57.31,,"-267,251.94"
,IN,AR,30311402,1005,100,,Invoice,,,,,,04/04/2018,04/04/2018,0.00,,103.69,,"-267,355.63"
,IN,AR,30311403,1005,100,,Invoice,,,,,,04/04/2018,04/04/2018,0.00,,13.64,,"-267,369.27"
,IN,AR,30311445,1005,100,,Invoice,,,,,,04/04/2018,04/04/2018,0.00,,6.02,,"-267,375.29"
,IN,AR,30311461,1005,100,,Invoice,,,,,,04/04/2018,04/04/2018,0.00,,546.61,,"-267,921.90"
,IN,AR,30311469,1005,100,,Invoice,,,,,,04/04/2018,04/04/2018,0.00,,18.57,,"-267,940.47"
,IN,AR,30311545,1005,100,,Invoice,,,,,,04/04/2018,04/04/2018,0.00,,22.88,,"-267,963.35"
,IN,AR,30311580,1005,100,,Invoice,,,,,,04/04/2018,04/04/2018,0.00,,2.80,,"-267,966.15"
,IN,AR,30311614,1005,100,,Invoice,,,,,,04/04/2018,04/04/2018,0.00,,16.73,,"-267,982.88"
,IN,AR,30311636,1005,100,,Invoice,,,,,,04/04/2018,04/04/2018,0.00,,9.56,,"-267,992.44"
,IN,AR,30311649,1005,100,,Invoice,,,,,,04/04/2018,04/04/2018,0.00,,61.53,,"-268,053.97"
,IN,AR,30311664,1005,100,,Invoice,,,,,,04/04/2018,04/04/2018,0.00,,91.53,,"-268,145.50"
,IN,AR,30311678,1005,100,,Invoice,,,,,,04/04/2018,04/04/2018,0.00,,10.93,,"-268,156.43"
,IN,AR,30311735,1005,100,,Invoice,,,,,,04/04/2018,04/04/2018,0.00,,7.75,,"-268,164.18"
,IN,AR,30311750,1005,100,,Invoice,,,,,,04/04/2018,04/04/2018,0.00,,114.03,,"-268,278.21"
,IN,AR,30311849,1005,100,,Invoice,,,,,,04/04/2018,04/04/2018,0.00,,15.90,,"-268,294.11"
,IN,AR,30311878,1005,100,,Invoice,,,,,,04/04/2018,04/04/2018,0.00,,364.41,,"-268,658.52"
,IN,AR,30311892,1005,100,,Invoice,,,,,,04/04/2018,04/04/2018,0.00,,5.08,,"-268,663.60"
,IN,AR,30311920,1005,100,,Invoice,,,,,,04/04/2018,04/04/2018,0.00,,77.54,,"-268,741.14"
,IN,AR,30311958,1005,100,,Invoice,,,,,,04/04/2018,04/04/2018,0.00,,182.20,,"-268,923.34"
,IN,AR,30311965,1005,100,,Invoice,,,,,,04/04/2018,04/04/2018,0.00,,19.64,,"-268,942.98"
,IN,AR,30311986,1005,100,,Invoice,,,,,,04/04/2018,04/04/2018,0.00,,11.86,,"-268,954.84"
,IN,AR,30312012,1005,100,,Invoice,,,,,,04/04/2018,04/04/2018,0.00,,7.63,,"-268,962.47"
,IN,AR,30312017,1005,100,,Invoice,,,,,,04/04/2018,04/04/2018,0.00,,10.93,,"-268,973.40"
,IN,AR,30312040,1005,100,,Invoice,,,,,,04/04/2018,04/04/2018,0.00,,41.95,,"-269,015.35"
,IN,AR,30312130,1005,100,,Invoice,,,,,,04/04/2018,04/04/2018,0.00,,18.05,,"-269,033.40"
,IN,AR,30312182,1005,100,,Invoice,,,,,,04/04/2018,04/04/2018,0.00,,7.75,,"-269,041.15"
,IN,AR,30312193,1005,100,,Invoice,,,,,,04/04/2018,04/04/2018,0.00,,1.76,,"-269,042.91"
,IN,AR,30312194,1005,100,,Invoice,,,,,,04/04/2018,04/04/2018,0.00,,14.09,,"-269,057.00"
,IN,AR,30312207,1005,100,,Invoice,,,,,,04/04/2018,04/04/2018,0.00,,15.04,,"-269,072.04"
,IN,AR,30312227,1005,100,,Invoice,,,,,,04/04/2018,04/04/2018,0.00,,8.24,,"-269,080.28"
,IN,AR,30312239,1005,100,,Invoice,,,,,,04/04/2018,04/04/2018,0.00,,106.48,,"-269,186.76"
,IN,AR,30312265,1005,100,,Invoice,,,,,,04/04/2018,04/04/2018,0.00,,12.00,,"-269,198.76"
,IN,AR,30312269,1005,100,,Invoice,,,,,,04/04/2018,04/04/2018,0.00,,10.93,,"-269,209.69"
,IN,AR,30312290,1005,100,,Invoice,,,,,,04/04/2018,04/04/2018,0.00,,364.41,,"-269,574.10"
,IN,AR,30312292,1005,100,,Invoice,,,,,,04/04/2018,04/04/2018,0.00,,5.17,,"-269,579.27"
,IN,AR,30312362,1005,100,,Invoice,,,,,,04/04/2018,04/04/2018,0.00,,32.00,,"-269,611.27"
,IN,AR,30312376,1005,100,,Invoice,,,,,,04/04/2018,04/04/2018,0.00,,28.06,,"-269,639.33"
,IN,AR,30312389,1005,100,,Invoice,,,,,,04/04/2018,04/04/2018,0.00,,7.29,,"-269,646.62"
,IN,AR,30312398,1005,100,,Invoice,,,,,,04/04/2018,04/04/2018,0.00,,3.64,,"-269,650.26"
,IN,AR,30312406,1005,100,,Invoice,,,,,,04/04/2018,04/04/2018,0.00,,10.93,,"-269,661.19"
,IN,AR,30312410,1005,100,,Invoice,,,,,,04/04/2018,04/04/2018,0.00,,28.09,,"-269,689.28"
,IN,AR,30312421,1005,100,,Invoice,,,,,,04/04/2018,04/04/2018,0.00,,14.58,,"-269,703.86"
,IN,AR,30312425,1005,100,,Invoice,,,,,,04/04/2018,04/04/2018,0.00,,1.60,,"-269,705.46"
,IN,AR,30312426,1005,100,,Invoice,,,,,,04/04/2018,04/04/2018,0.00,,11.22,,"-269,716.68"
,IN,AR,30312427,1005,100,,Invoice,,,,,,04/04/2018,04/04/2018,0.00,,12.83,,"-269,729.51"
,IN,AR,30312428,1005,100,,Invoice,,,,,,04/04/2018,04/04/2018,0.00,,4.81,,"-269,734.32"
,IN,AR,30312429,1005,100,,Invoice,,,,,,04/04/2018,04/04/2018,0.00,,19.24,,"-269,753.56"
,IN,AR,30312430,1005,100,,Invoice,,,,,,04/04/2018,04/04/2018,0.00,,6.42,,"-269,759.98"
,IN,AR,30312431,1005,100,,Invoice,,,,,,04/04/2018,04/04/2018,0.00,,6.42,,"-269,766.40"
,IN,AR,30312432,1005,100,,Invoice,,,,,,04/04/2018,04/04/2018,0.00,,6.42,,"-269,772.82"
,IN,AR,30312472,1005,100,,Invoice,,,,,,04/04/2018,04/04/2018,0.00,,21.86,,"-269,794.68"
,IN,AR,30312486,1005,100,,Invoice,,,,,,04/04/2018,04/04/2018,0.00,,16.40,,"-269,811.08"
,IN,AR,30312489,1005,100,,Invoice,,,,,,04/04/2018,04/04/2018,0.00,,12.73,,"-269,823.81"
,IN,AR,30312497,1005,100,,Invoice,,,,,,04/04/2018,04/04/2018,0.00,,36.22,,"-269,860.03"
,IN,AR,30312504,1005,100,,Invoice,,,,,,04/04/2018,04/04/2018,0.00,,18.22,,"-269,878.25"
,IN,AR,30312515,1005,100,,Invoice,,,,,,04/04/2018,04/04/2018,0.00,,18.22,,"-269,896.47"
,IN,AR,30312541,1005,100,,Invoice,,,,,,04/04/2018,04/04/2018,0.00,,14.00,,"-269,910.47"
,IN,AR,30312580,1005,100,,Invoice,,,,,,04/04/2018,04/04/2018,0.00,,4.53,,"-269,915.00"
,IN,AR,30312599,1005,100,,Invoice,,,,,,04/04/2018,04/04/2018,0.00,,44.15,,"-269,959.15"
,IN,AR,30312607,1005,100,,Invoice,,,,,,04/04/2018,04/04/2018,0.00,,15.04,,"-269,974.19"
,IN,AR,30312609,1005,100,,Invoice,,,,,,04/04/2018,04/04/2018,0.00,,7.97,,"-269,982.16"
,IN,AR,30312619,1005,100,,Invoice,,,,,,04/04/2018,04/04/2018,0.00,,18.22,,"-270,000.38"
,IN,AR,30312660,1005,100,,Invoice,,,,,,04/04/2018,04/04/2018,0.00,,13.98,,"-270,014.36"
,IN,AR,30312730,1005,100,,Invoice,,,,,,04/04/2018,04/04/2018,0.00,,81.15,,"-270,095.51"
,IN,AR,30312733,1005,100,,Invoice,,,,,,04/04/2018,04/04/2018,0.00,,25.51,,"-270,121.02"
,IN,AR,30312735,1005,100,,Invoice,,,,,,04/04/2018,04/04/2018,0.00,,9.56,,"-270,130.58"
,IN,AR,30312813,1005,100,,Invoice,,,,,,04/04/2018,04/04/2018,0.00,,3.51,,"-270,134.09"
,IN,AR,30312860,1005,100,,Invoice,,,,,,04/04/2018,04/04/2018,0.00,,3.64,,"-270,137.73"
,IN,AR,30312891,1005,100,,Invoice,,,,,,04/04/2018,04/04/2018,0.00,,7.53,,"-270,145.26"
,IN,AR,30312921,1005,100,,Invoice,,,,,,04/04/2018,04/04/2018,0.00,,54.66,,"-270,199.92"
,IN,AR,30312922,1005,100,,Invoice,,,,,,04/04/2018,04/04/2018,0.00,,54.66,,"-270,254.58"
,IN,AR,30312928,1005,100,,Invoice,,,,,,04/04/2018,04/04/2018,0.00,,11.19,,"-270,265.77"
,IN,AR,30312992,1005,100,,Invoice,,,,,,04/04/2018,04/04/2018,0.00,,9.15,,"-270,274.92"
,IN,AR,30313025,1005,100,,Invoice,,,,,,04/04/2018,04/04/2018,0.00,,45.68,,"-270,320.60"
,IN,AR,30313026,1005,100,,Invoice,,,,,,04/04/2018,04/04/2018,0.00,,6.23,,"-270,326.83"
,IN,AR,30313027,1005,100,,Invoice,,,,,,04/04/2018,04/04/2018,0.00,,4.15,,"-270,330.98"
,IN,AR,30313086,1005,100,,Invoice,,,,,,04/04/2018,04/04/2018,0.00,,455.51,,"-270,786.49"
,CN,AR,31017812,1005,100,,Credit Note,,,,,,05/04/2018,05/04/2018,29.15,,0.00,,"-270,757.34"
,CS,AR,32002592,1005,100,,Cash sale,,,,,,05/04/2018,05/04/2018,0.00,,12.03,,"-270,769.37"
,CS,AR,32002621,1005,100,,Cash sale,,,,,,05/04/2018,05/04/2018,0.00,,7.29,,"-270,776.66"
,CS,AR,32002635,1005,100,,Cash sale,,,,,,05/04/2018,05/04/2018,0.00,,14.58,,"-270,791.24"
,CS,AR,32002643,1005,100,,Cash sale,,,,,,05/04/2018,05/04/2018,0.00,,2.58,,"-270,793.82"
,CS,AR,32002659,1005,100,,Cash sale,,,,,,05/04/2018,05/04/2018,0.00,,3.64,,"-270,797.46"
,CS,AR,32002674,1005,100,,Cash sale,,,,,,05/04/2018,05/04/2018,0.00,,7.29,,"-270,804.75"
,CS,AR,32002692,1005,100,,Cash sale,,,,,,05/04/2018,05/04/2018,0.00,,3.64,,"-270,808.39"
,CS,AR,32002721,1005,100,,Cash sale,,,,,,05/04/2018,05/04/2018,0.00,,3.64,,"-270,812.03"
,CS,AR,32002732,1005,100,,Cash sale,,,,,,05/04/2018,05/04/2018,0.00,,10.93,,"-270,822.96"
,CS,AR,32002735,1005,100,,Cash sale,,,,,,05/04/2018,05/04/2018,0.00,,3.64,,"-270,826.60"
,CS,AR,32002763,1005,100,,Cash sale,,,,,,05/04/2018,05/04/2018,0.00,,7.29,,"-270,833.89"
,CS,AR,32002773,1005,100,,Cash sale,,,,,,05/04/2018,05/04/2018,0.00,,7.29,,"-270,841.18"
,CS,AR,32002809,1005,100,,Cash sale,,,,,,05/04/2018,05/04/2018,0.00,,7.29,,"-270,848.47"
,CS,AR,32002823,1005,100,,Cash sale,,,,,,05/04/2018,05/04/2018,0.00,,2.58,,"-270,851.05"
,CS,AR,32002841,1005,100,,Cash sale,,,,,,05/04/2018,05/04/2018,0.00,,18.09,,"-270,869.14"
,CS,AR,32002953,1005,100,,Cash sale,,,,,,05/04/2018,05/04/2018,0.00,,7.75,,"-270,876.89"
,CS,AR,32002963,1005,100,,Cash sale,,,,,,05/04/2018,05/04/2018,0.00,,22.03,,"-270,898.92"
,CS,AR,32002995,1005,100,,Cash sale,,,,,,05/04/2018,05/04/2018,0.00,,7.29,,"-270,906.21"
,CS,AR,32003001,1005,100,,Cash sale,,,,,,05/04/2018,05/04/2018,0.00,,14.58,,"-270,920.79"
,CS,AR,32003011,1005,100,,Cash sale,,,,,,05/04/2018,05/04/2018,0.00,,19.58,,"-270,940.37"
,CS,AR,32003016,1005,100,,Cash sale,,,,,,05/04/2018,05/04/2018,0.00,,15.51,,"-270,955.88"
,CS,AR,32003050,1005,100,,Cash sale,,,,,,05/04/2018,05/04/2018,0.00,,14.58,,"-270,970.46"
,CS,AR,32003063,1005,100,,Cash sale,,,,,,05/04/2018,05/04/2018,0.00,,10.93,,"-270,981.39"
,CS,AR,32003064,1005,100,,Cash sale,,,,,,05/04/2018,05/04/2018,0.00,,5.17,,"-270,986.56"
,CS,AR,32003105,1005,100,,Cash sale,,,,,,05/04/2018,05/04/2018,0.00,,36.10,,"-271,022.66"
,CS,AR,32003137,1005,100,,Cash sale,,,,,,05/04/2018,05/04/2018,0.00,,5.24,,"-271,027.90"
,CS,AR,32003160,1005,100,,Cash sale,,,,,,05/04/2018,05/04/2018,0.00,,2.58,,"-271,030.48"
,CS,AR,32003196,1005,100,,Cash sale,,,,,,05/04/2018,05/04/2018,0.00,,11.02,,"-271,041.50"
,CS,AR,32003202,1005,100,,Cash sale,,,,,,05/04/2018,05/04/2018,0.00,,5.93,,"-271,047.43"
,CS,AR,32003222,1005,100,,Cash sale,,,,,,05/04/2018,05/04/2018,0.00,,18.22,,"-271,065.65"
,CS,AR,32003223,1005,100,,Cash sale,,,,,,05/04/2018,05/04/2018,0.00,,7.29,,"-271,072.94"
,CS,AR,32003250,1005,100,,Cash sale,,,,,,05/04/2018,05/04/2018,0.00,,11.86,,"-271,084.80"
,CS,AR,32003286,1005,100,,Cash sale,,,,,,05/04/2018,05/04/2018,0.00,,10.93,,"-271,095.73"
,CS,AR,32003298,1005,100,,Cash sale,,,,,,05/04/2018,05/04/2018,0.00,,7.29,,"-271,103.02"
,CS,AR,32003317,1005,100,,Cash sale,,,,,,05/04/2018,05/04/2018,0.00,,3.64,,"-271,106.66"
,CS,AR,32003325,1005,100,,Cash sale,,,,,,05/04/2018,05/04/2018,0.00,,29.15,,"-271,135.81"
,CS,AR,32003341,1005,100,,Cash sale,,,,,,05/04/2018,05/04/2018,0.00,,18.22,,"-271,154.03"
,CS,AR,32003351,1005,100,,Cash sale,,,,,,05/04/2018,05/04/2018,0.00,,3.64,,"-271,157.67"
,CS,AR,32003354,1005,100,,Cash sale,,,,,,05/04/2018,05/04/2018,0.00,,7.29,,"-271,164.96"
,CS,AR,32003368,1005,100,,Cash sale,,,,,,05/04/2018,05/04/2018,0.00,,10.93,,"-271,175.89"
,CS,AR,32003375,1005,100,,Cash sale,,,,,,05/04/2018,05/04/2018,0.00,,7.29,,"-271,183.18"
,CS,AR,32003388,1005,100,,Cash sale,,,,,,05/04/2018,05/04/2018,0.00,,14.58,,"-271,197.76"
,CS,AR,32003390,1005,100,,Cash sale,,,,,,05/04/2018,05/04/2018,0.00,,5.85,,"-271,203.61"
,CS,AR,32003409,1005,100,,Cash sale,,,,,,05/04/2018,05/04/2018,0.00,,14.58,,"-271,218.19"
,IN,AR,30311103,1005,100,,Invoice,,,,,,05/04/2018,05/04/2018,0.00,,7.29,,"-271,225.48"
,IN,AR,30311111,1005,100,,Invoice,,,,,,05/04/2018,05/04/2018,0.00,,364.41,,"-271,589.89"
,IN,AR,30311125,1005,100,,Invoice,,,,,,05/04/2018,05/04/2018,0.00,,10.93,,"-271,600.82"
,IN,AR,30311153,1005,100,,Invoice,,,,,,05/04/2018,05/04/2018,0.00,,3.64,,"-271,604.46"
,IN,AR,30311169,1005,100,,Invoice,,,,,,05/04/2018,05/04/2018,0.00,,3.64,,"-271,608.10"
,IN,AR,30311179,1005,100,,Invoice,,,,,,05/04/2018,05/04/2018,0.00,,6.10,,"-271,614.20"
,IN,AR,30311197,1005,100,,Invoice,,,,,,05/04/2018,05/04/2018,0.00,,14.58,,"-271,628.78"
,IN,AR,30311200,1005,100,,Invoice,,,,,,05/04/2018,05/04/2018,0.00,,7.29,,"-271,636.07"
,IN,AR,30311204,1005,100,,Invoice,,,,,,05/04/2018,05/04/2018,0.00,,21.86,,"-271,657.93"
,IN,AR,30311218,1005,100,,Invoice,,,,,,05/04/2018,05/04/2018,0.00,,3.98,,"-271,661.91"
,IN,AR,30311219,1005,100,,Invoice,,,,,,05/04/2018,05/04/2018,0.00,,3.98,,"-271,665.89"
,IN,AR,30311230,1005,100,,Invoice,,,,,,05/04/2018,05/04/2018,0.00,,83.05,,"-271,748.94"
,IN,AR,30311298,1005,100,,Invoice,,,,,,05/04/2018,05/04/2018,0.00,,3.64,,"-271,752.58"
,IN,AR,30311321,1005,100,,Invoice,,,,,,05/04/2018,05/04/2018,0.00,,7.29,,"-271,759.87"
,IN,AR,30311389,1005,100,,Invoice,,,,,,05/04/2018,05/04/2018,0.00,,38.44,,"-271,798.31"
,IN,AR,30311433,1005,100,,Invoice,,,,,,05/04/2018,05/04/2018,0.00,,48.00,,"-271,846.31"
,IN,AR,30311448,1005,100,,Invoice,,,,,,05/04/2018,05/04/2018,0.00,,25.51,,"-271,871.82"
,IN,AR,30311493,1005,100,,Invoice,,,,,,05/04/2018,05/04/2018,0.00,,14.58,,"-271,886.40"
,IN,AR,30311505,1005,100,,Invoice,,,,,,05/04/2018,05/04/2018,0.00,,21.00,,"-271,907.40"
,IN,AR,30311522,1005,100,,Invoice,,,,,,05/04/2018,05/04/2018,0.00,,4.64,,"-271,912.04"
,IN,AR,30311541,1005,100,,Invoice,,,,,,05/04/2018,05/04/2018,0.00,,7.29,,"-271,919.33"
,IN,AR,30311571,1005,100,,Invoice,,,,,,05/04/2018,05/04/2018,0.00,,18.05,,"-271,937.38"
,IN,AR,30311610,1005,100,,Invoice,,,,,,05/04/2018,05/04/2018,0.00,,41.40,,"-271,978.78"
,IN,AR,30311626,1005,100,,Invoice,,,,,,05/04/2018,05/04/2018,0.00,,14.34,,"-271,993.12"
,IN,AR,30311644,1005,100,,Invoice,,,,,,05/04/2018,05/04/2018,0.00,,15.25,,"-272,008.37"
,IN,AR,30311665,1005,100,,Invoice,,,,,,05/04/2018,05/04/2018,0.00,,17.80,,"-272,026.17"
,IN,AR,30311684,1005,100,,Invoice,,,,,,05/04/2018,05/04/2018,0.00,,14.34,,"-272,040.51"
,IN,AR,30311703,1005,100,,Invoice,,,,,,05/04/2018,05/04/2018,0.00,,19.32,,"-272,059.83"
,IN,AR,30311719,1005,100,,Invoice,,,,,,05/04/2018,05/04/2018,0.00,,7.29,,"-272,067.12"
,IN,AR,30311762,1005,100,,Invoice,,,,,,05/04/2018,05/04/2018,0.00,,2.39,,"-272,069.51"
,IN,AR,30311767,1005,100,,Invoice,,,,,,05/04/2018,05/04/2018,0.00,,10.17,,"-272,079.68"
,IN,AR,30311768,1005,100,,Invoice,,,,,,05/04/2018,05/04/2018,0.00,,2.54,,"-272,082.22"
,IN,AR,30311790,1005,100,,Invoice,,,,,,05/04/2018,05/04/2018,0.00,,39.83,,"-272,122.05"
,IN,AR,30311791,1005,100,,Invoice,,,,,,05/04/2018,05/04/2018,0.00,,52.58,,"-272,174.63"
,IN,AR,30311805,1005,100,,Invoice,,,,,,05/04/2018,05/04/2018,0.00,,18.39,,"-272,193.02"
,IN,AR,30311810,1005,100,,Invoice,,,,,,05/04/2018,05/04/2018,0.00,,2.58,,"-272,195.60"
,IN,AR,30311833,1005,100,,Invoice,,,,,,05/04/2018,05/04/2018,0.00,,12.71,,"-272,208.31"
,IN,AR,30311842,1005,100,,Invoice,,,,,,05/04/2018,05/04/2018,0.00,,7.29,,"-272,215.60"
,IN,AR,30311866,1005,100,,Invoice,,,,,,05/04/2018,05/04/2018,0.00,,22.50,,"-272,238.10"
,IN,AR,30311918,1005,100,,Invoice,,,,,,05/04/2018,05/04/2018,0.00,,364.41,,"-272,602.51"
,IN,AR,30311928,1005,100,,Invoice,,,,,,05/04/2018,05/04/2018,0.00,,18.22,,"-272,620.73"
,IN,AR,30311954,1005,100,,Invoice,,,,,,05/04/2018,05/04/2018,0.00,,13.73,,"-272,634.46"
,IN,AR,30311993,1005,100,,Invoice,,,,,,05/04/2018,05/04/2018,0.00,,2.29,,"-272,636.75"
,IN,AR,30311994,1005,100,,Invoice,,,,,,05/04/2018,05/04/2018,0.00,,14.00,,"-272,650.75"
,IN,AR,30312016,1005,100,,Invoice,,,,,,05/04/2018,05/04/2018,0.00,,7.29,,"-272,658.04"
,IN,AR,30312024,1005,100,,Invoice,,,,,,05/04/2018,05/04/2018,0.00,,10.93,,"-272,668.97"
,IN,AR,30312047,1005,100,,Invoice,,,,,,05/04/2018,05/04/2018,0.00,,7.63,,"-272,676.60"
,IN,AR,30312071,1005,100,,Invoice,,,,,,05/04/2018,05/04/2018,0.00,,4.64,,"-272,681.24"
,IN,AR,30312077,1005,100,,Invoice,,,,,,05/04/2018,05/04/2018,0.00,,8.77,,"-272,690.01"
,IN,AR,30312087,1005,100,,Invoice,,,,,,05/04/2018,05/04/2018,0.00,,11.02,,"-272,701.03"
,IN,AR,30312148,1005,100,,Invoice,,,,,,05/04/2018,05/04/2018,0.00,,10.99,,"-272,712.02"
,IN,AR,30312153,1005,100,,Invoice,,,,,,05/04/2018,05/04/2018,0.00,,49.83,,"-272,761.85"
,IN,AR,30312154,1005,100,,Invoice,,,,,,05/04/2018,05/04/2018,0.00,,15.53,,"-272,777.38"
,IN,AR,30312161,1005,100,,Invoice,,,,,,05/04/2018,05/04/2018,0.00,,5.08,,"-272,782.46"
,IN,AR,30312170,1005,100,,Invoice,,,,,,05/04/2018,05/04/2018,0.00,,11.36,,"-272,793.82"
,IN,AR,30312175,1005,100,,Invoice,,,,,,05/04/2018,05/04/2018,0.00,,8.00,,"-272,801.82"
,IN,AR,30312195,1005,100,,Invoice,,,,,,05/04/2018,05/04/2018,0.00,,3.53,,"-272,805.35"
,IN,AR,30312224,1005,100,,Invoice,,,,,,05/04/2018,05/04/2018,0.00,,4.54,,"-272,809.89"
,IN,AR,30312270,1005,100,,Invoice,,,,,,05/04/2018,05/04/2018,0.00,,51.02,,"-272,860.91"
,IN,AR,30312300,1005,100,,Invoice,,,,,,05/04/2018,05/04/2018,0.00,,18.22,,"-272,879.13"
,IN,AR,30312304,1005,100,,Invoice,,,,,,05/04/2018,05/04/2018,0.00,,12.71,,"-272,891.84"
,IN,AR,30312315,1005,100,,Invoice,,,,,,05/04/2018,05/04/2018,0.00,,7.29,,"-272,899.13"
,IN,AR,30312319,1005,100,,Invoice,,,,,,05/04/2018,05/04/2018,0.00,,4.88,,"-272,904.01"
,IN,AR,30312320,1005,100,,Invoice,,,,,,05/04/2018,05/04/2018,0.00,,9.76,,"-272,913.77"
,IN,AR,30312321,1005,100,,Invoice,,,,,,05/04/2018,05/04/2018,0.00,,3.25,,"-272,917.02"
,IN,AR,30312322,1005,100,,Invoice,,,,,,05/04/2018,05/04/2018,0.00,,40.68,,"-272,957.70"
,IN,AR,30312337,1005,100,,Invoice,,,,,,05/04/2018,05/04/2018,0.00,,12.72,,"-272,970.42"
,IN,AR,30312367,1005,100,,Invoice,,,,,,05/04/2018,05/04/2018,0.00,,31.42,,"-273,001.84"
,IN,AR,30312393,1005,100,,Invoice,,,,,,05/04/2018,05/04/2018,0.00,,21.36,,"-273,023.20"
,IN,AR,30312411,1005,100,,Invoice,,,,,,05/04/2018,05/04/2018,0.00,,12.97,,"-273,036.17"
,IN,AR,30312433,1005,100,,Invoice,,,,,,05/04/2018,05/04/2018,0.00,,9.62,,"-273,045.79"
,IN,AR,30312434,1005,100,,Invoice,,,,,,05/04/2018,05/04/2018,0.00,,8.02,,"-273,053.81"
,IN,AR,30312487,1005,100,,Invoice,,,,,,05/04/2018,05/04/2018,0.00,,6.56,,"-273,060.37"
,IN,AR,30312505,1005,100,,Invoice,,,,,,05/04/2018,05/04/2018,0.00,,10.93,,"-273,071.30"
,IN,AR,30312517,1005,100,,Invoice,,,,,,05/04/2018,05/04/2018,0.00,,14.58,,"-273,085.88"
,IN,AR,30312520,1005,100,,Invoice,,,,,,05/04/2018,05/04/2018,0.00,,7.63,,"-273,093.51"
,IN,AR,30312531,1005,100,,Invoice,,,,,,05/04/2018,05/04/2018,0.00,,26.01,,"-273,119.52"
,IN,AR,30312548,1005,100,,Invoice,,,,,,05/04/2018,05/04/2018,0.00,,20.01,,"-273,139.53"
,IN,AR,30312560,1005,100,,Invoice,,,,,,05/04/2018,05/04/2018,0.00,,14.58,,"-273,154.11"
,IN,AR,30312561,1005,100,,Invoice,,,,,,05/04/2018,05/04/2018,0.00,,11.66,,"-273,165.77"
,IN,AR,30312622,1005,100,,Invoice,,,,,,05/04/2018,05/04/2018,0.00,,29.15,,"-273,194.92"
,IN,AR,30312623,1005,100,,Invoice,,,,,,05/04/2018,05/04/2018,0.00,,54.66,,"-273,249.58"
,IN,AR,30312640,1005,100,,Invoice,,,,,,05/04/2018,05/04/2018,0.00,,25.25,,"-273,274.83"
,IN,AR,30312652,1005,100,,Invoice,,,,,,05/04/2018,05/04/2018,0.00,,20.59,,"-273,295.42"
,IN,AR,30312658,1005,100,,Invoice,,,,,,05/04/2018,05/04/2018,0.00,,2.84,,"-273,298.26"
,IN,AR,30312736,1005,100,,Invoice,,,,,,05/04/2018,05/04/2018,0.00,,3.19,,"-273,301.45"
,IN,AR,30312737,1005,100,,Invoice,,,,,,05/04/2018,05/04/2018,0.00,,111.53,,"-273,412.98"
,IN,AR,30312738,1005,100,,Invoice,,,,,,05/04/2018,05/04/2018,0.00,,4.78,,"-273,417.76"
,IN,AR,30312739,1005,100,,Invoice,,,,,,05/04/2018,05/04/2018,0.00,,14.34,,"-273,432.10"
,IN,AR,30312740,1005,100,,Invoice,,,,,,05/04/2018,05/04/2018,0.00,,7.97,,"-273,440.07"
,IN,AR,30312784,1005,100,,Invoice,,,,,,05/04/2018,05/04/2018,0.00,,16.27,,"-273,456.34"
,IN,AR,30312832,1005,100,,Invoice,,,,,,05/04/2018,05/04/2018,0.00,,8.52,,"-273,464.86"
,IN,AR,30312850,1005,100,,Invoice,,,,,,05/04/2018,05/04/2018,0.00,,13.12,,"-273,477.98"
,IN,AR,30312854,1005,100,,Invoice,,,,,,05/04/2018,05/04/2018,0.00,,29.15,,"-273,507.13"
,IN,AR,30312866,1005,100,,Invoice,,,,,,05/04/2018,05/04/2018,0.00,,54.66,,"-273,561.79"
,IN,AR,30312880,1005,100,,Invoice,,,,,,05/04/2018,05/04/2018,0.00,,10.59,,"-273,572.38"
,IN,AR,30312913,1005,100,,Invoice,,,,,,05/04/2018,05/04/2018,0.00,,18.33,,"-273,590.71"
,IN,AR,30312949,1005,100,,Invoice,,,,,,05/04/2018,05/04/2018,0.00,,10.93,,"-273,601.64"
,IN,AR,30312966,1005,100,,Invoice,,,,,,05/04/2018,05/04/2018,0.00,,21.86,,"-273,623.50"
,IN,AR,30313028,1005,100,,Invoice,,,,,,05/04/2018,05/04/2018,0.00,,31.14,,"-273,654.64"
,IN,AR,30313029,1005,100,,Invoice,,,,,,05/04/2018,05/04/2018,0.00,,8.31,,"-273,662.95"
,IN,AR,30313030,1005,100,,Invoice,,,,,,05/04/2018,05/04/2018,0.00,,14.53,,"-273,677.48"
,IN,AR,30313062,1005,100,,Invoice,,,,,,05/04/2018,05/04/2018,0.00,,5.08,,"-273,682.56"
,IN,AR,30313063,1005,100,,Invoice,,,,,,05/04/2018,05/04/2018,0.00,,5.08,,"-273,687.64"
,IN,AR,30313064,1005,100,,Invoice,,,,,,05/04/2018,05/04/2018,0.00,,10.17,,"-273,697.81"
,IN,AR,30313067,1005,100,,Invoice,,,,,,05/04/2018,05/04/2018,0.00,,10.17,,"-273,707.98"
,IN,AR,30313082,1005,100,,Invoice,,,,,,05/04/2018,05/04/2018,0.00,,7.29,,"-273,715.27"
,IN,AR,30313088,1005,100,,Invoice,,,,,,05/04/2018,05/04/2018,0.00,,364.41,,"-274,079.68"
,CN,AR,31017761,1005,100,,Credit Note,,,,,,06/04/2018,06/04/2018,18.22,,0.00,,"-274,061.46"
,CS,AR,32002591,1005,100,,Cash sale,,,,,,06/04/2018,06/04/2018,0.00,,3.64,,"-274,065.10"
,CS,AR,32002598,1005,100,,Cash sale,,,,,,06/04/2018,06/04/2018,0.00,,14.03,,"-274,079.13"
,CS,AR,32002615,1005,100,,Cash sale,,,,,,06/04/2018,06/04/2018,0.00,,16.61,,"-274,095.74"
,CS,AR,32002624,1005,100,,Cash sale,,,,,,06/04/2018,06/04/2018,0.00,,8.52,,"-274,104.26"
,CS,AR,32002633,1005,100,,Cash sale,,,,,,06/04/2018,06/04/2018,0.00,,9.13,,"-274,113.39"
,CS,AR,32002648,1005,100,,Cash sale,,,,,,06/04/2018,06/04/2018,0.00,,14.58,,"-274,127.97"
,CS,AR,32002652,1005,100,,Cash sale,,,,,,06/04/2018,06/04/2018,0.00,,3.64,,"-274,131.61"
,CS,AR,32002671,1005,100,,Cash sale,,,,,,06/04/2018,06/04/2018,0.00,,10.93,,"-274,142.54"
,CS,AR,32002680,1005,100,,Cash sale,,,,,,06/04/2018,06/04/2018,0.00,,24.07,,"-274,166.61"
,CS,AR,32002697,1005,100,,Cash sale,,,,,,06/04/2018,06/04/2018,0.00,,21.36,,"-274,187.97"
,CS,AR,32002713,1005,100,,Cash sale,,,,,,06/04/2018,06/04/2018,0.00,,18.69,,"-274,206.66"
,CS,AR,32002723,1005,100,,Cash sale,,,,,,06/04/2018,06/04/2018,0.00,,7.29,,"-274,213.95"
,CS,AR,32002769,1005,100,,Cash sale,,,,,,06/04/2018,06/04/2018,0.00,,3.64,,"-274,217.59"
,CS,AR,32002816,1005,100,,Cash sale,,,,,,06/04/2018,06/04/2018,0.00,,32.80,,"-274,250.39"
,CS,AR,32002819,1005,100,,Cash sale,,,,,,06/04/2018,06/04/2018,0.00,,5.17,,"-274,255.56"
,CS,AR,32002825,1005,100,,Cash sale,,,,,,06/04/2018,06/04/2018,0.00,,15.25,,"-274,270.81"
,CS,AR,32002851,1005,100,,Cash sale,,,,,,06/04/2018,06/04/2018,0.00,,38.47,,"-274,309.28"
,CS,AR,32002864,1005,100,,Cash sale,,,,,,06/04/2018,06/04/2018,0.00,,10.99,,"-274,320.27"
,CS,AR,32002884,1005,100,,Cash sale,,,,,,06/04/2018,06/04/2018,0.00,,9.03,,"-274,329.30"
,CS,AR,32002889,1005,100,,Cash sale,,,,,,06/04/2018,06/04/2018,0.00,,7.29,,"-274,336.59"
,CS,AR,32002911,1005,100,,Cash sale,,,,,,06/04/2018,06/04/2018,0.00,,7.63,,"-274,344.22"
,CS,AR,32002919,1005,100,,Cash sale,,,,,,06/04/2018,06/04/2018,0.00,,32.16,,"-274,376.38"
,CS,AR,32002935,1005,100,,Cash sale,,,,,,06/04/2018,06/04/2018,0.00,,33.09,,"-274,409.47"
,CS,AR,32002944,1005,100,,Cash sale,,,,,,06/04/2018,06/04/2018,0.00,,10.93,,"-274,420.40"
,CS,AR,32002972,1005,100,,Cash sale,,,,,,06/04/2018,06/04/2018,0.00,,7.29,,"-274,427.69"
,CS,AR,32002983,1005,100,,Cash sale,,,,,,06/04/2018,06/04/2018,0.00,,3.64,,"-274,431.33"
,CS,AR,32002991,1005,100,,Cash sale,,,,,,06/04/2018,06/04/2018,0.00,,18.22,,"-274,449.55"
,CS,AR,32003023,1005,100,,Cash sale,,,,,,06/04/2018,06/04/2018,0.00,,14.58,,"-274,464.13"
,CS,AR,32003034,1005,100,,Cash sale,,,,,,06/04/2018,06/04/2018,0.00,,14.58,,"-274,478.71"
,CS,AR,32003054,1005,100,,Cash sale,,,,,,06/04/2018,06/04/2018,0.00,,20.48,,"-274,499.19"
,CS,AR,32003057,1005,100,,Cash sale,,,,,,06/04/2018,06/04/2018,0.00,,7.29,,"-274,506.48"
,CS,AR,32003085,1005,100,,Cash sale,,,,,,06/04/2018,06/04/2018,0.00,,7.29,,"-274,513.77"
,CS,AR,32003089,1005,100,,Cash sale,,,,,,06/04/2018,06/04/2018,0.00,,5.17,,"-274,518.94"
,CS,AR,32003096,1005,100,,Cash sale,,,,,,06/04/2018,06/04/2018,0.00,,11.12,,"-274,530.06"
,CS,AR,32003112,1005,100,,Cash sale,,,,,,06/04/2018,06/04/2018,0.00,,3.64,,"-274,533.70"
,CS,AR,32003141,1005,100,,Cash sale,,,,,,06/04/2018,06/04/2018,0.00,,12.71,,"-274,546.41"
,CS,AR,32003146,1005,100,,Cash sale,,,,,,06/04/2018,06/04/2018,0.00,,3.01,,"-274,549.42"
,CS,AR,32003151,1005,100,,Cash sale,,,,,,06/04/2018,06/04/2018,0.00,,7.29,,"-274,556.71"
,CS,AR,32003158,1005,100,,Cash sale,,,,,,06/04/2018,06/04/2018,0.00,,6.12,,"-274,562.83"
,CS,AR,32003167,1005,100,,Cash sale,,,,,,06/04/2018,06/04/2018,0.00,,17.80,,"-274,580.63"
,CS,AR,32003183,1005,100,,Cash sale,,,,,,06/04/2018,06/04/2018,0.00,,44.00,,"-274,624.63"
,CS,AR,32003186,1005,100,,Cash sale,,,,,,06/04/2018,06/04/2018,0.00,,3.64,,"-274,628.27"
,CS,AR,32003189,1005,100,,Cash sale,,,,,,06/04/2018,06/04/2018,0.00,,7.29,,"-274,635.56"
,CS,AR,32003211,1005,100,,Cash sale,,,,,,06/04/2018,06/04/2018,0.00,,2.54,,"-274,638.10"
,CS,AR,32003221,1005,100,,Cash sale,,,,,,06/04/2018,06/04/2018,0.00,,14.58,,"-274,652.68"
,CS,AR,32003228,1005,100,,Cash sale,,,,,,06/04/2018,06/04/2018,0.00,,6.86,,"-274,659.54"
,CS,AR,32003238,1005,100,,Cash sale,,,,,,06/04/2018,06/04/2018,0.00,,10.93,,"-274,670.47"
,CS,AR,32003257,1005,100,,Cash sale,,,,,,06/04/2018,06/04/2018,0.00,,17.80,,"-274,688.27"
,CS,AR,32003281,1005,100,,Cash sale,,,,,,06/04/2018,06/04/2018,0.00,,21.25,,"-274,709.52"
,CS,AR,32003294,1005,100,,Cash sale,,,,,,06/04/2018,06/04/2018,0.00,,5.47,,"-274,714.99"
,CS,AR,32003299,1005,100,,Cash sale,,,,,,06/04/2018,06/04/2018,0.00,,7.29,,"-274,722.28"
,CS,AR,32003312,1005,100,,Cash sale,,,,,,06/04/2018,06/04/2018,0.00,,9.15,,"-274,731.43"
,CS,AR,32003319,1005,100,,Cash sale,,,,,,06/04/2018,06/04/2018,0.00,,11.86,,"-274,743.29"
,CS,AR,32003334,1005,100,,Cash sale,,,,,,06/04/2018,06/04/2018,0.00,,7.29,,"-274,750.58"
,CS,AR,32003336,1005,100,,Cash sale,,,,,,06/04/2018,06/04/2018,0.00,,6.08,,"-274,756.66"
,CS,AR,32003395,1005,100,,Cash sale,,,,,,06/04/2018,06/04/2018,0.00,,25.51,,"-274,782.17"
,IN,AR,30311089,1005,100,,Invoice,,,,,,06/04/2018,06/04/2018,0.00,,74.15,,"-274,856.32"
,IN,AR,30311100,1005,100,,Invoice,,,,,,06/04/2018,06/04/2018,0.00,,18.22,,"-274,874.54"
,IN,AR,30311121,1005,100,,Invoice,,,,,,06/04/2018,06/04/2018,0.00,,18.22,,"-274,892.76"
,IN,AR,30311142,1005,100,,Invoice,,,,,,06/04/2018,06/04/2018,0.00,,10.93,,"-274,903.69"
,IN,AR,30311165,1005,100,,Invoice,,,,,,06/04/2018,06/04/2018,0.00,,21.74,,"-274,925.43"
,IN,AR,30311180,1005,100,,Invoice,,,,,,06/04/2018,06/04/2018,0.00,,14.24,,"-274,939.67"
,IN,AR,30311202,1005,100,,Invoice,,,,,,06/04/2018,06/04/2018,0.00,,7.29,,"-274,946.96"
,IN,AR,30311208,1005,100,,Invoice,,,,,,06/04/2018,06/04/2018,0.00,,9.19,,"-274,956.15"
,IN,AR,30311213,1005,100,,Invoice,,,,,,06/04/2018,06/04/2018,0.00,,65.98,,"-275,022.13"
,IN,AR,30311231,1005,100,,Invoice,,,,,,06/04/2018,06/04/2018,0.00,,14.24,,"-275,036.37"
,IN,AR,30311260,1005,100,,Invoice,,,,,,06/04/2018,06/04/2018,0.00,,18.00,,"-275,054.37"
,IN,AR,30311290,1005,100,,Invoice,,,,,,06/04/2018,06/04/2018,0.00,,14.49,,"-275,068.86"
,IN,AR,30311308,1005,100,,Invoice,,,,,,06/04/2018,06/04/2018,0.00,,46.00,,"-275,114.86"
,IN,AR,30311323,1005,100,,Invoice,,,,,,06/04/2018,06/04/2018,0.00,,3.64,,"-275,118.50"
,IN,AR,30311351,1005,100,,Invoice,,,,,,06/04/2018,06/04/2018,0.00,,5.84,,"-275,124.34"
,IN,AR,30311364,1005,100,,Invoice,,,,,,06/04/2018,06/04/2018,0.00,,4.75,,"-275,129.09"
,IN,AR,30311372,1005,100,,Invoice,,,,,,06/04/2018,06/04/2018,0.00,,18.00,,"-275,147.09"
,IN,AR,30311373,1005,100,,Invoice,,,,,,06/04/2018,06/04/2018,0.00,,22.00,,"-275,169.09"
,IN,AR,30311414,1005,100,,Invoice,,,,,,06/04/2018,06/04/2018,0.00,,774.86,,"-275,943.95"
,IN,AR,30311422,1005,100,,Invoice,,,,,,06/04/2018,06/04/2018,0.00,,9.70,,"-275,953.65"
,IN,AR,30311431,1005,100,,Invoice,,,,,,06/04/2018,06/04/2018,0.00,,3.64,,"-275,957.29"
,IN,AR,30311454,1005,100,,Invoice,,,,,,06/04/2018,06/04/2018,0.00,,16.78,,"-275,974.07"
,IN,AR,30311465,1005,100,,Invoice,,,,,,06/04/2018,06/04/2018,0.00,,23.29,,"-275,997.36"
,IN,AR,30311479,1005,100,,Invoice,,,,,,06/04/2018,06/04/2018,0.00,,182.20,,"-276,179.56"
,IN,AR,30311488,1005,100,,Invoice,,,,,,06/04/2018,06/04/2018,0.00,,9.56,,"-276,189.12"
,IN,AR,30311513,1005,100,,Invoice,,,,,,06/04/2018,06/04/2018,0.00,,7.75,,"-276,196.87"
,IN,AR,30311529,1005,100,,Invoice,,,,,,06/04/2018,06/04/2018,0.00,,4.80,,"-276,201.67"
,IN,AR,30311530,1005,100,,Invoice,,,,,,06/04/2018,06/04/2018,0.00,,2.40,,"-276,204.07"
,IN,AR,30311586,1005,100,,Invoice,,,,,,06/04/2018,06/04/2018,0.00,,12.92,,"-276,216.99"
,IN,AR,30311592,1005,100,,Invoice,,,,,,06/04/2018,06/04/2018,0.00,,4.78,,"-276,221.77"
,IN,AR,30311600,1005,100,,Invoice,,,,,,06/04/2018,06/04/2018,0.00,,220.58,,"-276,442.35"
,IN,AR,30311650,1005,100,,Invoice,,,,,,06/04/2018,06/04/2018,0.00,,38.97,,"-276,481.32"
,IN,AR,30311660,1005,100,,Invoice,,,,,,06/04/2018,06/04/2018,0.00,,8.42,,"-276,489.74"
,IN,AR,30311709,1005,100,,Invoice,,,,,,06/04/2018,06/04/2018,0.00,,10.93,,"-276,500.67"
,IN,AR,30311732,1005,100,,Invoice,,,,,,06/04/2018,06/04/2018,0.00,,15.04,,"-276,515.71"
,IN,AR,30311736,1005,100,,Invoice,,,,,,06/04/2018,06/04/2018,0.00,,10.34,,"-276,526.05"
,IN,AR,30311747,1005,100,,Invoice,,,,,,06/04/2018,06/04/2018,0.00,,6.36,,"-276,532.41"
,IN,AR,30311769,1005,100,,Invoice,,,,,,06/04/2018,06/04/2018,0.00,,10.17,,"-276,542.58"
,IN,AR,30311770,1005,100,,Invoice,,,,,,06/04/2018,06/04/2018,0.00,,5.08,,"-276,547.66"
,IN,AR,30311785,1005,100,,Invoice,,,,,,06/04/2018,06/04/2018,0.00,,2.54,,"-276,550.20"
,IN,AR,30311809,1005,100,,Invoice,,,,,,06/04/2018,06/04/2018,0.00,,63.15,,"-276,613.35"
,IN,AR,30311826,1005,100,,Invoice,,,,,,06/04/2018,06/04/2018,0.00,,27.97,,"-276,641.32"
,IN,AR,30311848,1005,100,,Invoice,,,,,,06/04/2018,06/04/2018,0.00,,25.51,,"-276,666.83"
,IN,AR,30311856,1005,100,,Invoice,,,,,,06/04/2018,06/04/2018,0.00,,30.51,,"-276,697.34"
,IN,AR,30311905,1005,100,,Invoice,,,,,,06/04/2018,06/04/2018,0.00,,16.48,,"-276,713.82"
,IN,AR,30311906,1005,100,,Invoice,,,,,,06/04/2018,06/04/2018,0.00,,10.93,,"-276,724.75"
,IN,AR,30311910,1005,100,,Invoice,,,,,,06/04/2018,06/04/2018,0.00,,3.64,,"-276,728.39"
,IN,AR,30311966,1005,100,,Invoice,,,,,,06/04/2018,06/04/2018,0.00,,11.22,,"-276,739.61"
,IN,AR,30312026,1005,100,,Invoice,,,,,,06/04/2018,06/04/2018,0.00,,18.22,,"-276,757.83"
,IN,AR,30312028,1005,100,,Invoice,,,,,,06/04/2018,06/04/2018,0.00,,7.29,,"-276,765.12"
,IN,AR,30312038,1005,100,,Invoice,,,,,,06/04/2018,06/04/2018,0.00,,23.31,,"-276,788.43"
,IN,AR,30312044,1005,100,,Invoice,,,,,,06/04/2018,06/04/2018,0.00,,75.66,,"-276,864.09"
,IN,AR,30312137,1005,100,,Invoice,,,,,,06/04/2018,06/04/2018,0.00,,17.95,,"-276,882.04"
,IN,AR,30312138,1005,100,,Invoice,,,,,,06/04/2018,06/04/2018,0.00,,21.06,,"-276,903.10"
,IN,AR,30312155,1005,100,,Invoice,,,,,,06/04/2018,06/04/2018,0.00,,1.94,,"-276,905.04"
,IN,AR,30312173,1005,100,,Invoice,,,,,,06/04/2018,06/04/2018,0.00,,10.93,,"-276,915.97"
,IN,AR,30312181,1005,100,,Invoice,,,,,,06/04/2018,06/04/2018,0.00,,7.29,,"-276,923.26"
,IN,AR,30312220,1005,100,,Invoice,,,,,,06/04/2018,06/04/2018,0.00,,4.85,,"-276,928.11"
,IN,AR,30312307,1005,100,,Invoice,,,,,,06/04/2018,06/04/2018,0.00,,3.64,,"-276,931.75"
,IN,AR,30312355,1005,100,,Invoice,,,,,,06/04/2018,06/04/2018,0.00,,59.62,,"-276,991.37"
,IN,AR,30312382,1005,100,,Invoice,,,,,,06/04/2018,06/04/2018,0.00,,32.07,,"-277,023.44"
,IN,AR,30312395,1005,100,,Invoice,,,,,,06/04/2018,06/04/2018,0.00,,8.21,,"-277,031.65"
,IN,AR,30312435,1005,100,,Invoice,,,,,,06/04/2018,06/04/2018,0.00,,73.75,,"-277,105.40"
,IN,AR,30312474,1005,100,,Invoice,,,,,,06/04/2018,06/04/2018,0.00,,31.53,,"-277,136.93"
,IN,AR,30312481,1005,100,,Invoice,,,,,,06/04/2018,06/04/2018,0.00,,6.86,,"-277,143.79"
,IN,AR,30312501,1005,100,,Invoice,,,,,,06/04/2018,06/04/2018,0.00,,23.91,,"-277,167.70"
,IN,AR,30312511,1005,100,,Invoice,,,,,,06/04/2018,06/04/2018,0.00,,25.51,,"-277,193.21"
,IN,AR,30312521,1005,100,,Invoice,,,,,,06/04/2018,06/04/2018,0.00,,12.71,,"-277,205.92"
,IN,AR,30312542,1005,100,,Invoice,,,,,,06/04/2018,06/04/2018,0.00,,16.01,,"-277,221.93"
,IN,AR,30312552,1005,100,,Invoice,,,,,,06/04/2018,06/04/2018,0.00,,16.01,,"-277,237.94"
,IN,AR,30312572,1005,100,,Invoice,,,,,,06/04/2018,06/04/2018,0.00,,54.66,,"-277,292.60"
,IN,AR,30312575,1005,100,,Invoice,,,,,,06/04/2018,06/04/2018,0.00,,70.97,,"-277,363.57"
,IN,AR,30312596,1005,100,,Invoice,,,,,,06/04/2018,06/04/2018,0.00,,30.11,,"-277,393.68"
,IN,AR,30312600,1005,100,,Invoice,,,,,,06/04/2018,06/04/2018,0.00,,8.41,,"-277,402.09"
,IN,AR,30312601,1005,100,,Invoice,,,,,,06/04/2018,06/04/2018,0.00,,4.20,,"-277,406.29"
,IN,AR,30312648,1005,100,,Invoice,,,,,,06/04/2018,06/04/2018,0.00,,4.59,,"-277,410.88"
,IN,AR,30312666,1005,100,,Invoice,,,,,,06/04/2018,06/04/2018,0.00,,9.64,,"-277,420.52"
,IN,AR,30312703,1005,100,,Invoice,,,,,,06/04/2018,06/04/2018,0.00,,18.22,,"-277,438.74"
,IN,AR,30312717,1005,100,,Invoice,,,,,,06/04/2018,06/04/2018,0.00,,5.68,,"-277,444.42"
,IN,AR,30312721,1005,100,,Invoice,,,,,,06/04/2018,06/04/2018,0.00,,9.66,,"-277,454.08"
,IN,AR,30312741,1005,100,,Invoice,,,,,,06/04/2018,06/04/2018,0.00,,15.93,,"-277,470.01"
,IN,AR,30312801,1005,100,,Invoice,,,,,,06/04/2018,06/04/2018,0.00,,8.00,,"-277,478.01"
,IN,AR,30312873,1005,100,,Invoice,,,,,,06/04/2018,06/04/2018,0.00,,5.47,,"-277,483.48"
,IN,AR,30312883,1005,100,,Invoice,,,,,,06/04/2018,06/04/2018,0.00,,67.80,,"-277,551.28"
,IN,AR,30312925,1005,100,,Invoice,,,,,,06/04/2018,06/04/2018,0.00,,11.86,,"-277,563.14"
,IN,AR,30312934,1005,100,,Invoice,,,,,,06/04/2018,06/04/2018,0.00,,10.21,,"-277,573.35"
,IN,AR,30312967,1005,100,,Invoice,,,,,,06/04/2018,06/04/2018,0.00,,18.22,,"-277,591.57"
,IN,AR,30312980,1005,100,,Invoice,,,,,,06/04/2018,06/04/2018,0.00,,11.95,,"-277,603.52"
,IN,AR,30312997,1005,100,,Invoice,,,,,,06/04/2018,06/04/2018,0.00,,7.25,,"-277,610.77"
,IN,AR,30312999,1005,100,,Invoice,,,,,,06/04/2018,06/04/2018,0.00,,9.11,,"-277,619.88"
,IN,AR,30313031,1005,100,,Invoice,,,,,,06/04/2018,06/04/2018,0.00,,18.69,,"-277,638.57"
,IN,AR,30313057,1005,100,,Invoice,,,,,,06/04/2018,06/04/2018,0.00,,3.64,,"-277,642.21"
,IN,AR,30313065,1005,100,,Invoice,,,,,,06/04/2018,06/04/2018,0.00,,10.17,,"-277,652.38"
,IN,AR,30313068,1005,100,,Invoice,,,,,,06/04/2018,06/04/2018,0.00,,10.17,,"-277,662.55"
,CS,AR,32002606,1005,100,,Cash sale,,,,,,07/04/2018,07/04/2018,0.00,,16.78,,"-277,679.33"
,CS,AR,32002702,1005,100,,Cash sale,,,,,,07/04/2018,07/04/2018,0.00,,3.64,,"-277,682.97"
,CS,AR,32002749,1005,100,,Cash sale,,,,,,07/04/2018,07/04/2018,0.00,,10.93,,"-277,693.90"
,CS,AR,32002754,1005,100,,Cash sale,,,,,,07/04/2018,07/04/2018,0.00,,7.29,,"-277,701.19"
,CS,AR,32002839,1005,100,,Cash sale,,,,,,07/04/2018,07/04/2018,0.00,,10.93,,"-277,712.12"
,CS,AR,32002954,1005,100,,Cash sale,,,,,,07/04/2018,07/04/2018,0.00,,10.93,,"-277,723.05"
,CS,AR,32003177,1005,100,,Cash sale,,,,,,07/04/2018,07/04/2018,0.00,,9.84,,"-277,732.89"
,CS,AR,32003258,1005,100,,Cash sale,,,,,,07/04/2018,07/04/2018,0.00,,4.24,,"-277,737.13"
,CS,AR,32003293,1005,100,,Cash sale,,,,,,07/04/2018,07/04/2018,0.00,,10.34,,"-277,747.47"
,CS,AR,32003339,1005,100,,Cash sale,,,,,,07/04/2018,07/04/2018,0.00,,18.22,,"-277,765.69"
,IN,AR,30311174,1005,100,,Invoice,,,,,,07/04/2018,07/04/2018,0.00,,7.29,,"-277,772.98"
,IN,AR,30312985,1005,100,,Invoice,,,,,,07/04/2018,07/04/2018,0.00,,7.17,,"-277,780.15"
,IN,AR,30313006,1005,100,,Invoice,,,,,,07/04/2018,07/04/2018,0.00,,7.29,,"-277,787.44"
,CS,AR,32003316,1005,100,,Cash sale,,,,,,08/04/2018,08/04/2018,0.00,,54.66,,"-277,842.10"
,CN,AR,31017712,1005,100,,Credit Note,,,,,,09/04/2018,09/04/2018,"2,432.32",,0.00,,"-275,409.78"
,CN,AR,31017784,1005,100,,Credit Note,,,,,,09/04/2018,09/04/2018,182.20,,0.00,,"-275,227.58"
,CN,AR,31017827,1005,100,,Credit Note,,,,,,09/04/2018,09/04/2018,142.17,,0.00,,"-275,085.41"
,CS,AR,32002599,1005,100,,Cash sale,,,,,,09/04/2018,09/04/2018,0.00,,14.03,,"-275,099.44"
,CS,AR,32002616,1005,100,,Cash sale,,,,,,09/04/2018,09/04/2018,0.00,,9.49,,"-275,108.93"
,CS,AR,32002675,1005,100,,Cash sale,,,,,,09/04/2018,09/04/2018,0.00,,3.64,,"-275,112.57"
,CS,AR,32002714,1005,100,,Cash sale,,,,,,09/04/2018,09/04/2018,0.00,,14.53,,"-275,127.10"
,CS,AR,32002726,1005,100,,Cash sale,,,,,,09/04/2018,09/04/2018,0.00,,7.29,,"-275,134.39"
,CS,AR,32002738,1005,100,,Cash sale,,,,,,09/04/2018,09/04/2018,0.00,,8.77,,"-275,143.16"
,CS,AR,32002766,1005,100,,Cash sale,,,,,,09/04/2018,09/04/2018,0.00,,3.64,,"-275,146.80"
,CS,AR,32002779,1005,100,,Cash sale,,,,,,09/04/2018,09/04/2018,0.00,,7.29,,"-275,154.09"
,CS,AR,32002785,1005,100,,Cash sale,,,,,,09/04/2018,09/04/2018,0.00,,10.34,,"-275,164.43"
,CS,AR,32002826,1005,100,,Cash sale,,,,,,09/04/2018,09/04/2018,0.00,,12.71,,"-275,177.14"
,CS,AR,32002833,1005,100,,Cash sale,,,,,,09/04/2018,09/04/2018,0.00,,22.37,,"-275,199.51"
,CS,AR,32002865,1005,100,,Cash sale,,,,,,09/04/2018,09/04/2018,0.00,,8.25,,"-275,207.76"
,CS,AR,32002895,1005,100,,Cash sale,,,,,,09/04/2018,09/04/2018,0.00,,7.29,,"-275,215.05"
,CS,AR,32002906,1005,100,,Cash sale,,,,,,09/04/2018,09/04/2018,0.00,,6.02,,"-275,221.07"
,CS,AR,32002908,1005,100,,Cash sale,,,,,,09/04/2018,09/04/2018,0.00,,3.64,,"-275,224.71"
,CS,AR,32002929,1005,100,,Cash sale,,,,,,09/04/2018,09/04/2018,0.00,,6.02,,"-275,230.73"
,CS,AR,32002936,1005,100,,Cash sale,,,,,,09/04/2018,09/04/2018,0.00,,36.10,,"-275,266.83"
,CS,AR,32002948,1005,100,,Cash sale,,,,,,09/04/2018,09/04/2018,0.00,,4.32,,"-275,271.15"
,CS,AR,32003000,1005,100,,Cash sale,,,,,,09/04/2018,09/04/2018,0.00,,3.64,,"-275,274.79"
,CS,AR,32003041,1005,100,,Cash sale,,,,,,09/04/2018,09/04/2018,0.00,,7.29,,"-275,282.08"
,CS,AR,32003080,1005,100,,Cash sale,,,,,,09/04/2018,09/04/2018,0.00,,5.17,,"-275,287.25"
,CS,AR,32003083,1005,100,,Cash sale,,,,,,09/04/2018,09/04/2018,0.00,,7.29,,"-275,294.54"
,CS,AR,32003115,1005,100,,Cash sale,,,,,,09/04/2018,09/04/2018,0.00,,7.29,,"-275,301.83"
,CS,AR,32003142,1005,100,,Cash sale,,,,,,09/04/2018,09/04/2018,0.00,,10.17,,"-275,312.00"
,CS,AR,32003201,1005,100,,Cash sale,,,,,,09/04/2018,09/04/2018,0.00,,14.58,,"-275,326.58"
,CS,AR,32003206,1005,100,,Cash sale,,,,,,09/04/2018,09/04/2018,0.00,,10.93,,"-275,337.51"
,CS,AR,32003229,1005,100,,Cash sale,,,,,,09/04/2018,09/04/2018,0.00,,11.44,,"-275,348.95"
,CS,AR,32003259,1005,100,,Cash sale,,,,,,09/04/2018,09/04/2018,0.00,,9.10,,"-275,358.05"
,CS,AR,32003272,1005,100,,Cash sale,,,,,,09/04/2018,09/04/2018,0.00,,63.75,,"-275,421.80"
,CS,AR,32003283,1005,100,,Cash sale,,,,,,09/04/2018,09/04/2018,0.00,,10.93,,"-275,432.73"
,CS,AR,32003300,1005,100,,Cash sale,,,,,,09/04/2018,09/04/2018,0.00,,10.93,,"-275,443.66"
,CS,AR,32003307,1005,100,,Cash sale,,,,,,09/04/2018,09/04/2018,0.00,,19.14,,"-275,462.80"
,CS,AR,32003345,1005,100,,Cash sale,,,,,,09/04/2018,09/04/2018,0.00,,5.93,,"-275,468.73"
,CS,AR,32003347,1005,100,,Cash sale,,,,,,09/04/2018,09/04/2018,0.00,,29.15,,"-275,497.88"
,CS,AR,32003380,1005,100,,Cash sale,,,,,,09/04/2018,09/04/2018,0.00,,7.29,,"-275,505.17"
,CS,AR,32003401,1005,100,,Cash sale,,,,,,09/04/2018,09/04/2018,0.00,,3.64,,"-275,508.81"
,IN,AR,30311108,1005,100,,Invoice,,,,,,09/04/2018,09/04/2018,0.00,,14.58,,"-275,523.39"
,IN,AR,30311115,1005,100,,Invoice,,,,,,09/04/2018,09/04/2018,0.00,,219.81,,"-275,743.20"
,IN,AR,30311191,1005,100,,Invoice,,,,,,09/04/2018,09/04/2018,0.00,,84.54,,"-275,827.74"
,IN,AR,30311217,1005,100,,Invoice,,,,,,09/04/2018,09/04/2018,0.00,,3.64,,"-275,831.38"
,IN,AR,30311232,1005,100,,Invoice,,,,,,09/04/2018,09/04/2018,0.00,,135.25,,"-275,966.63"
,IN,AR,30311250,1005,100,,Invoice,,,,,,09/04/2018,09/04/2018,0.00,,22.03,,"-275,988.66"
,IN,AR,30311261,1005,100,,Invoice,,,,,,09/04/2018,09/04/2018,0.00,,32.00,,"-276,020.66"
,IN,AR,30311284,1005,100,,Invoice,,,,,,09/04/2018,09/04/2018,0.00,,50.90,,"-276,071.56"
,IN,AR,30311288,1005,100,,Invoice,,,,,,09/04/2018,09/04/2018,0.00,,182.20,,"-276,253.76"
,IN,AR,30311301,1005,100,,Invoice,,,,,,09/04/2018,09/04/2018,0.00,,3.64,,"-276,257.40"
,IN,AR,30311309,1005,100,,Invoice,,,,,,09/04/2018,09/04/2018,0.00,,14.00,,"-276,271.40"
,IN,AR,30311310,1005,100,,Invoice,,,,,,09/04/2018,09/04/2018,0.00,,12.00,,"-276,283.40"
,IN,AR,30311333,1005,100,,Invoice,,,,,,09/04/2018,09/04/2018,0.00,,2.75,,"-276,286.15"
,IN,AR,30311339,1005,100,,Invoice,,,,,,09/04/2018,09/04/2018,0.00,,8.26,,"-276,294.41"
,IN,AR,30311352,1005,100,,Invoice,,,,,,09/04/2018,09/04/2018,0.00,,3.89,,"-276,298.30"
,IN,AR,30311381,1005,100,,Invoice,,,,,,09/04/2018,09/04/2018,0.00,,7.29,,"-276,305.59"
,IN,AR,30311437,1005,100,,Invoice,,,,,,09/04/2018,09/04/2018,0.00,,10.93,,"-276,316.52"
,IN,AR,30311458,1005,100,,Invoice,,,,,,09/04/2018,09/04/2018,0.00,,12.88,,"-276,329.40"
,IN,AR,30311474,1005,100,,Invoice,,,,,,09/04/2018,09/04/2018,0.00,,25.55,,"-276,354.95"
,IN,AR,30311498,1005,100,,Invoice,,,,,,09/04/2018,09/04/2018,0.00,,12.92,,"-276,367.87"
,IN,AR,30311527,1005,100,,Invoice,,,,,,09/04/2018,09/04/2018,0.00,,7.29,,"-276,375.16"
,IN,AR,30311528,1005,100,,Invoice,,,,,,09/04/2018,09/04/2018,0.00,,29.15,,"-276,404.31"
,IN,AR,30311560,1005,100,,Invoice,,,,,,09/04/2018,09/04/2018,0.00,,6.36,,"-276,410.67"
,IN,AR,30311587,1005,100,,Invoice,,,,,,09/04/2018,09/04/2018,0.00,,18.09,,"-276,428.76"
,IN,AR,30311606,1005,100,,Invoice,,,,,,09/04/2018,09/04/2018,0.00,,16.31,,"-276,445.07"
,IN,AR,30311611,1005,100,,Invoice,,,,,,09/04/2018,09/04/2018,0.00,,2.58,,"-276,447.65"
,IN,AR,30311624,1005,100,,Invoice,,,,,,09/04/2018,09/04/2018,0.00,,7.29,,"-276,454.94"
,IN,AR,30311651,1005,100,,Invoice,,,,,,09/04/2018,09/04/2018,0.00,,100.49,,"-276,555.43"
,IN,AR,30311666,1005,100,,Invoice,,,,,,09/04/2018,09/04/2018,0.00,,40.68,,"-276,596.11"
,IN,AR,30311685,1005,100,,Invoice,,,,,,09/04/2018,09/04/2018,0.00,,23.90,,"-276,620.01"
,IN,AR,30311686,1005,100,,Invoice,,,,,,09/04/2018,09/04/2018,0.00,,9.56,,"-276,629.57"
,IN,AR,30311699,1005,100,,Invoice,,,,,,09/04/2018,09/04/2018,0.00,,12.88,,"-276,642.45"
,IN,AR,30311713,1005,100,,Invoice,,,,,,09/04/2018,09/04/2018,0.00,,21.06,,"-276,663.51"
,IN,AR,30311717,1005,100,,Invoice,,,,,,09/04/2018,09/04/2018,0.00,,10.93,,"-276,674.44"
,IN,AR,30311720,1005,100,,Invoice,,,,,,09/04/2018,09/04/2018,0.00,,6.36,,"-276,680.80"
,IN,AR,30311722,1005,100,,Invoice,,,,,,09/04/2018,09/04/2018,0.00,,7.29,,"-276,688.09"
,IN,AR,30311725,1005,100,,Invoice,,,,,,09/04/2018,09/04/2018,0.00,,6.02,,"-276,694.11"
,IN,AR,30311740,1005,100,,Invoice,,,,,,09/04/2018,09/04/2018,0.00,,4.24,,"-276,698.35"
,IN,AR,30311771,1005,100,,Invoice,,,,,,09/04/2018,09/04/2018,0.00,,17.80,,"-276,716.15"
,IN,AR,30311857,1005,100,,Invoice,,,,,,09/04/2018,09/04/2018,0.00,,25.42,,"-276,741.57"
,IN,AR,30311889,1005,100,,Invoice,,,,,,09/04/2018,09/04/2018,0.00,,3.64,,"-276,745.21"
,IN,AR,30311903,1005,100,,Invoice,,,,,,09/04/2018,09/04/2018,0.00,,3.64,,"-276,748.85"
,IN,AR,30311915,1005,100,,Invoice,,,,,,09/04/2018,09/04/2018,0.00,,10.93,,"-276,759.78"
,IN,AR,30311940,1005,100,,Invoice,,,,,,09/04/2018,09/04/2018,0.00,,11.02,,"-276,770.80"
,IN,AR,30311944,1005,100,,Invoice,,,,,,09/04/2018,09/04/2018,0.00,,7.29,,"-276,778.09"
,IN,AR,30311949,1005,100,,Invoice,,,,,,09/04/2018,09/04/2018,0.00,,10.93,,"-276,789.02"
,IN,AR,30311952,1005,100,,Invoice,,,,,,09/04/2018,09/04/2018,0.00,,3.64,,"-276,792.66"
,IN,AR,30311961,1005,100,,Invoice,,,,,,09/04/2018,09/04/2018,0.00,,6.89,,"-276,799.55"
,IN,AR,30311967,1005,100,,Invoice,,,,,,09/04/2018,09/04/2018,0.00,,16.83,,"-276,816.38"
,IN,AR,30311975,1005,100,,Invoice,,,,,,09/04/2018,09/04/2018,0.00,,10.51,,"-276,826.89"
,IN,AR,30311977,1005,100,,Invoice,,,,,,09/04/2018,09/04/2018,0.00,,2.54,,"-276,829.43"
,IN,AR,30311980,1005,100,,Invoice,,,,,,09/04/2018,09/04/2018,0.00,,7.29,,"-276,836.72"
,IN,AR,30312056,1005,100,,Invoice,,,,,,09/04/2018,09/04/2018,0.00,,58.00,,"-276,894.72"
,IN,AR,30312093,1005,100,,Invoice,,,,,,09/04/2018,09/04/2018,0.00,,14.58,,"-276,909.30"
,IN,AR,30312102,1005,100,,Invoice,,,,,,09/04/2018,09/04/2018,0.00,,5.17,,"-276,914.47"
,IN,AR,30312119,1005,100,,Invoice,,,,,,09/04/2018,09/04/2018,0.00,,29.55,,"-276,944.02"
,IN,AR,30312127,1005,100,,Invoice,,,,,,09/04/2018,09/04/2018,0.00,,4.49,,"-276,948.51"
,IN,AR,30312189,1005,100,,Invoice,,,,,,09/04/2018,09/04/2018,0.00,,40.08,,"-276,988.59"
,IN,AR,30312196,1005,100,,Invoice,,,,,,09/04/2018,09/04/2018,0.00,,7.05,,"-276,995.64"
,IN,AR,30312213,1005,100,,Invoice,,,,,,09/04/2018,09/04/2018,0.00,,7.29,,"-277,002.93"
,IN,AR,30312286,1005,100,,Invoice,,,,,,09/04/2018,09/04/2018,0.00,,2.14,,"-277,005.07"
,IN,AR,30312372,1005,100,,Invoice,,,,,,09/04/2018,09/04/2018,0.00,,14.58,,"-277,019.65"
,IN,AR,30312383,1005,100,,Invoice,,,,,,09/04/2018,09/04/2018,0.00,,20.04,,"-277,039.69"
,IN,AR,30312388,1005,100,,Invoice,,,,,,09/04/2018,09/04/2018,0.00,,7.29,,"-277,046.98"
,IN,AR,30312407,1005,100,,Invoice,,,,,,09/04/2018,09/04/2018,0.00,,30.36,,"-277,077.34"
,IN,AR,30312436,1005,100,,Invoice,,,,,,09/04/2018,09/04/2018,0.00,,6.42,,"-277,083.76"
,IN,AR,30312475,1005,100,,Invoice,,,,,,09/04/2018,09/04/2018,0.00,,36.78,,"-277,120.54"
,IN,AR,30312532,1005,100,,Invoice,,,,,,09/04/2018,09/04/2018,0.00,,10.00,,"-277,130.54"
,IN,AR,30312537,1005,100,,Invoice,,,,,,09/04/2018,09/04/2018,0.00,,12.00,,"-277,142.54"
,IN,AR,30312581,1005,100,,Invoice,,,,,,09/04/2018,09/04/2018,0.00,,45.25,,"-277,187.79"
,IN,AR,30312617,1005,100,,Invoice,,,,,,09/04/2018,09/04/2018,0.00,,32.07,,"-277,219.86"
,IN,AR,30312625,1005,100,,Invoice,,,,,,09/04/2018,09/04/2018,0.00,,38.65,,"-277,258.51"
,IN,AR,30312629,1005,100,,Invoice,,,,,,09/04/2018,09/04/2018,0.00,,181.78,,"-277,440.29"
,IN,AR,30312667,1005,100,,Invoice,,,,,,09/04/2018,09/04/2018,0.00,,9.64,,"-277,449.93"
,IN,AR,30312671,1005,100,,Invoice,,,,,,09/04/2018,09/04/2018,0.00,,116.00,,"-277,565.93"
,IN,AR,30312681,1005,100,,Invoice,,,,,,09/04/2018,09/04/2018,0.00,,6.13,,"-277,572.06"
,IN,AR,30312727,1005,100,,Invoice,,,,,,09/04/2018,09/04/2018,0.00,,26.69,,"-277,598.75"
,IN,AR,30312799,1005,100,,Invoice,,,,,,09/04/2018,09/04/2018,0.00,,54.66,,"-277,653.41"
,IN,AR,30312802,1005,100,,Invoice,,,,,,09/04/2018,09/04/2018,0.00,,8.00,,"-277,661.41"
,IN,AR,30312809,1005,100,,Invoice,,,,,,09/04/2018,09/04/2018,0.00,,1.88,,"-277,663.29"
,IN,AR,30312821,1005,100,,Invoice,,,,,,09/04/2018,09/04/2018,0.00,,16.53,,"-277,679.82"
,IN,AR,30312840,1005,100,,Invoice,,,,,,09/04/2018,09/04/2018,0.00,,29.15,,"-277,708.97"
,IN,AR,30312879,1005,100,,Invoice,,,,,,09/04/2018,09/04/2018,0.00,,29.15,,"-277,738.12"
,IN,AR,30312918,1005,100,,Invoice,,,,,,09/04/2018,09/04/2018,0.00,,8.77,,"-277,746.89"
,IN,AR,30312935,1005,100,,Invoice,,,,,,09/04/2018,09/04/2018,0.00,,6.13,,"-277,753.02"
,IN,AR,30312943,1005,100,,Invoice,,,,,,09/04/2018,09/04/2018,0.00,,12.25,,"-277,765.27"
,IN,AR,30312968,1005,100,,Invoice,,,,,,09/04/2018,09/04/2018,0.00,,54.66,,"-277,819.93"
,IN,AR,30313032,1005,100,,Invoice,,,,,,09/04/2018,09/04/2018,0.00,,12.46,,"-277,832.39"
,IN,AR,30313066,1005,100,,Invoice,,,,,,09/04/2018,09/04/2018,0.00,,5.08,,"-277,837.47"
,IN,AR,30313069,1005,100,,Invoice,,,,,,09/04/2018,09/04/2018,0.00,,10.17,,"-277,847.64"
,IN,AR,30313085,1005,100,,Invoice,,,,,,09/04/2018,09/04/2018,0.00,,9.11,,"-277,856.75"
,IN,AR,30313089,1005,100,,Invoice,,,,,,09/04/2018,09/04/2018,0.00,,54.66,,"-277,911.41"
,CS,AR,32002631,1005,100,,Cash sale,,,,,,10/04/2018,10/04/2018,0.00,,3.64,,"-277,915.05"
,CS,AR,32002649,1005,100,,Cash sale,,,,,,10/04/2018,10/04/2018,0.00,,7.29,,"-277,922.34"
,CS,AR,32002653,1005,100,,Cash sale,,,,,,10/04/2018,10/04/2018,0.00,,14.58,,"-277,936.92"
,CS,AR,32002689,1005,100,,Cash sale,,,,,,10/04/2018,10/04/2018,0.00,,3.01,,"-277,939.93"
,CS,AR,32002725,1005,100,,Cash sale,,,,,,10/04/2018,10/04/2018,0.00,,3.64,,"-277,943.57"
,CS,AR,32002753,1005,100,,Cash sale,,,,,,10/04/2018,10/04/2018,0.00,,14.58,,"-277,958.15"
,CS,AR,32002762,1005,100,,Cash sale,,,,,,10/04/2018,10/04/2018,0.00,,7.29,,"-277,965.44"
,CS,AR,32002791,1005,100,,Cash sale,,,,,,10/04/2018,10/04/2018,0.00,,10.17,,"-277,975.61"
,CS,AR,32002800,1005,100,,Cash sale,,,,,,10/04/2018,10/04/2018,0.00,,4.78,,"-277,980.39"
,CS,AR,32002805,1005,100,,Cash sale,,,,,,10/04/2018,10/04/2018,0.00,,10.93,,"-277,991.32"
,CS,AR,32002836,1005,100,,Cash sale,,,,,,10/04/2018,10/04/2018,0.00,,5.17,,"-277,996.49"
,CS,AR,32002846,1005,100,,Cash sale,,,,,,10/04/2018,10/04/2018,0.00,,3.64,,"-278,000.13"
,CS,AR,32002861,1005,100,,Cash sale,,,,,,10/04/2018,10/04/2018,0.00,,5.17,,"-278,005.30"
,CS,AR,32002897,1005,100,,Cash sale,,,,,,10/04/2018,10/04/2018,0.00,,10.72,,"-278,016.02"
,CS,AR,32002901,1005,100,,Cash sale,,,,,,10/04/2018,10/04/2018,0.00,,3.64,,"-278,019.66"
,CS,AR,32002931,1005,100,,Cash sale,,,,,,10/04/2018,10/04/2018,0.00,,4.32,,"-278,023.98"
,CS,AR,32002932,1005,100,,Cash sale,,,,,,10/04/2018,10/04/2018,0.00,,5.85,,"-278,029.83"
,CS,AR,32002943,1005,100,,Cash sale,,,,,,10/04/2018,10/04/2018,0.00,,18.22,,"-278,048.05"
,CS,AR,32002951,1005,100,,Cash sale,,,,,,10/04/2018,10/04/2018,0.00,,3.90,,"-278,051.95"
,CS,AR,32002977,1005,100,,Cash sale,,,,,,10/04/2018,10/04/2018,0.00,,7.75,,"-278,059.70"
,CS,AR,32003002,1005,100,,Cash sale,,,,,,10/04/2018,10/04/2018,0.00,,5.85,,"-278,065.55"
,CS,AR,32003061,1005,100,,Cash sale,,,,,,10/04/2018,10/04/2018,0.00,,5.59,,"-278,071.14"
,CS,AR,32003076,1005,100,,Cash sale,,,,,,10/04/2018,10/04/2018,0.00,,2.58,,"-278,073.72"
,CS,AR,32003101,1005,100,,Cash sale,,,,,,10/04/2018,10/04/2018,0.00,,8.58,,"-278,082.30"
,CS,AR,32003106,1005,100,,Cash sale,,,,,,10/04/2018,10/04/2018,0.00,,14.58,,"-278,096.88"
,CS,AR,32003168,1005,100,,Cash sale,,,,,,10/04/2018,10/04/2018,0.00,,7.29,,"-278,104.17"
,CS,AR,32003181,1005,100,,Cash sale,,,,,,10/04/2018,10/04/2018,0.00,,24.00,,"-278,128.17"
,CS,AR,32003195,1005,100,,Cash sale,,,,,,10/04/2018,10/04/2018,0.00,,3.64,,"-278,131.81"
,CS,AR,32003216,1005,100,,Cash sale,,,,,,10/04/2018,10/04/2018,0.00,,5.47,,"-278,137.28"
,CS,AR,32003220,1005,100,,Cash sale,,,,,,10/04/2018,10/04/2018,0.00,,6.56,,"-278,143.84"
,CS,AR,32003246,1005,100,,Cash sale,,,,,,10/04/2018,10/04/2018,0.00,,14.83,,"-278,158.67"
,CS,AR,32003264,1005,100,,Cash sale,,,,,,10/04/2018,10/04/2018,0.00,,8.25,,"-278,166.92"
,CS,AR,32003287,1005,100,,Cash sale,,,,,,10/04/2018,10/04/2018,0.00,,14.58,,"-278,181.50"
,CS,AR,32003329,1005,100,,Cash sale,,,,,,10/04/2018,10/04/2018,0.00,,3.64,,"-278,185.14"
,CS,AR,32003340,1005,100,,Cash sale,,,,,,10/04/2018,10/04/2018,0.00,,3.64,,"-278,188.78"
,CS,AR,32003363,1005,100,,Cash sale,,,,,,10/04/2018,10/04/2018,0.00,,13.69,,"-278,202.47"
,CS,AR,32003369,1005,100,,Cash sale,,,,,,10/04/2018,10/04/2018,0.00,,14.58,,"-278,217.05"
,CS,AR,32003378,1005,100,,Cash sale,,,,,,10/04/2018,10/04/2018,0.00,,6.56,,"-278,223.61"
,CS,AR,32003414,1005,100,,Cash sale,,,,,,10/04/2018,10/04/2018,0.00,,3.64,,"-278,227.25"
,IN,AR,30311090,1005,100,,Invoice,,,,,,10/04/2018,10/04/2018,0.00,,77.12,,"-278,304.37"
,IN,AR,30311122,1005,100,,Invoice,,,,,,10/04/2018,10/04/2018,0.00,,10.93,,"-278,315.30"
,IN,AR,30311135,1005,100,,Invoice,,,,,,10/04/2018,10/04/2018,0.00,,14.58,,"-278,329.88"
,IN,AR,30311176,1005,100,,Invoice,,,,,,10/04/2018,10/04/2018,0.00,,7.00,,"-278,336.88"
,IN,AR,30311220,1005,100,,Invoice,,,,,,10/04/2018,10/04/2018,0.00,,7.97,,"-278,344.85"
,IN,AR,30311233,1005,100,,Invoice,,,,,,10/04/2018,10/04/2018,0.00,,99.66,,"-278,444.51"
,IN,AR,30311274,1005,100,,Invoice,,,,,,10/04/2018,10/04/2018,0.00,,18.22,,"-278,462.73"
,IN,AR,30311328,1005,100,,Invoice,,,,,,10/04/2018,10/04/2018,0.00,,7.29,,"-278,470.02"
,IN,AR,30311342,1005,100,,Invoice,,,,,,10/04/2018,10/04/2018,0.00,,3.64,,"-278,473.66"
,IN,AR,30311382,1005,100,,Invoice,,,,,,10/04/2018,10/04/2018,0.00,,10.93,,"-278,484.59"
,IN,AR,30311387,1005,100,,Invoice,,,,,,10/04/2018,10/04/2018,0.00,,51.02,,"-278,535.61"
,IN,AR,30311441,1005,100,,Invoice,,,,,,10/04/2018,10/04/2018,0.00,,10.99,,"-278,546.60"
,IN,AR,30311478,1005,100,,Invoice,,,,,,10/04/2018,10/04/2018,0.00,,3.64,,"-278,550.24"
,IN,AR,30311503,1005,100,,Invoice,,,,,,10/04/2018,10/04/2018,0.00,,7.29,,"-278,557.53"
,IN,AR,30311523,1005,100,,Invoice,,,,,,10/04/2018,10/04/2018,0.00,,6.97,,"-278,564.50"
,IN,AR,30311531,1005,100,,Invoice,,,,,,10/04/2018,10/04/2018,0.00,,7.19,,"-278,571.69"
,IN,AR,30311553,1005,100,,Invoice,,,,,,10/04/2018,10/04/2018,0.00,,6.36,,"-278,578.05"
,IN,AR,30311565,1005,100,,Invoice,,,,,,10/04/2018,10/04/2018,0.00,,48.81,,"-278,626.86"
,IN,AR,30311566,1005,100,,Invoice,,,,,,10/04/2018,10/04/2018,0.00,,18.31,,"-278,645.17"
,IN,AR,30311567,1005,100,,Invoice,,,,,,10/04/2018,10/04/2018,0.00,,8.14,,"-278,653.31"
,IN,AR,30311575,1005,100,,Invoice,,,,,,10/04/2018,10/04/2018,0.00,,8.47,,"-278,661.78"
,IN,AR,30311578,1005,100,,Invoice,,,,,,10/04/2018,10/04/2018,0.00,,6.36,,"-278,668.14"
,IN,AR,30311631,1005,100,,Invoice,,,,,,10/04/2018,10/04/2018,0.00,,15.04,,"-278,683.18"
,IN,AR,30311642,1005,100,,Invoice,,,,,,10/04/2018,10/04/2018,0.00,,5.85,,"-278,689.03"
,IN,AR,30311733,1005,100,,Invoice,,,,,,10/04/2018,10/04/2018,0.00,,44.28,,"-278,733.31"
,IN,AR,30311743,1005,100,,Invoice,,,,,,10/04/2018,10/04/2018,0.00,,36.76,,"-278,770.07"
,IN,AR,30311818,1005,100,,Invoice,,,,,,10/04/2018,10/04/2018,0.00,,20.34,,"-278,790.41"
,IN,AR,30311829,1005,100,,Invoice,,,,,,10/04/2018,10/04/2018,0.00,,3.64,,"-278,794.05"
,IN,AR,30311837,1005,100,,Invoice,,,,,,10/04/2018,10/04/2018,0.00,,7.29,,"-278,801.34"
,IN,AR,30311863,1005,100,,Invoice,,,,,,10/04/2018,10/04/2018,0.00,,17.56,,"-278,818.90"
,IN,AR,30311882,1005,100,,Invoice,,,,,,10/04/2018,10/04/2018,0.00,,14.87,,"-278,833.77"
,IN,AR,30311886,1005,100,,Invoice,,,,,,10/04/2018,10/04/2018,0.00,,4.78,,"-278,838.55"
,IN,AR,30311893,1005,100,,Invoice,,,,,,10/04/2018,10/04/2018,0.00,,17.80,,"-278,856.35"
,IN,AR,30311900,1005,100,,Invoice,,,,,,10/04/2018,10/04/2018,0.00,,10.53,,"-278,866.88"
,IN,AR,30311924,1005,100,,Invoice,,,,,,10/04/2018,10/04/2018,0.00,,8.47,,"-278,875.35"
,IN,AR,30311987,1005,100,,Invoice,,,,,,10/04/2018,10/04/2018,0.00,,14.83,,"-278,890.18"
,IN,AR,30312011,1005,100,,Invoice,,,,,,10/04/2018,10/04/2018,0.00,,10.93,,"-278,901.11"
,IN,AR,30312031,1005,100,,Invoice,,,,,,10/04/2018,10/04/2018,0.00,,7.29,,"-278,908.40"
,IN,AR,30312052,1005,100,,Invoice,,,,,,10/04/2018,10/04/2018,0.00,,54.66,,"-278,963.06"
,IN,AR,30312060,1005,100,,Invoice,,,,,,10/04/2018,10/04/2018,0.00,,21.05,,"-278,984.11"
,IN,AR,30312088,1005,100,,Invoice,,,,,,10/04/2018,10/04/2018,0.00,,8.26,,"-278,992.37"
,IN,AR,30312184,1005,100,,Invoice,,,,,,10/04/2018,10/04/2018,0.00,,36.45,,"-279,028.82"
,IN,AR,30312197,1005,100,,Invoice,,,,,,10/04/2018,10/04/2018,0.00,,8.81,,"-279,037.63"
,IN,AR,30312223,1005,100,,Invoice,,,,,,10/04/2018,10/04/2018,0.00,,10.68,,"-279,048.31"
,IN,AR,30312233,1005,100,,Invoice,,,,,,10/04/2018,10/04/2018,0.00,,5.17,,"-279,053.48"
,IN,AR,30312235,1005,100,,Invoice,,,,,,10/04/2018,10/04/2018,0.00,,105.93,,"-279,159.41"
,IN,AR,30312240,1005,100,,Invoice,,,,,,10/04/2018,10/04/2018,0.00,,21.90,,"-279,181.31"
,IN,AR,30312299,1005,100,,Invoice,,,,,,10/04/2018,10/04/2018,0.00,,5.17,,"-279,186.48"
,IN,AR,30312338,1005,100,,Invoice,,,,,,10/04/2018,10/04/2018,0.00,,22.26,,"-279,208.74"
,IN,AR,30312339,1005,100,,Invoice,,,,,,10/04/2018,10/04/2018,0.00,,4.77,,"-279,213.51"
,IN,AR,30312340,1005,100,,Invoice,,,,,,10/04/2018,10/04/2018,0.00,,7.95,,"-279,221.46"
,IN,AR,30312341,1005,100,,Invoice,,,,,,10/04/2018,10/04/2018,0.00,,213.06,,"-279,434.52"
,IN,AR,30312356,1005,100,,Invoice,,,,,,10/04/2018,10/04/2018,0.00,,45.42,,"-279,479.94"
,IN,AR,30312417,1005,100,,Invoice,,,,,,10/04/2018,10/04/2018,0.00,,181.11,,"-279,661.05"
,IN,AR,30312437,1005,100,,Invoice,,,,,,10/04/2018,10/04/2018,0.00,,8.02,,"-279,669.07"
,IN,AR,30312522,1005,100,,Invoice,,,,,,10/04/2018,10/04/2018,0.00,,17.80,,"-279,686.87"
,IN,AR,30312543,1005,100,,Invoice,,,,,,10/04/2018,10/04/2018,0.00,,16.01,,"-279,702.88"
,IN,AR,30312635,1005,100,,Invoice,,,,,,10/04/2018,10/04/2018,0.00,,8.21,,"-279,711.09"
,IN,AR,30312676,1005,100,,Invoice,,,,,,10/04/2018,10/04/2018,0.00,,18.20,,"-279,729.29"
,IN,AR,30312689,1005,100,,Invoice,,,,,,10/04/2018,10/04/2018,0.00,,33.22,,"-279,762.51"
,IN,AR,30312696,1005,100,,Invoice,,,,,,10/04/2018,10/04/2018,0.00,,7.29,,"-279,769.80"
,IN,AR,30312766,1005,100,,Invoice,,,,,,10/04/2018,10/04/2018,0.00,,89.49,,"-279,859.29"
,IN,AR,30312775,1005,100,,Invoice,,,,,,10/04/2018,10/04/2018,0.00,,21.36,,"-279,880.65"
,IN,AR,30312818,1005,100,,Invoice,,,,,,10/04/2018,10/04/2018,0.00,,1.75,,"-279,882.40"
,IN,AR,30312824,1005,100,,Invoice,,,,,,10/04/2018,10/04/2018,0.00,,10.00,,"-279,892.40"
,IN,AR,30312835,1005,100,,Invoice,,,,,,10/04/2018,10/04/2018,0.00,,114.97,,"-280,007.37"
,IN,AR,30312857,1005,100,,Invoice,,,,,,10/04/2018,10/04/2018,0.00,,7.02,,"-280,014.39"
,IN,AR,30312861,1005,100,,Invoice,,,,,,10/04/2018,10/04/2018,0.00,,11.66,,"-280,026.05"
,IN,AR,30312895,1005,100,,Invoice,,,,,,10/04/2018,10/04/2018,0.00,,15.17,,"-280,041.22"
,IN,AR,30312896,1005,100,,Invoice,,,,,,10/04/2018,10/04/2018,0.00,,12.14,,"-280,053.36"
,IN,AR,30312969,1005,100,,Invoice,,,,,,10/04/2018,10/04/2018,0.00,,10.93,,"-280,064.29"
,IN,AR,30313003,1005,100,,Invoice,,,,,,10/04/2018,10/04/2018,0.00,,7.29,,"-280,071.58"
,IN,AR,30313071,1005,100,,Invoice,,,,,,10/04/2018,10/04/2018,0.00,,24.15,,"-280,095.73"
,IN,AR,30313092,1005,100,,Invoice,,,,,,10/04/2018,10/04/2018,0.00,,419.07,,"-280,514.80"
,CN,AR,31017730,1005,100,,Credit Note,,,,,,11/04/2018,11/04/2018,18.31,,0.00,,"-280,496.49"
,CN,AR,31017731,1005,100,,Credit Note,,,,,,11/04/2018,11/04/2018,8.14,,0.00,,"-280,488.35"
,CS,AR,32002600,1005,100,,Cash sale,,,,,,11/04/2018,11/04/2018,0.00,,5.61,,"-280,493.96"
,CS,AR,32002609,1005,100,,Cash sale,,,,,,11/04/2018,11/04/2018,0.00,,3.64,,"-280,497.60"
,CS,AR,32002611,1005,100,,Cash sale,,,,,,11/04/2018,11/04/2018,0.00,,50.17,,"-280,547.77"
,CS,AR,32002639,1005,100,,Cash sale,,,,,,11/04/2018,11/04/2018,0.00,,7.29,,"-280,555.06"
,CS,AR,32002654,1005,100,,Cash sale,,,,,,11/04/2018,11/04/2018,0.00,,3.64,,"-280,558.70"
,CS,AR,32002663,1005,100,,Cash sale,,,,,,11/04/2018,11/04/2018,0.00,,7.29,,"-280,565.99"
,CS,AR,32002729,1005,100,,Cash sale,,,,,,11/04/2018,11/04/2018,0.00,,6.02,,"-280,572.01"
,CS,AR,32002741,1005,100,,Cash sale,,,,,,11/04/2018,11/04/2018,0.00,,3.64,,"-280,575.65"
,CS,AR,32002746,1005,100,,Cash sale,,,,,,11/04/2018,11/04/2018,0.00,,10.93,,"-280,586.58"
,CS,AR,32002771,1005,100,,Cash sale,,,,,,11/04/2018,11/04/2018,0.00,,5.86,,"-280,592.44"
,CS,AR,32002778,1005,100,,Cash sale,,,,,,11/04/2018,11/04/2018,0.00,,7.29,,"-280,599.73"
,CS,AR,32002812,1005,100,,Cash sale,,,,,,11/04/2018,11/04/2018,0.00,,14.58,,"-280,614.31"
,CS,AR,32002855,1005,100,,Cash sale,,,,,,11/04/2018,11/04/2018,0.00,,7.29,,"-280,621.60"
,CS,AR,32002859,1005,100,,Cash sale,,,,,,11/04/2018,11/04/2018,0.00,,3.64,,"-280,625.24"
,CS,AR,32002871,1005,100,,Cash sale,,,,,,11/04/2018,11/04/2018,0.00,,15.04,,"-280,640.28"
,CS,AR,32002875,1005,100,,Cash sale,,,,,,11/04/2018,11/04/2018,0.00,,6.43,,"-280,646.71"
,CS,AR,32002882,1005,100,,Cash sale,,,,,,11/04/2018,11/04/2018,0.00,,7.29,,"-280,654.00"
,CS,AR,32002892,1005,100,,Cash sale,,,,,,11/04/2018,11/04/2018,0.00,,10.93,,"-280,664.93"
,CS,AR,32002909,1005,100,,Cash sale,,,,,,11/04/2018,11/04/2018,0.00,,5.08,,"-280,670.01"
,CS,AR,32002912,1005,100,,Cash sale,,,,,,11/04/2018,11/04/2018,0.00,,7.63,,"-280,677.64"
,CS,AR,32002958,1005,100,,Cash sale,,,,,,11/04/2018,11/04/2018,0.00,,3.64,,"-280,681.28"
,CS,AR,32002959,1005,100,,Cash sale,,,,,,11/04/2018,11/04/2018,0.00,,10.93,,"-280,692.21"
,CS,AR,32003007,1005,100,,Cash sale,,,,,,11/04/2018,11/04/2018,0.00,,7.29,,"-280,699.50"
,CS,AR,32003029,1005,100,,Cash sale,,,,,,11/04/2018,11/04/2018,0.00,,14.58,,"-280,714.08"
,CS,AR,32003067,1005,100,,Cash sale,,,,,,11/04/2018,11/04/2018,0.00,,7.29,,"-280,721.37"
,CS,AR,32003099,1005,100,,Cash sale,,,,,,11/04/2018,11/04/2018,0.00,,10.93,,"-280,732.30"
,CS,AR,32003110,1005,100,,Cash sale,,,,,,11/04/2018,11/04/2018,0.00,,7.29,,"-280,739.59"
,CS,AR,32003121,1005,100,,Cash sale,,,,,,11/04/2018,11/04/2018,0.00,,18.98,,"-280,758.57"
,CS,AR,32003123,1005,100,,Cash sale,,,,,,11/04/2018,11/04/2018,0.00,,10.93,,"-280,769.50"
,CS,AR,32003152,1005,100,,Cash sale,,,,,,11/04/2018,11/04/2018,0.00,,6.53,,"-280,776.03"
,CS,AR,32003172,1005,100,,Cash sale,,,,,,11/04/2018,11/04/2018,0.00,,7.29,,"-280,783.32"
,CS,AR,32003193,1005,100,,Cash sale,,,,,,11/04/2018,11/04/2018,0.00,,7.29,,"-280,790.61"
,CS,AR,32003225,1005,100,,Cash sale,,,,,,11/04/2018,11/04/2018,0.00,,7.29,,"-280,797.90"
,CS,AR,32003230,1005,100,,Cash sale,,,,,,11/04/2018,11/04/2018,0.00,,11.44,,"-280,809.34"
,CS,AR,32003243,1005,100,,Cash sale,,,,,,11/04/2018,11/04/2018,0.00,,9.10,,"-280,818.44"
,CS,AR,32003251,1005,100,,Cash sale,,,,,,11/04/2018,11/04/2018,0.00,,10.93,,"-280,829.37"
,CS,AR,32003262,1005,100,,Cash sale,,,,,,11/04/2018,11/04/2018,0.00,,7.29,,"-280,836.66"
,CS,AR,32003267,1005,100,,Cash sale,,,,,,11/04/2018,11/04/2018,0.00,,6.86,,"-280,843.52"
,CS,AR,32003276,1005,100,,Cash sale,,,,,,11/04/2018,11/04/2018,0.00,,9.03,,"-280,852.55"
,CS,AR,32003279,1005,100,,Cash sale,,,,,,11/04/2018,11/04/2018,0.00,,7.29,,"-280,859.84"
,CS,AR,32003291,1005,100,,Cash sale,,,,,,11/04/2018,11/04/2018,0.00,,7.29,,"-280,867.13"
,CS,AR,32003301,1005,100,,Cash sale,,,,,,11/04/2018,11/04/2018,0.00,,10.93,,"-280,878.06"
,CS,AR,32003322,1005,100,,Cash sale,,,,,,11/04/2018,11/04/2018,0.00,,9.10,,"-280,887.16"
,CS,AR,32003356,1005,100,,Cash sale,,,,,,11/04/2018,11/04/2018,0.00,,9.84,,"-280,897.00"
,CS,AR,32003382,1005,100,,Cash sale,,,,,,11/04/2018,11/04/2018,0.00,,10.99,,"-280,907.99"
,IN,AR,30311113,1005,100,,Invoice,,,,,,11/04/2018,11/04/2018,0.00,,28.47,,"-280,936.46"
,IN,AR,30311117,1005,100,,Invoice,,,,,,11/04/2018,11/04/2018,0.00,,364.41,,"-281,300.87"
,IN,AR,30311123,1005,100,,Invoice,,,,,,11/04/2018,11/04/2018,0.00,,43.73,,"-281,344.60"
,IN,AR,30311129,1005,100,,Invoice,,,,,,11/04/2018,11/04/2018,0.00,,73.22,,"-281,417.82"
,IN,AR,30311130,1005,100,,Invoice,,,,,,11/04/2018,11/04/2018,0.00,,19.53,,"-281,437.35"
,IN,AR,30311136,1005,100,,Invoice,,,,,,11/04/2018,11/04/2018,0.00,,419.07,,"-281,856.42"
,IN,AR,30311146,1005,100,,Invoice,,,,,,11/04/2018,11/04/2018,0.00,,11.36,,"-281,867.78"
,IN,AR,30311157,1005,100,,Invoice,,,,,,11/04/2018,11/04/2018,0.00,,23.64,,"-281,891.42"
,IN,AR,30311158,1005,100,,Invoice,,,,,,11/04/2018,11/04/2018,0.00,,78.81,,"-281,970.23"
,IN,AR,30311234,1005,100,,Invoice,,,,,,11/04/2018,11/04/2018,0.00,,23.73,,"-281,993.96"
,IN,AR,30311262,1005,100,,Invoice,,,,,,11/04/2018,11/04/2018,0.00,,38.00,,"-282,031.96"
,IN,AR,30311269,1005,100,,Invoice,,,,,,11/04/2018,11/04/2018,0.00,,14.58,,"-282,046.54"
,IN,AR,30311271,1005,100,,Invoice,,,,,,11/04/2018,11/04/2018,0.00,,364.41,,"-282,410.95"
,IN,AR,30311295,1005,100,,Invoice,,,,,,11/04/2018,11/04/2018,0.00,,7.29,,"-282,418.24"
,IN,AR,30311311,1005,100,,Invoice,,,,,,11/04/2018,11/04/2018,0.00,,24.00,,"-282,442.24"
,IN,AR,30311358,1005,100,,Invoice,,,,,,11/04/2018,11/04/2018,0.00,,26.00,,"-282,468.24"
,IN,AR,30311365,1005,100,,Invoice,,,,,,11/04/2018,11/04/2018,0.00,,66.44,,"-282,534.68"
,IN,AR,30311398,1005,100,,Invoice,,,,,,11/04/2018,11/04/2018,0.00,,364.41,,"-282,899.09"
,IN,AR,30311404,1005,100,,Invoice,,,,,,11/04/2018,11/04/2018,0.00,,106.42,,"-283,005.51"
,IN,AR,30311405,1005,100,,Invoice,,,,,,11/04/2018,11/04/2018,0.00,,21.83,,"-283,027.34"
,IN,AR,30311406,1005,100,,Invoice,,,,,,11/04/2018,11/04/2018,0.00,,49.12,,"-283,076.46"
,IN,AR,30311446,1005,100,,Invoice,,,,,,11/04/2018,11/04/2018,0.00,,6.02,,"-283,082.48"
,IN,AR,30311470,1005,100,,Invoice,,,,,,11/04/2018,11/04/2018,0.00,,23.87,,"-283,106.35"
,IN,AR,30311482,1005,100,,Invoice,,,,,,11/04/2018,11/04/2018,0.00,,10.93,,"-283,117.28"
,IN,AR,30311516,1005,100,,Invoice,,,,,,11/04/2018,11/04/2018,0.00,,10.34,,"-283,127.62"
,IN,AR,30311521,1005,100,,Invoice,,,,,,11/04/2018,11/04/2018,0.00,,182.20,,"-283,309.82"
,IN,AR,30311536,1005,100,,Invoice,,,,,,11/04/2018,11/04/2018,0.00,,18.37,,"-283,328.19"
,IN,AR,30311546,1005,100,,Invoice,,,,,,11/04/2018,11/04/2018,0.00,,15.25,,"-283,343.44"
,IN,AR,30311557,1005,100,,Invoice,,,,,,11/04/2018,11/04/2018,0.00,,4.24,,"-283,347.68"
,IN,AR,30311572,1005,100,,Invoice,,,,,,11/04/2018,11/04/2018,0.00,,6.36,,"-283,354.04"
,IN,AR,30311604,1005,100,,Invoice,,,,,,11/04/2018,11/04/2018,0.00,,"1,093.22",,"-284,447.26"
,IN,AR,30311615,1005,100,,Invoice,,,,,,11/04/2018,11/04/2018,0.00,,16.73,,"-284,463.99"
,IN,AR,30311618,1005,100,,Invoice,,,,,,11/04/2018,11/04/2018,0.00,,"1,093.22",,"-285,557.21"
,IN,AR,30311622,1005,100,,Invoice,,,,,,11/04/2018,11/04/2018,0.00,,29.15,,"-285,586.36"
,IN,AR,30311637,1005,100,,Invoice,,,,,,11/04/2018,11/04/2018,0.00,,7.17,,"-285,593.53"
,IN,AR,30311652,1005,100,,Invoice,,,,,,11/04/2018,11/04/2018,0.00,,55.37,,"-285,648.90"
,IN,AR,30311667,1005,100,,Invoice,,,,,,11/04/2018,11/04/2018,0.00,,104.24,,"-285,753.14"
,IN,AR,30311668,1005,100,,Invoice,,,,,,11/04/2018,11/04/2018,0.00,,10.17,,"-285,763.31"
,IN,AR,30311737,1005,100,,Invoice,,,,,,11/04/2018,11/04/2018,0.00,,5.17,,"-285,768.48"
,IN,AR,30311746,1005,100,,Invoice,,,,,,11/04/2018,11/04/2018,0.00,,364.41,,"-286,132.89"
,IN,AR,30311751,1005,100,,Invoice,,,,,,11/04/2018,11/04/2018,0.00,,144.04,,"-286,276.93"
,IN,AR,30311815,1005,100,,Invoice,,,,,,11/04/2018,11/04/2018,0.00,,4.24,,"-286,281.17"
,IN,AR,30311847,1005,100,,Invoice,,,,,,11/04/2018,11/04/2018,0.00,,364.41,,"-286,645.58"
,IN,AR,30311850,1005,100,,Invoice,,,,,,11/04/2018,11/04/2018,0.00,,13.63,,"-286,659.21"
,IN,AR,30311867,1005,100,,Invoice,,,,,,11/04/2018,11/04/2018,0.00,,20.00,,"-286,679.21"
,IN,AR,30311872,1005,100,,Invoice,,,,,,11/04/2018,11/04/2018,0.00,,18.31,,"-286,697.52"
,IN,AR,30311873,1005,100,,Invoice,,,,,,11/04/2018,11/04/2018,0.00,,8.14,,"-286,705.66"
,IN,AR,30311888,1005,100,,Invoice,,,,,,11/04/2018,11/04/2018,0.00,,54.66,,"-286,760.32"
,IN,AR,30311894,1005,100,,Invoice,,,,,,11/04/2018,11/04/2018,0.00,,2.54,,"-286,762.86"
,IN,AR,30311948,1005,100,,Invoice,,,,,,11/04/2018,11/04/2018,0.00,,364.41,,"-287,127.27"
,IN,AR,30311951,1005,100,,Invoice,,,,,,11/04/2018,11/04/2018,0.00,,15.21,,"-287,142.48"
,IN,AR,30311968,1005,100,,Invoice,,,,,,11/04/2018,11/04/2018,0.00,,5.61,,"-287,148.09"
,IN,AR,30311988,1005,100,,Invoice,,,,,,11/04/2018,11/04/2018,0.00,,20.76,,"-287,168.85"
,IN,AR,30312001,1005,100,,Invoice,,,,,,11/04/2018,11/04/2018,0.00,,16.78,,"-287,185.63"
,IN,AR,30312009,1005,100,,Invoice,,,,,,11/04/2018,11/04/2018,0.00,,364.41,,"-287,550.04"
,IN,AR,30312022,1005,100,,Invoice,,,,,,11/04/2018,11/04/2018,0.00,,1.88,,"-287,551.92"
,IN,AR,30312025,1005,100,,Invoice,,,,,,11/04/2018,11/04/2018,0.00,,"1,093.22",,"-288,645.14"
,IN,AR,30312034,1005,100,,Invoice,,,,,,11/04/2018,11/04/2018,0.00,,10.93,,"-288,656.07"
,IN,AR,30312035,1005,100,,Invoice,,,,,,11/04/2018,11/04/2018,0.00,,7.29,,"-288,663.36"
,IN,AR,30312041,1005,100,,Invoice,,,,,,11/04/2018,11/04/2018,0.00,,22.37,,"-288,685.73"
,IN,AR,30312053,1005,100,,Invoice,,,,,,11/04/2018,11/04/2018,0.00,,182.20,,"-288,867.93"
,IN,AR,30312114,1005,100,,Invoice,,,,,,11/04/2018,11/04/2018,0.00,,35.26,,"-288,903.19"
,IN,AR,30312131,1005,100,,Invoice,,,,,,11/04/2018,11/04/2018,0.00,,24.07,,"-288,927.26"
,IN,AR,30312139,1005,100,,Invoice,,,,,,11/04/2018,11/04/2018,0.00,,18.05,,"-288,945.31"
,IN,AR,30312191,1005,100,,Invoice,,,,,,11/04/2018,11/04/2018,0.00,,182.20,,"-289,127.51"
,IN,AR,30312198,1005,100,,Invoice,,,,,,11/04/2018,11/04/2018,0.00,,1.76,,"-289,129.27"
,IN,AR,30312208,1005,100,,Invoice,,,,,,11/04/2018,11/04/2018,0.00,,6.02,,"-289,135.29"
,IN,AR,30312245,1005,100,,Invoice,,,,,,11/04/2018,11/04/2018,0.00,,29.15,,"-289,164.44"
,IN,AR,30312246,1005,100,,Invoice,,,,,,11/04/2018,11/04/2018,0.00,,15.51,,"-289,179.95"
,IN,AR,30312247,1005,100,,Invoice,,,,,,11/04/2018,11/04/2018,0.00,,12.92,,"-289,192.87"
,IN,AR,30312259,1005,100,,Invoice,,,,,,11/04/2018,11/04/2018,0.00,,54.66,,"-289,247.53"
,IN,AR,30312260,1005,100,,Invoice,,,,,,11/04/2018,11/04/2018,0.00,,54.66,,"-289,302.19"
,IN,AR,30312261,1005,100,,Invoice,,,,,,11/04/2018,11/04/2018,0.00,,364.41,,"-289,666.60"
,IN,AR,30312266,1005,100,,Invoice,,,,,,11/04/2018,11/04/2018,0.00,,12.00,,"-289,678.60"
,IN,AR,30312309,1005,100,,Invoice,,,,,,11/04/2018,11/04/2018,0.00,,7.29,,"-289,685.89"
,IN,AR,30312363,1005,100,,Invoice,,,,,,11/04/2018,11/04/2018,0.00,,28.00,,"-289,713.89"
,IN,AR,30312371,1005,100,,Invoice,,,,,,11/04/2018,11/04/2018,0.00,,7.29,,"-289,721.18"
,IN,AR,30312377,1005,100,,Invoice,,,,,,11/04/2018,11/04/2018,0.00,,72.15,,"-289,793.33"
,IN,AR,30312380,1005,100,,Invoice,,,,,,11/04/2018,11/04/2018,0.00,,11.36,,"-289,804.69"
,IN,AR,30312399,1005,100,,Invoice,,,,,,11/04/2018,11/04/2018,0.00,,3.64,,"-289,808.33"
,IN,AR,30312438,1005,100,,Invoice,,,,,,11/04/2018,11/04/2018,0.00,,16.03,,"-289,824.36"
,IN,AR,30312439,1005,100,,Invoice,,,,,,11/04/2018,11/04/2018,0.00,,16.03,,"-289,840.39"
,IN,AR,30312440,1005,100,,Invoice,,,,,,11/04/2018,11/04/2018,0.00,,3.20,,"-289,843.59"
,IN,AR,30312441,1005,100,,Invoice,,,,,,11/04/2018,11/04/2018,0.00,,4.81,,"-289,848.40"
,IN,AR,30312442,1005,100,,Invoice,,,,,,11/04/2018,11/04/2018,0.00,,4.81,,"-289,853.21"
,IN,AR,30312483,1005,100,,Invoice,,,,,,11/04/2018,11/04/2018,0.00,,14.58,,"-289,867.79"
,IN,AR,30312498,1005,100,,Invoice,,,,,,11/04/2018,11/04/2018,0.00,,36.22,,"-289,904.01"
,IN,AR,30312554,1005,100,,Invoice,,,,,,11/04/2018,11/04/2018,0.00,,20.01,,"-289,924.02"
,IN,AR,30312557,1005,100,,Invoice,,,,,,11/04/2018,11/04/2018,0.00,,54.66,,"-289,978.68"
,IN,AR,30312576,1005,100,,Invoice,,,,,,11/04/2018,11/04/2018,0.00,,34.07,,"-290,012.75"
,IN,AR,30312582,1005,100,,Invoice,,,,,,11/04/2018,11/04/2018,0.00,,6.03,,"-290,018.78"
,IN,AR,30312591,1005,100,,Invoice,,,,,,11/04/2018,11/04/2018,0.00,,2.92,,"-290,021.70"
,IN,AR,30312610,1005,100,,Invoice,,,,,,11/04/2018,11/04/2018,0.00,,19.92,,"-290,041.62"
,IN,AR,30312614,1005,100,,Invoice,,,,,,11/04/2018,11/04/2018,0.00,,14.58,,"-290,056.20"
,IN,AR,30312616,1005,100,,Invoice,,,,,,11/04/2018,11/04/2018,0.00,,6.99,,"-290,063.19"
,IN,AR,30312657,1005,100,,Invoice,,,,,,11/04/2018,11/04/2018,0.00,,54.66,,"-290,117.85"
,IN,AR,30312662,1005,100,,Invoice,,,,,,11/04/2018,11/04/2018,0.00,,364.41,,"-290,482.26"
,IN,AR,30312702,1005,100,,Invoice,,,,,,11/04/2018,11/04/2018,0.00,,54.66,,"-290,536.92"
,IN,AR,30312706,1005,100,,Invoice,,,,,,11/04/2018,11/04/2018,0.00,,14.58,,"-290,551.50"
,IN,AR,30312709,1005,100,,Invoice,,,,,,11/04/2018,11/04/2018,0.00,,7.29,,"-290,558.79"
,IN,AR,30312725,1005,100,,Invoice,,,,,,11/04/2018,11/04/2018,0.00,,17.49,,"-290,576.28"
,IN,AR,30312731,1005,100,,Invoice,,,,,,11/04/2018,11/04/2018,0.00,,81.15,,"-290,657.43"
,IN,AR,30312742,1005,100,,Invoice,,,,,,11/04/2018,11/04/2018,0.00,,6.37,,"-290,663.80"
,IN,AR,30312743,1005,100,,Invoice,,,,,,11/04/2018,11/04/2018,0.00,,22.31,,"-290,686.11"
,IN,AR,30312776,1005,100,,Invoice,,,,,,11/04/2018,11/04/2018,0.00,,23.73,,"-290,709.84"
,IN,AR,30312777,1005,100,,Invoice,,,,,,11/04/2018,11/04/2018,0.00,,99.67,,"-290,809.51"
,IN,AR,30312814,1005,100,,Invoice,,,,,,11/04/2018,11/04/2018,0.00,,5.26,,"-290,814.77"
,IN,AR,30312867,1005,100,,Invoice,,,,,,11/04/2018,11/04/2018,0.00,,54.66,,"-290,869.43"
,IN,AR,30312877,1005,100,,Invoice,,,,,,11/04/2018,11/04/2018,0.00,,29.15,,"-290,898.58"
,IN,AR,30312892,1005,100,,Invoice,,,,,,11/04/2018,11/04/2018,0.00,,7.53,,"-290,906.11"
,IN,AR,30312929,1005,100,,Invoice,,,,,,11/04/2018,11/04/2018,0.00,,11.19,,"-290,917.30"
,IN,AR,30312971,1005,100,,Invoice,,,,,,11/04/2018,11/04/2018,0.00,,12.94,,"-290,930.24"
,IN,AR,30312981,1005,100,,Invoice,,,,,,11/04/2018,11/04/2018,0.00,,11.95,,"-290,942.19"
,IN,AR,30312989,1005,100,,Invoice,,,,,,11/04/2018,11/04/2018,0.00,,46.78,,"-290,988.97"
,IN,AR,30312993,1005,100,,Invoice,,,,,,11/04/2018,11/04/2018,0.00,,9.15,,"-290,998.12"
,IN,AR,30313004,1005,100,,Invoice,,,,,,11/04/2018,11/04/2018,0.00,,7.29,,"-291,005.41"
,IN,AR,30313033,1005,100,,Invoice,,,,,,11/04/2018,11/04/2018,0.00,,10.38,,"-291,015.79"
,IN,AR,30313034,1005,100,,Invoice,,,,,,11/04/2018,11/04/2018,0.00,,51.91,,"-291,067.70"
,IN,AR,30313035,1005,100,,Invoice,,,,,,11/04/2018,11/04/2018,0.00,,12.46,,"-291,080.16"
,IN,AR,30313036,1005,100,,Invoice,,,,,,11/04/2018,11/04/2018,0.00,,16.61,,"-291,096.77"
,IN,AR,30313037,1005,100,,Invoice,,,,,,11/04/2018,11/04/2018,0.00,,31.14,,"-291,127.91"
,IN,AR,30313096,1005,100,,Invoice,,,,,,11/04/2018,11/04/2018,0.00,,29.15,,"-291,157.06"
,CN,AR,31017781,1005,100,,Credit Note,,,,,,12/04/2018,12/04/2018,7.29,,0.00,,"-291,149.77"
,CN,AR,31017791,1005,100,,Credit Note,,,,,,12/04/2018,12/04/2018,21.86,,0.00,,"-291,127.91"
,CN,AR,31017797,1005,100,,Credit Note,,,,,,12/04/2018,12/04/2018,7.29,,0.00,,"-291,120.62"
,CN,AR,31017851,1005,100,,Credit Note,,,,,,12/04/2018,12/04/2018,7.29,,0.00,,"-291,113.33"
,CR,AR,33000102,1005,100,,Cash Return,,,,,,12/04/2018,12/04/2018,7.29,,0.00,,"-291,106.04"
,CS,AR,32002593,1005,100,,Cash sale,,,,,,12/04/2018,12/04/2018,0.00,,18.05,,"-291,124.09"
,CS,AR,32002636,1005,100,,Cash sale,,,,,,12/04/2018,12/04/2018,0.00,,3.64,,"-291,127.73"
,CS,AR,32002645,1005,100,,Cash sale,,,,,,12/04/2018,12/04/2018,0.00,,11.22,,"-291,138.95"
,CS,AR,32002660,1005,100,,Cash sale,,,,,,12/04/2018,12/04/2018,0.00,,3.64,,"-291,142.59"
,CS,AR,32002677,1005,100,,Cash sale,,,,,,12/04/2018,12/04/2018,0.00,,3.64,,"-291,146.23"
,CS,AR,32002693,1005,100,,Cash sale,,,,,,12/04/2018,12/04/2018,0.00,,3.64,,"-291,149.87"
,CS,AR,32002720,1005,100,,Cash sale,,,,,,12/04/2018,12/04/2018,0.00,,3.64,,"-291,153.51"
,CS,AR,32002734,1005,100,,Cash sale,,,,,,12/04/2018,12/04/2018,0.00,,10.93,,"-291,164.44"
,CS,AR,32002736,1005,100,,Cash sale,,,,,,12/04/2018,12/04/2018,0.00,,3.64,,"-291,168.08"
,CS,AR,32002750,1005,100,,Cash sale,,,,,,12/04/2018,12/04/2018,0.00,,14.58,,"-291,182.66"
,CS,AR,32002774,1005,100,,Cash sale,,,,,,12/04/2018,12/04/2018,0.00,,7.29,,"-291,189.95"
,CS,AR,32002783,1005,100,,Cash sale,,,,,,12/04/2018,12/04/2018,0.00,,6.02,,"-291,195.97"
,CS,AR,32002797,1005,100,,Cash sale,,,,,,12/04/2018,12/04/2018,0.00,,7.29,,"-291,203.26"
,CS,AR,32002842,1005,100,,Cash sale,,,,,,12/04/2018,12/04/2018,0.00,,12.92,,"-291,216.18"
,CS,AR,32002844,1005,100,,Cash sale,,,,,,12/04/2018,12/04/2018,0.00,,10.93,,"-291,227.11"
,CS,AR,32002968,1005,100,,Cash sale,,,,,,12/04/2018,12/04/2018,0.00,,3.64,,"-291,230.75"
,CS,AR,32003012,1005,100,,Cash sale,,,,,,12/04/2018,12/04/2018,0.00,,8.39,,"-291,239.14"
,CS,AR,32003015,1005,100,,Cash sale,,,,,,12/04/2018,12/04/2018,0.00,,3.64,,"-291,242.78"
,CS,AR,32003017,1005,100,,Cash sale,,,,,,12/04/2018,12/04/2018,0.00,,7.75,,"-291,250.53"
,CS,AR,32003051,1005,100,,Cash sale,,,,,,12/04/2018,12/04/2018,0.00,,9.66,,"-291,260.19"
,CS,AR,32003107,1005,100,,Cash sale,,,,,,12/04/2018,12/04/2018,0.00,,14.58,,"-291,274.77"
,CS,AR,32003117,1005,100,,Cash sale,,,,,,12/04/2018,12/04/2018,0.00,,7.29,,"-291,282.06"
,CS,AR,32003173,1005,100,,Cash sale,,,,,,12/04/2018,12/04/2018,0.00,,36.44,,"-291,318.50"
,CS,AR,32003203,1005,100,,Cash sale,,,,,,12/04/2018,12/04/2018,0.00,,5.93,,"-291,324.43"
,CS,AR,32003215,1005,100,,Cash sale,,,,,,12/04/2018,12/04/2018,0.00,,9.11,,"-291,333.54"
,CS,AR,32003224,1005,100,,Cash sale,,,,,,12/04/2018,12/04/2018,0.00,,3.64,,"-291,337.18"
,CS,AR,32003271,1005,100,,Cash sale,,,,,,12/04/2018,12/04/2018,0.00,,14.58,,"-291,351.76"
,CS,AR,32003335,1005,100,,Cash sale,,,,,,12/04/2018,12/04/2018,0.00,,7.29,,"-291,359.05"
,CS,AR,32003374,1005,100,,Cash sale,,,,,,12/04/2018,12/04/2018,0.00,,7.29,,"-291,366.34"
,CS,AR,32003418,1005,100,,Cash sale,,,,,,12/04/2018,12/04/2018,0.00,,14.58,,"-291,380.92"
,IN,AR,30311091,1005,100,,Invoice,,,,,,12/04/2018,12/04/2018,0.00,,5.93,,"-291,386.85"
,IN,AR,30311092,1005,100,,Invoice,,,,,,12/04/2018,12/04/2018,0.00,,32.63,,"-291,419.48"
,IN,AR,30311137,1005,100,,Invoice,,,,,,12/04/2018,12/04/2018,0.00,,7.29,,"-291,426.77"
,IN,AR,30311152,1005,100,,Invoice,,,,,,12/04/2018,12/04/2018,0.00,,29.15,,"-291,455.92"
,IN,AR,30311170,1005,100,,Invoice,,,,,,12/04/2018,12/04/2018,0.00,,10.93,,"-291,466.85"
,IN,AR,30311178,1005,100,,Invoice,,,,,,12/04/2018,12/04/2018,0.00,,364.41,,"-291,831.26"
,IN,AR,30311181,1005,100,,Invoice,,,,,,12/04/2018,12/04/2018,0.00,,2.03,,"-291,833.29"
,IN,AR,30311205,1005,100,,Invoice,,,,,,12/04/2018,12/04/2018,0.00,,43.73,,"-291,877.02"
,IN,AR,30311221,1005,100,,Invoice,,,,,,12/04/2018,12/04/2018,0.00,,7.97,,"-291,884.99"
,IN,AR,30311235,1005,100,,Invoice,,,,,,12/04/2018,12/04/2018,0.00,,37.97,,"-291,922.96"
,IN,AR,30311253,1005,100,,Invoice,,,,,,12/04/2018,12/04/2018,0.00,,3.64,,"-291,926.60"
,IN,AR,30311346,1005,100,,Invoice,,,,,,12/04/2018,12/04/2018,0.00,,7.29,,"-291,933.89"
,IN,AR,30311386,1005,100,,Invoice,,,,,,12/04/2018,12/04/2018,0.00,,364.41,,"-292,298.30"
,IN,AR,30311390,1005,100,,Invoice,,,,,,12/04/2018,12/04/2018,0.00,,30.20,,"-292,328.50"
,IN,AR,30311399,1005,100,,Invoice,,,,,,12/04/2018,12/04/2018,0.00,,28.39,,"-292,356.89"
,IN,AR,30311434,1005,100,,Invoice,,,,,,12/04/2018,12/04/2018,0.00,,58.00,,"-292,414.89"
,IN,AR,30311489,1005,100,,Invoice,,,,,,12/04/2018,12/04/2018,0.00,,15.93,,"-292,430.82"
,IN,AR,30311494,1005,100,,Invoice,,,,,,12/04/2018,12/04/2018,0.00,,14.58,,"-292,445.40"
,IN,AR,30311501,1005,100,,Invoice,,,,,,12/04/2018,12/04/2018,0.00,,18.22,,"-292,463.62"
,IN,AR,30311507,1005,100,,Invoice,,,,,,12/04/2018,12/04/2018,0.00,,28.00,,"-292,491.62"
,IN,AR,30311543,1005,100,,Invoice,,,,,,12/04/2018,12/04/2018,0.00,,7.29,,"-292,498.91"
,IN,AR,30311549,1005,100,,Invoice,,,,,,12/04/2018,12/04/2018,0.00,,7.29,,"-292,506.20"
,IN,AR,30311597,1005,100,,Invoice,,,,,,12/04/2018,12/04/2018,0.00,,7.29,,"-292,513.49"
,IN,AR,30311617,1005,100,,Invoice,,,,,,12/04/2018,12/04/2018,0.00,,24.79,,"-292,538.28"
,IN,AR,30311645,1005,100,,Invoice,,,,,,12/04/2018,12/04/2018,0.00,,16.95,,"-292,555.23"
,IN,AR,30311680,1005,100,,Invoice,,,,,,12/04/2018,12/04/2018,0.00,,546.61,,"-293,101.84"
,IN,AR,30311687,1005,100,,Invoice,,,,,,12/04/2018,12/04/2018,0.00,,19.12,,"-293,120.96"
,IN,AR,30311704,1005,100,,Invoice,,,,,,12/04/2018,12/04/2018,0.00,,6.44,,"-293,127.40"
,IN,AR,30311757,1005,100,,Invoice,,,,,,12/04/2018,12/04/2018,0.00,,10.93,,"-293,138.33"
,IN,AR,30311759,1005,100,,Invoice,,,,,,12/04/2018,12/04/2018,0.00,,8.47,,"-293,146.80"
,IN,AR,30311772,1005,100,,Invoice,,,,,,12/04/2018,12/04/2018,0.00,,7.63,,"-293,154.43"
,IN,AR,30311773,1005,100,,Invoice,,,,,,12/04/2018,12/04/2018,0.00,,5.08,,"-293,159.51"
,IN,AR,30311784,1005,100,,Invoice,,,,,,12/04/2018,12/04/2018,0.00,,7.29,,"-293,166.80"
,IN,AR,30311792,1005,100,,Invoice,,,,,,12/04/2018,12/04/2018,0.00,,52.58,,"-293,219.38"
,IN,AR,30311793,1005,100,,Invoice,,,,,,12/04/2018,12/04/2018,0.00,,3.19,,"-293,222.57"
,IN,AR,30311794,1005,100,,Invoice,,,,,,12/04/2018,12/04/2018,0.00,,6.37,,"-293,228.94"
,IN,AR,30311795,1005,100,,Invoice,,,,,,12/04/2018,12/04/2018,0.00,,52.58,,"-293,281.52"
,IN,AR,30311806,1005,100,,Invoice,,,,,,12/04/2018,12/04/2018,0.00,,25.75,,"-293,307.27"
,IN,AR,30311811,1005,100,,Invoice,,,,,,12/04/2018,12/04/2018,0.00,,5.17,,"-293,312.44"
,IN,AR,30311823,1005,100,,Invoice,,,,,,12/04/2018,12/04/2018,0.00,,18.22,,"-293,330.66"
,IN,AR,30311846,1005,100,,Invoice,,,,,,12/04/2018,12/04/2018,0.00,,5.17,,"-293,335.83"
,IN,AR,30311913,1005,100,,Invoice,,,,,,12/04/2018,12/04/2018,0.00,,12.03,,"-293,347.86"
,IN,AR,30311929,1005,100,,Invoice,,,,,,12/04/2018,12/04/2018,0.00,,7.29,,"-293,355.15"
,IN,AR,30311955,1005,100,,Invoice,,,,,,12/04/2018,12/04/2018,0.00,,19.22,,"-293,374.37"
,IN,AR,30312048,1005,100,,Invoice,,,,,,12/04/2018,12/04/2018,0.00,,12.71,,"-293,387.08"
,IN,AR,30312054,1005,100,,Invoice,,,,,,12/04/2018,12/04/2018,0.00,,18.22,,"-293,405.30"
,IN,AR,30312068,1005,100,,Invoice,,,,,,12/04/2018,12/04/2018,0.00,,9.66,,"-293,414.96"
,IN,AR,30312072,1005,100,,Invoice,,,,,,12/04/2018,12/04/2018,0.00,,4.64,,"-293,419.60"
,IN,AR,30312078,1005,100,,Invoice,,,,,,12/04/2018,12/04/2018,0.00,,11.69,,"-293,431.29"
,IN,AR,30312082,1005,100,,Invoice,,,,,,12/04/2018,12/04/2018,0.00,,14.58,,"-293,445.87"
,IN,AR,30312084,1005,100,,Invoice,,,,,,12/04/2018,12/04/2018,0.00,,14.58,,"-293,460.45"
,IN,AR,30312085,1005,100,,Invoice,,,,,,12/04/2018,12/04/2018,0.00,,18.22,,"-293,478.67"
,IN,AR,30312089,1005,100,,Invoice,,,,,,12/04/2018,12/04/2018,0.00,,11.02,,"-293,489.69"
,IN,AR,30312108,1005,100,,Invoice,,,,,,12/04/2018,12/04/2018,0.00,,364.41,,"-293,854.10"
,IN,AR,30312115,1005,100,,Invoice,,,,,,12/04/2018,12/04/2018,0.00,,2.58,,"-293,856.68"
,IN,AR,30312145,1005,100,,Invoice,,,,,,12/04/2018,12/04/2018,0.00,,12.14,,"-293,868.82"
,IN,AR,30312156,1005,100,,Invoice,,,,,,12/04/2018,12/04/2018,0.00,,17.47,,"-293,886.29"
,IN,AR,30312162,1005,100,,Invoice,,,,,,12/04/2018,12/04/2018,0.00,,5.08,,"-293,891.37"
,IN,AR,30312176,1005,100,,Invoice,,,,,,12/04/2018,12/04/2018,0.00,,10.00,,"-293,901.37"
,IN,AR,30312218,1005,100,,Invoice,,,,,,12/04/2018,12/04/2018,0.00,,14.58,,"-293,915.95"
,IN,AR,30312225,1005,100,,Invoice,,,,,,12/04/2018,12/04/2018,0.00,,4.54,,"-293,920.49"
,IN,AR,30312263,1005,100,,Invoice,,,,,,12/04/2018,12/04/2018,0.00,,11.70,,"-293,932.19"
,IN,AR,30312271,1005,100,,Invoice,,,,,,12/04/2018,12/04/2018,0.00,,29.15,,"-293,961.34"
,IN,AR,30312272,1005,100,,Invoice,,,,,,12/04/2018,12/04/2018,0.00,,21.86,,"-293,983.20"
,IN,AR,30312301,1005,100,,Invoice,,,,,,12/04/2018,12/04/2018,0.00,,3.64,,"-293,986.84"
,IN,AR,30312305,1005,100,,Invoice,,,,,,12/04/2018,12/04/2018,0.00,,12.71,,"-293,999.55"
,IN,AR,30312316,1005,100,,Invoice,,,,,,12/04/2018,12/04/2018,0.00,,7.29,,"-294,006.84"
,IN,AR,30312323,1005,100,,Invoice,,,,,,12/04/2018,12/04/2018,0.00,,3.25,,"-294,010.09"
,IN,AR,30312324,1005,100,,Invoice,,,,,,12/04/2018,12/04/2018,0.00,,17.90,,"-294,027.99"
,IN,AR,30312325,1005,100,,Invoice,,,,,,12/04/2018,12/04/2018,0.00,,9.76,,"-294,037.75"
,IN,AR,30312326,1005,100,,Invoice,,,,,,12/04/2018,12/04/2018,0.00,,39.05,,"-294,076.80"
,IN,AR,30312342,1005,100,,Invoice,,,,,,12/04/2018,12/04/2018,0.00,,15.90,,"-294,092.70"
,IN,AR,30312368,1005,100,,Invoice,,,,,,12/04/2018,12/04/2018,0.00,,28.81,,"-294,121.51"
,IN,AR,30312412,1005,100,,Invoice,,,,,,12/04/2018,12/04/2018,0.00,,34.58,,"-294,156.09"
,IN,AR,30312443,1005,100,,Invoice,,,,,,12/04/2018,12/04/2018,0.00,,4.81,,"-294,160.90"
,IN,AR,30312444,1005,100,,Invoice,,,,,,12/04/2018,12/04/2018,0.00,,6.42,,"-294,167.32"
,IN,AR,30312523,1005,100,,Invoice,,,,,,12/04/2018,12/04/2018,0.00,,5.08,,"-294,172.40"
,IN,AR,30312533,1005,100,,Invoice,,,,,,12/04/2018,12/04/2018,0.00,,10.00,,"-294,182.40"
,IN,AR,30312549,1005,100,,Invoice,,,,,,12/04/2018,12/04/2018,0.00,,20.01,,"-294,202.41"
,IN,AR,30312562,1005,100,,Invoice,,,,,,12/04/2018,12/04/2018,0.00,,14.58,,"-294,216.99"
,IN,AR,30312563,1005,100,,Invoice,,,,,,12/04/2018,12/04/2018,0.00,,14.58,,"-294,231.57"
,IN,AR,30312595,1005,100,,Invoice,,,,,,12/04/2018,12/04/2018,0.00,,14.58,,"-294,246.15"
,IN,AR,30312620,1005,100,,Invoice,,,,,,12/04/2018,12/04/2018,0.00,,18.22,,"-294,264.37"
,IN,AR,30312641,1005,100,,Invoice,,,,,,12/04/2018,12/04/2018,0.00,,5.61,,"-294,269.98"
,IN,AR,30312653,1005,100,,Invoice,,,,,,12/04/2018,12/04/2018,0.00,,20.59,,"-294,290.57"
,IN,AR,30312744,1005,100,,Invoice,,,,,,12/04/2018,12/04/2018,0.00,,6.37,,"-294,296.94"
,IN,AR,30312745,1005,100,,Invoice,,,,,,12/04/2018,12/04/2018,0.00,,132.24,,"-294,429.18"
,IN,AR,30312746,1005,100,,Invoice,,,,,,12/04/2018,12/04/2018,0.00,,6.37,,"-294,435.55"
,IN,AR,30312747,1005,100,,Invoice,,,,,,12/04/2018,12/04/2018,0.00,,14.34,,"-294,449.89"
,IN,AR,30312748,1005,100,,Invoice,,,,,,12/04/2018,12/04/2018,0.00,,17.53,,"-294,467.42"
,IN,AR,30312786,1005,100,,Invoice,,,,,,12/04/2018,12/04/2018,0.00,,24.41,,"-294,491.83"
,IN,AR,30312865,1005,100,,Invoice,,,,,,12/04/2018,12/04/2018,0.00,,275.42,,"-294,767.25"
,IN,AR,30312888,1005,100,,Invoice,,,,,,12/04/2018,12/04/2018,0.00,,7.29,,"-294,774.54"
,IN,AR,30312906,1005,100,,Invoice,,,,,,12/04/2018,12/04/2018,0.00,,8.78,,"-294,783.32"
,IN,AR,30312941,1005,100,,Invoice,,,,,,12/04/2018,12/04/2018,0.00,,4.08,,"-294,787.40"
,IN,AR,30312973,1005,100,,Invoice,,,,,,12/04/2018,12/04/2018,0.00,,11.19,,"-294,798.59"
,IN,AR,30312996,1005,100,,Invoice,,,,,,12/04/2018,12/04/2018,0.00,,182.20,,"-294,980.79"
,IN,AR,30313007,1005,100,,Invoice,,,,,,12/04/2018,12/04/2018,0.00,,6.00,,"-294,986.79"
,IN,AR,30313008,1005,100,,Invoice,,,,,,12/04/2018,12/04/2018,0.00,,4.00,,"-294,990.79"
,IN,AR,30313038,1005,100,,Invoice,,,,,,12/04/2018,12/04/2018,0.00,,35.30,,"-295,026.09"
,IN,AR,30313098,1005,100,,Invoice,,,,,,12/04/2018,12/04/2018,0.00,,10.93,,"-295,037.02"
,IN,AR,30313100,1005,100,,Invoice,,,,,,12/04/2018,12/04/2018,0.00,,419.07,,"-295,456.09"
,CN,AR,31017689,1005,100,,Credit Note,,,,,,13/04/2018,13/04/2018,14.03,,0.00,,"-295,442.06"
,CS,AR,32002589,1005,100,,Cash sale,,,,,,13/04/2018,13/04/2018,0.00,,46.71,,"-295,488.77"
,CS,AR,32002601,1005,100,,Cash sale,,,,,,13/04/2018,13/04/2018,0.00,,11.22,,"-295,499.99"
,CS,AR,32002617,1005,100,,Cash sale,,,,,,13/04/2018,13/04/2018,0.00,,11.86,,"-295,511.85"
,CS,AR,32002625,1005,100,,Cash sale,,,,,,13/04/2018,13/04/2018,0.00,,8.52,,"-295,520.37"
,CS,AR,32002662,1005,100,,Cash sale,,,,,,13/04/2018,13/04/2018,0.00,,3.64,,"-295,524.01"
,CS,AR,32002668,1005,100,,Cash sale,,,,,,13/04/2018,13/04/2018,0.00,,3.64,,"-295,527.65"
,CS,AR,32002685,1005,100,,Cash sale,,,,,,13/04/2018,13/04/2018,0.00,,7.25,,"-295,534.90"
,CS,AR,32002698,1005,100,,Cash sale,,,,,,13/04/2018,13/04/2018,0.00,,21.36,,"-295,556.26"
,CS,AR,32002711,1005,100,,Cash sale,,,,,,13/04/2018,13/04/2018,0.00,,7.29,,"-295,563.55"
,CS,AR,32002715,1005,100,,Cash sale,,,,,,13/04/2018,13/04/2018,0.00,,14.53,,"-295,578.08"
,CS,AR,32002731,1005,100,,Cash sale,,,,,,13/04/2018,13/04/2018,0.00,,3.64,,"-295,581.72"
,CS,AR,32002817,1005,100,,Cash sale,,,,,,13/04/2018,13/04/2018,0.00,,21.86,,"-295,603.58"
,CS,AR,32002827,1005,100,,Cash sale,,,,,,13/04/2018,13/04/2018,0.00,,10.17,,"-295,613.75"
,CS,AR,32002849,1005,100,,Cash sale,,,,,,13/04/2018,13/04/2018,0.00,,28.43,,"-295,642.18"
,CS,AR,32002852,1005,100,,Cash sale,,,,,,13/04/2018,13/04/2018,0.00,,35.72,,"-295,677.90"
,CS,AR,32002866,1005,100,,Cash sale,,,,,,13/04/2018,13/04/2018,0.00,,10.99,,"-295,688.89"
,CS,AR,32002885,1005,100,,Cash sale,,,,,,13/04/2018,13/04/2018,0.00,,18.05,,"-295,706.94"
,CS,AR,32002903,1005,100,,Cash sale,,,,,,13/04/2018,13/04/2018,0.00,,9.03,,"-295,715.97"
,CS,AR,32002937,1005,100,,Cash sale,,,,,,13/04/2018,13/04/2018,0.00,,30.08,,"-295,746.05"
,CS,AR,32002956,1005,100,,Cash sale,,,,,,13/04/2018,13/04/2018,0.00,,10.00,,"-295,756.05"
,CS,AR,32002966,1005,100,,Cash sale,,,,,,13/04/2018,13/04/2018,0.00,,3.64,,"-295,759.69"
,CS,AR,32002970,1005,100,,Cash sale,,,,,,13/04/2018,13/04/2018,0.00,,15.04,,"-295,774.73"
,CS,AR,32003058,1005,100,,Cash sale,,,,,,13/04/2018,13/04/2018,0.00,,3.64,,"-295,778.37"
,CS,AR,32003128,1005,100,,Cash sale,,,,,,13/04/2018,13/04/2018,0.00,,7.29,,"-295,785.66"
,CS,AR,32003143,1005,100,,Cash sale,,,,,,13/04/2018,13/04/2018,0.00,,12.71,,"-295,798.37"
,CS,AR,32003150,1005,100,,Cash sale,,,,,,13/04/2018,13/04/2018,0.00,,10.93,,"-295,809.30"
,CS,AR,32003164,1005,100,,Cash sale,,,,,,13/04/2018,13/04/2018,0.00,,7.29,,"-295,816.59"
,CS,AR,32003184,1005,100,,Cash sale,,,,,,13/04/2018,13/04/2018,0.00,,32.00,,"-295,848.59"
,CS,AR,32003231,1005,100,,Cash sale,,,,,,13/04/2018,13/04/2018,0.00,,6.86,,"-295,855.45"
,CS,AR,32003270,1005,100,,Cash sale,,,,,,13/04/2018,13/04/2018,0.00,,18.22,,"-295,873.67"
,CS,AR,32003302,1005,100,,Cash sale,,,,,,13/04/2018,13/04/2018,0.00,,10.93,,"-295,884.60"
,CS,AR,32003305,1005,100,,Cash sale,,,,,,13/04/2018,13/04/2018,0.00,,3.64,,"-295,888.24"
,CS,AR,32003308,1005,100,,Cash sale,,,,,,13/04/2018,13/04/2018,0.00,,8.20,,"-295,896.44"
,CS,AR,32003309,1005,100,,Cash sale,,,,,,13/04/2018,13/04/2018,0.00,,14.58,,"-295,911.02"
,CS,AR,32003311,1005,100,,Cash sale,,,,,,13/04/2018,13/04/2018,0.00,,6.07,,"-295,917.09"
,CS,AR,32003342,1005,100,,Cash sale,,,,,,13/04/2018,13/04/2018,0.00,,14.58,,"-295,931.67"
,CS,AR,32003366,1005,100,,Cash sale,,,,,,13/04/2018,13/04/2018,0.00,,7.29,,"-295,938.96"
,CS,AR,32003373,1005,100,,Cash sale,,,,,,13/04/2018,13/04/2018,0.00,,3.64,,"-295,942.60"
,CS,AR,32003386,1005,100,,Cash sale,,,,,,13/04/2018,13/04/2018,0.00,,7.29,,"-295,949.89"
,CS,AR,32003394,1005,100,,Cash sale,,,,,,13/04/2018,13/04/2018,0.00,,7.29,,"-295,957.18"
,IN,AR,30311093,1005,100,,Invoice,,,,,,13/04/2018,13/04/2018,0.00,,14.83,,"-295,972.01"
,IN,AR,30311101,1005,100,,Invoice,,,,,,13/04/2018,13/04/2018,0.00,,25.51,,"-295,997.52"
,IN,AR,30311112,1005,100,,Invoice,,,,,,13/04/2018,13/04/2018,0.00,,11.22,,"-296,008.74"
,IN,AR,30311119,1005,100,,Invoice,,,,,,13/04/2018,13/04/2018,0.00,,11.19,,"-296,019.93"
,IN,AR,30311143,1005,100,,Invoice,,,,,,13/04/2018,13/04/2018,0.00,,36.44,,"-296,056.37"
,IN,AR,30311166,1005,100,,Invoice,,,,,,13/04/2018,13/04/2018,0.00,,16.91,,"-296,073.28"
,IN,AR,30311203,1005,100,,Invoice,,,,,,13/04/2018,13/04/2018,0.00,,21.86,,"-296,095.14"
,IN,AR,30311209,1005,100,,Invoice,,,,,,13/04/2018,13/04/2018,0.00,,9.19,,"-296,104.33"
,IN,AR,30311214,1005,100,,Invoice,,,,,,13/04/2018,13/04/2018,0.00,,97.03,,"-296,201.36"
,IN,AR,30311236,1005,100,,Invoice,,,,,,13/04/2018,13/04/2018,0.00,,54.58,,"-296,255.94"
,IN,AR,30311255,1005,100,,Invoice,,,,,,13/04/2018,13/04/2018,0.00,,14.58,,"-296,270.52"
,IN,AR,30311263,1005,100,,Invoice,,,,,,13/04/2018,13/04/2018,0.00,,20.00,,"-296,290.52"
,IN,AR,30311312,1005,100,,Invoice,,,,,,13/04/2018,13/04/2018,0.00,,24.00,,"-296,314.52"
,IN,AR,30311345,1005,100,,Invoice,,,,,,13/04/2018,13/04/2018,0.00,,3.64,,"-296,318.16"
,IN,AR,30311366,1005,100,,Invoice,,,,,,13/04/2018,13/04/2018,0.00,,4.75,,"-296,322.91"
,IN,AR,30311374,1005,100,,Invoice,,,,,,13/04/2018,13/04/2018,0.00,,14.00,,"-296,336.91"
,IN,AR,30311416,1005,100,,Invoice,,,,,,13/04/2018,13/04/2018,0.00,,732.15,,"-297,069.06"
,IN,AR,30311423,1005,100,,Invoice,,,,,,13/04/2018,13/04/2018,0.00,,9.70,,"-297,078.76"
,IN,AR,30311428,1005,100,,Invoice,,,,,,13/04/2018,13/04/2018,0.00,,90.81,,"-297,169.57"
,IN,AR,30311455,1005,100,,Invoice,,,,,,13/04/2018,13/04/2018,0.00,,13.98,,"-297,183.55"
,IN,AR,30311466,1005,100,,Invoice,,,,,,13/04/2018,13/04/2018,0.00,,23.29,,"-297,206.84"
,IN,AR,30311472,1005,100,,Invoice,,,,,,13/04/2018,13/04/2018,0.00,,29.15,,"-297,235.99"
,IN,AR,30311490,1005,100,,Invoice,,,,,,13/04/2018,13/04/2018,0.00,,4.78,,"-297,240.77"
,IN,AR,30311532,1005,100,,Invoice,,,,,,13/04/2018,13/04/2018,0.00,,4.80,,"-297,245.57"
,IN,AR,30311588,1005,100,,Invoice,,,,,,13/04/2018,13/04/2018,0.00,,18.09,,"-297,263.66"
,IN,AR,30311593,1005,100,,Invoice,,,,,,13/04/2018,13/04/2018,0.00,,4.78,,"-297,268.44"
,IN,AR,30311601,1005,100,,Invoice,,,,,,13/04/2018,13/04/2018,0.00,,196.07,,"-297,464.51"
,IN,AR,30311653,1005,100,,Invoice,,,,,,13/04/2018,13/04/2018,0.00,,34.86,,"-297,499.37"
,IN,AR,30311661,1005,100,,Invoice,,,,,,13/04/2018,13/04/2018,0.00,,22.44,,"-297,521.81"
,IN,AR,30311688,1005,100,,Invoice,,,,,,13/04/2018,13/04/2018,0.00,,14.34,,"-297,536.15"
,IN,AR,30311689,1005,100,,Invoice,,,,,,13/04/2018,13/04/2018,0.00,,4.78,,"-297,540.93"
,IN,AR,30311705,1005,100,,Invoice,,,,,,13/04/2018,13/04/2018,0.00,,48.31,,"-297,589.24"
,IN,AR,30311711,1005,100,,Invoice,,,,,,13/04/2018,13/04/2018,0.00,,10.93,,"-297,600.17"
,IN,AR,30311774,1005,100,,Invoice,,,,,,13/04/2018,13/04/2018,0.00,,2.54,,"-297,602.71"
,IN,AR,30311775,1005,100,,Invoice,,,,,,13/04/2018,13/04/2018,0.00,,10.17,,"-297,612.88"
,IN,AR,30311786,1005,100,,Invoice,,,,,,13/04/2018,13/04/2018,0.00,,5.08,,"-297,617.96"
,IN,AR,30311788,1005,100,,Invoice,,,,,,13/04/2018,13/04/2018,0.00,,20.47,,"-297,638.43"
,IN,AR,30311796,1005,100,,Invoice,,,,,,13/04/2018,13/04/2018,0.00,,23.90,,"-297,662.33"
,IN,AR,30311827,1005,100,,Invoice,,,,,,13/04/2018,13/04/2018,0.00,,12.71,,"-297,675.04"
,IN,AR,30311831,1005,100,,Invoice,,,,,,13/04/2018,13/04/2018,0.00,,8.47,,"-297,683.51"
,IN,AR,30311835,1005,100,,Invoice,,,,,,13/04/2018,13/04/2018,0.00,,27.54,,"-297,711.05"
,IN,AR,30311845,1005,100,,Invoice,,,,,,13/04/2018,13/04/2018,0.00,,8.39,,"-297,719.44"
,IN,AR,30311854,1005,100,,Invoice,,,,,,13/04/2018,13/04/2018,0.00,,10.93,,"-297,730.37"
,IN,AR,30311858,1005,100,,Invoice,,,,,,13/04/2018,13/04/2018,0.00,,33.05,,"-297,763.42"
,IN,AR,30311907,1005,100,,Invoice,,,,,,13/04/2018,13/04/2018,0.00,,3.64,,"-297,767.06"
,IN,AR,30311969,1005,100,,Invoice,,,,,,13/04/2018,13/04/2018,0.00,,22.44,,"-297,789.50"
,IN,AR,30311997,1005,100,,Invoice,,,,,,13/04/2018,13/04/2018,0.00,,29.15,,"-297,818.65"
,IN,AR,30312005,1005,100,,Invoice,,,,,,13/04/2018,13/04/2018,0.00,,29.15,,"-297,847.80"
,IN,AR,30312006,1005,100,,Invoice,,,,,,13/04/2018,13/04/2018,0.00,,14.58,,"-297,862.38"
,IN,AR,30312007,1005,100,,Invoice,,,,,,13/04/2018,13/04/2018,0.00,,789.41,,"-298,651.79"
,IN,AR,30312049,1005,100,,Invoice,,,,,,13/04/2018,13/04/2018,0.00,,10.17,,"-298,661.96"
,IN,AR,30312103,1005,100,,Invoice,,,,,,13/04/2018,13/04/2018,0.00,,10.34,,"-298,672.30"
,IN,AR,30312136,1005,100,,Invoice,,,,,,13/04/2018,13/04/2018,0.00,,7.29,,"-298,679.59"
,IN,AR,30312166,1005,100,,Invoice,,,,,,13/04/2018,13/04/2018,0.00,,6.53,,"-298,686.12"
,IN,AR,30312221,1005,100,,Invoice,,,,,,13/04/2018,13/04/2018,0.00,,4.85,,"-298,690.97"
,IN,AR,30312252,1005,100,,Invoice,,,,,,13/04/2018,13/04/2018,0.00,,18.22,,"-298,709.19"
,IN,AR,30312254,1005,100,,Invoice,,,,,,13/04/2018,13/04/2018,0.00,,10.93,,"-298,720.12"
,IN,AR,30312283,1005,100,,Invoice,,,,,,13/04/2018,13/04/2018,0.00,,182.20,,"-298,902.32"
,IN,AR,30312327,1005,100,,Invoice,,,,,,13/04/2018,13/04/2018,0.00,,6.51,,"-298,908.83"
,IN,AR,30312343,1005,100,,Invoice,,,,,,13/04/2018,13/04/2018,0.00,,23.85,,"-298,932.68"
,IN,AR,30312357,1005,100,,Invoice,,,,,,13/04/2018,13/04/2018,0.00,,53.94,,"-298,986.62"
,IN,AR,30312374,1005,100,,Invoice,,,,,,13/04/2018,13/04/2018,0.00,,60.57,,"-299,047.19"
,IN,AR,30312384,1005,100,,Invoice,,,,,,13/04/2018,13/04/2018,0.00,,66.14,,"-299,113.33"
,IN,AR,30312403,1005,100,,Invoice,,,,,,13/04/2018,13/04/2018,0.00,,12.03,,"-299,125.36"
,IN,AR,30312420,1005,100,,Invoice,,,,,,13/04/2018,13/04/2018,0.00,,18.22,,"-299,143.58"
,IN,AR,30312445,1005,100,,Invoice,,,,,,13/04/2018,13/04/2018,0.00,,80.17,,"-299,223.75"
,IN,AR,30312446,1005,100,,Invoice,,,,,,13/04/2018,13/04/2018,0.00,,80.17,,"-299,303.92"
,IN,AR,30312476,1005,100,,Invoice,,,,,,13/04/2018,13/04/2018,0.00,,34.15,,"-299,338.07"
,IN,AR,30312502,1005,100,,Invoice,,,,,,13/04/2018,13/04/2018,0.00,,21.52,,"-299,359.59"
,IN,AR,30312524,1005,100,,Invoice,,,,,,13/04/2018,13/04/2018,0.00,,15.25,,"-299,374.84"
,IN,AR,30312583,1005,100,,Invoice,,,,,,13/04/2018,13/04/2018,0.00,,48.27,,"-299,423.11"
,IN,AR,30312597,1005,100,,Invoice,,,,,,13/04/2018,13/04/2018,0.00,,24.64,,"-299,447.75"
,IN,AR,30312602,1005,100,,Invoice,,,,,,13/04/2018,13/04/2018,0.00,,4.20,,"-299,451.95"
,IN,AR,30312630,1005,100,,Invoice,,,,,,13/04/2018,13/04/2018,0.00,,27.97,,"-299,479.92"
,IN,AR,30312679,1005,100,,Invoice,,,,,,13/04/2018,13/04/2018,0.00,,7.29,,"-299,487.21"
,IN,AR,30312687,1005,100,,Invoice,,,,,,13/04/2018,13/04/2018,0.00,,10.38,,"-299,497.59"
,IN,AR,30312707,1005,100,,Invoice,,,,,,13/04/2018,13/04/2018,0.00,,10.93,,"-299,508.52"
,IN,AR,30312708,1005,100,,Invoice,,,,,,13/04/2018,13/04/2018,0.00,,29.15,,"-299,537.67"
,IN,AR,30312710,1005,100,,Invoice,,,,,,13/04/2018,13/04/2018,0.00,,7.29,,"-299,544.96"
,IN,AR,30312718,1005,100,,Invoice,,,,,,13/04/2018,13/04/2018,0.00,,2.84,,"-299,547.80"
,IN,AR,30312722,1005,100,,Invoice,,,,,,13/04/2018,13/04/2018,0.00,,19.32,,"-299,567.12"
,IN,AR,30312749,1005,100,,Invoice,,,,,,13/04/2018,13/04/2018,0.00,,25.49,,"-299,592.61"
,IN,AR,30312803,1005,100,,Invoice,,,,,,13/04/2018,13/04/2018,0.00,,10.00,,"-299,602.61"
,IN,AR,30312869,1005,100,,Invoice,,,,,,13/04/2018,13/04/2018,0.00,,8.47,,"-299,611.08"
,IN,AR,30312874,1005,100,,Invoice,,,,,,13/04/2018,13/04/2018,0.00,,8.21,,"-299,619.29"
,IN,AR,30312884,1005,100,,Invoice,,,,,,13/04/2018,13/04/2018,0.00,,46.61,,"-299,665.90"
,IN,AR,30312887,1005,100,,Invoice,,,,,,13/04/2018,13/04/2018,0.00,,3.64,,"-299,669.54"
,IN,AR,30312901,1005,100,,Invoice,,,,,,13/04/2018,13/04/2018,0.00,,7.29,,"-299,676.83"
,IN,AR,30312908,1005,100,,Invoice,,,,,,13/04/2018,13/04/2018,0.00,,522.50,,"-300,199.33"
,IN,AR,30312936,1005,100,,Invoice,,,,,,13/04/2018,13/04/2018,0.00,,8.17,,"-300,207.50"
,IN,AR,30312944,1005,100,,Invoice,,,,,,13/04/2018,13/04/2018,0.00,,6.13,,"-300,213.63"
,IN,AR,30312982,1005,100,,Invoice,,,,,,13/04/2018,13/04/2018,0.00,,7.97,,"-300,221.60"
,IN,AR,30313039,1005,100,,Invoice,,,,,,13/04/2018,13/04/2018,0.00,,14.53,,"-300,236.13"
,IN,AR,30313040,1005,100,,Invoice,,,,,,13/04/2018,13/04/2018,0.00,,12.46,,"-300,248.59"
,IN,AR,30313073,1005,100,,Invoice,,,,,,13/04/2018,13/04/2018,0.00,,7.29,,"-300,255.88"
,CS,AR,32002640,1005,100,,Cash sale,,,,,,14/04/2018,14/04/2018,0.00,,6.02,,"-300,261.90"
,CS,AR,32002986,1005,100,,Cash sale,,,,,,14/04/2018,14/04/2018,0.00,,54.15,,"-300,316.05"
,CS,AR,32003130,1005,100,,Cash sale,,,,,,14/04/2018,14/04/2018,0.00,,18.22,,"-300,334.27"
,CS,AR,32003148,1005,100,,Cash sale,,,,,,14/04/2018,14/04/2018,0.00,,29.15,,"-300,363.42"
,CS,AR,32003249,1005,100,,Cash sale,,,,,,14/04/2018,14/04/2018,0.00,,10.93,,"-300,374.35"
,IN,AR,30311237,1005,100,,Invoice,,,,,,14/04/2018,14/04/2018,0.00,,52.20,,"-300,426.55"
,IN,AR,30311430,1005,100,,Invoice,,,,,,14/04/2018,14/04/2018,0.00,,7.29,,"-300,433.84"
,IN,AR,30311468,1005,100,,Invoice,,,,,,14/04/2018,14/04/2018,0.00,,6.02,,"-300,439.86"
,IN,AR,30312651,1005,100,,Invoice,,,,,,14/04/2018,14/04/2018,0.00,,7.29,,"-300,447.15"
,IN,AR,30312770,1005,100,,Invoice,,,,,,14/04/2018,14/04/2018,0.00,,29.15,,"-300,476.30"
,IN,AR,30312911,1005,100,,Invoice,,,,,,14/04/2018,14/04/2018,0.00,,10.93,,"-300,487.23"
,IN,AR,30313094,1005,100,,Invoice,,,,,,14/04/2018,14/04/2018,0.00,,10.93,,"-300,498.16"
,CS,AR,32003256,1005,100,,Cash sale,,,,,,15/04/2018,15/04/2018,0.00,,29.15,,"-300,527.31"
,IN,AR,30312514,1005,100,,Invoice,,,,,,15/04/2018,15/04/2018,0.00,,72.88,,"-300,600.19"
,CS,AR,32002602,1005,100,,Cash sale,,,,,,16/04/2018,16/04/2018,0.00,,8.42,,"-300,608.61"
,CS,AR,32002618,1005,100,,Cash sale,,,,,,16/04/2018,16/04/2018,0.00,,9.49,,"-300,618.10"
,CS,AR,32002651,1005,100,,Cash sale,,,,,,16/04/2018,16/04/2018,0.00,,7.29,,"-300,625.39"
,CS,AR,32002716,1005,100,,Cash sale,,,,,,16/04/2018,16/04/2018,0.00,,14.53,,"-300,639.92"
,CS,AR,32002727,1005,100,,Cash sale,,,,,,16/04/2018,16/04/2018,0.00,,7.29,,"-300,647.21"
,CS,AR,32002739,1005,100,,Cash sale,,,,,,16/04/2018,16/04/2018,0.00,,11.69,,"-300,658.90"
,CS,AR,32002759,1005,100,,Cash sale,,,,,,16/04/2018,16/04/2018,0.00,,10.93,,"-300,669.83"
,CS,AR,32002767,1005,100,,Cash sale,,,,,,16/04/2018,16/04/2018,0.00,,3.64,,"-300,673.47"
,CS,AR,32002786,1005,100,,Cash sale,,,,,,16/04/2018,16/04/2018,0.00,,10.34,,"-300,683.81"
,CS,AR,32002814,1005,100,,Cash sale,,,,,,16/04/2018,16/04/2018,0.00,,7.29,,"-300,691.10"
,CS,AR,32002828,1005,100,,Cash sale,,,,,,16/04/2018,16/04/2018,0.00,,12.71,,"-300,703.81"
,CS,AR,32002838,1005,100,,Cash sale,,,,,,16/04/2018,16/04/2018,0.00,,7.29,,"-300,711.10"
,CS,AR,32002867,1005,100,,Cash sale,,,,,,16/04/2018,16/04/2018,0.00,,10.99,,"-300,722.09"
,CS,AR,32002896,1005,100,,Cash sale,,,,,,16/04/2018,16/04/2018,0.00,,3.64,,"-300,725.73"
,CS,AR,32002907,1005,100,,Cash sale,,,,,,16/04/2018,16/04/2018,0.00,,3.01,,"-300,728.74"
,CS,AR,32002920,1005,100,,Cash sale,,,,,,16/04/2018,16/04/2018,0.00,,20.47,,"-300,749.21"
,CS,AR,32002928,1005,100,,Cash sale,,,,,,16/04/2018,16/04/2018,0.00,,3.64,,"-300,752.85"
,CS,AR,32002938,1005,100,,Cash sale,,,,,,16/04/2018,16/04/2018,0.00,,39.11,,"-300,791.96"
,CS,AR,32002990,1005,100,,Cash sale,,,,,,16/04/2018,16/04/2018,0.00,,7.88,,"-300,799.84"
,CS,AR,32003021,1005,100,,Cash sale,,,,,,16/04/2018,16/04/2018,0.00,,7.75,,"-300,807.59"
,CS,AR,32003025,1005,100,,Cash sale,,,,,,16/04/2018,16/04/2018,0.00,,5.85,,"-300,813.44"
,CS,AR,32003027,1005,100,,Cash sale,,,,,,16/04/2018,16/04/2018,0.00,,3.01,,"-300,816.45"
,CS,AR,32003042,1005,100,,Cash sale,,,,,,16/04/2018,16/04/2018,0.00,,10.93,,"-300,827.38"
,CS,AR,32003070,1005,100,,Cash sale,,,,,,16/04/2018,16/04/2018,0.00,,9.03,,"-300,836.41"
,CS,AR,32003190,1005,100,,Cash sale,,,,,,16/04/2018,16/04/2018,0.00,,14.58,,"-300,850.99"
,CS,AR,32003191,1005,100,,Cash sale,,,,,,16/04/2018,16/04/2018,0.00,,29.15,,"-300,880.14"
,CS,AR,32003199,1005,100,,Cash sale,,,,,,16/04/2018,16/04/2018,0.00,,54.66,,"-300,934.80"
,CS,AR,32003232,1005,100,,Cash sale,,,,,,16/04/2018,16/04/2018,0.00,,11.44,,"-300,946.24"
,CS,AR,32003260,1005,100,,Cash sale,,,,,,16/04/2018,16/04/2018,0.00,,9.10,,"-300,955.34"
,CS,AR,32003282,1005,100,,Cash sale,,,,,,16/04/2018,16/04/2018,0.00,,15.18,,"-300,970.52"
,CS,AR,32003284,1005,100,,Cash sale,,,,,,16/04/2018,16/04/2018,0.00,,7.29,,"-300,977.81"
,CS,AR,32003295,1005,100,,Cash sale,,,,,,16/04/2018,16/04/2018,0.00,,5.47,,"-300,983.28"
,CS,AR,32003332,1005,100,,Cash sale,,,,,,16/04/2018,16/04/2018,0.00,,10.93,,"-300,994.21"
,CS,AR,32003344,1005,100,,Cash sale,,,,,,16/04/2018,16/04/2018,0.00,,3.64,,"-300,997.85"
,CS,AR,32003365,1005,100,,Cash sale,,,,,,16/04/2018,16/04/2018,0.00,,10.93,,"-301,008.78"
,CS,AR,32003371,1005,100,,Cash sale,,,,,,16/04/2018,16/04/2018,0.00,,10.93,,"-301,019.71"
,CS,AR,32003399,1005,100,,Cash sale,,,,,,16/04/2018,16/04/2018,0.00,,7.29,,"-301,027.00"
,IN,AR,30311094,1005,100,,Invoice,,,,,,16/04/2018,16/04/2018,0.00,,29.66,,"-301,056.66"
,IN,AR,30311109,1005,100,,Invoice,,,,,,16/04/2018,16/04/2018,0.00,,29.15,,"-301,085.81"
,IN,AR,30311192,1005,100,,Invoice,,,,,,16/04/2018,16/04/2018,0.00,,71.86,,"-301,157.67"
,IN,AR,30311222,1005,100,,Invoice,,,,,,16/04/2018,16/04/2018,0.00,,7.97,,"-301,165.64"
,IN,AR,30311238,1005,100,,Invoice,,,,,,16/04/2018,16/04/2018,0.00,,151.86,,"-301,317.50"
,IN,AR,30311251,1005,100,,Invoice,,,,,,16/04/2018,16/04/2018,0.00,,2.75,,"-301,320.25"
,IN,AR,30311264,1005,100,,Invoice,,,,,,16/04/2018,16/04/2018,0.00,,36.00,,"-301,356.25"
,IN,AR,30311285,1005,100,,Invoice,,,,,,16/04/2018,16/04/2018,0.00,,50.90,,"-301,407.15"
,IN,AR,30311313,1005,100,,Invoice,,,,,,16/04/2018,16/04/2018,0.00,,32.00,,"-301,439.15"
,IN,AR,30311314,1005,100,,Invoice,,,,,,16/04/2018,16/04/2018,0.00,,12.00,,"-301,451.15"
,IN,AR,30311334,1005,100,,Invoice,,,,,,16/04/2018,16/04/2018,0.00,,8.26,,"-301,459.41"
,IN,AR,30311340,1005,100,,Invoice,,,,,,16/04/2018,16/04/2018,0.00,,8.26,,"-301,467.67"
,IN,AR,30311353,1005,100,,Invoice,,,,,,16/04/2018,16/04/2018,0.00,,5.84,,"-301,473.51"
,IN,AR,30311375,1005,100,,Invoice,,,,,,16/04/2018,16/04/2018,0.00,,14.00,,"-301,487.51"
,IN,AR,30311383,1005,100,,Invoice,,,,,,16/04/2018,16/04/2018,0.00,,10.93,,"-301,498.44"
,IN,AR,30311459,1005,100,,Invoice,,,,,,16/04/2018,16/04/2018,0.00,,14.49,,"-301,512.93"
,IN,AR,30311475,1005,100,,Invoice,,,,,,16/04/2018,16/04/2018,0.00,,22.71,,"-301,535.64"
,IN,AR,30311481,1005,100,,Invoice,,,,,,16/04/2018,16/04/2018,0.00,,7.29,,"-301,542.93"
,IN,AR,30311491,1005,100,,Invoice,,,,,,16/04/2018,16/04/2018,0.00,,11.15,,"-301,554.08"
,IN,AR,30311499,1005,100,,Invoice,,,,,,16/04/2018,16/04/2018,0.00,,18.09,,"-301,572.17"
,IN,AR,30311517,1005,100,,Invoice,,,,,,16/04/2018,16/04/2018,0.00,,5.17,,"-301,577.34"
,IN,AR,30311537,1005,100,,Invoice,,,,,,16/04/2018,16/04/2018,0.00,,6.89,,"-301,584.23"
,IN,AR,30311544,1005,100,,Invoice,,,,,,16/04/2018,16/04/2018,0.00,,5.25,,"-301,589.48"
,IN,AR,30311568,1005,100,,Invoice,,,,,,16/04/2018,16/04/2018,0.00,,61.02,,"-301,650.50"
,IN,AR,30311569,1005,100,,Invoice,,,,,,16/04/2018,16/04/2018,0.00,,28.47,,"-301,678.97"
,IN,AR,30311607,1005,100,,Invoice,,,,,,16/04/2018,16/04/2018,0.00,,11.86,,"-301,690.83"
,IN,AR,30311612,1005,100,,Invoice,,,,,,16/04/2018,16/04/2018,0.00,,7.76,,"-301,698.59"
,IN,AR,30311620,1005,100,,Invoice,,,,,,16/04/2018,16/04/2018,0.00,,44.37,,"-301,742.96"
,IN,AR,30311654,1005,100,,Invoice,,,,,,16/04/2018,16/04/2018,0.00,,88.19,,"-301,831.15"
,IN,AR,30311669,1005,100,,Invoice,,,,,,16/04/2018,16/04/2018,0.00,,40.68,,"-301,871.83"
,IN,AR,30311690,1005,100,,Invoice,,,,,,16/04/2018,16/04/2018,0.00,,23.90,,"-301,895.73"
,IN,AR,30311700,1005,100,,Invoice,,,,,,16/04/2018,16/04/2018,0.00,,28.98,,"-301,924.71"
,IN,AR,30311714,1005,100,,Invoice,,,,,,16/04/2018,16/04/2018,0.00,,15.04,,"-301,939.75"
,IN,AR,30311728,1005,100,,Invoice,,,,,,16/04/2018,16/04/2018,0.00,,8.26,,"-301,948.01"
,IN,AR,30311741,1005,100,,Invoice,,,,,,16/04/2018,16/04/2018,0.00,,2.12,,"-301,950.13"
,IN,AR,30311761,1005,100,,Invoice,,,,,,16/04/2018,16/04/2018,0.00,,36.44,,"-301,986.57"
,IN,AR,30311776,1005,100,,Invoice,,,,,,16/04/2018,16/04/2018,0.00,,10.17,,"-301,996.74"
,IN,AR,30311859,1005,100,,Invoice,,,,,,16/04/2018,16/04/2018,0.00,,25.42,,"-302,022.16"
,IN,AR,30311874,1005,100,,Invoice,,,,,,16/04/2018,16/04/2018,0.00,,12.20,,"-302,034.36"
,IN,AR,30311911,1005,100,,Invoice,,,,,,16/04/2018,16/04/2018,0.00,,3.64,,"-302,038.00"
,IN,AR,30311916,1005,100,,Invoice,,,,,,16/04/2018,16/04/2018,0.00,,10.93,,"-302,048.93"
,IN,AR,30311941,1005,100,,Invoice,,,,,,16/04/2018,16/04/2018,0.00,,16.53,,"-302,065.46"
,IN,AR,30311945,1005,100,,Invoice,,,,,,16/04/2018,16/04/2018,0.00,,7.29,,"-302,072.75"
,IN,AR,30311950,1005,100,,Invoice,,,,,,16/04/2018,16/04/2018,0.00,,8.17,,"-302,080.92"
,IN,AR,30311962,1005,100,,Invoice,,,,,,16/04/2018,16/04/2018,0.00,,9.19,,"-302,090.11"
,IN,AR,30311970,1005,100,,Invoice,,,,,,16/04/2018,16/04/2018,0.00,,19.64,,"-302,109.75"
,IN,AR,30311978,1005,100,,Invoice,,,,,,16/04/2018,16/04/2018,0.00,,2.54,,"-302,112.29"
,IN,AR,30311981,1005,100,,Invoice,,,,,,16/04/2018,16/04/2018,0.00,,7.29,,"-302,119.58"
,IN,AR,30312030,1005,100,,Invoice,,,,,,16/04/2018,16/04/2018,0.00,,54.66,,"-302,174.24"
,IN,AR,30312045,1005,100,,Invoice,,,,,,16/04/2018,16/04/2018,0.00,,73.22,,"-302,247.46"
,IN,AR,30312057,1005,100,,Invoice,,,,,,16/04/2018,16/04/2018,0.00,,40.00,,"-302,287.46"
,IN,AR,30312104,1005,100,,Invoice,,,,,,16/04/2018,16/04/2018,0.00,,7.75,,"-302,295.21"
,IN,AR,30312120,1005,100,,Invoice,,,,,,16/04/2018,16/04/2018,0.00,,32.83,,"-302,328.04"
,IN,AR,30312122,1005,100,,Invoice,,,,,,16/04/2018,16/04/2018,0.00,,11.11,,"-302,339.15"
,IN,AR,30312134,1005,100,,Invoice,,,,,,16/04/2018,16/04/2018,0.00,,54.66,,"-302,393.81"
,IN,AR,30312135,1005,100,,Invoice,,,,,,16/04/2018,16/04/2018,0.00,,54.66,,"-302,448.47"
,IN,AR,30312160,1005,100,,Invoice,,,,,,16/04/2018,16/04/2018,0.00,,54.66,,"-302,503.13"
,IN,AR,30312187,1005,100,,Invoice,,,,,,16/04/2018,16/04/2018,0.00,,29.15,,"-302,532.28"
,IN,AR,30312214,1005,100,,Invoice,,,,,,16/04/2018,16/04/2018,0.00,,3.64,,"-302,535.92"
,IN,AR,30312238,1005,100,,Invoice,,,,,,16/04/2018,16/04/2018,0.00,,7.29,,"-302,543.21"
,IN,AR,30312243,1005,100,,Invoice,,,,,,16/04/2018,16/04/2018,0.00,,54.66,,"-302,597.87"
,IN,AR,30312287,1005,100,,Invoice,,,,,,16/04/2018,16/04/2018,0.00,,4.29,,"-302,602.16"
,IN,AR,30312294,1005,100,,Invoice,,,,,,16/04/2018,16/04/2018,0.00,,14.58,,"-302,616.74"
,IN,AR,30312370,1005,100,,Invoice,,,,,,16/04/2018,16/04/2018,0.00,,4.29,,"-302,621.03"
,IN,AR,30312385,1005,100,,Invoice,,,,,,16/04/2018,16/04/2018,0.00,,28.06,,"-302,649.09"
,IN,AR,30312447,1005,100,,Invoice,,,,,,16/04/2018,16/04/2018,0.00,,8.02,,"-302,657.11"
,IN,AR,30312470,1005,100,,Invoice,,,,,,16/04/2018,16/04/2018,0.00,,9.84,,"-302,666.95"
,IN,AR,30312477,1005,100,,Invoice,,,,,,16/04/2018,16/04/2018,0.00,,7.88,,"-302,674.83"
,IN,AR,30312538,1005,100,,Invoice,,,,,,16/04/2018,16/04/2018,0.00,,28.01,,"-302,702.84"
,IN,AR,30312584,1005,100,,Invoice,,,,,,16/04/2018,16/04/2018,0.00,,42.24,,"-302,745.08"
,IN,AR,30312626,1005,100,,Invoice,,,,,,16/04/2018,16/04/2018,0.00,,28.99,,"-302,774.07"
,IN,AR,30312631,1005,100,,Invoice,,,,,,16/04/2018,16/04/2018,0.00,,167.80,,"-302,941.87"
,IN,AR,30312642,1005,100,,Invoice,,,,,,16/04/2018,16/04/2018,0.00,,22.44,,"-302,964.31"
,IN,AR,30312682,1005,100,,Invoice,,,,,,16/04/2018,16/04/2018,0.00,,4.08,,"-302,968.39"
,IN,AR,30312714,1005,100,,Invoice,,,,,,16/04/2018,16/04/2018,0.00,,9.10,,"-302,977.49"
,IN,AR,30312716,1005,100,,Invoice,,,,,,16/04/2018,16/04/2018,0.00,,29.15,,"-303,006.64"
,IN,AR,30312728,1005,100,,Invoice,,,,,,16/04/2018,16/04/2018,0.00,,37.37,,"-303,044.01"
,IN,AR,30312750,1005,100,,Invoice,,,,,,16/04/2018,16/04/2018,0.00,,9.56,,"-303,053.57"
,IN,AR,30312804,1005,100,,Invoice,,,,,,16/04/2018,16/04/2018,0.00,,12.00,,"-303,065.57"
,IN,AR,30312810,1005,100,,Invoice,,,,,,16/04/2018,16/04/2018,0.00,,7.53,,"-303,073.10"
,IN,AR,30312811,1005,100,,Invoice,,,,,,16/04/2018,16/04/2018,0.00,,3.76,,"-303,076.86"
,IN,AR,30312914,1005,100,,Invoice,,,,,,16/04/2018,16/04/2018,0.00,,10.47,,"-303,087.33"
,IN,AR,30312937,1005,100,,Invoice,,,,,,16/04/2018,16/04/2018,0.00,,6.13,,"-303,093.46"
,IN,AR,30312990,1005,100,,Invoice,,,,,,16/04/2018,16/04/2018,0.00,,17.54,,"-303,111.00"
,IN,AR,30313009,1005,100,,Invoice,,,,,,16/04/2018,16/04/2018,0.00,,2.00,,"-303,113.00"
,IN,AR,30313010,1005,100,,Invoice,,,,,,16/04/2018,16/04/2018,0.00,,6.00,,"-303,119.00"
,IN,AR,30313041,1005,100,,Invoice,,,,,,16/04/2018,16/04/2018,0.00,,6.23,,"-303,125.23"
,IN,AR,30313042,1005,100,,Invoice,,,,,,16/04/2018,16/04/2018,0.00,,8.31,,"-303,133.54"
,IN,AR,30313070,1005,100,,Invoice,,,,,,16/04/2018,16/04/2018,0.00,,9.84,,"-303,143.38"
,CN,AR,31017724,1005,100,,Credit Note,,,,,,17/04/2018,17/04/2018,29.15,,0.00,,"-303,114.23"
,CN,AR,31017842,1005,100,,Credit Note,,,,,,17/04/2018,17/04/2018,"2,332.20",,0.00,,"-300,782.03"
,CS,AR,32002650,1005,100,,Cash sale,,,,,,17/04/2018,17/04/2018,0.00,,3.64,,"-300,785.67"
,CS,AR,32002657,1005,100,,Cash sale,,,,,,17/04/2018,17/04/2018,0.00,,7.29,,"-300,792.96"
,CS,AR,32002673,1005,100,,Cash sale,,,,,,17/04/2018,17/04/2018,0.00,,7.29,,"-300,800.25"
,CS,AR,32002690,1005,100,,Cash sale,,,,,,17/04/2018,17/04/2018,0.00,,6.02,,"-300,806.27"
,CS,AR,32002724,1005,100,,Cash sale,,,,,,17/04/2018,17/04/2018,0.00,,10.93,,"-300,817.20"
,CS,AR,32002747,1005,100,,Cash sale,,,,,,17/04/2018,17/04/2018,0.00,,14.58,,"-300,831.78"
,CS,AR,32002792,1005,100,,Cash sale,,,,,,17/04/2018,17/04/2018,0.00,,10.17,,"-300,841.95"
,CS,AR,32002802,1005,100,,Cash sale,,,,,,17/04/2018,17/04/2018,0.00,,5.17,,"-300,847.12"
,CS,AR,32002807,1005,100,,Cash sale,,,,,,17/04/2018,17/04/2018,0.00,,4.32,,"-300,851.44"
,CS,AR,32002822,1005,100,,Cash sale,,,,,,17/04/2018,17/04/2018,0.00,,5.17,,"-300,856.61"
,CS,AR,32002832,1005,100,,Cash sale,,,,,,17/04/2018,17/04/2018,0.00,,1.95,,"-300,858.56"
,CS,AR,32002840,1005,100,,Cash sale,,,,,,17/04/2018,17/04/2018,0.00,,11.36,,"-300,869.92"
,CS,AR,32002905,1005,100,,Cash sale,,,,,,17/04/2018,17/04/2018,0.00,,7.75,,"-300,877.67"
,CS,AR,32002917,1005,100,,Cash sale,,,,,,17/04/2018,17/04/2018,0.00,,3.90,,"-300,881.57"
,CS,AR,32002924,1005,100,,Cash sale,,,,,,17/04/2018,17/04/2018,0.00,,8.98,,"-300,890.55"
,CS,AR,32002941,1005,100,,Cash sale,,,,,,17/04/2018,17/04/2018,0.00,,6.86,,"-300,897.41"
,CS,AR,32002952,1005,100,,Cash sale,,,,,,17/04/2018,17/04/2018,0.00,,5.85,,"-300,903.26"
,CS,AR,32002962,1005,100,,Cash sale,,,,,,17/04/2018,17/04/2018,0.00,,3.64,,"-300,906.90"
,CS,AR,32002978,1005,100,,Cash sale,,,,,,17/04/2018,17/04/2018,0.00,,7.75,,"-300,914.65"
,CS,AR,32002981,1005,100,,Cash sale,,,,,,17/04/2018,17/04/2018,0.00,,7.29,,"-300,921.94"
,CS,AR,32002994,1005,100,,Cash sale,,,,,,17/04/2018,17/04/2018,0.00,,8.39,,"-300,930.33"
,CS,AR,32002997,1005,100,,Cash sale,,,,,,17/04/2018,17/04/2018,0.00,,2.58,,"-300,932.91"
,CS,AR,32003003,1005,100,,Cash sale,,,,,,17/04/2018,17/04/2018,0.00,,5.85,,"-300,938.76"
,CS,AR,32003005,1005,100,,Cash sale,,,,,,17/04/2018,17/04/2018,0.00,,14.58,,"-300,953.34"
,CS,AR,32003010,1005,100,,Cash sale,,,,,,17/04/2018,17/04/2018,0.00,,7.29,,"-300,960.63"
,CS,AR,32003049,1005,100,,Cash sale,,,,,,17/04/2018,17/04/2018,0.00,,7.29,,"-300,967.92"
,CS,AR,32003078,1005,100,,Cash sale,,,,,,17/04/2018,17/04/2018,0.00,,7.29,,"-300,975.21"
,CS,AR,32003102,1005,100,,Cash sale,,,,,,17/04/2018,17/04/2018,0.00,,19.30,,"-300,994.51"
,CS,AR,32003109,1005,100,,Cash sale,,,,,,17/04/2018,17/04/2018,0.00,,5.64,,"-301,000.15"
,CS,AR,32003111,1005,100,,Cash sale,,,,,,17/04/2018,17/04/2018,0.00,,14.58,,"-301,014.73"
,CS,AR,32003178,1005,100,,Cash sale,,,,,,17/04/2018,17/04/2018,0.00,,7.63,,"-301,022.36"
,CS,AR,32003182,1005,100,,Cash sale,,,,,,17/04/2018,17/04/2018,0.00,,28.00,,"-301,050.36"
,CS,AR,32003197,1005,100,,Cash sale,,,,,,17/04/2018,17/04/2018,0.00,,13.77,,"-301,064.13"
,CS,AR,32003239,1005,100,,Cash sale,,,,,,17/04/2018,17/04/2018,0.00,,2.97,,"-301,067.10"
,CS,AR,32003244,1005,100,,Cash sale,,,,,,17/04/2018,17/04/2018,0.00,,9.10,,"-301,076.20"
,CS,AR,32003248,1005,100,,Cash sale,,,,,,17/04/2018,17/04/2018,0.00,,14.58,,"-301,090.78"
,CS,AR,32003265,1005,100,,Cash sale,,,,,,17/04/2018,17/04/2018,0.00,,2.75,,"-301,093.53"
,CS,AR,32003315,1005,100,,Cash sale,,,,,,17/04/2018,17/04/2018,0.00,,10.93,,"-301,104.46"
,CS,AR,32003318,1005,100,,Cash sale,,,,,,17/04/2018,17/04/2018,0.00,,3.64,,"-301,108.10"
,CS,AR,32003358,1005,100,,Cash sale,,,,,,17/04/2018,17/04/2018,0.00,,29.15,,"-301,137.25"
,CS,AR,32003361,1005,100,,Cash sale,,,,,,17/04/2018,17/04/2018,0.00,,14.58,,"-301,151.83"
,CS,AR,32003364,1005,100,,Cash sale,,,,,,17/04/2018,17/04/2018,0.00,,13.69,,"-301,165.52"
,CS,AR,32003393,1005,100,,Cash sale,,,,,,17/04/2018,17/04/2018,0.00,,7.75,,"-301,173.27"
,IN,AR,30311079,1005,100,,Invoice,,,,,,17/04/2018,17/04/2018,0.00,,12.03,,"-301,185.30"
,IN,AR,30311223,1005,100,,Invoice,,,,,,17/04/2018,17/04/2018,0.00,,15.93,,"-301,201.23"
,IN,AR,30311224,1005,100,,Invoice,,,,,,17/04/2018,17/04/2018,0.00,,3.98,,"-301,205.21"
,IN,AR,30311239,1005,100,,Invoice,,,,,,17/04/2018,17/04/2018,0.00,,26.10,,"-301,231.31"
,IN,AR,30311275,1005,100,,Invoice,,,,,,17/04/2018,17/04/2018,0.00,,14.58,,"-301,245.89"
,IN,AR,30311282,1005,100,,Invoice,,,,,,17/04/2018,17/04/2018,0.00,,10.93,,"-301,256.82"
,IN,AR,30311304,1005,100,,Invoice,,,,,,17/04/2018,17/04/2018,0.00,,364.41,,"-301,621.23"
,IN,AR,30311329,1005,100,,Invoice,,,,,,17/04/2018,17/04/2018,0.00,,3.64,,"-301,624.87"
,IN,AR,30311349,1005,100,,Invoice,,,,,,17/04/2018,17/04/2018,0.00,,18.22,,"-301,643.09"
,IN,AR,30311411,1005,100,,Invoice,,,,,,17/04/2018,17/04/2018,0.00,,14.58,,"-301,657.67"
,IN,AR,30311424,1005,100,,Invoice,,,,,,17/04/2018,17/04/2018,0.00,,9.70,,"-301,667.37"
,IN,AR,30311442,1005,100,,Invoice,,,,,,17/04/2018,17/04/2018,0.00,,13.74,,"-301,681.11"
,IN,AR,30311444,1005,100,,Invoice,,,,,,17/04/2018,17/04/2018,0.00,,7.29,,"-301,688.40"
,IN,AR,30311451,1005,100,,Invoice,,,,,,17/04/2018,17/04/2018,0.00,,7.29,,"-301,695.69"
,IN,AR,30311453,1005,100,,Invoice,,,,,,17/04/2018,17/04/2018,0.00,,18.05,,"-301,713.74"
,IN,AR,30311520,1005,100,,Invoice,,,,,,17/04/2018,17/04/2018,0.00,,32.95,,"-301,746.69"
,IN,AR,30311524,1005,100,,Invoice,,,,,,17/04/2018,17/04/2018,0.00,,2.32,,"-301,749.01"
,IN,AR,30311542,1005,100,,Invoice,,,,,,17/04/2018,17/04/2018,0.00,,18.22,,"-301,767.23"
,IN,AR,30311551,1005,100,,Invoice,,,,,,17/04/2018,17/04/2018,0.00,,4.32,,"-301,771.55"
,IN,AR,30311554,1005,100,,Invoice,,,,,,17/04/2018,17/04/2018,0.00,,8.47,,"-301,780.02"
,IN,AR,30311576,1005,100,,Invoice,,,,,,17/04/2018,17/04/2018,0.00,,8.47,,"-301,788.49"
,IN,AR,30311670,1005,100,,Invoice,,,,,,17/04/2018,17/04/2018,0.00,,86.44,,"-301,874.93"
,IN,AR,30311691,1005,100,,Invoice,,,,,,17/04/2018,17/04/2018,0.00,,7.17,,"-301,882.10"
,IN,AR,30311744,1005,100,,Invoice,,,,,,17/04/2018,17/04/2018,0.00,,16.34,,"-301,898.44"
,IN,AR,30311783,1005,100,,Invoice,,,,,,17/04/2018,17/04/2018,0.00,,6.74,,"-301,905.18"
,IN,AR,30311797,1005,100,,Invoice,,,,,,17/04/2018,17/04/2018,0.00,,3.19,,"-301,908.37"
,IN,AR,30311819,1005,100,,Invoice,,,,,,17/04/2018,17/04/2018,0.00,,5.08,,"-301,913.45"
,IN,AR,30311824,1005,100,,Invoice,,,,,,17/04/2018,17/04/2018,0.00,,10.93,,"-301,924.38"
,IN,AR,30311838,1005,100,,Invoice,,,,,,17/04/2018,17/04/2018,0.00,,7.29,,"-301,931.67"
,IN,AR,30311853,1005,100,,Invoice,,,,,,17/04/2018,17/04/2018,0.00,,49.83,,"-301,981.50"
,IN,AR,30311876,1005,100,,Invoice,,,,,,17/04/2018,17/04/2018,0.00,,4.08,,"-301,985.58"
,IN,AR,30311883,1005,100,,Invoice,,,,,,17/04/2018,17/04/2018,0.00,,11.57,,"-301,997.15"
,IN,AR,30311895,1005,100,,Invoice,,,,,,17/04/2018,17/04/2018,0.00,,10.17,,"-302,007.32"
,IN,AR,30311898,1005,100,,Invoice,,,,,,17/04/2018,17/04/2018,0.00,,5.85,,"-302,013.17"
,IN,AR,30311901,1005,100,,Invoice,,,,,,17/04/2018,17/04/2018,0.00,,10.53,,"-302,023.70"
,IN,AR,30311921,1005,100,,Invoice,,,,,,17/04/2018,17/04/2018,0.00,,8.47,,"-302,032.17"
,IN,AR,30311925,1005,100,,Invoice,,,,,,17/04/2018,17/04/2018,0.00,,6.36,,"-302,038.53"
,IN,AR,30311932,1005,100,,Invoice,,,,,,17/04/2018,17/04/2018,0.00,,10.59,,"-302,049.12"
,IN,AR,30311947,1005,100,,Invoice,,,,,,17/04/2018,17/04/2018,0.00,,7.63,,"-302,056.75"
,IN,AR,30311983,1005,100,,Invoice,,,,,,17/04/2018,17/04/2018,0.00,,8.47,,"-302,065.22"
,IN,AR,30311989,1005,100,,Invoice,,,,,,17/04/2018,17/04/2018,0.00,,23.73,,"-302,088.95"
,IN,AR,30312032,1005,100,,Invoice,,,,,,17/04/2018,17/04/2018,0.00,,3.64,,"-302,092.59"
,IN,AR,30312042,1005,100,,Invoice,,,,,,17/04/2018,17/04/2018,0.00,,36.36,,"-302,128.95"
,IN,AR,30312061,1005,100,,Invoice,,,,,,17/04/2018,17/04/2018,0.00,,24.56,,"-302,153.51"
,IN,AR,30312096,1005,100,,Invoice,,,,,,17/04/2018,17/04/2018,0.00,,5.59,,"-302,159.10"
,IN,AR,30312107,1005,100,,Invoice,,,,,,17/04/2018,17/04/2018,0.00,,11.70,,"-302,170.80"
,IN,AR,30312111,1005,100,,Invoice,,,,,,17/04/2018,17/04/2018,0.00,,11.36,,"-302,182.16"
,IN,AR,30312128,1005,100,,Invoice,,,,,,17/04/2018,17/04/2018,0.00,,8.98,,"-302,191.14"
,IN,AR,30312169,1005,100,,Invoice,,,,,,17/04/2018,17/04/2018,0.00,,18.22,,"-302,209.36"
,IN,AR,30312185,1005,100,,Invoice,,,,,,17/04/2018,17/04/2018,0.00,,25.73,,"-302,235.09"
,IN,AR,30312200,1005,100,,Invoice,,,,,,17/04/2018,17/04/2018,0.00,,3.53,,"-302,238.62"
,IN,AR,30312217,1005,100,,Invoice,,,,,,17/04/2018,17/04/2018,0.00,,14.58,,"-302,253.20"
,IN,AR,30312256,1005,100,,Invoice,,,,,,17/04/2018,17/04/2018,0.00,,14.58,,"-302,267.78"
,IN,AR,30312278,1005,100,,Invoice,,,,,,17/04/2018,17/04/2018,0.00,,29.15,,"-302,296.93"
,IN,AR,30312295,1005,100,,Invoice,,,,,,17/04/2018,17/04/2018,0.00,,182.20,,"-302,479.13"
,IN,AR,30312358,1005,100,,Invoice,,,,,,17/04/2018,17/04/2018,0.00,,51.10,,"-302,530.23"
,IN,AR,30312405,1005,100,,Invoice,,,,,,17/04/2018,17/04/2018,0.00,,364.41,,"-302,894.64"
,IN,AR,30312413,1005,100,,Invoice,,,,,,17/04/2018,17/04/2018,0.00,,36.74,,"-302,931.38"
,IN,AR,30312418,1005,100,,Invoice,,,,,,17/04/2018,17/04/2018,0.00,,193.86,,"-303,125.24"
,IN,AR,30312448,1005,100,,Invoice,,,,,,17/04/2018,17/04/2018,0.00,,6.42,,"-303,131.66"
,IN,AR,30312482,1005,100,,Invoice,,,,,,17/04/2018,17/04/2018,0.00,,9.15,,"-303,140.81"
,IN,AR,30312513,1005,100,,Invoice,,,,,,17/04/2018,17/04/2018,0.00,,8.90,,"-303,149.71"
,IN,AR,30312525,1005,100,,Invoice,,,,,,17/04/2018,17/04/2018,0.00,,17.80,,"-303,167.51"
,IN,AR,30312544,1005,100,,Invoice,,,,,,17/04/2018,17/04/2018,0.00,,18.01,,"-303,185.52"
,IN,AR,30312611,1005,100,,Invoice,,,,,,17/04/2018,17/04/2018,0.00,,11.95,,"-303,197.47"
,IN,AR,30312636,1005,100,,Invoice,,,,,,17/04/2018,17/04/2018,0.00,,8.21,,"-303,205.68"
,IN,AR,30312647,1005,100,,Invoice,,,,,,17/04/2018,17/04/2018,0.00,,29.15,,"-303,234.83"
,IN,AR,30312672,1005,100,,Invoice,,,,,,17/04/2018,17/04/2018,0.00,,124.00,,"-303,358.83"
,IN,AR,30312677,1005,100,,Invoice,,,,,,17/04/2018,17/04/2018,0.00,,12.14,,"-303,370.97"
,IN,AR,30312684,1005,100,,Invoice,,,,,,17/04/2018,17/04/2018,0.00,,29.15,,"-303,400.12"
,IN,AR,30312691,1005,100,,Invoice,,,,,,17/04/2018,17/04/2018,0.00,,26.10,,"-303,426.22"
,IN,AR,30312713,1005,100,,Invoice,,,,,,17/04/2018,17/04/2018,0.00,,5.08,,"-303,431.30"
,IN,AR,30312767,1005,100,,Invoice,,,,,,17/04/2018,17/04/2018,0.00,,78.64,,"-303,509.94"
,IN,AR,30312771,1005,100,,Invoice,,,,,,17/04/2018,17/04/2018,0.00,,61.44,,"-303,571.38"
,IN,AR,30312778,1005,100,,Invoice,,,,,,17/04/2018,17/04/2018,0.00,,18.98,,"-303,590.36"
,IN,AR,30312779,1005,100,,Invoice,,,,,,17/04/2018,17/04/2018,0.00,,33.22,,"-303,623.58"
,IN,AR,30312780,1005,100,,Invoice,,,,,,17/04/2018,17/04/2018,0.00,,99.67,,"-303,723.25"
,IN,AR,30312819,1005,100,,Invoice,,,,,,17/04/2018,17/04/2018,0.00,,1.75,,"-303,725.00"
,IN,AR,30312825,1005,100,,Invoice,,,,,,17/04/2018,17/04/2018,0.00,,8.00,,"-303,733.00"
,IN,AR,30312827,1005,100,,Invoice,,,,,,17/04/2018,17/04/2018,0.00,,2.97,,"-303,735.97"
,IN,AR,30312836,1005,100,,Invoice,,,,,,17/04/2018,17/04/2018,0.00,,96.81,,"-303,832.78"
,IN,AR,30312846,1005,100,,Invoice,,,,,,17/04/2018,17/04/2018,0.00,,10.93,,"-303,843.71"
,IN,AR,30312858,1005,100,,Invoice,,,,,,17/04/2018,17/04/2018,0.00,,5.26,,"-303,848.97"
,IN,AR,30312862,1005,100,,Invoice,,,,,,17/04/2018,17/04/2018,0.00,,29.15,,"-303,878.12"
,IN,AR,30312875,1005,100,,Invoice,,,,,,17/04/2018,17/04/2018,0.00,,8.21,,"-303,886.33"
,IN,AR,30312897,1005,100,,Invoice,,,,,,17/04/2018,17/04/2018,0.00,,7.29,,"-303,893.62"
,IN,AR,30312910,1005,100,,Invoice,,,,,,17/04/2018,17/04/2018,0.00,,145.76,,"-304,039.38"
,IN,AR,30312938,1005,100,,Invoice,,,,,,17/04/2018,17/04/2018,0.00,,30.64,,"-304,070.02"
,IN,AR,30312947,1005,100,,Invoice,,,,,,17/04/2018,17/04/2018,0.00,,7.29,,"-304,077.31"
,IN,AR,30312957,1005,100,,Invoice,,,,,,17/04/2018,17/04/2018,0.00,,"2,332.20",,"-306,409.51"
,IN,AR,30312976,1005,100,,Invoice,,,,,,17/04/2018,17/04/2018,0.00,,14.58,,"-306,424.09"
,IN,AR,30313000,1005,100,,Invoice,,,,,,17/04/2018,17/04/2018,0.00,,12.14,,"-306,436.23"
,IN,AR,30313043,1005,100,,Invoice,,,,,,17/04/2018,17/04/2018,0.00,,10.38,,"-306,446.61"
,IN,AR,30313044,1005,100,,Invoice,,,,,,17/04/2018,17/04/2018,0.00,,12.46,,"-306,459.07"
,IN,AR,30313083,1005,100,,Invoice,,,,,,17/04/2018,17/04/2018,0.00,,14.58,,"-306,473.65"
,CN,AR,31017799,1005,100,,Credit Note,,,,,,18/04/2018,18/04/2018,393.56,,0.00,,"-306,080.09"
,CN,AR,31017854,1005,100,,Credit Note,,,,,,18/04/2018,18/04/2018,3.64,,0.00,,"-306,076.45"
,CS,AR,32002595,1005,100,,Cash sale,,,,,,18/04/2018,18/04/2018,0.00,,14.58,,"-306,091.03"
,CS,AR,32002612,1005,100,,Cash sale,,,,,,18/04/2018,18/04/2018,0.00,,55.19,,"-306,146.22"
,CS,AR,32002655,1005,100,,Cash sale,,,,,,18/04/2018,18/04/2018,0.00,,3.64,,"-306,149.86"
,CS,AR,32002684,1005,100,,Cash sale,,,,,,18/04/2018,18/04/2018,0.00,,3.64,,"-306,153.50"
,CS,AR,32002703,1005,100,,Cash sale,,,,,,18/04/2018,18/04/2018,0.00,,3.64,,"-306,157.14"
,CS,AR,32002705,1005,100,,Cash sale,,,,,,18/04/2018,18/04/2018,0.00,,7.29,,"-306,164.43"
,CS,AR,32002707,1005,100,,Cash sale,,,,,,18/04/2018,18/04/2018,0.00,,7.29,,"-306,171.72"
,CS,AR,32002742,1005,100,,Cash sale,,,,,,18/04/2018,18/04/2018,0.00,,10.93,,"-306,182.65"
,CS,AR,32002748,1005,100,,Cash sale,,,,,,18/04/2018,18/04/2018,0.00,,29.15,,"-306,211.80"
,CS,AR,32002856,1005,100,,Cash sale,,,,,,18/04/2018,18/04/2018,0.00,,7.29,,"-306,219.09"
,CS,AR,32002872,1005,100,,Cash sale,,,,,,18/04/2018,18/04/2018,0.00,,21.06,,"-306,240.15"
,CS,AR,32002876,1005,100,,Cash sale,,,,,,18/04/2018,18/04/2018,0.00,,6.43,,"-306,246.58"
,CS,AR,32002880,1005,100,,Cash sale,,,,,,18/04/2018,18/04/2018,0.00,,7.29,,"-306,253.87"
,CS,AR,32002893,1005,100,,Cash sale,,,,,,18/04/2018,18/04/2018,0.00,,14.58,,"-306,268.45"
,CS,AR,32002949,1005,100,,Cash sale,,,,,,18/04/2018,18/04/2018,0.00,,4.32,,"-306,272.77"
,CS,AR,32002975,1005,100,,Cash sale,,,,,,18/04/2018,18/04/2018,0.00,,7.29,,"-306,280.06"
,CS,AR,32003030,1005,100,,Cash sale,,,,,,18/04/2018,18/04/2018,0.00,,14.58,,"-306,294.64"
,CS,AR,32003062,1005,100,,Cash sale,,,,,,18/04/2018,18/04/2018,0.00,,7.29,,"-306,301.93"
,CS,AR,32003104,1005,100,,Cash sale,,,,,,18/04/2018,18/04/2018,0.00,,5.34,,"-306,307.27"
,CS,AR,32003149,1005,100,,Cash sale,,,,,,18/04/2018,18/04/2018,0.00,,14.58,,"-306,321.85"
,CS,AR,32003155,1005,100,,Cash sale,,,,,,18/04/2018,18/04/2018,0.00,,14.58,,"-306,336.43"
,CS,AR,32003170,1005,100,,Cash sale,,,,,,18/04/2018,18/04/2018,0.00,,3.64,,"-306,340.07"
,CS,AR,32003233,1005,100,,Cash sale,,,,,,18/04/2018,18/04/2018,0.00,,9.15,,"-306,349.22"
,CS,AR,32003240,1005,100,,Cash sale,,,,,,18/04/2018,18/04/2018,0.00,,10.93,,"-306,360.15"
,CS,AR,32003269,1005,100,,Cash sale,,,,,,18/04/2018,18/04/2018,0.00,,14.83,,"-306,374.98"
,CS,AR,32003277,1005,100,,Cash sale,,,,,,18/04/2018,18/04/2018,0.00,,9.03,,"-306,384.01"
,CS,AR,32003323,1005,100,,Cash sale,,,,,,18/04/2018,18/04/2018,0.00,,9.10,,"-306,393.11"
,CS,AR,32003327,1005,100,,Cash sale,,,,,,18/04/2018,18/04/2018,0.00,,7.29,,"-306,400.40"
,CS,AR,32003350,1005,100,,Cash sale,,,,,,18/04/2018,18/04/2018,0.00,,7.29,,"-306,407.69"
,CS,AR,32003352,1005,100,,Cash sale,,,,,,18/04/2018,18/04/2018,0.00,,3.64,,"-306,411.33"
,CS,AR,32003359,1005,100,,Cash sale,,,,,,18/04/2018,18/04/2018,0.00,,10.93,,"-306,422.26"
,CS,AR,32003383,1005,100,,Cash sale,,,,,,18/04/2018,18/04/2018,0.00,,5.49,,"-306,427.75"
,CS,AR,32003402,1005,100,,Cash sale,,,,,,18/04/2018,18/04/2018,0.00,,7.29,,"-306,435.04"
,IN,AR,30311083,1005,100,,Invoice,,,,,,18/04/2018,18/04/2018,0.00,,84.54,,"-306,519.58"
,IN,AR,30311124,1005,100,,Invoice,,,,,,18/04/2018,18/04/2018,0.00,,10.93,,"-306,530.51"
,IN,AR,30311131,1005,100,,Invoice,,,,,,18/04/2018,18/04/2018,0.00,,26.85,,"-306,557.36"
,IN,AR,30311132,1005,100,,Invoice,,,,,,18/04/2018,18/04/2018,0.00,,41.49,,"-306,598.85"
,IN,AR,30311141,1005,100,,Invoice,,,,,,18/04/2018,18/04/2018,0.00,,16.27,,"-306,615.12"
,IN,AR,30311148,1005,100,,Invoice,,,,,,18/04/2018,18/04/2018,0.00,,14.58,,"-306,629.70"
,IN,AR,30311151,1005,100,,Invoice,,,,,,18/04/2018,18/04/2018,0.00,,21.91,,"-306,651.61"
,IN,AR,30311159,1005,100,,Invoice,,,,,,18/04/2018,18/04/2018,0.00,,26.27,,"-306,677.88"
,IN,AR,30311160,1005,100,,Invoice,,,,,,18/04/2018,18/04/2018,0.00,,78.81,,"-306,756.69"
,IN,AR,30311164,1005,100,,Invoice,,,,,,18/04/2018,18/04/2018,0.00,,25.51,,"-306,782.20"
,IN,AR,30311240,1005,100,,Invoice,,,,,,18/04/2018,18/04/2018,0.00,,54.58,,"-306,836.78"
,IN,AR,30311265,1005,100,,Invoice,,,,,,18/04/2018,18/04/2018,0.00,,22.00,,"-306,858.78"
,IN,AR,30311272,1005,100,,Invoice,,,,,,18/04/2018,18/04/2018,0.00,,23.73,,"-306,882.51"
,IN,AR,30311292,1005,100,,Invoice,,,,,,18/04/2018,18/04/2018,0.00,,43.73,,"-306,926.24"
,IN,AR,30311296,1005,100,,Invoice,,,,,,18/04/2018,18/04/2018,0.00,,7.29,,"-306,933.53"
,IN,AR,30311359,1005,100,,Invoice,,,,,,18/04/2018,18/04/2018,0.00,,38.00,,"-306,971.53"
,IN,AR,30311367,1005,100,,Invoice,,,,,,18/04/2018,18/04/2018,0.00,,83.05,,"-307,054.58"
,IN,AR,30311376,1005,100,,Invoice,,,,,,18/04/2018,18/04/2018,0.00,,10.00,,"-307,064.58"
,IN,AR,30311407,1005,100,,Invoice,,,,,,18/04/2018,18/04/2018,0.00,,90.05,,"-307,154.63"
,IN,AR,30311408,1005,100,,Invoice,,,,,,18/04/2018,18/04/2018,0.00,,49.12,,"-307,203.75"
,IN,AR,30311447,1005,100,,Invoice,,,,,,18/04/2018,18/04/2018,0.00,,6.02,,"-307,209.77"
,IN,AR,30311471,1005,100,,Invoice,,,,,,18/04/2018,18/04/2018,0.00,,10.61,,"-307,220.38"
,IN,AR,30311547,1005,100,,Invoice,,,,,,18/04/2018,18/04/2018,0.00,,25.42,,"-307,245.80"
,IN,AR,30311556,1005,100,,Invoice,,,,,,18/04/2018,18/04/2018,0.00,,4.24,,"-307,250.04"
,IN,AR,30311558,1005,100,,Invoice,,,,,,18/04/2018,18/04/2018,0.00,,6.36,,"-307,256.40"
,IN,AR,30311581,1005,100,,Invoice,,,,,,18/04/2018,18/04/2018,0.00,,11.19,,"-307,267.59"
,IN,AR,30311621,1005,100,,Invoice,,,,,,18/04/2018,18/04/2018,0.00,,14.58,,"-307,282.17"
,IN,AR,30311632,1005,100,,Invoice,,,,,,18/04/2018,18/04/2018,0.00,,21.06,,"-307,303.23"
,IN,AR,30311638,1005,100,,Invoice,,,,,,18/04/2018,18/04/2018,0.00,,23.90,,"-307,327.13"
,IN,AR,30311655,1005,100,,Invoice,,,,,,18/04/2018,18/04/2018,0.00,,41.02,,"-307,368.15"
,IN,AR,30311671,1005,100,,Invoice,,,,,,18/04/2018,18/04/2018,0.00,,17.80,,"-307,385.95"
,IN,AR,30311672,1005,100,,Invoice,,,,,,18/04/2018,18/04/2018,0.00,,5.08,,"-307,391.03"
,IN,AR,30311738,1005,100,,Invoice,,,,,,18/04/2018,18/04/2018,0.00,,10.34,,"-307,401.37"
,IN,AR,30311752,1005,100,,Invoice,,,,,,18/04/2018,18/04/2018,0.00,,116.03,,"-307,517.40"
,IN,AR,30311756,1005,100,,Invoice,,,,,,18/04/2018,18/04/2018,0.00,,10.17,,"-307,527.57"
,IN,AR,30311777,1005,100,,Invoice,,,,,,18/04/2018,18/04/2018,0.00,,5.08,,"-307,532.65"
,IN,AR,30311798,1005,100,,Invoice,,,,,,18/04/2018,18/04/2018,0.00,,1.59,,"-307,534.24"
,IN,AR,30311851,1005,100,,Invoice,,,,,,18/04/2018,18/04/2018,0.00,,18.17,,"-307,552.41"
,IN,AR,30311868,1005,100,,Invoice,,,,,,18/04/2018,18/04/2018,0.00,,20.00,,"-307,572.41"
,IN,AR,30311971,1005,100,,Invoice,,,,,,18/04/2018,18/04/2018,0.00,,8.42,,"-307,580.83"
,IN,AR,30311990,1005,100,,Invoice,,,,,,18/04/2018,18/04/2018,0.00,,20.76,,"-307,601.59"
,IN,AR,30312002,1005,100,,Invoice,,,,,,18/04/2018,18/04/2018,0.00,,8.39,,"-307,609.98"
,IN,AR,30312003,1005,100,,Invoice,,,,,,18/04/2018,18/04/2018,0.00,,8.39,,"-307,618.37"
,IN,AR,30312036,1005,100,,Invoice,,,,,,18/04/2018,18/04/2018,0.00,,18.22,,"-307,636.59"
,IN,AR,30312070,1005,100,,Invoice,,,,,,18/04/2018,18/04/2018,0.00,,2.71,,"-307,639.30"
,IN,AR,30312076,1005,100,,Invoice,,,,,,18/04/2018,18/04/2018,0.00,,364.41,,"-308,003.71"
,IN,AR,30312125,1005,100,,Invoice,,,,,,18/04/2018,18/04/2018,0.00,,12.71,,"-308,016.42"
,IN,AR,30312132,1005,100,,Invoice,,,,,,18/04/2018,18/04/2018,0.00,,24.07,,"-308,040.49"
,IN,AR,30312140,1005,100,,Invoice,,,,,,18/04/2018,18/04/2018,0.00,,18.05,,"-308,058.54"
,IN,AR,30312192,1005,100,,Invoice,,,,,,18/04/2018,18/04/2018,0.00,,30.76,,"-308,089.30"
,IN,AR,30312201,1005,100,,Invoice,,,,,,18/04/2018,18/04/2018,0.00,,17.62,,"-308,106.92"
,IN,AR,30312209,1005,100,,Invoice,,,,,,18/04/2018,18/04/2018,0.00,,15.04,,"-308,121.96"
,IN,AR,30312242,1005,100,,Invoice,,,,,,18/04/2018,18/04/2018,0.00,,364.41,,"-308,486.37"
,IN,AR,30312248,1005,100,,Invoice,,,,,,18/04/2018,18/04/2018,0.00,,10.34,,"-308,496.71"
,IN,AR,30312257,1005,100,,Invoice,,,,,,18/04/2018,18/04/2018,0.00,,10.47,,"-308,507.18"
,IN,AR,30312258,1005,100,,Invoice,,,,,,18/04/2018,18/04/2018,0.00,,20.34,,"-308,527.52"
,IN,AR,30312267,1005,100,,Invoice,,,,,,18/04/2018,18/04/2018,0.00,,8.00,,"-308,535.52"
,IN,AR,30312311,1005,100,,Invoice,,,,,,18/04/2018,18/04/2018,0.00,,10.93,,"-308,546.45"
,IN,AR,30312313,1005,100,,Invoice,,,,,,18/04/2018,18/04/2018,0.00,,9.15,,"-308,555.60"
,IN,AR,30312364,1005,100,,Invoice,,,,,,18/04/2018,18/04/2018,0.00,,38.00,,"-308,593.60"
,IN,AR,30312378,1005,100,,Invoice,,,,,,18/04/2018,18/04/2018,0.00,,36.08,,"-308,629.68"
,IN,AR,30312390,1005,100,,Invoice,,,,,,18/04/2018,18/04/2018,0.00,,18.22,,"-308,647.90"
,IN,AR,30312397,1005,100,,Invoice,,,,,,18/04/2018,18/04/2018,0.00,,182.20,,"-308,830.10"
,IN,AR,30312400,1005,100,,Invoice,,,,,,18/04/2018,18/04/2018,0.00,,3.64,,"-308,833.74"
,IN,AR,30312408,1005,100,,Invoice,,,,,,18/04/2018,18/04/2018,0.00,,401.76,,"-309,235.50"
,IN,AR,30312422,1005,100,,Invoice,,,,,,18/04/2018,18/04/2018,0.00,,7.29,,"-309,242.79"
,IN,AR,30312449,1005,100,,Invoice,,,,,,18/04/2018,18/04/2018,0.00,,3.20,,"-309,245.99"
,IN,AR,30312450,1005,100,,Invoice,,,,,,18/04/2018,18/04/2018,0.00,,8.02,,"-309,254.01"
,IN,AR,30312451,1005,100,,Invoice,,,,,,18/04/2018,18/04/2018,0.00,,6.42,,"-309,260.43"
,IN,AR,30312452,1005,100,,Invoice,,,,,,18/04/2018,18/04/2018,0.00,,35.27,,"-309,295.70"
,IN,AR,30312453,1005,100,,Invoice,,,,,,18/04/2018,18/04/2018,0.00,,4.81,,"-309,300.51"
,IN,AR,30312454,1005,100,,Invoice,,,,,,18/04/2018,18/04/2018,0.00,,19.24,,"-309,319.75"
,IN,AR,30312455,1005,100,,Invoice,,,,,,18/04/2018,18/04/2018,0.00,,3.20,,"-309,322.95"
,IN,AR,30312456,1005,100,,Invoice,,,,,,18/04/2018,18/04/2018,0.00,,3.20,,"-309,326.15"
,IN,AR,30312490,1005,100,,Invoice,,,,,,18/04/2018,18/04/2018,0.00,,10.19,,"-309,336.34"
,IN,AR,30312499,1005,100,,Invoice,,,,,,18/04/2018,18/04/2018,0.00,,36.22,,"-309,372.56"
,IN,AR,30312555,1005,100,,Invoice,,,,,,18/04/2018,18/04/2018,0.00,,16.01,,"-309,388.57"
,IN,AR,30312577,1005,100,,Invoice,,,,,,18/04/2018,18/04/2018,0.00,,73.81,,"-309,462.38"
,IN,AR,30312589,1005,100,,Invoice,,,,,,18/04/2018,18/04/2018,0.00,,14.58,,"-309,476.96"
,IN,AR,30312603,1005,100,,Invoice,,,,,,18/04/2018,18/04/2018,0.00,,39.95,,"-309,516.91"
,IN,AR,30312661,1005,100,,Invoice,,,,,,18/04/2018,18/04/2018,0.00,,22.37,,"-309,539.28"
,IN,AR,30312664,1005,100,,Invoice,,,,,,18/04/2018,18/04/2018,0.00,,16.78,,"-309,556.06"
,IN,AR,30312668,1005,100,,Invoice,,,,,,18/04/2018,18/04/2018,0.00,,12.85,,"-309,568.91"
,IN,AR,30312732,1005,100,,Invoice,,,,,,18/04/2018,18/04/2018,0.00,,81.15,,"-309,650.06"
,IN,AR,30312751,1005,100,,Invoice,,,,,,18/04/2018,18/04/2018,0.00,,6.37,,"-309,656.43"
,IN,AR,30312752,1005,100,,Invoice,,,,,,18/04/2018,18/04/2018,0.00,,9.56,,"-309,665.99"
,IN,AR,30312815,1005,100,,Invoice,,,,,,18/04/2018,18/04/2018,0.00,,5.26,,"-309,671.25"
,IN,AR,30312870,1005,100,,Invoice,,,,,,18/04/2018,18/04/2018,0.00,,10.93,,"-309,682.18"
,IN,AR,30312871,1005,100,,Invoice,,,,,,18/04/2018,18/04/2018,0.00,,29.15,,"-309,711.33"
,IN,AR,30312881,1005,100,,Invoice,,,,,,18/04/2018,18/04/2018,0.00,,6.02,,"-309,717.35"
,IN,AR,30312893,1005,100,,Invoice,,,,,,18/04/2018,18/04/2018,0.00,,9.41,,"-309,726.76"
,IN,AR,30312923,1005,100,,Invoice,,,,,,18/04/2018,18/04/2018,0.00,,29.15,,"-309,755.91"
,IN,AR,30312930,1005,100,,Invoice,,,,,,18/04/2018,18/04/2018,0.00,,22.37,,"-309,778.28"
,IN,AR,30312994,1005,100,,Invoice,,,,,,18/04/2018,18/04/2018,0.00,,11.44,,"-309,789.72"
,IN,AR,30313045,1005,100,,Invoice,,,,,,18/04/2018,18/04/2018,0.00,,51.91,,"-309,841.63"
,IN,AR,30313046,1005,100,,Invoice,,,,,,18/04/2018,18/04/2018,0.00,,14.53,,"-309,856.16"
,IN,AR,30313102,1005,100,,Invoice,,,,,,18/04/2018,18/04/2018,0.00,,3.64,,"-309,859.80"
,CN,AR,31017714,1005,100,,Credit Note,,,,,,19/04/2018,19/04/2018,"2,247.26",,0.00,,"-307,612.54"
,CN,AR,31017754,1005,100,,Credit Note,,,,,,19/04/2018,19/04/2018,15.80,,0.00,,"-307,596.74"
,CN,AR,31017764,1005,100,,Credit Note,,,,,,19/04/2018,19/04/2018,1.19,,0.00,,"-307,595.55"
,CN,AR,31017800,1005,100,,Credit Note,,,,,,19/04/2018,19/04/2018,8.20,,0.00,,"-307,587.35"
,CN,AR,31017811,1005,100,,Credit Note,,,,,,19/04/2018,19/04/2018,15.80,,0.00,,"-307,571.55"
,CS,AR,32002594,1005,100,,Cash sale,,,,,,19/04/2018,19/04/2018,0.00,,18.05,,"-307,589.60"
,CS,AR,32002622,1005,100,,Cash sale,,,,,,19/04/2018,19/04/2018,0.00,,3.64,,"-307,593.24"
,CS,AR,32002637,1005,100,,Cash sale,,,,,,19/04/2018,19/04/2018,0.00,,7.29,,"-307,600.53"
,CS,AR,32002658,1005,100,,Cash sale,,,,,,19/04/2018,19/04/2018,0.00,,10.93,,"-307,611.46"
,CS,AR,32002664,1005,100,,Cash sale,,,,,,19/04/2018,19/04/2018,0.00,,7.29,,"-307,618.75"
,CS,AR,32002710,1005,100,,Cash sale,,,,,,19/04/2018,19/04/2018,0.00,,10.93,,"-307,629.68"
,CS,AR,32002722,1005,100,,Cash sale,,,,,,19/04/2018,19/04/2018,0.00,,7.29,,"-307,636.97"
,CS,AR,32002737,1005,100,,Cash sale,,,,,,19/04/2018,19/04/2018,0.00,,3.64,,"-307,640.61"
,CS,AR,32002755,1005,100,,Cash sale,,,,,,19/04/2018,19/04/2018,0.00,,8.39,,"-307,649.00"
,CS,AR,32002764,1005,100,,Cash sale,,,,,,19/04/2018,19/04/2018,0.00,,6.02,,"-307,655.02"
,CS,AR,32002768,1005,100,,Cash sale,,,,,,19/04/2018,19/04/2018,0.00,,3.64,,"-307,658.66"
,CS,AR,32002775,1005,100,,Cash sale,,,,,,19/04/2018,19/04/2018,0.00,,7.29,,"-307,665.95"
,CS,AR,32002790,1005,100,,Cash sale,,,,,,19/04/2018,19/04/2018,0.00,,10.34,,"-307,676.29"
,CS,AR,32002795,1005,100,,Cash sale,,,,,,19/04/2018,19/04/2018,0.00,,7.29,,"-307,683.58"
,CS,AR,32002803,1005,100,,Cash sale,,,,,,19/04/2018,19/04/2018,0.00,,12.03,,"-307,695.61"
,CS,AR,32002804,1005,100,,Cash sale,,,,,,19/04/2018,19/04/2018,0.00,,12.03,,"-307,707.64"
,CS,AR,32002810,1005,100,,Cash sale,,,,,,19/04/2018,19/04/2018,0.00,,7.29,,"-307,714.93"
,CS,AR,32002843,1005,100,,Cash sale,,,,,,19/04/2018,19/04/2018,0.00,,7.75,,"-307,722.68"
,CS,AR,32002955,1005,100,,Cash sale,,,,,,19/04/2018,19/04/2018,0.00,,10.93,,"-307,733.61"
,CS,AR,32002957,1005,100,,Cash sale,,,,,,19/04/2018,19/04/2018,0.00,,10.93,,"-307,744.54"
,CS,AR,32002964,1005,100,,Cash sale,,,,,,19/04/2018,19/04/2018,0.00,,16.53,,"-307,761.07"
,CS,AR,32002965,1005,100,,Cash sale,,,,,,19/04/2018,19/04/2018,0.00,,14.58,,"-307,775.65"
,CS,AR,32003013,1005,100,,Cash sale,,,,,,19/04/2018,19/04/2018,0.00,,27.97,,"-307,803.62"
,CS,AR,32003018,1005,100,,Cash sale,,,,,,19/04/2018,19/04/2018,0.00,,10.34,,"-307,813.96"
,CS,AR,32003022,1005,100,,Cash sale,,,,,,19/04/2018,19/04/2018,0.00,,3.64,,"-307,817.60"
,CS,AR,32003032,1005,100,,Cash sale,,,,,,19/04/2018,19/04/2018,0.00,,10.93,,"-307,828.53"
,CS,AR,32003065,1005,100,,Cash sale,,,,,,19/04/2018,19/04/2018,0.00,,2.58,,"-307,831.11"
,CS,AR,32003081,1005,100,,Cash sale,,,,,,19/04/2018,19/04/2018,0.00,,10.93,,"-307,842.04"
,CS,AR,32003118,1005,100,,Cash sale,,,,,,19/04/2018,19/04/2018,0.00,,3.64,,"-307,845.68"
,CS,AR,32003122,1005,100,,Cash sale,,,,,,19/04/2018,19/04/2018,0.00,,47.37,,"-307,893.05"
,CS,AR,32003132,1005,100,,Cash sale,,,,,,19/04/2018,19/04/2018,0.00,,7.29,,"-307,900.34"
,CS,AR,32003138,1005,100,,Cash sale,,,,,,19/04/2018,19/04/2018,0.00,,10.47,,"-307,910.81"
,CS,AR,32003161,1005,100,,Cash sale,,,,,,19/04/2018,19/04/2018,0.00,,2.58,,"-307,913.39"
,CS,AR,32003174,1005,100,,Cash sale,,,,,,19/04/2018,19/04/2018,0.00,,25.51,,"-307,938.90"
,CS,AR,32003176,1005,100,,Cash sale,,,,,,19/04/2018,19/04/2018,0.00,,7.29,,"-307,946.19"
,CS,AR,32003198,1005,100,,Cash sale,,,,,,19/04/2018,19/04/2018,0.00,,2.75,,"-307,948.94"
,CS,AR,32003204,1005,100,,Cash sale,,,,,,19/04/2018,19/04/2018,0.00,,2.97,,"-307,951.91"
,CS,AR,32003214,1005,100,,Cash sale,,,,,,19/04/2018,19/04/2018,0.00,,7.29,,"-307,959.20"
,CS,AR,32003217,1005,100,,Cash sale,,,,,,19/04/2018,19/04/2018,0.00,,18.22,,"-307,977.42"
,CS,AR,32003346,1005,100,,Cash sale,,,,,,19/04/2018,19/04/2018,0.00,,10.93,,"-307,988.35"
,CS,AR,32003349,1005,100,,Cash sale,,,,,,19/04/2018,19/04/2018,0.00,,10.93,,"-307,999.28"
,CS,AR,32003353,1005,100,,Cash sale,,,,,,19/04/2018,19/04/2018,0.00,,11.66,,"-308,010.94"
,CS,AR,32003355,1005,100,,Cash sale,,,,,,19/04/2018,19/04/2018,0.00,,14.58,,"-308,025.52"
,CS,AR,32003370,1005,100,,Cash sale,,,,,,19/04/2018,19/04/2018,0.00,,18.22,,"-308,043.74"
,IN,AR,30311095,1005,100,,Invoice,,,,,,19/04/2018,19/04/2018,0.00,,5.93,,"-308,049.67"
,IN,AR,30311104,1005,100,,Invoice,,,,,,19/04/2018,19/04/2018,0.00,,7.29,,"-308,056.96"
,IN,AR,30311149,1005,100,,Invoice,,,,,,19/04/2018,19/04/2018,0.00,,14.58,,"-308,071.54"
,IN,AR,30311177,1005,100,,Invoice,,,,,,19/04/2018,19/04/2018,0.00,,7.00,,"-308,078.54"
,IN,AR,30311182,1005,100,,Invoice,,,,,,19/04/2018,19/04/2018,0.00,,12.20,,"-308,090.74"
,IN,AR,30311183,1005,100,,Invoice,,,,,,19/04/2018,19/04/2018,0.00,,2.03,,"-308,092.77"
,IN,AR,30311196,1005,100,,Invoice,,,,,,19/04/2018,19/04/2018,0.00,,36.44,,"-308,129.21"
,IN,AR,30311198,1005,100,,Invoice,,,,,,19/04/2018,19/04/2018,0.00,,7.29,,"-308,136.50"
,IN,AR,30311206,1005,100,,Invoice,,,,,,19/04/2018,19/04/2018,0.00,,32.80,,"-308,169.30"
,IN,AR,30311225,1005,100,,Invoice,,,,,,19/04/2018,19/04/2018,0.00,,1.99,,"-308,171.29"
,IN,AR,30311241,1005,100,,Invoice,,,,,,19/04/2018,19/04/2018,0.00,,45.08,,"-308,216.37"
,IN,AR,30311277,1005,100,,Invoice,,,,,,19/04/2018,19/04/2018,0.00,,29.15,,"-308,245.52"
,IN,AR,30311299,1005,100,,Invoice,,,,,,19/04/2018,19/04/2018,0.00,,7.29,,"-308,252.81"
,IN,AR,30311322,1005,100,,Invoice,,,,,,19/04/2018,19/04/2018,0.00,,7.29,,"-308,260.10"
,IN,AR,30311331,1005,100,,Invoice,,,,,,19/04/2018,19/04/2018,0.00,,3.64,,"-308,263.74"
,IN,AR,30311391,1005,100,,Invoice,,,,,,19/04/2018,19/04/2018,0.00,,43.93,,"-308,307.67"
,IN,AR,30311435,1005,100,,Invoice,,,,,,19/04/2018,19/04/2018,0.00,,40.00,,"-308,347.67"
,IN,AR,30311449,1005,100,,Invoice,,,,,,19/04/2018,19/04/2018,0.00,,29.15,,"-308,376.82"
,IN,AR,30311484,1005,100,,Invoice,,,,,,19/04/2018,19/04/2018,0.00,,218.64,,"-308,595.46"
,IN,AR,30311492,1005,100,,Invoice,,,,,,19/04/2018,19/04/2018,0.00,,7.97,,"-308,603.43"
,IN,AR,30311495,1005,100,,Invoice,,,,,,19/04/2018,19/04/2018,0.00,,10.93,,"-308,614.36"
,IN,AR,30311508,1005,100,,Invoice,,,,,,19/04/2018,19/04/2018,0.00,,24.50,,"-308,638.86"
,IN,AR,30311511,1005,100,,Invoice,,,,,,19/04/2018,19/04/2018,0.00,,18.22,,"-308,657.08"
,IN,AR,30311512,1005,100,,Invoice,,,,,,19/04/2018,19/04/2018,0.00,,18.22,,"-308,675.30"
,IN,AR,30311518,1005,100,,Invoice,,,,,,19/04/2018,19/04/2018,0.00,,182.20,,"-308,857.50"
,IN,AR,30311533,1005,100,,Invoice,,,,,,19/04/2018,19/04/2018,0.00,,14.39,,"-308,871.89"
,IN,AR,30311616,1005,100,,Invoice,,,,,,19/04/2018,19/04/2018,0.00,,23.90,,"-308,895.79"
,IN,AR,30311627,1005,100,,Invoice,,,,,,19/04/2018,19/04/2018,0.00,,28.68,,"-308,924.47"
,IN,AR,30311646,1005,100,,Invoice,,,,,,19/04/2018,19/04/2018,0.00,,16.95,,"-308,941.42"
,IN,AR,30311692,1005,100,,Invoice,,,,,,19/04/2018,19/04/2018,0.00,,14.34,,"-308,955.76"
,IN,AR,30311706,1005,100,,Invoice,,,,,,19/04/2018,19/04/2018,0.00,,19.32,,"-308,975.08"
,IN,AR,30311707,1005,100,,Invoice,,,,,,19/04/2018,19/04/2018,0.00,,28.98,,"-309,004.06"
,IN,AR,30311754,1005,100,,Invoice,,,,,,19/04/2018,19/04/2018,0.00,,18.22,,"-309,022.28"
,IN,AR,30311763,1005,100,,Invoice,,,,,,19/04/2018,19/04/2018,0.00,,4.78,,"-309,027.06"
,IN,AR,30311778,1005,100,,Invoice,,,,,,19/04/2018,19/04/2018,0.00,,10.17,,"-309,037.23"
,IN,AR,30311779,1005,100,,Invoice,,,,,,19/04/2018,19/04/2018,0.00,,7.63,,"-309,044.86"
,IN,AR,30311799,1005,100,,Invoice,,,,,,19/04/2018,19/04/2018,0.00,,50.98,,"-309,095.84"
,IN,AR,30311800,1005,100,,Invoice,,,,,,19/04/2018,19/04/2018,0.00,,14.34,,"-309,110.18"
,IN,AR,30311801,1005,100,,Invoice,,,,,,19/04/2018,19/04/2018,0.00,,49.39,,"-309,159.57"
,IN,AR,30311807,1005,100,,Invoice,,,,,,19/04/2018,19/04/2018,0.00,,20.23,,"-309,179.80"
,IN,AR,30311812,1005,100,,Invoice,,,,,,19/04/2018,19/04/2018,0.00,,2.58,,"-309,182.38"
,IN,AR,30311843,1005,100,,Invoice,,,,,,19/04/2018,19/04/2018,0.00,,7.29,,"-309,189.67"
,IN,AR,30311927,1005,100,,Invoice,,,,,,19/04/2018,19/04/2018,0.00,,10.59,,"-309,200.26"
,IN,AR,30311930,1005,100,,Invoice,,,,,,19/04/2018,19/04/2018,0.00,,10.93,,"-309,211.19"
,IN,AR,30311942,1005,100,,Invoice,,,,,,19/04/2018,19/04/2018,0.00,,15.25,,"-309,226.44"
,IN,AR,30311956,1005,100,,Invoice,,,,,,19/04/2018,19/04/2018,0.00,,13.73,,"-309,240.17"
,IN,AR,30311995,1005,100,,Invoice,,,,,,19/04/2018,19/04/2018,0.00,,14.00,,"-309,254.17"
,IN,AR,30312008,1005,100,,Invoice,,,,,,19/04/2018,19/04/2018,0.00,,703.45,,"-309,957.62"
,IN,AR,30312033,1005,100,,Invoice,,,,,,19/04/2018,19/04/2018,0.00,,16.95,,"-309,974.57"
,IN,AR,30312050,1005,100,,Invoice,,,,,,19/04/2018,19/04/2018,0.00,,10.17,,"-309,984.74"
,IN,AR,30312051,1005,100,,Invoice,,,,,,19/04/2018,19/04/2018,0.00,,10.17,,"-309,994.91"
,IN,AR,30312073,1005,100,,Invoice,,,,,,19/04/2018,19/04/2018,0.00,,6.97,,"-310,001.88"
,IN,AR,30312079,1005,100,,Invoice,,,,,,19/04/2018,19/04/2018,0.00,,8.77,,"-310,010.65"
,IN,AR,30312090,1005,100,,Invoice,,,,,,19/04/2018,19/04/2018,0.00,,16.53,,"-310,027.18"
,IN,AR,30312149,1005,100,,Invoice,,,,,,19/04/2018,19/04/2018,0.00,,13.74,,"-310,040.92"
,IN,AR,30312157,1005,100,,Invoice,,,,,,19/04/2018,19/04/2018,0.00,,15.53,,"-310,056.45"
,IN,AR,30312163,1005,100,,Invoice,,,,,,19/04/2018,19/04/2018,0.00,,10.17,,"-310,066.62"
,IN,AR,30312174,1005,100,,Invoice,,,,,,19/04/2018,19/04/2018,0.00,,42.12,,"-310,108.74"
,IN,AR,30312177,1005,100,,Invoice,,,,,,19/04/2018,19/04/2018,0.00,,10.00,,"-310,118.74"
,IN,AR,30312202,1005,100,,Invoice,,,,,,19/04/2018,19/04/2018,0.00,,3.53,,"-310,122.27"
,IN,AR,30312203,1005,100,,Invoice,,,,,,19/04/2018,19/04/2018,0.00,,3.53,,"-310,125.80"
,IN,AR,30312262,1005,100,,Invoice,,,,,,19/04/2018,19/04/2018,0.00,,29.15,,"-310,154.95"
,IN,AR,30312273,1005,100,,Invoice,,,,,,19/04/2018,19/04/2018,0.00,,21.86,,"-310,176.81"
,IN,AR,30312274,1005,100,,Invoice,,,,,,19/04/2018,19/04/2018,0.00,,36.44,,"-310,213.25"
,IN,AR,30312289,1005,100,,Invoice,,,,,,19/04/2018,19/04/2018,0.00,,10.93,,"-310,224.18"
,IN,AR,30312293,1005,100,,Invoice,,,,,,19/04/2018,19/04/2018,0.00,,5.68,,"-310,229.86"
,IN,AR,30312302,1005,100,,Invoice,,,,,,19/04/2018,19/04/2018,0.00,,7.29,,"-310,237.15"
,IN,AR,30312306,1005,100,,Invoice,,,,,,19/04/2018,19/04/2018,0.00,,10.17,,"-310,247.32"
,IN,AR,30312328,1005,100,,Invoice,,,,,,19/04/2018,19/04/2018,0.00,,11.39,,"-310,258.71"
,IN,AR,30312329,1005,100,,Invoice,,,,,,19/04/2018,19/04/2018,0.00,,13.02,,"-310,271.73"
,IN,AR,30312330,1005,100,,Invoice,,,,,,19/04/2018,19/04/2018,0.00,,4.88,,"-310,276.61"
,IN,AR,30312331,1005,100,,Invoice,,,,,,19/04/2018,19/04/2018,0.00,,32.54,,"-310,309.15"
,IN,AR,30312332,1005,100,,Invoice,,,,,,19/04/2018,19/04/2018,0.00,,9.76,,"-310,318.91"
,IN,AR,30312344,1005,100,,Invoice,,,,,,19/04/2018,19/04/2018,0.00,,17.49,,"-310,336.40"
,IN,AR,30312352,1005,100,,Invoice,,,,,,19/04/2018,19/04/2018,0.00,,9.74,,"-310,346.14"
,IN,AR,30312369,1005,100,,Invoice,,,,,,19/04/2018,19/04/2018,0.00,,28.81,,"-310,374.95"
,IN,AR,30312409,1005,100,,Invoice,,,,,,19/04/2018,19/04/2018,0.00,,10.93,,"-310,385.88"
,IN,AR,30312414,1005,100,,Invoice,,,,,,19/04/2018,19/04/2018,0.00,,4.32,,"-310,390.20"
,IN,AR,30312457,1005,100,,Invoice,,,,,,19/04/2018,19/04/2018,0.00,,11.22,,"-310,401.42"
,IN,AR,30312458,1005,100,,Invoice,,,,,,19/04/2018,19/04/2018,0.00,,64.14,,"-310,465.56"
,IN,AR,30312459,1005,100,,Invoice,,,,,,19/04/2018,19/04/2018,0.00,,8.02,,"-310,473.58"
,IN,AR,30312488,1005,100,,Invoice,,,,,,19/04/2018,19/04/2018,0.00,,9.84,,"-310,483.42"
,IN,AR,30312495,1005,100,,Invoice,,,,,,19/04/2018,19/04/2018,0.00,,10.93,,"-310,494.35"
,IN,AR,30312496,1005,100,,Invoice,,,,,,19/04/2018,19/04/2018,0.00,,12.14,,"-310,506.49"
,IN,AR,30312518,1005,100,,Invoice,,,,,,19/04/2018,19/04/2018,0.00,,10.93,,"-310,517.42"
,IN,AR,30312526,1005,100,,Invoice,,,,,,19/04/2018,19/04/2018,0.00,,7.63,,"-310,525.05"
,IN,AR,30312527,1005,100,,Invoice,,,,,,19/04/2018,19/04/2018,0.00,,12.71,,"-310,537.76"
,IN,AR,30312534,1005,100,,Invoice,,,,,,19/04/2018,19/04/2018,0.00,,16.01,,"-310,553.77"
,IN,AR,30312550,1005,100,,Invoice,,,,,,19/04/2018,19/04/2018,0.00,,30.01,,"-310,583.78"
,IN,AR,30312564,1005,100,,Invoice,,,,,,19/04/2018,19/04/2018,0.00,,14.58,,"-310,598.36"
,IN,AR,30312565,1005,100,,Invoice,,,,,,19/04/2018,19/04/2018,0.00,,17.49,,"-310,615.85"
,IN,AR,30312585,1005,100,,Invoice,,,,,,19/04/2018,19/04/2018,0.00,,6.03,,"-310,621.88"
,IN,AR,30312586,1005,100,,Invoice,,,,,,19/04/2018,19/04/2018,0.00,,51.29,,"-310,673.17"
,IN,AR,30312615,1005,100,,Invoice,,,,,,19/04/2018,19/04/2018,0.00,,7.90,,"-310,681.07"
,IN,AR,30312632,1005,100,,Invoice,,,,,,19/04/2018,19/04/2018,0.00,,37.29,,"-310,718.36"
,IN,AR,30312643,1005,100,,Invoice,,,,,,19/04/2018,19/04/2018,0.00,,14.03,,"-310,732.39"
,IN,AR,30312654,1005,100,,Invoice,,,,,,19/04/2018,19/04/2018,0.00,,22.88,,"-310,755.27"
,IN,AR,30312659,1005,100,,Invoice,,,,,,19/04/2018,19/04/2018,0.00,,5.68,,"-310,760.95"
,IN,AR,30312683,1005,100,,Invoice,,,,,,19/04/2018,19/04/2018,0.00,,10.21,,"-310,771.16"
,IN,AR,30312705,1005,100,,Invoice,,,,,,19/04/2018,19/04/2018,0.00,,54.66,,"-310,825.82"
,IN,AR,30312753,1005,100,,Invoice,,,,,,19/04/2018,19/04/2018,0.00,,4.78,,"-310,830.60"
,IN,AR,30312754,1005,100,,Invoice,,,,,,19/04/2018,19/04/2018,0.00,,9.56,,"-310,840.16"
,IN,AR,30312755,1005,100,,Invoice,,,,,,19/04/2018,19/04/2018,0.00,,111.53,,"-310,951.69"
,IN,AR,30312756,1005,100,,Invoice,,,,,,19/04/2018,19/04/2018,0.00,,19.12,,"-310,970.81"
,IN,AR,30312757,1005,100,,Invoice,,,,,,19/04/2018,19/04/2018,0.00,,12.75,,"-310,983.56"
,IN,AR,30312758,1005,100,,Invoice,,,,,,19/04/2018,19/04/2018,0.00,,9.56,,"-310,993.12"
,IN,AR,30312791,1005,100,,Invoice,,,,,,19/04/2018,19/04/2018,0.00,,16.27,,"-311,009.39"
,IN,AR,30312822,1005,100,,Invoice,,,,,,19/04/2018,19/04/2018,0.00,,29.15,,"-311,038.54"
,IN,AR,30312909,1005,100,,Invoice,,,,,,19/04/2018,19/04/2018,0.00,,762.50,,"-311,801.04"
,IN,AR,30312945,1005,100,,Invoice,,,,,,19/04/2018,19/04/2018,0.00,,8.17,,"-311,809.21"
,IN,AR,30312950,1005,100,,Invoice,,,,,,19/04/2018,19/04/2018,0.00,,25.51,,"-311,834.72"
,IN,AR,30312983,1005,100,,Invoice,,,,,,19/04/2018,19/04/2018,0.00,,17.92,,"-311,852.64"
,IN,AR,30313005,1005,100,,Invoice,,,,,,19/04/2018,19/04/2018,0.00,,7.29,,"-311,859.93"
,IN,AR,30313047,1005,100,,Invoice,,,,,,19/04/2018,19/04/2018,0.00,,8.31,,"-311,868.24"
,IN,AR,30313048,1005,100,,Invoice,,,,,,19/04/2018,19/04/2018,0.00,,8.31,,"-311,876.55"
,IN,AR,30313072,1005,100,,Invoice,,,,,,19/04/2018,19/04/2018,0.00,,16.91,,"-311,893.46"
,CS,AR,32002590,1005,100,,Cash sale,,,,,,20/04/2018,20/04/2018,0.00,,43.97,,"-311,937.43"
,CS,AR,32002603,1005,100,,Cash sale,,,,,,20/04/2018,20/04/2018,0.00,,5.61,,"-311,943.04"
,CS,AR,32002607,1005,100,,Cash sale,,,,,,20/04/2018,20/04/2018,0.00,,19.58,,"-311,962.62"
,CS,AR,32002626,1005,100,,Cash sale,,,,,,20/04/2018,20/04/2018,0.00,,5.68,,"-311,968.30"
,CS,AR,32002634,1005,100,,Cash sale,,,,,,20/04/2018,20/04/2018,0.00,,12.17,,"-311,980.47"
,CS,AR,32002642,1005,100,,Cash sale,,,,,,20/04/2018,20/04/2018,0.00,,7.29,,"-311,987.76"
,CS,AR,32002647,1005,100,,Cash sale,,,,,,20/04/2018,20/04/2018,0.00,,10.93,,"-311,998.69"
,CS,AR,32002667,1005,100,,Cash sale,,,,,,20/04/2018,20/04/2018,0.00,,29.15,,"-312,027.84"
,CS,AR,32002686,1005,100,,Cash sale,,,,,,20/04/2018,20/04/2018,0.00,,12.08,,"-312,039.92"
,CS,AR,32002699,1005,100,,Cash sale,,,,,,20/04/2018,20/04/2018,0.00,,9.49,,"-312,049.41"
,CS,AR,32002708,1005,100,,Cash sale,,,,,,20/04/2018,20/04/2018,0.00,,10.93,,"-312,060.34"
,CS,AR,32002717,1005,100,,Cash sale,,,,,,20/04/2018,20/04/2018,0.00,,14.53,,"-312,074.87"
,CS,AR,32002820,1005,100,,Cash sale,,,,,,20/04/2018,20/04/2018,0.00,,5.17,,"-312,080.04"
,CS,AR,32002829,1005,100,,Cash sale,,,,,,20/04/2018,20/04/2018,0.00,,12.71,,"-312,092.75"
,CS,AR,32002853,1005,100,,Cash sale,,,,,,20/04/2018,20/04/2018,0.00,,16.48,,"-312,109.23"
,CS,AR,32002868,1005,100,,Cash sale,,,,,,20/04/2018,20/04/2018,0.00,,10.99,,"-312,120.22"
,CS,AR,32002881,1005,100,,Cash sale,,,,,,20/04/2018,20/04/2018,0.00,,3.64,,"-312,123.86"
,CS,AR,32002886,1005,100,,Cash sale,,,,,,20/04/2018,20/04/2018,0.00,,9.03,,"-312,132.89"
,CS,AR,32002887,1005,100,,Cash sale,,,,,,20/04/2018,20/04/2018,0.00,,6.02,,"-312,138.91"
,CS,AR,32002890,1005,100,,Cash sale,,,,,,20/04/2018,20/04/2018,0.00,,14.58,,"-312,153.49"
,CS,AR,32002902,1005,100,,Cash sale,,,,,,20/04/2018,20/04/2018,0.00,,7.29,,"-312,160.78"
,CS,AR,32002913,1005,100,,Cash sale,,,,,,20/04/2018,20/04/2018,0.00,,10.17,,"-312,170.95"
,CS,AR,32002921,1005,100,,Cash sale,,,,,,20/04/2018,20/04/2018,0.00,,14.62,,"-312,185.57"
,CS,AR,32002939,1005,100,,Cash sale,,,,,,20/04/2018,20/04/2018,0.00,,30.08,,"-312,215.65"
,CS,AR,32002945,1005,100,,Cash sale,,,,,,20/04/2018,20/04/2018,0.00,,15.25,,"-312,230.90"
,CS,AR,32002967,1005,100,,Cash sale,,,,,,20/04/2018,20/04/2018,0.00,,3.64,,"-312,234.54"
,CS,AR,32002974,1005,100,,Cash sale,,,,,,20/04/2018,20/04/2018,0.00,,3.64,,"-312,238.18"
,CS,AR,32003035,1005,100,,Cash sale,,,,,,20/04/2018,20/04/2018,0.00,,21.86,,"-312,260.04"
,CS,AR,32003047,1005,100,,Cash sale,,,,,,20/04/2018,20/04/2018,0.00,,7.29,,"-312,267.33"
,CS,AR,32003055,1005,100,,Cash sale,,,,,,20/04/2018,20/04/2018,0.00,,23.41,,"-312,290.74"
,CS,AR,32003059,1005,100,,Cash sale,,,,,,20/04/2018,20/04/2018,0.00,,3.64,,"-312,294.38"
,CS,AR,32003077,1005,100,,Cash sale,,,,,,20/04/2018,20/04/2018,0.00,,5.17,,"-312,299.55"
,CS,AR,32003086,1005,100,,Cash sale,,,,,,20/04/2018,20/04/2018,0.00,,7.29,,"-312,306.84"
,CS,AR,32003097,1005,100,,Cash sale,,,,,,20/04/2018,20/04/2018,0.00,,8.34,,"-312,315.18"
,CS,AR,32003114,1005,100,,Cash sale,,,,,,20/04/2018,20/04/2018,0.00,,7.29,,"-312,322.47"
,CS,AR,32003120,1005,100,,Cash sale,,,,,,20/04/2018,20/04/2018,0.00,,10.93,,"-312,333.40"
,CS,AR,32003127,1005,100,,Cash sale,,,,,,20/04/2018,20/04/2018,0.00,,7.29,,"-312,340.69"
,CS,AR,32003134,1005,100,,Cash sale,,,,,,20/04/2018,20/04/2018,0.00,,2.58,,"-312,343.27"
,CS,AR,32003144,1005,100,,Cash sale,,,,,,20/04/2018,20/04/2018,0.00,,5.08,,"-312,348.35"
,CS,AR,32003153,1005,100,,Cash sale,,,,,,20/04/2018,20/04/2018,0.00,,6.53,,"-312,354.88"
,CS,AR,32003159,1005,100,,Cash sale,,,,,,20/04/2018,20/04/2018,0.00,,8.16,,"-312,363.04"
,CS,AR,32003165,1005,100,,Cash sale,,,,,,20/04/2018,20/04/2018,0.00,,7.29,,"-312,370.33"
,CS,AR,32003185,1005,100,,Cash sale,,,,,,20/04/2018,20/04/2018,0.00,,32.00,,"-312,402.33"
,CS,AR,32003187,1005,100,,Cash sale,,,,,,20/04/2018,20/04/2018,0.00,,3.64,,"-312,405.97"
,CS,AR,32003192,1005,100,,Cash sale,,,,,,20/04/2018,20/04/2018,0.00,,12.14,,"-312,418.11"
,CS,AR,32003200,1005,100,,Cash sale,,,,,,20/04/2018,20/04/2018,0.00,,7.29,,"-312,425.40"
,CS,AR,32003209,1005,100,,Cash sale,,,,,,20/04/2018,20/04/2018,0.00,,13.12,,"-312,438.52"
,CS,AR,32003212,1005,100,,Cash sale,,,,,,20/04/2018,20/04/2018,0.00,,5.08,,"-312,443.60"
,CS,AR,32003234,1005,100,,Cash sale,,,,,,20/04/2018,20/04/2018,0.00,,9.15,,"-312,452.75"
,CS,AR,32003266,1005,100,,Cash sale,,,,,,20/04/2018,20/04/2018,0.00,,14.58,,"-312,467.33"
,CS,AR,32003274,1005,100,,Cash sale,,,,,,20/04/2018,20/04/2018,0.00,,21.86,,"-312,489.19"
,CS,AR,32003292,1005,100,,Cash sale,,,,,,20/04/2018,20/04/2018,0.00,,12.71,,"-312,501.90"
,CS,AR,32003306,1005,100,,Cash sale,,,,,,20/04/2018,20/04/2018,0.00,,3.64,,"-312,505.54"
,CS,AR,32003313,1005,100,,Cash sale,,,,,,20/04/2018,20/04/2018,0.00,,12.20,,"-312,517.74"
,CS,AR,32003337,1005,100,,Cash sale,,,,,,20/04/2018,20/04/2018,0.00,,12.17,,"-312,529.91"
,CS,AR,32003338,1005,100,,Cash sale,,,,,,20/04/2018,20/04/2018,0.00,,14.58,,"-312,544.49"
,CS,AR,32003343,1005,100,,Cash sale,,,,,,20/04/2018,20/04/2018,0.00,,14.58,,"-312,559.07"
,CS,AR,32003348,1005,100,,Cash sale,,,,,,20/04/2018,20/04/2018,0.00,,29.15,,"-312,588.22"
,CS,AR,32003372,1005,100,,Cash sale,,,,,,20/04/2018,20/04/2018,0.00,,5.86,,"-312,594.08"
,CS,AR,32003391,1005,100,,Cash sale,,,,,,20/04/2018,20/04/2018,0.00,,11.69,,"-312,605.77"
,CS,AR,32003396,1005,100,,Cash sale,,,,,,20/04/2018,20/04/2018,0.00,,18.22,,"-312,623.99"
,CS,AR,32003415,1005,100,,Cash sale,,,,,,20/04/2018,20/04/2018,0.00,,7.29,,"-312,631.28"
,CS,AR,32003427,1005,100,,Cash sale,,,,,,20/04/2018,20/04/2018,0.00,,16.31,,"-312,647.59"
,IN,AR,30311096,1005,100,,Invoice,,,,,,20/04/2018,20/04/2018,0.00,,83.05,,"-312,730.64"
,IN,AR,30311102,1005,100,,Invoice,,,,,,20/04/2018,20/04/2018,0.00,,21.86,,"-312,752.50"
,IN,AR,30311139,1005,100,,Invoice,,,,,,20/04/2018,20/04/2018,0.00,,14.24,,"-312,766.74"
,IN,AR,30311144,1005,100,,Invoice,,,,,,20/04/2018,20/04/2018,0.00,,18.22,,"-312,784.96"
,IN,AR,30311167,1005,100,,Invoice,,,,,,20/04/2018,20/04/2018,0.00,,28.98,,"-312,813.94"
,IN,AR,30311210,1005,100,,Invoice,,,,,,20/04/2018,20/04/2018,0.00,,11.48,,"-312,825.42"
,IN,AR,30311215,1005,100,,Invoice,,,,,,20/04/2018,20/04/2018,0.00,,65.98,,"-312,891.40"
,IN,AR,30311242,1005,100,,Invoice,,,,,,20/04/2018,20/04/2018,0.00,,35.59,,"-312,926.99"
,IN,AR,30311266,1005,100,,Invoice,,,,,,20/04/2018,20/04/2018,0.00,,26.00,,"-312,952.99"
,IN,AR,30311278,1005,100,,Invoice,,,,,,20/04/2018,20/04/2018,0.00,,7.29,,"-312,960.28"
,IN,AR,30311300,1005,100,,Invoice,,,,,,20/04/2018,20/04/2018,0.00,,29.15,,"-312,989.43"
,IN,AR,30311315,1005,100,,Invoice,,,,,,20/04/2018,20/04/2018,0.00,,30.00,,"-313,019.43"
,IN,AR,30311324,1005,100,,Invoice,,,,,,20/04/2018,20/04/2018,0.00,,7.29,,"-313,026.72"
,IN,AR,30311354,1005,100,,Invoice,,,,,,20/04/2018,20/04/2018,0.00,,5.84,,"-313,032.56"
,IN,AR,30311355,1005,100,,Invoice,,,,,,20/04/2018,20/04/2018,0.00,,1.95,,"-313,034.51"
,IN,AR,30311368,1005,100,,Invoice,,,,,,20/04/2018,20/04/2018,0.00,,4.75,,"-313,039.26"
,IN,AR,30311377,1005,100,,Invoice,,,,,,20/04/2018,20/04/2018,0.00,,16.00,,"-313,055.26"
,IN,AR,30311419,1005,100,,Invoice,,,,,,20/04/2018,20/04/2018,0.00,,699.61,,"-313,754.87"
,IN,AR,30311425,1005,100,,Invoice,,,,,,20/04/2018,20/04/2018,0.00,,7.76,,"-313,762.63"
,IN,AR,30311432,1005,100,,Invoice,,,,,,20/04/2018,20/04/2018,0.00,,3.64,,"-313,766.27"
,IN,AR,30311456,1005,100,,Invoice,,,,,,20/04/2018,20/04/2018,0.00,,13.98,,"-313,780.25"
,IN,AR,30311467,1005,100,,Invoice,,,,,,20/04/2018,20/04/2018,0.00,,23.29,,"-313,803.54"
,IN,AR,30311514,1005,100,,Invoice,,,,,,20/04/2018,20/04/2018,0.00,,7.75,,"-313,811.29"
,IN,AR,30311534,1005,100,,Invoice,,,,,,20/04/2018,20/04/2018,0.00,,4.80,,"-313,816.09"
,IN,AR,30311570,1005,100,,Invoice,,,,,,20/04/2018,20/04/2018,0.00,,101.69,,"-313,917.78"
,IN,AR,30311584,1005,100,,Invoice,,,,,,20/04/2018,20/04/2018,0.00,,31.78,,"-313,949.56"
,IN,AR,30311589,1005,100,,Invoice,,,,,,20/04/2018,20/04/2018,0.00,,25.85,,"-313,975.41"
,IN,AR,30311594,1005,100,,Invoice,,,,,,20/04/2018,20/04/2018,0.00,,4.78,,"-313,980.19"
,IN,AR,30311602,1005,100,,Invoice,,,,,,20/04/2018,20/04/2018,0.00,,183.81,,"-314,164.00"
,IN,AR,30311633,1005,100,,Invoice,,,,,,20/04/2018,20/04/2018,0.00,,9.03,,"-314,173.03"
,IN,AR,30311656,1005,100,,Invoice,,,,,,20/04/2018,20/04/2018,0.00,,51.27,,"-314,224.30"
,IN,AR,30311701,1005,100,,Invoice,,,,,,20/04/2018,20/04/2018,0.00,,12.88,,"-314,237.18"
,IN,AR,30311710,1005,100,,Invoice,,,,,,20/04/2018,20/04/2018,0.00,,18.22,,"-314,255.40"
,IN,AR,30311716,1005,100,,Invoice,,,,,,20/04/2018,20/04/2018,0.00,,10.93,,"-314,266.33"
,IN,AR,30311748,1005,100,,Invoice,,,,,,20/04/2018,20/04/2018,0.00,,4.24,,"-314,270.57"
,IN,AR,30311780,1005,100,,Invoice,,,,,,20/04/2018,20/04/2018,0.00,,2.54,,"-314,273.11"
,IN,AR,30311787,1005,100,,Invoice,,,,,,20/04/2018,20/04/2018,0.00,,5.08,,"-314,278.19"
,IN,AR,30311828,1005,100,,Invoice,,,,,,20/04/2018,20/04/2018,0.00,,7.63,,"-314,285.82"
,IN,AR,30311832,1005,100,,Invoice,,,,,,20/04/2018,20/04/2018,0.00,,8.47,,"-314,294.29"
,IN,AR,30311860,1005,100,,Invoice,,,,,,20/04/2018,20/04/2018,0.00,,33.05,,"-314,327.34"
,IN,AR,30311908,1005,100,,Invoice,,,,,,20/04/2018,20/04/2018,0.00,,10.93,,"-314,338.27"
,IN,AR,30311922,1005,100,,Invoice,,,,,,20/04/2018,20/04/2018,0.00,,16.95,,"-314,355.22"
,IN,AR,30311972,1005,100,,Invoice,,,,,,20/04/2018,20/04/2018,0.00,,19.64,,"-314,374.86"
,IN,AR,30312152,1005,100,,Invoice,,,,,,20/04/2018,20/04/2018,0.00,,"1,275.42",,"-315,650.28"
,IN,AR,30312204,1005,100,,Invoice,,,,,,20/04/2018,20/04/2018,0.00,,5.29,,"-315,655.57"
,IN,AR,30312211,1005,100,,Invoice,,,,,,20/04/2018,20/04/2018,0.00,,29.15,,"-315,684.72"
,IN,AR,30312222,1005,100,,Invoice,,,,,,20/04/2018,20/04/2018,0.00,,2.42,,"-315,687.14"
,IN,AR,30312296,1005,100,,Invoice,,,,,,20/04/2018,20/04/2018,0.00,,10.93,,"-315,698.07"
,IN,AR,30312298,1005,100,,Invoice,,,,,,20/04/2018,20/04/2018,0.00,,11.25,,"-315,709.32"
,IN,AR,30312308,1005,100,,Invoice,,,,,,20/04/2018,20/04/2018,0.00,,364.41,,"-316,073.73"
,IN,AR,30312318,1005,100,,Invoice,,,,,,20/04/2018,20/04/2018,0.00,,7.29,,"-316,081.02"
,IN,AR,30312359,1005,100,,Invoice,,,,,,20/04/2018,20/04/2018,0.00,,45.42,,"-316,126.44"
,IN,AR,30312386,1005,100,,Invoice,,,,,,20/04/2018,20/04/2018,0.00,,36.08,,"-316,162.52"
,IN,AR,30312460,1005,100,,Invoice,,,,,,20/04/2018,20/04/2018,0.00,,80.17,,"-316,242.69"
,IN,AR,30312471,1005,100,,Invoice,,,,,,20/04/2018,20/04/2018,0.00,,28.03,,"-316,270.72"
,IN,AR,30312478,1005,100,,Invoice,,,,,,20/04/2018,20/04/2018,0.00,,31.53,,"-316,302.25"
,IN,AR,30312503,1005,100,,Invoice,,,,,,20/04/2018,20/04/2018,0.00,,19.13,,"-316,321.38"
,IN,AR,30312528,1005,100,,Invoice,,,,,,20/04/2018,20/04/2018,0.00,,25.42,,"-316,346.80"
,IN,AR,30312553,1005,100,,Invoice,,,,,,20/04/2018,20/04/2018,0.00,,14.00,,"-316,360.80"
,IN,AR,30312598,1005,100,,Invoice,,,,,,20/04/2018,20/04/2018,0.00,,21.90,,"-316,382.70"
,IN,AR,30312604,1005,100,,Invoice,,,,,,20/04/2018,20/04/2018,0.00,,6.31,,"-316,389.01"
,IN,AR,30312649,1005,100,,Invoice,,,,,,20/04/2018,20/04/2018,0.00,,4.59,,"-316,393.60"
,IN,AR,30312674,1005,100,,Invoice,,,,,,20/04/2018,20/04/2018,0.00,,4.54,,"-316,398.14"
,IN,AR,30312704,1005,100,,Invoice,,,,,,20/04/2018,20/04/2018,0.00,,14.58,,"-316,412.72"
,IN,AR,30312711,1005,100,,Invoice,,,,,,20/04/2018,20/04/2018,0.00,,10.93,,"-316,423.65"
,IN,AR,30312719,1005,100,,Invoice,,,,,,20/04/2018,20/04/2018,0.00,,11.36,,"-316,435.01"
,IN,AR,30312723,1005,100,,Invoice,,,,,,20/04/2018,20/04/2018,0.00,,12.08,,"-316,447.09"
,IN,AR,30312797,1005,100,,Invoice,,,,,,20/04/2018,20/04/2018,0.00,,54.66,,"-316,501.75"
,IN,AR,30312805,1005,100,,Invoice,,,,,,20/04/2018,20/04/2018,0.00,,20.00,,"-316,521.75"
,IN,AR,30312876,1005,100,,Invoice,,,,,,20/04/2018,20/04/2018,0.00,,13.69,,"-316,535.44"
,IN,AR,30312885,1005,100,,Invoice,,,,,,20/04/2018,20/04/2018,0.00,,44.49,,"-316,579.93"
,IN,AR,30312912,1005,100,,Invoice,,,,,,20/04/2018,20/04/2018,0.00,,7.29,,"-316,587.22"
,IN,AR,30312939,1005,100,,Invoice,,,,,,20/04/2018,20/04/2018,0.00,,8.17,,"-316,595.39"
,IN,AR,30313058,1005,100,,Invoice,,,,,,20/04/2018,20/04/2018,0.00,,18.22,,"-316,613.61"
,IN,AR,30313112,1005,100,,Invoice,,,,,,20/04/2018,20/04/2018,0.00,,7.29,,"-316,620.90"
,CS,AR,32002681,1005,100,,Cash sale,,,,,,21/04/2018,21/04/2018,0.00,,54.15,,"-316,675.05"
,CS,AR,32002793,1005,100,,Cash sale,,,,,,21/04/2018,21/04/2018,0.00,,35.59,,"-316,710.64"
,CS,AR,32003098,1005,100,,Cash sale,,,,,,21/04/2018,21/04/2018,0.00,,10.93,,"-316,721.57"
,IN,AR,30311316,1005,100,,Invoice,,,,,,21/04/2018,21/04/2018,0.00,,30.00,,"-316,751.57"
,IN,AR,30311635,1005,100,,Invoice,,,,,,21/04/2018,21/04/2018,0.00,,9.03,,"-316,760.60"
,IN,AR,30311640,1005,100,,Invoice,,,,,,21/04/2018,21/04/2018,0.00,,612.20,,"-317,372.80"
,IN,AR,30311844,1005,100,,Invoice,,,,,,21/04/2018,21/04/2018,0.00,,10.93,,"-317,383.73"
,IN,AR,30312917,1005,100,,Invoice,,,,,,21/04/2018,21/04/2018,0.00,,21.86,,"-317,405.59"
,IN,AR,30313056,1005,100,,Invoice,,,,,,21/04/2018,21/04/2018,0.00,,3.64,,"-317,409.23"
,CS,AR,32002960,1005,100,,Cash sale,,,,,,22/04/2018,22/04/2018,0.00,,29.15,,"-317,438.38"
,CN,AR,31017767,1005,100,,Credit Note,,,,,,23/04/2018,23/04/2018,7.29,,0.00,,"-317,431.09"
,CN,AR,31017829,1005,100,,Credit Note,,,,,,23/04/2018,23/04/2018,39.36,,0.00,,"-317,391.73"
,CN,AR,31017843,1005,100,,Credit Note,,,,,,23/04/2018,23/04/2018,"2,332.20",,0.00,,"-315,059.53"
,CS,AR,32002619,1005,100,,Cash sale,,,,,,23/04/2018,23/04/2018,0.00,,7.12,,"-315,066.65"
,CS,AR,32002676,1005,100,,Cash sale,,,,,,23/04/2018,23/04/2018,0.00,,7.29,,"-315,073.94"
,CS,AR,32002700,1005,100,,Cash sale,,,,,,23/04/2018,23/04/2018,0.00,,18.98,,"-315,092.92"
,CS,AR,32002718,1005,100,,Cash sale,,,,,,23/04/2018,23/04/2018,0.00,,10.38,,"-315,103.30"
,CS,AR,32002740,1005,100,,Cash sale,,,,,,23/04/2018,23/04/2018,0.00,,17.54,,"-315,120.84"
,CS,AR,32002760,1005,100,,Cash sale,,,,,,23/04/2018,23/04/2018,0.00,,7.29,,"-315,128.13"
,CS,AR,32002787,1005,100,,Cash sale,,,,,,23/04/2018,23/04/2018,0.00,,10.34,,"-315,138.47"
,CS,AR,32002815,1005,100,,Cash sale,,,,,,23/04/2018,23/04/2018,0.00,,7.29,,"-315,145.76"
,CS,AR,32002830,1005,100,,Cash sale,,,,,,23/04/2018,23/04/2018,0.00,,12.71,,"-315,158.47"
,CS,AR,32002834,1005,100,,Cash sale,,,,,,23/04/2018,23/04/2018,0.00,,22.37,,"-315,180.84"
,CS,AR,32002837,1005,100,,Cash sale,,,,,,23/04/2018,23/04/2018,0.00,,12.92,,"-315,193.76"
,CS,AR,32002869,1005,100,,Cash sale,,,,,,23/04/2018,23/04/2018,0.00,,8.25,,"-315,202.01"
,CS,AR,32002900,1005,100,,Cash sale,,,,,,23/04/2018,23/04/2018,0.00,,7.29,,"-315,209.30"
,CS,AR,32002922,1005,100,,Cash sale,,,,,,23/04/2018,23/04/2018,0.00,,23.39,,"-315,232.69"
,CS,AR,32002927,1005,100,,Cash sale,,,,,,23/04/2018,23/04/2018,0.00,,10.88,,"-315,243.57"
,CS,AR,32002930,1005,100,,Cash sale,,,,,,23/04/2018,23/04/2018,0.00,,6.02,,"-315,249.59"
,CS,AR,32002940,1005,100,,Cash sale,,,,,,23/04/2018,23/04/2018,0.00,,51.14,,"-315,300.73"
,CS,AR,32002947,1005,100,,Cash sale,,,,,,23/04/2018,23/04/2018,0.00,,7.17,,"-315,307.90"
,CS,AR,32002987,1005,100,,Cash sale,,,,,,23/04/2018,23/04/2018,0.00,,45.13,,"-315,353.03"
,CS,AR,32002993,1005,100,,Cash sale,,,,,,23/04/2018,23/04/2018,0.00,,5.08,,"-315,358.11"
,CS,AR,32003026,1005,100,,Cash sale,,,,,,23/04/2018,23/04/2018,0.00,,8.77,,"-315,366.88"
,CS,AR,32003038,1005,100,,Cash sale,,,,,,23/04/2018,23/04/2018,0.00,,10.93,,"-315,377.81"
,CS,AR,32003043,1005,100,,Cash sale,,,,,,23/04/2018,23/04/2018,0.00,,10.93,,"-315,388.74"
,CS,AR,32003060,1005,100,,Cash sale,,,,,,23/04/2018,23/04/2018,0.00,,14.58,,"-315,403.32"
,CS,AR,32003071,1005,100,,Cash sale,,,,,,23/04/2018,23/04/2018,0.00,,3.64,,"-315,406.96"
,CS,AR,32003088,1005,100,,Cash sale,,,,,,23/04/2018,23/04/2018,0.00,,3.20,,"-315,410.16"
,CS,AR,32003091,1005,100,,Cash sale,,,,,,23/04/2018,23/04/2018,0.00,,12.17,,"-315,422.33"
,CS,AR,32003116,1005,100,,Cash sale,,,,,,23/04/2018,23/04/2018,0.00,,10.93,,"-315,433.26"
,CS,AR,32003124,1005,100,,Cash sale,,,,,,23/04/2018,23/04/2018,0.00,,3.64,,"-315,436.90"
,CS,AR,32003145,1005,100,,Cash sale,,,,,,23/04/2018,23/04/2018,0.00,,12.71,,"-315,449.61"
,CS,AR,32003157,1005,100,,Cash sale,,,,,,23/04/2018,23/04/2018,0.00,,14.58,,"-315,464.19"
,CS,AR,32003163,1005,100,,Cash sale,,,,,,23/04/2018,23/04/2018,0.00,,7.75,,"-315,471.94"
,CS,AR,32003208,1005,100,,Cash sale,,,,,,23/04/2018,23/04/2018,0.00,,9.84,,"-315,481.78"
,CS,AR,32003235,1005,100,,Cash sale,,,,,,23/04/2018,23/04/2018,0.00,,11.44,,"-315,493.22"
,CS,AR,32003261,1005,100,,Cash sale,,,,,,23/04/2018,23/04/2018,0.00,,9.10,,"-315,502.32"
,CS,AR,32003275,1005,100,,Cash sale,,,,,,23/04/2018,23/04/2018,0.00,,14.58,,"-315,516.90"
,CS,AR,32003285,1005,100,,Cash sale,,,,,,23/04/2018,23/04/2018,0.00,,7.29,,"-315,524.19"
,CS,AR,32003333,1005,100,,Cash sale,,,,,,23/04/2018,23/04/2018,0.00,,7.29,,"-315,531.48"
,CS,AR,32003377,1005,100,,Cash sale,,,,,,23/04/2018,23/04/2018,0.00,,10.93,,"-315,542.41"
,CS,AR,32003379,1005,100,,Cash sale,,,,,,23/04/2018,23/04/2018,0.00,,6.56,,"-315,548.97"
,CS,AR,32003403,1005,100,,Cash sale,,,,,,23/04/2018,23/04/2018,0.00,,3.64,,"-315,552.61"
,CS,AR,32003428,1005,100,,Cash sale,,,,,,23/04/2018,23/04/2018,0.00,,9.32,,"-315,561.93"
,IN,AR,30311078,1005,100,,Invoice,,,,,,23/04/2018,23/04/2018,0.00,,14.58,,"-315,576.51"
,IN,AR,30311097,1005,100,,Invoice,,,,,,23/04/2018,23/04/2018,0.00,,41.53,,"-315,618.04"
,IN,AR,30311110,1005,100,,Invoice,,,,,,23/04/2018,23/04/2018,0.00,,18.22,,"-315,636.26"
,IN,AR,30311126,1005,100,,Invoice,,,,,,23/04/2018,23/04/2018,0.00,,10.93,,"-315,647.19"
,IN,AR,30311173,1005,100,,Invoice,,,,,,23/04/2018,23/04/2018,0.00,,10.93,,"-315,658.12"
,IN,AR,30311193,1005,100,,Invoice,,,,,,23/04/2018,23/04/2018,0.00,,44.38,,"-315,702.50"
,IN,AR,30311243,1005,100,,Invoice,,,,,,23/04/2018,23/04/2018,0.00,,158.98,,"-315,861.48"
,IN,AR,30311252,1005,100,,Invoice,,,,,,23/04/2018,23/04/2018,0.00,,5.51,,"-315,866.99"
,IN,AR,30311267,1005,100,,Invoice,,,,,,23/04/2018,23/04/2018,0.00,,48.00,,"-315,914.99"
,IN,AR,30311286,1005,100,,Invoice,,,,,,23/04/2018,23/04/2018,0.00,,59.38,,"-315,974.37"
,IN,AR,30311302,1005,100,,Invoice,,,,,,23/04/2018,23/04/2018,0.00,,7.29,,"-315,981.66"
,IN,AR,30311317,1005,100,,Invoice,,,,,,23/04/2018,23/04/2018,0.00,,38.00,,"-316,019.66"
,IN,AR,30311318,1005,100,,Invoice,,,,,,23/04/2018,23/04/2018,0.00,,6.00,,"-316,025.66"
,IN,AR,30311335,1005,100,,Invoice,,,,,,23/04/2018,23/04/2018,0.00,,2.75,,"-316,028.41"
,IN,AR,30311337,1005,100,,Invoice,,,,,,23/04/2018,23/04/2018,0.00,,15.25,,"-316,043.66"
,IN,AR,30311341,1005,100,,Invoice,,,,,,23/04/2018,23/04/2018,0.00,,11.02,,"-316,054.68"
,IN,AR,30311356,1005,100,,Invoice,,,,,,23/04/2018,23/04/2018,0.00,,3.89,,"-316,058.57"
,IN,AR,30311378,1005,100,,Invoice,,,,,,23/04/2018,23/04/2018,0.00,,18.00,,"-316,076.57"
,IN,AR,30311384,1005,100,,Invoice,,,,,,23/04/2018,23/04/2018,0.00,,7.29,,"-316,083.86"
,IN,AR,30311397,1005,100,,Invoice,,,,,,23/04/2018,23/04/2018,0.00,,21.86,,"-316,105.72"
,IN,AR,30311436,1005,100,,Invoice,,,,,,23/04/2018,23/04/2018,0.00,,28.00,,"-316,133.72"
,IN,AR,30311438,1005,100,,Invoice,,,,,,23/04/2018,23/04/2018,0.00,,7.29,,"-316,141.01"
,IN,AR,30311460,1005,100,,Invoice,,,,,,23/04/2018,23/04/2018,0.00,,9.66,,"-316,150.67"
,IN,AR,30311476,1005,100,,Invoice,,,,,,23/04/2018,23/04/2018,0.00,,22.71,,"-316,173.38"
,IN,AR,30311500,1005,100,,Invoice,,,,,,23/04/2018,23/04/2018,0.00,,15.51,,"-316,188.89"
,IN,AR,30311538,1005,100,,Invoice,,,,,,23/04/2018,23/04/2018,0.00,,9.19,,"-316,198.08"
,IN,AR,30311561,1005,100,,Invoice,,,,,,23/04/2018,23/04/2018,0.00,,8.47,,"-316,206.55"
,IN,AR,30311590,1005,100,,Invoice,,,,,,23/04/2018,23/04/2018,0.00,,23.26,,"-316,229.81"
,IN,AR,30311608,1005,100,,Invoice,,,,,,23/04/2018,23/04/2018,0.00,,11.86,,"-316,241.67"
,IN,AR,30311613,1005,100,,Invoice,,,,,,23/04/2018,23/04/2018,0.00,,5.18,,"-316,246.85"
,IN,AR,30311625,1005,100,,Invoice,,,,,,23/04/2018,23/04/2018,0.00,,3.64,,"-316,250.49"
,IN,AR,30311657,1005,100,,Invoice,,,,,,23/04/2018,23/04/2018,0.00,,100.49,,"-316,350.98"
,IN,AR,30311673,1005,100,,Invoice,,,,,,23/04/2018,23/04/2018,0.00,,27.97,,"-316,378.95"
,IN,AR,30311693,1005,100,,Invoice,,,,,,23/04/2018,23/04/2018,0.00,,19.12,,"-316,398.07"
,IN,AR,30311694,1005,100,,Invoice,,,,,,23/04/2018,23/04/2018,0.00,,9.56,,"-316,407.63"
,IN,AR,30311702,1005,100,,Invoice,,,,,,23/04/2018,23/04/2018,0.00,,16.10,,"-316,423.73"
,IN,AR,30311715,1005,100,,Invoice,,,,,,23/04/2018,23/04/2018,0.00,,21.06,,"-316,444.79"
,IN,AR,30311718,1005,100,,Invoice,,,,,,23/04/2018,23/04/2018,0.00,,7.29,,"-316,452.08"
,IN,AR,30311721,1005,100,,Invoice,,,,,,23/04/2018,23/04/2018,0.00,,4.24,,"-316,456.32"
,IN,AR,30311723,1005,100,,Invoice,,,,,,23/04/2018,23/04/2018,0.00,,7.29,,"-316,463.61"
,IN,AR,30311726,1005,100,,Invoice,,,,,,23/04/2018,23/04/2018,0.00,,9.03,,"-316,472.64"
,IN,AR,30311730,1005,100,,Invoice,,,,,,23/04/2018,23/04/2018,0.00,,7.29,,"-316,479.93"
,IN,AR,30311781,1005,100,,Invoice,,,,,,23/04/2018,23/04/2018,0.00,,10.17,,"-316,490.10"
,IN,AR,30311861,1005,100,,Invoice,,,,,,23/04/2018,23/04/2018,0.00,,25.42,,"-316,515.52"
,IN,AR,30311875,1005,100,,Invoice,,,,,,23/04/2018,23/04/2018,0.00,,22.37,,"-316,537.89"
,IN,AR,30311890,1005,100,,Invoice,,,,,,23/04/2018,23/04/2018,0.00,,7.29,,"-316,545.18"
,IN,AR,30311912,1005,100,,Invoice,,,,,,23/04/2018,23/04/2018,0.00,,3.64,,"-316,548.82"
,IN,AR,30311917,1005,100,,Invoice,,,,,,23/04/2018,23/04/2018,0.00,,18.22,,"-316,567.04"
,IN,AR,30311946,1005,100,,Invoice,,,,,,23/04/2018,23/04/2018,0.00,,3.64,,"-316,570.68"
,IN,AR,30311953,1005,100,,Invoice,,,,,,23/04/2018,23/04/2018,0.00,,7.29,,"-316,577.97"
,IN,AR,30311963,1005,100,,Invoice,,,,,,23/04/2018,23/04/2018,0.00,,9.19,,"-316,587.16"
,IN,AR,30311973,1005,100,,Invoice,,,,,,23/04/2018,23/04/2018,0.00,,8.42,,"-316,595.58"
,IN,AR,30311976,1005,100,,Invoice,,,,,,23/04/2018,23/04/2018,0.00,,10.51,,"-316,606.09"
,IN,AR,30311982,1005,100,,Invoice,,,,,,23/04/2018,23/04/2018,0.00,,3.64,,"-316,609.73"
,IN,AR,30312027,1005,100,,Invoice,,,,,,23/04/2018,23/04/2018,0.00,,7.29,,"-316,617.02"
,IN,AR,30312046,1005,100,,Invoice,,,,,,23/04/2018,23/04/2018,0.00,,65.90,,"-316,682.92"
,IN,AR,30312058,1005,100,,Invoice,,,,,,23/04/2018,23/04/2018,0.00,,8.00,,"-316,690.92"
,IN,AR,30312105,1005,100,,Invoice,,,,,,23/04/2018,23/04/2018,0.00,,5.17,,"-316,696.09"
,IN,AR,30312117,1005,100,,Invoice,,,,,,23/04/2018,23/04/2018,0.00,,10.93,,"-316,707.02"
,IN,AR,30312121,1005,100,,Invoice,,,,,,23/04/2018,23/04/2018,0.00,,36.12,,"-316,743.14"
,IN,AR,30312129,1005,100,,Invoice,,,,,,23/04/2018,23/04/2018,0.00,,2.25,,"-316,745.39"
,IN,AR,30312158,1005,100,,Invoice,,,,,,23/04/2018,23/04/2018,0.00,,1.94,,"-316,747.33"
,IN,AR,30312215,1005,100,,Invoice,,,,,,23/04/2018,23/04/2018,0.00,,7.29,,"-316,754.62"
,IN,AR,30312255,1005,100,,Invoice,,,,,,23/04/2018,23/04/2018,0.00,,7.29,,"-316,761.91"
,IN,AR,30312288,1005,100,,Invoice,,,,,,23/04/2018,23/04/2018,0.00,,4.29,,"-316,766.20"
,IN,AR,30312345,1005,100,,Invoice,,,,,,23/04/2018,23/04/2018,0.00,,47.70,,"-316,813.90"
,IN,AR,30312375,1005,100,,Invoice,,,,,,23/04/2018,23/04/2018,0.00,,157.47,,"-316,971.37"
,IN,AR,30312387,1005,100,,Invoice,,,,,,23/04/2018,23/04/2018,0.00,,20.04,,"-316,991.41"
,IN,AR,30312461,1005,100,,Invoice,,,,,,23/04/2018,23/04/2018,0.00,,4.81,,"-316,996.22"
,IN,AR,30312479,1005,100,,Invoice,,,,,,23/04/2018,23/04/2018,0.00,,15.76,,"-317,011.98"
,IN,AR,30312491,1005,100,,Invoice,,,,,,23/04/2018,23/04/2018,0.00,,6.56,,"-317,018.54"
,IN,AR,30312512,1005,100,,Invoice,,,,,,23/04/2018,23/04/2018,0.00,,29.15,,"-317,047.69"
,IN,AR,30312539,1005,100,,Invoice,,,,,,23/04/2018,23/04/2018,0.00,,22.01,,"-317,069.70"
,IN,AR,30312556,1005,100,,Invoice,,,,,,23/04/2018,23/04/2018,0.00,,12.00,,"-317,081.70"
,IN,AR,30312566,1005,100,,Invoice,,,,,,23/04/2018,23/04/2018,0.00,,20.41,,"-317,102.11"
,IN,AR,30312567,1005,100,,Invoice,,,,,,23/04/2018,23/04/2018,0.00,,8.75,,"-317,110.86"
,IN,AR,30312568,1005,100,,Invoice,,,,,,23/04/2018,23/04/2018,0.00,,11.66,,"-317,122.52"
,IN,AR,30312587,1005,100,,Invoice,,,,,,23/04/2018,23/04/2018,0.00,,49.78,,"-317,172.30"
,IN,AR,30312618,1005,100,,Invoice,,,,,,23/04/2018,23/04/2018,0.00,,11.66,,"-317,183.96"
,IN,AR,30312627,1005,100,,Invoice,,,,,,23/04/2018,23/04/2018,0.00,,38.65,,"-317,222.61"
,IN,AR,30312633,1005,100,,Invoice,,,,,,23/04/2018,23/04/2018,0.00,,181.78,,"-317,404.39"
,IN,AR,30312644,1005,100,,Invoice,,,,,,23/04/2018,23/04/2018,0.00,,16.83,,"-317,421.22"
,IN,AR,30312669,1005,100,,Invoice,,,,,,23/04/2018,23/04/2018,0.00,,9.64,,"-317,430.86"
,IN,AR,30312673,1005,100,,Invoice,,,,,,23/04/2018,23/04/2018,0.00,,148.00,,"-317,578.86"
,IN,AR,30312729,1005,100,,Invoice,,,,,,23/04/2018,23/04/2018,0.00,,24.03,,"-317,602.89"
,IN,AR,30312806,1005,100,,Invoice,,,,,,23/04/2018,23/04/2018,0.00,,8.00,,"-317,610.89"
,IN,AR,30312812,1005,100,,Invoice,,,,,,23/04/2018,23/04/2018,0.00,,1.88,,"-317,612.77"
,IN,AR,30312828,1005,100,,Invoice,,,,,,23/04/2018,23/04/2018,0.00,,29.15,,"-317,641.92"
,IN,AR,30312829,1005,100,,Invoice,,,,,,23/04/2018,23/04/2018,0.00,,29.15,,"-317,671.07"
,IN,AR,30312851,1005,100,,Invoice,,,,,,23/04/2018,23/04/2018,0.00,,182.20,,"-317,853.27"
,IN,AR,30312915,1005,100,,Invoice,,,,,,23/04/2018,23/04/2018,0.00,,5.24,,"-317,858.51"
,IN,AR,30312919,1005,100,,Invoice,,,,,,23/04/2018,23/04/2018,0.00,,8.77,,"-317,867.28"
,IN,AR,30312940,1005,100,,Invoice,,,,,,23/04/2018,23/04/2018,0.00,,6.13,,"-317,873.41"
,IN,AR,30312961,1005,100,,Invoice,,,,,,23/04/2018,23/04/2018,0.00,,"2,332.20",,"-320,205.61"
,IN,AR,30312984,1005,100,,Invoice,,,,,,23/04/2018,23/04/2018,0.00,,7.97,,"-320,213.58"
,IN,AR,30313011,1005,100,,Invoice,,,,,,23/04/2018,23/04/2018,0.00,,2.00,,"-320,215.58"
,IN,AR,30313012,1005,100,,Invoice,,,,,,23/04/2018,23/04/2018,0.00,,2.00,,"-320,217.58"
,CS,AR,32002632,1005,100,,Cash sale,,,,,,24/04/2018,24/04/2018,0.00,,3.64,,"-320,221.22"
,CS,AR,32002691,1005,100,,Cash sale,,,,,,24/04/2018,24/04/2018,0.00,,3.01,,"-320,224.23"
,CS,AR,32002696,1005,100,,Cash sale,,,,,,24/04/2018,24/04/2018,0.00,,18.22,,"-320,242.45"
,CS,AR,32002744,1005,100,,Cash sale,,,,,,24/04/2018,24/04/2018,0.00,,14.58,,"-320,257.03"
,CS,AR,32002752,1005,100,,Cash sale,,,,,,24/04/2018,24/04/2018,0.00,,14.58,,"-320,271.61"
,CS,AR,32002794,1005,100,,Cash sale,,,,,,24/04/2018,24/04/2018,0.00,,10.17,,"-320,281.78"
,CS,AR,32002799,1005,100,,Cash sale,,,,,,24/04/2018,24/04/2018,0.00,,7.29,,"-320,289.07"
,CS,AR,32002847,1005,100,,Cash sale,,,,,,24/04/2018,24/04/2018,0.00,,7.29,,"-320,296.36"
,CS,AR,32002857,1005,100,,Cash sale,,,,,,24/04/2018,24/04/2018,0.00,,18.22,,"-320,314.58"
,CS,AR,32002862,1005,100,,Cash sale,,,,,,24/04/2018,24/04/2018,0.00,,5.17,,"-320,319.75"
,CS,AR,32002883,1005,100,,Cash sale,,,,,,24/04/2018,24/04/2018,0.00,,7.29,,"-320,327.04"
,CS,AR,32002898,1005,100,,Cash sale,,,,,,24/04/2018,24/04/2018,0.00,,8.58,,"-320,335.62"
,CS,AR,32002916,1005,100,,Cash sale,,,,,,24/04/2018,24/04/2018,0.00,,15.04,,"-320,350.66"
,CS,AR,32002979,1005,100,,Cash sale,,,,,,24/04/2018,24/04/2018,0.00,,7.75,,"-320,358.41"
,CS,AR,32002984,1005,100,,Cash sale,,,,,,24/04/2018,24/04/2018,0.00,,7.29,,"-320,365.70"
,CS,AR,32002998,1005,100,,Cash sale,,,,,,24/04/2018,24/04/2018,0.00,,2.58,,"-320,368.28"
,CS,AR,32002999,1005,100,,Cash sale,,,,,,24/04/2018,24/04/2018,0.00,,18.05,,"-320,386.33"
,CS,AR,32003004,1005,100,,Cash sale,,,,,,24/04/2018,24/04/2018,0.00,,3.90,,"-320,390.23"
,CS,AR,32003006,1005,100,,Cash sale,,,,,,24/04/2018,24/04/2018,0.00,,3.64,,"-320,393.87"
,CS,AR,32003008,1005,100,,Cash sale,,,,,,24/04/2018,24/04/2018,0.00,,12.88,,"-320,406.75"
,CS,AR,32003014,1005,100,,Cash sale,,,,,,24/04/2018,24/04/2018,0.00,,33.56,,"-320,440.31"
,CS,AR,32003046,1005,100,,Cash sale,,,,,,24/04/2018,24/04/2018,0.00,,25.51,,"-320,465.82"
,CS,AR,32003079,1005,100,,Cash sale,,,,,,24/04/2018,24/04/2018,0.00,,3.64,,"-320,469.46"
,CS,AR,32003126,1005,100,,Cash sale,,,,,,24/04/2018,24/04/2018,0.00,,7.29,,"-320,476.75"
,CS,AR,32003179,1005,100,,Cash sale,,,,,,24/04/2018,24/04/2018,0.00,,5.08,,"-320,481.83"
,CS,AR,32003218,1005,100,,Cash sale,,,,,,24/04/2018,24/04/2018,0.00,,5.09,,"-320,486.92"
,CS,AR,32003247,1005,100,,Cash sale,,,,,,24/04/2018,24/04/2018,0.00,,11.86,,"-320,498.78"
,CS,AR,32003290,1005,100,,Cash sale,,,,,,24/04/2018,24/04/2018,0.00,,3.64,,"-320,502.42"
,CS,AR,32003398,1005,100,,Cash sale,,,,,,24/04/2018,24/04/2018,0.00,,21.86,,"-320,524.28"
,IN,AR,30311080,1005,100,,Invoice,,,,,,24/04/2018,24/04/2018,0.00,,3.01,,"-320,527.29"
,IN,AR,30311098,1005,100,,Invoice,,,,,,24/04/2018,24/04/2018,0.00,,20.76,,"-320,548.05"
,IN,AR,30311184,1005,100,,Invoice,,,,,,24/04/2018,24/04/2018,0.00,,16.27,,"-320,564.32"
,IN,AR,30311194,1005,100,,Invoice,,,,,,24/04/2018,24/04/2018,0.00,,182.20,,"-320,746.52"
,IN,AR,30311226,1005,100,,Invoice,,,,,,24/04/2018,24/04/2018,0.00,,3.98,,"-320,750.50"
,IN,AR,30311244,1005,100,,Invoice,,,,,,24/04/2018,24/04/2018,0.00,,64.07,,"-320,814.57"
,IN,AR,30311248,1005,100,,Invoice,,,,,,24/04/2018,24/04/2018,0.00,,25.51,,"-320,840.08"
,IN,AR,30311254,1005,100,,Invoice,,,,,,24/04/2018,24/04/2018,0.00,,7.29,,"-320,847.37"
,IN,AR,30311276,1005,100,,Invoice,,,,,,24/04/2018,24/04/2018,0.00,,18.22,,"-320,865.59"
,IN,AR,30311330,1005,100,,Invoice,,,,,,24/04/2018,24/04/2018,0.00,,7.29,,"-320,872.88"
,IN,AR,30311379,1005,100,,Invoice,,,,,,24/04/2018,24/04/2018,0.00,,364.41,,"-321,237.29"
,IN,AR,30311385,1005,100,,Invoice,,,,,,24/04/2018,24/04/2018,0.00,,14.58,,"-321,251.87"
,IN,AR,30311388,1005,100,,Invoice,,,,,,24/04/2018,24/04/2018,0.00,,7.29,,"-321,259.16"
,IN,AR,30311394,1005,100,,Invoice,,,,,,24/04/2018,24/04/2018,0.00,,18.22,,"-321,277.38"
,IN,AR,30311412,1005,100,,Invoice,,,,,,24/04/2018,24/04/2018,0.00,,14.58,,"-321,291.96"
,IN,AR,30311421,1005,100,,Invoice,,,,,,24/04/2018,24/04/2018,0.00,,54.66,,"-321,346.62"
,IN,AR,30311443,1005,100,,Invoice,,,,,,24/04/2018,24/04/2018,0.00,,10.99,,"-321,357.61"
,IN,AR,30311504,1005,100,,Invoice,,,,,,24/04/2018,24/04/2018,0.00,,7.29,,"-321,364.90"
,IN,AR,30311525,1005,100,,Invoice,,,,,,24/04/2018,24/04/2018,0.00,,4.64,,"-321,369.54"
,IN,AR,30311555,1005,100,,Invoice,,,,,,24/04/2018,24/04/2018,0.00,,10.59,,"-321,380.13"
,IN,AR,30311562,1005,100,,Invoice,,,,,,24/04/2018,24/04/2018,0.00,,54.66,,"-321,434.79"
,IN,AR,30311577,1005,100,,Invoice,,,,,,24/04/2018,24/04/2018,0.00,,10.59,,"-321,445.38"
,IN,AR,30311579,1005,100,,Invoice,,,,,,24/04/2018,24/04/2018,0.00,,8.47,,"-321,453.85"
,IN,AR,30311634,1005,100,,Invoice,,,,,,24/04/2018,24/04/2018,0.00,,9.03,,"-321,462.88"
,IN,AR,30311643,1005,100,,Invoice,,,,,,24/04/2018,24/04/2018,0.00,,13.64,,"-321,476.52"
,IN,AR,30311745,1005,100,,Invoice,,,,,,24/04/2018,24/04/2018,0.00,,49.02,,"-321,525.54"
,IN,AR,30311820,1005,100,,Invoice,,,,,,24/04/2018,24/04/2018,0.00,,12.71,,"-321,538.25"
,IN,AR,30311830,1005,100,,Invoice,,,,,,24/04/2018,24/04/2018,0.00,,7.29,,"-321,545.54"
,IN,AR,30311839,1005,100,,Invoice,,,,,,24/04/2018,24/04/2018,0.00,,7.29,,"-321,552.83"
,IN,AR,30311841,1005,100,,Invoice,,,,,,24/04/2018,24/04/2018,0.00,,5.85,,"-321,558.68"
,IN,AR,30311884,1005,100,,Invoice,,,,,,24/04/2018,24/04/2018,0.00,,9.92,,"-321,568.60"
,IN,AR,30311887,1005,100,,Invoice,,,,,,24/04/2018,24/04/2018,0.00,,2.39,,"-321,570.99"
,IN,AR,30311896,1005,100,,Invoice,,,,,,24/04/2018,24/04/2018,0.00,,20.34,,"-321,591.33"
,IN,AR,30311902,1005,100,,Invoice,,,,,,24/04/2018,24/04/2018,0.00,,10.53,,"-321,601.86"
,IN,AR,30311926,1005,100,,Invoice,,,,,,24/04/2018,24/04/2018,0.00,,6.36,,"-321,608.22"
,IN,AR,30311933,1005,100,,Invoice,,,,,,24/04/2018,24/04/2018,0.00,,4.24,,"-321,612.46"
,IN,AR,30311938,1005,100,,Invoice,,,,,,24/04/2018,24/04/2018,0.00,,4.29,,"-321,616.75"
,IN,AR,30311991,1005,100,,Invoice,,,,,,24/04/2018,24/04/2018,0.00,,17.80,,"-321,634.55"
,IN,AR,30312004,1005,100,,Invoice,,,,,,24/04/2018,24/04/2018,0.00,,5.59,,"-321,640.14"
,IN,AR,30312062,1005,100,,Invoice,,,,,,24/04/2018,24/04/2018,0.00,,19.30,,"-321,659.44"
,IN,AR,30312069,1005,100,,Invoice,,,,,,24/04/2018,24/04/2018,0.00,,12.88,,"-321,672.32"
,IN,AR,30312091,1005,100,,Invoice,,,,,,24/04/2018,24/04/2018,0.00,,8.26,,"-321,680.58"
,IN,AR,30312097,1005,100,,Invoice,,,,,,24/04/2018,24/04/2018,0.00,,8.39,,"-321,688.97"
,IN,AR,30312113,1005,100,,Invoice,,,,,,24/04/2018,24/04/2018,0.00,,8.52,,"-321,697.49"
,IN,AR,30312144,1005,100,,Invoice,,,,,,24/04/2018,24/04/2018,0.00,,17.56,,"-321,715.05"
,IN,AR,30312186,1005,100,,Invoice,,,,,,24/04/2018,24/04/2018,0.00,,25.73,,"-321,740.78"
,IN,AR,30312205,1005,100,,Invoice,,,,,,24/04/2018,24/04/2018,0.00,,3.53,,"-321,744.31"
,IN,AR,30312228,1005,100,,Invoice,,,,,,24/04/2018,24/04/2018,0.00,,8.24,,"-321,752.55"
,IN,AR,30312234,1005,100,,Invoice,,,,,,24/04/2018,24/04/2018,0.00,,15.51,,"-321,768.06"
,IN,AR,30312236,1005,100,,Invoice,,,,,,24/04/2018,24/04/2018,0.00,,44.49,,"-321,812.55"
,IN,AR,30312346,1005,100,,Invoice,,,,,,24/04/2018,24/04/2018,0.00,,22.26,,"-321,834.81"
,IN,AR,30312347,1005,100,,Invoice,,,,,,24/04/2018,24/04/2018,0.00,,259.17,,"-322,093.98"
,IN,AR,30312360,1005,100,,Invoice,,,,,,24/04/2018,24/04/2018,0.00,,39.75,,"-322,133.73"
,IN,AR,30312361,1005,100,,Invoice,,,,,,24/04/2018,24/04/2018,0.00,,26.00,,"-322,159.73"
,IN,AR,30312394,1005,100,,Invoice,,,,,,24/04/2018,24/04/2018,0.00,,3.64,,"-322,163.37"
,IN,AR,30312415,1005,100,,Invoice,,,,,,24/04/2018,24/04/2018,0.00,,47.54,,"-322,210.91"
,IN,AR,30312419,1005,100,,Invoice,,,,,,24/04/2018,24/04/2018,0.00,,178.56,,"-322,389.47"
,IN,AR,30312462,1005,100,,Invoice,,,,,,24/04/2018,24/04/2018,0.00,,8.02,,"-322,397.49"
,IN,AR,30312485,1005,100,,Invoice,,,,,,24/04/2018,24/04/2018,0.00,,5.47,,"-322,402.96"
,IN,AR,30312529,1005,100,,Invoice,,,,,,24/04/2018,24/04/2018,0.00,,22.88,,"-322,425.84"
,IN,AR,30312530,1005,100,,Invoice,,,,,,24/04/2018,24/04/2018,0.00,,20.34,,"-322,446.18"
,IN,AR,30312545,1005,100,,Invoice,,,,,,24/04/2018,24/04/2018,0.00,,6.00,,"-322,452.18"
,IN,AR,30312546,1005,100,,Invoice,,,,,,24/04/2018,24/04/2018,0.00,,18.01,,"-322,470.19"
,IN,AR,30312559,1005,100,,Invoice,,,,,,24/04/2018,24/04/2018,0.00,,153.05,,"-322,623.24"
,IN,AR,30312605,1005,100,,Invoice,,,,,,24/04/2018,24/04/2018,0.00,,84.10,,"-322,707.34"
,IN,AR,30312637,1005,100,,Invoice,,,,,,24/04/2018,24/04/2018,0.00,,5.47,,"-322,712.81"
,IN,AR,30312678,1005,100,,Invoice,,,,,,24/04/2018,24/04/2018,0.00,,12.14,,"-322,724.95"
,IN,AR,30312695,1005,100,,Invoice,,,,,,24/04/2018,24/04/2018,0.00,,35.59,,"-322,760.54"
,IN,AR,30312697,1005,100,,Invoice,,,,,,24/04/2018,24/04/2018,0.00,,7.29,,"-322,767.83"
,IN,AR,30312759,1005,100,,Invoice,,,,,,24/04/2018,24/04/2018,0.00,,15.93,,"-322,783.76"
,IN,AR,30312768,1005,100,,Invoice,,,,,,24/04/2018,24/04/2018,0.00,,81.36,,"-322,865.12"
,IN,AR,30312781,1005,100,,Invoice,,,,,,24/04/2018,24/04/2018,0.00,,18.98,,"-322,884.10"
,IN,AR,30312820,1005,100,,Invoice,,,,,,24/04/2018,24/04/2018,0.00,,3.51,,"-322,887.61"
,IN,AR,30312826,1005,100,,Invoice,,,,,,24/04/2018,24/04/2018,0.00,,10.00,,"-322,897.61"
,IN,AR,30312837,1005,100,,Invoice,,,,,,24/04/2018,24/04/2018,0.00,,121.02,,"-323,018.63"
,IN,AR,30312847,1005,100,,Invoice,,,,,,24/04/2018,24/04/2018,0.00,,10.93,,"-323,029.56"
,IN,AR,30312855,1005,100,,Invoice,,,,,,24/04/2018,24/04/2018,0.00,,10.93,,"-323,040.49"
,IN,AR,30312859,1005,100,,Invoice,,,,,,24/04/2018,24/04/2018,0.00,,7.02,,"-323,047.51"
,IN,AR,30312882,1005,100,,Invoice,,,,,,24/04/2018,24/04/2018,0.00,,29.15,,"-323,076.66"
,IN,AR,30312970,1005,100,,Invoice,,,,,,24/04/2018,24/04/2018,0.00,,11.02,,"-323,087.68"
,IN,AR,30312974,1005,100,,Invoice,,,,,,24/04/2018,24/04/2018,0.00,,2.80,,"-323,090.48"
,IN,AR,30312991,1005,100,,Invoice,,,,,,24/04/2018,24/04/2018,0.00,,49.70,,"-323,140.18"
,IN,AR,30313049,1005,100,,Invoice,,,,,,24/04/2018,24/04/2018,0.00,,12.46,,"-323,152.64"
,CN,AR,31017823,1005,100,,Credit Note,,,,,,25/04/2018,25/04/2018,"1,301.69",,0.00,,"-321,850.95"
,CS,AR,32002604,1005,100,,Cash sale,,,,,,25/04/2018,25/04/2018,0.00,,8.42,,"-321,859.37"
,CS,AR,32002613,1005,100,,Cash sale,,,,,,25/04/2018,25/04/2018,0.00,,52.68,,"-321,912.05"
,CS,AR,32002656,1005,100,,Cash sale,,,,,,25/04/2018,25/04/2018,0.00,,3.64,,"-321,915.69"
,CS,AR,32002730,1005,100,,Cash sale,,,,,,25/04/2018,25/04/2018,0.00,,6.02,,"-321,921.71"
,CS,AR,32002758,1005,100,,Cash sale,,,,,,25/04/2018,25/04/2018,0.00,,7.29,,"-321,929.00"
,CS,AR,32002772,1005,100,,Cash sale,,,,,,25/04/2018,25/04/2018,0.00,,8.78,,"-321,937.78"
,CS,AR,32002782,1005,100,,Cash sale,,,,,,25/04/2018,25/04/2018,0.00,,7.29,,"-321,945.07"
,CS,AR,32002850,1005,100,,Cash sale,,,,,,25/04/2018,25/04/2018,0.00,,41.36,,"-321,986.43"
,CS,AR,32002860,1005,100,,Cash sale,,,,,,25/04/2018,25/04/2018,0.00,,3.64,,"-321,990.07"
,CS,AR,32002873,1005,100,,Cash sale,,,,,,25/04/2018,25/04/2018,0.00,,15.04,,"-322,005.11"
,CS,AR,32002877,1005,100,,Cash sale,,,,,,25/04/2018,25/04/2018,0.00,,8.58,,"-322,013.69"
,CS,AR,32002894,1005,100,,Cash sale,,,,,,25/04/2018,25/04/2018,0.00,,10.93,,"-322,024.62"
,CS,AR,32002910,1005,100,,Cash sale,,,,,,25/04/2018,25/04/2018,0.00,,5.08,,"-322,029.70"
,CS,AR,32002914,1005,100,,Cash sale,,,,,,25/04/2018,25/04/2018,0.00,,5.08,,"-322,034.78"
,CS,AR,32002915,1005,100,,Cash sale,,,,,,25/04/2018,25/04/2018,0.00,,7.00,,"-322,041.78"
,CS,AR,32002950,1005,100,,Cash sale,,,,,,25/04/2018,25/04/2018,0.00,,4.32,,"-322,046.10"
,CS,AR,32002961,1005,100,,Cash sale,,,,,,25/04/2018,25/04/2018,0.00,,27.97,,"-322,074.07"
,CS,AR,32003009,1005,100,,Cash sale,,,,,,25/04/2018,25/04/2018,0.00,,3.64,,"-322,077.71"
,CS,AR,32003031,1005,100,,Cash sale,,,,,,25/04/2018,25/04/2018,0.00,,14.58,,"-322,092.29"
,CS,AR,32003036,1005,100,,Cash sale,,,,,,25/04/2018,25/04/2018,0.00,,5.17,,"-322,097.46"
,CS,AR,32003039,1005,100,,Cash sale,,,,,,25/04/2018,25/04/2018,0.00,,11.19,,"-322,108.65"
,CS,AR,32003053,1005,100,,Cash sale,,,,,,25/04/2018,25/04/2018,0.00,,3.64,,"-322,112.29"
,CS,AR,32003072,1005,100,,Cash sale,,,,,,25/04/2018,25/04/2018,0.00,,21.86,,"-322,134.15"
,CS,AR,32003084,1005,100,,Cash sale,,,,,,25/04/2018,25/04/2018,0.00,,3.64,,"-322,137.79"
,CS,AR,32003171,1005,100,,Cash sale,,,,,,25/04/2018,25/04/2018,0.00,,7.29,,"-322,145.08"
,CS,AR,32003194,1005,100,,Cash sale,,,,,,25/04/2018,25/04/2018,0.00,,3.64,,"-322,148.72"
,CS,AR,32003213,1005,100,,Cash sale,,,,,,25/04/2018,25/04/2018,0.00,,20.34,,"-322,169.06"
,CS,AR,32003236,1005,100,,Cash sale,,,,,,25/04/2018,25/04/2018,0.00,,9.15,,"-322,178.21"
,CS,AR,32003273,1005,100,,Cash sale,,,,,,25/04/2018,25/04/2018,0.00,,60.71,,"-322,238.92"
,CS,AR,32003296,1005,100,,Cash sale,,,,,,25/04/2018,25/04/2018,0.00,,5.47,,"-322,244.39"
,CS,AR,32003303,1005,100,,Cash sale,,,,,,25/04/2018,25/04/2018,0.00,,10.93,,"-322,255.32"
,CS,AR,32003310,1005,100,,Cash sale,,,,,,25/04/2018,25/04/2018,0.00,,5.08,,"-322,260.40"
,CS,AR,32003324,1005,100,,Cash sale,,,,,,25/04/2018,25/04/2018,0.00,,12.14,,"-322,272.54"
,CS,AR,32003328,1005,100,,Cash sale,,,,,,25/04/2018,25/04/2018,0.00,,7.29,,"-322,279.83"
,CS,AR,32003384,1005,100,,Cash sale,,,,,,25/04/2018,25/04/2018,0.00,,10.99,,"-322,290.82"
,CS,AR,32003387,1005,100,,Cash sale,,,,,,25/04/2018,25/04/2018,0.00,,3.64,,"-322,294.46"
,CS,AR,32003413,1005,100,,Cash sale,,,,,,25/04/2018,25/04/2018,0.00,,29.15,,"-322,323.61"
,IN,AR,30311084,1005,100,,Invoice,,,,,,25/04/2018,25/04/2018,0.00,,84.54,,"-322,408.15"
,IN,AR,30311099,1005,100,,Invoice,,,,,,25/04/2018,25/04/2018,0.00,,59.32,,"-322,467.47"
,IN,AR,30311133,1005,100,,Invoice,,,,,,25/04/2018,25/04/2018,0.00,,85.42,,"-322,552.89"
,IN,AR,30311134,1005,100,,Invoice,,,,,,25/04/2018,25/04/2018,0.00,,39.05,,"-322,591.94"
,IN,AR,30311147,1005,100,,Invoice,,,,,,25/04/2018,25/04/2018,0.00,,8.52,,"-322,600.46"
,IN,AR,30311161,1005,100,,Invoice,,,,,,25/04/2018,25/04/2018,0.00,,21.02,,"-322,621.48"
,IN,AR,30311162,1005,100,,Invoice,,,,,,25/04/2018,25/04/2018,0.00,,73.56,,"-322,695.04"
,IN,AR,30311163,1005,100,,Invoice,,,,,,25/04/2018,25/04/2018,0.00,,7.29,,"-322,702.33"
,IN,AR,30311245,1005,100,,Invoice,,,,,,25/04/2018,25/04/2018,0.00,,66.44,,"-322,768.77"
,IN,AR,30311268,1005,100,,Invoice,,,,,,25/04/2018,25/04/2018,0.00,,30.00,,"-322,798.77"
,IN,AR,30311297,1005,100,,Invoice,,,,,,25/04/2018,25/04/2018,0.00,,7.29,,"-322,806.06"
,IN,AR,30311319,1005,100,,Invoice,,,,,,25/04/2018,25/04/2018,0.00,,48.00,,"-322,854.06"
,IN,AR,30311360,1005,100,,Invoice,,,,,,25/04/2018,25/04/2018,0.00,,38.00,,"-322,892.06"
,IN,AR,30311409,1005,100,,Invoice,,,,,,25/04/2018,25/04/2018,0.00,,218.31,,"-323,110.37"
,IN,AR,30311429,1005,100,,Invoice,,,,,,25/04/2018,25/04/2018,0.00,,88.42,,"-323,198.79"
,IN,AR,30311483,1005,100,,Invoice,,,,,,25/04/2018,25/04/2018,0.00,,10.93,,"-323,209.72"
,IN,AR,30311548,1005,100,,Invoice,,,,,,25/04/2018,25/04/2018,0.00,,17.80,,"-323,227.52"
,IN,AR,30311559,1005,100,,Invoice,,,,,,25/04/2018,25/04/2018,0.00,,4.24,,"-323,231.76"
,IN,AR,30311573,1005,100,,Invoice,,,,,,25/04/2018,25/04/2018,0.00,,4.24,,"-323,236.00"
,IN,AR,30311582,1005,100,,Invoice,,,,,,25/04/2018,25/04/2018,0.00,,5.59,,"-323,241.59"
,IN,AR,30311623,1005,100,,Invoice,,,,,,25/04/2018,25/04/2018,0.00,,25.51,,"-323,267.10"
,IN,AR,30311639,1005,100,,Invoice,,,,,,25/04/2018,25/04/2018,0.00,,19.12,,"-323,286.22"
,IN,AR,30311658,1005,100,,Invoice,,,,,,25/04/2018,25/04/2018,0.00,,55.37,,"-323,341.59"
,IN,AR,30311739,1005,100,,Invoice,,,,,,25/04/2018,25/04/2018,0.00,,15.51,,"-323,357.10"
,IN,AR,30311753,1005,100,,Invoice,,,,,,25/04/2018,25/04/2018,0.00,,216.07,,"-323,573.17"
,IN,AR,30311765,1005,100,,Invoice,,,,,,25/04/2018,25/04/2018,0.00,,12.97,,"-323,586.14"
,IN,AR,30311802,1005,100,,Invoice,,,,,,25/04/2018,25/04/2018,0.00,,1.59,,"-323,587.73"
,IN,AR,30311816,1005,100,,Invoice,,,,,,25/04/2018,25/04/2018,0.00,,6.36,,"-323,594.09"
,IN,AR,30311852,1005,100,,Invoice,,,,,,25/04/2018,25/04/2018,0.00,,18.17,,"-323,612.26"
,IN,AR,30311937,1005,100,,Invoice,,,,,,25/04/2018,25/04/2018,0.00,,10.93,,"-323,623.19"
,IN,AR,30311974,1005,100,,Invoice,,,,,,25/04/2018,25/04/2018,0.00,,8.42,,"-323,631.61"
,IN,AR,30311992,1005,100,,Invoice,,,,,,25/04/2018,25/04/2018,0.00,,17.80,,"-323,649.41"
,IN,AR,30312018,1005,100,,Invoice,,,,,,25/04/2018,25/04/2018,0.00,,10.93,,"-323,660.34"
,IN,AR,30312037,1005,100,,Invoice,,,,,,25/04/2018,25/04/2018,0.00,,7.29,,"-323,667.63"
,IN,AR,30312094,1005,100,,Invoice,,,,,,25/04/2018,25/04/2018,0.00,,3.64,,"-323,671.27"
,IN,AR,30312133,1005,100,,Invoice,,,,,,25/04/2018,25/04/2018,0.00,,36.10,,"-323,707.37"
,IN,AR,30312171,1005,100,,Invoice,,,,,,25/04/2018,25/04/2018,0.00,,31.23,,"-323,738.60"
,IN,AR,30312206,1005,100,,Invoice,,,,,,25/04/2018,25/04/2018,0.00,,3.53,,"-323,742.13"
,IN,AR,30312210,1005,100,,Invoice,,,,,,25/04/2018,25/04/2018,0.00,,15.04,,"-323,757.17"
,IN,AR,30312249,1005,100,,Invoice,,,,,,25/04/2018,25/04/2018,0.00,,5.17,,"-323,762.34"
,IN,AR,30312264,1005,100,,Invoice,,,,,,25/04/2018,25/04/2018,0.00,,8.78,,"-323,771.12"
,IN,AR,30312268,1005,100,,Invoice,,,,,,25/04/2018,25/04/2018,0.00,,10.00,,"-323,781.12"
,IN,AR,30312312,1005,100,,Invoice,,,,,,25/04/2018,25/04/2018,0.00,,7.29,,"-323,788.41"
,IN,AR,30312314,1005,100,,Invoice,,,,,,25/04/2018,25/04/2018,0.00,,4.58,,"-323,792.99"
,IN,AR,30312365,1005,100,,Invoice,,,,,,25/04/2018,25/04/2018,0.00,,36.00,,"-323,828.99"
,IN,AR,30312401,1005,100,,Invoice,,,,,,25/04/2018,25/04/2018,0.00,,3.64,,"-323,832.63"
,IN,AR,30312463,1005,100,,Invoice,,,,,,25/04/2018,25/04/2018,0.00,,11.22,,"-323,843.85"
,IN,AR,30312464,1005,100,,Invoice,,,,,,25/04/2018,25/04/2018,0.00,,17.64,,"-323,861.49"
,IN,AR,30312465,1005,100,,Invoice,,,,,,25/04/2018,25/04/2018,0.00,,25.65,,"-323,887.14"
,IN,AR,30312466,1005,100,,Invoice,,,,,,25/04/2018,25/04/2018,0.00,,6.42,,"-323,893.56"
,IN,AR,30312467,1005,100,,Invoice,,,,,,25/04/2018,25/04/2018,0.00,,4.81,,"-323,898.37"
,IN,AR,30312500,1005,100,,Invoice,,,,,,25/04/2018,25/04/2018,0.00,,38.81,,"-323,937.18"
,IN,AR,30312516,1005,100,,Invoice,,,,,,25/04/2018,25/04/2018,0.00,,10.93,,"-323,948.11"
,IN,AR,30312551,1005,100,,Invoice,,,,,,25/04/2018,25/04/2018,0.00,,20.01,,"-323,968.12"
,IN,AR,30312588,1005,100,,Invoice,,,,,,25/04/2018,25/04/2018,0.00,,6.03,,"-323,974.15"
,IN,AR,30312592,1005,100,,Invoice,,,,,,25/04/2018,25/04/2018,0.00,,8.75,,"-323,982.90"
,IN,AR,30312608,1005,100,,Invoice,,,,,,25/04/2018,25/04/2018,0.00,,12.03,,"-323,994.93"
,IN,AR,30312612,1005,100,,Invoice,,,,,,25/04/2018,25/04/2018,0.00,,11.95,,"-324,006.88"
,IN,AR,30312656,1005,100,,Invoice,,,,,,25/04/2018,25/04/2018,0.00,,10.93,,"-324,017.81"
,IN,AR,30312698,1005,100,,Invoice,,,,,,25/04/2018,25/04/2018,0.00,,29.15,,"-324,046.96"
,IN,AR,30312760,1005,100,,Invoice,,,,,,25/04/2018,25/04/2018,0.00,,7.97,,"-324,054.93"
,IN,AR,30312782,1005,100,,Invoice,,,,,,25/04/2018,25/04/2018,0.00,,104.42,,"-324,159.35"
,IN,AR,30312793,1005,100,,Invoice,,,,,,25/04/2018,25/04/2018,0.00,,"1,301.69",,"-325,461.04"
,IN,AR,30312816,1005,100,,Invoice,,,,,,25/04/2018,25/04/2018,0.00,,5.26,,"-325,466.30"
,IN,AR,30312864,1005,100,,Invoice,,,,,,25/04/2018,25/04/2018,0.00,,10.93,,"-325,477.23"
,IN,AR,30312894,1005,100,,Invoice,,,,,,25/04/2018,25/04/2018,0.00,,9.41,,"-325,486.64"
,IN,AR,30312926,1005,100,,Invoice,,,,,,25/04/2018,25/04/2018,0.00,,14.83,,"-325,501.47"
,IN,AR,30312927,1005,100,,Invoice,,,,,,25/04/2018,25/04/2018,0.00,,13.09,,"-325,514.56"
,IN,AR,30312931,1005,100,,Invoice,,,,,,25/04/2018,25/04/2018,0.00,,16.78,,"-325,531.34"
,IN,AR,30312972,1005,100,,Invoice,,,,,,25/04/2018,25/04/2018,0.00,,7.76,,"-325,539.10"
,IN,AR,30312995,1005,100,,Invoice,,,,,,25/04/2018,25/04/2018,0.00,,16.02,,"-325,555.12"
,IN,AR,30313050,1005,100,,Invoice,,,,,,25/04/2018,25/04/2018,0.00,,4.15,,"-325,559.27"
,IN,AR,30313051,1005,100,,Invoice,,,,,,25/04/2018,25/04/2018,0.00,,45.68,,"-325,604.95"
,IN,AR,30313052,1005,100,,Invoice,,,,,,25/04/2018,25/04/2018,0.00,,8.31,,"-325,613.26"
,IN,AR,30313053,1005,100,,Invoice,,,,,,25/04/2018,25/04/2018,0.00,,14.53,,"-325,627.79"
,IN,AR,30313054,1005,100,,Invoice,,,,,,25/04/2018,25/04/2018,0.00,,16.61,,"-325,644.40"
,IN,AR,30313095,1005,100,,Invoice,,,,,,25/04/2018,25/04/2018,0.00,,18.20,,"-325,662.60"
,IN,AR,30313114,1005,100,,Invoice,,,,,,25/04/2018,25/04/2018,0.00,,10.93,,"-325,673.53"
,CN,AR,31017694,1005,100,,Credit Note,,,,,,26/04/2018,26/04/2018,2.03,,0.00,,"-325,671.50"
,CN,AR,31017695,1005,100,,Credit Note,,,,,,26/04/2018,26/04/2018,2.03,,0.00,,"-325,669.47"
,CN,AR,31017701,1005,100,,Credit Note,,,,,,26/04/2018,26/04/2018,29.15,,0.00,,"-325,640.32"
,CS,AR,32002605,1005,100,,Cash sale,,,,,,26/04/2018,26/04/2018,0.00,,28.47,,"-325,668.79"
,CS,AR,32002623,1005,100,,Cash sale,,,,,,26/04/2018,26/04/2018,0.00,,3.64,,"-325,672.43"
,CS,AR,32002628,1005,100,,Cash sale,,,,,,26/04/2018,26/04/2018,0.00,,7.29,,"-325,679.72"
,CS,AR,32002629,1005,100,,Cash sale,,,,,,26/04/2018,26/04/2018,0.00,,3.64,,"-325,683.36"
,CS,AR,32002638,1005,100,,Cash sale,,,,,,26/04/2018,26/04/2018,0.00,,7.29,,"-325,690.65"
,CS,AR,32002644,1005,100,,Cash sale,,,,,,26/04/2018,26/04/2018,0.00,,5.17,,"-325,695.82"
,CS,AR,32002646,1005,100,,Cash sale,,,,,,26/04/2018,26/04/2018,0.00,,10.93,,"-325,706.75"
,CS,AR,32002661,1005,100,,Cash sale,,,,,,26/04/2018,26/04/2018,0.00,,3.64,,"-325,710.39"
,CS,AR,32002678,1005,100,,Cash sale,,,,,,26/04/2018,26/04/2018,0.00,,3.64,,"-325,714.03"
,CS,AR,32002694,1005,100,,Cash sale,,,,,,26/04/2018,26/04/2018,0.00,,3.64,,"-325,717.67"
,CS,AR,32002745,1005,100,,Cash sale,,,,,,26/04/2018,26/04/2018,0.00,,364.41,,"-326,082.08"
,CS,AR,32002751,1005,100,,Cash sale,,,,,,26/04/2018,26/04/2018,0.00,,18.22,,"-326,100.30"
,CS,AR,32002776,1005,100,,Cash sale,,,,,,26/04/2018,26/04/2018,0.00,,10.93,,"-326,111.23"
,CS,AR,32002777,1005,100,,Cash sale,,,,,,26/04/2018,26/04/2018,0.00,,3.64,,"-326,114.87"
,CS,AR,32002925,1005,100,,Cash sale,,,,,,26/04/2018,26/04/2018,0.00,,13.47,,"-326,128.34"
,CS,AR,32002969,1005,100,,Cash sale,,,,,,26/04/2018,26/04/2018,0.00,,3.64,,"-326,131.98"
,CS,AR,32002982,1005,100,,Cash sale,,,,,,26/04/2018,26/04/2018,0.00,,3.64,,"-326,135.62"
,CS,AR,32003019,1005,100,,Cash sale,,,,,,26/04/2018,26/04/2018,0.00,,7.75,,"-326,143.37"
,CS,AR,32003044,1005,100,,Cash sale,,,,,,26/04/2018,26/04/2018,0.00,,2.16,,"-326,145.53"
,CS,AR,32003066,1005,100,,Cash sale,,,,,,26/04/2018,26/04/2018,0.00,,5.17,,"-326,150.70"
,CS,AR,32003129,1005,100,,Cash sale,,,,,,26/04/2018,26/04/2018,0.00,,7.29,,"-326,157.99"
,CS,AR,32003139,1005,100,,Cash sale,,,,,,26/04/2018,26/04/2018,0.00,,2.62,,"-326,160.61"
,CS,AR,32003154,1005,100,,Cash sale,,,,,,26/04/2018,26/04/2018,0.00,,10.93,,"-326,171.54"
,CS,AR,32003162,1005,100,,Cash sale,,,,,,26/04/2018,26/04/2018,0.00,,5.17,,"-326,176.71"
,CS,AR,32003175,1005,100,,Cash sale,,,,,,26/04/2018,26/04/2018,0.00,,32.80,,"-326,209.51"
,CS,AR,32003205,1005,100,,Cash sale,,,,,,26/04/2018,26/04/2018,0.00,,5.93,,"-326,215.44"
,CS,AR,32003241,1005,100,,Cash sale,,,,,,26/04/2018,26/04/2018,0.00,,21.86,,"-326,237.30"
,CS,AR,32003280,1005,100,,Cash sale,,,,,,26/04/2018,26/04/2018,0.00,,10.93,,"-326,248.23"
,CS,AR,32003410,1005,100,,Cash sale,,,,,,26/04/2018,26/04/2018,0.00,,14.58,,"-326,262.81"
,IN,AR,30311171,1005,100,,Invoice,,,,,,26/04/2018,26/04/2018,0.00,,14.58,,"-326,277.39"
,IN,AR,30311185,1005,100,,Invoice,,,,,,26/04/2018,26/04/2018,0.00,,2.03,,"-326,279.42"
,IN,AR,30311186,1005,100,,Invoice,,,,,,26/04/2018,26/04/2018,0.00,,2.03,,"-326,281.45"
,IN,AR,30311188,1005,100,,Invoice,,,,,,26/04/2018,26/04/2018,0.00,,14.24,,"-326,295.69"
,IN,AR,30311207,1005,100,,Invoice,,,,,,26/04/2018,26/04/2018,0.00,,54.66,,"-326,350.35"
,IN,AR,30311227,1005,100,,Invoice,,,,,,26/04/2018,26/04/2018,0.00,,1.99,,"-326,352.34"
,IN,AR,30311246,1005,100,,Invoice,,,,,,26/04/2018,26/04/2018,0.00,,64.07,,"-326,416.41"
,IN,AR,30311287,1005,100,,Invoice,,,,,,26/04/2018,26/04/2018,0.00,,25.51,,"-326,441.92"
,IN,AR,30311293,1005,100,,Invoice,,,,,,26/04/2018,26/04/2018,0.00,,10.93,,"-326,452.85"
,IN,AR,30311347,1005,100,,Invoice,,,,,,26/04/2018,26/04/2018,0.00,,7.29,,"-326,460.14"
,IN,AR,30311369,1005,100,,Invoice,,,,,,26/04/2018,26/04/2018,0.00,,73.56,,"-326,533.70"
,IN,AR,30311392,1005,100,,Invoice,,,,,,26/04/2018,26/04/2018,0.00,,32.95,,"-326,566.65"
,IN,AR,30311395,1005,100,,Invoice,,,,,,26/04/2018,26/04/2018,0.00,,364.41,,"-326,931.06"
,IN,AR,30311496,1005,100,,Invoice,,,,,,26/04/2018,26/04/2018,0.00,,18.22,,"-326,949.28"
,IN,AR,30311502,1005,100,,Invoice,,,,,,26/04/2018,26/04/2018,0.00,,7.29,,"-326,956.57"
,IN,AR,30311510,1005,100,,Invoice,,,,,,26/04/2018,26/04/2018,0.00,,21.00,,"-326,977.57"
,IN,AR,30311598,1005,100,,Invoice,,,,,,26/04/2018,26/04/2018,0.00,,7.29,,"-326,984.86"
,IN,AR,30311628,1005,100,,Invoice,,,,,,26/04/2018,26/04/2018,0.00,,11.95,,"-326,996.81"
,IN,AR,30311647,1005,100,,Invoice,,,,,,26/04/2018,26/04/2018,0.00,,22.03,,"-327,018.84"
,IN,AR,30311662,1005,100,,Invoice,,,,,,26/04/2018,26/04/2018,0.00,,3.64,,"-327,022.48"
,IN,AR,30311674,1005,100,,Invoice,,,,,,26/04/2018,26/04/2018,0.00,,94.07,,"-327,116.55"
,IN,AR,30311675,1005,100,,Invoice,,,,,,26/04/2018,26/04/2018,0.00,,10.17,,"-327,126.72"
,IN,AR,30311695,1005,100,,Invoice,,,,,,26/04/2018,26/04/2018,0.00,,14.34,,"-327,141.06"
,IN,AR,30311708,1005,100,,Invoice,,,,,,26/04/2018,26/04/2018,0.00,,12.88,,"-327,153.94"
,IN,AR,30311758,1005,100,,Invoice,,,,,,26/04/2018,26/04/2018,0.00,,14.58,,"-327,168.52"
,IN,AR,30311760,1005,100,,Invoice,,,,,,26/04/2018,26/04/2018,0.00,,10.59,,"-327,179.11"
,IN,AR,30311764,1005,100,,Invoice,,,,,,26/04/2018,26/04/2018,0.00,,2.39,,"-327,181.50"
,IN,AR,30311782,1005,100,,Invoice,,,,,,26/04/2018,26/04/2018,0.00,,7.63,,"-327,189.13"
,IN,AR,30311803,1005,100,,Invoice,,,,,,26/04/2018,26/04/2018,0.00,,55.76,,"-327,244.89"
,IN,AR,30311804,1005,100,,Invoice,,,,,,26/04/2018,26/04/2018,0.00,,46.20,,"-327,291.09"
,IN,AR,30311808,1005,100,,Invoice,,,,,,26/04/2018,26/04/2018,0.00,,16.55,,"-327,307.64"
,IN,AR,30311813,1005,100,,Invoice,,,,,,26/04/2018,26/04/2018,0.00,,2.58,,"-327,310.22"
,IN,AR,30311834,1005,100,,Invoice,,,,,,26/04/2018,26/04/2018,0.00,,16.95,,"-327,327.17"
,IN,AR,30311862,1005,100,,Invoice,,,,,,26/04/2018,26/04/2018,0.00,,20.34,,"-327,347.51"
,IN,AR,30311869,1005,100,,Invoice,,,,,,26/04/2018,26/04/2018,0.00,,15.00,,"-327,362.51"
,IN,AR,30311957,1005,100,,Invoice,,,,,,26/04/2018,26/04/2018,0.00,,16.47,,"-327,378.98"
,IN,AR,30311996,1005,100,,Invoice,,,,,,26/04/2018,26/04/2018,0.00,,7.00,,"-327,385.98"
,IN,AR,30311999,1005,100,,Invoice,,,,,,26/04/2018,26/04/2018,0.00,,7.29,,"-327,393.27"
,IN,AR,30312074,1005,100,,Invoice,,,,,,26/04/2018,26/04/2018,0.00,,6.97,,"-327,400.24"
,IN,AR,30312080,1005,100,,Invoice,,,,,,26/04/2018,26/04/2018,0.00,,5.85,,"-327,406.09"
,IN,AR,30312083,1005,100,,Invoice,,,,,,26/04/2018,26/04/2018,0.00,,21.86,,"-327,427.95"
,IN,AR,30312086,1005,100,,Invoice,,,,,,26/04/2018,26/04/2018,0.00,,14.58,,"-327,442.53"
,IN,AR,30312092,1005,100,,Invoice,,,,,,26/04/2018,26/04/2018,0.00,,16.53,,"-327,459.06"
,IN,AR,30312141,1005,100,,Invoice,,,,,,26/04/2018,26/04/2018,0.00,,24.07,,"-327,483.13"
,IN,AR,30312146,1005,100,,Invoice,,,,,,26/04/2018,26/04/2018,0.00,,15.17,,"-327,498.30"
,IN,AR,30312159,1005,100,,Invoice,,,,,,26/04/2018,26/04/2018,0.00,,13.58,,"-327,511.88"
,IN,AR,30312164,1005,100,,Invoice,,,,,,26/04/2018,26/04/2018,0.00,,10.17,,"-327,522.05"
,IN,AR,30312167,1005,100,,Invoice,,,,,,26/04/2018,26/04/2018,0.00,,6.53,,"-327,528.58"
,IN,AR,30312172,1005,100,,Invoice,,,,,,26/04/2018,26/04/2018,0.00,,17.15,,"-327,545.73"
,IN,AR,30312178,1005,100,,Invoice,,,,,,26/04/2018,26/04/2018,0.00,,8.00,,"-327,553.73"
,IN,AR,30312179,1005,100,,Invoice,,,,,,26/04/2018,26/04/2018,0.00,,9.85,,"-327,563.58"
,IN,AR,30312190,1005,100,,Invoice,,,,,,26/04/2018,26/04/2018,0.00,,29.15,,"-327,592.73"
,IN,AR,30312219,1005,100,,Invoice,,,,,,26/04/2018,26/04/2018,0.00,,14.58,,"-327,607.31"
,IN,AR,30312226,1005,100,,Invoice,,,,,,26/04/2018,26/04/2018,0.00,,6.81,,"-327,614.12"
,IN,AR,30312303,1005,100,,Invoice,,,,,,26/04/2018,26/04/2018,0.00,,14.58,,"-327,628.70"
,IN,AR,30312317,1005,100,,Invoice,,,,,,26/04/2018,26/04/2018,0.00,,10.93,,"-327,639.63"
,IN,AR,30312333,1005,100,,Invoice,,,,,,26/04/2018,26/04/2018,0.00,,11.39,,"-327,651.02"
,IN,AR,30312334,1005,100,,Invoice,,,,,,26/04/2018,26/04/2018,0.00,,13.02,,"-327,664.04"
,IN,AR,30312335,1005,100,,Invoice,,,,,,26/04/2018,26/04/2018,0.00,,3.25,,"-327,667.29"
,IN,AR,30312336,1005,100,,Invoice,,,,,,26/04/2018,26/04/2018,0.00,,32.54,,"-327,699.83"
,IN,AR,30312348,1005,100,,Invoice,,,,,,26/04/2018,26/04/2018,0.00,,7.95,,"-327,707.78"
,IN,AR,30312349,1005,100,,Invoice,,,,,,26/04/2018,26/04/2018,0.00,,15.90,,"-327,723.68"
,IN,AR,30312350,1005,100,,Invoice,,,,,,26/04/2018,26/04/2018,0.00,,9.54,,"-327,733.22"
,IN,AR,30312351,1005,100,,Invoice,,,,,,26/04/2018,26/04/2018,0.00,,18.04,,"-327,751.26"
,IN,AR,30312379,1005,100,,Invoice,,,,,,26/04/2018,26/04/2018,0.00,,62.14,,"-327,813.40"
,IN,AR,30312391,1005,100,,Invoice,,,,,,26/04/2018,26/04/2018,0.00,,10.93,,"-327,824.33"
,IN,AR,30312468,1005,100,,Invoice,,,,,,26/04/2018,26/04/2018,0.00,,11.22,,"-327,835.55"
,IN,AR,30312469,1005,100,,Invoice,,,,,,26/04/2018,26/04/2018,0.00,,8.02,,"-327,843.57"
,IN,AR,30312484,1005,100,,Invoice,,,,,,26/04/2018,26/04/2018,0.00,,364.41,,"-328,207.98"
,IN,AR,30312535,1005,100,,Invoice,,,,,,26/04/2018,26/04/2018,0.00,,22.01,,"-328,229.99"
,IN,AR,30312547,1005,100,,Invoice,,,,,,26/04/2018,26/04/2018,0.00,,2.00,,"-328,231.99"
,IN,AR,30312569,1005,100,,Invoice,,,,,,26/04/2018,26/04/2018,0.00,,5.83,,"-328,237.82"
,IN,AR,30312570,1005,100,,Invoice,,,,,,26/04/2018,26/04/2018,0.00,,14.58,,"-328,252.40"
,IN,AR,30312578,1005,100,,Invoice,,,,,,26/04/2018,26/04/2018,0.00,,59.62,,"-328,312.02"
,IN,AR,30312594,1005,100,,Invoice,,,,,,26/04/2018,26/04/2018,0.00,,7.29,,"-328,319.31"
,IN,AR,30312655,1005,100,,Invoice,,,,,,26/04/2018,26/04/2018,0.00,,27.46,,"-328,346.77"
,IN,AR,30312761,1005,100,,Invoice,,,,,,26/04/2018,26/04/2018,0.00,,3.19,,"-328,349.96"
,IN,AR,30312762,1005,100,,Invoice,,,,,,26/04/2018,26/04/2018,0.00,,9.56,,"-328,359.52"
,IN,AR,30312763,1005,100,,Invoice,,,,,,26/04/2018,26/04/2018,0.00,,133.83,,"-328,493.35"
,IN,AR,30312764,1005,100,,Invoice,,,,,,26/04/2018,26/04/2018,0.00,,15.93,,"-328,509.28"
,IN,AR,30312783,1005,100,,Invoice,,,,,,26/04/2018,26/04/2018,0.00,,30.85,,"-328,540.13"
,IN,AR,30312795,1005,100,,Invoice,,,,,,26/04/2018,26/04/2018,0.00,,22.37,,"-328,562.50"
,IN,AR,30312841,1005,100,,Invoice,,,,,,26/04/2018,26/04/2018,0.00,,29.15,,"-328,591.65"
,IN,AR,30312868,1005,100,,Invoice,,,,,,26/04/2018,26/04/2018,0.00,,10.99,,"-328,602.64"
,IN,AR,30312903,1005,100,,Invoice,,,,,,26/04/2018,26/04/2018,0.00,,279.66,,"-328,882.30"
,IN,AR,30312907,1005,100,,Invoice,,,,,,26/04/2018,26/04/2018,0.00,,8.78,,"-328,891.08"
,IN,AR,30312942,1005,100,,Invoice,,,,,,26/04/2018,26/04/2018,0.00,,20.42,,"-328,911.50"
,IN,AR,30312948,1005,100,,Invoice,,,,,,26/04/2018,26/04/2018,0.00,,7.29,,"-328,918.79"
,IN,AR,30312986,1005,100,,Invoice,,,,,,26/04/2018,26/04/2018,0.00,,29.15,,"-328,947.94"
,IN,AR,30312998,1005,100,,Invoice,,,,,,26/04/2018,26/04/2018,0.00,,4.83,,"-328,952.77"
,IN,AR,30313055,1005,100,,Invoice,,,,,,26/04/2018,26/04/2018,0.00,,33.22,,"-328,985.99"
,IN,AR,30313104,1005,100,,Invoice,,,,,,26/04/2018,26/04/2018,0.00,,364.41,,"-329,350.40"
,IN,AR,30313113,1005,100,,Invoice,,,,,,26/04/2018,26/04/2018,0.00,,6.19,,"-329,356.59"
,IN,AR,30313115,1005,100,,Invoice,,,,,,26/04/2018,26/04/2018,0.00,,419.07,,"-329,775.66"
,CS,AR,32002620,1005,100,,Cash sale,,,,,,27/04/2018,27/04/2018,0.00,,7.12,,"-329,782.78"
,CS,AR,32002627,1005,100,,Cash sale,,,,,,27/04/2018,27/04/2018,0.00,,8.52,,"-329,791.30"
,CS,AR,32002687,1005,100,,Cash sale,,,,,,27/04/2018,27/04/2018,0.00,,12.08,,"-329,803.38"
,CS,AR,32002701,1005,100,,Cash sale,,,,,,27/04/2018,27/04/2018,0.00,,11.86,,"-329,815.24"
,CS,AR,32002719,1005,100,,Cash sale,,,,,,27/04/2018,27/04/2018,0.00,,16.61,,"-329,831.85"
,CS,AR,32002973,1005,100,,Cash sale,,,,,,27/04/2018,27/04/2018,0.00,,17.80,,"-329,849.65"
,CS,AR,32003056,1005,100,,Cash sale,,,,,,27/04/2018,27/04/2018,0.00,,20.48,,"-329,870.13"
,CS,AR,32003090,1005,100,,Cash sale,,,,,,27/04/2018,27/04/2018,0.00,,5.17,,"-329,875.30"
,CS,AR,32003113,1005,100,,Cash sale,,,,,,27/04/2018,27/04/2018,0.00,,10.93,,"-329,886.23"
,CS,AR,32003237,1005,100,,Cash sale,,,,,,27/04/2018,27/04/2018,0.00,,9.15,,"-329,895.38"
,CS,AR,32003278,1005,100,,Cash sale,,,,,,27/04/2018,27/04/2018,0.00,,14.58,,"-329,909.96"
,CS,AR,32003304,1005,100,,Cash sale,,,,,,27/04/2018,27/04/2018,0.00,,10.93,,"-329,920.89"
,CS,AR,32003330,1005,100,,Cash sale,,,,,,27/04/2018,27/04/2018,0.00,,3.64,,"-329,924.53"
,CS,AR,32003397,1005,100,,Cash sale,,,,,,27/04/2018,27/04/2018,0.00,,7.29,,"-329,931.82"
,IN,AR,30311145,1005,100,,Invoice,,,,,,27/04/2018,27/04/2018,0.00,,21.86,,"-329,953.68"
,IN,AR,30311168,1005,100,,Invoice,,,,,,27/04/2018,27/04/2018,0.00,,24.15,,"-329,977.83"
,IN,AR,30311211,1005,100,,Invoice,,,,,,27/04/2018,27/04/2018,0.00,,20.67,,"-329,998.50"
,IN,AR,30311216,1005,100,,Invoice,,,,,,27/04/2018,27/04/2018,0.00,,79.57,,"-330,078.07"
,IN,AR,30311280,1005,100,,Invoice,,,,,,27/04/2018,27/04/2018,0.00,,"1,093.22",,"-331,171.29"
,IN,AR,30311320,1005,100,,Invoice,,,,,,27/04/2018,27/04/2018,0.00,,8.00,,"-331,179.29"
,IN,AR,30311325,1005,100,,Invoice,,,,,,27/04/2018,27/04/2018,0.00,,10.93,,"-331,190.22"
,IN,AR,30311344,1005,100,,Invoice,,,,,,27/04/2018,27/04/2018,0.00,,364.41,,"-331,554.63"
,IN,AR,30311370,1005,100,,Invoice,,,,,,27/04/2018,27/04/2018,0.00,,4.75,,"-331,559.38"
,IN,AR,30311426,1005,100,,Invoice,,,,,,27/04/2018,27/04/2018,0.00,,13.58,,"-331,572.96"
,IN,AR,30311591,1005,100,,Invoice,,,,,,27/04/2018,27/04/2018,0.00,,20.68,,"-331,593.64"
,IN,AR,30311595,1005,100,,Invoice,,,,,,27/04/2018,27/04/2018,0.00,,4.78,,"-331,598.42"
,IN,AR,30311603,1005,100,,Invoice,,,,,,27/04/2018,27/04/2018,0.00,,140.92,,"-331,739.34"
,IN,AR,30311659,1005,100,,Invoice,,,,,,27/04/2018,27/04/2018,0.00,,36.92,,"-331,776.26"
,IN,AR,30312150,1005,100,,Invoice,,,,,,27/04/2018,27/04/2018,0.00,,"1,093.22",,"-332,869.48"
,IN,AR,30312277,1005,100,,Invoice,,,,,,27/04/2018,27/04/2018,0.00,,546.61,,"-333,416.09"
,IN,AR,30312404,1005,100,,Invoice,,,,,,27/04/2018,27/04/2018,0.00,,12.03,,"-333,428.12"
,IN,AR,30312480,1005,100,,Invoice,,,,,,27/04/2018,27/04/2018,0.00,,28.90,,"-333,457.02"
,IN,AR,30312508,1005,100,,Invoice,,,,,,27/04/2018,27/04/2018,0.00,,364.41,,"-333,821.43"
,IN,AR,30312540,1005,100,,Invoice,,,,,,27/04/2018,27/04/2018,0.00,,12.00,,"-333,833.43"
,IN,AR,30312606,1005,100,,Invoice,,,,,,27/04/2018,27/04/2018,0.00,,29.44,,"-333,862.87"
,IN,AR,30312645,1005,100,,Invoice,,,,,,27/04/2018,27/04/2018,0.00,,16.83,,"-333,879.70"
,IN,AR,30312650,1005,100,,Invoice,,,,,,27/04/2018,27/04/2018,0.00,,6.89,,"-333,886.59"
,IN,AR,30312720,1005,100,,Invoice,,,,,,27/04/2018,27/04/2018,0.00,,11.36,,"-333,897.95"
,IN,AR,30312724,1005,100,,Invoice,,,,,,27/04/2018,27/04/2018,0.00,,16.91,,"-333,914.86"
,IN,AR,30312886,1005,100,,Invoice,,,,,,27/04/2018,27/04/2018,0.00,,33.90,,"-333,948.76"
,CR,AR,33000123,1005,100,,Cash Return,,,,,,27/04/2018,27/04/2018,10.93,,0.00,,"-333,937.83"
,CS,AR,32003431,1005,100,,Cash sale,,,,,,27/04/2018,27/04/2018,0.00,,14.58,,"-333,952.41"
,CS,AR,32003440,1005,100,,Cash sale,,,,,,27/04/2018,27/04/2018,0.00,,19.58,,"-333,971.99"
,CS,AR,32003474,1005,100,,Cash sale,,,,,,27/04/2018,27/04/2018,0.00,,10.93,,"-333,982.92"
,CS,AR,32003503,1005,100,,Cash sale,,,,,,27/04/2018,27/04/2018,0.00,,7.29,,"-333,990.21"
,CS,AR,32003511,1005,100,,Cash sale,,,,,,27/04/2018,27/04/2018,0.00,,3.64,,"-333,993.85"
,CS,AR,32003517,1005,100,,Cash sale,,,,,,27/04/2018,27/04/2018,0.00,,14.58,,"-334,008.43"
,CS,AR,32003521,1005,100,,Cash sale,,,,,,27/04/2018,27/04/2018,0.00,,14.58,,"-334,023.01"
,CS,AR,32003535,1005,100,,Cash sale,,,,,,27/04/2018,27/04/2018,0.00,,7.29,,"-334,030.30"
,CS,AR,32003566,1005,100,,Cash sale,,,,,,27/04/2018,27/04/2018,0.00,,29.15,,"-334,059.45"
,CS,AR,32003572,1005,100,,Cash sale,,,,,,27/04/2018,27/04/2018,0.00,,10.17,,"-334,069.62"
,CS,AR,32003585,1005,100,,Cash sale,,,,,,27/04/2018,27/04/2018,0.00,,10.34,,"-334,079.96"
,CS,AR,32003587,1005,100,,Cash sale,,,,,,27/04/2018,27/04/2018,0.00,,3.64,,"-334,083.60"
,CS,AR,32003591,1005,100,,Cash sale,,,,,,27/04/2018,27/04/2018,0.00,,13.74,,"-334,097.34"
,CS,AR,32003594,1005,100,,Cash sale,,,,,,27/04/2018,27/04/2018,0.00,,10.93,,"-334,108.27"
,CS,AR,32003597,1005,100,,Cash sale,,,,,,27/04/2018,27/04/2018,0.00,,5.61,,"-334,113.88"
,CS,AR,32003599,1005,100,,Cash sale,,,,,,27/04/2018,27/04/2018,0.00,,10.99,,"-334,124.87"
,CS,AR,32003629,1005,100,,Cash sale,,,,,,27/04/2018,27/04/2018,0.00,,2.54,,"-334,127.41"
,CS,AR,32003633,1005,100,,Cash sale,,,,,,27/04/2018,27/04/2018,0.00,,12.92,,"-334,140.33"
,CS,AR,32003634,1005,100,,Cash sale,,,,,,27/04/2018,27/04/2018,0.00,,17.54,,"-334,157.87"
,CS,AR,32003651,1005,100,,Cash sale,,,,,,27/04/2018,27/04/2018,0.00,,42.12,,"-334,199.99"
,CS,AR,32003660,1005,100,,Cash sale,,,,,,27/04/2018,27/04/2018,0.00,,10.17,,"-334,210.16"
,CS,AR,32003683,1005,100,,Cash sale,,,,,,27/04/2018,27/04/2018,0.00,,3.64,,"-334,213.80"
,CS,AR,32003688,1005,100,,Cash sale,,,,,,27/04/2018,27/04/2018,0.00,,18.22,,"-334,232.02"
,CS,AR,32003690,1005,100,,Cash sale,,,,,,27/04/2018,27/04/2018,0.00,,10.93,,"-334,242.95"
,CS,AR,32003691,1005,100,,Cash sale,,,,,,27/04/2018,27/04/2018,0.00,,3.64,,"-334,246.59"
,CS,AR,32003733,1005,100,,Cash sale,,,,,,27/04/2018,27/04/2018,0.00,,10.93,,"-334,257.52"
,CS,AR,32003738,1005,100,,Cash sale,,,,,,27/04/2018,27/04/2018,0.00,,7.29,,"-334,264.81"
,CS,AR,32003783,1005,100,,Cash sale,,,,,,27/04/2018,27/04/2018,0.00,,14.58,,"-334,279.39"
,CS,AR,32003791,1005,100,,Cash sale,,,,,,27/04/2018,27/04/2018,0.00,,2.54,,"-334,281.93"
,CS,AR,32003794,1005,100,,Cash sale,,,,,,27/04/2018,27/04/2018,0.00,,9.03,,"-334,290.96"
,CS,AR,32003819,1005,100,,Cash sale,,,,,,27/04/2018,27/04/2018,0.00,,38.00,,"-334,328.96"
,CS,AR,32003822,1005,100,,Cash sale,,,,,,27/04/2018,27/04/2018,0.00,,3.64,,"-334,332.60"
,CS,AR,32003856,1005,100,,Cash sale,,,,,,27/04/2018,27/04/2018,0.00,,14.58,,"-334,347.18"
,CS,AR,32003876,1005,100,,Cash sale,,,,,,27/04/2018,27/04/2018,0.00,,18.21,,"-334,365.39"
,CS,AR,32003881,1005,100,,Cash sale,,,,,,27/04/2018,27/04/2018,0.00,,10.93,,"-334,376.32"
,CS,AR,32003914,1005,100,,Cash sale,,,,,,27/04/2018,27/04/2018,0.00,,7.29,,"-334,383.61"
,CS,AR,32003918,1005,100,,Cash sale,,,,,,27/04/2018,27/04/2018,0.00,,10.93,,"-334,394.54"
,CS,AR,32003931,1005,100,,Cash sale,,,,,,27/04/2018,27/04/2018,0.00,,3.64,,"-334,398.18"
,CS,AR,32003937,1005,100,,Cash sale,,,,,,27/04/2018,27/04/2018,0.00,,10.93,,"-334,409.11"
,CS,AR,32003947,1005,100,,Cash sale,,,,,,27/04/2018,27/04/2018,0.00,,10.93,,"-334,420.04"
,CS,AR,32003951,1005,100,,Cash sale,,,,,,27/04/2018,27/04/2018,0.00,,7.29,,"-334,427.33"
,CS,AR,32003953,1005,100,,Cash sale,,,,,,27/04/2018,27/04/2018,0.00,,12.03,,"-334,439.36"
,CS,AR,32004000,1005,100,,Cash sale,,,,,,27/04/2018,27/04/2018,0.00,,6.07,,"-334,445.43"
,IN,AR,30313120,1005,100,,Invoice,,,,,,27/04/2018,27/04/2018,0.00,,26.69,,"-334,472.12"
,IN,AR,30313121,1005,100,,Invoice,,,,,,27/04/2018,27/04/2018,0.00,,14.83,,"-334,486.95"
,IN,AR,30313132,1005,100,,Invoice,,,,,,27/04/2018,27/04/2018,0.00,,29.15,,"-334,516.10"
,IN,AR,30313173,1005,100,,Invoice,,,,,,27/04/2018,27/04/2018,0.00,,3.64,,"-334,519.74"
,IN,AR,30313174,1005,100,,Invoice,,,,,,27/04/2018,27/04/2018,0.00,,10.93,,"-334,530.67"
,IN,AR,30313178,1005,100,,Invoice,,,,,,27/04/2018,27/04/2018,0.00,,14.58,,"-334,545.25"
,IN,AR,30313186,1005,100,,Invoice,,,,,,27/04/2018,27/04/2018,0.00,,14.58,,"-334,559.83"
,IN,AR,30313205,1005,100,,Invoice,,,,,,27/04/2018,27/04/2018,0.00,,94.92,,"-334,654.75"
,IN,AR,30313224,1005,100,,Invoice,,,,,,27/04/2018,27/04/2018,0.00,,7.29,,"-334,662.04"
,IN,AR,30313227,1005,100,,Invoice,,,,,,27/04/2018,27/04/2018,0.00,,28.00,,"-334,690.04"
,IN,AR,30313274,1005,100,,Invoice,,,,,,27/04/2018,27/04/2018,0.00,,3.89,,"-334,693.93"
,IN,AR,30313289,1005,100,,Invoice,,,,,,27/04/2018,27/04/2018,0.00,,18.00,,"-334,711.93"
,IN,AR,30313315,1005,100,,Invoice,,,,,,27/04/2018,27/04/2018,0.00,,28.39,,"-334,740.32"
,IN,AR,30313325,1005,100,,Invoice,,,,,,27/04/2018,27/04/2018,0.00,,748.42,,"-335,488.74"
,IN,AR,30313337,1005,100,,Invoice,,,,,,27/04/2018,27/04/2018,0.00,,364.41,,"-335,853.15"
,IN,AR,30313338,1005,100,,Invoice,,,,,,27/04/2018,27/04/2018,0.00,,44.00,,"-335,897.15"
,IN,AR,30313351,1005,100,,Invoice,,,,,,27/04/2018,27/04/2018,0.00,,25.51,,"-335,922.66"
,IN,AR,30313353,1005,100,,Invoice,,,,,,27/04/2018,27/04/2018,0.00,,8.39,,"-335,931.05"
,IN,AR,30313361,1005,100,,Invoice,,,,,,27/04/2018,27/04/2018,0.00,,23.29,,"-335,954.34"
,IN,AR,30313375,1005,100,,Invoice,,,,,,27/04/2018,27/04/2018,0.00,,36.44,,"-335,990.78"
,IN,AR,30313387,1005,100,,Invoice,,,,,,27/04/2018,27/04/2018,0.00,,7.75,,"-335,998.53"
,IN,AR,30313391,1005,100,,Invoice,,,,,,27/04/2018,27/04/2018,0.00,,18.09,,"-336,016.62"
,IN,AR,30313404,1005,100,,Invoice,,,,,,27/04/2018,27/04/2018,0.00,,4.80,,"-336,021.42"
,IN,AR,30313410,1005,100,,Invoice,,,,,,27/04/2018,27/04/2018,0.00,,25.51,,"-336,046.93"
,IN,AR,30313465,1005,100,,Invoice,,,,,,27/04/2018,27/04/2018,0.00,,6.02,,"-336,052.95"
,IN,AR,30313498,1005,100,,Invoice,,,,,,27/04/2018,27/04/2018,0.00,,7.17,,"-336,060.12"
,IN,AR,30313588,1005,100,,Invoice,,,,,,27/04/2018,27/04/2018,0.00,,7.63,,"-336,067.75"
,IN,AR,30313589,1005,100,,Invoice,,,,,,27/04/2018,27/04/2018,0.00,,5.08,,"-336,072.83"
,IN,AR,30313590,1005,100,,Invoice,,,,,,27/04/2018,27/04/2018,0.00,,10.17,,"-336,083.00"
,IN,AR,30313604,1005,100,,Invoice,,,,,,27/04/2018,27/04/2018,0.00,,5.08,,"-336,088.08"
,IN,AR,30313662,1005,100,,Invoice,,,,,,27/04/2018,27/04/2018,0.00,,12.71,,"-336,100.79"
,IN,AR,30313666,1005,100,,Invoice,,,,,,27/04/2018,27/04/2018,0.00,,4.24,,"-336,105.03"
,IN,AR,30313668,1005,100,,Invoice,,,,,,27/04/2018,27/04/2018,0.00,,10.59,,"-336,115.62"
,IN,AR,30313673,1005,100,,Invoice,,,,,,27/04/2018,27/04/2018,0.00,,7.29,,"-336,122.91"
,IN,AR,30313674,1005,100,,Invoice,,,,,,27/04/2018,27/04/2018,0.00,,7.75,,"-336,130.66"
,IN,AR,30313680,1005,100,,Invoice,,,,,,27/04/2018,27/04/2018,0.00,,10.93,,"-336,141.59"
,IN,AR,30313723,1005,100,,Invoice,,,,,,27/04/2018,27/04/2018,0.00,,14.58,,"-336,156.17"
,IN,AR,30313748,1005,100,,Invoice,,,,,,27/04/2018,27/04/2018,0.00,,19.64,,"-336,175.81"
,IN,AR,30313769,1005,100,,Invoice,,,,,,27/04/2018,27/04/2018,0.00,,13.98,,"-336,189.79"
,IN,AR,30313794,1005,100,,Invoice,,,,,,27/04/2018,27/04/2018,0.00,,53.14,,"-336,242.93"
,IN,AR,30313801,1005,100,,Invoice,,,,,,27/04/2018,27/04/2018,0.00,,12.71,,"-336,255.64"
,IN,AR,30313842,1005,100,,Invoice,,,,,,27/04/2018,27/04/2018,0.00,,3.64,,"-336,259.28"
,IN,AR,30313864,1005,100,,Invoice,,,,,,27/04/2018,27/04/2018,0.00,,"1,093.22",,"-337,352.50"
,IN,AR,30313911,1005,100,,Invoice,,,,,,27/04/2018,27/04/2018,0.00,,7.27,,"-337,359.77"
,IN,AR,30313914,1005,100,,Invoice,,,,,,27/04/2018,27/04/2018,0.00,,5.34,,"-337,365.11"
,IN,AR,30313938,1005,100,,Invoice,,,,,,27/04/2018,27/04/2018,0.00,,21.86,,"-337,386.97"
,IN,AR,30313949,1005,100,,Invoice,,,,,,27/04/2018,27/04/2018,0.00,,29.15,,"-337,416.12"
,IN,AR,30313985,1005,100,,Invoice,,,,,,27/04/2018,27/04/2018,0.00,,10.17,,"-337,426.29"
,IN,AR,30314014,1005,100,,Invoice,,,,,,27/04/2018,27/04/2018,0.00,,48.26,,"-337,474.55"
,IN,AR,30314023,1005,100,,Invoice,,,,,,27/04/2018,27/04/2018,0.00,,31.42,,"-337,505.97"
,IN,AR,30314034,1005,100,,Invoice,,,,,,27/04/2018,27/04/2018,0.00,,44.09,,"-337,550.06"
,IN,AR,30314055,1005,100,,Invoice,,,,,,27/04/2018,27/04/2018,0.00,,10.93,,"-337,560.99"
,IN,AR,30314056,1005,100,,Invoice,,,,,,27/04/2018,27/04/2018,0.00,,15.13,,"-337,576.12"
,IN,AR,30314064,1005,100,,Invoice,,,,,,27/04/2018,27/04/2018,0.00,,89.79,,"-337,665.91"
,IN,AR,30314094,1005,100,,Invoice,,,,,,27/04/2018,27/04/2018,0.00,,14.58,,"-337,680.49"
,IN,AR,30314116,1005,100,,Invoice,,,,,,27/04/2018,27/04/2018,0.00,,40.64,,"-337,721.13"
,IN,AR,30314126,1005,100,,Invoice,,,,,,27/04/2018,27/04/2018,0.00,,22.88,,"-337,744.01"
,IN,AR,30314127,1005,100,,Invoice,,,,,,27/04/2018,27/04/2018,0.00,,5.08,,"-337,749.09"
,IN,AR,30314128,1005,100,,Invoice,,,,,,27/04/2018,27/04/2018,0.00,,7.63,,"-337,756.72"
,IN,AR,30314148,1005,100,,Invoice,,,,,,27/04/2018,27/04/2018,0.00,,8.00,,"-337,764.72"
,IN,AR,30314168,1005,100,,Invoice,,,,,,27/04/2018,27/04/2018,0.00,,30.11,,"-337,794.83"
,IN,AR,30314212,1005,100,,Invoice,,,,,,27/04/2018,27/04/2018,0.00,,7.63,,"-337,802.46"
,IN,AR,30314245,1005,100,,Invoice,,,,,,27/04/2018,27/04/2018,0.00,,14.58,,"-337,817.04"
,IN,AR,30314328,1005,100,,Invoice,,,,,,27/04/2018,27/04/2018,0.00,,18.00,,"-337,835.04"
,IN,AR,30314354,1005,100,,Invoice,,,,,,27/04/2018,27/04/2018,0.00,,14.19,,"-337,849.23"
,IN,AR,30314374,1005,100,,Invoice,,,,,,27/04/2018,27/04/2018,0.00,,8.75,,"-337,857.98"
,IN,AR,30314381,1005,100,,Invoice,,,,,,27/04/2018,27/04/2018,0.00,,16.42,,"-337,874.40"
,IN,AR,30314400,1005,100,,Invoice,,,,,,27/04/2018,27/04/2018,0.00,,3.64,,"-337,878.04"
,IN,AR,30314413,1005,100,,Invoice,,,,,,27/04/2018,27/04/2018,0.00,,8.17,,"-337,886.21"
,IN,AR,30314444,1005,100,,Invoice,,,,,,27/04/2018,27/04/2018,0.00,,11.95,,"-337,898.16"
,IN,AR,30314469,1005,100,,Invoice,,,,,,27/04/2018,27/04/2018,0.00,,2.00,,"-337,900.16"
,IN,AR,30314529,1005,100,,Invoice,,,,,,27/04/2018,27/04/2018,0.00,,10.93,,"-337,911.09"
,IN,AR,30314537,1005,100,,Invoice,,,,,,27/04/2018,27/04/2018,0.00,,7.29,,"-337,918.38"
,IN,AR,30314540,1005,100,,Invoice,,,,,,27/04/2018,27/04/2018,0.00,,3.10,,"-337,921.48"
,IN,AR,30314542,1005,100,,Invoice,,,,,,27/04/2018,27/04/2018,0.00,,18.20,,"-337,939.68"
,IN,AR,30314547,1005,100,,Invoice,,,,,,27/04/2018,27/04/2018,0.00,,3.64,,"-337,943.32"
,CS,AR,32003457,1005,100,,Cash sale,,,,,,28/04/2018,28/04/2018,0.00,,3.01,,"-337,946.33"
,CS,AR,32003524,1005,100,,Cash sale,,,,,,28/04/2018,28/04/2018,0.00,,10.93,,"-337,957.26"
,CS,AR,32003622,1005,100,,Cash sale,,,,,,28/04/2018,28/04/2018,0.00,,10.93,,"-337,968.19"
,CS,AR,32003731,1005,100,,Cash sale,,,,,,28/04/2018,28/04/2018,0.00,,7.29,,"-337,975.48"
,CS,AR,32003744,1005,100,,Cash sale,,,,,,28/04/2018,28/04/2018,0.00,,14.58,,"-337,990.06"
,CS,AR,32003755,1005,100,,Cash sale,,,,,,28/04/2018,28/04/2018,0.00,,3.64,,"-337,993.70"
,CS,AR,32003841,1005,100,,Cash sale,,,,,,28/04/2018,28/04/2018,0.00,,10.93,,"-338,004.63"
,CS,AR,32003903,1005,100,,Cash sale,,,,,,28/04/2018,28/04/2018,0.00,,7.29,,"-338,011.92"
,CS,AR,32003908,1005,100,,Cash sale,,,,,,28/04/2018,28/04/2018,0.00,,54.66,,"-338,066.58"
,CS,AR,32003928,1005,100,,Cash sale,,,,,,28/04/2018,28/04/2018,0.00,,10.93,,"-338,077.51"
,CS,AR,32003929,1005,100,,Cash sale,,,,,,28/04/2018,28/04/2018,0.00,,8.75,,"-338,086.26"
,IN,AR,30313335,1005,100,,Invoice,,,,,,28/04/2018,28/04/2018,0.00,,14.58,,"-338,100.84"
,IN,AR,30313613,1005,100,,Invoice,,,,,,28/04/2018,28/04/2018,0.00,,6.74,,"-338,107.58"
,IN,AR,30313838,1005,100,,Invoice,,,,,,28/04/2018,28/04/2018,0.00,,8.78,,"-338,116.36"
,IN,AR,30313891,1005,100,,Invoice,,,,,,28/04/2018,28/04/2018,0.00,,9.29,,"-338,125.65"
,IN,AR,30314390,1005,100,,Invoice,,,,,,28/04/2018,28/04/2018,0.00,,7.29,,"-338,132.94"
,CN,AR,31017929,1005,100,,Credit Note,,,,,,30/04/2018,30/04/2018,548.23,,0.00,,"-337,584.71"
,CN,AR,31017930,1005,100,,Credit Note,,,,,,30/04/2018,30/04/2018,724.44,,0.00,,"-336,860.27"
,CN,AR,31017975,1005,100,,Credit Note,,,,,,30/04/2018,30/04/2018,132.27,,0.00,,"-336,728.00"
,CN,AR,31017992,1005,100,,Credit Note,,,,,,30/04/2018,30/04/2018,419.07,,0.00,,"-336,308.93"
,CS,AR,32003446,1005,100,,Cash sale,,,,,,30/04/2018,30/04/2018,0.00,,9.49,,"-336,318.42"
,CS,AR,32003469,1005,100,,Cash sale,,,,,,30/04/2018,30/04/2018,0.00,,18.22,,"-336,336.64"
,CS,AR,32003496,1005,100,,Cash sale,,,,,,30/04/2018,30/04/2018,0.00,,12.46,,"-336,349.10"
,CS,AR,32003501,1005,100,,Cash sale,,,,,,30/04/2018,30/04/2018,0.00,,14.58,,"-336,363.68"
,CS,AR,32003514,1005,100,,Cash sale,,,,,,30/04/2018,30/04/2018,0.00,,8.77,,"-336,372.45"
,CS,AR,32003522,1005,100,,Cash sale,,,,,,30/04/2018,30/04/2018,0.00,,14.58,,"-336,387.03"
,CS,AR,32003527,1005,100,,Cash sale,,,,,,30/04/2018,30/04/2018,0.00,,3.64,,"-336,390.67"
,CS,AR,32003528,1005,100,,Cash sale,,,,,,30/04/2018,30/04/2018,0.00,,10.93,,"-336,401.60"
,CS,AR,32003534,1005,100,,Cash sale,,,,,,30/04/2018,30/04/2018,0.00,,3.64,,"-336,405.24"
,CS,AR,32003539,1005,100,,Cash sale,,,,,,30/04/2018,30/04/2018,0.00,,7.29,,"-336,412.53"
,CS,AR,32003543,1005,100,,Cash sale,,,,,,30/04/2018,30/04/2018,0.00,,10.34,,"-336,422.87"
,CS,AR,32003563,1005,100,,Cash sale,,,,,,30/04/2018,30/04/2018,0.00,,7.29,,"-336,430.16"
,CS,AR,32003573,1005,100,,Cash sale,,,,,,30/04/2018,30/04/2018,0.00,,12.71,,"-336,442.87"
,CS,AR,32003578,1005,100,,Cash sale,,,,,,30/04/2018,30/04/2018,0.00,,3.90,,"-336,446.77"
,CS,AR,32003600,1005,100,,Cash sale,,,,,,30/04/2018,30/04/2018,0.00,,13.74,,"-336,460.51"
,CS,AR,32003609,1005,100,,Cash sale,,,,,,30/04/2018,30/04/2018,0.00,,7.29,,"-336,467.80"
,CS,AR,32003618,1005,100,,Cash sale,,,,,,30/04/2018,30/04/2018,0.00,,7.29,,"-336,475.09"
,CS,AR,32003635,1005,100,,Cash sale,,,,,,30/04/2018,30/04/2018,0.00,,20.47,,"-336,495.56"
,CS,AR,32003641,1005,100,,Cash sale,,,,,,30/04/2018,30/04/2018,0.00,,5.44,,"-336,501.00"
,CS,AR,32003647,1005,100,,Cash sale,,,,,,30/04/2018,30/04/2018,0.00,,9.49,,"-336,510.49"
,CS,AR,32003650,1005,100,,Cash sale,,,,,,30/04/2018,30/04/2018,0.00,,7.17,,"-336,517.66"
,CS,AR,32003652,1005,100,,Cash sale,,,,,,30/04/2018,30/04/2018,0.00,,24.07,,"-336,541.73"
,CS,AR,32003663,1005,100,,Cash sale,,,,,,30/04/2018,30/04/2018,0.00,,10.93,,"-336,552.66"
,CS,AR,32003666,1005,100,,Cash sale,,,,,,30/04/2018,30/04/2018,0.00,,3.90,,"-336,556.56"
,CS,AR,32003680,1005,100,,Cash sale,,,,,,30/04/2018,30/04/2018,0.00,,3.90,,"-336,560.46"
,CS,AR,32003697,1005,100,,Cash sale,,,,,,30/04/2018,30/04/2018,0.00,,54.15,,"-336,614.61"
,CS,AR,32003699,1005,100,,Cash sale,,,,,,30/04/2018,30/04/2018,0.00,,2.63,,"-336,617.24"
,CS,AR,32003700,1005,100,,Cash sale,,,,,,30/04/2018,30/04/2018,0.00,,2.54,,"-336,619.78"
,CS,AR,32003718,1005,100,,Cash sale,,,,,,30/04/2018,30/04/2018,0.00,,10.93,,"-336,630.71"
,CS,AR,32003771,1005,100,,Cash sale,,,,,,30/04/2018,30/04/2018,0.00,,5.64,,"-336,636.35"
,CS,AR,32003774,1005,100,,Cash sale,,,,,,30/04/2018,30/04/2018,0.00,,7.29,,"-336,643.64"
,CS,AR,32003781,1005,100,,Cash sale,,,,,,30/04/2018,30/04/2018,0.00,,10.93,,"-336,654.57"
,CS,AR,32003797,1005,100,,Cash sale,,,,,,30/04/2018,30/04/2018,0.00,,6.53,,"-336,661.10"
,CS,AR,32003832,1005,100,,Cash sale,,,,,,30/04/2018,30/04/2018,0.00,,10.93,,"-336,672.03"
,CS,AR,32003838,1005,100,,Cash sale,,,,,,30/04/2018,30/04/2018,0.00,,6.56,,"-336,678.59"
,CS,AR,32003843,1005,100,,Cash sale,,,,,,30/04/2018,30/04/2018,0.00,,11.44,,"-336,690.03"
,CS,AR,32003879,1005,100,,Cash sale,,,,,,30/04/2018,30/04/2018,0.00,,7.29,,"-336,697.32"
,CS,AR,32003889,1005,100,,Cash sale,,,,,,30/04/2018,30/04/2018,0.00,,10.93,,"-336,708.25"
,CS,AR,32003949,1005,100,,Cash sale,,,,,,30/04/2018,30/04/2018,0.00,,7.75,,"-336,716.00"
,CS,AR,32003993,1005,100,,Cash sale,,,,,,30/04/2018,30/04/2018,0.00,,11.65,,"-336,727.65"
,CS,AR,32003999,1005,100,,Cash sale,,,,,,30/04/2018,30/04/2018,0.00,,3.64,,"-336,731.29"
,IN,AR,30313117,1005,100,,Invoice,,,,,,30/04/2018,30/04/2018,0.00,,26.69,,"-336,757.98"
,IN,AR,30313122,1005,100,,Invoice,,,,,,30/04/2018,30/04/2018,0.00,,71.19,,"-336,829.17"
,IN,AR,30313138,1005,100,,Invoice,,,,,,30/04/2018,30/04/2018,0.00,,364.41,,"-337,193.58"
,IN,AR,30313139,1005,100,,Invoice,,,,,,30/04/2018,30/04/2018,0.00,,18.22,,"-337,211.80"
,IN,AR,30313158,1005,100,,Invoice,,,,,,30/04/2018,30/04/2018,0.00,,"1,236.75",,"-338,448.55"
,IN,AR,30313181,1005,100,,Invoice,,,,,,30/04/2018,30/04/2018,0.00,,61.30,,"-338,509.85"
,IN,AR,30313196,1005,100,,Invoice,,,,,,30/04/2018,30/04/2018,0.00,,11.64,,"-338,521.49"
,IN,AR,30313206,1005,100,,Invoice,,,,,,30/04/2018,30/04/2018,0.00,,87.80,,"-338,609.29"
,IN,AR,30313207,1005,100,,Invoice,,,,,,30/04/2018,30/04/2018,0.00,,71.19,,"-338,680.48"
,IN,AR,30313218,1005,100,,Invoice,,,,,,30/04/2018,30/04/2018,0.00,,38.56,,"-338,719.04"
,IN,AR,30313223,1005,100,,Invoice,,,,,,30/04/2018,30/04/2018,0.00,,"1,468.22",,"-340,187.26"
,IN,AR,30313228,1005,100,,Invoice,,,,,,30/04/2018,30/04/2018,0.00,,34.00,,"-340,221.26"
,IN,AR,30313238,1005,100,,Invoice,,,,,,30/04/2018,30/04/2018,0.00,,53.03,,"-340,274.29"
,IN,AR,30313240,1005,100,,Invoice,,,,,,30/04/2018,30/04/2018,0.00,,364.41,,"-340,638.70"
,IN,AR,30313248,1005,100,,Invoice,,,,,,30/04/2018,30/04/2018,0.00,,44.00,,"-340,682.70"
,IN,AR,30313249,1005,100,,Invoice,,,,,,30/04/2018,30/04/2018,0.00,,22.00,,"-340,704.70"
,IN,AR,30313265,1005,100,,Invoice,,,,,,30/04/2018,30/04/2018,0.00,,33.05,,"-340,737.75"
,IN,AR,30313275,1005,100,,Invoice,,,,,,30/04/2018,30/04/2018,0.00,,3.89,,"-340,741.64"
,IN,AR,30313281,1005,100,,Invoice,,,,,,30/04/2018,30/04/2018,0.00,,546.61,,"-341,288.25"
,IN,AR,30313288,1005,100,,Invoice,,,,,,30/04/2018,30/04/2018,0.00,,37.29,,"-341,325.54"
,IN,AR,30313290,1005,100,,Invoice,,,,,,30/04/2018,30/04/2018,0.00,,16.00,,"-341,341.54"
,IN,AR,30313300,1005,100,,Invoice,,,,,,30/04/2018,30/04/2018,0.00,,10.93,,"-341,352.47"
,IN,AR,30313326,1005,100,,Invoice,,,,,,30/04/2018,30/04/2018,0.00,,30.51,,"-341,382.98"
,IN,AR,30313330,1005,100,,Invoice,,,,,,30/04/2018,30/04/2018,0.00,,15.51,,"-341,398.49"
,IN,AR,30313356,1005,100,,Invoice,,,,,,30/04/2018,30/04/2018,0.00,,14.49,,"-341,412.98"
,IN,AR,30313366,1005,100,,Invoice,,,,,,30/04/2018,30/04/2018,0.00,,81.23,,"-341,494.21"
,IN,AR,30313367,1005,100,,Invoice,,,,,,30/04/2018,30/04/2018,0.00,,36.91,,"-341,531.12"
,IN,AR,30313371,1005,100,,Invoice,,,,,,30/04/2018,30/04/2018,0.00,,364.41,,"-341,895.53"
,IN,AR,30313372,1005,100,,Invoice,,,,,,30/04/2018,30/04/2018,0.00,,7.29,,"-341,902.82"
,IN,AR,30313380,1005,100,,Invoice,,,,,,30/04/2018,30/04/2018,0.00,,23.26,,"-341,926.08"
,IN,AR,30313392,1005,100,,Invoice,,,,,,30/04/2018,30/04/2018,0.00,,7.75,,"-341,933.83"
,IN,AR,30313396,1005,100,,Invoice,,,,,,30/04/2018,30/04/2018,0.00,,27.46,,"-341,961.29"
,IN,AR,30313403,1005,100,,Invoice,,,,,,30/04/2018,30/04/2018,0.00,,54.66,,"-342,015.95"
,IN,AR,30313407,1005,100,,Invoice,,,,,,30/04/2018,30/04/2018,0.00,,11.48,,"-342,027.43"
,IN,AR,30313414,1005,100,,Invoice,,,,,,30/04/2018,30/04/2018,0.00,,"1,731.43",,"-343,758.86"
,IN,AR,30313415,1005,100,,Invoice,,,,,,30/04/2018,30/04/2018,0.00,,54.38,,"-343,813.24"
,IN,AR,30313416,1005,100,,Invoice,,,,,,30/04/2018,30/04/2018,0.00,,22.81,,"-343,836.05"
,IN,AR,30313417,1005,100,,Invoice,,,,,,30/04/2018,30/04/2018,0.00,,80.69,,"-343,916.74"
,IN,AR,30313427,1005,100,,Invoice,,,,,,30/04/2018,30/04/2018,0.00,,50.85,,"-343,967.59"
,IN,AR,30313428,1005,100,,Invoice,,,,,,30/04/2018,30/04/2018,0.00,,30.51,,"-343,998.10"
,IN,AR,30313432,1005,100,,Invoice,,,,,,30/04/2018,30/04/2018,0.00,,188.56,,"-344,186.66"
,IN,AR,30313440,1005,100,,Invoice,,,,,,30/04/2018,30/04/2018,0.00,,18.09,,"-344,204.75"
,IN,AR,30313451,1005,100,,Invoice,,,,,,30/04/2018,30/04/2018,0.00,,364.41,,"-344,569.16"
,IN,AR,30313452,1005,100,,Invoice,,,,,,30/04/2018,30/04/2018,0.00,,7.42,,"-344,576.58"
,IN,AR,30313461,1005,100,,Invoice,,,,,,30/04/2018,30/04/2018,0.00,,3.64,,"-344,580.22"
,IN,AR,30313466,1005,100,,Invoice,,,,,,30/04/2018,30/04/2018,0.00,,15.04,,"-344,595.26"
,IN,AR,30313474,1005,100,,Invoice,,,,,,30/04/2018,30/04/2018,0.00,,"1,677.63",,"-346,272.89"
,IN,AR,30313479,1005,100,,Invoice,,,,,,30/04/2018,30/04/2018,0.00,,106.64,,"-346,379.53"
,IN,AR,30313486,1005,100,,Invoice,,,,,,30/04/2018,30/04/2018,0.00,,40.68,,"-346,420.21"
,IN,AR,30313496,1005,100,,Invoice,,,,,,30/04/2018,30/04/2018,0.00,,364.41,,"-346,784.62"
,IN,AR,30313499,1005,100,,Invoice,,,,,,30/04/2018,30/04/2018,0.00,,35.85,,"-346,820.47"
,IN,AR,30313508,1005,100,,Invoice,,,,,,30/04/2018,30/04/2018,0.00,,364.41,,"-347,184.88"
,IN,AR,30313509,1005,100,,Invoice,,,,,,30/04/2018,30/04/2018,0.00,,12.88,,"-347,197.76"
,IN,AR,30313510,1005,100,,Invoice,,,,,,30/04/2018,30/04/2018,0.00,,19.32,,"-347,217.08"
,IN,AR,30313521,1005,100,,Invoice,,,,,,30/04/2018,30/04/2018,0.00,,18.05,,"-347,235.13"
,IN,AR,30313524,1005,100,,Invoice,,,,,,30/04/2018,30/04/2018,0.00,,629.24,,"-347,864.37"
,IN,AR,30313525,1005,100,,Invoice,,,,,,30/04/2018,30/04/2018,0.00,,18.46,,"-347,882.83"
,IN,AR,30313526,1005,100,,Invoice,,,,,,30/04/2018,30/04/2018,0.00,,21.81,,"-347,904.64"
,IN,AR,30313527,1005,100,,Invoice,,,,,,30/04/2018,30/04/2018,0.00,,16.78,,"-347,921.42"
,IN,AR,30313528,1005,100,,Invoice,,,,,,30/04/2018,30/04/2018,0.00,,11.75,,"-347,933.17"
,IN,AR,30313529,1005,100,,Invoice,,,,,,30/04/2018,30/04/2018,0.00,,10.07,,"-347,943.24"
,IN,AR,30313530,1005,100,,Invoice,,,,,,30/04/2018,30/04/2018,0.00,,8.39,,"-347,951.63"
,IN,AR,30313531,1005,100,,Invoice,,,,,,30/04/2018,30/04/2018,0.00,,11.75,,"-347,963.38"
,IN,AR,30313532,1005,100,,Invoice,,,,,,30/04/2018,30/04/2018,0.00,,15.10,,"-347,978.48"
,IN,AR,30313533,1005,100,,Invoice,,,,,,30/04/2018,30/04/2018,0.00,,6.71,,"-347,985.19"
,IN,AR,30313543,1005,100,,Invoice,,,,,,30/04/2018,30/04/2018,0.00,,8.26,,"-347,993.45"
,IN,AR,30313549,1005,100,,Invoice,,,,,,30/04/2018,30/04/2018,0.00,,6.36,,"-347,999.81"
,IN,AR,30313552,1005,100,,Invoice,,,,,,30/04/2018,30/04/2018,0.00,,154.37,,"-348,154.18"
,IN,AR,30313553,1005,100,,Invoice,,,,,,30/04/2018,30/04/2018,0.00,,6.02,,"-348,160.20"
,IN,AR,30313554,1005,100,,Invoice,,,,,,30/04/2018,30/04/2018,0.00,,159.64,,"-348,319.84"
,IN,AR,30313557,1005,100,,Invoice,,,,,,30/04/2018,30/04/2018,0.00,,41.39,,"-348,361.23"
,IN,AR,30313558,1005,100,,Invoice,,,,,,30/04/2018,30/04/2018,0.00,,56.14,,"-348,417.37"
,IN,AR,30313559,1005,100,,Invoice,,,,,,30/04/2018,30/04/2018,0.00,,185.95,,"-348,603.32"
,IN,AR,30313561,1005,100,,Invoice,,,,,,30/04/2018,30/04/2018,0.00,,36.84,,"-348,640.16"
,IN,AR,30313562,1005,100,,Invoice,,,,,,30/04/2018,30/04/2018,0.00,,13.17,,"-348,653.33"
,IN,AR,30313563,1005,100,,Invoice,,,,,,30/04/2018,30/04/2018,0.00,,26.34,,"-348,679.67"
,IN,AR,30313564,1005,100,,Invoice,,,,,,30/04/2018,30/04/2018,0.00,,37.63,,"-348,717.30"
,IN,AR,30313565,1005,100,,Invoice,,,,,,30/04/2018,30/04/2018,0.00,,47.03,,"-348,764.33"
,IN,AR,30313566,1005,100,,Invoice,,,,,,30/04/2018,30/04/2018,0.00,,22.58,,"-348,786.91"
,IN,AR,30313567,1005,100,,Invoice,,,,,,30/04/2018,30/04/2018,0.00,,48.92,,"-348,835.83"
,IN,AR,30313568,1005,100,,Invoice,,,,,,30/04/2018,30/04/2018,0.00,,24.46,,"-348,860.29"
,IN,AR,30313569,1005,100,,Invoice,,,,,,30/04/2018,30/04/2018,0.00,,3.76,,"-348,864.05"
,IN,AR,30313571,1005,100,,Invoice,,,,,,30/04/2018,30/04/2018,0.00,,349.09,,"-349,213.14"
,IN,AR,30313572,1005,100,,Invoice,,,,,,30/04/2018,30/04/2018,0.00,,56.14,,"-349,269.28"
,IN,AR,30313573,1005,100,,Invoice,,,,,,30/04/2018,30/04/2018,0.00,,45.61,,"-349,314.89"
,IN,AR,30313575,1005,100,,Invoice,,,,,,30/04/2018,30/04/2018,0.00,,18.81,,"-349,333.70"
,IN,AR,30313576,1005,100,,Invoice,,,,,,30/04/2018,30/04/2018,0.00,,26.31,,"-349,360.01"
,IN,AR,30313577,1005,100,,Invoice,,,,,,30/04/2018,30/04/2018,0.00,,31.58,,"-349,391.59"
,IN,AR,30313579,1005,100,,Invoice,,,,,,30/04/2018,30/04/2018,0.00,,15.79,,"-349,407.38"
,IN,AR,30313580,1005,100,,Invoice,,,,,,30/04/2018,30/04/2018,0.00,,45.61,,"-349,452.99"
,IN,AR,30313581,1005,100,,Invoice,,,,,,30/04/2018,30/04/2018,0.00,,21.05,,"-349,474.04"
,IN,AR,30313585,1005,100,,Invoice,,,,,,30/04/2018,30/04/2018,0.00,,3.51,,"-349,477.55"
,IN,AR,30313591,1005,100,,Invoice,,,,,,30/04/2018,30/04/2018,0.00,,10.17,,"-349,487.72"
,IN,AR,30313602,1005,100,,Invoice,,,,,,30/04/2018,30/04/2018,0.00,,15.79,,"-349,503.51"
,IN,AR,30313606,1005,100,,Invoice,,,,,,30/04/2018,30/04/2018,0.00,,364.41,,"-349,867.92"
,IN,AR,30313617,1005,100,,Invoice,,,,,,30/04/2018,30/04/2018,0.00,,187.70,,"-350,055.62"
,IN,AR,30313620,1005,100,,Invoice,,,,,,30/04/2018,30/04/2018,0.00,,7.80,,"-350,063.42"
,IN,AR,30313627,1005,100,,Invoice,,,,,,30/04/2018,30/04/2018,0.00,,100.14,,"-350,163.56"
,IN,AR,30313628,1005,100,,Invoice,,,,,,30/04/2018,30/04/2018,0.00,,35.76,,"-350,199.32"
,IN,AR,30313629,1005,100,,Invoice,,,,,,30/04/2018,30/04/2018,0.00,,5.36,,"-350,204.68"
,IN,AR,30313630,1005,100,,Invoice,,,,,,30/04/2018,30/04/2018,0.00,,78.68,,"-350,283.36"
,IN,AR,30313631,1005,100,,Invoice,,,,,,30/04/2018,30/04/2018,0.00,,37.55,,"-350,320.91"
,IN,AR,30313632,1005,100,,Invoice,,,,,,30/04/2018,30/04/2018,0.00,,19.67,,"-350,340.58"
,IN,AR,30313633,1005,100,,Invoice,,,,,,30/04/2018,30/04/2018,0.00,,39.34,,"-350,379.92"
,IN,AR,30313634,1005,100,,Invoice,,,,,,30/04/2018,30/04/2018,0.00,,30.40,,"-350,410.32"
,IN,AR,30313635,1005,100,,Invoice,,,,,,30/04/2018,30/04/2018,0.00,,1.79,,"-350,412.11"
,IN,AR,30313636,1005,100,,Invoice,,,,,,30/04/2018,30/04/2018,0.00,,5.36,,"-350,417.47"
,IN,AR,30313637,1005,100,,Invoice,,,,,,30/04/2018,30/04/2018,0.00,,219.94,,"-350,637.41"
,IN,AR,30313638,1005,100,,Invoice,,,,,,30/04/2018,30/04/2018,0.00,,8.94,,"-350,646.35"
,IN,AR,30313639,1005,100,,Invoice,,,,,,30/04/2018,30/04/2018,0.00,,8.94,,"-350,655.29"
,IN,AR,30313640,1005,100,,Invoice,,,,,,30/04/2018,30/04/2018,0.00,,12.52,,"-350,667.81"
,IN,AR,30313641,1005,100,,Invoice,,,,,,30/04/2018,30/04/2018,0.00,,23.25,,"-350,691.06"
,IN,AR,30313642,1005,100,,Invoice,,,,,,30/04/2018,30/04/2018,0.00,,14.31,,"-350,705.37"
,IN,AR,30313644,1005,100,,Invoice,,,,,,30/04/2018,30/04/2018,0.00,,28.61,,"-350,733.98"
,IN,AR,30313645,1005,100,,Invoice,,,,,,30/04/2018,30/04/2018,0.00,,64.37,,"-350,798.35"
,IN,AR,30313646,1005,100,,Invoice,,,,,,30/04/2018,30/04/2018,0.00,,19.67,,"-350,818.02"
,IN,AR,30313647,1005,100,,Invoice,,,,,,30/04/2018,30/04/2018,0.00,,10.73,,"-350,828.75"
,IN,AR,30313648,1005,100,,Invoice,,,,,,30/04/2018,30/04/2018,0.00,,16.09,,"-350,844.84"
,IN,AR,30313649,1005,100,,Invoice,,,,,,30/04/2018,30/04/2018,0.00,,12.52,,"-350,857.36"
,IN,AR,30313650,1005,100,,Invoice,,,,,,30/04/2018,30/04/2018,0.00,,21.46,,"-350,878.82"
,IN,AR,30313651,1005,100,,Invoice,,,,,,30/04/2018,30/04/2018,0.00,,10.73,,"-350,889.55"
,IN,AR,30313653,1005,100,,Invoice,,,,,,30/04/2018,30/04/2018,0.00,,96.48,,"-350,986.03"
,IN,AR,30313655,1005,100,,Invoice,,,,,,30/04/2018,30/04/2018,0.00,,212.41,,"-351,198.44"
,IN,AR,30313656,1005,100,,Invoice,,,,,,30/04/2018,30/04/2018,0.00,,136.84,,"-351,335.28"
,IN,AR,30313657,1005,100,,Invoice,,,,,,30/04/2018,30/04/2018,0.00,,6.13,,"-351,341.41"
,IN,AR,30313658,1005,100,,Invoice,,,,,,30/04/2018,30/04/2018,0.00,,106.20,,"-351,447.61"
,IN,AR,30313659,1005,100,,Invoice,,,,,,30/04/2018,30/04/2018,0.00,,30.64,,"-351,478.25"
,IN,AR,30313660,1005,100,,Invoice,,,,,,30/04/2018,30/04/2018,0.00,,202.19,,"-351,680.44"
,IN,AR,30313661,1005,100,,Invoice,,,,,,30/04/2018,30/04/2018,0.00,,51.06,,"-351,731.50"
,IN,AR,30313669,1005,100,,Invoice,,,,,,30/04/2018,30/04/2018,0.00,,25.42,,"-351,756.92"
,IN,AR,30313681,1005,100,,Invoice,,,,,,30/04/2018,30/04/2018,0.00,,35.59,,"-351,792.51"
,IN,AR,30313691,1005,100,,Invoice,,,,,,30/04/2018,30/04/2018,0.00,,12.20,,"-351,804.71"
,IN,AR,30313714,1005,100,,Invoice,,,,,,30/04/2018,30/04/2018,0.00,,18.22,,"-351,822.93"
,IN,AR,30313717,1005,100,,Invoice,,,,,,30/04/2018,30/04/2018,0.00,,12.71,,"-351,835.64"
,IN,AR,30313727,1005,100,,Invoice,,,,,,30/04/2018,30/04/2018,0.00,,182.20,,"-352,017.84"
,IN,AR,30313729,1005,100,,Invoice,,,,,,30/04/2018,30/04/2018,0.00,,49.58,,"-352,067.42"
,IN,AR,30313734,1005,100,,Invoice,,,,,,30/04/2018,30/04/2018,0.00,,13.77,,"-352,081.19"
,IN,AR,30313737,1005,100,,Invoice,,,,,,30/04/2018,30/04/2018,0.00,,3.64,,"-352,084.83"
,IN,AR,30313741,1005,100,,Invoice,,,,,,30/04/2018,30/04/2018,0.00,,8.17,,"-352,093.00"
,IN,AR,30313746,1005,100,,Invoice,,,,,,30/04/2018,30/04/2018,0.00,,11.48,,"-352,104.48"
,IN,AR,30313756,1005,100,,Invoice,,,,,,30/04/2018,30/04/2018,0.00,,3.64,,"-352,108.12"
,IN,AR,30313766,1005,100,,Invoice,,,,,,30/04/2018,30/04/2018,0.00,,364.41,,"-352,472.53"
,IN,AR,30313770,1005,100,,Invoice,,,,,,30/04/2018,30/04/2018,0.00,,5.59,,"-352,478.12"
,IN,AR,30313776,1005,100,,Invoice,,,,,,30/04/2018,30/04/2018,0.00,,"1,128.81",,"-353,606.93"
,IN,AR,30313779,1005,100,,Invoice,,,,,,30/04/2018,30/04/2018,0.00,,10.93,,"-353,617.86"
,IN,AR,30313782,1005,100,,Invoice,,,,,,30/04/2018,30/04/2018,0.00,,563.80,,"-354,181.66"
,IN,AR,30313783,1005,100,,Invoice,,,,,,30/04/2018,30/04/2018,0.00,,53.69,,"-354,235.35"
,IN,AR,30313784,1005,100,,Invoice,,,,,,30/04/2018,30/04/2018,0.00,,35.08,,"-354,270.43"
,IN,AR,30313793,1005,100,,Invoice,,,,,,30/04/2018,30/04/2018,0.00,,182.20,,"-354,452.63"
,IN,AR,30313797,1005,100,,Invoice,,,,,,30/04/2018,30/04/2018,0.00,,43.93,,"-354,496.56"
,IN,AR,30313807,1005,100,,Invoice,,,,,,30/04/2018,30/04/2018,0.00,,46.00,,"-354,542.56"
,IN,AR,30313813,1005,100,,Invoice,,,,,,30/04/2018,30/04/2018,0.00,,29.15,,"-354,571.71"
,IN,AR,30313819,1005,100,,Invoice,,,,,,30/04/2018,30/04/2018,0.00,,"1,093.22",,"-355,664.93"
,IN,AR,30313828,1005,100,,Invoice,,,,,,30/04/2018,30/04/2018,0.00,,18.22,,"-355,683.15"
,IN,AR,30313847,1005,100,,Invoice,,,,,,30/04/2018,30/04/2018,0.00,,39.40,,"-355,722.55"
,IN,AR,30313852,1005,100,,Invoice,,,,,,30/04/2018,30/04/2018,0.00,,43.73,,"-355,766.28"
,IN,AR,30313853,1005,100,,Invoice,,,,,,30/04/2018,30/04/2018,0.00,,54.66,,"-355,820.94"
,IN,AR,30313854,1005,100,,Invoice,,,,,,30/04/2018,30/04/2018,0.00,,77.61,,"-355,898.55"
,IN,AR,30313877,1005,100,,Invoice,,,,,,30/04/2018,30/04/2018,0.00,,91.36,,"-355,989.91"
,IN,AR,30313883,1005,100,,Invoice,,,,,,30/04/2018,30/04/2018,0.00,,53.60,,"-356,043.51"
,IN,AR,30313895,1005,100,,Invoice,,,,,,30/04/2018,30/04/2018,0.00,,5.29,,"-356,048.80"
,IN,AR,30313923,1005,100,,Invoice,,,,,,30/04/2018,30/04/2018,0.00,,182.20,,"-356,231.00"
,IN,AR,30313946,1005,100,,Invoice,,,,,,30/04/2018,30/04/2018,0.00,,14.58,,"-356,245.58"
,IN,AR,30313956,1005,100,,Invoice,,,,,,30/04/2018,30/04/2018,0.00,,548.23,,"-356,793.81"
,IN,AR,30313957,1005,100,,Invoice,,,,,,30/04/2018,30/04/2018,0.00,,724.44,,"-357,518.25"
,IN,AR,30313958,1005,100,,Invoice,,,,,,30/04/2018,30/04/2018,0.00,,724.44,,"-358,242.69"
,IN,AR,30313968,1005,100,,Invoice,,,,,,30/04/2018,30/04/2018,0.00,,364.41,,"-358,607.10"
,IN,AR,30313970,1005,100,,Invoice,,,,,,30/04/2018,30/04/2018,0.00,,81.57,,"-358,688.67"
,IN,AR,30313971,1005,100,,Invoice,,,,,,30/04/2018,30/04/2018,0.00,,18.64,,"-358,707.31"
,IN,AR,30313972,1005,100,,Invoice,,,,,,30/04/2018,30/04/2018,0.00,,46.61,,"-358,753.92"
,IN,AR,30313973,1005,100,,Invoice,,,,,,30/04/2018,30/04/2018,0.00,,23.31,,"-358,777.23"
,IN,AR,30313974,1005,100,,Invoice,,,,,,30/04/2018,30/04/2018,0.00,,39.62,,"-358,816.85"
,IN,AR,30313975,1005,100,,Invoice,,,,,,30/04/2018,30/04/2018,0.00,,55.93,,"-358,872.78"
,IN,AR,30313976,1005,100,,Invoice,,,,,,30/04/2018,30/04/2018,0.00,,44.28,,"-358,917.06"
,IN,AR,30313977,1005,100,,Invoice,,,,,,30/04/2018,30/04/2018,0.00,,25.64,,"-358,942.70"
,IN,AR,30313978,1005,100,,Invoice,,,,,,30/04/2018,30/04/2018,0.00,,53.60,,"-358,996.30"
,IN,AR,30313979,1005,100,,Invoice,,,,,,30/04/2018,30/04/2018,0.00,,27.97,,"-359,024.27"
,IN,AR,30313981,1005,100,,Invoice,,,,,,30/04/2018,30/04/2018,0.00,,669.76,,"-359,694.03"
,IN,AR,30314022,1005,100,,Invoice,,,,,,30/04/2018,30/04/2018,0.00,,54.66,,"-359,748.69"
,IN,AR,30314027,1005,100,,Invoice,,,,,,30/04/2018,30/04/2018,0.00,,4.29,,"-359,752.98"
,IN,AR,30314035,1005,100,,Invoice,,,,,,30/04/2018,30/04/2018,0.00,,24.05,,"-359,777.03"
,IN,AR,30314040,1005,100,,Invoice,,,,,,30/04/2018,30/04/2018,0.00,,3.64,,"-359,780.67"
,IN,AR,30314042,1005,100,,Invoice,,,,,,30/04/2018,30/04/2018,0.00,,297.33,,"-360,078.00"
,IN,AR,30314043,1005,100,,Invoice,,,,,,30/04/2018,30/04/2018,0.00,,411.92,,"-360,489.92"
,IN,AR,30314059,1005,100,,Invoice,,,,,,30/04/2018,30/04/2018,0.00,,181.11,,"-360,671.03"
,IN,AR,30314065,1005,100,,Invoice,,,,,,30/04/2018,30/04/2018,0.00,,9.62,,"-360,680.65"
,IN,AR,30314091,1005,100,,Invoice,,,,,,30/04/2018,30/04/2018,0.00,,9.84,,"-360,690.49"
,IN,AR,30314095,1005,100,,Invoice,,,,,,30/04/2018,30/04/2018,0.00,,26.27,,"-360,716.76"
,IN,AR,30314100,1005,100,,Invoice,,,,,,30/04/2018,30/04/2018,0.00,,11.44,,"-360,728.20"
,IN,AR,30314104,1005,100,,Invoice,,,,,,30/04/2018,30/04/2018,0.00,,198.20,,"-360,926.40"
,IN,AR,30314105,1005,100,,Invoice,,,,,,30/04/2018,30/04/2018,0.00,,47.19,,"-360,973.59"
,IN,AR,30314106,1005,100,,Invoice,,,,,,30/04/2018,30/04/2018,0.00,,41.53,,"-361,015.12"
,IN,AR,30314107,1005,100,,Invoice,,,,,,30/04/2018,30/04/2018,0.00,,24.54,,"-361,039.66"
,IN,AR,30314110,1005,100,,Invoice,,,,,,30/04/2018,30/04/2018,0.00,,364.41,,"-361,404.07"
,IN,AR,30314139,1005,100,,Invoice,,,,,,30/04/2018,30/04/2018,0.00,,10.00,,"-361,414.07"
,IN,AR,30314142,1005,100,,Invoice,,,,,,30/04/2018,30/04/2018,0.00,,20.01,,"-361,434.08"
,IN,AR,30314161,1005,100,,Invoice,,,,,,30/04/2018,30/04/2018,0.00,,48.27,,"-361,482.35"
,IN,AR,30314167,1005,100,,Invoice,,,,,,30/04/2018,30/04/2018,0.00,,60.94,,"-361,543.29"
,IN,AR,30314179,1005,100,,Invoice,,,,,,30/04/2018,30/04/2018,0.00,,9.32,,"-361,552.61"
,IN,AR,30314180,1005,100,,Invoice,,,,,,30/04/2018,30/04/2018,0.00,,14.58,,"-361,567.19"
,IN,AR,30314184,1005,100,,Invoice,,,,,,30/04/2018,30/04/2018,0.00,,43.49,,"-361,610.68"
,IN,AR,30314187,1005,100,,Invoice,,,,,,30/04/2018,30/04/2018,0.00,,195.76,,"-361,806.44"
,IN,AR,30314195,1005,100,,Invoice,,,,,,30/04/2018,30/04/2018,0.00,,16.83,,"-361,823.27"
,IN,AR,30314204,1005,100,,Invoice,,,,,,30/04/2018,30/04/2018,0.00,,218.64,,"-362,041.91"
,IN,AR,30314254,1005,100,,Invoice,,,,,,30/04/2018,30/04/2018,0.00,,40.04,,"-362,081.95"
,IN,AR,30314259,1005,100,,Invoice,,,,,,30/04/2018,30/04/2018,0.00,,20.71,,"-362,102.66"
,IN,AR,30314260,1005,100,,Invoice,,,,,,30/04/2018,30/04/2018,0.00,,9.56,,"-362,112.22"
,IN,AR,30314278,1005,100,,Invoice,,,,,,30/04/2018,30/04/2018,0.00,,762.12,,"-362,874.34"
,IN,AR,30314279,1005,100,,Invoice,,,,,,30/04/2018,30/04/2018,0.00,,15.59,,"-362,889.93"
,IN,AR,30314280,1005,100,,Invoice,,,,,,30/04/2018,30/04/2018,0.00,,7.80,,"-362,897.73"
,IN,AR,30314281,1005,100,,Invoice,,,,,,30/04/2018,30/04/2018,0.00,,13.64,,"-362,911.37"
,IN,AR,30314282,1005,100,,Invoice,,,,,,30/04/2018,30/04/2018,0.00,,21.44,,"-362,932.81"
,IN,AR,30314283,1005,100,,Invoice,,,,,,30/04/2018,30/04/2018,0.00,,1.95,,"-362,934.76"
,IN,AR,30314284,1005,100,,Invoice,,,,,,30/04/2018,30/04/2018,0.00,,25.34,,"-362,960.10"
,IN,AR,30314285,1005,100,,Invoice,,,,,,30/04/2018,30/04/2018,0.00,,7.80,,"-362,967.90"
,IN,AR,30314286,1005,100,,Invoice,,,,,,30/04/2018,30/04/2018,0.00,,9.75,,"-362,977.65"
,IN,AR,30314287,1005,100,,Invoice,,,,,,30/04/2018,30/04/2018,0.00,,25.34,,"-363,002.99"
,IN,AR,30314288,1005,100,,Invoice,,,,,,30/04/2018,30/04/2018,0.00,,48.73,,"-363,051.72"
,IN,AR,30314289,1005,100,,Invoice,,,,,,30/04/2018,30/04/2018,0.00,,11.69,,"-363,063.41"
,IN,AR,30314290,1005,100,,Invoice,,,,,,30/04/2018,30/04/2018,0.00,,15.59,,"-363,079.00"
,IN,AR,30314291,1005,100,,Invoice,,,,,,30/04/2018,30/04/2018,0.00,,54.58,,"-363,133.58"
,IN,AR,30314292,1005,100,,Invoice,,,,,,30/04/2018,30/04/2018,0.00,,13.64,,"-363,147.22"
,IN,AR,30314293,1005,100,,Invoice,,,,,,30/04/2018,30/04/2018,0.00,,21.44,,"-363,168.66"
,IN,AR,30314294,1005,100,,Invoice,,,,,,30/04/2018,30/04/2018,0.00,,5.85,,"-363,174.51"
,IN,AR,30314295,1005,100,,Invoice,,,,,,30/04/2018,30/04/2018,0.00,,7.80,,"-363,182.31"
,IN,AR,30314296,1005,100,,Invoice,,,,,,30/04/2018,30/04/2018,0.00,,19.49,,"-363,201.80"
,IN,AR,30314297,1005,100,,Invoice,,,,,,30/04/2018,30/04/2018,0.00,,38.98,,"-363,240.78"
,IN,AR,30314298,1005,100,,Invoice,,,,,,30/04/2018,30/04/2018,0.00,,596.44,,"-363,837.22"
,IN,AR,30314299,1005,100,,Invoice,,,,,,30/04/2018,30/04/2018,0.00,,42.88,,"-363,880.10"
,IN,AR,30314300,1005,100,,Invoice,,,,,,30/04/2018,30/04/2018,0.00,,17.54,,"-363,897.64"
,IN,AR,30314301,1005,100,,Invoice,,,,,,30/04/2018,30/04/2018,0.00,,795.25,,"-364,692.89"
,IN,AR,30314302,1005,100,,Invoice,,,,,,30/04/2018,30/04/2018,0.00,,13.64,,"-364,706.53"
,IN,AR,30314303,1005,100,,Invoice,,,,,,30/04/2018,30/04/2018,0.00,,33.14,,"-364,739.67"
,IN,AR,30314304,1005,100,,Invoice,,,,,,30/04/2018,30/04/2018,0.00,,7.80,,"-364,747.47"
,IN,AR,30314305,1005,100,,Invoice,,,,,,30/04/2018,30/04/2018,0.00,,5.85,,"-364,753.32"
,IN,AR,30314306,1005,100,,Invoice,,,,,,30/04/2018,30/04/2018,0.00,,25.34,,"-364,778.66"
,IN,AR,30314307,1005,100,,Invoice,,,,,,30/04/2018,30/04/2018,0.00,,23.39,,"-364,802.05"
,IN,AR,30314329,1005,100,,Invoice,,,,,,30/04/2018,30/04/2018,0.00,,18.00,,"-364,820.05"
,IN,AR,30314334,1005,100,,Invoice,,,,,,30/04/2018,30/04/2018,0.00,,24.46,,"-364,844.51"
,IN,AR,30314335,1005,100,,Invoice,,,,,,30/04/2018,30/04/2018,0.00,,13.17,,"-364,857.68"
,IN,AR,30314336,1005,100,,Invoice,,,,,,30/04/2018,30/04/2018,0.00,,13.17,,"-364,870.85"
,IN,AR,30314337,1005,100,,Invoice,,,,,,30/04/2018,30/04/2018,0.00,,9.41,,"-364,880.26"
,IN,AR,30314338,1005,100,,Invoice,,,,,,30/04/2018,30/04/2018,0.00,,11.29,,"-364,891.55"
,IN,AR,30314339,1005,100,,Invoice,,,,,,30/04/2018,30/04/2018,0.00,,7.53,,"-364,899.08"
,IN,AR,30314340,1005,100,,Invoice,,,,,,30/04/2018,30/04/2018,0.00,,3.76,,"-364,902.84"
,IN,AR,30314346,1005,100,,Invoice,,,,,,30/04/2018,30/04/2018,0.00,,3.51,,"-364,906.35"
,IN,AR,30314352,1005,100,,Invoice,,,,,,30/04/2018,30/04/2018,0.00,,5.93,,"-364,912.28"
,IN,AR,30314361,1005,100,,Invoice,,,,,,30/04/2018,30/04/2018,0.00,,29.15,,"-364,941.43"
,IN,AR,30314364,1005,100,,Invoice,,,,,,30/04/2018,30/04/2018,0.00,,29.15,,"-364,970.58"
,IN,AR,30314365,1005,100,,Invoice,,,,,,30/04/2018,30/04/2018,0.00,,54.66,,"-365,025.24"
,IN,AR,30314366,1005,100,,Invoice,,,,,,30/04/2018,30/04/2018,0.00,,706.96,,"-365,732.20"
,IN,AR,30314370,1005,100,,Invoice,,,,,,30/04/2018,30/04/2018,0.00,,5.26,,"-365,737.46"
,IN,AR,30314395,1005,100,,Invoice,,,,,,30/04/2018,30/04/2018,0.00,,299.35,,"-366,036.81"
,IN,AR,30314396,1005,100,,Invoice,,,,,,30/04/2018,30/04/2018,0.00,,250.03,,"-366,286.84"
,IN,AR,30314403,1005,100,,Invoice,,,,,,30/04/2018,30/04/2018,0.00,,182.20,,"-366,469.04"
,IN,AR,30314404,1005,100,,Invoice,,,,,,30/04/2018,30/04/2018,0.00,,7.86,,"-366,476.90"
,IN,AR,30314408,1005,100,,Invoice,,,,,,30/04/2018,30/04/2018,0.00,,66.14,,"-366,543.04"
,IN,AR,30314414,1005,100,,Invoice,,,,,,30/04/2018,30/04/2018,0.00,,6.13,,"-366,549.17"
,IN,AR,30314424,1005,100,,Invoice,,,,,,30/04/2018,30/04/2018,0.00,,10.93,,"-366,560.10"
,IN,AR,30314445,1005,100,,Invoice,,,,,,30/04/2018,30/04/2018,0.00,,11.95,,"-366,572.05"
,IN,AR,30314450,1005,100,,Invoice,,,,,,30/04/2018,30/04/2018,0.00,,54.66,,"-366,626.71"
,IN,AR,30314454,1005,100,,Invoice,,,,,,30/04/2018,30/04/2018,0.00,,23.39,,"-366,650.10"
,IN,AR,30314457,1005,100,,Invoice,,,,,,30/04/2018,30/04/2018,0.00,,41.06,,"-366,691.16"
,IN,AR,30314458,1005,100,,Invoice,,,,,,30/04/2018,30/04/2018,0.00,,16.42,,"-366,707.58"
,IN,AR,30314459,1005,100,,Invoice,,,,,,30/04/2018,30/04/2018,0.00,,10.95,,"-366,718.53"
,IN,AR,30314460,1005,100,,Invoice,,,,,,30/04/2018,30/04/2018,0.00,,19.16,,"-366,737.69"
,IN,AR,30314467,1005,100,,Invoice,,,,,,30/04/2018,30/04/2018,0.00,,6.07,,"-366,743.76"
,IN,AR,30314476,1005,100,,Invoice,,,,,,30/04/2018,30/04/2018,0.00,,10.38,,"-366,754.14"
,IN,AR,30314477,1005,100,,Invoice,,,,,,30/04/2018,30/04/2018,0.00,,6.23,,"-366,760.37"
,IN,AR,30314478,1005,100,,Invoice,,,,,,30/04/2018,30/04/2018,0.00,,4.15,,"-366,764.52"
,IN,AR,30314479,1005,100,,Invoice,,,,,,30/04/2018,30/04/2018,0.00,,6.23,,"-366,770.75"
,IN,AR,30314514,1005,100,,Invoice,,,,,,30/04/2018,30/04/2018,0.00,,6.56,,"-366,777.31"
,IN,AR,30314517,1005,100,,Invoice,,,,,,30/04/2018,30/04/2018,0.00,,21.74,,"-366,799.05"
,IN,AR,30314551,1005,100,,Invoice,,,,,,30/04/2018,30/04/2018,0.00,,"1,093.22",,"-367,892.27"
,IN,AR,30314554,1005,100,,Invoice,,,,,,30/04/2018,30/04/2018,0.00,,419.07,,"-368,311.34"
,IN,AR,30314555,1005,100,,Invoice,,,,,,30/04/2018,30/04/2018,0.00,,419.07,,"-368,730.41"
,IN,AR,30314557,1005,100,,Invoice,,,,,,30/04/2018,30/04/2018,0.00,,54.66,,"-368,785.07"
,CS,AR,32003795,1005,100,,Cash sale,,,,,,01/05/2018,01/05/2018,0.00,,29.15,,"-368,814.22"
,CS,AR,32003435,1005,100,,Cash sale,,,,,,02/05/2018,02/05/2018,0.00,,30.86,,"-368,845.08"
,CS,AR,32003443,1005,100,,Cash sale,,,,,,02/05/2018,02/05/2018,0.00,,7.29,,"-368,852.37"
,CS,AR,32003444,1005,100,,Cash sale,,,,,,02/05/2018,02/05/2018,0.00,,45.15,,"-368,897.52"
,CS,AR,32003460,1005,100,,Cash sale,,,,,,02/05/2018,02/05/2018,0.00,,7.29,,"-368,904.81"
,CS,AR,32003470,1005,100,,Cash sale,,,,,,02/05/2018,02/05/2018,0.00,,3.64,,"-368,908.45"
,CS,AR,32003473,1005,100,,Cash sale,,,,,,02/05/2018,02/05/2018,0.00,,10.93,,"-368,919.38"
,CS,AR,32003475,1005,100,,Cash sale,,,,,,02/05/2018,02/05/2018,0.00,,7.29,,"-368,926.67"
,CS,AR,32003489,1005,100,,Cash sale,,,,,,02/05/2018,02/05/2018,0.00,,7.29,,"-368,933.96"
,CS,AR,32003492,1005,100,,Cash sale,,,,,,02/05/2018,02/05/2018,0.00,,3.64,,"-368,937.60"
,CS,AR,32003507,1005,100,,Cash sale,,,,,,02/05/2018,02/05/2018,0.00,,6.02,,"-368,943.62"
,CS,AR,32003536,1005,100,,Cash sale,,,,,,02/05/2018,02/05/2018,0.00,,5.86,,"-368,949.48"
,CS,AR,32003547,1005,100,,Cash sale,,,,,,02/05/2018,02/05/2018,0.00,,15.25,,"-368,964.73"
,CS,AR,32003551,1005,100,,Cash sale,,,,,,02/05/2018,02/05/2018,0.00,,14.58,,"-368,979.31"
,CS,AR,32003584,1005,100,,Cash sale,,,,,,02/05/2018,02/05/2018,0.00,,11.36,,"-368,990.67"
,CS,AR,32003590,1005,100,,Cash sale,,,,,,02/05/2018,02/05/2018,0.00,,20.68,,"-369,011.35"
,CS,AR,32003595,1005,100,,Cash sale,,,,,,02/05/2018,02/05/2018,0.00,,7.29,,"-369,018.64"
,CS,AR,32003605,1005,100,,Cash sale,,,,,,02/05/2018,02/05/2018,0.00,,18.05,,"-369,036.69"
,CS,AR,32003607,1005,100,,Cash sale,,,,,,02/05/2018,02/05/2018,0.00,,8.58,,"-369,045.27"
,CS,AR,32003616,1005,100,,Cash sale,,,,,,02/05/2018,02/05/2018,0.00,,14.58,,"-369,059.85"
,CS,AR,32003645,1005,100,,Cash sale,,,,,,02/05/2018,02/05/2018,0.00,,4.32,,"-369,064.17"
,CS,AR,32003664,1005,100,,Cash sale,,,,,,02/05/2018,02/05/2018,0.00,,4.32,,"-369,068.49"
,CS,AR,32003686,1005,100,,Cash sale,,,,,,02/05/2018,02/05/2018,0.00,,5.08,,"-369,073.57"
,CS,AR,32003705,1005,100,,Cash sale,,,,,,02/05/2018,02/05/2018,0.00,,14.58,,"-369,088.15"
,CS,AR,32003720,1005,100,,Cash sale,,,,,,02/05/2018,02/05/2018,0.00,,21.86,,"-369,110.01"
,CS,AR,32003723,1005,100,,Cash sale,,,,,,02/05/2018,02/05/2018,0.00,,29.15,,"-369,139.16"
,CS,AR,32003748,1005,100,,Cash sale,,,,,,02/05/2018,02/05/2018,0.00,,3.64,,"-369,142.80"
,CS,AR,32003751,1005,100,,Cash sale,,,,,,02/05/2018,02/05/2018,0.00,,7.29,,"-369,150.09"
,CS,AR,32003754,1005,100,,Cash sale,,,,,,02/05/2018,02/05/2018,0.00,,3.64,,"-369,153.73"
,CS,AR,32003765,1005,100,,Cash sale,,,,,,02/05/2018,02/05/2018,0.00,,17.15,,"-369,170.88"
,CS,AR,32003809,1005,100,,Cash sale,,,,,,02/05/2018,02/05/2018,0.00,,7.29,,"-369,178.17"
,CS,AR,32003844,1005,100,,Cash sale,,,,,,02/05/2018,02/05/2018,0.00,,11.44,,"-369,189.61"
,CS,AR,32003854,1005,100,,Cash sale,,,,,,02/05/2018,02/05/2018,0.00,,12.14,,"-369,201.75"
,CS,AR,32003867,1005,100,,Cash sale,,,,,,02/05/2018,02/05/2018,0.00,,7.29,,"-369,209.04"
,CS,AR,32003874,1005,100,,Cash sale,,,,,,02/05/2018,02/05/2018,0.00,,12.03,,"-369,221.07"
,CS,AR,32003885,1005,100,,Cash sale,,,,,,02/05/2018,02/05/2018,0.00,,7.29,,"-369,228.36"
,CS,AR,32003905,1005,100,,Cash sale,,,,,,02/05/2018,02/05/2018,0.00,,6.56,,"-369,234.92"
,CS,AR,32003910,1005,100,,Cash sale,,,,,,02/05/2018,02/05/2018,0.00,,7.29,,"-369,242.21"
,CS,AR,32003924,1005,100,,Cash sale,,,,,,02/05/2018,02/05/2018,0.00,,13.69,,"-369,255.90"
,CS,AR,32003942,1005,100,,Cash sale,,,,,,02/05/2018,02/05/2018,0.00,,8.25,,"-369,264.15"
,CS,AR,32003954,1005,100,,Cash sale,,,,,,02/05/2018,02/05/2018,0.00,,6.07,,"-369,270.22"
,IN,AR,30313116,1005,100,,Invoice,,,,,,02/05/2018,02/05/2018,0.00,,6.02,,"-369,276.24"
,IN,AR,30313123,1005,100,,Invoice,,,,,,02/05/2018,02/05/2018,0.00,,32.63,,"-369,308.87"
,IN,AR,30313142,1005,100,,Invoice,,,,,,02/05/2018,02/05/2018,0.00,,329.71,,"-369,638.58"
,IN,AR,30313145,1005,100,,Invoice,,,,,,02/05/2018,02/05/2018,0.00,,32.80,,"-369,671.38"
,IN,AR,30313147,1005,100,,Invoice,,,,,,02/05/2018,02/05/2018,0.00,,48.81,,"-369,720.19"
,IN,AR,30313159,1005,100,,Invoice,,,,,,02/05/2018,02/05/2018,0.00,,25.89,,"-369,746.08"
,IN,AR,30313160,1005,100,,Invoice,,,,,,02/05/2018,02/05/2018,0.00,,23.64,,"-369,769.72"
,IN,AR,30313161,1005,100,,Invoice,,,,,,02/05/2018,02/05/2018,0.00,,73.56,,"-369,843.28"
,IN,AR,30313166,1005,100,,Invoice,,,,,,02/05/2018,02/05/2018,0.00,,21.86,,"-369,865.14"
,IN,AR,30313175,1005,100,,Invoice,,,,,,02/05/2018,02/05/2018,0.00,,10.50,,"-369,875.64"
,IN,AR,30313200,1005,100,,Invoice,,,,,,02/05/2018,02/05/2018,0.00,,3.98,,"-369,879.62"
,IN,AR,30313208,1005,100,,Invoice,,,,,,02/05/2018,02/05/2018,0.00,,75.93,,"-369,955.55"
,IN,AR,30313229,1005,100,,Invoice,,,,,,02/05/2018,02/05/2018,0.00,,42.00,,"-369,997.55"
,IN,AR,30313236,1005,100,,Invoice,,,,,,02/05/2018,02/05/2018,0.00,,18.22,,"-370,015.77"
,IN,AR,30313250,1005,100,,Invoice,,,,,,02/05/2018,02/05/2018,0.00,,20.00,,"-370,035.77"
,IN,AR,30313251,1005,100,,Invoice,,,,,,02/05/2018,02/05/2018,0.00,,24.00,,"-370,059.77"
,IN,AR,30313279,1005,100,,Invoice,,,,,,02/05/2018,02/05/2018,0.00,,36.00,,"-370,095.77"
,IN,AR,30313291,1005,100,,Invoice,,,,,,02/05/2018,02/05/2018,0.00,,12.00,,"-370,107.77"
,IN,AR,30313292,1005,100,,Invoice,,,,,,02/05/2018,02/05/2018,0.00,,22.00,,"-370,129.77"
,IN,AR,30313318,1005,100,,Invoice,,,,,,02/05/2018,02/05/2018,0.00,,49.12,,"-370,178.89"
,IN,AR,30313319,1005,100,,Invoice,,,,,,02/05/2018,02/05/2018,0.00,,103.69,,"-370,282.58"
,IN,AR,30313320,1005,100,,Invoice,,,,,,02/05/2018,02/05/2018,0.00,,30.02,,"-370,312.60"
,IN,AR,30313339,1005,100,,Invoice,,,,,,02/05/2018,02/05/2018,0.00,,44.00,,"-370,356.60"
,IN,AR,30313349,1005,100,,Invoice,,,,,,02/05/2018,02/05/2018,0.00,,12.03,,"-370,368.63"
,IN,AR,30313357,1005,100,,Invoice,,,,,,02/05/2018,02/05/2018,0.00,,4.83,,"-370,373.46"
,IN,AR,30313365,1005,100,,Invoice,,,,,,02/05/2018,02/05/2018,0.00,,26.53,,"-370,399.99"
,IN,AR,30313412,1005,100,,Invoice,,,,,,02/05/2018,02/05/2018,0.00,,25.42,,"-370,425.41"
,IN,AR,30313419,1005,100,,Invoice,,,,,,02/05/2018,02/05/2018,0.00,,19.07,,"-370,444.48"
,IN,AR,30313423,1005,100,,Invoice,,,,,,02/05/2018,02/05/2018,0.00,,2.12,,"-370,446.60"
,IN,AR,30313433,1005,100,,Invoice,,,,,,02/05/2018,02/05/2018,0.00,,2.12,,"-370,448.72"
,IN,AR,30313435,1005,100,,Invoice,,,,,,02/05/2018,02/05/2018,0.00,,8.39,,"-370,457.11"
,IN,AR,30313437,1005,100,,Invoice,,,,,,02/05/2018,02/05/2018,0.00,,12.71,,"-370,469.82"
,IN,AR,30313471,1005,100,,Invoice,,,,,,02/05/2018,02/05/2018,0.00,,26.29,,"-370,496.11"
,IN,AR,30313480,1005,100,,Invoice,,,,,,02/05/2018,02/05/2018,0.00,,55.37,,"-370,551.48"
,IN,AR,30313487,1005,100,,Invoice,,,,,,02/05/2018,02/05/2018,0.00,,15.25,,"-370,566.73"
,IN,AR,30313494,1005,100,,Invoice,,,,,,02/05/2018,02/05/2018,0.00,,9.43,,"-370,576.16"
,IN,AR,30313497,1005,100,,Invoice,,,,,,02/05/2018,02/05/2018,0.00,,54.66,,"-370,630.82"
,IN,AR,30313500,1005,100,,Invoice,,,,,,02/05/2018,02/05/2018,0.00,,4.78,,"-370,635.60"
,IN,AR,30313555,1005,100,,Invoice,,,,,,02/05/2018,02/05/2018,0.00,,150.04,,"-370,785.64"
,IN,AR,30313592,1005,100,,Invoice,,,,,,02/05/2018,02/05/2018,0.00,,5.08,,"-370,790.72"
,IN,AR,30313607,1005,100,,Invoice,,,,,,02/05/2018,02/05/2018,0.00,,1.59,,"-370,792.31"
,IN,AR,30313686,1005,100,,Invoice,,,,,,02/05/2018,02/05/2018,0.00,,14.63,,"-370,806.94"
,IN,AR,30313696,1005,100,,Invoice,,,,,,02/05/2018,02/05/2018,0.00,,8.26,,"-370,815.20"
,IN,AR,30313700,1005,100,,Invoice,,,,,,02/05/2018,02/05/2018,0.00,,10.93,,"-370,826.13"
,IN,AR,30313702,1005,100,,Invoice,,,,,,02/05/2018,02/05/2018,0.00,,15.25,,"-370,841.38"
,IN,AR,30313706,1005,100,,Invoice,,,,,,02/05/2018,02/05/2018,0.00,,15.79,,"-370,857.17"
,IN,AR,30313759,1005,100,,Invoice,,,,,,02/05/2018,02/05/2018,0.00,,20.76,,"-370,877.93"
,IN,AR,30313763,1005,100,,Invoice,,,,,,02/05/2018,02/05/2018,0.00,,14.58,,"-370,892.51"
,IN,AR,30313771,1005,100,,Invoice,,,,,,02/05/2018,02/05/2018,0.00,,8.39,,"-370,900.90"
,IN,AR,30313772,1005,100,,Invoice,,,,,,02/05/2018,02/05/2018,0.00,,2.80,,"-370,903.70"
,IN,AR,30313787,1005,100,,Invoice,,,,,,02/05/2018,02/05/2018,0.00,,10.93,,"-370,914.63"
,IN,AR,30313789,1005,100,,Invoice,,,,,,02/05/2018,02/05/2018,0.00,,10.93,,"-370,925.56"
,IN,AR,30313790,1005,100,,Invoice,,,,,,02/05/2018,02/05/2018,0.00,,10.93,,"-370,936.49"
,IN,AR,30313795,1005,100,,Invoice,,,,,,02/05/2018,02/05/2018,0.00,,22.37,,"-370,958.86"
,IN,AR,30313810,1005,100,,Invoice,,,,,,02/05/2018,02/05/2018,0.00,,22.81,,"-370,981.67"
,IN,AR,30313830,1005,100,,Invoice,,,,,,02/05/2018,02/05/2018,0.00,,5.59,,"-370,987.26"
,IN,AR,30313850,1005,100,,Invoice,,,,,,02/05/2018,02/05/2018,0.00,,54.66,,"-371,041.92"
,IN,AR,30313855,1005,100,,Invoice,,,,,,02/05/2018,02/05/2018,0.00,,18.05,,"-371,059.97"
,IN,AR,30313874,1005,100,,Invoice,,,,,,02/05/2018,02/05/2018,0.00,,10.93,,"-371,070.90"
,IN,AR,30313884,1005,100,,Invoice,,,,,,02/05/2018,02/05/2018,0.00,,32.16,,"-371,103.06"
,IN,AR,30313896,1005,100,,Invoice,,,,,,02/05/2018,02/05/2018,0.00,,1.76,,"-371,104.82"
,IN,AR,30313897,1005,100,,Invoice,,,,,,02/05/2018,02/05/2018,0.00,,15.86,,"-371,120.68"
,IN,AR,30313925,1005,100,,Invoice,,,,,,02/05/2018,02/05/2018,0.00,,10.93,,"-371,131.61"
,IN,AR,30313926,1005,100,,Invoice,,,,,,02/05/2018,02/05/2018,0.00,,5.17,,"-371,136.78"
,IN,AR,30313942,1005,100,,Invoice,,,,,,02/05/2018,02/05/2018,0.00,,15.25,,"-371,152.03"
,IN,AR,30313947,1005,100,,Invoice,,,,,,02/05/2018,02/05/2018,0.00,,16.01,,"-371,168.04"
,IN,AR,30313999,1005,100,,Invoice,,,,,,02/05/2018,02/05/2018,0.00,,11.13,,"-371,179.17"
,IN,AR,30314011,1005,100,,Invoice,,,,,,02/05/2018,02/05/2018,0.00,,2.01,,"-371,181.18"
,IN,AR,30314015,1005,100,,Invoice,,,,,,02/05/2018,02/05/2018,0.00,,42.58,,"-371,223.76"
,IN,AR,30314019,1005,100,,Invoice,,,,,,02/05/2018,02/05/2018,0.00,,36.00,,"-371,259.76"
,IN,AR,30314044,1005,100,,Invoice,,,,,,02/05/2018,02/05/2018,0.00,,58.31,,"-371,318.07"
,IN,AR,30314045,1005,100,,Invoice,,,,,,02/05/2018,02/05/2018,0.00,,14.58,,"-371,332.65"
,IN,AR,30314060,1005,100,,Invoice,,,,,,02/05/2018,02/05/2018,0.00,,35.71,,"-371,368.36"
,IN,AR,30314066,1005,100,,Invoice,,,,,,02/05/2018,02/05/2018,0.00,,3.20,,"-371,371.56"
,IN,AR,30314067,1005,100,,Invoice,,,,,,02/05/2018,02/05/2018,0.00,,4.81,,"-371,376.37"
,IN,AR,30314068,1005,100,,Invoice,,,,,,02/05/2018,02/05/2018,0.00,,1.60,,"-371,377.97"
,IN,AR,30314069,1005,100,,Invoice,,,,,,02/05/2018,02/05/2018,0.00,,9.62,,"-371,387.59"
,IN,AR,30314070,1005,100,,Invoice,,,,,,02/05/2018,02/05/2018,0.00,,9.62,,"-371,397.21"
,IN,AR,30314071,1005,100,,Invoice,,,,,,02/05/2018,02/05/2018,0.00,,17.64,,"-371,414.85"
,IN,AR,30314072,1005,100,,Invoice,,,,,,02/05/2018,02/05/2018,0.00,,3.20,,"-371,418.05"
,IN,AR,30314096,1005,100,,Invoice,,,,,,02/05/2018,02/05/2018,0.00,,7.88,,"-371,425.93"
,IN,AR,30314108,1005,100,,Invoice,,,,,,02/05/2018,02/05/2018,0.00,,7.64,,"-371,433.57"
,IN,AR,30314114,1005,100,,Invoice,,,,,,02/05/2018,02/05/2018,0.00,,36.22,,"-371,469.79"
,IN,AR,30314150,1005,100,,Invoice,,,,,,02/05/2018,02/05/2018,0.00,,20.01,,"-371,489.80"
,IN,AR,30314158,1005,100,,Invoice,,,,,,02/05/2018,02/05/2018,0.00,,28.39,,"-371,518.19"
,IN,AR,30314162,1005,100,,Invoice,,,,,,02/05/2018,02/05/2018,0.00,,6.03,,"-371,524.22"
,IN,AR,30314171,1005,100,,Invoice,,,,,,02/05/2018,02/05/2018,0.00,,29.44,,"-371,553.66"
,IN,AR,30314172,1005,100,,Invoice,,,,,,02/05/2018,02/05/2018,0.00,,16.82,,"-371,570.48"
,IN,AR,30314177,1005,100,,Invoice,,,,,,02/05/2018,02/05/2018,0.00,,11.95,,"-371,582.43"
,IN,AR,30314209,1005,100,,Invoice,,,,,,02/05/2018,02/05/2018,0.00,,8.39,,"-371,590.82"
,IN,AR,30314214,1005,100,,Invoice,,,,,,02/05/2018,02/05/2018,0.00,,9.64,,"-371,600.46"
,IN,AR,30314217,1005,100,,Invoice,,,,,,02/05/2018,02/05/2018,0.00,,114.00,,"-371,714.46"
,IN,AR,30314228,1005,100,,Invoice,,,,,,02/05/2018,02/05/2018,0.00,,23.73,,"-371,738.19"
,IN,AR,30314240,1005,100,,Invoice,,,,,,02/05/2018,02/05/2018,0.00,,182.20,,"-371,920.39"
,IN,AR,30314248,1005,100,,Invoice,,,,,,02/05/2018,02/05/2018,0.00,,7.29,,"-371,927.68"
,IN,AR,30314261,1005,100,,Invoice,,,,,,02/05/2018,02/05/2018,0.00,,9.56,,"-371,937.24"
,IN,AR,30314310,1005,100,,Invoice,,,,,,02/05/2018,02/05/2018,0.00,,33.22,,"-371,970.46"
,IN,AR,30314311,1005,100,,Invoice,,,,,,02/05/2018,02/05/2018,0.00,,45.08,,"-372,015.54"
,IN,AR,30314358,1005,100,,Invoice,,,,,,02/05/2018,02/05/2018,0.00,,145.22,,"-372,160.76"
,IN,AR,30314394,1005,100,,Invoice,,,,,,02/05/2018,02/05/2018,0.00,,10.93,,"-372,171.69"
,IN,AR,30314411,1005,100,,Invoice,,,,,,02/05/2018,02/05/2018,0.00,,11.19,,"-372,182.88"
,IN,AR,30314461,1005,100,,Invoice,,,,,,02/05/2018,02/05/2018,0.00,,11.44,,"-372,194.32"
,IN,AR,30314480,1005,100,,Invoice,,,,,,02/05/2018,02/05/2018,0.00,,60.21,,"-372,254.53"
,IN,AR,30314481,1005,100,,Invoice,,,,,,02/05/2018,02/05/2018,0.00,,4.15,,"-372,258.68"
,IN,AR,30314482,1005,100,,Invoice,,,,,,02/05/2018,02/05/2018,0.00,,12.46,,"-372,271.14"
,IN,AR,30314483,1005,100,,Invoice,,,,,,02/05/2018,02/05/2018,0.00,,8.31,,"-372,279.45"
,IN,AR,30314562,1005,100,,Invoice,,,,,,02/05/2018,02/05/2018,0.00,,72.88,,"-372,352.33"
,CN,AR,31017986,1005,100,,Credit Note,,,,,,03/05/2018,03/05/2018,3.64,,0.00,,"-372,348.69"
,CR,AR,33000138,1005,100,,Cash Return,,,,,,03/05/2018,03/05/2018,3.64,,0.00,,"-372,345.05"
,CS,AR,32003433,1005,100,,Cash sale,,,,,,03/05/2018,03/05/2018,0.00,,15.04,,"-372,360.09"
,CS,AR,32003478,1005,100,,Cash sale,,,,,,03/05/2018,03/05/2018,0.00,,7.29,,"-372,367.38"
,CS,AR,32003479,1005,100,,Cash sale,,,,,,03/05/2018,03/05/2018,0.00,,3.64,,"-372,371.02"
,CS,AR,32003480,1005,100,,Cash sale,,,,,,03/05/2018,03/05/2018,0.00,,60.17,,"-372,431.19"
,CS,AR,32003487,1005,100,,Cash sale,,,,,,03/05/2018,03/05/2018,0.00,,3.64,,"-372,434.83"
,CS,AR,32003494,1005,100,,Cash sale,,,,,,03/05/2018,03/05/2018,0.00,,7.29,,"-372,442.12"
,CS,AR,32003502,1005,100,,Cash sale,,,,,,03/05/2018,03/05/2018,0.00,,3.64,,"-372,445.76"
,CS,AR,32003510,1005,100,,Cash sale,,,,,,03/05/2018,03/05/2018,0.00,,7.29,,"-372,453.05"
,CS,AR,32003512,1005,100,,Cash sale,,,,,,03/05/2018,03/05/2018,0.00,,3.64,,"-372,456.69"
,CS,AR,32003537,1005,100,,Cash sale,,,,,,03/05/2018,03/05/2018,0.00,,14.58,,"-372,471.27"
,CS,AR,32003553,1005,100,,Cash sale,,,,,,03/05/2018,03/05/2018,0.00,,3.64,,"-372,474.91"
,CS,AR,32003555,1005,100,,Cash sale,,,,,,03/05/2018,03/05/2018,0.00,,10.93,,"-372,485.84"
,CS,AR,32003560,1005,100,,Cash sale,,,,,,03/05/2018,03/05/2018,0.00,,4.32,,"-372,490.16"
,CS,AR,32003562,1005,100,,Cash sale,,,,,,03/05/2018,03/05/2018,0.00,,7.29,,"-372,497.45"
,CS,AR,32003589,1005,100,,Cash sale,,,,,,03/05/2018,03/05/2018,0.00,,7.29,,"-372,504.74"
,CS,AR,32003614,1005,100,,Cash sale,,,,,,03/05/2018,03/05/2018,0.00,,7.29,,"-372,512.03"
,CS,AR,32003657,1005,100,,Cash sale,,,,,,03/05/2018,03/05/2018,0.00,,10.21,,"-372,522.24"
,CS,AR,32003681,1005,100,,Cash sale,,,,,,03/05/2018,03/05/2018,0.00,,19.28,,"-372,541.52"
,CS,AR,32003692,1005,100,,Cash sale,,,,,,03/05/2018,03/05/2018,0.00,,12.92,,"-372,554.44"
,CS,AR,32003709,1005,100,,Cash sale,,,,,,03/05/2018,03/05/2018,0.00,,10.17,,"-372,564.61"
,CS,AR,32003712,1005,100,,Cash sale,,,,,,03/05/2018,03/05/2018,0.00,,25.17,,"-372,589.78"
,CS,AR,32003716,1005,100,,Cash sale,,,,,,03/05/2018,03/05/2018,0.00,,18.09,,"-372,607.87"
,CS,AR,32003722,1005,100,,Cash sale,,,,,,03/05/2018,03/05/2018,0.00,,7.29,,"-372,615.16"
,CS,AR,32003742,1005,100,,Cash sale,,,,,,03/05/2018,03/05/2018,0.00,,2.58,,"-372,617.74"
,CS,AR,32003762,1005,100,,Cash sale,,,,,,03/05/2018,03/05/2018,0.00,,5.56,,"-372,623.30"
,CS,AR,32003768,1005,100,,Cash sale,,,,,,03/05/2018,03/05/2018,0.00,,8.02,,"-372,631.32"
,CS,AR,32003787,1005,100,,Cash sale,,,,,,03/05/2018,03/05/2018,0.00,,7.29,,"-372,638.61"
,CS,AR,32003790,1005,100,,Cash sale,,,,,,03/05/2018,03/05/2018,0.00,,2.62,,"-372,641.23"
,CS,AR,32003802,1005,100,,Cash sale,,,,,,03/05/2018,03/05/2018,0.00,,6.12,,"-372,647.35"
,CS,AR,32003806,1005,100,,Cash sale,,,,,,03/05/2018,03/05/2018,0.00,,18.22,,"-372,665.57"
,CS,AR,32003812,1005,100,,Cash sale,,,,,,03/05/2018,03/05/2018,0.00,,7.29,,"-372,672.86"
,CS,AR,32003814,1005,100,,Cash sale,,,,,,03/05/2018,03/05/2018,0.00,,10.17,,"-372,683.03"
,CS,AR,32003816,1005,100,,Cash sale,,,,,,03/05/2018,03/05/2018,0.00,,32.00,,"-372,715.03"
,CS,AR,32003831,1005,100,,Cash sale,,,,,,03/05/2018,03/05/2018,0.00,,5.93,,"-372,720.96"
,CS,AR,32003850,1005,100,,Cash sale,,,,,,03/05/2018,03/05/2018,0.00,,29.15,,"-372,750.11"
,CS,AR,32003868,1005,100,,Cash sale,,,,,,03/05/2018,03/05/2018,0.00,,5.50,,"-372,755.61"
,CS,AR,32003872,1005,100,,Cash sale,,,,,,03/05/2018,03/05/2018,0.00,,18.22,,"-372,773.83"
,CS,AR,32003887,1005,100,,Cash sale,,,,,,03/05/2018,03/05/2018,0.00,,5.47,,"-372,779.30"
,CS,AR,32003900,1005,100,,Cash sale,,,,,,03/05/2018,03/05/2018,0.00,,14.58,,"-372,793.88"
,CS,AR,32003917,1005,100,,Cash sale,,,,,,03/05/2018,03/05/2018,0.00,,3.64,,"-372,797.52"
,CS,AR,32003922,1005,100,,Cash sale,,,,,,03/05/2018,03/05/2018,0.00,,10.93,,"-372,808.45"
,CS,AR,32003933,1005,100,,Cash sale,,,,,,03/05/2018,03/05/2018,0.00,,14.58,,"-372,823.03"
,CS,AR,32003934,1005,100,,Cash sale,,,,,,03/05/2018,03/05/2018,0.00,,14.58,,"-372,837.61"
,CS,AR,32003938,1005,100,,Cash sale,,,,,,03/05/2018,03/05/2018,0.00,,7.29,,"-372,844.90"
,CS,AR,32003940,1005,100,,Cash sale,,,,,,03/05/2018,03/05/2018,0.00,,7.29,,"-372,852.19"
,CS,AR,32003944,1005,100,,Cash sale,,,,,,03/05/2018,03/05/2018,0.00,,7.29,,"-372,859.48"
,CS,AR,32003946,1005,100,,Cash sale,,,,,,03/05/2018,03/05/2018,0.00,,7.17,,"-372,866.65"
,CS,AR,32003975,1005,100,,Cash sale,,,,,,03/05/2018,03/05/2018,0.00,,3.64,,"-372,870.29"
,IN,AR,30313124,1005,100,,Invoice,,,,,,03/05/2018,03/05/2018,0.00,,5.93,,"-372,876.22"
,IN,AR,30313135,1005,100,,Invoice,,,,,,03/05/2018,03/05/2018,0.00,,7.29,,"-372,883.51"
,IN,AR,30313179,1005,100,,Invoice,,,,,,03/05/2018,03/05/2018,0.00,,2.03,,"-372,885.54"
,IN,AR,30313191,1005,100,,Invoice,,,,,,03/05/2018,03/05/2018,0.00,,25.51,,"-372,911.05"
,IN,AR,30313209,1005,100,,Invoice,,,,,,03/05/2018,03/05/2018,0.00,,61.69,,"-372,972.74"
,IN,AR,30313245,1005,100,,Invoice,,,,,,03/05/2018,03/05/2018,0.00,,3.64,,"-372,976.38"
,IN,AR,30313246,1005,100,,Invoice,,,,,,03/05/2018,03/05/2018,0.00,,21.86,,"-372,998.24"
,IN,AR,30313260,1005,100,,Invoice,,,,,,03/05/2018,03/05/2018,0.00,,7.29,,"-373,005.53"
,IN,AR,30313268,1005,100,,Invoice,,,,,,03/05/2018,03/05/2018,0.00,,13.77,,"-373,019.30"
,IN,AR,30313270,1005,100,,Invoice,,,,,,03/05/2018,03/05/2018,0.00,,7.29,,"-373,026.59"
,IN,AR,30313284,1005,100,,Invoice,,,,,,03/05/2018,03/05/2018,0.00,,78.31,,"-373,104.90"
,IN,AR,30313301,1005,100,,Invoice,,,,,,03/05/2018,03/05/2018,0.00,,7.29,,"-373,112.19"
,IN,AR,30313305,1005,100,,Invoice,,,,,,03/05/2018,03/05/2018,0.00,,30.20,,"-373,142.39"
,IN,AR,30313307,1005,100,,Invoice,,,,,,03/05/2018,03/05/2018,0.00,,14.58,,"-373,156.97"
,IN,AR,30313316,1005,100,,Invoice,,,,,,03/05/2018,03/05/2018,0.00,,25.55,,"-373,182.52"
,IN,AR,30313324,1005,100,,Invoice,,,,,,03/05/2018,03/05/2018,0.00,,182.20,,"-373,364.72"
,IN,AR,30313378,1005,100,,Invoice,,,,,,03/05/2018,03/05/2018,0.00,,7.29,,"-373,372.01"
,IN,AR,30313383,1005,100,,Invoice,,,,,,03/05/2018,03/05/2018,0.00,,10.93,,"-373,382.94"
,IN,AR,30313385,1005,100,,Invoice,,,,,,03/05/2018,03/05/2018,0.00,,38.50,,"-373,421.44"
,IN,AR,30313401,1005,100,,Invoice,,,,,,03/05/2018,03/05/2018,0.00,,25.51,,"-373,446.95"
,IN,AR,30313449,1005,100,,Invoice,,,,,,03/05/2018,03/05/2018,0.00,,196.07,,"-373,643.02"
,IN,AR,30313467,1005,100,,Invoice,,,,,,03/05/2018,03/05/2018,0.00,,6.02,,"-373,649.04"
,IN,AR,30313477,1005,100,,Invoice,,,,,,03/05/2018,03/05/2018,0.00,,15.25,,"-373,664.29"
,IN,AR,30313488,1005,100,,Invoice,,,,,,03/05/2018,03/05/2018,0.00,,83.90,,"-373,748.19"
,IN,AR,30313495,1005,100,,Invoice,,,,,,03/05/2018,03/05/2018,0.00,,29.15,,"-373,777.34"
,IN,AR,30313514,1005,100,,Invoice,,,,,,03/05/2018,03/05/2018,0.00,,9.66,,"-373,787.00"
,IN,AR,30313538,1005,100,,Invoice,,,,,,03/05/2018,03/05/2018,0.00,,12.71,,"-373,799.71"
,IN,AR,30313544,1005,100,,Invoice,,,,,,03/05/2018,03/05/2018,0.00,,2.75,,"-373,802.46"
,IN,AR,30313583,1005,100,,Invoice,,,,,,03/05/2018,03/05/2018,0.00,,2.39,,"-373,804.85"
,IN,AR,30313608,1005,100,,Invoice,,,,,,03/05/2018,03/05/2018,0.00,,43.02,,"-373,847.87"
,IN,AR,30313616,1005,100,,Invoice,,,,,,03/05/2018,03/05/2018,0.00,,10.93,,"-373,858.80"
,IN,AR,30313623,1005,100,,Invoice,,,,,,03/05/2018,03/05/2018,0.00,,6.48,,"-373,865.28"
,IN,AR,30313670,1005,100,,Invoice,,,,,,03/05/2018,03/05/2018,0.00,,10.93,,"-373,876.21"
,IN,AR,30313675,1005,100,,Invoice,,,,,,03/05/2018,03/05/2018,0.00,,5.17,,"-373,881.38"
,IN,AR,30313679,1005,100,,Invoice,,,,,,03/05/2018,03/05/2018,0.00,,53.39,,"-373,934.77"
,IN,AR,30313682,1005,100,,Invoice,,,,,,03/05/2018,03/05/2018,0.00,,35.59,,"-373,970.36"
,IN,AR,30313689,1005,100,,Invoice,,,,,,03/05/2018,03/05/2018,0.00,,12.50,,"-373,982.86"
,IN,AR,30313699,1005,100,,Invoice,,,,,,03/05/2018,03/05/2018,0.00,,2.39,,"-373,985.25"
,IN,AR,30313719,1005,100,,Invoice,,,,,,03/05/2018,03/05/2018,0.00,,8.47,,"-373,993.72"
,IN,AR,30313732,1005,100,,Invoice,,,,,,03/05/2018,03/05/2018,0.00,,10.59,,"-374,004.31"
,IN,AR,30313744,1005,100,,Invoice,,,,,,03/05/2018,03/05/2018,0.00,,8.24,,"-374,012.55"
,IN,AR,30313753,1005,100,,Invoice,,,,,,03/05/2018,03/05/2018,0.00,,4.24,,"-374,016.79"
,IN,AR,30313762,1005,100,,Invoice,,,,,,03/05/2018,03/05/2018,0.00,,4.58,,"-374,021.37"
,IN,AR,30313764,1005,100,,Invoice,,,,,,03/05/2018,03/05/2018,0.00,,7.00,,"-374,028.37"
,IN,AR,30313802,1005,100,,Invoice,,,,,,03/05/2018,03/05/2018,0.00,,7.63,,"-374,036.00"
,IN,AR,30313816,1005,100,,Invoice,,,,,,03/05/2018,03/05/2018,0.00,,4.64,,"-374,040.64"
,IN,AR,30313820,1005,100,,Invoice,,,,,,03/05/2018,03/05/2018,0.00,,8.77,,"-374,049.41"
,IN,AR,30313825,1005,100,,Invoice,,,,,,03/05/2018,03/05/2018,0.00,,16.53,,"-374,065.94"
,IN,AR,30313859,1005,100,,Invoice,,,,,,03/05/2018,03/05/2018,0.00,,24.07,,"-374,090.01"
,IN,AR,30313863,1005,100,,Invoice,,,,,,03/05/2018,03/05/2018,0.00,,16.48,,"-374,106.49"
,IN,AR,30313868,1005,100,,Invoice,,,,,,03/05/2018,03/05/2018,0.00,,103.81,,"-374,210.30"
,IN,AR,30313869,1005,100,,Invoice,,,,,,03/05/2018,03/05/2018,0.00,,15.53,,"-374,225.83"
,IN,AR,30313871,1005,100,,Invoice,,,,,,03/05/2018,03/05/2018,0.00,,5.08,,"-374,230.91"
,IN,AR,30313898,1005,100,,Invoice,,,,,,03/05/2018,03/05/2018,0.00,,3.53,,"-374,234.44"
,IN,AR,30313950,1005,100,,Invoice,,,,,,03/05/2018,03/05/2018,0.00,,7.29,,"-374,241.73"
,IN,AR,30313951,1005,100,,Invoice,,,,,,03/05/2018,03/05/2018,0.00,,32.80,,"-374,274.53"
,IN,AR,30313982,1005,100,,Invoice,,,,,,03/05/2018,03/05/2018,0.00,,10.93,,"-374,285.46"
,IN,AR,30313987,1005,100,,Invoice,,,,,,03/05/2018,03/05/2018,0.00,,7.29,,"-374,292.75"
,IN,AR,30313988,1005,100,,Invoice,,,,,,03/05/2018,03/05/2018,0.00,,29.15,,"-374,321.90"
,IN,AR,30313990,1005,100,,Invoice,,,,,,03/05/2018,03/05/2018,0.00,,1.63,,"-374,323.53"
,IN,AR,30313991,1005,100,,Invoice,,,,,,03/05/2018,03/05/2018,0.00,,11.39,,"-374,334.92"
,IN,AR,30313992,1005,100,,Invoice,,,,,,03/05/2018,03/05/2018,0.00,,9.76,,"-374,344.68"
,IN,AR,30314024,1005,100,,Invoice,,,,,,03/05/2018,03/05/2018,0.00,,23.57,,"-374,368.25"
,IN,AR,30314048,1005,100,,Invoice,,,,,,03/05/2018,03/05/2018,0.00,,54.66,,"-374,422.91"
,IN,AR,30314057,1005,100,,Invoice,,,,,,03/05/2018,03/05/2018,0.00,,38.90,,"-374,461.81"
,IN,AR,30314073,1005,100,,Invoice,,,,,,03/05/2018,03/05/2018,0.00,,9.62,,"-374,471.43"
,IN,AR,30314103,1005,100,,Invoice,,,,,,03/05/2018,03/05/2018,0.00,,9.84,,"-374,481.27"
,IN,AR,30314124,1005,100,,Invoice,,,,,,03/05/2018,03/05/2018,0.00,,7.29,,"-374,488.56"
,IN,AR,30314129,1005,100,,Invoice,,,,,,03/05/2018,03/05/2018,0.00,,2.54,,"-374,491.10"
,IN,AR,30314136,1005,100,,Invoice,,,,,,03/05/2018,03/05/2018,0.00,,21.86,,"-374,512.96"
,IN,AR,30314137,1005,100,,Invoice,,,,,,03/05/2018,03/05/2018,0.00,,24.01,,"-374,536.97"
,IN,AR,30314146,1005,100,,Invoice,,,,,,03/05/2018,03/05/2018,0.00,,28.01,,"-374,564.98"
,IN,AR,30314154,1005,100,,Invoice,,,,,,03/05/2018,03/05/2018,0.00,,8.75,,"-374,573.73"
,IN,AR,30314155,1005,100,,Invoice,,,,,,03/05/2018,03/05/2018,0.00,,8.75,,"-374,582.48"
,IN,AR,30314183,1005,100,,Invoice,,,,,,03/05/2018,03/05/2018,0.00,,29.15,,"-374,611.63"
,IN,AR,30314196,1005,100,,Invoice,,,,,,03/05/2018,03/05/2018,0.00,,11.22,,"-374,622.85"
,IN,AR,30314206,1005,100,,Invoice,,,,,,03/05/2018,03/05/2018,0.00,,25.17,,"-374,648.02"
,IN,AR,30314208,1005,100,,Invoice,,,,,,03/05/2018,03/05/2018,0.00,,5.68,,"-374,653.70"
,IN,AR,30314257,1005,100,,Invoice,,,,,,03/05/2018,03/05/2018,0.00,,42.83,,"-374,696.53"
,IN,AR,30314262,1005,100,,Invoice,,,,,,03/05/2018,03/05/2018,0.00,,6.37,,"-374,702.90"
,IN,AR,30314263,1005,100,,Invoice,,,,,,03/05/2018,03/05/2018,0.00,,7.97,,"-374,710.87"
,IN,AR,30314264,1005,100,,Invoice,,,,,,03/05/2018,03/05/2018,0.00,,9.56,,"-374,720.43"
,IN,AR,30314276,1005,100,,Invoice,,,,,,03/05/2018,03/05/2018,0.00,,89.49,,"-374,809.92"
,IN,AR,30314312,1005,100,,Invoice,,,,,,03/05/2018,03/05/2018,0.00,,132.89,,"-374,942.81"
,IN,AR,30314320,1005,100,,Invoice,,,,,,03/05/2018,03/05/2018,0.00,,18.31,,"-374,961.12"
,IN,AR,30314344,1005,100,,Invoice,,,,,,03/05/2018,03/05/2018,0.00,,3.51,,"-374,964.63"
,IN,AR,30314350,1005,100,,Invoice,,,,,,03/05/2018,03/05/2018,0.00,,10.00,,"-374,974.63"
,IN,AR,30314356,1005,100,,Invoice,,,,,,03/05/2018,03/05/2018,0.00,,29.15,,"-375,003.78"
,IN,AR,30314409,1005,100,,Invoice,,,,,,03/05/2018,03/05/2018,0.00,,15.17,,"-375,018.95"
,IN,AR,30314484,1005,100,,Invoice,,,,,,03/05/2018,03/05/2018,0.00,,6.23,,"-375,025.18"
,IN,AR,30314531,1005,100,,Invoice,,,,,,03/05/2018,03/05/2018,0.00,,3.64,,"-375,028.82"
,IN,AR,30314543,1005,100,,Invoice,,,,,,03/05/2018,03/05/2018,0.00,,3.64,,"-375,032.46"
,CS,AR,32004599,1005,100,,Cash sale,,,,,,03/05/2018,03/05/2018,0.00,,25.51,,"-375,057.97"
,CS,AR,32004615,1005,100,,Cash sale,,,,,,03/05/2018,03/05/2018,0.00,,21.86,,"-375,079.83"
,CS,AR,32004620,1005,100,,Cash sale,,,,,,03/05/2018,03/05/2018,0.00,,7.29,,"-375,087.12"
,IN,AR,30315699,1005,100,,Invoice,,,,,,03/05/2018,03/05/2018,0.00,,5.08,,"-375,092.20"
,IN,AR,30315797,1005,100,,Invoice,,,,,,03/05/2018,03/05/2018,0.00,,6.36,,"-375,098.56"
,IN,AR,30315876,1005,100,,Invoice,,,,,,03/05/2018,03/05/2018,0.00,,7.63,,"-375,106.19"
,IN,AR,30315910,1005,100,,Invoice,,,,,,03/05/2018,03/05/2018,0.00,,10.93,,"-375,117.12"
,IN,AR,30315926,1005,100,,Invoice,,,,,,03/05/2018,03/05/2018,0.00,,5.08,,"-375,122.20"
,IN,AR,30316099,1005,100,,Invoice,,,,,,03/05/2018,03/05/2018,0.00,,2.54,,"-375,124.74"
,CN,AR,31017969,1005,100,,Credit Note,,,,,,04/05/2018,04/05/2018,29.15,,0.00,,"-375,095.59"
,CN,AR,31017990,1005,100,,Credit Note,,,,,,04/05/2018,04/05/2018,3.64,,0.00,,"-375,091.95"
,CN,AR,31017991,1005,100,,Credit Note,,,,,,04/05/2018,04/05/2018,3.64,,0.00,,"-375,088.31"
,CS,AR,32003436,1005,100,,Cash sale,,,,,,04/05/2018,04/05/2018,0.00,,5.61,,"-375,093.92"
,CS,AR,32003441,1005,100,,Cash sale,,,,,,04/05/2018,04/05/2018,0.00,,19.58,,"-375,113.50"
,CS,AR,32003447,1005,100,,Cash sale,,,,,,04/05/2018,04/05/2018,0.00,,14.24,,"-375,127.74"
,CS,AR,32003455,1005,100,,Cash sale,,,,,,04/05/2018,04/05/2018,0.00,,18.25,,"-375,145.99"
,CS,AR,32003459,1005,100,,Cash sale,,,,,,04/05/2018,04/05/2018,0.00,,7.29,,"-375,153.28"
,CS,AR,32003472,1005,100,,Cash sale,,,,,,04/05/2018,04/05/2018,0.00,,7.29,,"-375,160.57"
,CS,AR,32003482,1005,100,,Cash sale,,,,,,04/05/2018,04/05/2018,0.00,,10.93,,"-375,171.50"
,CS,AR,32003483,1005,100,,Cash sale,,,,,,04/05/2018,04/05/2018,0.00,,7.29,,"-375,178.79"
,CS,AR,32003484,1005,100,,Cash sale,,,,,,04/05/2018,04/05/2018,0.00,,9.66,,"-375,188.45"
,CS,AR,32003491,1005,100,,Cash sale,,,,,,04/05/2018,04/05/2018,0.00,,21.36,,"-375,209.81"
,CS,AR,32003497,1005,100,,Cash sale,,,,,,04/05/2018,04/05/2018,0.00,,18.69,,"-375,228.50"
,CS,AR,32003504,1005,100,,Cash sale,,,,,,04/05/2018,04/05/2018,0.00,,3.64,,"-375,232.14"
,CS,AR,32003526,1005,100,,Cash sale,,,,,,04/05/2018,04/05/2018,0.00,,8.39,,"-375,240.53"
,CS,AR,32003531,1005,100,,Cash sale,,,,,,04/05/2018,04/05/2018,0.00,,9.03,,"-375,249.56"
,CS,AR,32003533,1005,100,,Cash sale,,,,,,04/05/2018,04/05/2018,0.00,,6.02,,"-375,255.58"
,CS,AR,32003550,1005,100,,Cash sale,,,,,,04/05/2018,04/05/2018,0.00,,7.29,,"-375,262.87"
,CS,AR,32003567,1005,100,,Cash sale,,,,,,04/05/2018,04/05/2018,0.00,,18.22,,"-375,281.09"
,CS,AR,32003574,1005,100,,Cash sale,,,,,,04/05/2018,04/05/2018,0.00,,5.08,,"-375,286.17"
,CS,AR,32003592,1005,100,,Cash sale,,,,,,04/05/2018,04/05/2018,0.00,,19.24,,"-375,305.41"
,CS,AR,32003601,1005,100,,Cash sale,,,,,,04/05/2018,04/05/2018,0.00,,10.99,,"-375,316.40"
,CS,AR,32003612,1005,100,,Cash sale,,,,,,04/05/2018,04/05/2018,0.00,,14.58,,"-375,330.98"
,CS,AR,32003615,1005,100,,Cash sale,,,,,,04/05/2018,04/05/2018,0.00,,14.58,,"-375,345.56"
,CS,AR,32003630,1005,100,,Cash sale,,,,,,04/05/2018,04/05/2018,0.00,,5.08,,"-375,350.64"
,CS,AR,32003636,1005,100,,Cash sale,,,,,,04/05/2018,04/05/2018,0.00,,17.54,,"-375,368.18"
,CS,AR,32003649,1005,100,,Cash sale,,,,,,04/05/2018,04/05/2018,0.00,,18.09,,"-375,386.27"
,CS,AR,32003653,1005,100,,Cash sale,,,,,,04/05/2018,04/05/2018,0.00,,39.11,,"-375,425.38"
,CS,AR,32003661,1005,100,,Cash sale,,,,,,04/05/2018,04/05/2018,0.00,,12.71,,"-375,438.09"
,CS,AR,32003669,1005,100,,Cash sale,,,,,,04/05/2018,04/05/2018,0.00,,7.75,,"-375,445.84"
,CS,AR,32003675,1005,100,,Cash sale,,,,,,04/05/2018,04/05/2018,0.00,,25.51,,"-375,471.35"
,CS,AR,32003684,1005,100,,Cash sale,,,,,,04/05/2018,04/05/2018,0.00,,3.64,,"-375,474.99"
,CS,AR,32003696,1005,100,,Cash sale,,,,,,04/05/2018,04/05/2018,0.00,,3.64,,"-375,478.63"
,CS,AR,32003703,1005,100,,Cash sale,,,,,,04/05/2018,04/05/2018,0.00,,20.68,,"-375,499.31"
,CS,AR,32003730,1005,100,,Cash sale,,,,,,04/05/2018,04/05/2018,0.00,,6.02,,"-375,505.33"
,CS,AR,32003734,1005,100,,Cash sale,,,,,,04/05/2018,04/05/2018,0.00,,6.44,,"-375,511.77"
,CS,AR,32003736,1005,100,,Cash sale,,,,,,04/05/2018,04/05/2018,0.00,,7.29,,"-375,519.06"
,CS,AR,32003740,1005,100,,Cash sale,,,,,,04/05/2018,04/05/2018,0.00,,10.93,,"-375,529.99"
,CS,AR,32003772,1005,100,,Cash sale,,,,,,04/05/2018,04/05/2018,0.00,,7.29,,"-375,537.28"
,CS,AR,32003780,1005,100,,Cash sale,,,,,,04/05/2018,04/05/2018,0.00,,26.10,,"-375,563.38"
,CS,AR,32003786,1005,100,,Cash sale,,,,,,04/05/2018,04/05/2018,0.00,,3.64,,"-375,567.02"
,CS,AR,32003792,1005,100,,Cash sale,,,,,,04/05/2018,04/05/2018,0.00,,17.80,,"-375,584.82"
,CS,AR,32003796,1005,100,,Cash sale,,,,,,04/05/2018,04/05/2018,0.00,,7.29,,"-375,592.11"
,CS,AR,32003820,1005,100,,Cash sale,,,,,,04/05/2018,04/05/2018,0.00,,44.00,,"-375,636.11"
,CS,AR,32003826,1005,100,,Cash sale,,,,,,04/05/2018,04/05/2018,0.00,,10.17,,"-375,646.28"
,CS,AR,32003828,1005,100,,Cash sale,,,,,,04/05/2018,04/05/2018,0.00,,13.77,,"-375,660.05"
,CS,AR,32003829,1005,100,,Cash sale,,,,,,04/05/2018,04/05/2018,0.00,,7.29,,"-375,667.34"
,CS,AR,32003845,1005,100,,Cash sale,,,,,,04/05/2018,04/05/2018,0.00,,6.86,,"-375,674.20"
,CS,AR,32003861,1005,100,,Cash sale,,,,,,04/05/2018,04/05/2018,0.00,,5.08,,"-375,679.28"
,CS,AR,32003884,1005,100,,Cash sale,,,,,,04/05/2018,04/05/2018,0.00,,3.64,,"-375,682.92"
,CS,AR,32003890,1005,100,,Cash sale,,,,,,04/05/2018,04/05/2018,0.00,,14.58,,"-375,697.50"
,CS,AR,32003896,1005,100,,Cash sale,,,,,,04/05/2018,04/05/2018,0.00,,3.64,,"-375,701.14"
,CS,AR,32003899,1005,100,,Cash sale,,,,,,04/05/2018,04/05/2018,0.00,,9.15,,"-375,710.29"
,CS,AR,32003902,1005,100,,Cash sale,,,,,,04/05/2018,04/05/2018,0.00,,10.38,,"-375,720.67"
,CS,AR,32003909,1005,100,,Cash sale,,,,,,04/05/2018,04/05/2018,0.00,,25.51,,"-375,746.18"
,CS,AR,32003912,1005,100,,Cash sale,,,,,,04/05/2018,04/05/2018,0.00,,9.10,,"-375,755.28"
,CS,AR,32003916,1005,100,,Cash sale,,,,,,04/05/2018,04/05/2018,0.00,,10.93,,"-375,766.21"
,CS,AR,32003919,1005,100,,Cash sale,,,,,,04/05/2018,04/05/2018,0.00,,14.58,,"-375,780.79"
,CS,AR,32003921,1005,100,,Cash sale,,,,,,04/05/2018,04/05/2018,0.00,,10.93,,"-375,791.72"
,CS,AR,32003960,1005,100,,Cash sale,,,,,,04/05/2018,04/05/2018,0.00,,10.93,,"-375,802.65"
,CS,AR,32003961,1005,100,,Cash sale,,,,,,04/05/2018,04/05/2018,0.00,,10.93,,"-375,813.58"
,CS,AR,32003994,1005,100,,Cash sale,,,,,,04/05/2018,04/05/2018,0.00,,6.99,,"-375,820.57"
,CS,AR,32003998,1005,100,,Cash sale,,,,,,04/05/2018,04/05/2018,0.00,,3.64,,"-375,824.21"
,CS,AR,32004002,1005,100,,Cash sale,,,,,,04/05/2018,04/05/2018,0.00,,7.29,,"-375,831.50"
,IN,AR,30313125,1005,100,,Invoice,,,,,,04/05/2018,04/05/2018,0.00,,35.59,,"-375,867.09"
,IN,AR,30313133,1005,100,,Invoice,,,,,,04/05/2018,04/05/2018,0.00,,10.93,,"-375,878.02"
,IN,AR,30313154,1005,100,,Invoice,,,,,,04/05/2018,04/05/2018,0.00,,25.51,,"-375,903.53"
,IN,AR,30313168,1005,100,,Invoice,,,,,,04/05/2018,04/05/2018,0.00,,21.74,,"-375,925.27"
,IN,AR,30313171,1005,100,,Invoice,,,,,,04/05/2018,04/05/2018,0.00,,10.93,,"-375,936.20"
,IN,AR,30313193,1005,100,,Invoice,,,,,,04/05/2018,04/05/2018,0.00,,16.08,,"-375,952.28"
,IN,AR,30313197,1005,100,,Invoice,,,,,,04/05/2018,04/05/2018,0.00,,65.98,,"-376,018.26"
,IN,AR,30313210,1005,100,,Invoice,,,,,,04/05/2018,04/05/2018,0.00,,35.59,,"-376,053.85"
,IN,AR,30313221,1005,100,,Invoice,,,,,,04/05/2018,04/05/2018,0.00,,3.64,,"-376,057.49"
,IN,AR,30313230,1005,100,,Invoice,,,,,,04/05/2018,04/05/2018,0.00,,22.00,,"-376,079.49"
,IN,AR,30313252,1005,100,,Invoice,,,,,,04/05/2018,04/05/2018,0.00,,12.00,,"-376,091.49"
,IN,AR,30313271,1005,100,,Invoice,,,,,,04/05/2018,04/05/2018,0.00,,7.29,,"-376,098.78"
,IN,AR,30313276,1005,100,,Invoice,,,,,,04/05/2018,04/05/2018,0.00,,3.89,,"-376,102.67"
,IN,AR,30313285,1005,100,,Invoice,,,,,,04/05/2018,04/05/2018,0.00,,4.75,,"-376,107.42"
,IN,AR,30313293,1005,100,,Invoice,,,,,,04/05/2018,04/05/2018,0.00,,2.00,,"-376,109.42"
,IN,AR,30313331,1005,100,,Invoice,,,,,,04/05/2018,04/05/2018,0.00,,11.64,,"-376,121.06"
,IN,AR,30313336,1005,100,,Invoice,,,,,,04/05/2018,04/05/2018,0.00,,7.29,,"-376,128.35"
,IN,AR,30313340,1005,100,,Invoice,,,,,,04/05/2018,04/05/2018,0.00,,10.00,,"-376,138.35"
,IN,AR,30313354,1005,100,,Invoice,,,,,,04/05/2018,04/05/2018,0.00,,11.19,,"-376,149.54"
,IN,AR,30313362,1005,100,,Invoice,,,,,,04/05/2018,04/05/2018,0.00,,23.29,,"-376,172.83"
,IN,AR,30313376,1005,100,,Invoice,,,,,,04/05/2018,04/05/2018,0.00,,9.56,,"-376,182.39"
,IN,AR,30313388,1005,100,,Invoice,,,,,,04/05/2018,04/05/2018,0.00,,5.17,,"-376,187.56"
,IN,AR,30313429,1005,100,,Invoice,,,,,,04/05/2018,04/05/2018,0.00,,61.02,,"-376,248.58"
,IN,AR,30313441,1005,100,,Invoice,,,,,,04/05/2018,04/05/2018,0.00,,15.51,,"-376,264.09"
,IN,AR,30313445,1005,100,,Invoice,,,,,,04/05/2018,04/05/2018,0.00,,2.39,,"-376,266.48"
,IN,AR,30313447,1005,100,,Invoice,,,,,,04/05/2018,04/05/2018,0.00,,5.17,,"-376,271.65"
,IN,AR,30313458,1005,100,,Invoice,,,,,,04/05/2018,04/05/2018,0.00,,5.59,,"-376,277.24"
,IN,AR,30313459,1005,100,,Invoice,,,,,,04/05/2018,04/05/2018,0.00,,10.34,,"-376,287.58"
,IN,AR,30313481,1005,100,,Invoice,,,,,,04/05/2018,04/05/2018,0.00,,47.17,,"-376,334.75"
,IN,AR,30313485,1005,100,,Invoice,,,,,,04/05/2018,04/05/2018,0.00,,5.61,,"-376,340.36"
,IN,AR,30313501,1005,100,,Invoice,,,,,,04/05/2018,04/05/2018,0.00,,19.12,,"-376,359.48"
,IN,AR,30313502,1005,100,,Invoice,,,,,,04/05/2018,04/05/2018,0.00,,16.73,,"-376,376.21"
,IN,AR,30313517,1005,100,,Invoice,,,,,,04/05/2018,04/05/2018,0.00,,7.29,,"-376,383.50"
,IN,AR,30313593,1005,100,,Invoice,,,,,,04/05/2018,04/05/2018,0.00,,2.54,,"-376,386.04"
,IN,AR,30313594,1005,100,,Invoice,,,,,,04/05/2018,04/05/2018,0.00,,7.63,,"-376,393.67"
,IN,AR,30313609,1005,100,,Invoice,,,,,,04/05/2018,04/05/2018,0.00,,44.61,,"-376,438.28"
,IN,AR,30313614,1005,100,,Invoice,,,,,,04/05/2018,04/05/2018,0.00,,29.42,,"-376,467.70"
,IN,AR,30313663,1005,100,,Invoice,,,,,,04/05/2018,04/05/2018,0.00,,17.80,,"-376,485.50"
,IN,AR,30313676,1005,100,,Invoice,,,,,,04/05/2018,04/05/2018,0.00,,11.36,,"-376,496.86"
,IN,AR,30313703,1005,100,,Invoice,,,,,,04/05/2018,04/05/2018,0.00,,5.08,,"-376,501.94"
,IN,AR,30313711,1005,100,,Invoice,,,,,,04/05/2018,04/05/2018,0.00,,7.29,,"-376,509.23"
,IN,AR,30313749,1005,100,,Invoice,,,,,,04/05/2018,04/05/2018,0.00,,42.08,,"-376,551.31"
,IN,AR,30313773,1005,100,,Invoice,,,,,,04/05/2018,04/05/2018,0.00,,8.39,,"-376,559.70"
,IN,AR,30313834,1005,100,,Invoice,,,,,,04/05/2018,04/05/2018,0.00,,10.34,,"-376,570.04"
,IN,AR,30313878,1005,100,,Invoice,,,,,,04/05/2018,04/05/2018,0.00,,12.00,,"-376,582.04"
,IN,AR,30313887,1005,100,,Invoice,,,,,,04/05/2018,04/05/2018,0.00,,10.68,,"-376,592.72"
,IN,AR,30313904,1005,100,,Invoice,,,,,,04/05/2018,04/05/2018,0.00,,12.03,,"-376,604.75"
,IN,AR,30313908,1005,100,,Invoice,,,,,,04/05/2018,04/05/2018,0.00,,10.93,,"-376,615.68"
,IN,AR,30313912,1005,100,,Invoice,,,,,,04/05/2018,04/05/2018,0.00,,2.42,,"-376,618.10"
,IN,AR,30313916,1005,100,,Invoice,,,,,,04/05/2018,04/05/2018,0.00,,15.90,,"-376,634.00"
,IN,AR,30313934,1005,100,,Invoice,,,,,,04/05/2018,04/05/2018,0.00,,7.75,,"-376,641.75"
,IN,AR,30313939,1005,100,,Invoice,,,,,,04/05/2018,04/05/2018,0.00,,7.29,,"-376,649.04"
,IN,AR,30313966,1005,100,,Invoice,,,,,,04/05/2018,04/05/2018,0.00,,8.52,,"-376,657.56"
,IN,AR,30313967,1005,100,,Invoice,,,,,,04/05/2018,04/05/2018,0.00,,21.86,,"-376,679.42"
,IN,AR,30313993,1005,100,,Invoice,,,,,,04/05/2018,04/05/2018,0.00,,27.66,,"-376,707.08"
,IN,AR,30314000,1005,100,,Invoice,,,,,,04/05/2018,04/05/2018,0.00,,14.31,,"-376,721.39"
,IN,AR,30314016,1005,100,,Invoice,,,,,,04/05/2018,04/05/2018,0.00,,34.07,,"-376,755.46"
,IN,AR,30314029,1005,100,,Invoice,,,,,,04/05/2018,04/05/2018,0.00,,14.58,,"-376,770.04"
,IN,AR,30314036,1005,100,,Invoice,,,,,,04/05/2018,04/05/2018,0.00,,60.13,,"-376,830.17"
,IN,AR,30314051,1005,100,,Invoice,,,,,,04/05/2018,04/05/2018,0.00,,9.11,,"-376,839.28"
,IN,AR,30314074,1005,100,,Invoice,,,,,,04/05/2018,04/05/2018,0.00,,44.90,,"-376,884.18"
,IN,AR,30314075,1005,100,,Invoice,,,,,,04/05/2018,04/05/2018,0.00,,1.60,,"-376,885.78"
,IN,AR,30314076,1005,100,,Invoice,,,,,,04/05/2018,04/05/2018,0.00,,14.43,,"-376,900.21"
,IN,AR,30314077,1005,100,,Invoice,,,,,,04/05/2018,04/05/2018,0.00,,8.02,,"-376,908.23"
,IN,AR,30314117,1005,100,,Invoice,,,,,,04/05/2018,04/05/2018,0.00,,19.13,,"-376,927.36"
,IN,AR,30314130,1005,100,,Invoice,,,,,,04/05/2018,04/05/2018,0.00,,30.51,,"-376,957.87"
,IN,AR,30314143,1005,100,,Invoice,,,,,,04/05/2018,04/05/2018,0.00,,10.00,,"-376,967.87"
,IN,AR,30314169,1005,100,,Invoice,,,,,,04/05/2018,04/05/2018,0.00,,30.11,,"-376,997.98"
,IN,AR,30314173,1005,100,,Invoice,,,,,,04/05/2018,04/05/2018,0.00,,8.41,,"-377,006.39"
,IN,AR,30314201,1005,100,,Invoice,,,,,,04/05/2018,04/05/2018,0.00,,4.59,,"-377,010.98"
,IN,AR,30314241,1005,100,,Invoice,,,,,,04/05/2018,04/05/2018,0.00,,18.22,,"-377,029.20"
,IN,AR,30314242,1005,100,,Invoice,,,,,,04/05/2018,04/05/2018,0.00,,182.20,,"-377,211.40"
,IN,AR,30314246,1005,100,,Invoice,,,,,,04/05/2018,04/05/2018,0.00,,14.58,,"-377,225.98"
,IN,AR,30314249,1005,100,,Invoice,,,,,,04/05/2018,04/05/2018,0.00,,11.36,,"-377,237.34"
,IN,AR,30314251,1005,100,,Invoice,,,,,,04/05/2018,04/05/2018,0.00,,12.08,,"-377,249.42"
,IN,AR,30314265,1005,100,,Invoice,,,,,,04/05/2018,04/05/2018,0.00,,117.90,,"-377,367.32"
,IN,AR,30314266,1005,100,,Invoice,,,,,,04/05/2018,04/05/2018,0.00,,17.53,,"-377,384.85"
,IN,AR,30314308,1005,100,,Invoice,,,,,,04/05/2018,04/05/2018,0.00,,24.58,,"-377,409.43"
,IN,AR,30314330,1005,100,,Invoice,,,,,,04/05/2018,04/05/2018,0.00,,14.00,,"-377,423.43"
,IN,AR,30314363,1005,100,,Invoice,,,,,,04/05/2018,04/05/2018,0.00,,29.15,,"-377,452.58"
,IN,AR,30314367,1005,100,,Invoice,,,,,,04/05/2018,04/05/2018,0.00,,29.15,,"-377,481.73"
,IN,AR,30314373,1005,100,,Invoice,,,,,,04/05/2018,04/05/2018,0.00,,3.64,,"-377,485.37"
,IN,AR,30314382,1005,100,,Invoice,,,,,,04/05/2018,04/05/2018,0.00,,10.95,,"-377,496.32"
,IN,AR,30314387,1005,100,,Invoice,,,,,,04/05/2018,04/05/2018,0.00,,33.90,,"-377,530.22"
,IN,AR,30314401,1005,100,,Invoice,,,,,,04/05/2018,04/05/2018,0.00,,7.29,,"-377,537.51"
,IN,AR,30314422,1005,100,,Invoice,,,,,,04/05/2018,04/05/2018,0.00,,32.80,,"-377,570.31"
,IN,AR,30314439,1005,100,,Invoice,,,,,,04/05/2018,04/05/2018,0.00,,21.86,,"-377,592.17"
,IN,AR,30314441,1005,100,,Invoice,,,,,,04/05/2018,04/05/2018,0.00,,15.53,,"-377,607.70"
,IN,AR,30314446,1005,100,,Invoice,,,,,,04/05/2018,04/05/2018,0.00,,15.93,,"-377,623.63"
,IN,AR,30314470,1005,100,,Invoice,,,,,,04/05/2018,04/05/2018,0.00,,4.00,,"-377,627.63"
,IN,AR,30314471,1005,100,,Invoice,,,,,,04/05/2018,04/05/2018,0.00,,4.00,,"-377,631.63"
,IN,AR,30314485,1005,100,,Invoice,,,,,,04/05/2018,04/05/2018,0.00,,10.38,,"-377,642.01"
,IN,AR,30314510,1005,100,,Invoice,,,,,,04/05/2018,04/05/2018,0.00,,29.15,,"-377,671.16"
,IN,AR,30314524,1005,100,,Invoice,,,,,,04/05/2018,04/05/2018,0.00,,30.34,,"-377,701.50"
,IN,AR,30314544,1005,100,,Invoice,,,,,,04/05/2018,04/05/2018,0.00,,3.64,,"-377,705.14"
,IN,AR,30314564,1005,100,,Invoice,,,,,,04/05/2018,04/05/2018,0.00,,364.41,,"-378,069.55"
,CS,AR,32003430,1005,100,,Cash sale,,,,,,05/05/2018,05/05/2018,0.00,,90.67,,"-378,160.22"
,CS,AR,32003467,1005,100,,Cash sale,,,,,,05/05/2018,05/05/2018,0.00,,10.93,,"-378,171.15"
,CS,AR,32003519,1005,100,,Cash sale,,,,,,05/05/2018,05/05/2018,0.00,,3.64,,"-378,174.79"
,CS,AR,32003623,1005,100,,Cash sale,,,,,,05/05/2018,05/05/2018,0.00,,10.93,,"-378,185.72"
,CS,AR,32003670,1005,100,,Cash sale,,,,,,05/05/2018,05/05/2018,0.00,,7.75,,"-378,193.47"
,CS,AR,32003671,1005,100,,Cash sale,,,,,,05/05/2018,05/05/2018,0.00,,7.29,,"-378,200.76"
,CS,AR,32003678,1005,100,,Cash sale,,,,,,05/05/2018,05/05/2018,0.00,,14.58,,"-378,215.34"
,CS,AR,32003741,1005,100,,Cash sale,,,,,,05/05/2018,05/05/2018,0.00,,3.64,,"-378,218.98"
,CS,AR,32003777,1005,100,,Cash sale,,,,,,05/05/2018,05/05/2018,0.00,,7.29,,"-378,226.27"
,CS,AR,32003863,1005,100,,Cash sale,,,,,,05/05/2018,05/05/2018,0.00,,10.93,,"-378,237.20"
,CS,AR,32003864,1005,100,,Cash sale,,,,,,05/05/2018,05/05/2018,0.00,,4.24,,"-378,241.44"
,CS,AR,32003915,1005,100,,Cash sale,,,,,,05/05/2018,05/05/2018,0.00,,3.64,,"-378,245.08"
,CS,AR,32003923,1005,100,,Cash sale,,,,,,05/05/2018,05/05/2018,0.00,,14.58,,"-378,259.66"
,CS,AR,32003932,1005,100,,Cash sale,,,,,,05/05/2018,05/05/2018,0.00,,7.29,,"-378,266.95"
,CS,AR,32003955,1005,100,,Cash sale,,,,,,05/05/2018,05/05/2018,0.00,,3.64,,"-378,270.59"
,IN,AR,30313244,1005,100,,Invoice,,,,,,05/05/2018,05/05/2018,0.00,,9.03,,"-378,279.62"
,IN,AR,30313273,1005,100,,Invoice,,,,,,05/05/2018,05/05/2018,0.00,,29.15,,"-378,308.77"
,IN,AR,30313327,1005,100,,Invoice,,,,,,05/05/2018,05/05/2018,0.00,,780.96,,"-379,089.73"
,IN,AR,30313534,1005,100,,Invoice,,,,,,05/05/2018,05/05/2018,0.00,,6.02,,"-379,095.75"
,IN,AR,30313547,1005,100,,Invoice,,,,,,05/05/2018,05/05/2018,0.00,,7.29,,"-379,103.04"
,IN,AR,30313595,1005,100,,Invoice,,,,,,05/05/2018,05/05/2018,0.00,,15.25,,"-379,118.29"
,IN,AR,30313841,1005,100,,Invoice,,,,,,05/05/2018,05/05/2018,0.00,,12.97,,"-379,131.26"
,IN,AR,30313933,1005,100,,Invoice,,,,,,05/05/2018,05/05/2018,0.00,,14.58,,"-379,145.84"
,IN,AR,30314031,1005,100,,Invoice,,,,,,05/05/2018,05/05/2018,0.00,,56.12,,"-379,201.96"
,IN,AR,30314225,1005,100,,Invoice,,,,,,05/05/2018,05/05/2018,0.00,,14.58,,"-379,216.54"
,IN,AR,30314509,1005,100,,Invoice,,,,,,05/05/2018,05/05/2018,0.00,,3.64,,"-379,220.18"
,CS,AR,32003727,1005,100,,Cash sale,,,,,,06/05/2018,06/05/2018,0.00,,29.15,,"-379,249.33"
,CN,AR,31017914,1005,100,,Credit Note,,,,,,07/05/2018,07/05/2018,18.22,,0.00,,"-379,231.11"
,CN,AR,31017924,1005,100,,Credit Note,,,,,,07/05/2018,07/05/2018,8.24,,0.00,,"-379,222.87"
,CN,AR,31017926,1005,100,,Credit Note,,,,,,07/05/2018,07/05/2018,2.58,,0.00,,"-379,220.29"
,CN,AR,31017927,1005,100,,Credit Note,,,,,,07/05/2018,07/05/2018,10.93,,0.00,,"-379,209.36"
,CN,AR,31017931,1005,100,,Credit Note,,,,,,07/05/2018,07/05/2018,10.93,,0.00,,"-379,198.43"
,CN,AR,31017934,1005,100,,Credit Note,,,,,,07/05/2018,07/05/2018,7.29,,0.00,,"-379,191.14"
,CN,AR,31017943,1005,100,,Credit Note,,,,,,07/05/2018,07/05/2018,18.22,,0.00,,"-379,172.92"
,CN,AR,31017954,1005,100,,Credit Note,,,,,,07/05/2018,07/05/2018,10.93,,0.00,,"-379,161.99"
,CN,AR,31017970,1005,100,,Credit Note,,,,,,07/05/2018,07/05/2018,14.58,,0.00,,"-379,147.41"
,CN,AR,31017985,1005,100,,Credit Note,,,,,,07/05/2018,07/05/2018,3.64,,0.00,,"-379,143.77"
,CN,AR,31017988,1005,100,,Credit Note,,,,,,07/05/2018,07/05/2018,14.58,,0.00,,"-379,129.19"
,CS,AR,32003448,1005,100,,Cash sale,,,,,,07/05/2018,07/05/2018,0.00,,9.49,,"-379,138.68"
,CS,AR,32003463,1005,100,,Cash sale,,,,,,07/05/2018,07/05/2018,0.00,,25.51,,"-379,164.19"
,CS,AR,32003498,1005,100,,Cash sale,,,,,,07/05/2018,07/05/2018,0.00,,12.46,,"-379,176.65"
,CS,AR,32003530,1005,100,,Cash sale,,,,,,07/05/2018,07/05/2018,0.00,,10.93,,"-379,187.58"
,CS,AR,32003544,1005,100,,Cash sale,,,,,,07/05/2018,07/05/2018,0.00,,10.34,,"-379,197.92"
,CS,AR,32003564,1005,100,,Cash sale,,,,,,07/05/2018,07/05/2018,0.00,,7.29,,"-379,205.21"
,CS,AR,32003575,1005,100,,Cash sale,,,,,,07/05/2018,07/05/2018,0.00,,10.17,,"-379,215.38"
,CS,AR,32003583,1005,100,,Cash sale,,,,,,07/05/2018,07/05/2018,0.00,,7.29,,"-379,222.67"
,CS,AR,32003602,1005,100,,Cash sale,,,,,,07/05/2018,07/05/2018,0.00,,10.99,,"-379,233.66"
,CS,AR,32003611,1005,100,,Cash sale,,,,,,07/05/2018,07/05/2018,0.00,,14.58,,"-379,248.24"
,CS,AR,32003613,1005,100,,Cash sale,,,,,,07/05/2018,07/05/2018,0.00,,7.29,,"-379,255.53"
,CS,AR,32003619,1005,100,,Cash sale,,,,,,07/05/2018,07/05/2018,0.00,,7.29,,"-379,262.82"
,CS,AR,32003637,1005,100,,Cash sale,,,,,,07/05/2018,07/05/2018,0.00,,17.54,,"-379,280.36"
,CS,AR,32003654,1005,100,,Cash sale,,,,,,07/05/2018,07/05/2018,0.00,,24.07,,"-379,304.43"
,CS,AR,32003701,1005,100,,Cash sale,,,,,,07/05/2018,07/05/2018,0.00,,2.54,,"-379,306.97"
,CS,AR,32003710,1005,100,,Cash sale,,,,,,07/05/2018,07/05/2018,0.00,,18.22,,"-379,325.19"
,CS,AR,32003715,1005,100,,Cash sale,,,,,,07/05/2018,07/05/2018,0.00,,29.15,,"-379,354.34"
,CS,AR,32003725,1005,100,,Cash sale,,,,,,07/05/2018,07/05/2018,0.00,,7.29,,"-379,361.63"
,CS,AR,32003728,1005,100,,Cash sale,,,,,,07/05/2018,07/05/2018,0.00,,7.29,,"-379,368.92"
,CS,AR,32003735,1005,100,,Cash sale,,,,,,07/05/2018,07/05/2018,0.00,,10.85,,"-379,379.77"
,CS,AR,32003746,1005,100,,Cash sale,,,,,,07/05/2018,07/05/2018,0.00,,13.88,,"-379,393.65"
,CS,AR,32003750,1005,100,,Cash sale,,,,,,07/05/2018,07/05/2018,0.00,,5.17,,"-379,398.82"
,CS,AR,32003753,1005,100,,Cash sale,,,,,,07/05/2018,07/05/2018,0.00,,5.17,,"-379,403.99"
,CS,AR,32003764,1005,100,,Cash sale,,,,,,07/05/2018,07/05/2018,0.00,,10.93,,"-379,414.92"
,CS,AR,32003799,1005,100,,Cash sale,,,,,,07/05/2018,07/05/2018,0.00,,7.29,,"-379,422.21"
,CS,AR,32003800,1005,100,,Cash sale,,,,,,07/05/2018,07/05/2018,0.00,,14.58,,"-379,436.79"
,CS,AR,32003805,1005,100,,Cash sale,,,,,,07/05/2018,07/05/2018,0.00,,5.17,,"-379,441.96"
,CS,AR,32003839,1005,100,,Cash sale,,,,,,07/05/2018,07/05/2018,0.00,,6.56,,"-379,448.52"
,CS,AR,32003846,1005,100,,Cash sale,,,,,,07/05/2018,07/05/2018,0.00,,11.44,,"-379,459.96"
,CS,AR,32003852,1005,100,,Cash sale,,,,,,07/05/2018,07/05/2018,0.00,,10.93,,"-379,470.89"
,CS,AR,32003865,1005,100,,Cash sale,,,,,,07/05/2018,07/05/2018,0.00,,9.10,,"-379,479.99"
,CS,AR,32003877,1005,100,,Cash sale,,,,,,07/05/2018,07/05/2018,0.00,,18.21,,"-379,498.20"
,CS,AR,32003880,1005,100,,Cash sale,,,,,,07/05/2018,07/05/2018,0.00,,7.29,,"-379,505.49"
,CS,AR,32003891,1005,100,,Cash sale,,,,,,07/05/2018,07/05/2018,0.00,,10.93,,"-379,516.42"
,CS,AR,32003901,1005,100,,Cash sale,,,,,,07/05/2018,07/05/2018,0.00,,10.93,,"-379,527.35"
,CS,AR,32003935,1005,100,,Cash sale,,,,,,07/05/2018,07/05/2018,0.00,,18.22,,"-379,545.57"
,CS,AR,32003956,1005,100,,Cash sale,,,,,,07/05/2018,07/05/2018,0.00,,3.64,,"-379,549.21"
,CS,AR,32003957,1005,100,,Cash sale,,,,,,07/05/2018,07/05/2018,0.00,,7.29,,"-379,556.50"
,CS,AR,32003995,1005,100,,Cash sale,,,,,,07/05/2018,07/05/2018,0.00,,9.32,,"-379,565.82"
,IN,AR,30313126,1005,100,,Invoice,,,,,,07/05/2018,07/05/2018,0.00,,41.53,,"-379,607.35"
,IN,AR,30313140,1005,100,,Invoice,,,,,,07/05/2018,07/05/2018,0.00,,14.58,,"-379,621.93"
,IN,AR,30313153,1005,100,,Invoice,,,,,,07/05/2018,07/05/2018,0.00,,8.14,,"-379,630.07"
,IN,AR,30313182,1005,100,,Invoice,,,,,,07/05/2018,07/05/2018,0.00,,67.64,,"-379,697.71"
,IN,AR,30313199,1005,100,,Invoice,,,,,,07/05/2018,07/05/2018,0.00,,3.64,,"-379,701.35"
,IN,AR,30313211,1005,100,,Invoice,,,,,,07/05/2018,07/05/2018,0.00,,177.97,,"-379,879.32"
,IN,AR,30313219,1005,100,,Invoice,,,,,,07/05/2018,07/05/2018,0.00,,16.53,,"-379,895.85"
,IN,AR,30313231,1005,100,,Invoice,,,,,,07/05/2018,07/05/2018,0.00,,46.00,,"-379,941.85"
,IN,AR,30313239,1005,100,,Invoice,,,,,,07/05/2018,07/05/2018,0.00,,38.18,,"-379,980.03"
,IN,AR,30313253,1005,100,,Invoice,,,,,,07/05/2018,07/05/2018,0.00,,16.00,,"-379,996.03"
,IN,AR,30313254,1005,100,,Invoice,,,,,,07/05/2018,07/05/2018,0.00,,28.00,,"-380,024.03"
,IN,AR,30313266,1005,100,,Invoice,,,,,,07/05/2018,07/05/2018,0.00,,30.51,,"-380,054.54"
,IN,AR,30313294,1005,100,,Invoice,,,,,,07/05/2018,07/05/2018,0.00,,20.00,,"-380,074.54"
,IN,AR,30313299,1005,100,,Invoice,,,,,,07/05/2018,07/05/2018,0.00,,3.64,,"-380,078.18"
,IN,AR,30313302,1005,100,,Invoice,,,,,,07/05/2018,07/05/2018,0.00,,7.29,,"-380,085.47"
,IN,AR,30313332,1005,100,,Invoice,,,,,,07/05/2018,07/05/2018,0.00,,5.82,,"-380,091.29"
,IN,AR,30313341,1005,100,,Invoice,,,,,,07/05/2018,07/05/2018,0.00,,30.00,,"-380,121.29"
,IN,AR,30313358,1005,100,,Invoice,,,,,,07/05/2018,07/05/2018,0.00,,8.05,,"-380,129.34"
,IN,AR,30313368,1005,100,,Invoice,,,,,,07/05/2018,07/05/2018,0.00,,19.87,,"-380,149.21"
,IN,AR,30313377,1005,100,,Invoice,,,,,,07/05/2018,07/05/2018,0.00,,7.97,,"-380,157.18"
,IN,AR,30313381,1005,100,,Invoice,,,,,,07/05/2018,07/05/2018,0.00,,12.92,,"-380,170.10"
,IN,AR,30313393,1005,100,,Invoice,,,,,,07/05/2018,07/05/2018,0.00,,12.92,,"-380,183.02"
,IN,AR,30313405,1005,100,,Invoice,,,,,,07/05/2018,07/05/2018,0.00,,4.80,,"-380,187.82"
,IN,AR,30313408,1005,100,,Invoice,,,,,,07/05/2018,07/05/2018,0.00,,18.37,,"-380,206.19"
,IN,AR,30313425,1005,100,,Invoice,,,,,,07/05/2018,07/05/2018,0.00,,6.36,,"-380,212.55"
,IN,AR,30313442,1005,100,,Invoice,,,,,,07/05/2018,07/05/2018,0.00,,18.09,,"-380,230.64"
,IN,AR,30313453,1005,100,,Invoice,,,,,,07/05/2018,07/05/2018,0.00,,8.90,,"-380,239.54"
,IN,AR,30313454,1005,100,,Invoice,,,,,,07/05/2018,07/05/2018,0.00,,5.18,,"-380,244.72"
,IN,AR,30313482,1005,100,,Invoice,,,,,,07/05/2018,07/05/2018,0.00,,96.39,,"-380,341.11"
,IN,AR,30313489,1005,100,,Invoice,,,,,,07/05/2018,07/05/2018,0.00,,30.51,,"-380,371.62"
,IN,AR,30313503,1005,100,,Invoice,,,,,,07/05/2018,07/05/2018,0.00,,26.29,,"-380,397.91"
,IN,AR,30313511,1005,100,,Invoice,,,,,,07/05/2018,07/05/2018,0.00,,25.76,,"-380,423.67"
,IN,AR,30313522,1005,100,,Invoice,,,,,,07/05/2018,07/05/2018,0.00,,12.03,,"-380,435.70"
,IN,AR,30313537,1005,100,,Invoice,,,,,,07/05/2018,07/05/2018,0.00,,7.29,,"-380,442.99"
,IN,AR,30313539,1005,100,,Invoice,,,,,,07/05/2018,07/05/2018,0.00,,6.36,,"-380,449.35"
,IN,AR,30313540,1005,100,,Invoice,,,,,,07/05/2018,07/05/2018,0.00,,7.29,,"-380,456.64"
,IN,AR,30313542,1005,100,,Invoice,,,,,,07/05/2018,07/05/2018,0.00,,9.03,,"-380,465.67"
,IN,AR,30313560,1005,100,,Invoice,,,,,,07/05/2018,07/05/2018,0.00,,7.20,,"-380,472.87"
,IN,AR,30313596,1005,100,,Invoice,,,,,,07/05/2018,07/05/2018,0.00,,12.71,,"-380,485.58"
,IN,AR,30313654,1005,100,,Invoice,,,,,,07/05/2018,07/05/2018,0.00,,126.37,,"-380,611.95"
,IN,AR,30313683,1005,100,,Invoice,,,,,,07/05/2018,07/05/2018,0.00,,25.42,,"-380,637.37"
,IN,AR,30313692,1005,100,,Invoice,,,,,,07/05/2018,07/05/2018,0.00,,32.54,,"-380,669.91"
,IN,AR,30313712,1005,100,,Invoice,,,,,,07/05/2018,07/05/2018,0.00,,3.64,,"-380,673.55"
,IN,AR,30313715,1005,100,,Invoice,,,,,,07/05/2018,07/05/2018,0.00,,10.93,,"-380,684.48"
,IN,AR,30313735,1005,100,,Invoice,,,,,,07/05/2018,07/05/2018,0.00,,19.28,,"-380,703.76"
,IN,AR,30313738,1005,100,,Invoice,,,,,,07/05/2018,07/05/2018,0.00,,3.64,,"-380,707.40"
,IN,AR,30313743,1005,100,,Invoice,,,,,,07/05/2018,07/05/2018,0.00,,15.21,,"-380,722.61"
,IN,AR,30313747,1005,100,,Invoice,,,,,,07/05/2018,07/05/2018,0.00,,9.19,,"-380,731.80"
,IN,AR,30313754,1005,100,,Invoice,,,,,,07/05/2018,07/05/2018,0.00,,5.25,,"-380,737.05"
,IN,AR,30313757,1005,100,,Invoice,,,,,,07/05/2018,07/05/2018,0.00,,7.29,,"-380,744.34"
,IN,AR,30313768,1005,100,,Invoice,,,,,,07/05/2018,07/05/2018,0.00,,14.58,,"-380,758.92"
,IN,AR,30313774,1005,100,,Invoice,,,,,,07/05/2018,07/05/2018,0.00,,13.98,,"-380,772.90"
,IN,AR,30313808,1005,100,,Invoice,,,,,,07/05/2018,07/05/2018,0.00,,16.00,,"-380,788.90"
,IN,AR,30313822,1005,100,,Invoice,,,,,,07/05/2018,07/05/2018,0.00,,29.15,,"-380,818.05"
,IN,AR,30313829,1005,100,,Invoice,,,,,,07/05/2018,07/05/2018,0.00,,18.22,,"-380,836.27"
,IN,AR,30313835,1005,100,,Invoice,,,,,,07/05/2018,07/05/2018,0.00,,7.75,,"-380,844.02"
,IN,AR,30313848,1005,100,,Invoice,,,,,,07/05/2018,07/05/2018,0.00,,29.55,,"-380,873.57"
,IN,AR,30313861,1005,100,,Invoice,,,,,,07/05/2018,07/05/2018,0.00,,6.08,,"-380,879.65"
,IN,AR,30313906,1005,100,,Invoice,,,,,,07/05/2018,07/05/2018,0.00,,14.58,,"-380,894.23"
,IN,AR,30313921,1005,100,,Invoice,,,,,,07/05/2018,07/05/2018,0.00,,8.24,,"-380,902.47"
,IN,AR,30313929,1005,100,,Invoice,,,,,,07/05/2018,07/05/2018,0.00,,10.93,,"-380,913.40"
,IN,AR,30313936,1005,100,,Invoice,,,,,,07/05/2018,07/05/2018,0.00,,2.58,,"-380,915.98"
,IN,AR,30313940,1005,100,,Invoice,,,,,,07/05/2018,07/05/2018,0.00,,10.93,,"-380,926.91"
,IN,AR,30313963,1005,100,,Invoice,,,,,,07/05/2018,07/05/2018,0.00,,6.43,,"-380,933.34"
,IN,AR,30313980,1005,100,,Invoice,,,,,,07/05/2018,07/05/2018,0.00,,7.29,,"-380,940.63"
,IN,AR,30314033,1005,100,,Invoice,,,,,,07/05/2018,07/05/2018,0.00,,8.52,,"-380,949.15"
,IN,AR,30314037,1005,100,,Invoice,,,,,,07/05/2018,07/05/2018,0.00,,18.04,,"-380,967.19"
,IN,AR,30314052,1005,100,,Invoice,,,,,,07/05/2018,07/05/2018,0.00,,18.21,,"-380,985.40"
,IN,AR,30314078,1005,100,,Invoice,,,,,,07/05/2018,07/05/2018,0.00,,4.81,,"-380,990.21"
,IN,AR,30314097,1005,100,,Invoice,,,,,,07/05/2018,07/05/2018,0.00,,44.66,,"-381,034.87"
,IN,AR,30314102,1005,100,,Invoice,,,,,,07/05/2018,07/05/2018,0.00,,18.22,,"-381,053.09"
,IN,AR,30314121,1005,100,,Invoice,,,,,,07/05/2018,07/05/2018,0.00,,25.51,,"-381,078.60"
,IN,AR,30314140,1005,100,,Invoice,,,,,,07/05/2018,07/05/2018,0.00,,24.01,,"-381,102.61"
,IN,AR,30314163,1005,100,,Invoice,,,,,,07/05/2018,07/05/2018,0.00,,40.73,,"-381,143.34"
,IN,AR,30314174,1005,100,,Invoice,,,,,,07/05/2018,07/05/2018,0.00,,8.41,,"-381,151.75"
,IN,AR,30314181,1005,100,,Invoice,,,,,,07/05/2018,07/05/2018,0.00,,29.15,,"-381,180.90"
,IN,AR,30314185,1005,100,,Invoice,,,,,,07/05/2018,07/05/2018,0.00,,31.41,,"-381,212.31"
,IN,AR,30314188,1005,100,,Invoice,,,,,,07/05/2018,07/05/2018,0.00,,130.51,,"-381,342.82"
,IN,AR,30314197,1005,100,,Invoice,,,,,,07/05/2018,07/05/2018,0.00,,16.83,,"-381,359.65"
,IN,AR,30314255,1005,100,,Invoice,,,,,,07/05/2018,07/05/2018,0.00,,26.69,,"-381,386.34"
,IN,AR,30314267,1005,100,,Invoice,,,,,,07/05/2018,07/05/2018,0.00,,14.34,,"-381,400.68"
,IN,AR,30314268,1005,100,,Invoice,,,,,,07/05/2018,07/05/2018,0.00,,12.75,,"-381,413.43"
,IN,AR,30314309,1005,100,,Invoice,,,,,,07/05/2018,07/05/2018,0.00,,27.03,,"-381,440.46"
,IN,AR,30314331,1005,100,,Invoice,,,,,,07/05/2018,07/05/2018,0.00,,10.00,,"-381,450.46"
,IN,AR,30314341,1005,100,,Invoice,,,,,,07/05/2018,07/05/2018,0.00,,1.88,,"-381,452.34"
,IN,AR,30314383,1005,100,,Invoice,,,,,,07/05/2018,07/05/2018,0.00,,5.47,,"-381,457.81"
,IN,AR,30314389,1005,100,,Invoice,,,,,,07/05/2018,07/05/2018,0.00,,14.58,,"-381,472.39"
,IN,AR,30314405,1005,100,,Invoice,,,,,,07/05/2018,07/05/2018,0.00,,13.09,,"-381,485.48"
,IN,AR,30314407,1005,100,,Invoice,,,,,,07/05/2018,07/05/2018,0.00,,7.02,,"-381,492.50"
,IN,AR,30314415,1005,100,,Invoice,,,,,,07/05/2018,07/05/2018,0.00,,12.25,,"-381,504.75"
,IN,AR,30314455,1005,100,,Invoice,,,,,,07/05/2018,07/05/2018,0.00,,43.86,,"-381,548.61"
,IN,AR,30314472,1005,100,,Invoice,,,,,,07/05/2018,07/05/2018,0.00,,4.00,,"-381,552.61"
,IN,AR,30314473,1005,100,,Invoice,,,,,,07/05/2018,07/05/2018,0.00,,4.00,,"-381,556.61"
,IN,AR,30314486,1005,100,,Invoice,,,,,,07/05/2018,07/05/2018,0.00,,6.23,,"-381,562.84"
,IN,AR,30314535,1005,100,,Invoice,,,,,,07/05/2018,07/05/2018,0.00,,3.64,,"-381,566.48"
,IN,AR,30314538,1005,100,,Invoice,,,,,,07/05/2018,07/05/2018,0.00,,7.29,,"-381,573.77"
,IN,AR,30314539,1005,100,,Invoice,,,,,,07/05/2018,07/05/2018,0.00,,7.29,,"-381,581.06"
,CN,AR,31017987,1005,100,,Credit Note,,,,,,08/05/2018,08/05/2018,3.64,,0.00,,"-381,577.42"
,CN,AR,31017989,1005,100,,Credit Note,,,,,,08/05/2018,08/05/2018,3.10,,0.00,,"-381,574.32"
,CS,AR,32003452,1005,100,,Cash sale,,,,,,08/05/2018,08/05/2018,0.00,,11.36,,"-381,585.68"
,CS,AR,32003453,1005,100,,Cash sale,,,,,,08/05/2018,08/05/2018,0.00,,7.29,,"-381,592.97"
,CS,AR,32003481,1005,100,,Cash sale,,,,,,08/05/2018,08/05/2018,0.00,,7.29,,"-381,600.26"
,CS,AR,32003532,1005,100,,Cash sale,,,,,,08/05/2018,08/05/2018,0.00,,10.93,,"-381,611.19"
,CS,AR,32003541,1005,100,,Cash sale,,,,,,08/05/2018,08/05/2018,0.00,,10.93,,"-381,622.12"
,CS,AR,32003548,1005,100,,Cash sale,,,,,,08/05/2018,08/05/2018,0.00,,10.17,,"-381,632.29"
,CS,AR,32003557,1005,100,,Cash sale,,,,,,08/05/2018,08/05/2018,0.00,,7.17,,"-381,639.46"
,CS,AR,32003581,1005,100,,Cash sale,,,,,,08/05/2018,08/05/2018,0.00,,5.17,,"-381,644.63"
,CS,AR,32003621,1005,100,,Cash sale,,,,,,08/05/2018,08/05/2018,0.00,,8.58,,"-381,653.21"
,CS,AR,32003640,1005,100,,Cash sale,,,,,,08/05/2018,08/05/2018,0.00,,6.74,,"-381,659.95"
,CS,AR,32003659,1005,100,,Cash sale,,,,,,08/05/2018,08/05/2018,0.00,,14.58,,"-381,674.53"
,CS,AR,32003662,1005,100,,Cash sale,,,,,,08/05/2018,08/05/2018,0.00,,17.80,,"-381,692.33"
,CS,AR,32003667,1005,100,,Cash sale,,,,,,08/05/2018,08/05/2018,0.00,,7.80,,"-381,700.13"
,CS,AR,32003693,1005,100,,Cash sale,,,,,,08/05/2018,08/05/2018,0.00,,5.17,,"-381,705.30"
,CS,AR,32003706,1005,100,,Cash sale,,,,,,08/05/2018,08/05/2018,0.00,,7.80,,"-381,713.10"
,CS,AR,32003714,1005,100,,Cash sale,,,,,,08/05/2018,08/05/2018,0.00,,3.64,,"-381,716.74"
,CS,AR,32003763,1005,100,,Cash sale,,,,,,08/05/2018,08/05/2018,0.00,,10.93,,"-381,727.67"
,CS,AR,32003766,1005,100,,Cash sale,,,,,,08/05/2018,08/05/2018,0.00,,10.72,,"-381,738.39"
,CS,AR,32003769,1005,100,,Cash sale,,,,,,08/05/2018,08/05/2018,0.00,,18.05,,"-381,756.44"
,CS,AR,32003784,1005,100,,Cash sale,,,,,,08/05/2018,08/05/2018,0.00,,10.95,,"-381,767.39"
,CS,AR,32003788,1005,100,,Cash sale,,,,,,08/05/2018,08/05/2018,0.00,,29.15,,"-381,796.54"
,CS,AR,32003803,1005,100,,Cash sale,,,,,,08/05/2018,08/05/2018,0.00,,7.29,,"-381,803.83"
,CS,AR,32003815,1005,100,,Cash sale,,,,,,08/05/2018,08/05/2018,0.00,,5.08,,"-381,808.91"
,CS,AR,32003817,1005,100,,Cash sale,,,,,,08/05/2018,08/05/2018,0.00,,20.00,,"-381,828.91"
,CS,AR,32003827,1005,100,,Cash sale,,,,,,08/05/2018,08/05/2018,0.00,,3.64,,"-381,832.55"
,CS,AR,32003837,1005,100,,Cash sale,,,,,,08/05/2018,08/05/2018,0.00,,5.47,,"-381,838.02"
,CS,AR,32003869,1005,100,,Cash sale,,,,,,08/05/2018,08/05/2018,0.00,,2.75,,"-381,840.77"
,CS,AR,32003882,1005,100,,Cash sale,,,,,,08/05/2018,08/05/2018,0.00,,18.22,,"-381,858.99"
,CS,AR,32003883,1005,100,,Cash sale,,,,,,08/05/2018,08/05/2018,0.00,,3.64,,"-381,862.63"
,CS,AR,32003925,1005,100,,Cash sale,,,,,,08/05/2018,08/05/2018,0.00,,5.47,,"-381,868.10"
,CS,AR,32003936,1005,100,,Cash sale,,,,,,08/05/2018,08/05/2018,0.00,,10.93,,"-381,879.03"
,CS,AR,32003939,1005,100,,Cash sale,,,,,,08/05/2018,08/05/2018,0.00,,6.56,,"-381,885.59"
,CS,AR,32004003,1005,100,,Cash sale,,,,,,08/05/2018,08/05/2018,0.00,,7.29,,"-381,892.88"
,IN,AR,30313127,1005,100,,Invoice,,,,,,08/05/2018,08/05/2018,0.00,,23.73,,"-381,916.61"
,IN,AR,30313144,1005,100,,Invoice,,,,,,08/05/2018,08/05/2018,0.00,,182.20,,"-382,098.81"
,IN,AR,30313176,1005,100,,Invoice,,,,,,08/05/2018,08/05/2018,0.00,,10.50,,"-382,109.31"
,IN,AR,30313201,1005,100,,Invoice,,,,,,08/05/2018,08/05/2018,0.00,,5.97,,"-382,115.28"
,IN,AR,30313212,1005,100,,Invoice,,,,,,08/05/2018,08/05/2018,0.00,,11.86,,"-382,127.14"
,IN,AR,30313237,1005,100,,Invoice,,,,,,08/05/2018,08/05/2018,0.00,,14.58,,"-382,141.72"
,IN,AR,30313262,1005,100,,Invoice,,,,,,08/05/2018,08/05/2018,0.00,,7.29,,"-382,149.01"
,IN,AR,30313323,1005,100,,Invoice,,,,,,08/05/2018,08/05/2018,0.00,,14.58,,"-382,163.59"
,IN,AR,30313334,1005,100,,Invoice,,,,,,08/05/2018,08/05/2018,0.00,,90.81,,"-382,254.40"
,IN,AR,30313346,1005,100,,Invoice,,,,,,08/05/2018,08/05/2018,0.00,,30.22,,"-382,284.62"
,IN,AR,30313370,1005,100,,Invoice,,,,,,08/05/2018,08/05/2018,0.00,,3.64,,"-382,288.26"
,IN,AR,30313384,1005,100,,Invoice,,,,,,08/05/2018,08/05/2018,0.00,,10.93,,"-382,299.19"
,IN,AR,30313398,1005,100,,Invoice,,,,,,08/05/2018,08/05/2018,0.00,,9.29,,"-382,308.48"
,IN,AR,30313406,1005,100,,Invoice,,,,,,08/05/2018,08/05/2018,0.00,,11.99,,"-382,320.47"
,IN,AR,30313420,1005,100,,Invoice,,,,,,08/05/2018,08/05/2018,0.00,,6.36,,"-382,326.83"
,IN,AR,30313434,1005,100,,Invoice,,,,,,08/05/2018,08/05/2018,0.00,,6.36,,"-382,333.19"
,IN,AR,30313448,1005,100,,Invoice,,,,,,08/05/2018,08/05/2018,0.00,,5.17,,"-382,338.36"
,IN,AR,30313455,1005,100,,Invoice,,,,,,08/05/2018,08/05/2018,0.00,,49.16,,"-382,387.52"
,IN,AR,30313463,1005,100,,Invoice,,,,,,08/05/2018,08/05/2018,0.00,,29.15,,"-382,416.67"
,IN,AR,30313468,1005,100,,Invoice,,,,,,08/05/2018,08/05/2018,0.00,,12.03,,"-382,428.70"
,IN,AR,30313476,1005,100,,Invoice,,,,,,08/05/2018,08/05/2018,0.00,,11.69,,"-382,440.39"
,IN,AR,30313493,1005,100,,Invoice,,,,,,08/05/2018,08/05/2018,0.00,,7.75,,"-382,448.14"
,IN,AR,30313512,1005,100,,Invoice,,,,,,08/05/2018,08/05/2018,0.00,,6.44,,"-382,454.58"
,IN,AR,30313536,1005,100,,Invoice,,,,,,08/05/2018,08/05/2018,0.00,,7.29,,"-382,461.87"
,IN,AR,30313550,1005,100,,Invoice,,,,,,08/05/2018,08/05/2018,0.00,,85.78,,"-382,547.65"
,IN,AR,30313587,1005,100,,Invoice,,,,,,08/05/2018,08/05/2018,0.00,,3.90,,"-382,551.55"
,IN,AR,30313601,1005,100,,Invoice,,,,,,08/05/2018,08/05/2018,0.00,,6.74,,"-382,558.29"
,IN,AR,30313605,1005,100,,Invoice,,,,,,08/05/2018,08/05/2018,0.00,,5.08,,"-382,563.37"
,IN,AR,30313622,1005,100,,Invoice,,,,,,08/05/2018,08/05/2018,0.00,,33.05,,"-382,596.42"
,IN,AR,30313652,1005,100,,Invoice,,,,,,08/05/2018,08/05/2018,0.00,,6.86,,"-382,603.28"
,IN,AR,30313665,1005,100,,Invoice,,,,,,08/05/2018,08/05/2018,0.00,,7.29,,"-382,610.57"
,IN,AR,30313671,1005,100,,Invoice,,,,,,08/05/2018,08/05/2018,0.00,,7.29,,"-382,617.86"
,IN,AR,30313697,1005,100,,Invoice,,,,,,08/05/2018,08/05/2018,0.00,,8.26,,"-382,626.12"
,IN,AR,30313704,1005,100,,Invoice,,,,,,08/05/2018,08/05/2018,0.00,,10.17,,"-382,636.29"
,IN,AR,30313707,1005,100,,Invoice,,,,,,08/05/2018,08/05/2018,0.00,,10.53,,"-382,646.82"
,IN,AR,30313720,1005,100,,Invoice,,,,,,08/05/2018,08/05/2018,0.00,,6.36,,"-382,653.18"
,IN,AR,30313725,1005,100,,Invoice,,,,,,08/05/2018,08/05/2018,0.00,,10.59,,"-382,663.77"
,IN,AR,30313740,1005,100,,Invoice,,,,,,08/05/2018,08/05/2018,0.00,,29.15,,"-382,692.92"
,IN,AR,30313760,1005,100,,Invoice,,,,,,08/05/2018,08/05/2018,0.00,,44.49,,"-382,737.41"
,IN,AR,30313780,1005,100,,Invoice,,,,,,08/05/2018,08/05/2018,0.00,,10.93,,"-382,748.34"
,IN,AR,30313811,1005,100,,Invoice,,,,,,08/05/2018,08/05/2018,0.00,,17.54,,"-382,765.88"
,IN,AR,30313831,1005,100,,Invoice,,,,,,08/05/2018,08/05/2018,0.00,,5.59,,"-382,771.47"
,IN,AR,30313839,1005,100,,Invoice,,,,,,08/05/2018,08/05/2018,0.00,,8.78,,"-382,780.25"
,IN,AR,30313844,1005,100,,Invoice,,,,,,08/05/2018,08/05/2018,0.00,,14.19,,"-382,794.44"
,IN,AR,30313851,1005,100,,Invoice,,,,,,08/05/2018,08/05/2018,0.00,,9.66,,"-382,804.10"
,IN,AR,30313873,1005,100,,Invoice,,,,,,08/05/2018,08/05/2018,0.00,,6.53,,"-382,810.63"
,IN,AR,30313885,1005,100,,Invoice,,,,,,08/05/2018,08/05/2018,0.00,,32.16,,"-382,842.79"
,IN,AR,30313899,1005,100,,Invoice,,,,,,08/05/2018,08/05/2018,0.00,,8.81,,"-382,851.60"
,IN,AR,30313928,1005,100,,Invoice,,,,,,08/05/2018,08/05/2018,0.00,,67.80,,"-382,919.40"
,IN,AR,30313954,1005,100,,Invoice,,,,,,08/05/2018,08/05/2018,0.00,,54.66,,"-382,974.06"
,IN,AR,30313984,1005,100,,Invoice,,,,,,08/05/2018,08/05/2018,0.00,,54.66,,"-383,028.72"
,IN,AR,30314001,1005,100,,Invoice,,,,,,08/05/2018,08/05/2018,0.00,,216.24,,"-383,244.96"
,IN,AR,30314002,1005,100,,Invoice,,,,,,08/05/2018,08/05/2018,0.00,,1.59,,"-383,246.55"
,IN,AR,30314003,1005,100,,Invoice,,,,,,08/05/2018,08/05/2018,0.00,,20.67,,"-383,267.22"
,IN,AR,30314017,1005,100,,Invoice,,,,,,08/05/2018,08/05/2018,0.00,,34.07,,"-383,301.29"
,IN,AR,30314046,1005,100,,Invoice,,,,,,08/05/2018,08/05/2018,0.00,,18.22,,"-383,319.51"
,IN,AR,30314061,1005,100,,Invoice,,,,,,08/05/2018,08/05/2018,0.00,,155.60,,"-383,475.11"
,IN,AR,30314079,1005,100,,Invoice,,,,,,08/05/2018,08/05/2018,0.00,,6.42,,"-383,481.53"
,IN,AR,30314111,1005,100,,Invoice,,,,,,08/05/2018,08/05/2018,0.00,,54.66,,"-383,536.19"
,IN,AR,30314123,1005,100,,Invoice,,,,,,08/05/2018,08/05/2018,0.00,,7.29,,"-383,543.48"
,IN,AR,30314131,1005,100,,Invoice,,,,,,08/05/2018,08/05/2018,0.00,,35.59,,"-383,579.07"
,IN,AR,30314144,1005,100,,Invoice,,,,,,08/05/2018,08/05/2018,0.00,,12.00,,"-383,591.07"
,IN,AR,30314192,1005,100,,Invoice,,,,,,08/05/2018,08/05/2018,0.00,,16.42,,"-383,607.49"
,IN,AR,30314220,1005,100,,Invoice,,,,,,08/05/2018,08/05/2018,0.00,,24.27,,"-383,631.76"
,IN,AR,30314222,1005,100,,Invoice,,,,,,08/05/2018,08/05/2018,0.00,,3.64,,"-383,635.40"
,IN,AR,30314233,1005,100,,Invoice,,,,,,08/05/2018,08/05/2018,0.00,,21.36,,"-383,656.76"
,IN,AR,30314239,1005,100,,Invoice,,,,,,08/05/2018,08/05/2018,0.00,,7.29,,"-383,664.05"
,IN,AR,30314247,1005,100,,Invoice,,,,,,08/05/2018,08/05/2018,0.00,,5.08,,"-383,669.13"
,IN,AR,30314277,1005,100,,Invoice,,,,,,08/05/2018,08/05/2018,0.00,,48.81,,"-383,717.94"
,IN,AR,30314313,1005,100,,Invoice,,,,,,08/05/2018,08/05/2018,0.00,,80.69,,"-383,798.63"
,IN,AR,30314314,1005,100,,Invoice,,,,,,08/05/2018,08/05/2018,0.00,,16.61,,"-383,815.24"
,IN,AR,30314315,1005,100,,Invoice,,,,,,08/05/2018,08/05/2018,0.00,,26.10,,"-383,841.34"
,IN,AR,30314342,1005,100,,Invoice,,,,,,08/05/2018,08/05/2018,0.00,,5.64,,"-383,846.98"
,IN,AR,30314347,1005,100,,Invoice,,,,,,08/05/2018,08/05/2018,0.00,,3.51,,"-383,850.49"
,IN,AR,30314359,1005,100,,Invoice,,,,,,08/05/2018,08/05/2018,0.00,,96.81,,"-383,947.30"
,IN,AR,30314360,1005,100,,Invoice,,,,,,08/05/2018,08/05/2018,0.00,,10.93,,"-383,958.23"
,IN,AR,30314368,1005,100,,Invoice,,,,,,08/05/2018,08/05/2018,0.00,,18.22,,"-383,976.45"
,IN,AR,30314371,1005,100,,Invoice,,,,,,08/05/2018,08/05/2018,0.00,,8.77,,"-383,985.22"
,IN,AR,30314442,1005,100,,Invoice,,,,,,08/05/2018,08/05/2018,0.00,,5.59,,"-383,990.81"
,IN,AR,30314443,1005,100,,Invoice,,,,,,08/05/2018,08/05/2018,0.00,,18.22,,"-384,009.03"
,IN,AR,30314447,1005,100,,Invoice,,,,,,08/05/2018,08/05/2018,0.00,,9.96,,"-384,018.99"
,IN,AR,30314487,1005,100,,Invoice,,,,,,08/05/2018,08/05/2018,0.00,,10.38,,"-384,029.37"
,IN,AR,30314488,1005,100,,Invoice,,,,,,08/05/2018,08/05/2018,0.00,,4.15,,"-384,033.52"
,IN,AR,30314526,1005,100,,Invoice,,,,,,08/05/2018,08/05/2018,0.00,,61.44,,"-384,094.96"
,IN,AR,30314546,1005,100,,Invoice,,,,,,08/05/2018,08/05/2018,0.00,,9.30,,"-384,104.26"
,CN,AR,31017859,1005,100,,Credit Note,,,,,,09/05/2018,09/05/2018,14.58,,0.00,,"-384,089.68"
,CN,AR,31017889,1005,100,,Credit Note,,,,,,09/05/2018,09/05/2018,8.47,,0.00,,"-384,081.21"
,CN,AR,31017906,1005,100,,Credit Note,,,,,,09/05/2018,09/05/2018,364.88,,0.00,,"-383,716.33"
,CN,AR,31017935,1005,100,,Credit Note,,,,,,09/05/2018,09/05/2018,47.05,,0.00,,"-383,669.28"
,CS,AR,32003434,1005,100,,Cash sale,,,,,,09/05/2018,09/05/2018,0.00,,15.04,,"-383,684.32"
,CS,AR,32003437,1005,100,,Cash sale,,,,,,09/05/2018,09/05/2018,0.00,,25.25,,"-383,709.57"
,CS,AR,32003445,1005,100,,Cash sale,,,,,,09/05/2018,09/05/2018,0.00,,40.14,,"-383,749.71"
,CS,AR,32003471,1005,100,,Cash sale,,,,,,09/05/2018,09/05/2018,0.00,,3.64,,"-383,753.35"
,CS,AR,32003508,1005,100,,Cash sale,,,,,,09/05/2018,09/05/2018,0.00,,15.04,,"-383,768.39"
,CS,AR,32003515,1005,100,,Cash sale,,,,,,09/05/2018,09/05/2018,0.00,,14.62,,"-383,783.01"
,CS,AR,32003542,1005,100,,Cash sale,,,,,,09/05/2018,09/05/2018,0.00,,7.29,,"-383,790.30"
,CS,AR,32003546,1005,100,,Cash sale,,,,,,09/05/2018,09/05/2018,0.00,,18.09,,"-383,808.39"
,CS,AR,32003559,1005,100,,Cash sale,,,,,,09/05/2018,09/05/2018,0.00,,7.29,,"-383,815.68"
,CS,AR,32003586,1005,100,,Cash sale,,,,,,09/05/2018,09/05/2018,0.00,,12.92,,"-383,828.60"
,CS,AR,32003596,1005,100,,Cash sale,,,,,,09/05/2018,09/05/2018,0.00,,14.58,,"-383,843.18"
,CS,AR,32003606,1005,100,,Cash sale,,,,,,09/05/2018,09/05/2018,0.00,,24.07,,"-383,867.25"
,CS,AR,32003608,1005,100,,Cash sale,,,,,,09/05/2018,09/05/2018,0.00,,6.43,,"-383,873.68"
,CS,AR,32003626,1005,100,,Cash sale,,,,,,09/05/2018,09/05/2018,0.00,,3.64,,"-383,877.32"
,CS,AR,32003628,1005,100,,Cash sale,,,,,,09/05/2018,09/05/2018,0.00,,5.08,,"-383,882.40"
,CS,AR,32003665,1005,100,,Cash sale,,,,,,09/05/2018,09/05/2018,0.00,,6.48,,"-383,888.88"
,CS,AR,32003711,1005,100,,Cash sale,,,,,,09/05/2018,09/05/2018,0.00,,3.64,,"-383,892.52"
,CS,AR,32003721,1005,100,,Cash sale,,,,,,09/05/2018,09/05/2018,0.00,,14.58,,"-383,907.10"
,CS,AR,32003773,1005,100,,Cash sale,,,,,,09/05/2018,09/05/2018,0.00,,5.17,,"-383,912.27"
,CS,AR,32003807,1005,100,,Cash sale,,,,,,09/05/2018,09/05/2018,0.00,,15.25,,"-383,927.52"
,CS,AR,32003810,1005,100,,Cash sale,,,,,,09/05/2018,09/05/2018,0.00,,7.29,,"-383,934.81"
,CS,AR,32003825,1005,100,,Cash sale,,,,,,09/05/2018,09/05/2018,0.00,,7.29,,"-383,942.10"
,CS,AR,32003830,1005,100,,Cash sale,,,,,,09/05/2018,09/05/2018,0.00,,18.22,,"-383,960.32"
,CS,AR,32003840,1005,100,,Cash sale,,,,,,09/05/2018,09/05/2018,0.00,,10.93,,"-383,971.25"
,CS,AR,32003842,1005,100,,Cash sale,,,,,,09/05/2018,09/05/2018,0.00,,7.29,,"-383,978.54"
,CS,AR,32003847,1005,100,,Cash sale,,,,,,09/05/2018,09/05/2018,0.00,,11.44,,"-383,989.98"
,CS,AR,32003853,1005,100,,Cash sale,,,,,,09/05/2018,09/05/2018,0.00,,10.93,,"-384,000.91"
,CS,AR,32003870,1005,100,,Cash sale,,,,,,09/05/2018,09/05/2018,0.00,,7.29,,"-384,008.20"
,CS,AR,32003871,1005,100,,Cash sale,,,,,,09/05/2018,09/05/2018,0.00,,6.86,,"-384,015.06"
,CS,AR,32003875,1005,100,,Cash sale,,,,,,09/05/2018,09/05/2018,0.00,,12.03,,"-384,027.09"
,CS,AR,32003886,1005,100,,Cash sale,,,,,,09/05/2018,09/05/2018,0.00,,12.71,,"-384,039.80"
,CS,AR,32003892,1005,100,,Cash sale,,,,,,09/05/2018,09/05/2018,0.00,,14.58,,"-384,054.38"
,CS,AR,32003898,1005,100,,Cash sale,,,,,,09/05/2018,09/05/2018,0.00,,2.54,,"-384,056.92"
,CS,AR,32003911,1005,100,,Cash sale,,,,,,09/05/2018,09/05/2018,0.00,,7.29,,"-384,064.21"
,CS,AR,32003943,1005,100,,Cash sale,,,,,,09/05/2018,09/05/2018,0.00,,10.99,,"-384,075.20"
,IN,AR,30313148,1005,100,,Invoice,,,,,,09/05/2018,09/05/2018,0.00,,80.54,,"-384,155.74"
,IN,AR,30313149,1005,100,,Invoice,,,,,,09/05/2018,09/05/2018,0.00,,36.61,,"-384,192.35"
,IN,AR,30313156,1005,100,,Invoice,,,,,,09/05/2018,09/05/2018,0.00,,14.19,,"-384,206.54"
,IN,AR,30313162,1005,100,,Invoice,,,,,,09/05/2018,09/05/2018,0.00,,73.56,,"-384,280.10"
,IN,AR,30313163,1005,100,,Invoice,,,,,,09/05/2018,09/05/2018,0.00,,26.27,,"-384,306.37"
,IN,AR,30313164,1005,100,,Invoice,,,,,,09/05/2018,09/05/2018,0.00,,7.29,,"-384,313.66"
,IN,AR,30313167,1005,100,,Invoice,,,,,,09/05/2018,09/05/2018,0.00,,364.41,,"-384,678.07"
,IN,AR,30313202,1005,100,,Invoice,,,,,,09/05/2018,09/05/2018,0.00,,7.97,,"-384,686.04"
,IN,AR,30313213,1005,100,,Invoice,,,,,,09/05/2018,09/05/2018,0.00,,102.03,,"-384,788.07"
,IN,AR,30313234,1005,100,,Invoice,,,,,,09/05/2018,09/05/2018,0.00,,14.58,,"-384,802.65"
,IN,AR,30313242,1005,100,,Invoice,,,,,,09/05/2018,09/05/2018,0.00,,18.22,,"-384,820.87"
,IN,AR,30313243,1005,100,,Invoice,,,,,,09/05/2018,09/05/2018,0.00,,10.93,,"-384,831.80"
,IN,AR,30313255,1005,100,,Invoice,,,,,,09/05/2018,09/05/2018,0.00,,34.00,,"-384,865.80"
,IN,AR,30313256,1005,100,,Invoice,,,,,,09/05/2018,09/05/2018,0.00,,6.00,,"-384,871.80"
,IN,AR,30313263,1005,100,,Invoice,,,,,,09/05/2018,09/05/2018,0.00,,54.66,,"-384,926.46"
,IN,AR,30313280,1005,100,,Invoice,,,,,,09/05/2018,09/05/2018,0.00,,36.00,,"-384,962.46"
,IN,AR,30313283,1005,100,,Invoice,,,,,,09/05/2018,09/05/2018,0.00,,10.93,,"-384,973.39"
,IN,AR,30313310,1005,100,,Invoice,,,,,,09/05/2018,09/05/2018,0.00,,54.66,,"-385,028.05"
,IN,AR,30313314,1005,100,,Invoice,,,,,,09/05/2018,09/05/2018,0.00,,29.15,,"-385,057.20"
,IN,AR,30313321,1005,100,,Invoice,,,,,,09/05/2018,09/05/2018,0.00,,60.03,,"-385,117.23"
,IN,AR,30313350,1005,100,,Invoice,,,,,,09/05/2018,09/05/2018,0.00,,3.01,,"-385,120.24"
,IN,AR,30313373,1005,100,,Invoice,,,,,,09/05/2018,09/05/2018,0.00,,3.64,,"-385,123.88"
,IN,AR,30313374,1005,100,,Invoice,,,,,,09/05/2018,09/05/2018,0.00,,7.29,,"-385,131.17"
,IN,AR,30313413,1005,100,,Invoice,,,,,,09/05/2018,09/05/2018,0.00,,38.14,,"-385,169.31"
,IN,AR,30313422,1005,100,,Invoice,,,,,,09/05/2018,09/05/2018,0.00,,4.24,,"-385,173.55"
,IN,AR,30313424,1005,100,,Invoice,,,,,,09/05/2018,09/05/2018,0.00,,2.12,,"-385,175.67"
,IN,AR,30313436,1005,100,,Invoice,,,,,,09/05/2018,09/05/2018,0.00,,2.80,,"-385,178.47"
,IN,AR,30313438,1005,100,,Invoice,,,,,,09/05/2018,09/05/2018,0.00,,8.47,,"-385,186.94"
,IN,AR,30313439,1005,100,,Invoice,,,,,,09/05/2018,09/05/2018,0.00,,4.24,,"-385,191.18"
,IN,AR,30313460,1005,100,,Invoice,,,,,,09/05/2018,09/05/2018,0.00,,25.51,,"-385,216.69"
,IN,AR,30313472,1005,100,,Invoice,,,,,,09/05/2018,09/05/2018,0.00,,16.73,,"-385,233.42"
,IN,AR,30313515,1005,100,,Invoice,,,,,,09/05/2018,09/05/2018,0.00,,45.08,,"-385,278.50"
,IN,AR,30313541,1005,100,,Invoice,,,,,,09/05/2018,09/05/2018,0.00,,23.49,,"-385,301.99"
,IN,AR,30313548,1005,100,,Invoice,,,,,,09/05/2018,09/05/2018,0.00,,20.68,,"-385,322.67"
,IN,AR,30313556,1005,100,,Invoice,,,,,,09/05/2018,09/05/2018,0.00,,108.03,,"-385,430.70"
,IN,AR,30313603,1005,100,,Invoice,,,,,,09/05/2018,09/05/2018,0.00,,7.29,,"-385,437.99"
,IN,AR,30313610,1005,100,,Invoice,,,,,,09/05/2018,09/05/2018,0.00,,20.71,,"-385,458.70"
,IN,AR,30313621,1005,100,,Invoice,,,,,,09/05/2018,09/05/2018,0.00,,4.24,,"-385,462.94"
,IN,AR,30313625,1005,100,,Invoice,,,,,,09/05/2018,09/05/2018,0.00,,18.22,,"-385,481.16"
,IN,AR,30313677,1005,100,,Invoice,,,,,,09/05/2018,09/05/2018,0.00,,9.08,,"-385,490.24"
,IN,AR,30313724,1005,100,,Invoice,,,,,,09/05/2018,09/05/2018,0.00,,14.58,,"-385,504.82"
,IN,AR,30313750,1005,100,,Invoice,,,,,,09/05/2018,09/05/2018,0.00,,22.44,,"-385,527.26"
,IN,AR,30313761,1005,100,,Invoice,,,,,,09/05/2018,09/05/2018,0.00,,23.73,,"-385,550.99"
,IN,AR,30313777,1005,100,,Invoice,,,,,,09/05/2018,09/05/2018,0.00,,364.88,,"-385,915.87"
,IN,AR,30313778,1005,100,,Invoice,,,,,,09/05/2018,09/05/2018,0.00,,740.29,,"-386,656.16"
,IN,AR,30313786,1005,100,,Invoice,,,,,,09/05/2018,09/05/2018,0.00,,25.51,,"-386,681.67"
,IN,AR,30313791,1005,100,,Invoice,,,,,,09/05/2018,09/05/2018,0.00,,7.29,,"-386,688.96"
,IN,AR,30313798,1005,100,,Invoice,,,,,,09/05/2018,09/05/2018,0.00,,70.78,,"-386,759.74"
,IN,AR,30313800,1005,100,,Invoice,,,,,,09/05/2018,09/05/2018,0.00,,7.29,,"-386,767.03"
,IN,AR,30313803,1005,100,,Invoice,,,,,,09/05/2018,09/05/2018,0.00,,7.63,,"-386,774.66"
,IN,AR,30313814,1005,100,,Invoice,,,,,,09/05/2018,09/05/2018,0.00,,21.86,,"-386,796.52"
,IN,AR,30313827,1005,100,,Invoice,,,,,,09/05/2018,09/05/2018,0.00,,7.29,,"-386,803.81"
,IN,AR,30313856,1005,100,,Invoice,,,,,,09/05/2018,09/05/2018,0.00,,24.07,,"-386,827.88"
,IN,AR,30313880,1005,100,,Invoice,,,,,,09/05/2018,09/05/2018,0.00,,25.51,,"-386,853.39"
,IN,AR,30313881,1005,100,,Invoice,,,,,,09/05/2018,09/05/2018,0.00,,29.15,,"-386,882.54"
,IN,AR,30313900,1005,100,,Invoice,,,,,,09/05/2018,09/05/2018,0.00,,1.76,,"-386,884.30"
,IN,AR,30313905,1005,100,,Invoice,,,,,,09/05/2018,09/05/2018,0.00,,21.06,,"-386,905.36"
,IN,AR,30313922,1005,100,,Invoice,,,,,,09/05/2018,09/05/2018,0.00,,10.98,,"-386,916.34"
,IN,AR,30313935,1005,100,,Invoice,,,,,,09/05/2018,09/05/2018,0.00,,20.68,,"-386,937.02"
,IN,AR,30313948,1005,100,,Invoice,,,,,,09/05/2018,09/05/2018,0.00,,22.01,,"-386,959.03"
,IN,AR,30313952,1005,100,,Invoice,,,,,,09/05/2018,09/05/2018,0.00,,25.51,,"-386,984.54"
,IN,AR,30313961,1005,100,,Invoice,,,,,,09/05/2018,09/05/2018,0.00,,7.29,,"-386,991.83"
,IN,AR,30313986,1005,100,,Invoice,,,,,,09/05/2018,09/05/2018,0.00,,5.08,,"-386,996.91"
,IN,AR,30313994,1005,100,,Invoice,,,,,,09/05/2018,09/05/2018,0.00,,9.76,,"-387,006.67"
,IN,AR,30314004,1005,100,,Invoice,,,,,,09/05/2018,09/05/2018,0.00,,28.62,,"-387,035.29"
,IN,AR,30314005,1005,100,,Invoice,,,,,,09/05/2018,09/05/2018,0.00,,33.39,,"-387,068.68"
,IN,AR,30314012,1005,100,,Invoice,,,,,,09/05/2018,09/05/2018,0.00,,2.01,,"-387,070.69"
,IN,AR,30314013,1005,100,,Invoice,,,,,,09/05/2018,09/05/2018,0.00,,9.74,,"-387,080.43"
,IN,AR,30314032,1005,100,,Invoice,,,,,,09/05/2018,09/05/2018,0.00,,30.07,,"-387,110.50"
,IN,AR,30314047,1005,100,,Invoice,,,,,,09/05/2018,09/05/2018,0.00,,11.02,,"-387,121.52"
,IN,AR,30314050,1005,100,,Invoice,,,,,,09/05/2018,09/05/2018,0.00,,3.64,,"-387,125.16"
,IN,AR,30314058,1005,100,,Invoice,,,,,,09/05/2018,09/05/2018,0.00,,38.90,,"-387,164.06"
,IN,AR,30314063,1005,100,,Invoice,,,,,,09/05/2018,09/05/2018,0.00,,7.29,,"-387,171.35"
,IN,AR,30314080,1005,100,,Invoice,,,,,,09/05/2018,09/05/2018,0.00,,1.60,,"-387,172.95"
,IN,AR,30314081,1005,100,,Invoice,,,,,,09/05/2018,09/05/2018,0.00,,48.10,,"-387,221.05"
,IN,AR,30314082,1005,100,,Invoice,,,,,,09/05/2018,09/05/2018,0.00,,8.02,,"-387,229.07"
,IN,AR,30314083,1005,100,,Invoice,,,,,,09/05/2018,09/05/2018,0.00,,25.65,,"-387,254.72"
,IN,AR,30314084,1005,100,,Invoice,,,,,,09/05/2018,09/05/2018,0.00,,1.60,,"-387,256.32"
,IN,AR,30314085,1005,100,,Invoice,,,,,,09/05/2018,09/05/2018,0.00,,17.64,,"-387,273.96"
,IN,AR,30314115,1005,100,,Invoice,,,,,,09/05/2018,09/05/2018,0.00,,41.39,,"-387,315.35"
,IN,AR,30314132,1005,100,,Invoice,,,,,,09/05/2018,09/05/2018,0.00,,10.17,,"-387,325.52"
,IN,AR,30314133,1005,100,,Invoice,,,,,,09/05/2018,09/05/2018,0.00,,25.42,,"-387,350.94"
,IN,AR,30314159,1005,100,,Invoice,,,,,,09/05/2018,09/05/2018,0.00,,68.14,,"-387,419.08"
,IN,AR,30314160,1005,100,,Invoice,,,,,,09/05/2018,09/05/2018,0.00,,28.39,,"-387,447.47"
,IN,AR,30314164,1005,100,,Invoice,,,,,,09/05/2018,09/05/2018,0.00,,4.53,,"-387,452.00"
,IN,AR,30314165,1005,100,,Invoice,,,,,,09/05/2018,09/05/2018,0.00,,57.32,,"-387,509.32"
,IN,AR,30314166,1005,100,,Invoice,,,,,,09/05/2018,09/05/2018,0.00,,2.92,,"-387,512.24"
,IN,AR,30314175,1005,100,,Invoice,,,,,,09/05/2018,09/05/2018,0.00,,42.05,,"-387,554.29"
,IN,AR,30314178,1005,100,,Invoice,,,,,,09/05/2018,09/05/2018,0.00,,14.58,,"-387,568.87"
,IN,AR,30314189,1005,100,,Invoice,,,,,,09/05/2018,09/05/2018,0.00,,27.97,,"-387,596.84"
,IN,AR,30314210,1005,100,,Invoice,,,,,,09/05/2018,09/05/2018,0.00,,11.19,,"-387,608.03"
,IN,AR,30314216,1005,100,,Invoice,,,,,,09/05/2018,09/05/2018,0.00,,14.58,,"-387,622.61"
,IN,AR,30314218,1005,100,,Invoice,,,,,,09/05/2018,09/05/2018,0.00,,170.00,,"-387,792.61"
,IN,AR,30314223,1005,100,,Invoice,,,,,,09/05/2018,09/05/2018,0.00,,14.58,,"-387,807.19"
,IN,AR,30314243,1005,100,,Invoice,,,,,,09/05/2018,09/05/2018,0.00,,10.93,,"-387,818.12"
,IN,AR,30314269,1005,100,,Invoice,,,,,,09/05/2018,09/05/2018,0.00,,7.97,,"-387,826.09"
,IN,AR,30314270,1005,100,,Invoice,,,,,,09/05/2018,09/05/2018,0.00,,22.31,,"-387,848.40"
,IN,AR,30314345,1005,100,,Invoice,,,,,,09/05/2018,09/05/2018,0.00,,3.51,,"-387,851.91"
,IN,AR,30314349,1005,100,,Invoice,,,,,,09/05/2018,09/05/2018,0.00,,13.77,,"-387,865.68"
,IN,AR,30314376,1005,100,,Invoice,,,,,,09/05/2018,09/05/2018,0.00,,6.56,,"-387,872.24"
,IN,AR,30314386,1005,100,,Invoice,,,,,,09/05/2018,09/05/2018,0.00,,29.15,,"-387,901.39"
,IN,AR,30314391,1005,100,,Invoice,,,,,,09/05/2018,09/05/2018,0.00,,15.05,,"-387,916.44"
,IN,AR,30314398,1005,100,,Invoice,,,,,,09/05/2018,09/05/2018,0.00,,10.93,,"-387,927.37"
,IN,AR,30314412,1005,100,,Invoice,,,,,,09/05/2018,09/05/2018,0.00,,13.98,,"-387,941.35"
,IN,AR,30314419,1005,100,,Invoice,,,,,,09/05/2018,09/05/2018,0.00,,8.17,,"-387,949.52"
,IN,AR,30314462,1005,100,,Invoice,,,,,,09/05/2018,09/05/2018,0.00,,11.44,,"-387,960.96"
,IN,AR,30314468,1005,100,,Invoice,,,,,,09/05/2018,09/05/2018,0.00,,9.11,,"-387,970.07"
,IN,AR,30314489,1005,100,,Invoice,,,,,,09/05/2018,09/05/2018,0.00,,8.31,,"-387,978.38"
,IN,AR,30314490,1005,100,,Invoice,,,,,,09/05/2018,09/05/2018,0.00,,60.21,,"-388,038.59"
,IN,AR,30314491,1005,100,,Invoice,,,,,,09/05/2018,09/05/2018,0.00,,10.38,,"-388,048.97"
,IN,AR,30314492,1005,100,,Invoice,,,,,,09/05/2018,09/05/2018,0.00,,12.46,,"-388,061.43"
,IN,AR,30314493,1005,100,,Invoice,,,,,,09/05/2018,09/05/2018,0.00,,20.76,,"-388,082.19"
,IN,AR,30314511,1005,100,,Invoice,,,,,,09/05/2018,09/05/2018,0.00,,2.54,,"-388,084.73"
,IN,AR,30314521,1005,100,,Invoice,,,,,,09/05/2018,09/05/2018,0.00,,9.11,,"-388,093.84"
,CS,AR,32004474,1005,100,,Cash sale,,,,,,09/05/2018,09/05/2018,0.00,,2.92,,"-388,096.76"
,CN,AR,31017938,1005,100,,Credit Note,,,,,,10/05/2018,10/05/2018,28.62,,0.00,,"-388,068.14"
,CS,AR,32003439,1005,100,,Cash sale,,,,,,10/05/2018,10/05/2018,0.00,,30.85,,"-388,098.99"
,CS,AR,32003451,1005,100,,Cash sale,,,,,,10/05/2018,10/05/2018,0.00,,3.64,,"-388,102.63"
,CS,AR,32003456,1005,100,,Cash sale,,,,,,10/05/2018,10/05/2018,0.00,,14.58,,"-388,117.21"
,CS,AR,32003464,1005,100,,Cash sale,,,,,,10/05/2018,10/05/2018,0.00,,5.17,,"-388,122.38"
,CS,AR,32003488,1005,100,,Cash sale,,,,,,10/05/2018,10/05/2018,0.00,,3.64,,"-388,126.02"
,CS,AR,32003506,1005,100,,Cash sale,,,,,,10/05/2018,10/05/2018,0.00,,7.29,,"-388,133.31"
,CS,AR,32003518,1005,100,,Cash sale,,,,,,10/05/2018,10/05/2018,0.00,,7.29,,"-388,140.60"
,CS,AR,32003520,1005,100,,Cash sale,,,,,,10/05/2018,10/05/2018,0.00,,10.93,,"-388,151.53"
,CS,AR,32003538,1005,100,,Cash sale,,,,,,10/05/2018,10/05/2018,0.00,,7.29,,"-388,158.82"
,CS,AR,32003554,1005,100,,Cash sale,,,,,,10/05/2018,10/05/2018,0.00,,7.29,,"-388,166.11"
,CS,AR,32003556,1005,100,,Cash sale,,,,,,10/05/2018,10/05/2018,0.00,,20.68,,"-388,186.79"
,CS,AR,32003598,1005,100,,Cash sale,,,,,,10/05/2018,10/05/2018,0.00,,14.58,,"-388,201.37"
,CS,AR,32003617,1005,100,,Cash sale,,,,,,10/05/2018,10/05/2018,0.00,,10.93,,"-388,212.30"
,CS,AR,32003625,1005,100,,Cash sale,,,,,,10/05/2018,10/05/2018,0.00,,14.58,,"-388,226.88"
,CS,AR,32003632,1005,100,,Cash sale,,,,,,10/05/2018,10/05/2018,0.00,,14.58,,"-388,241.46"
,CS,AR,32003658,1005,100,,Cash sale,,,,,,10/05/2018,10/05/2018,0.00,,21.61,,"-388,263.07"
,CS,AR,32003674,1005,100,,Cash sale,,,,,,10/05/2018,10/05/2018,0.00,,11.19,,"-388,274.26"
,CS,AR,32003677,1005,100,,Cash sale,,,,,,10/05/2018,10/05/2018,0.00,,10.93,,"-388,285.19"
,CS,AR,32003713,1005,100,,Cash sale,,,,,,10/05/2018,10/05/2018,0.00,,27.97,,"-388,313.16"
,CS,AR,32003726,1005,100,,Cash sale,,,,,,10/05/2018,10/05/2018,0.00,,27.97,,"-388,341.13"
,CS,AR,32003743,1005,100,,Cash sale,,,,,,10/05/2018,10/05/2018,0.00,,5.17,,"-388,346.30"
,CS,AR,32003770,1005,100,,Cash sale,,,,,,10/05/2018,10/05/2018,0.00,,54.15,,"-388,400.45"
,CS,AR,32003778,1005,100,,Cash sale,,,,,,10/05/2018,10/05/2018,0.00,,3.64,,"-388,404.09"
,CS,AR,32003785,1005,100,,Cash sale,,,,,,10/05/2018,10/05/2018,0.00,,27.37,,"-388,431.46"
,CS,AR,32003793,1005,100,,Cash sale,,,,,,10/05/2018,10/05/2018,0.00,,12.71,,"-388,444.17"
,CS,AR,32003813,1005,100,,Cash sale,,,,,,10/05/2018,10/05/2018,0.00,,3.64,,"-388,447.81"
,CS,AR,32003855,1005,100,,Cash sale,,,,,,10/05/2018,10/05/2018,0.00,,10.93,,"-388,458.74"
,CS,AR,32003927,1005,100,,Cash sale,,,,,,10/05/2018,10/05/2018,0.00,,10.93,,"-388,469.67"
,CS,AR,32003930,1005,100,,Cash sale,,,,,,10/05/2018,10/05/2018,0.00,,14.58,,"-388,484.25"
,CS,AR,32003941,1005,100,,Cash sale,,,,,,10/05/2018,10/05/2018,0.00,,7.29,,"-388,491.54"
,IN,AR,30313136,1005,100,,Invoice,,,,,,10/05/2018,10/05/2018,0.00,,3.64,,"-388,495.18"
,IN,AR,30313143,1005,100,,Invoice,,,,,,10/05/2018,10/05/2018,0.00,,21.86,,"-388,517.04"
,IN,AR,30313146,1005,100,,Invoice,,,,,,10/05/2018,10/05/2018,0.00,,10.93,,"-388,527.97"
,IN,AR,30313172,1005,100,,Invoice,,,,,,10/05/2018,10/05/2018,0.00,,10.93,,"-388,538.90"
,IN,AR,30313180,1005,100,,Invoice,,,,,,10/05/2018,10/05/2018,0.00,,18.31,,"-388,557.21"
,IN,AR,30313192,1005,100,,Invoice,,,,,,10/05/2018,10/05/2018,0.00,,32.80,,"-388,590.01"
,IN,AR,30313203,1005,100,,Invoice,,,,,,10/05/2018,10/05/2018,0.00,,3.98,,"-388,593.99"
,IN,AR,30313214,1005,100,,Invoice,,,,,,10/05/2018,10/05/2018,0.00,,14.24,,"-388,608.23"
,IN,AR,30313232,1005,100,,Invoice,,,,,,10/05/2018,10/05/2018,0.00,,44.00,,"-388,652.23"
,IN,AR,30313235,1005,100,,Invoice,,,,,,10/05/2018,10/05/2018,0.00,,5.93,,"-388,658.16"
,IN,AR,30313241,1005,100,,Invoice,,,,,,10/05/2018,10/05/2018,0.00,,14.58,,"-388,672.74"
,IN,AR,30313272,1005,100,,Invoice,,,,,,10/05/2018,10/05/2018,0.00,,7.29,,"-388,680.03"
,IN,AR,30313286,1005,100,,Invoice,,,,,,10/05/2018,10/05/2018,0.00,,73.56,,"-388,753.59"
,IN,AR,30313306,1005,100,,Invoice,,,,,,10/05/2018,10/05/2018,0.00,,49.42,,"-388,803.01"
,IN,AR,30313313,1005,100,,Invoice,,,,,,10/05/2018,10/05/2018,0.00,,18.22,,"-388,821.23"
,IN,AR,30313345,1005,100,,Invoice,,,,,,10/05/2018,10/05/2018,0.00,,14.58,,"-388,835.81"
,IN,AR,30313352,1005,100,,Invoice,,,,,,10/05/2018,10/05/2018,0.00,,51.02,,"-388,886.83"
,IN,AR,30313379,1005,100,,Invoice,,,,,,10/05/2018,10/05/2018,0.00,,14.58,,"-388,901.41"
,IN,AR,30313386,1005,100,,Invoice,,,,,,10/05/2018,10/05/2018,0.00,,21.00,,"-388,922.41"
,IN,AR,30313395,1005,100,,Invoice,,,,,,10/05/2018,10/05/2018,0.00,,7.29,,"-388,929.70"
,IN,AR,30313400,1005,100,,Invoice,,,,,,10/05/2018,10/05/2018,0.00,,6.02,,"-388,935.72"
,IN,AR,30313450,1005,100,,Invoice,,,,,,10/05/2018,10/05/2018,0.00,,177.69,,"-389,113.41"
,IN,AR,30313464,1005,100,,Invoice,,,,,,10/05/2018,10/05/2018,0.00,,33.46,,"-389,146.87"
,IN,AR,30313478,1005,100,,Invoice,,,,,,10/05/2018,10/05/2018,0.00,,20.34,,"-389,167.21"
,IN,AR,30313490,1005,100,,Invoice,,,,,,10/05/2018,10/05/2018,0.00,,20.34,,"-389,187.55"
,IN,AR,30313491,1005,100,,Invoice,,,,,,10/05/2018,10/05/2018,0.00,,99.15,,"-389,286.70"
,IN,AR,30313513,1005,100,,Invoice,,,,,,10/05/2018,10/05/2018,0.00,,3.22,,"-389,289.92"
,IN,AR,30313516,1005,100,,Invoice,,,,,,10/05/2018,10/05/2018,0.00,,9.66,,"-389,299.58"
,IN,AR,30313584,1005,100,,Invoice,,,,,,10/05/2018,10/05/2018,0.00,,2.39,,"-389,301.97"
,IN,AR,30313611,1005,100,,Invoice,,,,,,10/05/2018,10/05/2018,0.00,,47.80,,"-389,349.77"
,IN,AR,30313612,1005,100,,Invoice,,,,,,10/05/2018,10/05/2018,0.00,,54.17,,"-389,403.94"
,IN,AR,30313619,1005,100,,Invoice,,,,,,10/05/2018,10/05/2018,0.00,,5.17,,"-389,409.11"
,IN,AR,30313624,1005,100,,Invoice,,,,,,10/05/2018,10/05/2018,0.00,,4.32,,"-389,413.43"
,IN,AR,30313626,1005,100,,Invoice,,,,,,10/05/2018,10/05/2018,0.00,,21.86,,"-389,435.29"
,IN,AR,30313684,1005,100,,Invoice,,,,,,10/05/2018,10/05/2018,0.00,,27.97,,"-389,463.26"
,IN,AR,30313690,1005,100,,Invoice,,,,,,10/05/2018,10/05/2018,0.00,,22.50,,"-389,485.76"
,IN,AR,30313695,1005,100,,Invoice,,,,,,10/05/2018,10/05/2018,0.00,,10.93,,"-389,496.69"
,IN,AR,30313745,1005,100,,Invoice,,,,,,10/05/2018,10/05/2018,0.00,,16.47,,"-389,513.16"
,IN,AR,30313765,1005,100,,Invoice,,,,,,10/05/2018,10/05/2018,0.00,,7.00,,"-389,520.16"
,IN,AR,30313775,1005,100,,Invoice,,,,,,10/05/2018,10/05/2018,0.00,,22.37,,"-389,542.53"
,IN,AR,30313785,1005,100,,Invoice,,,,,,10/05/2018,10/05/2018,0.00,,3.64,,"-389,546.17"
,IN,AR,30313805,1005,100,,Invoice,,,,,,10/05/2018,10/05/2018,0.00,,14.58,,"-389,560.75"
,IN,AR,30313817,1005,100,,Invoice,,,,,,10/05/2018,10/05/2018,0.00,,4.64,,"-389,565.39"
,IN,AR,30313821,1005,100,,Invoice,,,,,,10/05/2018,10/05/2018,0.00,,8.77,,"-389,574.16"
,IN,AR,30313823,1005,100,,Invoice,,,,,,10/05/2018,10/05/2018,0.00,,14.58,,"-389,588.74"
,IN,AR,30313824,1005,100,,Invoice,,,,,,10/05/2018,10/05/2018,0.00,,10.93,,"-389,599.67"
,IN,AR,30313826,1005,100,,Invoice,,,,,,10/05/2018,10/05/2018,0.00,,16.53,,"-389,616.20"
,IN,AR,30313846,1005,100,,Invoice,,,,,,10/05/2018,10/05/2018,0.00,,182.20,,"-389,798.40"
,IN,AR,30313860,1005,100,,Invoice,,,,,,10/05/2018,10/05/2018,0.00,,18.05,,"-389,816.45"
,IN,AR,30313862,1005,100,,Invoice,,,,,,10/05/2018,10/05/2018,0.00,,12.14,,"-389,828.59"
,IN,AR,30313870,1005,100,,Invoice,,,,,,10/05/2018,10/05/2018,0.00,,11.64,,"-389,840.23"
,IN,AR,30313872,1005,100,,Invoice,,,,,,10/05/2018,10/05/2018,0.00,,10.17,,"-389,850.40"
,IN,AR,30313879,1005,100,,Invoice,,,,,,10/05/2018,10/05/2018,0.00,,6.00,,"-389,856.40"
,IN,AR,30313889,1005,100,,Invoice,,,,,,10/05/2018,10/05/2018,0.00,,40.08,,"-389,896.48"
,IN,AR,30313894,1005,100,,Invoice,,,,,,10/05/2018,10/05/2018,0.00,,19.58,,"-389,916.06"
,IN,AR,30313910,1005,100,,Invoice,,,,,,10/05/2018,10/05/2018,0.00,,7.29,,"-389,923.35"
,IN,AR,30313917,1005,100,,Invoice,,,,,,10/05/2018,10/05/2018,0.00,,9.08,,"-389,932.43"
,IN,AR,30313945,1005,100,,Invoice,,,,,,10/05/2018,10/05/2018,0.00,,11.70,,"-389,944.13"
,IN,AR,30313983,1005,100,,Invoice,,,,,,10/05/2018,10/05/2018,0.00,,3.64,,"-389,947.77"
,IN,AR,30313995,1005,100,,Invoice,,,,,,10/05/2018,10/05/2018,0.00,,14.64,,"-389,962.41"
,IN,AR,30313996,1005,100,,Invoice,,,,,,10/05/2018,10/05/2018,0.00,,14.64,,"-389,977.05"
,IN,AR,30313997,1005,100,,Invoice,,,,,,10/05/2018,10/05/2018,0.00,,4.88,,"-389,981.93"
,IN,AR,30313998,1005,100,,Invoice,,,,,,10/05/2018,10/05/2018,0.00,,22.78,,"-390,004.71"
,IN,AR,30314006,1005,100,,Invoice,,,,,,10/05/2018,10/05/2018,0.00,,22.26,,"-390,026.97"
,IN,AR,30314030,1005,100,,Invoice,,,,,,10/05/2018,10/05/2018,0.00,,175.64,,"-390,202.61"
,IN,AR,30314049,1005,100,,Invoice,,,,,,10/05/2018,10/05/2018,0.00,,8.21,,"-390,210.82"
,IN,AR,30314086,1005,100,,Invoice,,,,,,10/05/2018,10/05/2018,0.00,,11.22,,"-390,222.04"
,IN,AR,30314087,1005,100,,Invoice,,,,,,10/05/2018,10/05/2018,0.00,,4.81,,"-390,226.85"
,IN,AR,30314093,1005,100,,Invoice,,,,,,10/05/2018,10/05/2018,0.00,,19.62,,"-390,246.47"
,IN,AR,30314112,1005,100,,Invoice,,,,,,10/05/2018,10/05/2018,0.00,,14.58,,"-390,261.05"
,IN,AR,30314138,1005,100,,Invoice,,,,,,10/05/2018,10/05/2018,0.00,,16.01,,"-390,277.06"
,IN,AR,30314147,1005,100,,Invoice,,,,,,10/05/2018,10/05/2018,0.00,,24.01,,"-390,301.07"
,IN,AR,30314156,1005,100,,Invoice,,,,,,10/05/2018,10/05/2018,0.00,,8.75,,"-390,309.82"
,IN,AR,30314157,1005,100,,Invoice,,,,,,10/05/2018,10/05/2018,0.00,,14.58,,"-390,324.40"
,IN,AR,30314190,1005,100,,Invoice,,,,,,10/05/2018,10/05/2018,0.00,,9.32,,"-390,333.72"
,IN,AR,30314198,1005,100,,Invoice,,,,,,10/05/2018,10/05/2018,0.00,,8.42,,"-390,342.14"
,IN,AR,30314207,1005,100,,Invoice,,,,,,10/05/2018,10/05/2018,0.00,,25.17,,"-390,367.31"
,IN,AR,30314215,1005,100,,Invoice,,,,,,10/05/2018,10/05/2018,0.00,,12.85,,"-390,380.16"
,IN,AR,30314253,1005,100,,Invoice,,,,,,10/05/2018,10/05/2018,0.00,,17.49,,"-390,397.65"
,IN,AR,30314258,1005,100,,Invoice,,,,,,10/05/2018,10/05/2018,0.00,,81.15,,"-390,478.80"
,IN,AR,30314271,1005,100,,Invoice,,,,,,10/05/2018,10/05/2018,0.00,,4.78,,"-390,483.58"
,IN,AR,30314272,1005,100,,Invoice,,,,,,10/05/2018,10/05/2018,0.00,,137.02,,"-390,620.60"
,IN,AR,30314273,1005,100,,Invoice,,,,,,10/05/2018,10/05/2018,0.00,,9.56,,"-390,630.16"
,IN,AR,30314274,1005,100,,Invoice,,,,,,10/05/2018,10/05/2018,0.00,,14.34,,"-390,644.50"
,IN,AR,30314324,1005,100,,Invoice,,,,,,10/05/2018,10/05/2018,0.00,,22.37,,"-390,666.87"
,IN,AR,30314418,1005,100,,Invoice,,,,,,10/05/2018,10/05/2018,0.00,,4.08,,"-390,670.95"
,IN,AR,30314494,1005,100,,Invoice,,,,,,10/05/2018,10/05/2018,0.00,,31.14,,"-390,702.09"
,IN,AR,30314495,1005,100,,Invoice,,,,,,10/05/2018,10/05/2018,0.00,,4.15,,"-390,706.24"
,IN,AR,30314496,1005,100,,Invoice,,,,,,10/05/2018,10/05/2018,0.00,,2.08,,"-390,708.32"
,IN,AR,30314497,1005,100,,Invoice,,,,,,10/05/2018,10/05/2018,0.00,,10.38,,"-390,718.70"
,IN,AR,30314498,1005,100,,Invoice,,,,,,10/05/2018,10/05/2018,0.00,,18.69,,"-390,737.39"
,IN,AR,30314512,1005,100,,Invoice,,,,,,10/05/2018,10/05/2018,0.00,,7.63,,"-390,745.02"
,CN,AR,31017913,1005,100,,Credit Note,,,,,,11/05/2018,11/05/2018,3.64,,0.00,,"-390,741.38"
,CN,AR,31017922,1005,100,,Credit Note,,,,,,11/05/2018,11/05/2018,15.90,,0.00,,"-390,725.48"
,CN,AR,31017950,1005,100,,Credit Note,,,,,,11/05/2018,11/05/2018,4.59,,0.00,,"-390,720.89"
,CS,AR,32003432,1005,100,,Cash sale,,,,,,11/05/2018,11/05/2018,0.00,,10.93,,"-390,731.82"
,CS,AR,32003438,1005,100,,Cash sale,,,,,,11/05/2018,11/05/2018,0.00,,8.42,,"-390,740.24"
,CS,AR,32003442,1005,100,,Cash sale,,,,,,11/05/2018,11/05/2018,0.00,,16.78,,"-390,757.02"
,CS,AR,32003449,1005,100,,Cash sale,,,,,,11/05/2018,11/05/2018,0.00,,16.61,,"-390,773.63"
,CS,AR,32003485,1005,100,,Cash sale,,,,,,11/05/2018,11/05/2018,0.00,,9.66,,"-390,783.29"
,CS,AR,32003493,1005,100,,Cash sale,,,,,,11/05/2018,11/05/2018,0.00,,10.93,,"-390,794.22"
,CS,AR,32003495,1005,100,,Cash sale,,,,,,11/05/2018,11/05/2018,0.00,,7.29,,"-390,801.51"
,CS,AR,32003499,1005,100,,Cash sale,,,,,,11/05/2018,11/05/2018,0.00,,14.53,,"-390,816.04"
,CS,AR,32003505,1005,100,,Cash sale,,,,,,11/05/2018,11/05/2018,0.00,,7.29,,"-390,823.33"
,CS,AR,32003529,1005,100,,Cash sale,,,,,,11/05/2018,11/05/2018,0.00,,25.51,,"-390,848.84"
,CS,AR,32003568,1005,100,,Cash sale,,,,,,11/05/2018,11/05/2018,0.00,,21.86,,"-390,870.70"
,CS,AR,32003571,1005,100,,Cash sale,,,,,,11/05/2018,11/05/2018,0.00,,10.93,,"-390,881.63"
,CS,AR,32003576,1005,100,,Cash sale,,,,,,11/05/2018,11/05/2018,0.00,,15.25,,"-390,896.88"
,CS,AR,32003588,1005,100,,Cash sale,,,,,,11/05/2018,11/05/2018,0.00,,7.29,,"-390,904.17"
,CS,AR,32003593,1005,100,,Cash sale,,,,,,11/05/2018,11/05/2018,0.00,,52.20,,"-390,956.37"
,CS,AR,32003603,1005,100,,Cash sale,,,,,,11/05/2018,11/05/2018,0.00,,13.74,,"-390,970.11"
,CS,AR,32003631,1005,100,,Cash sale,,,,,,11/05/2018,11/05/2018,0.00,,15.25,,"-390,985.36"
,CS,AR,32003638,1005,100,,Cash sale,,,,,,11/05/2018,11/05/2018,0.00,,14.62,,"-390,999.98"
,CS,AR,32003644,1005,100,,Cash sale,,,,,,11/05/2018,11/05/2018,0.00,,6.02,,"-391,006.00"
,CS,AR,32003655,1005,100,,Cash sale,,,,,,11/05/2018,11/05/2018,0.00,,33.09,,"-391,039.09"
,CS,AR,32003676,1005,100,,Cash sale,,,,,,11/05/2018,11/05/2018,0.00,,7.50,,"-391,046.59"
,CS,AR,32003679,1005,100,,Cash sale,,,,,,11/05/2018,11/05/2018,0.00,,14.58,,"-391,061.17"
,CS,AR,32003682,1005,100,,Cash sale,,,,,,11/05/2018,11/05/2018,0.00,,10.93,,"-391,072.10"
,CS,AR,32003685,1005,100,,Cash sale,,,,,,11/05/2018,11/05/2018,0.00,,3.64,,"-391,075.74"
,CS,AR,32003689,1005,100,,Cash sale,,,,,,11/05/2018,11/05/2018,0.00,,7.29,,"-391,083.03"
,CS,AR,32003695,1005,100,,Cash sale,,,,,,11/05/2018,11/05/2018,0.00,,7.29,,"-391,090.32"
,CS,AR,32003708,1005,100,,Cash sale,,,,,,11/05/2018,11/05/2018,0.00,,14.58,,"-391,104.90"
,CS,AR,32003717,1005,100,,Cash sale,,,,,,11/05/2018,11/05/2018,0.00,,7.75,,"-391,112.65"
,CS,AR,32003724,1005,100,,Cash sale,,,,,,11/05/2018,11/05/2018,0.00,,14.58,,"-391,127.23"
,CS,AR,32003729,1005,100,,Cash sale,,,,,,11/05/2018,11/05/2018,0.00,,14.58,,"-391,141.81"
,CS,AR,32003737,1005,100,,Cash sale,,,,,,11/05/2018,11/05/2018,0.00,,23.41,,"-391,165.22"
,CS,AR,32003739,1005,100,,Cash sale,,,,,,11/05/2018,11/05/2018,0.00,,3.64,,"-391,168.86"
,CS,AR,32003756,1005,100,,Cash sale,,,,,,11/05/2018,11/05/2018,0.00,,7.29,,"-391,176.15"
,CS,AR,32003758,1005,100,,Cash sale,,,,,,11/05/2018,11/05/2018,0.00,,10.34,,"-391,186.49"
,CS,AR,32003775,1005,100,,Cash sale,,,,,,11/05/2018,11/05/2018,0.00,,7.29,,"-391,193.78"
,CS,AR,32003804,1005,100,,Cash sale,,,,,,11/05/2018,11/05/2018,0.00,,2.58,,"-391,196.36"
,CS,AR,32003808,1005,100,,Cash sale,,,,,,11/05/2018,11/05/2018,0.00,,7.29,,"-391,203.65"
,CS,AR,32003811,1005,100,,Cash sale,,,,,,11/05/2018,11/05/2018,0.00,,7.29,,"-391,210.94"
,CS,AR,32003821,1005,100,,Cash sale,,,,,,11/05/2018,11/05/2018,0.00,,52.00,,"-391,262.94"
,CS,AR,32003823,1005,100,,Cash sale,,,,,,11/05/2018,11/05/2018,0.00,,3.64,,"-391,266.58"
,CS,AR,32003824,1005,100,,Cash sale,,,,,,11/05/2018,11/05/2018,0.00,,7.29,,"-391,273.87"
,CS,AR,32003835,1005,100,,Cash sale,,,,,,11/05/2018,11/05/2018,0.00,,5.08,,"-391,278.95"
,CS,AR,32003848,1005,100,,Cash sale,,,,,,11/05/2018,11/05/2018,0.00,,6.86,,"-391,285.81"
,CS,AR,32003851,1005,100,,Cash sale,,,,,,11/05/2018,11/05/2018,0.00,,10.93,,"-391,296.74"
,CS,AR,32003873,1005,100,,Cash sale,,,,,,11/05/2018,11/05/2018,0.00,,60.71,,"-391,357.45"
,CS,AR,32003893,1005,100,,Cash sale,,,,,,11/05/2018,11/05/2018,0.00,,7.29,,"-391,364.74"
,CS,AR,32003895,1005,100,,Cash sale,,,,,,11/05/2018,11/05/2018,0.00,,10.93,,"-391,375.67"
,CS,AR,32003897,1005,100,,Cash sale,,,,,,11/05/2018,11/05/2018,0.00,,3.64,,"-391,379.31"
,CS,AR,32003904,1005,100,,Cash sale,,,,,,11/05/2018,11/05/2018,0.00,,7.29,,"-391,386.60"
,CS,AR,32003907,1005,100,,Cash sale,,,,,,11/05/2018,11/05/2018,0.00,,14.58,,"-391,401.18"
,CS,AR,32003920,1005,100,,Cash sale,,,,,,11/05/2018,11/05/2018,0.00,,10.93,,"-391,412.11"
,CS,AR,32003952,1005,100,,Cash sale,,,,,,11/05/2018,11/05/2018,0.00,,7.29,,"-391,419.40"
,CS,AR,32003958,1005,100,,Cash sale,,,,,,11/05/2018,11/05/2018,0.00,,7.29,,"-391,426.69"
,CS,AR,32003996,1005,100,,Cash sale,,,,,,11/05/2018,11/05/2018,0.00,,9.32,,"-391,436.01"
,CS,AR,32004004,1005,100,,Cash sale,,,,,,11/05/2018,11/05/2018,0.00,,14.58,,"-391,450.59"
,IN,AR,30313128,1005,100,,Invoice,,,,,,11/05/2018,11/05/2018,0.00,,35.59,,"-391,486.18"
,IN,AR,30313129,1005,100,,Invoice,,,,,,11/05/2018,11/05/2018,0.00,,59.32,,"-391,545.50"
,IN,AR,30313130,1005,100,,Invoice,,,,,,11/05/2018,11/05/2018,0.00,,56.36,,"-391,601.86"
,IN,AR,30313134,1005,100,,Invoice,,,,,,11/05/2018,11/05/2018,0.00,,21.86,,"-391,623.72"
,IN,AR,30313155,1005,100,,Invoice,,,,,,11/05/2018,11/05/2018,0.00,,18.22,,"-391,641.94"
,IN,AR,30313157,1005,100,,Invoice,,,,,,11/05/2018,11/05/2018,0.00,,21.86,,"-391,663.80"
,IN,AR,30313170,1005,100,,Invoice,,,,,,11/05/2018,11/05/2018,0.00,,24.15,,"-391,687.95"
,IN,AR,30313188,1005,100,,Invoice,,,,,,11/05/2018,11/05/2018,0.00,,7.29,,"-391,695.24"
,IN,AR,30313194,1005,100,,Invoice,,,,,,11/05/2018,11/05/2018,0.00,,9.19,,"-391,704.43"
,IN,AR,30313195,1005,100,,Invoice,,,,,,11/05/2018,11/05/2018,0.00,,4.59,,"-391,709.02"
,IN,AR,30313198,1005,100,,Invoice,,,,,,11/05/2018,11/05/2018,0.00,,62.10,,"-391,771.12"
,IN,AR,30313215,1005,100,,Invoice,,,,,,11/05/2018,11/05/2018,0.00,,116.27,,"-391,887.39"
,IN,AR,30313222,1005,100,,Invoice,,,,,,11/05/2018,11/05/2018,0.00,,3.64,,"-391,891.03"
,IN,AR,30313225,1005,100,,Invoice,,,,,,11/05/2018,11/05/2018,0.00,,10.93,,"-391,901.96"
,IN,AR,30313226,1005,100,,Invoice,,,,,,11/05/2018,11/05/2018,0.00,,54.66,,"-391,956.62"
,IN,AR,30313257,1005,100,,Invoice,,,,,,11/05/2018,11/05/2018,0.00,,48.00,,"-392,004.62"
,IN,AR,30313277,1005,100,,Invoice,,,,,,11/05/2018,11/05/2018,0.00,,3.89,,"-392,008.51"
,IN,AR,30313287,1005,100,,Invoice,,,,,,11/05/2018,11/05/2018,0.00,,4.75,,"-392,013.26"
,IN,AR,30313295,1005,100,,Invoice,,,,,,11/05/2018,11/05/2018,0.00,,20.00,,"-392,033.26"
,IN,AR,30313317,1005,100,,Invoice,,,,,,11/05/2018,11/05/2018,0.00,,22.71,,"-392,055.97"
,IN,AR,30313322,1005,100,,Invoice,,,,,,11/05/2018,11/05/2018,0.00,,223.76,,"-392,279.73"
,IN,AR,30313333,1005,100,,Invoice,,,,,,11/05/2018,11/05/2018,0.00,,13.58,,"-392,293.31"
,IN,AR,30313342,1005,100,,Invoice,,,,,,11/05/2018,11/05/2018,0.00,,42.00,,"-392,335.31"
,IN,AR,30313344,1005,100,,Invoice,,,,,,11/05/2018,11/05/2018,0.00,,10.93,,"-392,346.24"
,IN,AR,30313355,1005,100,,Invoice,,,,,,11/05/2018,11/05/2018,0.00,,30.76,,"-392,377.00"
,IN,AR,30313363,1005,100,,Invoice,,,,,,11/05/2018,11/05/2018,0.00,,23.29,,"-392,400.29"
,IN,AR,30313389,1005,100,,Invoice,,,,,,11/05/2018,11/05/2018,0.00,,7.75,,"-392,408.04"
,IN,AR,30313443,1005,100,,Invoice,,,,,,11/05/2018,11/05/2018,0.00,,18.09,,"-392,426.13"
,IN,AR,30313446,1005,100,,Invoice,,,,,,11/05/2018,11/05/2018,0.00,,4.78,,"-392,430.91"
,IN,AR,30313469,1005,100,,Invoice,,,,,,11/05/2018,11/05/2018,0.00,,6.02,,"-392,436.93"
,IN,AR,30313470,1005,100,,Invoice,,,,,,11/05/2018,11/05/2018,0.00,,24.58,,"-392,461.51"
,IN,AR,30313483,1005,100,,Invoice,,,,,,11/05/2018,11/05/2018,0.00,,125.10,,"-392,586.61"
,IN,AR,30313504,1005,100,,Invoice,,,,,,11/05/2018,11/05/2018,0.00,,4.78,,"-392,591.39"
,IN,AR,30313505,1005,100,,Invoice,,,,,,11/05/2018,11/05/2018,0.00,,19.12,,"-392,610.51"
,IN,AR,30313518,1005,100,,Invoice,,,,,,11/05/2018,11/05/2018,0.00,,10.93,,"-392,621.44"
,IN,AR,30313519,1005,100,,Invoice,,,,,,11/05/2018,11/05/2018,0.00,,7.29,,"-392,628.73"
,IN,AR,30313551,1005,100,,Invoice,,,,,,11/05/2018,11/05/2018,0.00,,8.47,,"-392,637.20"
,IN,AR,30313578,1005,100,,Invoice,,,,,,11/05/2018,11/05/2018,0.00,,4.24,,"-392,641.44"
,IN,AR,30313597,1005,100,,Invoice,,,,,,11/05/2018,11/05/2018,0.00,,7.63,,"-392,649.07"
,IN,AR,30313598,1005,100,,Invoice,,,,,,11/05/2018,11/05/2018,0.00,,2.54,,"-392,651.61"
,IN,AR,30313599,1005,100,,Invoice,,,,,,11/05/2018,11/05/2018,0.00,,15.25,,"-392,666.86"
,IN,AR,30313615,1005,100,,Invoice,,,,,,11/05/2018,11/05/2018,0.00,,20.23,,"-392,687.09"
,IN,AR,30313664,1005,100,,Invoice,,,,,,11/05/2018,11/05/2018,0.00,,10.17,,"-392,697.26"
,IN,AR,30313667,1005,100,,Invoice,,,,,,11/05/2018,11/05/2018,0.00,,4.24,,"-392,701.50"
,IN,AR,30313678,1005,100,,Invoice,,,,,,11/05/2018,11/05/2018,0.00,,15.90,,"-392,717.40"
,IN,AR,30313713,1005,100,,Invoice,,,,,,11/05/2018,11/05/2018,0.00,,12.03,,"-392,729.43"
,IN,AR,30313721,1005,100,,Invoice,,,,,,11/05/2018,11/05/2018,0.00,,8.47,,"-392,737.90"
,IN,AR,30313731,1005,100,,Invoice,,,,,,11/05/2018,11/05/2018,0.00,,18.22,,"-392,756.12"
,IN,AR,30313751,1005,100,,Invoice,,,,,,11/05/2018,11/05/2018,0.00,,11.22,,"-392,767.34"
,IN,AR,30313788,1005,100,,Invoice,,,,,,11/05/2018,11/05/2018,0.00,,10.93,,"-392,778.27"
,IN,AR,30313799,1005,100,,Invoice,,,,,,11/05/2018,11/05/2018,0.00,,23.90,,"-392,802.17"
,IN,AR,30313836,1005,100,,Invoice,,,,,,11/05/2018,11/05/2018,0.00,,5.17,,"-392,807.34"
,IN,AR,30313890,1005,100,,Invoice,,,,,,11/05/2018,11/05/2018,0.00,,3.64,,"-392,810.98"
,IN,AR,30313901,1005,100,,Invoice,,,,,,11/05/2018,11/05/2018,0.00,,5.29,,"-392,816.27"
,IN,AR,30313902,1005,100,,Invoice,,,,,,11/05/2018,11/05/2018,0.00,,7.05,,"-392,823.32"
,IN,AR,30313907,1005,100,,Invoice,,,,,,11/05/2018,11/05/2018,0.00,,10.93,,"-392,834.25"
,IN,AR,30313909,1005,100,,Invoice,,,,,,11/05/2018,11/05/2018,0.00,,7.29,,"-392,841.54"
,IN,AR,30313913,1005,100,,Invoice,,,,,,11/05/2018,11/05/2018,0.00,,4.85,,"-392,846.39"
,IN,AR,30313915,1005,100,,Invoice,,,,,,11/05/2018,11/05/2018,0.00,,8.01,,"-392,854.40"
,IN,AR,30313930,1005,100,,Invoice,,,,,,11/05/2018,11/05/2018,0.00,,85.19,,"-392,939.59"
,IN,AR,30313941,1005,100,,Invoice,,,,,,11/05/2018,11/05/2018,0.00,,10.93,,"-392,950.52"
,IN,AR,30313989,1005,100,,Invoice,,,,,,11/05/2018,11/05/2018,0.00,,10.93,,"-392,961.45"
,IN,AR,30314007,1005,100,,Invoice,,,,,,11/05/2018,11/05/2018,0.00,,6.36,,"-392,967.81"
,IN,AR,30314018,1005,100,,Invoice,,,,,,11/05/2018,11/05/2018,0.00,,34.07,,"-393,001.88"
,IN,AR,30314020,1005,100,,Invoice,,,,,,11/05/2018,11/05/2018,0.00,,40.00,,"-393,041.88"
,IN,AR,30314025,1005,100,,Invoice,,,,,,11/05/2018,11/05/2018,0.00,,18.33,,"-393,060.21"
,IN,AR,30314038,1005,100,,Invoice,,,,,,11/05/2018,11/05/2018,0.00,,52.11,,"-393,112.32"
,IN,AR,30314053,1005,100,,Invoice,,,,,,11/05/2018,11/05/2018,0.00,,24.29,,"-393,136.61"
,IN,AR,30314054,1005,100,,Invoice,,,,,,11/05/2018,11/05/2018,0.00,,12.03,,"-393,148.64"
,IN,AR,30314088,1005,100,,Invoice,,,,,,11/05/2018,11/05/2018,0.00,,73.75,,"-393,222.39"
,IN,AR,30314098,1005,100,,Invoice,,,,,,11/05/2018,11/05/2018,0.00,,26.27,,"-393,248.66"
,IN,AR,30314113,1005,100,,Invoice,,,,,,11/05/2018,11/05/2018,0.00,,12.14,,"-393,260.80"
,IN,AR,30314118,1005,100,,Invoice,,,,,,11/05/2018,11/05/2018,0.00,,23.91,,"-393,284.71"
,IN,AR,30314134,1005,100,,Invoice,,,,,,11/05/2018,11/05/2018,0.00,,17.80,,"-393,302.51"
,IN,AR,30314149,1005,100,,Invoice,,,,,,11/05/2018,11/05/2018,0.00,,12.00,,"-393,314.51"
,IN,AR,30314151,1005,100,,Invoice,,,,,,11/05/2018,11/05/2018,0.00,,16.01,,"-393,330.52"
,IN,AR,30314170,1005,100,,Invoice,,,,,,11/05/2018,11/05/2018,0.00,,21.90,,"-393,352.42"
,IN,AR,30314176,1005,100,,Invoice,,,,,,11/05/2018,11/05/2018,0.00,,8.41,,"-393,360.83"
,IN,AR,30314202,1005,100,,Invoice,,,,,,11/05/2018,11/05/2018,0.00,,4.59,,"-393,365.42"
,IN,AR,30314213,1005,100,,Invoice,,,,,,11/05/2018,11/05/2018,0.00,,29.15,,"-393,394.57"
,IN,AR,30314219,1005,100,,Invoice,,,,,,11/05/2018,11/05/2018,0.00,,15.90,,"-393,410.47"
,IN,AR,30314244,1005,100,,Invoice,,,,,,11/05/2018,11/05/2018,0.00,,10.93,,"-393,421.40"
,IN,AR,30314250,1005,100,,Invoice,,,,,,11/05/2018,11/05/2018,0.00,,8.52,,"-393,429.92"
,IN,AR,30314252,1005,100,,Invoice,,,,,,11/05/2018,11/05/2018,0.00,,12.08,,"-393,442.00"
,IN,AR,30314332,1005,100,,Invoice,,,,,,11/05/2018,11/05/2018,0.00,,12.00,,"-393,454.00"
,IN,AR,30314355,1005,100,,Invoice,,,,,,11/05/2018,11/05/2018,0.00,,5.68,,"-393,459.68"
,IN,AR,30314384,1005,100,,Invoice,,,,,,11/05/2018,11/05/2018,0.00,,5.47,,"-393,465.15"
,IN,AR,30314388,1005,100,,Invoice,,,,,,11/05/2018,11/05/2018,0.00,,23.31,,"-393,488.46"
,IN,AR,30314399,1005,100,,Invoice,,,,,,11/05/2018,11/05/2018,0.00,,8.78,,"-393,497.24"
,IN,AR,30314402,1005,100,,Invoice,,,,,,11/05/2018,11/05/2018,0.00,,7.29,,"-393,504.53"
,IN,AR,30314416,1005,100,,Invoice,,,,,,11/05/2018,11/05/2018,0.00,,12.25,,"-393,516.78"
,IN,AR,30314448,1005,100,,Invoice,,,,,,11/05/2018,11/05/2018,0.00,,7.97,,"-393,524.75"
,IN,AR,30314474,1005,100,,Invoice,,,,,,11/05/2018,11/05/2018,0.00,,2.00,,"-393,526.75"
,IN,AR,30314475,1005,100,,Invoice,,,,,,11/05/2018,11/05/2018,0.00,,2.00,,"-393,528.75"
,IN,AR,30314499,1005,100,,Invoice,,,,,,11/05/2018,11/05/2018,0.00,,8.31,,"-393,537.06"
,IN,AR,30314500,1005,100,,Invoice,,,,,,11/05/2018,11/05/2018,0.00,,20.76,,"-393,557.82"
,IN,AR,30314501,1005,100,,Invoice,,,,,,11/05/2018,11/05/2018,0.00,,10.38,,"-393,568.20"
,IN,AR,30314502,1005,100,,Invoice,,,,,,11/05/2018,11/05/2018,0.00,,12.46,,"-393,580.66"
,IN,AR,30314513,1005,100,,Invoice,,,,,,11/05/2018,11/05/2018,0.00,,7.63,,"-393,588.29"
,IN,AR,30314527,1005,100,,Invoice,,,,,,11/05/2018,11/05/2018,0.00,,49.15,,"-393,637.44"
,IN,AR,30314541,1005,100,,Invoice,,,,,,11/05/2018,11/05/2018,0.00,,1.55,,"-393,638.99"
,IN,AR,30314550,1005,100,,Invoice,,,,,,11/05/2018,11/05/2018,0.00,,3.03,,"-393,642.02"
,IN,AR,30314567,1005,100,,Invoice,,,,,,11/05/2018,11/05/2018,0.00,,54.66,,"-393,696.68"
,IN,AR,30314568,1005,100,,Invoice,,,,,,11/05/2018,11/05/2018,0.00,,29.15,,"-393,725.83"
,CS,AR,32004484,1005,100,,Cash sale,,,,,,11/05/2018,11/05/2018,0.00,,7.29,,"-393,733.12"
,CS,AR,32003458,1005,100,,Cash sale,,,,,,12/05/2018,12/05/2018,0.00,,6.02,,"-393,739.14"
,CS,AR,32003513,1005,100,,Cash sale,,,,,,12/05/2018,12/05/2018,0.00,,3.64,,"-393,742.78"
,CS,AR,32003525,1005,100,,Cash sale,,,,,,12/05/2018,12/05/2018,0.00,,3.64,,"-393,746.42"
,CS,AR,32003672,1005,100,,Cash sale,,,,,,12/05/2018,12/05/2018,0.00,,7.29,,"-393,753.71"
,CS,AR,32003833,1005,100,,Cash sale,,,,,,12/05/2018,12/05/2018,0.00,,6.07,,"-393,759.78"
,CS,AR,32003836,1005,100,,Cash sale,,,,,,12/05/2018,12/05/2018,0.00,,6.07,,"-393,765.85"
,IN,AR,30313329,1005,100,,Invoice,,,,,,12/05/2018,12/05/2018,0.00,,780.96,,"-394,546.81"
,IN,AR,30313475,1005,100,,Invoice,,,,,,12/05/2018,12/05/2018,0.00,,612.20,,"-395,159.01"
,IN,AR,30313535,1005,100,,Invoice,,,,,,12/05/2018,12/05/2018,0.00,,6.02,,"-395,165.03"
,IN,AR,30313546,1005,100,,Invoice,,,,,,12/05/2018,12/05/2018,0.00,,55.93,,"-395,220.96"
,IN,AR,30314026,1005,100,,Invoice,,,,,,12/05/2018,12/05/2018,0.00,,52.37,,"-395,273.33"
,IN,AR,30314327,1005,100,,Invoice,,,,,,12/05/2018,12/05/2018,0.00,,20.34,,"-395,293.67"
,CN,AR,31017901,1005,100,,Credit Note,,,,,,14/05/2018,14/05/2018,36.44,,0.00,,"-395,257.23"
,CN,AR,31017909,1005,100,,Credit Note,,,,,,14/05/2018,14/05/2018,268.48,,0.00,,"-394,988.75"
,CS,AR,32003450,1005,100,,Cash sale,,,,,,14/05/2018,14/05/2018,0.00,,14.24,,"-395,002.99"
,CS,AR,32003500,1005,100,,Cash sale,,,,,,14/05/2018,14/05/2018,0.00,,12.46,,"-395,015.45"
,CS,AR,32003509,1005,100,,Cash sale,,,,,,14/05/2018,14/05/2018,0.00,,3.64,,"-395,019.09"
,CS,AR,32003516,1005,100,,Cash sale,,,,,,14/05/2018,14/05/2018,0.00,,8.77,,"-395,027.86"
,CS,AR,32003540,1005,100,,Cash sale,,,,,,14/05/2018,14/05/2018,0.00,,3.64,,"-395,031.50"
,CS,AR,32003545,1005,100,,Cash sale,,,,,,14/05/2018,14/05/2018,0.00,,10.34,,"-395,041.84"
,CS,AR,32003565,1005,100,,Cash sale,,,,,,14/05/2018,14/05/2018,0.00,,7.29,,"-395,049.13"
,CS,AR,32003577,1005,100,,Cash sale,,,,,,14/05/2018,14/05/2018,0.00,,12.71,,"-395,061.84"
,CS,AR,32003580,1005,100,,Cash sale,,,,,,14/05/2018,14/05/2018,0.00,,25.17,,"-395,087.01"
,CS,AR,32003604,1005,100,,Cash sale,,,,,,14/05/2018,14/05/2018,0.00,,8.25,,"-395,095.26"
,CS,AR,32003610,1005,100,,Cash sale,,,,,,14/05/2018,14/05/2018,0.00,,3.64,,"-395,098.90"
,CS,AR,32003620,1005,100,,Cash sale,,,,,,14/05/2018,14/05/2018,0.00,,7.29,,"-395,106.19"
,CS,AR,32003627,1005,100,,Cash sale,,,,,,14/05/2018,14/05/2018,0.00,,6.02,,"-395,112.21"
,CS,AR,32003639,1005,100,,Cash sale,,,,,,14/05/2018,14/05/2018,0.00,,20.47,,"-395,132.68"
,CS,AR,32003642,1005,100,,Cash sale,,,,,,14/05/2018,14/05/2018,0.00,,10.88,,"-395,143.56"
,CS,AR,32003643,1005,100,,Cash sale,,,,,,14/05/2018,14/05/2018,0.00,,3.64,,"-395,147.20"
,CS,AR,32003648,1005,100,,Cash sale,,,,,,14/05/2018,14/05/2018,0.00,,4.75,,"-395,151.95"
,CS,AR,32003656,1005,100,,Cash sale,,,,,,14/05/2018,14/05/2018,0.00,,42.12,,"-395,194.07"
,CS,AR,32003702,1005,100,,Cash sale,,,,,,14/05/2018,14/05/2018,0.00,,5.08,,"-395,199.15"
,CS,AR,32003719,1005,100,,Cash sale,,,,,,14/05/2018,14/05/2018,0.00,,7.29,,"-395,206.44"
,CS,AR,32003747,1005,100,,Cash sale,,,,,,14/05/2018,14/05/2018,0.00,,9.03,,"-395,215.47"
,CS,AR,32003759,1005,100,,Cash sale,,,,,,14/05/2018,14/05/2018,0.00,,3.04,,"-395,218.51"
,CS,AR,32003776,1005,100,,Cash sale,,,,,,14/05/2018,14/05/2018,0.00,,10.93,,"-395,229.44"
,CS,AR,32003782,1005,100,,Cash sale,,,,,,14/05/2018,14/05/2018,0.00,,7.29,,"-395,236.73"
,CS,AR,32003798,1005,100,,Cash sale,,,,,,14/05/2018,14/05/2018,0.00,,6.53,,"-395,243.26"
,CS,AR,32003801,1005,100,,Cash sale,,,,,,14/05/2018,14/05/2018,0.00,,3.64,,"-395,246.90"
,CS,AR,32003834,1005,100,,Cash sale,,,,,,14/05/2018,14/05/2018,0.00,,9.84,,"-395,256.74"
,CS,AR,32003849,1005,100,,Cash sale,,,,,,14/05/2018,14/05/2018,0.00,,11.44,,"-395,268.18"
,CS,AR,32003860,1005,100,,Cash sale,,,,,,14/05/2018,14/05/2018,0.00,,8.90,,"-395,277.08"
,CS,AR,32003862,1005,100,,Cash sale,,,,,,14/05/2018,14/05/2018,0.00,,7.29,,"-395,284.37"
,CS,AR,32003866,1005,100,,Cash sale,,,,,,14/05/2018,14/05/2018,0.00,,6.07,,"-395,290.44"
,CS,AR,32003878,1005,100,,Cash sale,,,,,,14/05/2018,14/05/2018,0.00,,18.21,,"-395,308.65"
,CS,AR,32003888,1005,100,,Cash sale,,,,,,14/05/2018,14/05/2018,0.00,,5.47,,"-395,314.12"
,CS,AR,32003894,1005,100,,Cash sale,,,,,,14/05/2018,14/05/2018,0.00,,10.93,,"-395,325.05"
,CS,AR,32003906,1005,100,,Cash sale,,,,,,14/05/2018,14/05/2018,0.00,,29.15,,"-395,354.20"
,CS,AR,32003913,1005,100,,Cash sale,,,,,,14/05/2018,14/05/2018,0.00,,10.93,,"-395,365.13"
,CS,AR,32003945,1005,100,,Cash sale,,,,,,14/05/2018,14/05/2018,0.00,,10.93,,"-395,376.06"
,CS,AR,32003948,1005,100,,Cash sale,,,,,,14/05/2018,14/05/2018,0.00,,18.22,,"-395,394.28"
,CS,AR,32003950,1005,100,,Cash sale,,,,,,14/05/2018,14/05/2018,0.00,,7.75,,"-395,402.03"
,CS,AR,32003997,1005,100,,Cash sale,,,,,,14/05/2018,14/05/2018,0.00,,9.32,,"-395,411.35"
,CS,AR,32004008,1005,100,,Cash sale,,,,,,14/05/2018,14/05/2018,0.00,,3.64,,"-395,414.99"
,IN,AR,30313118,1005,100,,Invoice,,,,,,14/05/2018,14/05/2018,0.00,,84.54,,"-395,499.53"
,IN,AR,30313131,1005,100,,Invoice,,,,,,14/05/2018,14/05/2018,0.00,,44.49,,"-395,544.02"
,IN,AR,30313141,1005,100,,Invoice,,,,,,14/05/2018,14/05/2018,0.00,,29.15,,"-395,573.17"
,IN,AR,30313183,1005,100,,Invoice,,,,,,14/05/2018,14/05/2018,0.00,,63.41,,"-395,636.58"
,IN,AR,30313204,1005,100,,Invoice,,,,,,14/05/2018,14/05/2018,0.00,,7.97,,"-395,644.55"
,IN,AR,30313216,1005,100,,Invoice,,,,,,14/05/2018,14/05/2018,0.00,,147.12,,"-395,791.67"
,IN,AR,30313220,1005,100,,Invoice,,,,,,14/05/2018,14/05/2018,0.00,,11.02,,"-395,802.69"
,IN,AR,30313233,1005,100,,Invoice,,,,,,14/05/2018,14/05/2018,0.00,,44.00,,"-395,846.69"
,IN,AR,30313258,1005,100,,Invoice,,,,,,14/05/2018,14/05/2018,0.00,,36.00,,"-395,882.69"
,IN,AR,30313259,1005,100,,Invoice,,,,,,14/05/2018,14/05/2018,0.00,,16.00,,"-395,898.69"
,IN,AR,30313264,1005,100,,Invoice,,,,,,14/05/2018,14/05/2018,0.00,,11.02,,"-395,909.71"
,IN,AR,30313267,1005,100,,Invoice,,,,,,14/05/2018,14/05/2018,0.00,,25.42,,"-395,935.13"
,IN,AR,30313269,1005,100,,Invoice,,,,,,14/05/2018,14/05/2018,0.00,,11.02,,"-395,946.15"
,IN,AR,30313278,1005,100,,Invoice,,,,,,14/05/2018,14/05/2018,0.00,,3.89,,"-395,950.04"
,IN,AR,30313296,1005,100,,Invoice,,,,,,14/05/2018,14/05/2018,0.00,,20.00,,"-395,970.04"
,IN,AR,30313303,1005,100,,Invoice,,,,,,14/05/2018,14/05/2018,0.00,,7.29,,"-395,977.33"
,IN,AR,30313343,1005,100,,Invoice,,,,,,14/05/2018,14/05/2018,0.00,,28.00,,"-396,005.33"
,IN,AR,30313359,1005,100,,Invoice,,,,,,14/05/2018,14/05/2018,0.00,,12.88,,"-396,018.21"
,IN,AR,30313369,1005,100,,Invoice,,,,,,14/05/2018,14/05/2018,0.00,,22.71,,"-396,040.92"
,IN,AR,30313382,1005,100,,Invoice,,,,,,14/05/2018,14/05/2018,0.00,,12.92,,"-396,053.84"
,IN,AR,30313394,1005,100,,Invoice,,,,,,14/05/2018,14/05/2018,0.00,,10.34,,"-396,064.18"
,IN,AR,30313402,1005,100,,Invoice,,,,,,14/05/2018,14/05/2018,0.00,,7.29,,"-396,071.47"
,IN,AR,30313409,1005,100,,Invoice,,,,,,14/05/2018,14/05/2018,0.00,,18.37,,"-396,089.84"
,IN,AR,30313411,1005,100,,Invoice,,,,,,14/05/2018,14/05/2018,0.00,,13.14,,"-396,102.98"
,IN,AR,30313426,1005,100,,Invoice,,,,,,14/05/2018,14/05/2018,0.00,,8.47,,"-396,111.45"
,IN,AR,30313430,1005,100,,Invoice,,,,,,14/05/2018,14/05/2018,0.00,,26.44,,"-396,137.89"
,IN,AR,30313444,1005,100,,Invoice,,,,,,14/05/2018,14/05/2018,0.00,,18.09,,"-396,155.98"
,IN,AR,30313462,1005,100,,Invoice,,,,,,14/05/2018,14/05/2018,0.00,,3.64,,"-396,159.62"
,IN,AR,30313484,1005,100,,Invoice,,,,,,14/05/2018,14/05/2018,0.00,,82.03,,"-396,241.65"
,IN,AR,30313492,1005,100,,Invoice,,,,,,14/05/2018,14/05/2018,0.00,,45.76,,"-396,287.41"
,IN,AR,30313506,1005,100,,Invoice,,,,,,14/05/2018,14/05/2018,0.00,,23.90,,"-396,311.31"
,IN,AR,30313520,1005,100,,Invoice,,,,,,14/05/2018,14/05/2018,0.00,,364.41,,"-396,675.72"
,IN,AR,30313523,1005,100,,Invoice,,,,,,14/05/2018,14/05/2018,0.00,,18.05,,"-396,693.77"
,IN,AR,30313570,1005,100,,Invoice,,,,,,14/05/2018,14/05/2018,0.00,,2.54,,"-396,696.31"
,IN,AR,30313600,1005,100,,Invoice,,,,,,14/05/2018,14/05/2018,0.00,,10.17,,"-396,706.48"
,IN,AR,30313672,1005,100,,Invoice,,,,,,14/05/2018,14/05/2018,0.00,,7.17,,"-396,713.65"
,IN,AR,30313685,1005,100,,Invoice,,,,,,14/05/2018,14/05/2018,0.00,,27.97,,"-396,741.62"
,IN,AR,30313693,1005,100,,Invoice,,,,,,14/05/2018,14/05/2018,0.00,,16.27,,"-396,757.89"
,IN,AR,30313709,1005,100,,Invoice,,,,,,14/05/2018,14/05/2018,0.00,,36.44,,"-396,794.33"
,IN,AR,30313716,1005,100,,Invoice,,,,,,14/05/2018,14/05/2018,0.00,,21.86,,"-396,816.19"
,IN,AR,30313728,1005,100,,Invoice,,,,,,14/05/2018,14/05/2018,0.00,,21.19,,"-396,837.38"
,IN,AR,30313736,1005,100,,Invoice,,,,,,14/05/2018,14/05/2018,0.00,,13.77,,"-396,851.15"
,IN,AR,30313752,1005,100,,Invoice,,,,,,14/05/2018,14/05/2018,0.00,,16.83,,"-396,867.98"
,IN,AR,30313755,1005,100,,Invoice,,,,,,14/05/2018,14/05/2018,0.00,,10.51,,"-396,878.49"
,IN,AR,30313809,1005,100,,Invoice,,,,,,14/05/2018,14/05/2018,0.00,,30.00,,"-396,908.49"
,IN,AR,30313837,1005,100,,Invoice,,,,,,14/05/2018,14/05/2018,0.00,,5.17,,"-396,913.66"
,IN,AR,30313849,1005,100,,Invoice,,,,,,14/05/2018,14/05/2018,0.00,,42.69,,"-396,956.35"
,IN,AR,30313920,1005,100,,Invoice,,,,,,14/05/2018,14/05/2018,0.00,,19.69,,"-396,976.04"
,IN,AR,30313943,1005,100,,Invoice,,,,,,14/05/2018,14/05/2018,0.00,,15.25,,"-396,991.29"
,IN,AR,30313955,1005,100,,Invoice,,,,,,14/05/2018,14/05/2018,0.00,,54.66,,"-397,045.95"
,IN,AR,30313964,1005,100,,Invoice,,,,,,14/05/2018,14/05/2018,0.00,,4.29,,"-397,050.24"
,IN,AR,30314008,1005,100,,Invoice,,,,,,14/05/2018,14/05/2018,0.00,,6.36,,"-397,056.60"
,IN,AR,30314021,1005,100,,Invoice,,,,,,14/05/2018,14/05/2018,0.00,,364.41,,"-397,421.01"
,IN,AR,30314028,1005,100,,Invoice,,,,,,14/05/2018,14/05/2018,0.00,,2.14,,"-397,423.15"
,IN,AR,30314039,1005,100,,Invoice,,,,,,14/05/2018,14/05/2018,0.00,,24.05,,"-397,447.20"
,IN,AR,30314041,1005,100,,Invoice,,,,,,14/05/2018,14/05/2018,0.00,,7.29,,"-397,454.49"
,IN,AR,30314089,1005,100,,Invoice,,,,,,14/05/2018,14/05/2018,0.00,,11.22,,"-397,465.71"
,IN,AR,30314092,1005,100,,Invoice,,,,,,14/05/2018,14/05/2018,0.00,,54.66,,"-397,520.37"
,IN,AR,30314099,1005,100,,Invoice,,,,,,14/05/2018,14/05/2018,0.00,,18.39,,"-397,538.76"
,IN,AR,30314109,1005,100,,Invoice,,,,,,14/05/2018,14/05/2018,0.00,,6.56,,"-397,545.32"
,IN,AR,30314122,1005,100,,Invoice,,,,,,14/05/2018,14/05/2018,0.00,,25.51,,"-397,570.83"
,IN,AR,30314141,1005,100,,Invoice,,,,,,14/05/2018,14/05/2018,0.00,,22.01,,"-397,592.84"
,IN,AR,30314152,1005,100,,Invoice,,,,,,14/05/2018,14/05/2018,0.00,,14.00,,"-397,606.84"
,IN,AR,30314182,1005,100,,Invoice,,,,,,14/05/2018,14/05/2018,0.00,,14.58,,"-397,621.42"
,IN,AR,30314186,1005,100,,Invoice,,,,,,14/05/2018,14/05/2018,0.00,,38.65,,"-397,660.07"
,IN,AR,30314199,1005,100,,Invoice,,,,,,14/05/2018,14/05/2018,0.00,,33.66,,"-397,693.73"
,IN,AR,30314221,1005,100,,Invoice,,,,,,14/05/2018,14/05/2018,0.00,,7.29,,"-397,701.02"
,IN,AR,30314256,1005,100,,Invoice,,,,,,14/05/2018,14/05/2018,0.00,,34.70,,"-397,735.72"
,IN,AR,30314275,1005,100,,Invoice,,,,,,14/05/2018,14/05/2018,0.00,,30.27,,"-397,765.99"
,IN,AR,30314333,1005,100,,Invoice,,,,,,14/05/2018,14/05/2018,0.00,,16.00,,"-397,781.99"
,IN,AR,30314343,1005,100,,Invoice,,,,,,14/05/2018,14/05/2018,0.00,,5.64,,"-397,787.63"
,IN,AR,30314385,1005,100,,Invoice,,,,,,14/05/2018,14/05/2018,0.00,,5.47,,"-397,793.10"
,IN,AR,30314406,1005,100,,Invoice,,,,,,14/05/2018,14/05/2018,0.00,,10.47,,"-397,803.57"
,IN,AR,30314417,1005,100,,Invoice,,,,,,14/05/2018,14/05/2018,0.00,,4.08,,"-397,807.65"
,IN,AR,30314421,1005,100,,Invoice,,,,,,14/05/2018,14/05/2018,0.00,,10.93,,"-397,818.58"
,IN,AR,30314456,1005,100,,Invoice,,,,,,14/05/2018,14/05/2018,0.00,,38.01,,"-397,856.59"
,IN,AR,30314503,1005,100,,Invoice,,,,,,14/05/2018,14/05/2018,0.00,,2.08,,"-397,858.67"
,IN,AR,30314504,1005,100,,Invoice,,,,,,14/05/2018,14/05/2018,0.00,,4.15,,"-397,862.82"
,IN,AR,30314505,1005,100,,Invoice,,,,,,14/05/2018,14/05/2018,0.00,,12.46,,"-397,875.28"
,IN,AR,30314515,1005,100,,Invoice,,,,,,14/05/2018,14/05/2018,0.00,,13.12,,"-397,888.40"
,IN,AR,30314525,1005,100,,Invoice,,,,,,14/05/2018,14/05/2018,0.00,,39.44,,"-397,927.84"
,IN,AR,30314566,1005,100,,Invoice,,,,,,14/05/2018,14/05/2018,0.00,,25.51,,"-397,953.35"
,IN,AR,30314569,1005,100,,Invoice,,,,,,14/05/2018,14/05/2018,0.00,,182.20,,"-398,135.55"
,IN,AR,30314571,1005,100,,Invoice,,,,,,14/05/2018,14/05/2018,0.00,,29.15,,"-398,164.70"
,IN,AR,30314572,1005,100,,Invoice,,,,,,14/05/2018,14/05/2018,0.00,,10.93,,"-398,175.63"
,IN,AR,30314680,1005,100,,Invoice,,,,,,14/05/2018,14/05/2018,0.00,,59.38,,"-398,235.01"
,IN,AR,30314821,1005,100,,Invoice,,,,,,14/05/2018,14/05/2018,0.00,,11.86,,"-398,246.87"
,IN,AR,30314855,1005,100,,Invoice,,,,,,14/05/2018,14/05/2018,0.00,,19.32,,"-398,266.19"
,IN,AR,30314878,1005,100,,Invoice,,,,,,14/05/2018,14/05/2018,0.00,,6.36,,"-398,272.55"
,IN,AR,30314968,1005,100,,Invoice,,,,,,14/05/2018,14/05/2018,0.00,,7.29,,"-398,279.84"
,IN,AR,30314975,1005,100,,Invoice,,,,,,14/05/2018,14/05/2018,0.00,,11.48,,"-398,291.32"
,IN,AR,30314981,1005,100,,Invoice,,,,,,14/05/2018,14/05/2018,0.00,,3.64,,"-398,294.96"
,IN,AR,30315039,1005,100,,Invoice,,,,,,14/05/2018,14/05/2018,0.00,,11.23,,"-398,306.19"
,IN,AR,30315194,1005,100,,Invoice,,,,,,14/05/2018,14/05/2018,0.00,,6.86,,"-398,313.05"
,IN,AR,30315241,1005,100,,Invoice,,,,,,14/05/2018,14/05/2018,0.00,,54.31,,"-398,367.36"
,IN,AR,30315269,1005,100,,Invoice,,,,,,14/05/2018,14/05/2018,0.00,,214.41,,"-398,581.77"
,IN,AR,30315353,1005,100,,Invoice,,,,,,14/05/2018,14/05/2018,0.00,,3.76,,"-398,585.53"
,CS,AR,32003454,1005,100,,Cash sale,,,,,,15/05/2018,15/05/2018,0.00,,7.29,,"-398,592.82"
,CS,AR,32003466,1005,100,,Cash sale,,,,,,15/05/2018,15/05/2018,0.00,,3.64,,"-398,596.46"
,CS,AR,32003468,1005,100,,Cash sale,,,,,,15/05/2018,15/05/2018,0.00,,7.29,,"-398,603.75"
,CS,AR,32003486,1005,100,,Cash sale,,,,,,15/05/2018,15/05/2018,0.00,,3.01,,"-398,606.76"
,CS,AR,32003490,1005,100,,Cash sale,,,,,,15/05/2018,15/05/2018,0.00,,14.58,,"-398,621.34"
,CS,AR,32003523,1005,100,,Cash sale,,,,,,15/05/2018,15/05/2018,0.00,,14.58,,"-398,635.92"
,CS,AR,32003549,1005,100,,Cash sale,,,,,,15/05/2018,15/05/2018,0.00,,10.17,,"-398,646.09"
,CS,AR,32003552,1005,100,,Cash sale,,,,,,15/05/2018,15/05/2018,0.00,,3.64,,"-398,649.73"
,CS,AR,32003579,1005,100,,Cash sale,,,,,,15/05/2018,15/05/2018,0.00,,3.90,,"-398,653.63"
,CS,AR,32003582,1005,100,,Cash sale,,,,,,15/05/2018,15/05/2018,0.00,,10.34,,"-398,663.97"
,CS,AR,32003624,1005,100,,Cash sale,,,,,,15/05/2018,15/05/2018,0.00,,3.64,,"-398,667.61"
,CS,AR,32003646,1005,100,,Cash sale,,,,,,15/05/2018,15/05/2018,0.00,,7.29,,"-398,674.90"
,CS,AR,32003668,1005,100,,Cash sale,,,,,,15/05/2018,15/05/2018,0.00,,3.90,,"-398,678.80"
,CS,AR,32003673,1005,100,,Cash sale,,,,,,15/05/2018,15/05/2018,0.00,,10.93,,"-398,689.73"
,CS,AR,32003687,1005,100,,Cash sale,,,,,,15/05/2018,15/05/2018,0.00,,5.08,,"-398,694.81"
,CS,AR,32003698,1005,100,,Cash sale,,,,,,15/05/2018,15/05/2018,0.00,,96.27,,"-398,791.08"
,CS,AR,32003704,1005,100,,Cash sale,,,,,,15/05/2018,15/05/2018,0.00,,5.17,,"-398,796.25"
,CS,AR,32003707,1005,100,,Cash sale,,,,,,15/05/2018,15/05/2018,0.00,,3.90,,"-398,800.15"
,CS,AR,32003732,1005,100,,Cash sale,,,,,,15/05/2018,15/05/2018,0.00,,10.93,,"-398,811.08"
,CS,AR,32003745,1005,100,,Cash sale,,,,,,15/05/2018,15/05/2018,0.00,,2.58,,"-398,813.66"
,CS,AR,32003752,1005,100,,Cash sale,,,,,,15/05/2018,15/05/2018,0.00,,7.29,,"-398,820.95"
,CS,AR,32003779,1005,100,,Cash sale,,,,,,15/05/2018,15/05/2018,0.00,,5.18,,"-398,826.13"
,CS,AR,32003789,1005,100,,Cash sale,,,,,,15/05/2018,15/05/2018,0.00,,7.29,,"-398,833.42"
,CS,AR,32003818,1005,100,,Cash sale,,,,,,15/05/2018,15/05/2018,0.00,,26.00,,"-398,859.42"
,CS,AR,32003926,1005,100,,Cash sale,,,,,,15/05/2018,15/05/2018,0.00,,13.69,,"-398,873.11"
,CS,AR,32004001,1005,100,,Cash sale,,,,,,15/05/2018,15/05/2018,0.00,,6.07,,"-398,879.18"
,CS,AR,32004007,1005,100,,Cash sale,,,,,,15/05/2018,15/05/2018,0.00,,7.29,,"-398,886.47"
,IN,AR,30313177,1005,100,,Invoice,,,,,,15/05/2018,15/05/2018,0.00,,7.00,,"-398,893.47"
,IN,AR,30313217,1005,100,,Invoice,,,,,,15/05/2018,15/05/2018,0.00,,83.05,,"-398,976.52"
,IN,AR,30313304,1005,100,,Invoice,,,,,,15/05/2018,15/05/2018,0.00,,21.86,,"-398,998.38"
,IN,AR,30313308,1005,100,,Invoice,,,,,,15/05/2018,15/05/2018,0.00,,7.29,,"-399,005.67"
,IN,AR,30313347,1005,100,,Invoice,,,,,,15/05/2018,15/05/2018,0.00,,13.74,,"-399,019.41"
,IN,AR,30313348,1005,100,,Invoice,,,,,,15/05/2018,15/05/2018,0.00,,14.58,,"-399,033.99"
,IN,AR,30313397,1005,100,,Invoice,,,,,,15/05/2018,15/05/2018,0.00,,27.46,,"-399,061.45"
,IN,AR,30313399,1005,100,,Invoice,,,,,,15/05/2018,15/05/2018,0.00,,4.64,,"-399,066.09"
,IN,AR,30313418,1005,100,,Invoice,,,,,,15/05/2018,15/05/2018,0.00,,4.32,,"-399,070.41"
,IN,AR,30313421,1005,100,,Invoice,,,,,,15/05/2018,15/05/2018,0.00,,8.47,,"-399,078.88"
,IN,AR,30313431,1005,100,,Invoice,,,,,,15/05/2018,15/05/2018,0.00,,61.02,,"-399,139.90"
,IN,AR,30313456,1005,100,,Invoice,,,,,,15/05/2018,15/05/2018,0.00,,40.63,,"-399,180.53"
,IN,AR,30313507,1005,100,,Invoice,,,,,,15/05/2018,15/05/2018,0.00,,2.39,,"-399,182.92"
,IN,AR,30313545,1005,100,,Invoice,,,,,,15/05/2018,15/05/2018,0.00,,5.51,,"-399,188.43"
,IN,AR,30313582,1005,100,,Invoice,,,,,,15/05/2018,15/05/2018,0.00,,47.37,,"-399,235.80"
,IN,AR,30313687,1005,100,,Invoice,,,,,,15/05/2018,15/05/2018,0.00,,7.29,,"-399,243.09"
,IN,AR,30313698,1005,100,,Invoice,,,,,,15/05/2018,15/05/2018,0.00,,11.57,,"-399,254.66"
,IN,AR,30313705,1005,100,,Invoice,,,,,,15/05/2018,15/05/2018,0.00,,3.90,,"-399,258.56"
,IN,AR,30313708,1005,100,,Invoice,,,,,,15/05/2018,15/05/2018,0.00,,7.02,,"-399,265.58"
,IN,AR,30313718,1005,100,,Invoice,,,,,,15/05/2018,15/05/2018,0.00,,8.47,,"-399,274.05"
,IN,AR,30313726,1005,100,,Invoice,,,,,,15/05/2018,15/05/2018,0.00,,4.24,,"-399,278.29"
,IN,AR,30313733,1005,100,,Invoice,,,,,,15/05/2018,15/05/2018,0.00,,6.43,,"-399,284.72"
,IN,AR,30313742,1005,100,,Invoice,,,,,,15/05/2018,15/05/2018,0.00,,8.17,,"-399,292.89"
,IN,AR,30313758,1005,100,,Invoice,,,,,,15/05/2018,15/05/2018,0.00,,14.83,,"-399,307.72"
,IN,AR,30313781,1005,100,,Invoice,,,,,,15/05/2018,15/05/2018,0.00,,14.58,,"-399,322.30"
,IN,AR,30313796,1005,100,,Invoice,,,,,,15/05/2018,15/05/2018,0.00,,89.49,,"-399,411.79"
,IN,AR,30313812,1005,100,,Invoice,,,,,,15/05/2018,15/05/2018,0.00,,24.56,,"-399,436.35"
,IN,AR,30313832,1005,100,,Invoice,,,,,,15/05/2018,15/05/2018,0.00,,8.39,,"-399,444.74"
,IN,AR,30313840,1005,100,,Invoice,,,,,,15/05/2018,15/05/2018,0.00,,8.78,,"-399,453.52"
,IN,AR,30313845,1005,100,,Invoice,,,,,,15/05/2018,15/05/2018,0.00,,5.68,,"-399,459.20"
,IN,AR,30313875,1005,100,,Invoice,,,,,,15/05/2018,15/05/2018,0.00,,14.58,,"-399,473.78"
,IN,AR,30313876,1005,100,,Invoice,,,,,,15/05/2018,15/05/2018,0.00,,17.15,,"-399,490.93"
,IN,AR,30313882,1005,100,,Invoice,,,,,,15/05/2018,15/05/2018,0.00,,5.64,,"-399,496.57"
,IN,AR,30313886,1005,100,,Invoice,,,,,,15/05/2018,15/05/2018,0.00,,42.88,,"-399,539.45"
,IN,AR,30313903,1005,100,,Invoice,,,,,,15/05/2018,15/05/2018,0.00,,5.29,,"-399,544.74"
,IN,AR,30313927,1005,100,,Invoice,,,,,,15/05/2018,15/05/2018,0.00,,5.17,,"-399,549.91"
,IN,AR,30313931,1005,100,,Invoice,,,,,,15/05/2018,15/05/2018,0.00,,5.47,,"-399,555.38"
,IN,AR,30313937,1005,100,,Invoice,,,,,,15/05/2018,15/05/2018,0.00,,5.17,,"-399,560.55"
,IN,AR,30314009,1005,100,,Invoice,,,,,,15/05/2018,15/05/2018,0.00,,6.36,,"-399,566.91"
,IN,AR,30314010,1005,100,,Invoice,,,,,,15/05/2018,15/05/2018,0.00,,6.36,,"-399,573.27"
,IN,AR,30314062,1005,100,,Invoice,,,,,,15/05/2018,15/05/2018,0.00,,191.31,,"-399,764.58"
,IN,AR,30314090,1005,100,,Invoice,,,,,,15/05/2018,15/05/2018,0.00,,6.42,,"-399,771.00"
,IN,AR,30314119,1005,100,,Invoice,,,,,,15/05/2018,15/05/2018,0.00,,54.66,,"-399,825.66"
,IN,AR,30314125,1005,100,,Invoice,,,,,,15/05/2018,15/05/2018,0.00,,182.20,,"-400,007.86"
,IN,AR,30314135,1005,100,,Invoice,,,,,,15/05/2018,15/05/2018,0.00,,25.42,,"-400,033.28"
,IN,AR,30314145,1005,100,,Invoice,,,,,,15/05/2018,15/05/2018,0.00,,24.01,,"-400,057.29"
,IN,AR,30314193,1005,100,,Invoice,,,,,,15/05/2018,15/05/2018,0.00,,5.47,,"-400,062.76"
,IN,AR,30314238,1005,100,,Invoice,,,,,,15/05/2018,15/05/2018,0.00,,26.10,,"-400,088.86"
,IN,AR,30314316,1005,100,,Invoice,,,,,,15/05/2018,15/05/2018,0.00,,26.10,,"-400,114.96"
,IN,AR,30314348,1005,100,,Invoice,,,,,,15/05/2018,15/05/2018,0.00,,3.51,,"-400,118.47"
,IN,AR,30314351,1005,100,,Invoice,,,,,,15/05/2018,15/05/2018,0.00,,16.00,,"-400,134.47"
,IN,AR,30314353,1005,100,,Invoice,,,,,,15/05/2018,15/05/2018,0.00,,5.93,,"-400,140.40"
,IN,AR,30314369,1005,100,,Invoice,,,,,,15/05/2018,15/05/2018,0.00,,7.29,,"-400,147.69"
,IN,AR,30314372,1005,100,,Invoice,,,,,,15/05/2018,15/05/2018,0.00,,7.02,,"-400,154.71"
,IN,AR,30314393,1005,100,,Invoice,,,,,,15/05/2018,15/05/2018,0.00,,12.14,,"-400,166.85"
,IN,AR,30314410,1005,100,,Invoice,,,,,,15/05/2018,15/05/2018,0.00,,7.86,,"-400,174.71"
,IN,AR,30314449,1005,100,,Invoice,,,,,,15/05/2018,15/05/2018,0.00,,9.96,,"-400,184.67"
,IN,AR,30314506,1005,100,,Invoice,,,,,,15/05/2018,15/05/2018,0.00,,6.23,,"-400,190.90"
,IN,AR,30314507,1005,100,,Invoice,,,,,,15/05/2018,15/05/2018,0.00,,4.15,,"-400,195.05"
,IN,AR,30314508,1005,100,,Invoice,,,,,,15/05/2018,15/05/2018,0.00,,4.15,,"-400,199.20"
,IN,AR,30314518,1005,100,,Invoice,,,,,,15/05/2018,15/05/2018,0.00,,24.15,,"-400,223.35"
,IN,AR,30314520,1005,100,,Invoice,,,,,,15/05/2018,15/05/2018,0.00,,10.93,,"-400,234.28"
,CS,AR,32004109,1005,100,,Cash sale,,,,,,15/05/2018,15/05/2018,0.00,,6.48,,"-400,240.76"
,CS,AR,32004133,1005,100,,Cash sale,,,,,,15/05/2018,15/05/2018,0.00,,28.43,,"-400,269.19"
,CS,AR,32004172,1005,100,,Cash sale,,,,,,15/05/2018,15/05/2018,0.00,,2.39,,"-400,271.58"
,CS,AR,32004181,1005,100,,Cash sale,,,,,,15/05/2018,15/05/2018,0.00,,7.75,,"-400,279.33"
,CS,AR,32004209,1005,100,,Cash sale,,,,,,15/05/2018,15/05/2018,0.00,,7.29,,"-400,286.62"
,CS,AR,32004212,1005,100,,Cash sale,,,,,,15/05/2018,15/05/2018,0.00,,2.16,,"-400,288.78"
,CS,AR,32004214,1005,100,,Cash sale,,,,,,15/05/2018,15/05/2018,0.00,,7.29,,"-400,296.07"
,CS,AR,32004261,1005,100,,Cash sale,,,,,,15/05/2018,15/05/2018,0.00,,10.17,,"-400,306.24"
,CS,AR,32004301,1005,100,,Cash sale,,,,,,15/05/2018,15/05/2018,0.00,,2.75,,"-400,308.99"
,CS,AR,32004343,1005,100,,Cash sale,,,,,,15/05/2018,15/05/2018,0.00,,13.12,,"-400,322.11"
,IN,AR,30314579,1005,100,,Invoice,,,,,,15/05/2018,15/05/2018,0.00,,11.86,,"-400,333.97"
,IN,AR,30314649,1005,100,,Invoice,,,,,,15/05/2018,15/05/2018,0.00,,3.98,,"-400,337.95"
,IN,AR,30314660,1005,100,,Invoice,,,,,,15/05/2018,15/05/2018,0.00,,18.22,,"-400,356.17"
,IN,AR,30314675,1005,100,,Invoice,,,,,,15/05/2018,15/05/2018,0.00,,18.22,,"-400,374.39"
,IN,AR,30314699,1005,100,,Invoice,,,,,,15/05/2018,15/05/2018,0.00,,7.29,,"-400,381.68"
,IN,AR,30314723,1005,100,,Invoice,,,,,,15/05/2018,15/05/2018,0.00,,10.93,,"-400,392.61"
,IN,AR,30314786,1005,100,,Invoice,,,,,,15/05/2018,15/05/2018,0.00,,7.29,,"-400,399.90"
,IN,AR,30314803,1005,100,,Invoice,,,,,,15/05/2018,15/05/2018,0.00,,4.24,,"-400,404.14"
,IN,AR,30314829,1005,100,,Invoice,,,,,,15/05/2018,15/05/2018,0.00,,12.03,,"-400,416.17"
,IN,AR,30314927,1005,100,,Invoice,,,,,,15/05/2018,15/05/2018,0.00,,7.29,,"-400,423.46"
,IN,AR,30314931,1005,100,,Invoice,,,,,,15/05/2018,15/05/2018,0.00,,7.29,,"-400,430.75"
,IN,AR,30314951,1005,100,,Invoice,,,,,,15/05/2018,15/05/2018,0.00,,25.42,,"-400,456.17"
,IN,AR,30314962,1005,100,,Invoice,,,,,,15/05/2018,15/05/2018,0.00,,10.59,,"-400,466.76"
,IN,AR,30315138,1005,100,,Invoice,,,,,,15/05/2018,15/05/2018,0.00,,39.75,,"-400,506.51"
,IN,AR,30315196,1005,100,,Invoice,,,,,,15/05/2018,15/05/2018,0.00,,54.66,,"-400,561.17"
,IN,AR,30315232,1005,100,,Invoice,,,,,,15/05/2018,15/05/2018,0.00,,182.20,,"-400,743.37"
,IN,AR,30315290,1005,100,,Invoice,,,,,,15/05/2018,15/05/2018,0.00,,9.10,,"-400,752.47"
,IN,AR,30315326,1005,100,,Invoice,,,,,,15/05/2018,15/05/2018,0.00,,81.36,,"-400,833.83"
,IN,AR,30315332,1005,100,,Invoice,,,,,,15/05/2018,15/05/2018,0.00,,128.14,,"-400,961.97"
,IN,AR,30315333,1005,100,,Invoice,,,,,,15/05/2018,15/05/2018,0.00,,45.08,,"-401,007.05"
,IN,AR,30315363,1005,100,,Invoice,,,,,,15/05/2018,15/05/2018,0.00,,123.03,,"-401,130.08"
,IN,AR,30315484,1005,100,,Invoice,,,,,,15/05/2018,15/05/2018,0.00,,18.61,,"-401,148.69"
,CN,AR,31018027,1005,100,,Credit Note,,,,,,16/05/2018,16/05/2018,10.59,,0.00,,"-401,138.10"
,CS,AR,32004013,1005,100,,Cash sale,,,,,,16/05/2018,16/05/2018,0.00,,16.83,,"-401,154.93"
,CS,AR,32004022,1005,100,,Cash sale,,,,,,16/05/2018,16/05/2018,0.00,,3.64,,"-401,158.57"
,CS,AR,32004023,1005,100,,Cash sale,,,,,,16/05/2018,16/05/2018,0.00,,40.14,,"-401,198.71"
,CS,AR,32004042,1005,100,,Cash sale,,,,,,16/05/2018,16/05/2018,0.00,,3.64,,"-401,202.35"
,CS,AR,32004044,1005,100,,Cash sale,,,,,,16/05/2018,16/05/2018,0.00,,7.29,,"-401,209.64"
,CS,AR,32004053,1005,100,,Cash sale,,,,,,16/05/2018,16/05/2018,0.00,,10.93,,"-401,220.57"
,CS,AR,32004060,1005,100,,Cash sale,,,,,,16/05/2018,16/05/2018,0.00,,3.64,,"-401,224.21"
,CS,AR,32004070,1005,100,,Cash sale,,,,,,16/05/2018,16/05/2018,0.00,,3.64,,"-401,227.85"
,CS,AR,32004078,1005,100,,Cash sale,,,,,,16/05/2018,16/05/2018,0.00,,14.58,,"-401,242.43"
,CS,AR,32004081,1005,100,,Cash sale,,,,,,16/05/2018,16/05/2018,0.00,,14.58,,"-401,257.01"
,CS,AR,32004083,1005,100,,Cash sale,,,,,,16/05/2018,16/05/2018,0.00,,9.03,,"-401,266.04"
,CS,AR,32004099,1005,100,,Cash sale,,,,,,16/05/2018,16/05/2018,0.00,,5.86,,"-401,271.90"
,CS,AR,32004111,1005,100,,Cash sale,,,,,,16/05/2018,16/05/2018,0.00,,10.93,,"-401,282.83"
,CS,AR,32004122,1005,100,,Cash sale,,,,,,16/05/2018,16/05/2018,0.00,,5.17,,"-401,288.00"
,CS,AR,32004130,1005,100,,Cash sale,,,,,,16/05/2018,16/05/2018,0.00,,7.29,,"-401,295.29"
,CS,AR,32004138,1005,100,,Cash sale,,,,,,16/05/2018,16/05/2018,0.00,,15.04,,"-401,310.33"
,CS,AR,32004140,1005,100,,Cash sale,,,,,,16/05/2018,16/05/2018,0.00,,8.58,,"-401,318.91"
,CS,AR,32004147,1005,100,,Cash sale,,,,,,16/05/2018,16/05/2018,0.00,,18.22,,"-401,337.13"
,CS,AR,32004151,1005,100,,Cash sale,,,,,,16/05/2018,16/05/2018,0.00,,5.08,,"-401,342.21"
,CS,AR,32004173,1005,100,,Cash sale,,,,,,16/05/2018,16/05/2018,0.00,,7.29,,"-401,349.50"
,CS,AR,32004185,1005,100,,Cash sale,,,,,,16/05/2018,16/05/2018,0.00,,10.93,,"-401,360.43"
,CS,AR,32004193,1005,100,,Cash sale,,,,,,16/05/2018,16/05/2018,0.00,,10.93,,"-401,371.36"
,CS,AR,32004206,1005,100,,Cash sale,,,,,,16/05/2018,16/05/2018,0.00,,14.58,,"-401,385.94"
,CS,AR,32004218,1005,100,,Cash sale,,,,,,16/05/2018,16/05/2018,0.00,,2.71,,"-401,388.65"
,CS,AR,32004223,1005,100,,Cash sale,,,,,,16/05/2018,16/05/2018,0.00,,7.29,,"-401,395.94"
,CS,AR,32004230,1005,100,,Cash sale,,,,,,16/05/2018,16/05/2018,0.00,,7.29,,"-401,403.23"
,CS,AR,32004245,1005,100,,Cash sale,,,,,,16/05/2018,16/05/2018,0.00,,18.33,,"-401,421.56"
,CS,AR,32004256,1005,100,,Cash sale,,,,,,16/05/2018,16/05/2018,0.00,,20.34,,"-401,441.90"
,CS,AR,32004272,1005,100,,Cash sale,,,,,,16/05/2018,16/05/2018,0.00,,10.93,,"-401,452.83"
,CS,AR,32004282,1005,100,,Cash sale,,,,,,16/05/2018,16/05/2018,0.00,,9.15,,"-401,461.98"
,CS,AR,32004294,1005,100,,Cash sale,,,,,,16/05/2018,16/05/2018,0.00,,25.51,,"-401,487.49"
,CS,AR,32004306,1005,100,,Cash sale,,,,,,16/05/2018,16/05/2018,0.00,,9.03,,"-401,496.52"
,CS,AR,32004313,1005,100,,Cash sale,,,,,,16/05/2018,16/05/2018,0.00,,69.19,,"-401,565.71"
,CS,AR,32004316,1005,100,,Cash sale,,,,,,16/05/2018,16/05/2018,0.00,,10.93,,"-401,576.64"
,CS,AR,32004323,1005,100,,Cash sale,,,,,,16/05/2018,16/05/2018,0.00,,50.34,,"-401,626.98"
,CS,AR,32004332,1005,100,,Cash sale,,,,,,16/05/2018,16/05/2018,0.00,,15.17,,"-401,642.15"
,CS,AR,32004334,1005,100,,Cash sale,,,,,,16/05/2018,16/05/2018,0.00,,7.29,,"-401,649.44"
,CS,AR,32004337,1005,100,,Cash sale,,,,,,16/05/2018,16/05/2018,0.00,,7.29,,"-401,656.73"
,CS,AR,32004354,1005,100,,Cash sale,,,,,,16/05/2018,16/05/2018,0.00,,29.15,,"-401,685.88"
,CS,AR,32004363,1005,100,,Cash sale,,,,,,16/05/2018,16/05/2018,0.00,,10.99,,"-401,696.87"
,CS,AR,32004370,1005,100,,Cash sale,,,,,,16/05/2018,16/05/2018,0.00,,7.29,,"-401,704.16"
,IN,AR,30314580,1005,100,,Invoice,,,,,,16/05/2018,16/05/2018,0.00,,44.49,,"-401,748.65"
,IN,AR,30314594,1005,100,,Invoice,,,,,,16/05/2018,16/05/2018,0.00,,18.22,,"-401,766.87"
,IN,AR,30314596,1005,100,,Invoice,,,,,,16/05/2018,16/05/2018,0.00,,58.58,,"-401,825.45"
,IN,AR,30314597,1005,100,,Invoice,,,,,,16/05/2018,16/05/2018,0.00,,26.85,,"-401,852.30"
,IN,AR,30314608,1005,100,,Invoice,,,,,,16/05/2018,16/05/2018,0.00,,5.42,,"-401,857.72"
,IN,AR,30314614,1005,100,,Invoice,,,,,,16/05/2018,16/05/2018,0.00,,27.88,,"-401,885.60"
,IN,AR,30314616,1005,100,,Invoice,,,,,,16/05/2018,16/05/2018,0.00,,3.64,,"-401,889.24"
,IN,AR,30314619,1005,100,,Invoice,,,,,,16/05/2018,16/05/2018,0.00,,26.27,,"-401,915.51"
,IN,AR,30314620,1005,100,,Invoice,,,,,,16/05/2018,16/05/2018,0.00,,76.19,,"-401,991.70"
,IN,AR,30314624,1005,100,,Invoice,,,,,,16/05/2018,16/05/2018,0.00,,21.86,,"-402,013.56"
,IN,AR,30314651,1005,100,,Invoice,,,,,,16/05/2018,16/05/2018,0.00,,35.59,,"-402,049.15"
,IN,AR,30314679,1005,100,,Invoice,,,,,,16/05/2018,16/05/2018,0.00,,10.93,,"-402,060.08"
,IN,AR,30314686,1005,100,,Invoice,,,,,,16/05/2018,16/05/2018,0.00,,7.29,,"-402,067.37"
,IN,AR,30314692,1005,100,,Invoice,,,,,,16/05/2018,16/05/2018,0.00,,34.00,,"-402,101.37"
,IN,AR,30314710,1005,100,,Invoice,,,,,,16/05/2018,16/05/2018,0.00,,30.00,,"-402,131.37"
,IN,AR,30314712,1005,100,,Invoice,,,,,,16/05/2018,16/05/2018,0.00,,7.29,,"-402,138.66"
,IN,AR,30314722,1005,100,,Invoice,,,,,,16/05/2018,16/05/2018,0.00,,3.64,,"-402,142.30"
,IN,AR,30314732,1005,100,,Invoice,,,,,,16/05/2018,16/05/2018,0.00,,106.42,,"-402,248.72"
,IN,AR,30314748,1005,100,,Invoice,,,,,,16/05/2018,16/05/2018,0.00,,9.03,,"-402,257.75"
,IN,AR,30314757,1005,100,,Invoice,,,,,,16/05/2018,16/05/2018,0.00,,29.18,,"-402,286.93"
,IN,AR,30314788,1005,100,,Invoice,,,,,,16/05/2018,16/05/2018,0.00,,25.42,,"-402,312.35"
,IN,AR,30314793,1005,100,,Invoice,,,,,,16/05/2018,16/05/2018,0.00,,6.36,,"-402,318.71"
,IN,AR,30314802,1005,100,,Invoice,,,,,,16/05/2018,16/05/2018,0.00,,8.47,,"-402,327.18"
,IN,AR,30314807,1005,100,,Invoice,,,,,,16/05/2018,16/05/2018,0.00,,8.39,,"-402,335.57"
,IN,AR,30314831,1005,100,,Invoice,,,,,,16/05/2018,16/05/2018,0.00,,31.07,,"-402,366.64"
,IN,AR,30314837,1005,100,,Invoice,,,,,,16/05/2018,16/05/2018,0.00,,88.19,,"-402,454.83"
,IN,AR,30314880,1005,100,,Invoice,,,,,,16/05/2018,16/05/2018,0.00,,26.55,,"-402,481.38"
,IN,AR,30314885,1005,100,,Invoice,,,,,,16/05/2018,16/05/2018,0.00,,150.04,,"-402,631.42"
,IN,AR,30314893,1005,100,,Invoice,,,,,,16/05/2018,16/05/2018,0.00,,5.08,,"-402,636.50"
,IN,AR,30314906,1005,100,,Invoice,,,,,,16/05/2018,16/05/2018,0.00,,1.59,,"-402,638.09"
,IN,AR,30314918,1005,100,,Invoice,,,,,,16/05/2018,16/05/2018,0.00,,15.25,,"-402,653.34"
,IN,AR,30314925,1005,100,,Invoice,,,,,,16/05/2018,16/05/2018,0.00,,14.83,,"-402,668.17"
,IN,AR,30314936,1005,100,,Invoice,,,,,,16/05/2018,16/05/2018,0.00,,15.90,,"-402,684.07"
,IN,AR,30314963,1005,100,,Invoice,,,,,,16/05/2018,16/05/2018,0.00,,364.41,,"-403,048.48"
,IN,AR,30314977,1005,100,,Invoice,,,,,,16/05/2018,16/05/2018,0.00,,14.03,,"-403,062.51"
,IN,AR,30314982,1005,100,,Invoice,,,,,,16/05/2018,16/05/2018,0.00,,14.83,,"-403,077.34"
,IN,AR,30314988,1005,100,,Invoice,,,,,,16/05/2018,16/05/2018,0.00,,13.98,,"-403,091.32"
,IN,AR,30314996,1005,100,,Invoice,,,,,,16/05/2018,16/05/2018,0.00,,364.41,,"-403,455.73"
,IN,AR,30315000,1005,100,,Invoice,,,,,,16/05/2018,16/05/2018,0.00,,3.64,,"-403,459.37"
,IN,AR,30315004,1005,100,,Invoice,,,,,,16/05/2018,16/05/2018,0.00,,58.58,,"-403,517.95"
,IN,AR,30315030,1005,100,,Invoice,,,,,,16/05/2018,16/05/2018,0.00,,29.15,,"-403,547.10"
,IN,AR,30315033,1005,100,,Invoice,,,,,,16/05/2018,16/05/2018,0.00,,68.67,,"-403,615.77"
,IN,AR,30315040,1005,100,,Invoice,,,,,,16/05/2018,16/05/2018,0.00,,24.07,,"-403,639.84"
,IN,AR,30315064,1005,100,,Invoice,,,,,,16/05/2018,16/05/2018,0.00,,10.68,,"-403,650.52"
,IN,AR,30315068,1005,100,,Invoice,,,,,,16/05/2018,16/05/2018,0.00,,3.53,,"-403,654.05"
,IN,AR,30315069,1005,100,,Invoice,,,,,,16/05/2018,16/05/2018,0.00,,3.53,,"-403,657.58"
,IN,AR,30315070,1005,100,,Invoice,,,,,,16/05/2018,16/05/2018,0.00,,17.62,,"-403,675.20"
,IN,AR,30315075,1005,100,,Invoice,,,,,,16/05/2018,16/05/2018,0.00,,12.03,,"-403,687.23"
,IN,AR,30315082,1005,100,,Invoice,,,,,,16/05/2018,16/05/2018,0.00,,54.66,,"-403,741.89"
,IN,AR,30315088,1005,100,,Invoice,,,,,,16/05/2018,16/05/2018,0.00,,5.17,,"-403,747.06"
,IN,AR,30315095,1005,100,,Invoice,,,,,,16/05/2018,16/05/2018,0.00,,14.00,,"-403,761.06"
,IN,AR,30315097,1005,100,,Invoice,,,,,,16/05/2018,16/05/2018,0.00,,87.46,,"-403,848.52"
,IN,AR,30315098,1005,100,,Invoice,,,,,,16/05/2018,16/05/2018,0.00,,21.86,,"-403,870.38"
,IN,AR,30315135,1005,100,,Invoice,,,,,,16/05/2018,16/05/2018,0.00,,4.01,,"-403,874.39"
,IN,AR,30315142,1005,100,,Invoice,,,,,,16/05/2018,16/05/2018,0.00,,20.00,,"-403,894.39"
,IN,AR,30315148,1005,100,,Invoice,,,,,,16/05/2018,16/05/2018,0.00,,56.12,,"-403,950.51"
,IN,AR,30315156,1005,100,,Invoice,,,,,,16/05/2018,16/05/2018,0.00,,9.11,,"-403,959.62"
,IN,AR,30315159,1005,100,,Invoice,,,,,,16/05/2018,16/05/2018,0.00,,12.03,,"-403,971.65"
,IN,AR,30315161,1005,100,,Invoice,,,,,,16/05/2018,16/05/2018,0.00,,10.93,,"-403,982.58"
,IN,AR,30315162,1005,100,,Invoice,,,,,,16/05/2018,16/05/2018,0.00,,51.86,,"-404,034.44"
,IN,AR,30315166,1005,100,,Invoice,,,,,,16/05/2018,16/05/2018,0.00,,7.29,,"-404,041.73"
,IN,AR,30315168,1005,100,,Invoice,,,,,,16/05/2018,16/05/2018,0.00,,4.81,,"-404,046.54"
,IN,AR,30315169,1005,100,,Invoice,,,,,,16/05/2018,16/05/2018,0.00,,17.64,,"-404,064.18"
,IN,AR,30315170,1005,100,,Invoice,,,,,,16/05/2018,16/05/2018,0.00,,1.60,,"-404,065.78"
,IN,AR,30315171,1005,100,,Invoice,,,,,,16/05/2018,16/05/2018,0.00,,3.20,,"-404,068.98"
,IN,AR,30315172,1005,100,,Invoice,,,,,,16/05/2018,16/05/2018,0.00,,3.20,,"-404,072.18"
,IN,AR,30315173,1005,100,,Invoice,,,,,,16/05/2018,16/05/2018,0.00,,3.20,,"-404,075.38"
,IN,AR,30315174,1005,100,,Invoice,,,,,,16/05/2018,16/05/2018,0.00,,17.64,,"-404,093.02"
,IN,AR,30315197,1005,100,,Invoice,,,,,,16/05/2018,16/05/2018,0.00,,9.84,,"-404,102.86"
,IN,AR,30315199,1005,100,,Invoice,,,,,,16/05/2018,16/05/2018,0.00,,15.27,,"-404,118.13"
,IN,AR,30315204,1005,100,,Invoice,,,,,,16/05/2018,16/05/2018,0.00,,46.57,,"-404,164.70"
,IN,AR,30315213,1005,100,,Invoice,,,,,,16/05/2018,16/05/2018,0.00,,5.08,,"-404,169.78"
,IN,AR,30315242,1005,100,,Invoice,,,,,,16/05/2018,16/05/2018,0.00,,3.02,,"-404,172.80"
,IN,AR,30315252,1005,100,,Invoice,,,,,,16/05/2018,16/05/2018,0.00,,25.23,,"-404,198.03"
,IN,AR,30315253,1005,100,,Invoice,,,,,,16/05/2018,16/05/2018,0.00,,23.13,,"-404,221.16"
,IN,AR,30315258,1005,100,,Invoice,,,,,,16/05/2018,16/05/2018,0.00,,29.87,,"-404,251.03"
,IN,AR,30315280,1005,100,,Invoice,,,,,,16/05/2018,16/05/2018,0.00,,27.46,,"-404,278.49"
,IN,AR,30315285,1005,100,,Invoice,,,,,,16/05/2018,16/05/2018,0.00,,12.85,,"-404,291.34"
,IN,AR,30315288,1005,100,,Invoice,,,,,,16/05/2018,16/05/2018,0.00,,104.00,,"-404,395.34"
,IN,AR,30315303,1005,100,,Invoice,,,,,,16/05/2018,16/05/2018,0.00,,2.54,,"-404,397.88"
,IN,AR,30315312,1005,100,,Invoice,,,,,,16/05/2018,16/05/2018,0.00,,9.56,,"-404,407.44"
,IN,AR,30315355,1005,100,,Invoice,,,,,,16/05/2018,16/05/2018,0.00,,3.51,,"-404,410.95"
,IN,AR,30315378,1005,100,,Invoice,,,,,,16/05/2018,16/05/2018,0.00,,12.71,,"-404,423.66"
,IN,AR,30315382,1005,100,,Invoice,,,,,,16/05/2018,16/05/2018,0.00,,7.53,,"-404,431.19"
,IN,AR,30315392,1005,100,,Invoice,,,,,,16/05/2018,16/05/2018,0.00,,54.66,,"-404,485.85"
,IN,AR,30315400,1005,100,,Invoice,,,,,,16/05/2018,16/05/2018,0.00,,16.78,,"-404,502.63"
,IN,AR,30315402,1005,100,,Invoice,,,,,,16/05/2018,16/05/2018,0.00,,16.34,,"-404,518.97"
,IN,AR,30315426,1005,100,,Invoice,,,,,,16/05/2018,16/05/2018,0.00,,11.44,,"-404,530.41"
,IN,AR,30315431,1005,100,,Invoice,,,,,,16/05/2018,16/05/2018,0.00,,9.11,,"-404,539.52"
,IN,AR,30315446,1005,100,,Invoice,,,,,,16/05/2018,16/05/2018,0.00,,43.60,,"-404,583.12"
,IN,AR,30315447,1005,100,,Invoice,,,,,,16/05/2018,16/05/2018,0.00,,16.61,,"-404,599.73"
,IN,AR,30315448,1005,100,,Invoice,,,,,,16/05/2018,16/05/2018,0.00,,20.76,,"-404,620.49"
,IN,AR,30315449,1005,100,,Invoice,,,,,,16/05/2018,16/05/2018,0.00,,33.22,,"-404,653.71"
,IN,AR,30315474,1005,100,,Invoice,,,,,,16/05/2018,16/05/2018,0.00,,5.08,,"-404,658.79"
,IN,AR,30315486,1005,100,,Invoice,,,,,,16/05/2018,16/05/2018,0.00,,7.29,,"-404,666.08"
,CN,AR,31017996,1005,100,,Credit Note,,,,,,17/05/2018,17/05/2018,36.44,,0.00,,"-404,629.64"
,CN,AR,31018000,1005,100,,Credit Note,,,,,,17/05/2018,17/05/2018,25.51,,0.00,,"-404,604.13"
,CN,AR,31018025,1005,100,,Credit Note,,,,,,17/05/2018,17/05/2018,54.66,,0.00,,"-404,549.47"
,CN,AR,31018047,1005,100,,Credit Note,,,,,,17/05/2018,17/05/2018,2.75,,0.00,,"-404,546.72"
,CN,AR,31018070,1005,100,,Credit Note,,,,,,17/05/2018,17/05/2018,546.61,,0.00,,"-404,000.11"
,CR,AR,33000145,1005,100,,Cash Return,,,,,,17/05/2018,17/05/2018,69.19,,0.00,,"-403,930.92"
,CS,AR,32004011,1005,100,,Cash sale,,,,,,17/05/2018,17/05/2018,0.00,,18.05,,"-403,948.97"
,CS,AR,32004018,1005,100,,Cash sale,,,,,,17/05/2018,17/05/2018,0.00,,26.10,,"-403,975.07"
,CS,AR,32004041,1005,100,,Cash sale,,,,,,17/05/2018,17/05/2018,0.00,,7.29,,"-403,982.36"
,CS,AR,32004045,1005,100,,Cash sale,,,,,,17/05/2018,17/05/2018,0.00,,7.29,,"-403,989.65"
,CS,AR,32004049,1005,100,,Cash sale,,,,,,17/05/2018,17/05/2018,0.00,,36.44,,"-404,026.09"
,CS,AR,32004056,1005,100,,Cash sale,,,,,,17/05/2018,17/05/2018,0.00,,69.19,,"-404,095.28"
,CS,AR,32004058,1005,100,,Cash sale,,,,,,17/05/2018,17/05/2018,0.00,,14.58,,"-404,109.86"
,CS,AR,32004067,1005,100,,Cash sale,,,,,,17/05/2018,17/05/2018,0.00,,3.64,,"-404,113.50"
,CS,AR,32004077,1005,100,,Cash sale,,,,,,17/05/2018,17/05/2018,0.00,,3.64,,"-404,117.14"
,CS,AR,32004087,1005,100,,Cash sale,,,,,,17/05/2018,17/05/2018,0.00,,3.64,,"-404,120.78"
,CS,AR,32004097,1005,100,,Cash sale,,,,,,17/05/2018,17/05/2018,0.00,,3.01,,"-404,123.79"
,CS,AR,32004101,1005,100,,Cash sale,,,,,,17/05/2018,17/05/2018,0.00,,10.93,,"-404,134.72"
,CS,AR,32004110,1005,100,,Cash sale,,,,,,17/05/2018,17/05/2018,0.00,,7.29,,"-404,142.01"
,CS,AR,32004124,1005,100,,Cash sale,,,,,,17/05/2018,17/05/2018,0.00,,3.64,,"-404,145.65"
,CS,AR,32004167,1005,100,,Cash sale,,,,,,17/05/2018,17/05/2018,0.00,,10.21,,"-404,155.86"
,CS,AR,32004175,1005,100,,Cash sale,,,,,,17/05/2018,17/05/2018,0.00,,19.28,,"-404,175.14"
,CS,AR,32004178,1005,100,,Cash sale,,,,,,17/05/2018,17/05/2018,0.00,,7.29,,"-404,182.43"
,CS,AR,32004186,1005,100,,Cash sale,,,,,,17/05/2018,17/05/2018,0.00,,7.29,,"-404,189.72"
,CS,AR,32004189,1005,100,,Cash sale,,,,,,17/05/2018,17/05/2018,0.00,,7.29,,"-404,197.01"
,CS,AR,32004196,1005,100,,Cash sale,,,,,,17/05/2018,17/05/2018,0.00,,36.36,,"-404,233.37"
,CS,AR,32004198,1005,100,,Cash sale,,,,,,17/05/2018,17/05/2018,0.00,,12.92,,"-404,246.29"
,CS,AR,32004201,1005,100,,Cash sale,,,,,,17/05/2018,17/05/2018,0.00,,3.64,,"-404,249.93"
,CS,AR,32004208,1005,100,,Cash sale,,,,,,17/05/2018,17/05/2018,0.00,,10.93,,"-404,260.86"
,CS,AR,32004221,1005,100,,Cash sale,,,,,,17/05/2018,17/05/2018,0.00,,14.58,,"-404,275.44"
,CS,AR,32004224,1005,100,,Cash sale,,,,,,17/05/2018,17/05/2018,0.00,,2.58,,"-404,278.02"
,CS,AR,32004239,1005,100,,Cash sale,,,,,,17/05/2018,17/05/2018,0.00,,3.64,,"-404,281.66"
,CS,AR,32004244,1005,100,,Cash sale,,,,,,17/05/2018,17/05/2018,0.00,,7.29,,"-404,288.95"
,CS,AR,32004259,1005,100,,Cash sale,,,,,,17/05/2018,17/05/2018,0.00,,10.93,,"-404,299.88"
,CS,AR,32004268,1005,100,,Cash sale,,,,,,17/05/2018,17/05/2018,0.00,,12.14,,"-404,312.02"
,CS,AR,32004270,1005,100,,Cash sale,,,,,,17/05/2018,17/05/2018,0.00,,11.02,,"-404,323.04"
,CS,AR,32004271,1005,100,,Cash sale,,,,,,17/05/2018,17/05/2018,0.00,,8.90,,"-404,331.94"
,CS,AR,32004293,1005,100,,Cash sale,,,,,,17/05/2018,17/05/2018,0.00,,11.86,,"-404,343.80"
,CS,AR,32004304,1005,100,,Cash sale,,,,,,17/05/2018,17/05/2018,0.00,,29.15,,"-404,372.95"
,CS,AR,32004309,1005,100,,Cash sale,,,,,,17/05/2018,17/05/2018,0.00,,10.93,,"-404,383.88"
,CS,AR,32004344,1005,100,,Cash sale,,,,,,17/05/2018,17/05/2018,0.00,,10.93,,"-404,394.81"
,CS,AR,32004345,1005,100,,Cash sale,,,,,,17/05/2018,17/05/2018,0.00,,10.93,,"-404,405.74"
,CS,AR,32004348,1005,100,,Cash sale,,,,,,17/05/2018,17/05/2018,0.00,,10.93,,"-404,416.67"
,CS,AR,32004359,1005,100,,Cash sale,,,,,,17/05/2018,17/05/2018,0.00,,7.29,,"-404,423.96"
,CS,AR,32004362,1005,100,,Cash sale,,,,,,17/05/2018,17/05/2018,0.00,,7.29,,"-404,431.25"
,CS,AR,32004365,1005,100,,Cash sale,,,,,,17/05/2018,17/05/2018,0.00,,3.64,,"-404,434.89"
,CS,AR,32004428,1005,100,,Cash sale,,,,,,17/05/2018,17/05/2018,0.00,,10.93,,"-404,445.82"
,IN,AR,30314588,1005,100,,Invoice,,,,,,17/05/2018,17/05/2018,0.00,,3.64,,"-404,449.46"
,IN,AR,30314615,1005,100,,Invoice,,,,,,17/05/2018,17/05/2018,0.00,,3.64,,"-404,453.10"
,IN,AR,30314628,1005,100,,Invoice,,,,,,17/05/2018,17/05/2018,0.00,,40.08,,"-404,493.18"
,IN,AR,30314631,1005,100,,Invoice,,,,,,17/05/2018,17/05/2018,0.00,,4.07,,"-404,497.25"
,IN,AR,30314639,1005,100,,Invoice,,,,,,17/05/2018,17/05/2018,0.00,,18.22,,"-404,515.47"
,IN,AR,30314641,1005,100,,Invoice,,,,,,17/05/2018,17/05/2018,0.00,,29.15,,"-404,544.62"
,IN,AR,30314652,1005,100,,Invoice,,,,,,17/05/2018,17/05/2018,0.00,,33.22,,"-404,577.84"
,IN,AR,30314665,1005,100,,Invoice,,,,,,17/05/2018,17/05/2018,0.00,,30.00,,"-404,607.84"
,IN,AR,30314669,1005,100,,Invoice,,,,,,17/05/2018,17/05/2018,0.00,,25.48,,"-404,633.32"
,IN,AR,30314670,1005,100,,Invoice,,,,,,17/05/2018,17/05/2018,0.00,,54.66,,"-404,687.98"
,IN,AR,30314672,1005,100,,Invoice,,,,,,17/05/2018,17/05/2018,0.00,,14.58,,"-404,702.56"
,IN,AR,30314674,1005,100,,Invoice,,,,,,17/05/2018,17/05/2018,0.00,,43.73,,"-404,746.29"
,IN,AR,30314685,1005,100,,Invoice,,,,,,17/05/2018,17/05/2018,0.00,,51.02,,"-404,797.31"
,IN,AR,30314688,1005,100,,Invoice,,,,,,17/05/2018,17/05/2018,0.00,,7.29,,"-404,804.60"
,IN,AR,30314697,1005,100,,Invoice,,,,,,17/05/2018,17/05/2018,0.00,,7.29,,"-404,811.89"
,IN,AR,30314714,1005,100,,Invoice,,,,,,17/05/2018,17/05/2018,0.00,,78.31,,"-404,890.20"
,IN,AR,30314726,1005,100,,Invoice,,,,,,17/05/2018,17/05/2018,0.00,,32.95,,"-404,923.15"
,IN,AR,30314742,1005,100,,Invoice,,,,,,17/05/2018,17/05/2018,0.00,,7.29,,"-404,930.44"
,IN,AR,30314750,1005,100,,Invoice,,,,,,17/05/2018,17/05/2018,0.00,,25.51,,"-404,955.95"
,IN,AR,30314766,1005,100,,Invoice,,,,,,17/05/2018,17/05/2018,0.00,,14.58,,"-404,970.53"
,IN,AR,30314769,1005,100,,Invoice,,,,,,17/05/2018,17/05/2018,0.00,,21.86,,"-404,992.39"
,IN,AR,30314771,1005,100,,Invoice,,,,,,17/05/2018,17/05/2018,0.00,,21.00,,"-405,013.39"
,IN,AR,30314780,1005,100,,Invoice,,,,,,17/05/2018,17/05/2018,0.00,,7.17,,"-405,020.56"
,IN,AR,30314781,1005,100,,Invoice,,,,,,17/05/2018,17/05/2018,0.00,,4.80,,"-405,025.36"
,IN,AR,30314790,1005,100,,Invoice,,,,,,17/05/2018,17/05/2018,0.00,,29.15,,"-405,054.51"
,IN,AR,30314791,1005,100,,Invoice,,,,,,17/05/2018,17/05/2018,0.00,,12.03,,"-405,066.54"
,IN,AR,30314809,1005,100,,Invoice,,,,,,17/05/2018,17/05/2018,0.00,,2.12,,"-405,068.66"
,IN,AR,30314813,1005,100,,Invoice,,,,,,17/05/2018,17/05/2018,0.00,,14.58,,"-405,083.24"
,IN,AR,30314818,1005,100,,Invoice,,,,,,17/05/2018,17/05/2018,0.00,,169.52,,"-405,252.76"
,IN,AR,30314835,1005,100,,Invoice,,,,,,17/05/2018,17/05/2018,0.00,,16.95,,"-405,269.71"
,IN,AR,30314843,1005,100,,Invoice,,,,,,17/05/2018,17/05/2018,0.00,,91.53,,"-405,361.24"
,IN,AR,30314849,1005,100,,Invoice,,,,,,17/05/2018,17/05/2018,0.00,,14.34,,"-405,375.58"
,IN,AR,30314859,1005,100,,Invoice,,,,,,17/05/2018,17/05/2018,0.00,,12.88,,"-405,388.46"
,IN,AR,30314875,1005,100,,Invoice,,,,,,17/05/2018,17/05/2018,0.00,,15.04,,"-405,403.50"
,IN,AR,30314883,1005,100,,Invoice,,,,,,17/05/2018,17/05/2018,0.00,,7.29,,"-405,410.79"
,IN,AR,30314887,1005,100,,Invoice,,,,,,17/05/2018,17/05/2018,0.00,,5.08,,"-405,415.87"
,IN,AR,30314889,1005,100,,Invoice,,,,,,17/05/2018,17/05/2018,0.00,,4.24,,"-405,420.11"
,IN,AR,30314890,1005,100,,Invoice,,,,,,17/05/2018,17/05/2018,0.00,,2.39,,"-405,422.50"
,IN,AR,30314894,1005,100,,Invoice,,,,,,17/05/2018,17/05/2018,0.00,,7.63,,"-405,430.13"
,IN,AR,30314907,1005,100,,Invoice,,,,,,17/05/2018,17/05/2018,0.00,,49.39,,"-405,479.52"
,IN,AR,30314908,1005,100,,Invoice,,,,,,17/05/2018,17/05/2018,0.00,,46.20,,"-405,525.72"
,IN,AR,30314912,1005,100,,Invoice,,,,,,17/05/2018,17/05/2018,0.00,,12.87,,"-405,538.59"
,IN,AR,30314915,1005,100,,Invoice,,,,,,17/05/2018,17/05/2018,0.00,,2.58,,"-405,541.17"
,IN,AR,30314929,1005,100,,Invoice,,,,,,17/05/2018,17/05/2018,0.00,,54.66,,"-405,595.83"
,IN,AR,30314932,1005,100,,Invoice,,,,,,17/05/2018,17/05/2018,0.00,,3.64,,"-405,599.47"
,IN,AR,30314935,1005,100,,Invoice,,,,,,17/05/2018,17/05/2018,0.00,,5.17,,"-405,604.64"
,IN,AR,30314941,1005,100,,Invoice,,,,,,17/05/2018,17/05/2018,0.00,,25.42,,"-405,630.06"
,IN,AR,30314955,1005,100,,Invoice,,,,,,17/05/2018,17/05/2018,0.00,,30.22,,"-405,660.28"
,IN,AR,30314964,1005,100,,Invoice,,,,,,17/05/2018,17/05/2018,0.00,,14.58,,"-405,674.86"
,IN,AR,30314973,1005,100,,Invoice,,,,,,17/05/2018,17/05/2018,0.00,,16.47,,"-405,691.33"
,IN,AR,30314985,1005,100,,Invoice,,,,,,17/05/2018,17/05/2018,0.00,,6.86,,"-405,698.19"
,IN,AR,30314998,1005,100,,Invoice,,,,,,17/05/2018,17/05/2018,0.00,,6.36,,"-405,704.55"
,IN,AR,30315002,1005,100,,Invoice,,,,,,17/05/2018,17/05/2018,0.00,,10.59,,"-405,715.14"
,IN,AR,30315007,1005,100,,Invoice,,,,,,17/05/2018,17/05/2018,0.00,,10.17,,"-405,725.31"
,IN,AR,30315014,1005,100,,Invoice,,,,,,17/05/2018,17/05/2018,0.00,,4.64,,"-405,729.95"
,IN,AR,30315017,1005,100,,Invoice,,,,,,17/05/2018,17/05/2018,0.00,,8.77,,"-405,738.72"
,IN,AR,30315021,1005,100,,Invoice,,,,,,17/05/2018,17/05/2018,0.00,,16.53,,"-405,755.25"
,IN,AR,30315037,1005,100,,Invoice,,,,,,17/05/2018,17/05/2018,0.00,,16.66,,"-405,771.91"
,IN,AR,30315042,1005,100,,Invoice,,,,,,17/05/2018,17/05/2018,0.00,,21.06,,"-405,792.97"
,IN,AR,30315045,1005,100,,Invoice,,,,,,17/05/2018,17/05/2018,0.00,,16.48,,"-405,809.45"
,IN,AR,30315048,1005,100,,Invoice,,,,,,17/05/2018,17/05/2018,0.00,,17.47,,"-405,826.92"
,IN,AR,30315050,1005,100,,Invoice,,,,,,17/05/2018,17/05/2018,0.00,,10.17,,"-405,837.09"
,IN,AR,30315053,1005,100,,Invoice,,,,,,17/05/2018,17/05/2018,0.00,,28.39,,"-405,865.48"
,IN,AR,30315055,1005,100,,Invoice,,,,,,17/05/2018,17/05/2018,0.00,,8.00,,"-405,873.48"
,IN,AR,30315058,1005,100,,Invoice,,,,,,17/05/2018,17/05/2018,0.00,,9.85,,"-405,883.33"
,IN,AR,30315071,1005,100,,Invoice,,,,,,17/05/2018,17/05/2018,0.00,,3.53,,"-405,886.86"
,IN,AR,30315079,1005,100,,Invoice,,,,,,17/05/2018,17/05/2018,0.00,,3.64,,"-405,890.50"
,IN,AR,30315084,1005,100,,Invoice,,,,,,17/05/2018,17/05/2018,0.00,,4.54,,"-405,895.04"
,IN,AR,30315093,1005,100,,Invoice,,,,,,17/05/2018,17/05/2018,0.00,,14.58,,"-405,909.62"
,IN,AR,30315104,1005,100,,Invoice,,,,,,17/05/2018,17/05/2018,0.00,,5.68,,"-405,915.30"
,IN,AR,30315108,1005,100,,Invoice,,,,,,17/05/2018,17/05/2018,0.00,,3.64,,"-405,918.94"
,IN,AR,30315110,1005,100,,Invoice,,,,,,17/05/2018,17/05/2018,0.00,,20.34,,"-405,939.28"
,IN,AR,30315115,1005,100,,Invoice,,,,,,17/05/2018,17/05/2018,0.00,,3.25,,"-405,942.53"
,IN,AR,30315116,1005,100,,Invoice,,,,,,17/05/2018,17/05/2018,0.00,,17.90,,"-405,960.43"
,IN,AR,30315117,1005,100,,Invoice,,,,,,17/05/2018,17/05/2018,0.00,,13.02,,"-405,973.45"
,IN,AR,30315118,1005,100,,Invoice,,,,,,17/05/2018,17/05/2018,0.00,,9.76,,"-405,983.21"
,IN,AR,30315124,1005,100,,Invoice,,,,,,17/05/2018,17/05/2018,0.00,,19.08,,"-406,002.29"
,IN,AR,30315154,1005,100,,Invoice,,,,,,17/05/2018,17/05/2018,0.00,,24.03,,"-406,026.32"
,IN,AR,30315175,1005,100,,Invoice,,,,,,17/05/2018,17/05/2018,0.00,,14.43,,"-406,040.75"
,IN,AR,30315190,1005,100,,Invoice,,,,,,17/05/2018,17/05/2018,0.00,,10.93,,"-406,051.68"
,IN,AR,30315198,1005,100,,Invoice,,,,,,17/05/2018,17/05/2018,0.00,,9.84,,"-406,061.52"
,IN,AR,30315203,1005,100,,Invoice,,,,,,17/05/2018,17/05/2018,0.00,,10.93,,"-406,072.45"
,IN,AR,30315210,1005,100,,Invoice,,,,,,17/05/2018,17/05/2018,0.00,,10.93,,"-406,083.38"
,IN,AR,30315219,1005,100,,Invoice,,,,,,17/05/2018,17/05/2018,0.00,,20.01,,"-406,103.39"
,IN,AR,30315224,1005,100,,Invoice,,,,,,17/05/2018,17/05/2018,0.00,,20.01,,"-406,123.40"
,IN,AR,30315235,1005,100,,Invoice,,,,,,17/05/2018,17/05/2018,0.00,,14.58,,"-406,137.98"
,IN,AR,30315236,1005,100,,Invoice,,,,,,17/05/2018,17/05/2018,0.00,,11.66,,"-406,149.64"
,IN,AR,30315237,1005,100,,Invoice,,,,,,17/05/2018,17/05/2018,0.00,,14.58,,"-406,164.22"
,IN,AR,30315265,1005,100,,Invoice,,,,,,17/05/2018,17/05/2018,0.00,,21.86,,"-406,186.08"
,IN,AR,30315274,1005,100,,Invoice,,,,,,17/05/2018,17/05/2018,0.00,,11.22,,"-406,197.30"
,IN,AR,30315282,1005,100,,Invoice,,,,,,17/05/2018,17/05/2018,0.00,,5.68,,"-406,202.98"
,IN,AR,30315310,1005,100,,Invoice,,,,,,17/05/2018,17/05/2018,0.00,,121.73,,"-406,324.71"
,IN,AR,30315311,1005,100,,Invoice,,,,,,17/05/2018,17/05/2018,0.00,,25.51,,"-406,350.22"
,IN,AR,30315313,1005,100,,Invoice,,,,,,17/05/2018,17/05/2018,0.00,,6.37,,"-406,356.59"
,IN,AR,30315314,1005,100,,Invoice,,,,,,17/05/2018,17/05/2018,0.00,,122.68,,"-406,479.27"
,IN,AR,30315315,1005,100,,Invoice,,,,,,17/05/2018,17/05/2018,0.00,,6.37,,"-406,485.64"
,IN,AR,30315316,1005,100,,Invoice,,,,,,17/05/2018,17/05/2018,0.00,,12.75,,"-406,498.39"
,IN,AR,30315317,1005,100,,Invoice,,,,,,17/05/2018,17/05/2018,0.00,,12.75,,"-406,511.14"
,IN,AR,30315334,1005,100,,Invoice,,,,,,17/05/2018,17/05/2018,0.00,,26.10,,"-406,537.24"
,IN,AR,30315339,1005,100,,Invoice,,,,,,17/05/2018,17/05/2018,0.00,,24.41,,"-406,561.65"
,IN,AR,30315372,1005,100,,Invoice,,,,,,17/05/2018,17/05/2018,0.00,,3.64,,"-406,565.29"
,IN,AR,30315379,1005,100,,Invoice,,,,,,17/05/2018,17/05/2018,0.00,,8.75,,"-406,574.04"
,IN,AR,30315384,1005,100,,Invoice,,,,,,17/05/2018,17/05/2018,0.00,,18.20,,"-406,592.24"
,IN,AR,30315390,1005,100,,Invoice,,,,,,17/05/2018,17/05/2018,0.00,,2.92,,"-406,595.16"
,IN,AR,30315393,1005,100,,Invoice,,,,,,17/05/2018,17/05/2018,0.00,,72.88,,"-406,668.04"
,IN,AR,30315410,1005,100,,Invoice,,,,,,17/05/2018,17/05/2018,0.00,,32.80,,"-406,700.84"
,IN,AR,30315435,1005,100,,Invoice,,,,,,17/05/2018,17/05/2018,0.00,,39.44,,"-406,740.28"
,IN,AR,30315450,1005,100,,Invoice,,,,,,17/05/2018,17/05/2018,0.00,,2.08,,"-406,742.36"
,IN,AR,30315451,1005,100,,Invoice,,,,,,17/05/2018,17/05/2018,0.00,,4.15,,"-406,746.51"
,IN,AR,30315487,1005,100,,Invoice,,,,,,17/05/2018,17/05/2018,0.00,,7.29,,"-406,753.80"
,IN,AR,30315488,1005,100,,Invoice,,,,,,17/05/2018,17/05/2018,0.00,,7.25,,"-406,761.05"
,IN,AR,30315495,1005,100,,Invoice,,,,,,17/05/2018,17/05/2018,0.00,,6.56,,"-406,767.61"
,IN,AR,30315498,1005,100,,Invoice,,,,,,17/05/2018,17/05/2018,0.00,,24.27,,"-406,791.88"
,IN,AR,30315500,1005,100,,Invoice,,,,,,17/05/2018,17/05/2018,0.00,,29.15,,"-406,821.03"
,CN,AR,31018026,1005,100,,Credit Note,,,,,,18/05/2018,18/05/2018,8.39,,0.00,,"-406,812.64"
,CN,AR,31018052,1005,100,,Credit Note,,,,,,18/05/2018,18/05/2018,182.20,,0.00,,"-406,630.44"
,CN,AR,31018055,1005,100,,Credit Note,,,,,,18/05/2018,18/05/2018,419.07,,0.00,,"-406,211.37"
,CS,AR,32004009,1005,100,,Cash sale,,,,,,18/05/2018,18/05/2018,0.00,,35.72,,"-406,247.09"
,CS,AR,32004014,1005,100,,Cash sale,,,,,,18/05/2018,18/05/2018,0.00,,11.22,,"-406,258.31"
,CS,AR,32004020,1005,100,,Cash sale,,,,,,18/05/2018,18/05/2018,0.00,,16.78,,"-406,275.09"
,CS,AR,32004025,1005,100,,Cash sale,,,,,,18/05/2018,18/05/2018,0.00,,18.98,,"-406,294.07"
,CS,AR,32004029,1005,100,,Cash sale,,,,,,18/05/2018,18/05/2018,0.00,,14.19,,"-406,308.26"
,CS,AR,32004031,1005,100,,Cash sale,,,,,,18/05/2018,18/05/2018,0.00,,12.17,,"-406,320.43"
,CS,AR,32004034,1005,100,,Cash sale,,,,,,18/05/2018,18/05/2018,0.00,,18.22,,"-406,338.65"
,CS,AR,32004035,1005,100,,Cash sale,,,,,,18/05/2018,18/05/2018,0.00,,7.29,,"-406,345.94"
,CS,AR,32004037,1005,100,,Cash sale,,,,,,18/05/2018,18/05/2018,0.00,,3.64,,"-406,349.58"
,CS,AR,32004048,1005,100,,Cash sale,,,,,,18/05/2018,18/05/2018,0.00,,6.48,,"-406,356.06"
,CS,AR,32004059,1005,100,,Cash sale,,,,,,18/05/2018,18/05/2018,0.00,,10.93,,"-406,366.99"
,CS,AR,32004064,1005,100,,Cash sale,,,,,,18/05/2018,18/05/2018,0.00,,12.08,,"-406,379.07"
,CS,AR,32004073,1005,100,,Cash sale,,,,,,18/05/2018,18/05/2018,0.00,,7.29,,"-406,386.36"
,CS,AR,32004074,1005,100,,Cash sale,,,,,,18/05/2018,18/05/2018,0.00,,18.69,,"-406,405.05"
,CS,AR,32004113,1005,100,,Cash sale,,,,,,18/05/2018,18/05/2018,0.00,,25.51,,"-406,430.56"
,CS,AR,32004115,1005,100,,Cash sale,,,,,,18/05/2018,18/05/2018,0.00,,5.17,,"-406,435.73"
,CS,AR,32004117,1005,100,,Cash sale,,,,,,18/05/2018,18/05/2018,0.00,,12.71,,"-406,448.44"
,CS,AR,32004126,1005,100,,Cash sale,,,,,,18/05/2018,18/05/2018,0.00,,46.53,,"-406,494.97"
,CS,AR,32004128,1005,100,,Cash sale,,,,,,18/05/2018,18/05/2018,0.00,,27.47,,"-406,522.44"
,CS,AR,32004135,1005,100,,Cash sale,,,,,,18/05/2018,18/05/2018,0.00,,19.24,,"-406,541.68"
,CS,AR,32004144,1005,100,,Cash sale,,,,,,18/05/2018,18/05/2018,0.00,,10.93,,"-406,552.61"
,CS,AR,32004145,1005,100,,Cash sale,,,,,,18/05/2018,18/05/2018,0.00,,15.04,,"-406,567.65"
,CS,AR,32004146,1005,100,,Cash sale,,,,,,18/05/2018,18/05/2018,0.00,,10.93,,"-406,578.58"
,CS,AR,32004157,1005,100,,Cash sale,,,,,,18/05/2018,18/05/2018,0.00,,14.62,,"-406,593.20"
,CS,AR,32004162,1005,100,,Cash sale,,,,,,18/05/2018,18/05/2018,0.00,,24.07,,"-406,617.27"
,CS,AR,32004169,1005,100,,Cash sale,,,,,,18/05/2018,18/05/2018,0.00,,15.25,,"-406,632.52"
,CS,AR,32004176,1005,100,,Cash sale,,,,,,18/05/2018,18/05/2018,0.00,,3.64,,"-406,636.16"
,CS,AR,32004179,1005,100,,Cash sale,,,,,,18/05/2018,18/05/2018,0.00,,7.29,,"-406,643.45"
,CS,AR,32004215,1005,100,,Cash sale,,,,,,18/05/2018,18/05/2018,0.00,,7.29,,"-406,650.74"
,CS,AR,32004216,1005,100,,Cash sale,,,,,,18/05/2018,18/05/2018,0.00,,9.66,,"-406,660.40"
,CS,AR,32004234,1005,100,,Cash sale,,,,,,18/05/2018,18/05/2018,0.00,,11.12,,"-406,671.52"
,CS,AR,32004237,1005,100,,Cash sale,,,,,,18/05/2018,18/05/2018,0.00,,3.64,,"-406,675.16"
,CS,AR,32004238,1005,100,,Cash sale,,,,,,18/05/2018,18/05/2018,0.00,,7.29,,"-406,682.45"
,CS,AR,32004247,1005,100,,Cash sale,,,,,,18/05/2018,18/05/2018,0.00,,14.58,,"-406,697.03"
,CS,AR,32004251,1005,100,,Cash sale,,,,,,18/05/2018,18/05/2018,0.00,,10.93,,"-406,707.96"
,CS,AR,32004253,1005,100,,Cash sale,,,,,,18/05/2018,18/05/2018,0.00,,6.12,,"-406,714.08"
,CS,AR,32004255,1005,100,,Cash sale,,,,,,18/05/2018,18/05/2018,0.00,,3.64,,"-406,717.72"
,CS,AR,32004257,1005,100,,Cash sale,,,,,,18/05/2018,18/05/2018,0.00,,22.88,,"-406,740.60"
,CS,AR,32004264,1005,100,,Cash sale,,,,,,18/05/2018,18/05/2018,0.00,,46.00,,"-406,786.60"
,CS,AR,32004266,1005,100,,Cash sale,,,,,,18/05/2018,18/05/2018,0.00,,3.64,,"-406,790.24"
,CS,AR,32004276,1005,100,,Cash sale,,,,,,18/05/2018,18/05/2018,0.00,,12.71,,"-406,802.95"
,CS,AR,32004283,1005,100,,Cash sale,,,,,,18/05/2018,18/05/2018,0.00,,9.15,,"-406,812.10"
,CS,AR,32004299,1005,100,,Cash sale,,,,,,18/05/2018,18/05/2018,0.00,,7.29,,"-406,819.39"
,CS,AR,32004303,1005,100,,Cash sale,,,,,,18/05/2018,18/05/2018,0.00,,10.93,,"-406,830.32"
,CS,AR,32004308,1005,100,,Cash sale,,,,,,18/05/2018,18/05/2018,0.00,,21.86,,"-406,852.18"
,CS,AR,32004317,1005,100,,Cash sale,,,,,,18/05/2018,18/05/2018,0.00,,14.58,,"-406,866.76"
,CS,AR,32004325,1005,100,,Cash sale,,,,,,18/05/2018,18/05/2018,0.00,,9.15,,"-406,875.91"
,CS,AR,32004328,1005,100,,Cash sale,,,,,,18/05/2018,18/05/2018,0.00,,8.31,,"-406,884.22"
,CS,AR,32004339,1005,100,,Cash sale,,,,,,18/05/2018,18/05/2018,0.00,,15.21,,"-406,899.43"
,CS,AR,32004342,1005,100,,Cash sale,,,,,,18/05/2018,18/05/2018,0.00,,18.22,,"-406,917.65"
,CS,AR,32004350,1005,100,,Cash sale,,,,,,18/05/2018,18/05/2018,0.00,,7.29,,"-406,924.94"
,CS,AR,32004353,1005,100,,Cash sale,,,,,,18/05/2018,18/05/2018,0.00,,10.93,,"-406,935.87"
,CS,AR,32004361,1005,100,,Cash sale,,,,,,18/05/2018,18/05/2018,0.00,,6.56,,"-406,942.43"
,CS,AR,32004376,1005,100,,Cash sale,,,,,,18/05/2018,18/05/2018,0.00,,7.29,,"-406,949.72"
,CS,AR,32004377,1005,100,,Cash sale,,,,,,18/05/2018,18/05/2018,0.00,,7.29,,"-406,957.01"
,CS,AR,32004420,1005,100,,Cash sale,,,,,,18/05/2018,18/05/2018,0.00,,9.32,,"-406,966.33"
,CS,AR,32004424,1005,100,,Cash sale,,,,,,18/05/2018,18/05/2018,0.00,,3.64,,"-406,969.97"
,CS,AR,32004426,1005,100,,Cash sale,,,,,,18/05/2018,18/05/2018,0.00,,29.15,,"-406,999.12"
,IN,AR,30314575,1005,100,,Invoice,,,,,,18/05/2018,18/05/2018,0.00,,3.64,,"-407,002.76"
,IN,AR,30314581,1005,100,,Invoice,,,,,,18/05/2018,18/05/2018,0.00,,32.63,,"-407,035.39"
,IN,AR,30314586,1005,100,,Invoice,,,,,,18/05/2018,18/05/2018,0.00,,18.22,,"-407,053.61"
,IN,AR,30314610,1005,100,,Invoice,,,,,,18/05/2018,18/05/2018,0.00,,29.15,,"-407,082.76"
,IN,AR,30314626,1005,100,,Invoice,,,,,,18/05/2018,18/05/2018,0.00,,28.98,,"-407,111.74"
,IN,AR,30314633,1005,100,,Invoice,,,,,,18/05/2018,18/05/2018,0.00,,27.47,,"-407,139.21"
,IN,AR,30314643,1005,100,,Invoice,,,,,,18/05/2018,18/05/2018,0.00,,13.78,,"-407,152.99"
,IN,AR,30314645,1005,100,,Invoice,,,,,,18/05/2018,18/05/2018,0.00,,50.46,,"-407,203.45"
,IN,AR,30314646,1005,100,,Invoice,,,,,,18/05/2018,18/05/2018,0.00,,1.94,,"-407,205.39"
,IN,AR,30314653,1005,100,,Invoice,,,,,,18/05/2018,18/05/2018,0.00,,56.95,,"-407,262.34"
,IN,AR,30314673,1005,100,,Invoice,,,,,,18/05/2018,18/05/2018,0.00,,14.58,,"-407,276.92"
,IN,AR,30314689,1005,100,,Invoice,,,,,,18/05/2018,18/05/2018,0.00,,18.22,,"-407,295.14"
,IN,AR,30314708,1005,100,,Invoice,,,,,,18/05/2018,18/05/2018,0.00,,5.84,,"-407,300.98"
,IN,AR,30314715,1005,100,,Invoice,,,,,,18/05/2018,18/05/2018,0.00,,4.75,,"-407,305.73"
,IN,AR,30314718,1005,100,,Invoice,,,,,,18/05/2018,18/05/2018,0.00,,18.00,,"-407,323.73"
,IN,AR,30314735,1005,100,,Invoice,,,,,,18/05/2018,18/05/2018,0.00,,585.72,,"-407,909.45"
,IN,AR,30314739,1005,100,,Invoice,,,,,,18/05/2018,18/05/2018,0.00,,11.64,,"-407,921.09"
,IN,AR,30314741,1005,100,,Invoice,,,,,,18/05/2018,18/05/2018,0.00,,81.25,,"-408,002.34"
,IN,AR,30314743,1005,100,,Invoice,,,,,,18/05/2018,18/05/2018,0.00,,36.00,,"-408,038.34"
,IN,AR,30314752,1005,100,,Invoice,,,,,,18/05/2018,18/05/2018,0.00,,11.19,,"-408,049.53"
,IN,AR,30314753,1005,100,,Invoice,,,,,,18/05/2018,18/05/2018,0.00,,11.19,,"-408,060.72"
,IN,AR,30314756,1005,100,,Invoice,,,,,,18/05/2018,18/05/2018,0.00,,23.29,,"-408,084.01"
,IN,AR,30314764,1005,100,,Invoice,,,,,,18/05/2018,18/05/2018,0.00,,9.56,,"-408,093.57"
,IN,AR,30314773,1005,100,,Invoice,,,,,,18/05/2018,18/05/2018,0.00,,5.17,,"-408,098.74"
,IN,AR,30314797,1005,100,,Invoice,,,,,,18/05/2018,18/05/2018,0.00,,48.81,,"-408,147.55"
,IN,AR,30314810,1005,100,,Invoice,,,,,,18/05/2018,18/05/2018,0.00,,15.51,,"-408,163.06"
,IN,AR,30314814,1005,100,,Invoice,,,,,,18/05/2018,18/05/2018,0.00,,2.39,,"-408,165.45"
,IN,AR,30314824,1005,100,,Invoice,,,,,,18/05/2018,18/05/2018,0.00,,19.28,,"-408,184.73"
,IN,AR,30314838,1005,100,,Invoice,,,,,,18/05/2018,18/05/2018,0.00,,55.37,,"-408,240.10"
,IN,AR,30314850,1005,100,,Invoice,,,,,,18/05/2018,18/05/2018,0.00,,19.12,,"-408,259.22"
,IN,AR,30314882,1005,100,,Invoice,,,,,,18/05/2018,18/05/2018,0.00,,9.03,,"-408,268.25"
,IN,AR,30314895,1005,100,,Invoice,,,,,,18/05/2018,18/05/2018,0.00,,10.17,,"-408,278.42"
,IN,AR,30314896,1005,100,,Invoice,,,,,,18/05/2018,18/05/2018,0.00,,2.54,,"-408,280.96"
,IN,AR,30314902,1005,100,,Invoice,,,,,,18/05/2018,18/05/2018,0.00,,5.08,,"-408,286.04"
,IN,AR,30314922,1005,100,,Invoice,,,,,,18/05/2018,18/05/2018,0.00,,12.71,,"-408,298.75"
,IN,AR,30314934,1005,100,,Invoice,,,,,,18/05/2018,18/05/2018,0.00,,8.39,,"-408,307.14"
,IN,AR,30314938,1005,100,,Invoice,,,,,,18/05/2018,18/05/2018,0.00,,42.71,,"-408,349.85"
,IN,AR,30314940,1005,100,,Invoice,,,,,,18/05/2018,18/05/2018,0.00,,3.64,,"-408,353.49"
,IN,AR,30314971,1005,100,,Invoice,,,,,,18/05/2018,18/05/2018,0.00,,17.80,,"-408,371.29"
,IN,AR,30314978,1005,100,,Invoice,,,,,,18/05/2018,18/05/2018,0.00,,11.22,,"-408,382.51"
,IN,AR,30315026,1005,100,,Invoice,,,,,,18/05/2018,18/05/2018,0.00,,5.17,,"-408,387.68"
,IN,AR,30315029,1005,100,,Invoice,,,,,,18/05/2018,18/05/2018,0.00,,8.64,,"-408,396.32"
,IN,AR,30315035,1005,100,,Invoice,,,,,,18/05/2018,18/05/2018,0.00,,182.20,,"-408,578.52"
,IN,AR,30315038,1005,100,,Invoice,,,,,,18/05/2018,18/05/2018,0.00,,16.53,,"-408,595.05"
,IN,AR,30315080,1005,100,,Invoice,,,,,,18/05/2018,18/05/2018,0.00,,4.85,,"-408,599.90"
,IN,AR,30315091,1005,100,,Invoice,,,,,,18/05/2018,18/05/2018,0.00,,21.86,,"-408,621.76"
,IN,AR,30315105,1005,100,,Invoice,,,,,,18/05/2018,18/05/2018,0.00,,14.58,,"-408,636.34"
,IN,AR,30315139,1005,100,,Invoice,,,,,,18/05/2018,18/05/2018,0.00,,34.07,,"-408,670.41"
,IN,AR,30315150,1005,100,,Invoice,,,,,,18/05/2018,18/05/2018,0.00,,42.09,,"-408,712.50"
,IN,AR,30315153,1005,100,,Invoice,,,,,,18/05/2018,18/05/2018,0.00,,14.58,,"-408,727.08"
,IN,AR,30315176,1005,100,,Invoice,,,,,,18/05/2018,18/05/2018,0.00,,88.19,,"-408,815.27"
,IN,AR,30315192,1005,100,,Invoice,,,,,,18/05/2018,18/05/2018,0.00,,28.90,,"-408,844.17"
,IN,AR,30315206,1005,100,,Invoice,,,,,,18/05/2018,18/05/2018,0.00,,26.30,,"-408,870.47"
,IN,AR,30315214,1005,100,,Invoice,,,,,,18/05/2018,18/05/2018,0.00,,25.42,,"-408,895.89"
,IN,AR,30315227,1005,100,,Invoice,,,,,,18/05/2018,18/05/2018,0.00,,18.01,,"-408,913.90"
,IN,AR,30315234,1005,100,,Invoice,,,,,,18/05/2018,18/05/2018,0.00,,103.80,,"-409,017.70"
,IN,AR,30315250,1005,100,,Invoice,,,,,,18/05/2018,18/05/2018,0.00,,21.90,,"-409,039.60"
,IN,AR,30315254,1005,100,,Invoice,,,,,,18/05/2018,18/05/2018,0.00,,63.08,,"-409,102.68"
,IN,AR,30315261,1005,100,,Invoice,,,,,,18/05/2018,18/05/2018,0.00,,419.07,,"-409,521.75"
,IN,AR,30315262,1005,100,,Invoice,,,,,,18/05/2018,18/05/2018,0.00,,364.41,,"-409,886.16"
,IN,AR,30315278,1005,100,,Invoice,,,,,,18/05/2018,18/05/2018,0.00,,9.19,,"-409,895.35"
,IN,AR,30315283,1005,100,,Invoice,,,,,,18/05/2018,18/05/2018,0.00,,13.98,,"-409,909.33"
,IN,AR,30315292,1005,100,,Invoice,,,,,,18/05/2018,18/05/2018,0.00,,14.24,,"-409,923.57"
,IN,AR,30315302,1005,100,,Invoice,,,,,,18/05/2018,18/05/2018,0.00,,21.86,,"-409,945.43"
,IN,AR,30315304,1005,100,,Invoice,,,,,,18/05/2018,18/05/2018,0.00,,8.52,,"-409,953.95"
,IN,AR,30315306,1005,100,,Invoice,,,,,,18/05/2018,18/05/2018,0.00,,7.25,,"-409,961.20"
,IN,AR,30315330,1005,100,,Invoice,,,,,,18/05/2018,18/05/2018,0.00,,29.15,,"-409,990.35"
,IN,AR,30315350,1005,100,,Invoice,,,,,,18/05/2018,18/05/2018,0.00,,12.00,,"-410,002.35"
,IN,AR,30315373,1005,100,,Invoice,,,,,,18/05/2018,18/05/2018,0.00,,8.75,,"-410,011.10"
,IN,AR,30315374,1005,100,,Invoice,,,,,,18/05/2018,18/05/2018,0.00,,5.47,,"-410,016.57"
,IN,AR,30315380,1005,100,,Invoice,,,,,,18/05/2018,18/05/2018,0.00,,44.49,,"-410,061.06"
,IN,AR,30315394,1005,100,,Invoice,,,,,,18/05/2018,18/05/2018,0.00,,171.27,,"-410,232.33"
,IN,AR,30315395,1005,100,,Invoice,,,,,,18/05/2018,18/05/2018,0.00,,7.29,,"-410,239.62"
,IN,AR,30315403,1005,100,,Invoice,,,,,,18/05/2018,18/05/2018,0.00,,12.25,,"-410,251.87"
,IN,AR,30315413,1005,100,,Invoice,,,,,,18/05/2018,18/05/2018,0.00,,25.51,,"-410,277.38"
,IN,AR,30315422,1005,100,,Invoice,,,,,,18/05/2018,18/05/2018,0.00,,9.96,,"-410,287.34"
,IN,AR,30315436,1005,100,,Invoice,,,,,,18/05/2018,18/05/2018,0.00,,10.93,,"-410,298.27"
,IN,AR,30315439,1005,100,,Invoice,,,,,,18/05/2018,18/05/2018,0.00,,2.00,,"-410,300.27"
,IN,AR,30315440,1005,100,,Invoice,,,,,,18/05/2018,18/05/2018,0.00,,2.00,,"-410,302.27"
,IN,AR,30315452,1005,100,,Invoice,,,,,,18/05/2018,18/05/2018,0.00,,6.23,,"-410,308.50"
,IN,AR,30315453,1005,100,,Invoice,,,,,,18/05/2018,18/05/2018,0.00,,6.23,,"-410,314.73"
,IN,AR,30315454,1005,100,,Invoice,,,,,,18/05/2018,18/05/2018,0.00,,10.38,,"-410,325.11"
,IN,AR,30315455,1005,100,,Invoice,,,,,,18/05/2018,18/05/2018,0.00,,8.31,,"-410,333.42"
,IN,AR,30315479,1005,100,,Invoice,,,,,,18/05/2018,18/05/2018,0.00,,12.29,,"-410,345.71"
,IN,AR,30315491,1005,100,,Invoice,,,,,,18/05/2018,18/05/2018,0.00,,21.86,,"-410,367.57"
,IN,AR,30315499,1005,100,,Invoice,,,,,,18/05/2018,18/05/2018,0.00,,7.29,,"-410,374.86"
,CS,AR,32004054,1005,100,,Cash sale,,,,,,19/05/2018,19/05/2018,0.00,,10.93,,"-410,385.79"
,CS,AR,32004132,1005,100,,Cash sale,,,,,,19/05/2018,19/05/2018,0.00,,5.61,,"-410,391.40"
,CS,AR,32004289,1005,100,,Cash sale,,,,,,19/05/2018,19/05/2018,0.00,,10.93,,"-410,402.33"
,CS,AR,32004355,1005,100,,Cash sale,,,,,,19/05/2018,19/05/2018,0.00,,7.29,,"-410,409.62"
,CS,AR,32004368,1005,100,,Cash sale,,,,,,19/05/2018,19/05/2018,0.00,,15.59,,"-410,425.21"
,IN,AR,30314654,1005,100,,Invoice,,,,,,19/05/2018,19/05/2018,0.00,,42.71,,"-410,467.92"
,IN,AR,30314939,1005,100,,Invoice,,,,,,19/05/2018,19/05/2018,0.00,,7.29,,"-410,475.21"
,IN,AR,30315438,1005,100,,Invoice,,,,,,19/05/2018,19/05/2018,0.00,,3.64,,"-410,478.85"
,CS,AR,32004015,1005,100,,Cash sale,,,,,,21/05/2018,21/05/2018,0.00,,19.64,,"-410,498.49"
,CS,AR,32004026,1005,100,,Cash sale,,,,,,21/05/2018,21/05/2018,0.00,,18.98,,"-410,517.47"
,CS,AR,32004028,1005,100,,Cash sale,,,,,,21/05/2018,21/05/2018,0.00,,6.02,,"-410,523.49"
,CS,AR,32004038,1005,100,,Cash sale,,,,,,21/05/2018,21/05/2018,0.00,,14.58,,"-410,538.07"
,CS,AR,32004075,1005,100,,Cash sale,,,,,,21/05/2018,21/05/2018,0.00,,14.53,,"-410,552.60"
,CS,AR,32004082,1005,100,,Cash sale,,,,,,21/05/2018,21/05/2018,0.00,,7.29,,"-410,559.89"
,CS,AR,32004085,1005,100,,Cash sale,,,,,,21/05/2018,21/05/2018,0.00,,11.69,,"-410,571.58"
,CS,AR,32004086,1005,100,,Cash sale,,,,,,21/05/2018,21/05/2018,0.00,,14.58,,"-410,586.16"
,CS,AR,32004093,1005,100,,Cash sale,,,,,,21/05/2018,21/05/2018,0.00,,3.64,,"-410,589.80"
,CS,AR,32004103,1005,100,,Cash sale,,,,,,21/05/2018,21/05/2018,0.00,,3.64,,"-410,593.44"
,CS,AR,32004104,1005,100,,Cash sale,,,,,,21/05/2018,21/05/2018,0.00,,10.34,,"-410,603.78"
,CS,AR,32004112,1005,100,,Cash sale,,,,,,21/05/2018,21/05/2018,0.00,,7.29,,"-410,611.07"
,CS,AR,32004118,1005,100,,Cash sale,,,,,,21/05/2018,21/05/2018,0.00,,10.17,,"-410,621.24"
,CS,AR,32004136,1005,100,,Cash sale,,,,,,21/05/2018,21/05/2018,0.00,,8.25,,"-410,629.49"
,CS,AR,32004142,1005,100,,Cash sale,,,,,,21/05/2018,21/05/2018,0.00,,3.64,,"-410,633.13"
,CS,AR,32004158,1005,100,,Cash sale,,,,,,21/05/2018,21/05/2018,0.00,,14.62,,"-410,647.75"
,CS,AR,32004163,1005,100,,Cash sale,,,,,,21/05/2018,21/05/2018,0.00,,27.08,,"-410,674.83"
,CS,AR,32004187,1005,100,,Cash sale,,,,,,21/05/2018,21/05/2018,0.00,,10.51,,"-410,685.34"
,CS,AR,32004188,1005,100,,Cash sale,,,,,,21/05/2018,21/05/2018,0.00,,2.54,,"-410,687.88"
,CS,AR,32004200,1005,100,,Cash sale,,,,,,21/05/2018,21/05/2018,0.00,,5.17,,"-410,693.05"
,CS,AR,32004202,1005,100,,Cash sale,,,,,,21/05/2018,21/05/2018,0.00,,3.64,,"-410,696.69"
,CS,AR,32004204,1005,100,,Cash sale,,,,,,21/05/2018,21/05/2018,0.00,,5.85,,"-410,702.54"
,CS,AR,32004205,1005,100,,Cash sale,,,,,,21/05/2018,21/05/2018,0.00,,9.03,,"-410,711.57"
,CS,AR,32004211,1005,100,,Cash sale,,,,,,21/05/2018,21/05/2018,0.00,,7.29,,"-410,718.86"
,CS,AR,32004222,1005,100,,Cash sale,,,,,,21/05/2018,21/05/2018,0.00,,7.29,,"-410,726.15"
,CS,AR,32004227,1005,100,,Cash sale,,,,,,21/05/2018,21/05/2018,0.00,,11.11,,"-410,737.26"
,CS,AR,32004228,1005,100,,Cash sale,,,,,,21/05/2018,21/05/2018,0.00,,5.17,,"-410,742.43"
,CS,AR,32004231,1005,100,,Cash sale,,,,,,21/05/2018,21/05/2018,0.00,,6.42,,"-410,748.85"
,CS,AR,32004241,1005,100,,Cash sale,,,,,,21/05/2018,21/05/2018,0.00,,10.93,,"-410,759.78"
,CS,AR,32004252,1005,100,,Cash sale,,,,,,21/05/2018,21/05/2018,0.00,,7.29,,"-410,767.07"
,CS,AR,32004274,1005,100,,Cash sale,,,,,,21/05/2018,21/05/2018,0.00,,6.56,,"-410,773.63"
,CS,AR,32004275,1005,100,,Cash sale,,,,,,21/05/2018,21/05/2018,0.00,,14.58,,"-410,788.21"
,CS,AR,32004278,1005,100,,Cash sale,,,,,,21/05/2018,21/05/2018,0.00,,7.29,,"-410,795.50"
,CS,AR,32004284,1005,100,,Cash sale,,,,,,21/05/2018,21/05/2018,0.00,,11.44,,"-410,806.94"
,CS,AR,32004298,1005,100,,Cash sale,,,,,,21/05/2018,21/05/2018,0.00,,9.10,,"-410,816.04"
,CS,AR,32004300,1005,100,,Cash sale,,,,,,21/05/2018,21/05/2018,0.00,,14.58,,"-410,830.62"
,CS,AR,32004305,1005,100,,Cash sale,,,,,,21/05/2018,21/05/2018,0.00,,18.22,,"-410,848.84"
,CS,AR,32004318,1005,100,,Cash sale,,,,,,21/05/2018,21/05/2018,0.00,,10.93,,"-410,859.77"
,CS,AR,32004336,1005,100,,Cash sale,,,,,,21/05/2018,21/05/2018,0.00,,7.29,,"-410,867.06"
,CS,AR,32004367,1005,100,,Cash sale,,,,,,21/05/2018,21/05/2018,0.00,,35.08,,"-410,902.14"
,CS,AR,32004371,1005,100,,Cash sale,,,,,,21/05/2018,21/05/2018,0.00,,7.29,,"-410,909.43"
,CS,AR,32004372,1005,100,,Cash sale,,,,,,21/05/2018,21/05/2018,0.00,,7.29,,"-410,916.72"
,CS,AR,32004429,1005,100,,Cash sale,,,,,,21/05/2018,21/05/2018,0.00,,7.29,,"-410,924.01"
,IN,AR,30314582,1005,100,,Invoice,,,,,,21/05/2018,21/05/2018,0.00,,50.42,,"-410,974.43"
,IN,AR,30314590,1005,100,,Invoice,,,,,,21/05/2018,21/05/2018,0.00,,14.58,,"-410,989.01"
,IN,AR,30314600,1005,100,,Invoice,,,,,,21/05/2018,21/05/2018,0.00,,52.65,,"-411,041.66"
,IN,AR,30314601,1005,100,,Invoice,,,,,,21/05/2018,21/05/2018,0.00,,4.05,,"-411,045.71"
,IN,AR,30314602,1005,100,,Invoice,,,,,,21/05/2018,21/05/2018,0.00,,8.10,,"-411,053.81"
,IN,AR,30314603,1005,100,,Invoice,,,,,,21/05/2018,21/05/2018,0.00,,8.10,,"-411,061.91"
,IN,AR,30314604,1005,100,,Invoice,,,,,,21/05/2018,21/05/2018,0.00,,2.03,,"-411,063.94"
,IN,AR,30314605,1005,100,,Invoice,,,,,,21/05/2018,21/05/2018,0.00,,46.58,,"-411,110.52"
,IN,AR,30314606,1005,100,,Invoice,,,,,,21/05/2018,21/05/2018,0.00,,6.08,,"-411,116.60"
,IN,AR,30314625,1005,100,,Invoice,,,,,,21/05/2018,21/05/2018,0.00,,3.64,,"-411,120.24"
,IN,AR,30314634,1005,100,,Invoice,,,,,,21/05/2018,21/05/2018,0.00,,21.14,,"-411,141.38"
,IN,AR,30314636,1005,100,,Invoice,,,,,,21/05/2018,21/05/2018,0.00,,14.58,,"-411,155.96"
,IN,AR,30314637,1005,100,,Invoice,,,,,,21/05/2018,21/05/2018,0.00,,14.58,,"-411,170.54"
,IN,AR,30314648,1005,100,,Invoice,,,,,,21/05/2018,21/05/2018,0.00,,3.64,,"-411,174.18"
,IN,AR,30314655,1005,100,,Invoice,,,,,,21/05/2018,21/05/2018,0.00,,35.59,,"-411,209.77"
,IN,AR,30314656,1005,100,,Invoice,,,,,,21/05/2018,21/05/2018,0.00,,104.41,,"-411,314.18"
,IN,AR,30314661,1005,100,,Invoice,,,,,,21/05/2018,21/05/2018,0.00,,19.28,,"-411,333.46"
,IN,AR,30314666,1005,100,,Invoice,,,,,,21/05/2018,21/05/2018,0.00,,70.00,,"-411,403.46"
,IN,AR,30314668,1005,100,,Invoice,,,,,,21/05/2018,21/05/2018,0.00,,54.66,,"-411,458.12"
,IN,AR,30314681,1005,100,,Invoice,,,,,,21/05/2018,21/05/2018,0.00,,59.38,,"-411,517.50"
,IN,AR,30314693,1005,100,,Invoice,,,,,,21/05/2018,21/05/2018,0.00,,56.00,,"-411,573.50"
,IN,AR,30314694,1005,100,,Invoice,,,,,,21/05/2018,21/05/2018,0.00,,10.00,,"-411,583.50"
,IN,AR,30314702,1005,100,,Invoice,,,,,,21/05/2018,21/05/2018,0.00,,16.53,,"-411,600.03"
,IN,AR,30314703,1005,100,,Invoice,,,,,,21/05/2018,21/05/2018,0.00,,30.51,,"-411,630.54"
,IN,AR,30314704,1005,100,,Invoice,,,,,,21/05/2018,21/05/2018,0.00,,11.02,,"-411,641.56"
,IN,AR,30314719,1005,100,,Invoice,,,,,,21/05/2018,21/05/2018,0.00,,22.00,,"-411,663.56"
,IN,AR,30314744,1005,100,,Invoice,,,,,,21/05/2018,21/05/2018,0.00,,26.00,,"-411,689.56"
,IN,AR,30314755,1005,100,,Invoice,,,,,,21/05/2018,21/05/2018,0.00,,12.88,,"-411,702.44"
,IN,AR,30314758,1005,100,,Invoice,,,,,,21/05/2018,21/05/2018,0.00,,25.55,,"-411,727.99"
,IN,AR,30314768,1005,100,,Invoice,,,,,,21/05/2018,21/05/2018,0.00,,15.51,,"-411,743.50"
,IN,AR,30314775,1005,100,,Invoice,,,,,,21/05/2018,21/05/2018,0.00,,10.34,,"-411,753.84"
,IN,AR,30314782,1005,100,,Invoice,,,,,,21/05/2018,21/05/2018,0.00,,19.19,,"-411,773.03"
,IN,AR,30314785,1005,100,,Invoice,,,,,,21/05/2018,21/05/2018,0.00,,13.78,,"-411,786.81"
,IN,AR,30314795,1005,100,,Invoice,,,,,,21/05/2018,21/05/2018,0.00,,4.24,,"-411,791.05"
,IN,AR,30314798,1005,100,,Invoice,,,,,,21/05/2018,21/05/2018,0.00,,61.02,,"-411,852.07"
,IN,AR,30314811,1005,100,,Invoice,,,,,,21/05/2018,21/05/2018,0.00,,18.09,,"-411,870.16"
,IN,AR,30314822,1005,100,,Invoice,,,,,,21/05/2018,21/05/2018,0.00,,8.90,,"-411,879.06"
,IN,AR,30314823,1005,100,,Invoice,,,,,,21/05/2018,21/05/2018,0.00,,10.35,,"-411,889.41"
,IN,AR,30314828,1005,100,,Invoice,,,,,,21/05/2018,21/05/2018,0.00,,54.66,,"-411,944.07"
,IN,AR,30314839,1005,100,,Invoice,,,,,,21/05/2018,21/05/2018,0.00,,92.29,,"-412,036.36"
,IN,AR,30314851,1005,100,,Invoice,,,,,,21/05/2018,21/05/2018,0.00,,23.90,,"-412,060.26"
,IN,AR,30314852,1005,100,,Invoice,,,,,,21/05/2018,21/05/2018,0.00,,19.12,,"-412,079.38"
,IN,AR,30314856,1005,100,,Invoice,,,,,,21/05/2018,21/05/2018,0.00,,32.20,,"-412,111.58"
,IN,AR,30314864,1005,100,,Invoice,,,,,,21/05/2018,21/05/2018,0.00,,12.03,,"-412,123.61"
,IN,AR,30314865,1005,100,,Invoice,,,,,,21/05/2018,21/05/2018,0.00,,3.01,,"-412,126.62"
,IN,AR,30314867,1005,100,,Invoice,,,,,,21/05/2018,21/05/2018,0.00,,7.29,,"-412,133.91"
,IN,AR,30314868,1005,100,,Invoice,,,,,,21/05/2018,21/05/2018,0.00,,7.29,,"-412,141.20"
,IN,AR,30314870,1005,100,,Invoice,,,,,,21/05/2018,21/05/2018,0.00,,9.03,,"-412,150.23"
,IN,AR,30314871,1005,100,,Invoice,,,,,,21/05/2018,21/05/2018,0.00,,5.51,,"-412,155.74"
,IN,AR,30314872,1005,100,,Invoice,,,,,,21/05/2018,21/05/2018,0.00,,7.29,,"-412,163.03"
,IN,AR,30314879,1005,100,,Invoice,,,,,,21/05/2018,21/05/2018,0.00,,2.12,,"-412,165.15"
,IN,AR,30314897,1005,100,,Invoice,,,,,,21/05/2018,21/05/2018,0.00,,10.17,,"-412,175.32"
,IN,AR,30314914,1005,100,,Invoice,,,,,,21/05/2018,21/05/2018,0.00,,5.44,,"-412,180.76"
,IN,AR,30314942,1005,100,,Invoice,,,,,,21/05/2018,21/05/2018,0.00,,35.59,,"-412,216.35"
,IN,AR,30314947,1005,100,,Invoice,,,,,,21/05/2018,21/05/2018,0.00,,24.41,,"-412,240.76"
,IN,AR,30314950,1005,100,,Invoice,,,,,,21/05/2018,21/05/2018,0.00,,14.58,,"-412,255.34"
,IN,AR,30314958,1005,100,,Invoice,,,,,,21/05/2018,21/05/2018,0.00,,3.64,,"-412,258.98"
,IN,AR,30314960,1005,100,,Invoice,,,,,,21/05/2018,21/05/2018,0.00,,10.93,,"-412,269.91"
,IN,AR,30314966,1005,100,,Invoice,,,,,,21/05/2018,21/05/2018,0.00,,54.66,,"-412,324.57"
,IN,AR,30314967,1005,100,,Invoice,,,,,,21/05/2018,21/05/2018,0.00,,11.02,,"-412,335.59"
,IN,AR,30314969,1005,100,,Invoice,,,,,,21/05/2018,21/05/2018,0.00,,3.64,,"-412,339.23"
,IN,AR,30314976,1005,100,,Invoice,,,,,,21/05/2018,21/05/2018,0.00,,11.48,,"-412,350.71"
,IN,AR,30315003,1005,100,,Invoice,,,,,,21/05/2018,21/05/2018,0.00,,16.95,,"-412,367.66"
,IN,AR,30315011,1005,100,,Invoice,,,,,,21/05/2018,21/05/2018,0.00,,36.00,,"-412,403.66"
,IN,AR,30315016,1005,100,,Invoice,,,,,,21/05/2018,21/05/2018,0.00,,364.41,,"-412,768.07"
,IN,AR,30315036,1005,100,,Invoice,,,,,,21/05/2018,21/05/2018,0.00,,36.12,,"-412,804.19"
,IN,AR,30315052,1005,100,,Invoice,,,,,,21/05/2018,21/05/2018,0.00,,6.53,,"-412,810.72"
,IN,AR,30315078,1005,100,,Invoice,,,,,,21/05/2018,21/05/2018,0.00,,10.93,,"-412,821.65"
,IN,AR,30315087,1005,100,,Invoice,,,,,,21/05/2018,21/05/2018,0.00,,54.66,,"-412,876.31"
,IN,AR,30315103,1005,100,,Invoice,,,,,,21/05/2018,21/05/2018,0.00,,2.14,,"-412,878.45"
,IN,AR,30315107,1005,100,,Invoice,,,,,,21/05/2018,21/05/2018,0.00,,8.44,,"-412,886.89"
,IN,AR,30315146,1005,100,,Invoice,,,,,,21/05/2018,21/05/2018,0.00,,2.14,,"-412,889.03"
,IN,AR,30315151,1005,100,,Invoice,,,,,,21/05/2018,21/05/2018,0.00,,22.05,,"-412,911.08"
,IN,AR,30315177,1005,100,,Invoice,,,,,,21/05/2018,21/05/2018,0.00,,8.02,,"-412,919.10"
,IN,AR,30315193,1005,100,,Invoice,,,,,,21/05/2018,21/05/2018,0.00,,13.14,,"-412,932.24"
,IN,AR,30315195,1005,100,,Invoice,,,,,,21/05/2018,21/05/2018,0.00,,4.58,,"-412,936.82"
,IN,AR,30315200,1005,100,,Invoice,,,,,,21/05/2018,21/05/2018,0.00,,6.56,,"-412,943.38"
,IN,AR,30315222,1005,100,,Invoice,,,,,,21/05/2018,21/05/2018,0.00,,20.01,,"-412,963.39"
,IN,AR,30315223,1005,100,,Invoice,,,,,,21/05/2018,21/05/2018,0.00,,16.01,,"-412,979.40"
,IN,AR,30315228,1005,100,,Invoice,,,,,,21/05/2018,21/05/2018,0.00,,16.01,,"-412,995.41"
,IN,AR,30315231,1005,100,,Invoice,,,,,,21/05/2018,21/05/2018,0.00,,54.66,,"-413,050.07"
,IN,AR,30315240,1005,100,,Invoice,,,,,,21/05/2018,21/05/2018,0.00,,85.17,,"-413,135.24"
,IN,AR,30315243,1005,100,,Invoice,,,,,,21/05/2018,21/05/2018,0.00,,60.34,,"-413,195.58"
,IN,AR,30315263,1005,100,,Invoice,,,,,,21/05/2018,21/05/2018,0.00,,364.41,,"-413,559.99"
,IN,AR,30315268,1005,100,,Invoice,,,,,,21/05/2018,21/05/2018,0.00,,36.24,,"-413,596.23"
,IN,AR,30315270,1005,100,,Invoice,,,,,,21/05/2018,21/05/2018,0.00,,191.10,,"-413,787.33"
,IN,AR,30315275,1005,100,,Invoice,,,,,,21/05/2018,21/05/2018,0.00,,19.64,,"-413,806.97"
,IN,AR,30315299,1005,100,,Invoice,,,,,,21/05/2018,21/05/2018,0.00,,29.15,,"-413,836.12"
,IN,AR,30315309,1005,100,,Invoice,,,,,,21/05/2018,21/05/2018,0.00,,24.03,,"-413,860.15"
,IN,AR,30315318,1005,100,,Invoice,,,,,,21/05/2018,21/05/2018,0.00,,15.93,,"-413,876.08"
,IN,AR,30315351,1005,100,,Invoice,,,,,,21/05/2018,21/05/2018,0.00,,10.00,,"-413,886.08"
,IN,AR,30315354,1005,100,,Invoice,,,,,,21/05/2018,21/05/2018,0.00,,3.76,,"-413,889.84"
,IN,AR,30315375,1005,100,,Invoice,,,,,,21/05/2018,21/05/2018,0.00,,8.21,,"-413,898.05"
,IN,AR,30315387,1005,100,,Invoice,,,,,,21/05/2018,21/05/2018,0.00,,54.66,,"-413,952.71"
,IN,AR,30315396,1005,100,,Invoice,,,,,,21/05/2018,21/05/2018,0.00,,7.86,,"-413,960.57"
,IN,AR,30315398,1005,100,,Invoice,,,,,,21/05/2018,21/05/2018,0.00,,8.77,,"-413,969.34"
,IN,AR,30315399,1005,100,,Invoice,,,,,,21/05/2018,21/05/2018,0.00,,14.83,,"-413,984.17"
,IN,AR,30315404,1005,100,,Invoice,,,,,,21/05/2018,21/05/2018,0.00,,6.13,,"-413,990.30"
,IN,AR,30315432,1005,100,,Invoice,,,,,,21/05/2018,21/05/2018,0.00,,9.11,,"-413,999.41"
,IN,AR,30315441,1005,100,,Invoice,,,,,,21/05/2018,21/05/2018,0.00,,2.00,,"-414,001.41"
,IN,AR,30315442,1005,100,,Invoice,,,,,,21/05/2018,21/05/2018,0.00,,2.00,,"-414,003.41"
,IN,AR,30315456,1005,100,,Invoice,,,,,,21/05/2018,21/05/2018,0.00,,4.15,,"-414,007.56"
,IN,AR,30315457,1005,100,,Invoice,,,,,,21/05/2018,21/05/2018,0.00,,6.23,,"-414,013.79"
,IN,AR,30315458,1005,100,,Invoice,,,,,,21/05/2018,21/05/2018,0.00,,2.08,,"-414,015.87"
,IN,AR,30315459,1005,100,,Invoice,,,,,,21/05/2018,21/05/2018,0.00,,2.08,,"-414,017.95"
,IN,AR,30315460,1005,100,,Invoice,,,,,,21/05/2018,21/05/2018,0.00,,6.23,,"-414,024.18"
,IN,AR,30315492,1005,100,,Invoice,,,,,,21/05/2018,21/05/2018,0.00,,7.29,,"-414,031.47"
,IN,AR,30315502,1005,100,,Invoice,,,,,,21/05/2018,21/05/2018,0.00,,29.15,,"-414,060.62"
,CN,AR,31018051,1005,100,,Credit Note,,,,,,22/05/2018,22/05/2018,66.10,,0.00,,"-413,994.52"
,CS,AR,32004030,1005,100,,Cash sale,,,,,,22/05/2018,22/05/2018,0.00,,3.64,,"-413,998.16"
,CS,AR,32004036,1005,100,,Cash sale,,,,,,22/05/2018,22/05/2018,0.00,,3.64,,"-414,001.80"
,CS,AR,32004050,1005,100,,Cash sale,,,,,,22/05/2018,22/05/2018,0.00,,18.22,,"-414,020.02"
,CS,AR,32004055,1005,100,,Cash sale,,,,,,22/05/2018,22/05/2018,0.00,,3.64,,"-414,023.66"
,CS,AR,32004066,1005,100,,Cash sale,,,,,,22/05/2018,22/05/2018,0.00,,3.01,,"-414,026.67"
,CS,AR,32004069,1005,100,,Cash sale,,,,,,22/05/2018,22/05/2018,0.00,,7.29,,"-414,033.96"
,CS,AR,32004080,1005,100,,Cash sale,,,,,,22/05/2018,22/05/2018,0.00,,10.93,,"-414,044.89"
,CS,AR,32004090,1005,100,,Cash sale,,,,,,22/05/2018,22/05/2018,0.00,,14.58,,"-414,059.47"
,CS,AR,32004106,1005,100,,Cash sale,,,,,,22/05/2018,22/05/2018,0.00,,10.17,,"-414,069.64"
,CS,AR,32004120,1005,100,,Cash sale,,,,,,22/05/2018,22/05/2018,0.00,,5.17,,"-414,074.81"
,CS,AR,32004121,1005,100,,Cash sale,,,,,,22/05/2018,22/05/2018,0.00,,8.52,,"-414,083.33"
,CS,AR,32004134,1005,100,,Cash sale,,,,,,22/05/2018,22/05/2018,0.00,,5.17,,"-414,088.50"
,CS,AR,32004149,1005,100,,Cash sale,,,,,,22/05/2018,22/05/2018,0.00,,3.64,,"-414,092.14"
,CS,AR,32004155,1005,100,,Cash sale,,,,,,22/05/2018,22/05/2018,0.00,,18.05,,"-414,110.19"
,CS,AR,32004160,1005,100,,Cash sale,,,,,,22/05/2018,22/05/2018,0.00,,13.47,,"-414,123.66"
,CS,AR,32004168,1005,100,,Cash sale,,,,,,22/05/2018,22/05/2018,0.00,,10.93,,"-414,134.59"
,CS,AR,32004174,1005,100,,Cash sale,,,,,,22/05/2018,22/05/2018,0.00,,7.29,,"-414,141.88"
,CS,AR,32004182,1005,100,,Cash sale,,,,,,22/05/2018,22/05/2018,0.00,,10.34,,"-414,152.22"
,CS,AR,32004190,1005,100,,Cash sale,,,,,,22/05/2018,22/05/2018,0.00,,7.75,,"-414,159.97"
,CS,AR,32004191,1005,100,,Cash sale,,,,,,22/05/2018,22/05/2018,0.00,,5.85,,"-414,165.82"
,CS,AR,32004229,1005,100,,Cash sale,,,,,,22/05/2018,22/05/2018,0.00,,3.64,,"-414,169.46"
,CS,AR,32004236,1005,100,,Cash sale,,,,,,22/05/2018,22/05/2018,0.00,,15.01,,"-414,184.47"
,CS,AR,32004246,1005,100,,Cash sale,,,,,,22/05/2018,22/05/2018,0.00,,17.80,,"-414,202.27"
,CS,AR,32004248,1005,100,,Cash sale,,,,,,22/05/2018,22/05/2018,0.00,,7.29,,"-414,209.56"
,CS,AR,32004249,1005,100,,Cash sale,,,,,,22/05/2018,22/05/2018,0.00,,10.93,,"-414,220.49"
,CS,AR,32004262,1005,100,,Cash sale,,,,,,22/05/2018,22/05/2018,0.00,,10.17,,"-414,230.66"
,CS,AR,32004263,1005,100,,Cash sale,,,,,,22/05/2018,22/05/2018,0.00,,24.00,,"-414,254.66"
,CS,AR,32004269,1005,100,,Cash sale,,,,,,22/05/2018,22/05/2018,0.00,,3.64,,"-414,258.30"
,CS,AR,32004279,1005,100,,Cash sale,,,,,,22/05/2018,22/05/2018,0.00,,5.47,,"-414,263.77"
,CS,AR,32004292,1005,100,,Cash sale,,,,,,22/05/2018,22/05/2018,0.00,,10.93,,"-414,274.70"
,CS,AR,32004302,1005,100,,Cash sale,,,,,,22/05/2018,22/05/2018,0.00,,5.50,,"-414,280.20"
,CS,AR,32004311,1005,100,,Cash sale,,,,,,22/05/2018,22/05/2018,0.00,,3.64,,"-414,283.84"
,CS,AR,32004341,1005,100,,Cash sale,,,,,,22/05/2018,22/05/2018,0.00,,3.64,,"-414,287.48"
,CS,AR,32004346,1005,100,,Cash sale,,,,,,22/05/2018,22/05/2018,0.00,,7.29,,"-414,294.77"
,CS,AR,32004347,1005,100,,Cash sale,,,,,,22/05/2018,22/05/2018,0.00,,10.93,,"-414,305.70"
,CS,AR,32004352,1005,100,,Cash sale,,,,,,22/05/2018,22/05/2018,0.00,,5.47,,"-414,311.17"
,CS,AR,32004356,1005,100,,Cash sale,,,,,,22/05/2018,22/05/2018,0.00,,29.15,,"-414,340.32"
,CS,AR,32004357,1005,100,,Cash sale,,,,,,22/05/2018,22/05/2018,0.00,,29.15,,"-414,369.47"
,IN,AR,30314576,1005,100,,Invoice,,,,,,22/05/2018,22/05/2018,0.00,,9.03,,"-414,378.50"
,IN,AR,30314583,1005,100,,Invoice,,,,,,22/05/2018,22/05/2018,0.00,,23.73,,"-414,402.23"
,IN,AR,30314617,1005,100,,Invoice,,,,,,22/05/2018,22/05/2018,0.00,,14.58,,"-414,416.81"
,IN,AR,30314630,1005,100,,Invoice,,,,,,22/05/2018,22/05/2018,0.00,,7.00,,"-414,423.81"
,IN,AR,30314657,1005,100,,Invoice,,,,,,22/05/2018,22/05/2018,0.00,,35.59,,"-414,459.40"
,IN,AR,30314663,1005,100,,Invoice,,,,,,22/05/2018,22/05/2018,0.00,,451.27,,"-414,910.67"
,IN,AR,30314676,1005,100,,Invoice,,,,,,22/05/2018,22/05/2018,0.00,,21.86,,"-414,932.53"
,IN,AR,30314677,1005,100,,Invoice,,,,,,22/05/2018,22/05/2018,0.00,,10.93,,"-414,943.46"
,IN,AR,30314700,1005,100,,Invoice,,,,,,22/05/2018,22/05/2018,0.00,,3.64,,"-414,947.10"
,IN,AR,30314707,1005,100,,Invoice,,,,,,22/05/2018,22/05/2018,0.00,,21.86,,"-414,968.96"
,IN,AR,30314724,1005,100,,Invoice,,,,,,22/05/2018,22/05/2018,0.00,,7.29,,"-414,976.25"
,IN,AR,30314725,1005,100,,Invoice,,,,,,22/05/2018,22/05/2018,0.00,,10.93,,"-414,987.18"
,IN,AR,30314728,1005,100,,Invoice,,,,,,22/05/2018,22/05/2018,0.00,,21.86,,"-415,009.04"
,IN,AR,30314736,1005,100,,Invoice,,,,,,22/05/2018,22/05/2018,0.00,,48.81,,"-415,057.85"
,IN,AR,30314747,1005,100,,Invoice,,,,,,22/05/2018,22/05/2018,0.00,,13.74,,"-415,071.59"
,IN,AR,30314759,1005,100,,Invoice,,,,,,22/05/2018,22/05/2018,0.00,,3.64,,"-415,075.23"
,IN,AR,30314762,1005,100,,Invoice,,,,,,22/05/2018,22/05/2018,0.00,,14.58,,"-415,089.81"
,IN,AR,30314777,1005,100,,Invoice,,,,,,22/05/2018,22/05/2018,0.00,,2.32,,"-415,092.13"
,IN,AR,30314783,1005,100,,Invoice,,,,,,22/05/2018,22/05/2018,0.00,,9.59,,"-415,101.72"
,IN,AR,30314792,1005,100,,Invoice,,,,,,22/05/2018,22/05/2018,0.00,,4.24,,"-415,105.96"
,IN,AR,30314796,1005,100,,Invoice,,,,,,22/05/2018,22/05/2018,0.00,,54.66,,"-415,160.62"
,IN,AR,30314804,1005,100,,Invoice,,,,,,22/05/2018,22/05/2018,0.00,,4.24,,"-415,164.86"
,IN,AR,30314805,1005,100,,Invoice,,,,,,22/05/2018,22/05/2018,0.00,,10.93,,"-415,175.79"
,IN,AR,30314806,1005,100,,Invoice,,,,,,22/05/2018,22/05/2018,0.00,,8.47,,"-415,184.26"
,IN,AR,30314817,1005,100,,Invoice,,,,,,22/05/2018,22/05/2018,0.00,,5.17,,"-415,189.43"
,IN,AR,30314830,1005,100,,Invoice,,,,,,22/05/2018,22/05/2018,0.00,,21.06,,"-415,210.49"
,IN,AR,30314834,1005,100,,Invoice,,,,,,22/05/2018,22/05/2018,0.00,,15.59,,"-415,226.08"
,IN,AR,30314847,1005,100,,Invoice,,,,,,22/05/2018,22/05/2018,0.00,,9.43,,"-415,235.51"
,IN,AR,30314874,1005,100,,Invoice,,,,,,22/05/2018,22/05/2018,0.00,,8.58,,"-415,244.09"
,IN,AR,30314881,1005,100,,Invoice,,,,,,22/05/2018,22/05/2018,0.00,,53.10,,"-415,297.19"
,IN,AR,30314888,1005,100,,Invoice,,,,,,22/05/2018,22/05/2018,0.00,,14.58,,"-415,311.77"
,IN,AR,30314892,1005,100,,Invoice,,,,,,22/05/2018,22/05/2018,0.00,,364.41,,"-415,676.18"
,IN,AR,30314919,1005,100,,Invoice,,,,,,22/05/2018,22/05/2018,0.00,,12.71,,"-415,688.89"
,IN,AR,30314928,1005,100,,Invoice,,,,,,22/05/2018,22/05/2018,0.00,,7.29,,"-415,696.18"
,IN,AR,30314930,1005,100,,Invoice,,,,,,22/05/2018,22/05/2018,0.00,,5.85,,"-415,702.03"
,IN,AR,30314949,1005,100,,Invoice,,,,,,22/05/2018,22/05/2018,0.00,,13.22,,"-415,715.25"
,IN,AR,30314952,1005,100,,Invoice,,,,,,22/05/2018,22/05/2018,0.00,,7.63,,"-415,722.88"
,IN,AR,30314954,1005,100,,Invoice,,,,,,22/05/2018,22/05/2018,0.00,,10.53,,"-415,733.41"
,IN,AR,30314956,1005,100,,Invoice,,,,,,22/05/2018,22/05/2018,0.00,,19.24,,"-415,752.65"
,IN,AR,30314957,1005,100,,Invoice,,,,,,22/05/2018,22/05/2018,0.00,,14.58,,"-415,767.23"
,IN,AR,30314961,1005,100,,Invoice,,,,,,22/05/2018,22/05/2018,0.00,,8.47,,"-415,775.70"
,IN,AR,30314965,1005,100,,Invoice,,,,,,22/05/2018,22/05/2018,0.00,,4.24,,"-415,779.94"
,IN,AR,30314983,1005,100,,Invoice,,,,,,22/05/2018,22/05/2018,0.00,,44.49,,"-415,824.43"
,IN,AR,30314991,1005,100,,Invoice,,,,,,22/05/2018,22/05/2018,0.00,,182.20,,"-416,006.63"
,IN,AR,30314993,1005,100,,Invoice,,,,,,22/05/2018,22/05/2018,0.00,,10.93,,"-416,017.56"
,IN,AR,30314999,1005,100,,Invoice,,,,,,22/05/2018,22/05/2018,0.00,,10.93,,"-416,028.49"
,IN,AR,30315012,1005,100,,Invoice,,,,,,22/05/2018,22/05/2018,0.00,,19.30,,"-416,047.79"
,IN,AR,30315022,1005,100,,Invoice,,,,,,22/05/2018,22/05/2018,0.00,,8.26,,"-416,056.05"
,IN,AR,30315024,1005,100,,Invoice,,,,,,22/05/2018,22/05/2018,0.00,,8.39,,"-416,064.44"
,IN,AR,30315032,1005,100,,Invoice,,,,,,22/05/2018,22/05/2018,0.00,,8.52,,"-416,072.96"
,IN,AR,30315046,1005,100,,Invoice,,,,,,22/05/2018,22/05/2018,0.00,,3.64,,"-416,076.60"
,IN,AR,30315061,1005,100,,Invoice,,,,,,22/05/2018,22/05/2018,0.00,,30.02,,"-416,106.62"
,IN,AR,30315065,1005,100,,Invoice,,,,,,22/05/2018,22/05/2018,0.00,,10.68,,"-416,117.30"
,IN,AR,30315072,1005,100,,Invoice,,,,,,22/05/2018,22/05/2018,0.00,,3.53,,"-416,120.83"
,IN,AR,30315086,1005,100,,Invoice,,,,,,22/05/2018,22/05/2018,0.00,,67.80,,"-416,188.63"
,IN,AR,30315125,1005,100,,Invoice,,,,,,22/05/2018,22/05/2018,0.00,,20.67,,"-416,209.30"
,IN,AR,30315126,1005,100,,Invoice,,,,,,22/05/2018,22/05/2018,0.00,,3.18,,"-416,212.48"
,IN,AR,30315127,1005,100,,Invoice,,,,,,22/05/2018,22/05/2018,0.00,,235.32,,"-416,447.80"
,IN,AR,30315128,1005,100,,Invoice,,,,,,22/05/2018,22/05/2018,0.00,,7.95,,"-416,455.75"
,IN,AR,30315129,1005,100,,Invoice,,,,,,22/05/2018,22/05/2018,0.00,,9.54,,"-416,465.29"
,IN,AR,30315130,1005,100,,Invoice,,,,,,22/05/2018,22/05/2018,0.00,,3.18,,"-416,468.47"
,IN,AR,30315140,1005,100,,Invoice,,,,,,22/05/2018,22/05/2018,0.00,,34.07,,"-416,502.54"
,IN,AR,30315144,1005,100,,Invoice,,,,,,22/05/2018,22/05/2018,0.00,,49.75,,"-416,552.29"
,IN,AR,30315157,1005,100,,Invoice,,,,,,22/05/2018,22/05/2018,0.00,,9.11,,"-416,561.40"
,IN,AR,30315163,1005,100,,Invoice,,,,,,22/05/2018,22/05/2018,0.00,,28.09,,"-416,589.49"
,IN,AR,30315165,1005,100,,Invoice,,,,,,22/05/2018,22/05/2018,0.00,,193.86,,"-416,783.35"
,IN,AR,30315178,1005,100,,Invoice,,,,,,22/05/2018,22/05/2018,0.00,,6.42,,"-416,789.77"
,IN,AR,30315202,1005,100,,Invoice,,,,,,22/05/2018,22/05/2018,0.00,,10.93,,"-416,800.70"
,IN,AR,30315215,1005,100,,Invoice,,,,,,22/05/2018,22/05/2018,0.00,,66.10,,"-416,866.80"
,IN,AR,30315216,1005,100,,Invoice,,,,,,22/05/2018,22/05/2018,0.00,,22.88,,"-416,889.68"
,IN,AR,30315220,1005,100,,Invoice,,,,,,22/05/2018,22/05/2018,0.00,,16.01,,"-416,905.69"
,IN,AR,30315249,1005,100,,Invoice,,,,,,22/05/2018,22/05/2018,0.00,,18.22,,"-416,923.91"
,IN,AR,30315273,1005,100,,Invoice,,,,,,22/05/2018,22/05/2018,0.00,,8.21,,"-416,932.12"
,IN,AR,30315289,1005,100,,Invoice,,,,,,22/05/2018,22/05/2018,0.00,,136.00,,"-417,068.12"
,IN,AR,30315291,1005,100,,Invoice,,,,,,22/05/2018,22/05/2018,0.00,,3.03,,"-417,071.15"
,IN,AR,30315294,1005,100,,Invoice,,,,,,22/05/2018,22/05/2018,0.00,,14.24,,"-417,085.39"
,IN,AR,30315298,1005,100,,Invoice,,,,,,22/05/2018,22/05/2018,0.00,,7.29,,"-417,092.68"
,IN,AR,30315327,1005,100,,Invoice,,,,,,22/05/2018,22/05/2018,0.00,,75.93,,"-417,168.61"
,IN,AR,30315335,1005,100,,Invoice,,,,,,22/05/2018,22/05/2018,0.00,,21.36,,"-417,189.97"
,IN,AR,30315336,1005,100,,Invoice,,,,,,22/05/2018,22/05/2018,0.00,,66.44,,"-417,256.41"
,IN,AR,30315337,1005,100,,Invoice,,,,,,22/05/2018,22/05/2018,0.00,,28.47,,"-417,284.88"
,IN,AR,30315343,1005,100,,Invoice,,,,,,22/05/2018,22/05/2018,0.00,,12.20,,"-417,297.08"
,IN,AR,30315357,1005,100,,Invoice,,,,,,22/05/2018,22/05/2018,0.00,,3.51,,"-417,300.59"
,IN,AR,30315358,1005,100,,Invoice,,,,,,22/05/2018,22/05/2018,0.00,,8.00,,"-417,308.59"
,IN,AR,30315362,1005,100,,Invoice,,,,,,22/05/2018,22/05/2018,0.00,,29.15,,"-417,337.74"
,IN,AR,30315364,1005,100,,Invoice,,,,,,22/05/2018,22/05/2018,0.00,,127.07,,"-417,464.81"
,IN,AR,30315365,1005,100,,Invoice,,,,,,22/05/2018,22/05/2018,0.00,,29.15,,"-417,493.96"
,IN,AR,30315371,1005,100,,Invoice,,,,,,22/05/2018,22/05/2018,0.00,,5.26,,"-417,499.22"
,IN,AR,30315388,1005,100,,Invoice,,,,,,22/05/2018,22/05/2018,0.00,,18.22,,"-417,517.44"
,IN,AR,30315421,1005,100,,Invoice,,,,,,22/05/2018,22/05/2018,0.00,,5.59,,"-417,523.03"
,IN,AR,30315423,1005,100,,Invoice,,,,,,22/05/2018,22/05/2018,0.00,,9.96,,"-417,532.99"
,IN,AR,30315425,1005,100,,Invoice,,,,,,22/05/2018,22/05/2018,0.00,,455.51,,"-417,988.50"
,IN,AR,30315430,1005,100,,Invoice,,,,,,22/05/2018,22/05/2018,0.00,,7.25,,"-417,995.75"
,IN,AR,30315444,1005,100,,Invoice,,,,,,22/05/2018,22/05/2018,0.00,,29.15,,"-418,024.90"
,IN,AR,30315478,1005,100,,Invoice,,,,,,22/05/2018,22/05/2018,0.00,,36.41,,"-418,061.31"
,IN,AR,30315485,1005,100,,Invoice,,,,,,22/05/2018,22/05/2018,0.00,,7.29,,"-418,068.60"
,IN,AR,30315504,1005,100,,Invoice,,,,,,22/05/2018,22/05/2018,0.00,,10.93,,"-418,079.53"
,CN,AR,31018032,1005,100,,Credit Note,,,,,,23/05/2018,23/05/2018,3.64,,0.00,,"-418,075.89"
,CN,AR,31018045,1005,100,,Credit Note,,,,,,23/05/2018,23/05/2018,364.41,,0.00,,"-417,711.48"
,CS,AR,32004016,1005,100,,Cash sale,,,,,,23/05/2018,23/05/2018,0.00,,11.22,,"-417,722.70"
,CS,AR,32004024,1005,100,,Cash sale,,,,,,23/05/2018,23/05/2018,0.00,,42.64,,"-417,765.34"
,CS,AR,32004033,1005,100,,Cash sale,,,,,,23/05/2018,23/05/2018,0.00,,3.64,,"-417,768.98"
,CS,AR,32004043,1005,100,,Cash sale,,,,,,23/05/2018,23/05/2018,0.00,,3.64,,"-417,772.62"
,CS,AR,32004052,1005,100,,Cash sale,,,,,,23/05/2018,23/05/2018,0.00,,10.93,,"-417,783.55"
,CS,AR,32004061,1005,100,,Cash sale,,,,,,23/05/2018,23/05/2018,0.00,,3.64,,"-417,787.19"
,CS,AR,32004071,1005,100,,Cash sale,,,,,,23/05/2018,23/05/2018,0.00,,3.64,,"-417,790.83"
,CS,AR,32004105,1005,100,,Cash sale,,,,,,23/05/2018,23/05/2018,0.00,,7.75,,"-417,798.58"
,CS,AR,32004107,1005,100,,Cash sale,,,,,,23/05/2018,23/05/2018,0.00,,10.93,,"-417,809.51"
,CS,AR,32004123,1005,100,,Cash sale,,,,,,23/05/2018,23/05/2018,0.00,,7.75,,"-417,817.26"
,CS,AR,32004131,1005,100,,Cash sale,,,,,,23/05/2018,23/05/2018,0.00,,7.29,,"-417,824.55"
,CS,AR,32004139,1005,100,,Cash sale,,,,,,23/05/2018,23/05/2018,0.00,,18.05,,"-417,842.60"
,CS,AR,32004141,1005,100,,Cash sale,,,,,,23/05/2018,23/05/2018,0.00,,8.58,,"-417,851.18"
,CS,AR,32004143,1005,100,,Cash sale,,,,,,23/05/2018,23/05/2018,0.00,,10.93,,"-417,862.11"
,CS,AR,32004148,1005,100,,Cash sale,,,,,,23/05/2018,23/05/2018,0.00,,14.58,,"-417,876.69"
,CS,AR,32004150,1005,100,,Cash sale,,,,,,23/05/2018,23/05/2018,0.00,,5.08,,"-417,881.77"
,CS,AR,32004152,1005,100,,Cash sale,,,,,,23/05/2018,23/05/2018,0.00,,7.63,,"-417,889.40"
,CS,AR,32004171,1005,100,,Cash sale,,,,,,23/05/2018,23/05/2018,0.00,,6.48,,"-417,895.88"
,CS,AR,32004184,1005,100,,Cash sale,,,,,,23/05/2018,23/05/2018,0.00,,33.09,,"-417,928.97"
,CS,AR,32004192,1005,100,,Cash sale,,,,,,23/05/2018,23/05/2018,0.00,,7.63,,"-417,936.60"
,CS,AR,32004195,1005,100,,Cash sale,,,,,,23/05/2018,23/05/2018,0.00,,3.64,,"-417,940.24"
,CS,AR,32004207,1005,100,,Cash sale,,,,,,23/05/2018,23/05/2018,0.00,,18.22,,"-417,958.46"
,CS,AR,32004213,1005,100,,Cash sale,,,,,,23/05/2018,23/05/2018,0.00,,21.86,,"-417,980.32"
,CS,AR,32004217,1005,100,,Cash sale,,,,,,23/05/2018,23/05/2018,0.00,,3.22,,"-417,983.54"
,CS,AR,32004219,1005,100,,Cash sale,,,,,,23/05/2018,23/05/2018,0.00,,3.64,,"-417,987.18"
,CS,AR,32004240,1005,100,,Cash sale,,,,,,23/05/2018,23/05/2018,0.00,,21.36,,"-418,008.54"
,CS,AR,32004254,1005,100,,Cash sale,,,,,,23/05/2018,23/05/2018,0.00,,7.75,,"-418,016.29"
,CS,AR,32004258,1005,100,,Cash sale,,,,,,23/05/2018,23/05/2018,0.00,,10.93,,"-418,027.22"
,CS,AR,32004273,1005,100,,Cash sale,,,,,,23/05/2018,23/05/2018,0.00,,12.14,,"-418,039.36"
,CS,AR,32004281,1005,100,,Cash sale,,,,,,23/05/2018,23/05/2018,0.00,,7.29,,"-418,046.65"
,CS,AR,32004285,1005,100,,Cash sale,,,,,,23/05/2018,23/05/2018,0.00,,9.15,,"-418,055.80"
,CS,AR,32004287,1005,100,,Cash sale,,,,,,23/05/2018,23/05/2018,0.00,,29.15,,"-418,084.95"
,CS,AR,32004290,1005,100,,Cash sale,,,,,,23/05/2018,23/05/2018,0.00,,10.93,,"-418,095.88"
,CS,AR,32004291,1005,100,,Cash sale,,,,,,23/05/2018,23/05/2018,0.00,,6.07,,"-418,101.95"
,CS,AR,32004295,1005,100,,Cash sale,,,,,,23/05/2018,23/05/2018,0.00,,10.93,,"-418,112.88"
,CS,AR,32004307,1005,100,,Cash sale,,,,,,23/05/2018,23/05/2018,0.00,,9.03,,"-418,121.91"
,CS,AR,32004314,1005,100,,Cash sale,,,,,,23/05/2018,23/05/2018,0.00,,5.47,,"-418,127.38"
,CS,AR,32004319,1005,100,,Cash sale,,,,,,23/05/2018,23/05/2018,0.00,,7.29,,"-418,134.67"
,CS,AR,32004324,1005,100,,Cash sale,,,,,,23/05/2018,23/05/2018,0.00,,10.17,,"-418,144.84"
,CS,AR,32004335,1005,100,,Cash sale,,,,,,23/05/2018,23/05/2018,0.00,,10.93,,"-418,155.77"
,CS,AR,32004338,1005,100,,Cash sale,,,,,,23/05/2018,23/05/2018,0.00,,7.29,,"-418,163.06"
,CS,AR,32004364,1005,100,,Cash sale,,,,,,23/05/2018,23/05/2018,0.00,,10.99,,"-418,174.05"
,CS,AR,32004421,1005,100,,Cash sale,,,,,,23/05/2018,23/05/2018,0.00,,9.32,,"-418,183.37"
,CS,AR,32004427,1005,100,,Cash sale,,,,,,23/05/2018,23/05/2018,0.00,,7.29,,"-418,190.66"
,IN,AR,30314578,1005,100,,Invoice,,,,,,23/05/2018,23/05/2018,0.00,,182.20,,"-418,372.86"
,IN,AR,30314584,1005,100,,Invoice,,,,,,23/05/2018,23/05/2018,0.00,,35.59,,"-418,408.45"
,IN,AR,30314598,1005,100,,Invoice,,,,,,23/05/2018,23/05/2018,0.00,,41.49,,"-418,449.94"
,IN,AR,30314599,1005,100,,Invoice,,,,,,23/05/2018,23/05/2018,0.00,,19.53,,"-418,469.47"
,IN,AR,30314612,1005,100,,Invoice,,,,,,23/05/2018,23/05/2018,0.00,,8.52,,"-418,477.99"
,IN,AR,30314613,1005,100,,Invoice,,,,,,23/05/2018,23/05/2018,0.00,,7.29,,"-418,485.28"
,IN,AR,30314621,1005,100,,Invoice,,,,,,23/05/2018,23/05/2018,0.00,,21.02,,"-418,506.30"
,IN,AR,30314622,1005,100,,Invoice,,,,,,23/05/2018,23/05/2018,0.00,,81.44,,"-418,587.74"
,IN,AR,30314629,1005,100,,Invoice,,,,,,23/05/2018,23/05/2018,0.00,,7.29,,"-418,595.03"
,IN,AR,30314650,1005,100,,Invoice,,,,,,23/05/2018,23/05/2018,0.00,,7.97,,"-418,603.00"
,IN,AR,30314684,1005,100,,Invoice,,,,,,23/05/2018,23/05/2018,0.00,,18.22,,"-418,621.22"
,IN,AR,30314690,1005,100,,Invoice,,,,,,23/05/2018,23/05/2018,0.00,,14.58,,"-418,635.80"
,IN,AR,30314695,1005,100,,Invoice,,,,,,23/05/2018,23/05/2018,0.00,,18.00,,"-418,653.80"
,IN,AR,30314706,1005,100,,Invoice,,,,,,23/05/2018,23/05/2018,0.00,,6.02,,"-418,659.82"
,IN,AR,30314711,1005,100,,Invoice,,,,,,23/05/2018,23/05/2018,0.00,,34.00,,"-418,693.82"
,IN,AR,30314713,1005,100,,Invoice,,,,,,23/05/2018,23/05/2018,0.00,,7.29,,"-418,701.11"
,IN,AR,30314720,1005,100,,Invoice,,,,,,23/05/2018,23/05/2018,0.00,,20.00,,"-418,721.11"
,IN,AR,30314731,1005,100,,Invoice,,,,,,23/05/2018,23/05/2018,0.00,,34.07,,"-418,755.18"
,IN,AR,30314734,1005,100,,Invoice,,,,,,23/05/2018,23/05/2018,0.00,,174.64,,"-418,929.82"
,IN,AR,30314749,1005,100,,Invoice,,,,,,23/05/2018,23/05/2018,0.00,,6.02,,"-418,935.84"
,IN,AR,30314761,1005,100,,Invoice,,,,,,23/05/2018,23/05/2018,0.00,,14.58,,"-418,950.42"
,IN,AR,30314789,1005,100,,Invoice,,,,,,23/05/2018,23/05/2018,0.00,,20.34,,"-418,970.76"
,IN,AR,30314794,1005,100,,Invoice,,,,,,23/05/2018,23/05/2018,0.00,,4.24,,"-418,975.00"
,IN,AR,30314808,1005,100,,Invoice,,,,,,23/05/2018,23/05/2018,0.00,,5.59,,"-418,980.59"
,IN,AR,30314825,1005,100,,Invoice,,,,,,23/05/2018,23/05/2018,0.00,,25.51,,"-419,006.10"
,IN,AR,30314832,1005,100,,Invoice,,,,,,23/05/2018,23/05/2018,0.00,,23.90,,"-419,030.00"
,IN,AR,30314840,1005,100,,Invoice,,,,,,23/05/2018,23/05/2018,0.00,,51.27,,"-419,081.27"
,IN,AR,30314844,1005,100,,Invoice,,,,,,23/05/2018,23/05/2018,0.00,,53.39,,"-419,134.66"
,IN,AR,30314845,1005,100,,Invoice,,,,,,23/05/2018,23/05/2018,0.00,,10.17,,"-419,144.83"
,IN,AR,30314876,1005,100,,Invoice,,,,,,23/05/2018,23/05/2018,0.00,,18.09,,"-419,162.92"
,IN,AR,30314886,1005,100,,Invoice,,,,,,23/05/2018,23/05/2018,0.00,,72.03,,"-419,234.95"
,IN,AR,30314917,1005,100,,Invoice,,,,,,23/05/2018,23/05/2018,0.00,,8.47,,"-419,243.42"
,IN,AR,30314933,1005,100,,Invoice,,,,,,23/05/2018,23/05/2018,0.00,,3.64,,"-419,247.06"
,IN,AR,30314937,1005,100,,Invoice,,,,,,23/05/2018,23/05/2018,0.00,,13.63,,"-419,260.69"
,IN,AR,30314944,1005,100,,Invoice,,,,,,23/05/2018,23/05/2018,0.00,,14.63,,"-419,275.32"
,IN,AR,30314945,1005,100,,Invoice,,,,,,23/05/2018,23/05/2018,0.00,,40.00,,"-419,315.32"
,IN,AR,30314979,1005,100,,Invoice,,,,,,23/05/2018,23/05/2018,0.00,,16.83,,"-419,332.15"
,IN,AR,30314984,1005,100,,Invoice,,,,,,23/05/2018,23/05/2018,0.00,,14.83,,"-419,346.98"
,IN,AR,30314995,1005,100,,Invoice,,,,,,23/05/2018,23/05/2018,0.00,,3.64,,"-419,350.62"
,IN,AR,30315001,1005,100,,Invoice,,,,,,23/05/2018,23/05/2018,0.00,,14.58,,"-419,365.20"
,IN,AR,30315006,1005,100,,Invoice,,,,,,23/05/2018,23/05/2018,0.00,,7.29,,"-419,372.49"
,IN,AR,30315008,1005,100,,Invoice,,,,,,23/05/2018,23/05/2018,0.00,,5.08,,"-419,377.57"
,IN,AR,30315034,1005,100,,Invoice,,,,,,23/05/2018,23/05/2018,0.00,,14.85,,"-419,392.42"
,IN,AR,30315041,1005,100,,Invoice,,,,,,23/05/2018,23/05/2018,0.00,,24.07,,"-419,416.49"
,IN,AR,30315073,1005,100,,Invoice,,,,,,23/05/2018,23/05/2018,0.00,,1.76,,"-419,418.25"
,IN,AR,30315076,1005,100,,Invoice,,,,,,23/05/2018,23/05/2018,0.00,,15.04,,"-419,433.29"
,IN,AR,30315085,1005,100,,Invoice,,,,,,23/05/2018,23/05/2018,0.00,,4.54,,"-419,437.83"
,IN,AR,30315089,1005,100,,Invoice,,,,,,23/05/2018,23/05/2018,0.00,,12.92,,"-419,450.75"
,IN,AR,30315096,1005,100,,Invoice,,,,,,23/05/2018,23/05/2018,0.00,,22.01,,"-419,472.76"
,IN,AR,30315099,1005,100,,Invoice,,,,,,23/05/2018,23/05/2018,0.00,,29.15,,"-419,501.91"
,IN,AR,30315100,1005,100,,Invoice,,,,,,23/05/2018,23/05/2018,0.00,,18.22,,"-419,520.13"
,IN,AR,30315111,1005,100,,Invoice,,,,,,23/05/2018,23/05/2018,0.00,,7.63,,"-419,527.76"
,IN,AR,30315112,1005,100,,Invoice,,,,,,23/05/2018,23/05/2018,0.00,,10.93,,"-419,538.69"
,IN,AR,30315113,1005,100,,Invoice,,,,,,23/05/2018,23/05/2018,0.00,,364.41,,"-419,903.10"
,IN,AR,30315114,1005,100,,Invoice,,,,,,23/05/2018,23/05/2018,0.00,,"1,093.22",,"-420,996.32"
,IN,AR,30315136,1005,100,,Invoice,,,,,,23/05/2018,23/05/2018,0.00,,4.01,,"-421,000.33"
,IN,AR,30315143,1005,100,,Invoice,,,,,,23/05/2018,23/05/2018,0.00,,38.00,,"-421,038.33"
,IN,AR,30315149,1005,100,,Invoice,,,,,,23/05/2018,23/05/2018,0.00,,60.13,,"-421,098.46"
,IN,AR,30315155,1005,100,,Invoice,,,,,,23/05/2018,23/05/2018,0.00,,3.64,,"-421,102.10"
,IN,AR,30315167,1005,100,,Invoice,,,,,,23/05/2018,23/05/2018,0.00,,7.29,,"-421,109.39"
,IN,AR,30315179,1005,100,,Invoice,,,,,,23/05/2018,23/05/2018,0.00,,1.60,,"-421,110.99"
,IN,AR,30315180,1005,100,,Invoice,,,,,,23/05/2018,23/05/2018,0.00,,25.65,,"-421,136.64"
,IN,AR,30315181,1005,100,,Invoice,,,,,,23/05/2018,23/05/2018,0.00,,6.42,,"-421,143.06"
,IN,AR,30315182,1005,100,,Invoice,,,,,,23/05/2018,23/05/2018,0.00,,17.64,,"-421,160.70"
,IN,AR,30315183,1005,100,,Invoice,,,,,,23/05/2018,23/05/2018,0.00,,6.42,,"-421,167.12"
,IN,AR,30315184,1005,100,,Invoice,,,,,,23/05/2018,23/05/2018,0.00,,3.20,,"-421,170.32"
,IN,AR,30315185,1005,100,,Invoice,,,,,,23/05/2018,23/05/2018,0.00,,12.83,,"-421,183.15"
,IN,AR,30315205,1005,100,,Invoice,,,,,,23/05/2018,23/05/2018,0.00,,43.97,,"-421,227.12"
,IN,AR,30315212,1005,100,,Invoice,,,,,,23/05/2018,23/05/2018,0.00,,29.15,,"-421,256.27"
,IN,AR,30315217,1005,100,,Invoice,,,,,,23/05/2018,23/05/2018,0.00,,2.54,,"-421,258.81"
,IN,AR,30315246,1005,100,,Invoice,,,,,,23/05/2018,23/05/2018,0.00,,2.92,,"-421,261.73"
,IN,AR,30315255,1005,100,,Invoice,,,,,,23/05/2018,23/05/2018,0.00,,27.33,,"-421,289.06"
,IN,AR,30315259,1005,100,,Invoice,,,,,,23/05/2018,23/05/2018,0.00,,11.95,,"-421,301.01"
,IN,AR,30315284,1005,100,,Invoice,,,,,,23/05/2018,23/05/2018,0.00,,11.19,,"-421,312.20"
,IN,AR,30315286,1005,100,,Invoice,,,,,,23/05/2018,23/05/2018,0.00,,9.64,,"-421,321.84"
,IN,AR,30315287,1005,100,,Invoice,,,,,,23/05/2018,23/05/2018,0.00,,9.64,,"-421,331.48"
,IN,AR,30315319,1005,100,,Invoice,,,,,,23/05/2018,23/05/2018,0.00,,4.78,,"-421,336.26"
,IN,AR,30315320,1005,100,,Invoice,,,,,,23/05/2018,23/05/2018,0.00,,9.56,,"-421,345.82"
,IN,AR,30315321,1005,100,,Invoice,,,,,,23/05/2018,23/05/2018,0.00,,15.93,,"-421,361.75"
,IN,AR,30315328,1005,100,,Invoice,,,,,,23/05/2018,23/05/2018,0.00,,54.66,,"-421,416.41"
,IN,AR,30315329,1005,100,,Invoice,,,,,,23/05/2018,23/05/2018,0.00,,54.66,,"-421,471.07"
,IN,AR,30315356,1005,100,,Invoice,,,,,,23/05/2018,23/05/2018,0.00,,3.51,,"-421,474.58"
,IN,AR,30315360,1005,100,,Invoice,,,,,,23/05/2018,23/05/2018,0.00,,18.17,,"-421,492.75"
,IN,AR,30315383,1005,100,,Invoice,,,,,,23/05/2018,23/05/2018,0.00,,7.53,,"-421,500.28"
,IN,AR,30315389,1005,100,,Invoice,,,,,,23/05/2018,23/05/2018,0.00,,29.15,,"-421,529.43"
,IN,AR,30315401,1005,100,,Invoice,,,,,,23/05/2018,23/05/2018,0.00,,13.98,,"-421,543.41"
,IN,AR,30315427,1005,100,,Invoice,,,,,,23/05/2018,23/05/2018,0.00,,11.44,,"-421,554.85"
,IN,AR,30315437,1005,100,,Invoice,,,,,,23/05/2018,23/05/2018,0.00,,10.93,,"-421,565.78"
,IN,AR,30315461,1005,100,,Invoice,,,,,,23/05/2018,23/05/2018,0.00,,49.83,,"-421,615.61"
,IN,AR,30315462,1005,100,,Invoice,,,,,,23/05/2018,23/05/2018,0.00,,6.23,,"-421,621.84"
,IN,AR,30315463,1005,100,,Invoice,,,,,,23/05/2018,23/05/2018,0.00,,4.15,,"-421,625.99"
,IN,AR,30315464,1005,100,,Invoice,,,,,,23/05/2018,23/05/2018,0.00,,16.61,,"-421,642.60"
,IN,AR,30315477,1005,100,,Invoice,,,,,,23/05/2018,23/05/2018,0.00,,3.64,,"-421,646.24"
,IN,AR,30315489,1005,100,,Invoice,,,,,,23/05/2018,23/05/2018,0.00,,16.91,,"-421,663.15"
,CN,AR,31018010,1005,100,,Credit Note,,,,,,24/05/2018,24/05/2018,21.95,,0.00,,"-421,641.20"
,CS,AR,32004012,1005,100,,Cash sale,,,,,,24/05/2018,24/05/2018,0.00,,12.03,,"-421,653.23"
,CS,AR,32004019,1005,100,,Cash sale,,,,,,24/05/2018,24/05/2018,0.00,,18.22,,"-421,671.45"
,CS,AR,32004021,1005,100,,Cash sale,,,,,,24/05/2018,24/05/2018,0.00,,18.22,,"-421,689.67"
,CS,AR,32004032,1005,100,,Cash sale,,,,,,24/05/2018,24/05/2018,0.00,,14.58,,"-421,704.25"
,CS,AR,32004039,1005,100,,Cash sale,,,,,,24/05/2018,24/05/2018,0.00,,5.17,,"-421,709.42"
,CS,AR,32004040,1005,100,,Cash sale,,,,,,24/05/2018,24/05/2018,0.00,,11.22,,"-421,720.64"
,CS,AR,32004046,1005,100,,Cash sale,,,,,,24/05/2018,24/05/2018,0.00,,3.64,,"-421,724.28"
,CS,AR,32004062,1005,100,,Cash sale,,,,,,24/05/2018,24/05/2018,0.00,,54.66,,"-421,778.94"
,CS,AR,32004063,1005,100,,Cash sale,,,,,,24/05/2018,24/05/2018,0.00,,3.64,,"-421,782.58"
,CS,AR,32004068,1005,100,,Cash sale,,,,,,24/05/2018,24/05/2018,0.00,,3.64,,"-421,786.22"
,CS,AR,32004084,1005,100,,Cash sale,,,,,,24/05/2018,24/05/2018,0.00,,3.64,,"-421,789.86"
,CS,AR,32004088,1005,100,,Cash sale,,,,,,24/05/2018,24/05/2018,0.00,,10.93,,"-421,800.79"
,CS,AR,32004091,1005,100,,Cash sale,,,,,,24/05/2018,24/05/2018,0.00,,10.34,,"-421,811.13"
,CS,AR,32004094,1005,100,,Cash sale,,,,,,24/05/2018,24/05/2018,0.00,,14.58,,"-421,825.71"
,CS,AR,32004098,1005,100,,Cash sale,,,,,,24/05/2018,24/05/2018,0.00,,3.01,,"-421,828.72"
,CS,AR,32004102,1005,100,,Cash sale,,,,,,24/05/2018,24/05/2018,0.00,,7.29,,"-421,836.01"
,CS,AR,32004125,1005,100,,Cash sale,,,,,,24/05/2018,24/05/2018,0.00,,3.64,,"-421,839.65"
,CS,AR,32004166,1005,100,,Cash sale,,,,,,24/05/2018,24/05/2018,0.00,,10.30,,"-421,849.95"
,CS,AR,32004183,1005,100,,Cash sale,,,,,,24/05/2018,24/05/2018,0.00,,3.64,,"-421,853.59"
,CS,AR,32004197,1005,100,,Cash sale,,,,,,24/05/2018,24/05/2018,0.00,,8.39,,"-421,861.98"
,CS,AR,32004199,1005,100,,Cash sale,,,,,,24/05/2018,24/05/2018,0.00,,10.34,,"-421,872.32"
,CS,AR,32004225,1005,100,,Cash sale,,,,,,24/05/2018,24/05/2018,0.00,,5.17,,"-421,877.49"
,CS,AR,32004243,1005,100,,Cash sale,,,,,,24/05/2018,24/05/2018,0.00,,7.29,,"-421,884.78"
,CS,AR,32004250,1005,100,,Cash sale,,,,,,24/05/2018,24/05/2018,0.00,,6.53,,"-421,891.31"
,CS,AR,32004260,1005,100,,Cash sale,,,,,,24/05/2018,24/05/2018,0.00,,3.64,,"-421,894.95"
,CS,AR,32004280,1005,100,,Cash sale,,,,,,24/05/2018,24/05/2018,0.00,,3.64,,"-421,898.59"
,CS,AR,32004330,1005,100,,Cash sale,,,,,,24/05/2018,24/05/2018,0.00,,7.29,,"-421,905.88"
,CS,AR,32004349,1005,100,,Cash sale,,,,,,24/05/2018,24/05/2018,0.00,,29.15,,"-421,935.03"
,CS,AR,32004366,1005,100,,Cash sale,,,,,,24/05/2018,24/05/2018,0.00,,10.93,,"-421,945.96"
,CS,AR,32004375,1005,100,,Cash sale,,,,,,24/05/2018,24/05/2018,0.00,,5.94,,"-421,951.90"
,IN,AR,30314589,1005,100,,Invoice,,,,,,24/05/2018,24/05/2018,0.00,,3.64,,"-421,955.54"
,IN,AR,30314592,1005,100,,Invoice,,,,,,24/05/2018,24/05/2018,0.00,,14.58,,"-421,970.12"
,IN,AR,30314607,1005,100,,Invoice,,,,,,24/05/2018,24/05/2018,0.00,,10.13,,"-421,980.25"
,IN,AR,30314609,1005,100,,Invoice,,,,,,24/05/2018,24/05/2018,0.00,,3.64,,"-421,983.89"
,IN,AR,30314632,1005,100,,Invoice,,,,,,24/05/2018,24/05/2018,0.00,,20.34,,"-422,004.23"
,IN,AR,30314642,1005,100,,Invoice,,,,,,24/05/2018,24/05/2018,0.00,,25.51,,"-422,029.74"
,IN,AR,30314658,1005,100,,Invoice,,,,,,24/05/2018,24/05/2018,0.00,,102.03,,"-422,131.77"
,IN,AR,30314662,1005,100,,Invoice,,,,,,24/05/2018,24/05/2018,0.00,,3.64,,"-422,135.41"
,IN,AR,30314667,1005,100,,Invoice,,,,,,24/05/2018,24/05/2018,0.00,,44.00,,"-422,179.41"
,IN,AR,30314687,1005,100,,Invoice,,,,,,24/05/2018,24/05/2018,0.00,,10.93,,"-422,190.34"
,IN,AR,30314705,1005,100,,Invoice,,,,,,24/05/2018,24/05/2018,0.00,,7.29,,"-422,197.63"
,IN,AR,30314716,1005,100,,Invoice,,,,,,24/05/2018,24/05/2018,0.00,,85.42,,"-422,283.05"
,IN,AR,30314727,1005,100,,Invoice,,,,,,24/05/2018,24/05/2018,0.00,,35.69,,"-422,318.74"
,IN,AR,30314737,1005,100,,Invoice,,,,,,24/05/2018,24/05/2018,0.00,,20.34,,"-422,339.08"
,IN,AR,30314738,1005,100,,Invoice,,,,,,24/05/2018,24/05/2018,0.00,,683.34,,"-423,022.42"
,IN,AR,30314760,1005,100,,Invoice,,,,,,24/05/2018,24/05/2018,0.00,,14.58,,"-423,037.00"
,IN,AR,30314767,1005,100,,Invoice,,,,,,24/05/2018,24/05/2018,0.00,,14.58,,"-423,051.58"
,IN,AR,30314770,1005,100,,Invoice,,,,,,24/05/2018,24/05/2018,0.00,,10.93,,"-423,062.51"
,IN,AR,30314772,1005,100,,Invoice,,,,,,24/05/2018,24/05/2018,0.00,,24.50,,"-423,087.01"
,IN,AR,30314787,1005,100,,Invoice,,,,,,24/05/2018,24/05/2018,0.00,,10.93,,"-423,097.94"
,IN,AR,30314799,1005,100,,Invoice,,,,,,24/05/2018,24/05/2018,0.00,,30.51,,"-423,128.45"
,IN,AR,30314801,1005,100,,Invoice,,,,,,24/05/2018,24/05/2018,0.00,,18.05,,"-423,146.50"
,IN,AR,30314816,1005,100,,Invoice,,,,,,24/05/2018,24/05/2018,0.00,,7.29,,"-423,153.79"
,IN,AR,30314819,1005,100,,Invoice,,,,,,24/05/2018,24/05/2018,0.00,,194.03,,"-423,347.82"
,IN,AR,30314826,1005,100,,Invoice,,,,,,24/05/2018,24/05/2018,0.00,,182.20,,"-423,530.02"
,IN,AR,30314827,1005,100,,Invoice,,,,,,24/05/2018,24/05/2018,0.00,,33.46,,"-423,563.48"
,IN,AR,30314836,1005,100,,Invoice,,,,,,24/05/2018,24/05/2018,0.00,,25.42,,"-423,588.90"
,IN,AR,30314846,1005,100,,Invoice,,,,,,24/05/2018,24/05/2018,0.00,,106.78,,"-423,695.68"
,IN,AR,30314853,1005,100,,Invoice,,,,,,24/05/2018,24/05/2018,0.00,,14.34,,"-423,710.02"
,IN,AR,30314860,1005,100,,Invoice,,,,,,24/05/2018,24/05/2018,0.00,,25.76,,"-423,735.78"
,IN,AR,30314873,1005,100,,Invoice,,,,,,24/05/2018,24/05/2018,0.00,,54.66,,"-423,790.44"
,IN,AR,30314891,1005,100,,Invoice,,,,,,24/05/2018,24/05/2018,0.00,,2.39,,"-423,792.83"
,IN,AR,30314898,1005,100,,Invoice,,,,,,24/05/2018,24/05/2018,0.00,,17.80,,"-423,810.63"
,IN,AR,30314899,1005,100,,Invoice,,,,,,24/05/2018,24/05/2018,0.00,,5.08,,"-423,815.71"
,IN,AR,30314909,1005,100,,Invoice,,,,,,24/05/2018,24/05/2018,0.00,,47.80,,"-423,863.51"
,IN,AR,30314910,1005,100,,Invoice,,,,,,24/05/2018,24/05/2018,0.00,,41.42,,"-423,904.93"
,IN,AR,30314913,1005,100,,Invoice,,,,,,24/05/2018,24/05/2018,0.00,,23.91,,"-423,928.84"
,IN,AR,30314916,1005,100,,Invoice,,,,,,24/05/2018,24/05/2018,0.00,,2.58,,"-423,931.42"
,IN,AR,30314926,1005,100,,Invoice,,,,,,24/05/2018,24/05/2018,0.00,,16.95,,"-423,948.37"
,IN,AR,30314943,1005,100,,Invoice,,,,,,24/05/2018,24/05/2018,0.00,,27.97,,"-423,976.34"
,IN,AR,30314953,1005,100,,Invoice,,,,,,24/05/2018,24/05/2018,0.00,,54.66,,"-424,031.00"
,IN,AR,30314959,1005,100,,Invoice,,,,,,24/05/2018,24/05/2018,0.00,,9.03,,"-424,040.03"
,IN,AR,30314974,1005,100,,Invoice,,,,,,24/05/2018,24/05/2018,0.00,,10.98,,"-424,051.01"
,IN,AR,30314987,1005,100,,Invoice,,,,,,24/05/2018,24/05/2018,0.00,,7.00,,"-424,058.01"
,IN,AR,30314990,1005,100,,Invoice,,,,,,24/05/2018,24/05/2018,0.00,,14.58,,"-424,072.59"
,IN,AR,30315015,1005,100,,Invoice,,,,,,24/05/2018,24/05/2018,0.00,,6.97,,"-424,079.56"
,IN,AR,30315018,1005,100,,Invoice,,,,,,24/05/2018,24/05/2018,0.00,,8.77,,"-424,088.33"
,IN,AR,30315019,1005,100,,Invoice,,,,,,24/05/2018,24/05/2018,0.00,,10.93,,"-424,099.26"
,IN,AR,30315023,1005,100,,Invoice,,,,,,24/05/2018,24/05/2018,0.00,,16.53,,"-424,115.79"
,IN,AR,30315043,1005,100,,Invoice,,,,,,24/05/2018,24/05/2018,0.00,,18.05,,"-424,133.84"
,IN,AR,30315044,1005,100,,Invoice,,,,,,24/05/2018,24/05/2018,0.00,,12.14,,"-424,145.98"
,IN,AR,30315049,1005,100,,Invoice,,,,,,24/05/2018,24/05/2018,0.00,,15.53,,"-424,161.51"
,IN,AR,30315051,1005,100,,Invoice,,,,,,24/05/2018,24/05/2018,0.00,,7.63,,"-424,169.14"
,IN,AR,30315054,1005,100,,Invoice,,,,,,24/05/2018,24/05/2018,0.00,,22.71,,"-424,191.85"
,IN,AR,30315056,1005,100,,Invoice,,,,,,24/05/2018,24/05/2018,0.00,,8.00,,"-424,199.85"
,IN,AR,30315057,1005,100,,Invoice,,,,,,24/05/2018,24/05/2018,0.00,,364.41,,"-424,564.26"
,IN,AR,30315063,1005,100,,Invoice,,,,,,24/05/2018,24/05/2018,0.00,,25.51,,"-424,589.77"
,IN,AR,30315067,1005,100,,Invoice,,,,,,24/05/2018,24/05/2018,0.00,,19.58,,"-424,609.35"
,IN,AR,30315109,1005,100,,Invoice,,,,,,24/05/2018,24/05/2018,0.00,,3.64,,"-424,612.99"
,IN,AR,30315119,1005,100,,Invoice,,,,,,24/05/2018,24/05/2018,0.00,,14.64,,"-424,627.63"
,IN,AR,30315120,1005,100,,Invoice,,,,,,24/05/2018,24/05/2018,0.00,,13.02,,"-424,640.65"
,IN,AR,30315121,1005,100,,Invoice,,,,,,24/05/2018,24/05/2018,0.00,,4.88,,"-424,645.53"
,IN,AR,30315122,1005,100,,Invoice,,,,,,24/05/2018,24/05/2018,0.00,,47.19,,"-424,692.72"
,IN,AR,30315131,1005,100,,Invoice,,,,,,24/05/2018,24/05/2018,0.00,,17.49,,"-424,710.21"
,IN,AR,30315132,1005,100,,Invoice,,,,,,24/05/2018,24/05/2018,0.00,,28.62,,"-424,738.83"
,IN,AR,30315137,1005,100,,Invoice,,,,,,24/05/2018,24/05/2018,0.00,,12.98,,"-424,751.81"
,IN,AR,30315145,1005,100,,Invoice,,,,,,24/05/2018,24/05/2018,0.00,,10.47,,"-424,762.28"
,IN,AR,30315147,1005,100,,Invoice,,,,,,24/05/2018,24/05/2018,0.00,,215.00,,"-424,977.28"
,IN,AR,30315164,1005,100,,Invoice,,,,,,24/05/2018,24/05/2018,0.00,,8.64,,"-424,985.92"
,IN,AR,30315186,1005,100,,Invoice,,,,,,24/05/2018,24/05/2018,0.00,,12.83,,"-424,998.75"
,IN,AR,30315191,1005,100,,Invoice,,,,,,24/05/2018,24/05/2018,0.00,,14.58,,"-425,013.33"
,IN,AR,30315221,1005,100,,Invoice,,,,,,24/05/2018,24/05/2018,0.00,,4.00,,"-425,017.33"
,IN,AR,30315225,1005,100,,Invoice,,,,,,24/05/2018,24/05/2018,0.00,,22.01,,"-425,039.34"
,IN,AR,30315238,1005,100,,Invoice,,,,,,24/05/2018,24/05/2018,0.00,,14.58,,"-425,053.92"
,IN,AR,30315239,1005,100,,Invoice,,,,,,24/05/2018,24/05/2018,0.00,,11.66,,"-425,065.58"
,IN,AR,30315244,1005,100,,Invoice,,,,,,24/05/2018,24/05/2018,0.00,,7.54,,"-425,073.12"
,IN,AR,30315248,1005,100,,Invoice,,,,,,24/05/2018,24/05/2018,0.00,,7.29,,"-425,080.41"
,IN,AR,30315276,1005,100,,Invoice,,,,,,24/05/2018,24/05/2018,0.00,,11.22,,"-425,091.63"
,IN,AR,30315281,1005,100,,Invoice,,,,,,24/05/2018,24/05/2018,0.00,,29.75,,"-425,121.38"
,IN,AR,30315301,1005,100,,Invoice,,,,,,24/05/2018,24/05/2018,0.00,,10.93,,"-425,132.31"
,IN,AR,30315322,1005,100,,Invoice,,,,,,24/05/2018,24/05/2018,0.00,,6.37,,"-425,138.68"
,IN,AR,30315323,1005,100,,Invoice,,,,,,24/05/2018,24/05/2018,0.00,,9.56,,"-425,148.24"
,IN,AR,30315324,1005,100,,Invoice,,,,,,24/05/2018,24/05/2018,0.00,,146.58,,"-425,294.82"
,IN,AR,30315331,1005,100,,Invoice,,,,,,24/05/2018,24/05/2018,0.00,,68.81,,"-425,363.63"
,IN,AR,30315344,1005,100,,Invoice,,,,,,24/05/2018,24/05/2018,0.00,,8.14,,"-425,371.77"
,IN,AR,30315391,1005,100,,Invoice,,,,,,24/05/2018,24/05/2018,0.00,,5.86,,"-425,377.63"
,IN,AR,30315406,1005,100,,Invoice,,,,,,24/05/2018,24/05/2018,0.00,,8.17,,"-425,385.80"
,IN,AR,30315409,1005,100,,Invoice,,,,,,24/05/2018,24/05/2018,0.00,,7.29,,"-425,393.09"
,IN,AR,30315424,1005,100,,Invoice,,,,,,24/05/2018,24/05/2018,0.00,,7.17,,"-425,400.26"
,IN,AR,30315445,1005,100,,Invoice,,,,,,24/05/2018,24/05/2018,0.00,,29.15,,"-425,429.41"
,IN,AR,30315465,1005,100,,Invoice,,,,,,24/05/2018,24/05/2018,0.00,,41.53,,"-425,470.94"
,IN,AR,30315466,1005,100,,Invoice,,,,,,24/05/2018,24/05/2018,0.00,,4.15,,"-425,475.09"
,IN,AR,30315467,1005,100,,Invoice,,,,,,24/05/2018,24/05/2018,0.00,,2.08,,"-425,477.17"
,IN,AR,30315468,1005,100,,Invoice,,,,,,24/05/2018,24/05/2018,0.00,,4.15,,"-425,481.32"
,IN,AR,30315469,1005,100,,Invoice,,,,,,24/05/2018,24/05/2018,0.00,,26.99,,"-425,508.31"
,IN,AR,30315475,1005,100,,Invoice,,,,,,24/05/2018,24/05/2018,0.00,,2.54,,"-425,510.85"
,IN,AR,30315503,1005,100,,Invoice,,,,,,24/05/2018,24/05/2018,0.00,,2.03,,"-425,512.88"
,CN,AR,31018048,1005,100,,Credit Note,,,,,,25/05/2018,25/05/2018,3.20,,0.00,,"-425,509.68"
,CS,AR,32004010,1005,100,,Cash sale,,,,,,25/05/2018,25/05/2018,0.00,,10.93,,"-425,520.61"
,CS,AR,32004017,1005,100,,Cash sale,,,,,,25/05/2018,25/05/2018,0.00,,5.61,,"-425,526.22"
,CS,AR,32004027,1005,100,,Cash sale,,,,,,25/05/2018,25/05/2018,0.00,,21.36,,"-425,547.58"
,CS,AR,32004047,1005,100,,Cash sale,,,,,,25/05/2018,25/05/2018,0.00,,14.58,,"-425,562.16"
,CS,AR,32004057,1005,100,,Cash sale,,,,,,25/05/2018,25/05/2018,0.00,,45.13,,"-425,607.29"
,CS,AR,32004065,1005,100,,Cash sale,,,,,,25/05/2018,25/05/2018,0.00,,7.25,,"-425,614.54"
,CS,AR,32004076,1005,100,,Cash sale,,,,,,25/05/2018,25/05/2018,0.00,,12.46,,"-425,627.00"
,CS,AR,32004079,1005,100,,Cash sale,,,,,,25/05/2018,25/05/2018,0.00,,7.29,,"-425,634.29"
,CS,AR,32004092,1005,100,,Cash sale,,,,,,25/05/2018,25/05/2018,0.00,,11.19,,"-425,645.48"
,CS,AR,32004096,1005,100,,Cash sale,,,,,,25/05/2018,25/05/2018,0.00,,23.29,,"-425,668.77"
,CS,AR,32004100,1005,100,,Cash sale,,,,,,25/05/2018,25/05/2018,0.00,,5.86,,"-425,674.63"
,CS,AR,32004108,1005,100,,Cash sale,,,,,,25/05/2018,25/05/2018,0.00,,3.64,,"-425,678.27"
,CS,AR,32004114,1005,100,,Cash sale,,,,,,25/05/2018,25/05/2018,0.00,,14.58,,"-425,692.85"
,CS,AR,32004119,1005,100,,Cash sale,,,,,,25/05/2018,25/05/2018,0.00,,15.25,,"-425,708.10"
,CS,AR,32004127,1005,100,,Cash sale,,,,,,25/05/2018,25/05/2018,0.00,,18.09,,"-425,726.19"
,CS,AR,32004129,1005,100,,Cash sale,,,,,,25/05/2018,25/05/2018,0.00,,21.98,,"-425,748.17"
,CS,AR,32004137,1005,100,,Cash sale,,,,,,25/05/2018,25/05/2018,0.00,,19.24,,"-425,767.41"
,CS,AR,32004153,1005,100,,Cash sale,,,,,,25/05/2018,25/05/2018,0.00,,2.54,,"-425,769.95"
,CS,AR,32004154,1005,100,,Cash sale,,,,,,25/05/2018,25/05/2018,0.00,,18.09,,"-425,788.04"
,CS,AR,32004159,1005,100,,Cash sale,,,,,,25/05/2018,25/05/2018,0.00,,14.62,,"-425,802.66"
,CS,AR,32004161,1005,100,,Cash sale,,,,,,25/05/2018,25/05/2018,0.00,,6.02,,"-425,808.68"
,CS,AR,32004164,1005,100,,Cash sale,,,,,,25/05/2018,25/05/2018,0.00,,27.08,,"-425,835.76"
,CS,AR,32004165,1005,100,,Cash sale,,,,,,25/05/2018,25/05/2018,0.00,,18.05,,"-425,853.81"
,CS,AR,32004170,1005,100,,Cash sale,,,,,,25/05/2018,25/05/2018,0.00,,10.17,,"-425,863.98"
,CS,AR,32004177,1005,100,,Cash sale,,,,,,25/05/2018,25/05/2018,0.00,,3.64,,"-425,867.62"
,CS,AR,32004180,1005,100,,Cash sale,,,,,,25/05/2018,25/05/2018,0.00,,7.29,,"-425,874.91"
,CS,AR,32004194,1005,100,,Cash sale,,,,,,25/05/2018,25/05/2018,0.00,,10.93,,"-425,885.84"
,CS,AR,32004203,1005,100,,Cash sale,,,,,,25/05/2018,25/05/2018,0.00,,10.93,,"-425,896.77"
,CS,AR,32004210,1005,100,,Cash sale,,,,,,25/05/2018,25/05/2018,0.00,,36.44,,"-425,933.21"
,CS,AR,32004220,1005,100,,Cash sale,,,,,,25/05/2018,25/05/2018,0.00,,3.64,,"-425,936.85"
,CS,AR,32004235,1005,100,,Cash sale,,,,,,25/05/2018,25/05/2018,0.00,,10.93,,"-425,947.78"
,CS,AR,32004265,1005,100,,Cash sale,,,,,,25/05/2018,25/05/2018,0.00,,34.00,,"-425,981.78"
,CS,AR,32004267,1005,100,,Cash sale,,,,,,25/05/2018,25/05/2018,0.00,,3.64,,"-425,985.42"
,CS,AR,32004277,1005,100,,Cash sale,,,,,,25/05/2018,25/05/2018,0.00,,7.63,,"-425,993.05"
,CS,AR,32004286,1005,100,,Cash sale,,,,,,25/05/2018,25/05/2018,0.00,,9.15,,"-426,002.20"
,CS,AR,32004310,1005,100,,Cash sale,,,,,,25/05/2018,25/05/2018,0.00,,10.93,,"-426,013.13"
,CS,AR,32004312,1005,100,,Cash sale,,,,,,25/05/2018,25/05/2018,0.00,,7.29,,"-426,020.42"
,CS,AR,32004315,1005,100,,Cash sale,,,,,,25/05/2018,25/05/2018,0.00,,10.93,,"-426,031.35"
,CS,AR,32004320,1005,100,,Cash sale,,,,,,25/05/2018,25/05/2018,0.00,,7.29,,"-426,038.64"
,CS,AR,32004321,1005,100,,Cash sale,,,,,,25/05/2018,25/05/2018,0.00,,7.63,,"-426,046.27"
,CS,AR,32004322,1005,100,,Cash sale,,,,,,25/05/2018,25/05/2018,0.00,,3.64,,"-426,049.91"
,CS,AR,32004326,1005,100,,Cash sale,,,,,,25/05/2018,25/05/2018,0.00,,9.15,,"-426,059.06"
,CS,AR,32004329,1005,100,,Cash sale,,,,,,25/05/2018,25/05/2018,0.00,,4.15,,"-426,063.21"
,CS,AR,32004333,1005,100,,Cash sale,,,,,,25/05/2018,25/05/2018,0.00,,14.58,,"-426,077.79"
,CS,AR,32004351,1005,100,,Cash sale,,,,,,25/05/2018,25/05/2018,0.00,,7.29,,"-426,085.08"
,CS,AR,32004360,1005,100,,Cash sale,,,,,,25/05/2018,25/05/2018,0.00,,7.29,,"-426,092.37"
,CS,AR,32004369,1005,100,,Cash sale,,,,,,25/05/2018,25/05/2018,0.00,,6.02,,"-426,098.39"
,CS,AR,32004374,1005,100,,Cash sale,,,,,,25/05/2018,25/05/2018,0.00,,7.29,,"-426,105.68"
,CS,AR,32004422,1005,100,,Cash sale,,,,,,25/05/2018,25/05/2018,0.00,,9.32,,"-426,115.00"
,CS,AR,32004423,1005,100,,Cash sale,,,,,,25/05/2018,25/05/2018,0.00,,3.03,,"-426,118.03"
,IN,AR,30314577,1005,100,,Invoice,,,,,,25/05/2018,25/05/2018,0.00,,84.54,,"-426,202.57"
,IN,AR,30314585,1005,100,,Invoice,,,,,,25/05/2018,25/05/2018,0.00,,56.36,,"-426,258.93"
,IN,AR,30314587,1005,100,,Invoice,,,,,,25/05/2018,25/05/2018,0.00,,7.29,,"-426,266.22"
,IN,AR,30314591,1005,100,,Invoice,,,,,,25/05/2018,25/05/2018,0.00,,22.37,,"-426,288.59"
,IN,AR,30314595,1005,100,,Invoice,,,,,,25/05/2018,25/05/2018,0.00,,10.93,,"-426,299.52"
,IN,AR,30314611,1005,100,,Invoice,,,,,,25/05/2018,25/05/2018,0.00,,25.51,,"-426,325.03"
,IN,AR,30314618,1005,100,,Invoice,,,,,,25/05/2018,25/05/2018,0.00,,7.29,,"-426,332.32"
,IN,AR,30314627,1005,100,,Invoice,,,,,,25/05/2018,25/05/2018,0.00,,26.57,,"-426,358.89"
,IN,AR,30314635,1005,100,,Invoice,,,,,,25/05/2018,25/05/2018,0.00,,73.97,,"-426,432.86"
,IN,AR,30314644,1005,100,,Invoice,,,,,,25/05/2018,25/05/2018,0.00,,13.78,,"-426,446.64"
,IN,AR,30314647,1005,100,,Invoice,,,,,,25/05/2018,25/05/2018,0.00,,58.22,,"-426,504.86"
,IN,AR,30314659,1005,100,,Invoice,,,,,,25/05/2018,25/05/2018,0.00,,68.81,,"-426,573.67"
,IN,AR,30314664,1005,100,,Invoice,,,,,,25/05/2018,25/05/2018,0.00,,10.93,,"-426,584.60"
,IN,AR,30314696,1005,100,,Invoice,,,,,,25/05/2018,25/05/2018,0.00,,14.00,,"-426,598.60"
,IN,AR,30314709,1005,100,,Invoice,,,,,,25/05/2018,25/05/2018,0.00,,11.68,,"-426,610.28"
,IN,AR,30314717,1005,100,,Invoice,,,,,,25/05/2018,25/05/2018,0.00,,4.75,,"-426,615.03"
,IN,AR,30314740,1005,100,,Invoice,,,,,,25/05/2018,25/05/2018,0.00,,3.88,,"-426,618.91"
,IN,AR,30314745,1005,100,,Invoice,,,,,,25/05/2018,25/05/2018,0.00,,44.00,,"-426,662.91"
,IN,AR,30314746,1005,100,,Invoice,,,,,,25/05/2018,25/05/2018,0.00,,7.29,,"-426,670.20"
,IN,AR,30314751,1005,100,,Invoice,,,,,,25/05/2018,25/05/2018,0.00,,25.51,,"-426,695.71"
,IN,AR,30314754,1005,100,,Invoice,,,,,,25/05/2018,25/05/2018,0.00,,19.58,,"-426,715.29"
,IN,AR,30314765,1005,100,,Invoice,,,,,,25/05/2018,25/05/2018,0.00,,7.97,,"-426,723.26"
,IN,AR,30314774,1005,100,,Invoice,,,,,,25/05/2018,25/05/2018,0.00,,5.17,,"-426,728.43"
,IN,AR,30314779,1005,100,,Invoice,,,,,,25/05/2018,25/05/2018,0.00,,29.15,,"-426,757.58"
,IN,AR,30314784,1005,100,,Invoice,,,,,,25/05/2018,25/05/2018,0.00,,9.59,,"-426,767.17"
,IN,AR,30314812,1005,100,,Invoice,,,,,,25/05/2018,25/05/2018,0.00,,12.92,,"-426,780.09"
,IN,AR,30314815,1005,100,,Invoice,,,,,,25/05/2018,25/05/2018,0.00,,2.39,,"-426,782.48"
,IN,AR,30314841,1005,100,,Invoice,,,,,,25/05/2018,25/05/2018,0.00,,75.88,,"-426,858.36"
,IN,AR,30314842,1005,100,,Invoice,,,,,,25/05/2018,25/05/2018,0.00,,11.22,,"-426,869.58"
,IN,AR,30314854,1005,100,,Invoice,,,,,,25/05/2018,25/05/2018,0.00,,7.17,,"-426,876.75"
,IN,AR,30314857,1005,100,,Invoice,,,,,,25/05/2018,25/05/2018,0.00,,6.44,,"-426,883.19"
,IN,AR,30314858,1005,100,,Invoice,,,,,,25/05/2018,25/05/2018,0.00,,9.66,,"-426,892.85"
,IN,AR,30314861,1005,100,,Invoice,,,,,,25/05/2018,25/05/2018,0.00,,57.97,,"-426,950.82"
,IN,AR,30314862,1005,100,,Invoice,,,,,,25/05/2018,25/05/2018,0.00,,7.29,,"-426,958.11"
,IN,AR,30314863,1005,100,,Invoice,,,,,,25/05/2018,25/05/2018,0.00,,7.29,,"-426,965.40"
,IN,AR,30314866,1005,100,,Invoice,,,,,,25/05/2018,25/05/2018,0.00,,10.93,,"-426,976.33"
,IN,AR,30314877,1005,100,,Invoice,,,,,,25/05/2018,25/05/2018,0.00,,12.92,,"-426,989.25"
,IN,AR,30314884,1005,100,,Invoice,,,,,,25/05/2018,25/05/2018,0.00,,4.24,,"-426,993.49"
,IN,AR,30314900,1005,100,,Invoice,,,,,,25/05/2018,25/05/2018,0.00,,12.71,,"-427,006.20"
,IN,AR,30314901,1005,100,,Invoice,,,,,,25/05/2018,25/05/2018,0.00,,2.54,,"-427,008.74"
,IN,AR,30314903,1005,100,,Invoice,,,,,,25/05/2018,25/05/2018,0.00,,5.08,,"-427,013.82"
,IN,AR,30314911,1005,100,,Invoice,,,,,,25/05/2018,25/05/2018,0.00,,27.08,,"-427,040.90"
,IN,AR,30314923,1005,100,,Invoice,,,,,,25/05/2018,25/05/2018,0.00,,12.71,,"-427,053.61"
,IN,AR,30314924,1005,100,,Invoice,,,,,,25/05/2018,25/05/2018,0.00,,8.47,,"-427,062.08"
,IN,AR,30314980,1005,100,,Invoice,,,,,,25/05/2018,25/05/2018,0.00,,25.25,,"-427,087.33"
,IN,AR,30314992,1005,100,,Invoice,,,,,,25/05/2018,25/05/2018,0.00,,706.96,,"-427,794.29"
,IN,AR,30315005,1005,100,,Invoice,,,,,,25/05/2018,25/05/2018,0.00,,46.37,,"-427,840.66"
,IN,AR,30315009,1005,100,,Invoice,,,,,,25/05/2018,25/05/2018,0.00,,10.17,,"-427,850.83"
,IN,AR,30315020,1005,100,,Invoice,,,,,,25/05/2018,25/05/2018,0.00,,14.58,,"-427,865.41"
,IN,AR,30315027,1005,100,,Invoice,,,,,,25/05/2018,25/05/2018,0.00,,5.17,,"-427,870.58"
,IN,AR,30315062,1005,100,,Invoice,,,,,,25/05/2018,25/05/2018,0.00,,53.60,,"-427,924.18"
,IN,AR,30315066,1005,100,,Invoice,,,,,,25/05/2018,25/05/2018,0.00,,10.93,,"-427,935.11"
,IN,AR,30315074,1005,100,,Invoice,,,,,,25/05/2018,25/05/2018,0.00,,5.29,,"-427,940.40"
,IN,AR,30315081,1005,100,,Invoice,,,,,,25/05/2018,25/05/2018,0.00,,2.42,,"-427,942.82"
,IN,AR,30315083,1005,100,,Invoice,,,,,,25/05/2018,25/05/2018,0.00,,5.34,,"-427,948.16"
,IN,AR,30315092,1005,100,,Invoice,,,,,,25/05/2018,25/05/2018,0.00,,10.93,,"-427,959.09"
,IN,AR,30315094,1005,100,,Invoice,,,,,,25/05/2018,25/05/2018,0.00,,12.71,,"-427,971.80"
,IN,AR,30315106,1005,100,,Invoice,,,,,,25/05/2018,25/05/2018,0.00,,7.29,,"-427,979.09"
,IN,AR,30315123,1005,100,,Invoice,,,,,,25/05/2018,25/05/2018,0.00,,14.64,,"-427,993.73"
,IN,AR,30315133,1005,100,,Invoice,,,,,,25/05/2018,25/05/2018,0.00,,14.31,,"-428,008.04"
,IN,AR,30315134,1005,100,,Invoice,,,,,,25/05/2018,25/05/2018,0.00,,22.26,,"-428,030.30"
,IN,AR,30315141,1005,100,,Invoice,,,,,,25/05/2018,25/05/2018,0.00,,51.10,,"-428,081.40"
,IN,AR,30315152,1005,100,,Invoice,,,,,,25/05/2018,25/05/2018,0.00,,48.10,,"-428,129.50"
,IN,AR,30315158,1005,100,,Invoice,,,,,,25/05/2018,25/05/2018,0.00,,9.11,,"-428,138.61"
,IN,AR,30315160,1005,100,,Invoice,,,,,,25/05/2018,25/05/2018,0.00,,6.02,,"-428,144.63"
,IN,AR,30315187,1005,100,,Invoice,,,,,,25/05/2018,25/05/2018,0.00,,64.14,,"-428,208.77"
,IN,AR,30315188,1005,100,,Invoice,,,,,,25/05/2018,25/05/2018,0.00,,88.19,,"-428,296.96"
,IN,AR,30315189,1005,100,,Invoice,,,,,,25/05/2018,25/05/2018,0.00,,14.01,,"-428,310.97"
,IN,AR,30315207,1005,100,,Invoice,,,,,,25/05/2018,25/05/2018,0.00,,23.91,,"-428,334.88"
,IN,AR,30315209,1005,100,,Invoice,,,,,,25/05/2018,25/05/2018,0.00,,18.22,,"-428,353.10"
,IN,AR,30315218,1005,100,,Invoice,,,,,,25/05/2018,25/05/2018,0.00,,20.34,,"-428,373.44"
,IN,AR,30315226,1005,100,,Invoice,,,,,,25/05/2018,25/05/2018,0.00,,20.01,,"-428,393.45"
,IN,AR,30315229,1005,100,,Invoice,,,,,,25/05/2018,25/05/2018,0.00,,12.00,,"-428,405.45"
,IN,AR,30315245,1005,100,,Invoice,,,,,,25/05/2018,25/05/2018,0.00,,60.34,,"-428,465.79"
,IN,AR,30315251,1005,100,,Invoice,,,,,,25/05/2018,25/05/2018,0.00,,35.58,,"-428,501.37"
,IN,AR,30315256,1005,100,,Invoice,,,,,,25/05/2018,25/05/2018,0.00,,73.59,,"-428,574.96"
,IN,AR,30315264,1005,100,,Invoice,,,,,,25/05/2018,25/05/2018,0.00,,30.36,,"-428,605.32"
,IN,AR,30315271,1005,100,,Invoice,,,,,,25/05/2018,25/05/2018,0.00,,46.61,,"-428,651.93"
,IN,AR,30315279,1005,100,,Invoice,,,,,,25/05/2018,25/05/2018,0.00,,9.19,,"-428,661.12"
,IN,AR,30315297,1005,100,,Invoice,,,,,,25/05/2018,25/05/2018,0.00,,9.84,,"-428,670.96"
,IN,AR,30315300,1005,100,,Invoice,,,,,,25/05/2018,25/05/2018,0.00,,29.15,,"-428,700.11"
,IN,AR,30315305,1005,100,,Invoice,,,,,,25/05/2018,25/05/2018,0.00,,17.03,,"-428,717.14"
,IN,AR,30315307,1005,100,,Invoice,,,,,,25/05/2018,25/05/2018,0.00,,14.49,,"-428,731.63"
,IN,AR,30315325,1005,100,,Invoice,,,,,,25/05/2018,25/05/2018,0.00,,22.31,,"-428,753.94"
,IN,AR,30315348,1005,100,,Invoice,,,,,,25/05/2018,25/05/2018,0.00,,10.93,,"-428,764.87"
,IN,AR,30315352,1005,100,,Invoice,,,,,,25/05/2018,25/05/2018,0.00,,10.00,,"-428,774.87"
,IN,AR,30315359,1005,100,,Invoice,,,,,,25/05/2018,25/05/2018,0.00,,5.93,,"-428,780.80"
,IN,AR,30315376,1005,100,,Invoice,,,,,,25/05/2018,25/05/2018,0.00,,5.47,,"-428,786.27"
,IN,AR,30315381,1005,100,,Invoice,,,,,,25/05/2018,25/05/2018,0.00,,40.25,,"-428,826.52"
,IN,AR,30315385,1005,100,,Invoice,,,,,,25/05/2018,25/05/2018,0.00,,54.66,,"-428,881.18"
,IN,AR,30315397,1005,100,,Invoice,,,,,,25/05/2018,25/05/2018,0.00,,54.66,,"-428,935.84"
,IN,AR,30315405,1005,100,,Invoice,,,,,,25/05/2018,25/05/2018,0.00,,8.17,,"-428,944.01"
,IN,AR,30315407,1005,100,,Invoice,,,,,,25/05/2018,25/05/2018,0.00,,10.21,,"-428,954.22"
,IN,AR,30315420,1005,100,,Invoice,,,,,,25/05/2018,25/05/2018,0.00,,15.53,,"-428,969.75"
,IN,AR,30315433,1005,100,,Invoice,,,,,,25/05/2018,25/05/2018,0.00,,9.11,,"-428,978.86"
,IN,AR,30315443,1005,100,,Invoice,,,,,,25/05/2018,25/05/2018,0.00,,2.00,,"-428,980.86"
,IN,AR,30315470,1005,100,,Invoice,,,,,,25/05/2018,25/05/2018,0.00,,8.31,,"-428,989.17"
,IN,AR,30315471,1005,100,,Invoice,,,,,,25/05/2018,25/05/2018,0.00,,6.23,,"-428,995.40"
,IN,AR,30315472,1005,100,,Invoice,,,,,,25/05/2018,25/05/2018,0.00,,74.75,,"-429,070.15"
,IN,AR,30315473,1005,100,,Invoice,,,,,,25/05/2018,25/05/2018,0.00,,54.66,,"-429,124.81"
,IN,AR,30315493,1005,100,,Invoice,,,,,,25/05/2018,25/05/2018,0.00,,32.80,,"-429,157.61"
,IN,AR,30315505,1005,100,,Invoice,,,,,,25/05/2018,25/05/2018,0.00,,29.15,,"-429,186.76"
,CS,AR,32004156,1005,100,,Cash sale,,,,,,26/05/2018,26/05/2018,0.00,,12.97,,"-429,199.73"
,CS,AR,32004226,1005,100,,Cash sale,,,,,,26/05/2018,26/05/2018,0.00,,14.58,,"-429,214.31"
,CS,AR,32004242,1005,100,,Cash sale,,,,,,26/05/2018,26/05/2018,0.00,,7.29,,"-429,221.60"
,CS,AR,32004340,1005,100,,Cash sale,,,,,,26/05/2018,26/05/2018,0.00,,18.22,,"-429,239.82"
,CS,AR,32004358,1005,100,,Cash sale,,,,,,26/05/2018,26/05/2018,0.00,,7.29,,"-429,247.11"
,CS,AR,32004373,1005,100,,Cash sale,,,,,,26/05/2018,26/05/2018,0.00,,29.15,,"-429,276.26"
,IN,AR,30315346,1005,100,,Invoice,,,,,,26/05/2018,26/05/2018,0.00,,20.34,,"-429,296.60"
,CS,AR,32004443,1005,100,,Cash sale,,,,,,26/05/2018,26/05/2018,0.00,,6.02,,"-429,302.62"
,CS,AR,32004478,1005,100,,Cash sale,,,,,,26/05/2018,26/05/2018,0.00,,7.29,,"-429,309.91"
,CS,AR,32004485,1005,100,,Cash sale,,,,,,26/05/2018,26/05/2018,0.00,,9.03,,"-429,318.94"
,CS,AR,32004520,1005,100,,Cash sale,,,,,,26/05/2018,26/05/2018,0.00,,10.93,,"-429,329.87"
,IN,AR,30315938,1005,100,,Invoice,,,,,,27/05/2018,27/05/2018,0.00,,29.15,,"-429,359.02"
,IN,AR,30316112,1005,100,,Invoice,,,,,,27/05/2018,27/05/2018,0.00,,29.15,,"-429,388.17"
,CN,AR,31018103,1005,100,,Credit Note,,,,,,28/05/2018,28/05/2018,165.47,,0.00,,"-429,222.70"
,CS,AR,32004432,1005,100,,Cash sale,,,,,,28/05/2018,28/05/2018,0.00,,14.03,,"-429,236.73"
,CS,AR,32004438,1005,100,,Cash sale,,,,,,28/05/2018,28/05/2018,0.00,,11.86,,"-429,248.59"
,CS,AR,32004454,1005,100,,Cash sale,,,,,,28/05/2018,28/05/2018,0.00,,3.64,,"-429,252.23"
,CS,AR,32004460,1005,100,,Cash sale,,,,,,28/05/2018,28/05/2018,0.00,,7.29,,"-429,259.52"
,CS,AR,32004464,1005,100,,Cash sale,,,,,,28/05/2018,28/05/2018,0.00,,12.46,,"-429,271.98"
,CS,AR,32004466,1005,100,,Cash sale,,,,,,28/05/2018,28/05/2018,0.00,,7.29,,"-429,279.27"
,CS,AR,32004467,1005,100,,Cash sale,,,,,,28/05/2018,28/05/2018,0.00,,8.77,,"-429,288.04"
,CS,AR,32004469,1005,100,,Cash sale,,,,,,28/05/2018,28/05/2018,0.00,,7.29,,"-429,295.33"
,CS,AR,32004470,1005,100,,Cash sale,,,,,,28/05/2018,28/05/2018,0.00,,10.93,,"-429,306.26"
,CS,AR,32004477,1005,100,,Cash sale,,,,,,28/05/2018,28/05/2018,0.00,,7.29,,"-429,313.55"
,CS,AR,32004481,1005,100,,Cash sale,,,,,,28/05/2018,28/05/2018,0.00,,10.34,,"-429,323.89"
,CS,AR,32004491,1005,100,,Cash sale,,,,,,28/05/2018,28/05/2018,0.00,,3.64,,"-429,327.53"
,CS,AR,32004493,1005,100,,Cash sale,,,,,,28/05/2018,28/05/2018,0.00,,10.17,,"-429,337.70"
,CS,AR,32004497,1005,100,,Cash sale,,,,,,28/05/2018,28/05/2018,0.00,,10.34,,"-429,348.04"
,CS,AR,32004499,1005,100,,Cash sale,,,,,,28/05/2018,28/05/2018,0.00,,2.75,,"-429,350.79"
,CS,AR,32004510,1005,100,,Cash sale,,,,,,28/05/2018,28/05/2018,0.00,,11.69,,"-429,362.48"
,CS,AR,32004511,1005,100,,Cash sale,,,,,,28/05/2018,28/05/2018,0.00,,3.64,,"-429,366.12"
,CS,AR,32004513,1005,100,,Cash sale,,,,,,28/05/2018,28/05/2018,0.00,,18.09,,"-429,384.21"
,CS,AR,32004514,1005,100,,Cash sale,,,,,,28/05/2018,28/05/2018,0.00,,7.17,,"-429,391.38"
,CS,AR,32004515,1005,100,,Cash sale,,,,,,28/05/2018,28/05/2018,0.00,,24.07,,"-429,415.45"
,CS,AR,32004516,1005,100,,Cash sale,,,,,,28/05/2018,28/05/2018,0.00,,10.93,,"-429,426.38"
,CS,AR,32004519,1005,100,,Cash sale,,,,,,28/05/2018,28/05/2018,0.00,,7.75,,"-429,434.13"
,CS,AR,32004521,1005,100,,Cash sale,,,,,,28/05/2018,28/05/2018,0.00,,10.93,,"-429,445.06"
,CS,AR,32004528,1005,100,,Cash sale,,,,,,28/05/2018,28/05/2018,0.00,,3.64,,"-429,448.70"
,CS,AR,32004530,1005,100,,Cash sale,,,,,,28/05/2018,28/05/2018,0.00,,14.58,,"-429,463.28"
,CS,AR,32004531,1005,100,,Cash sale,,,,,,28/05/2018,28/05/2018,0.00,,2.54,,"-429,465.82"
,CS,AR,32004540,1005,100,,Cash sale,,,,,,28/05/2018,28/05/2018,0.00,,7.29,,"-429,473.11"
,CS,AR,32004541,1005,100,,Cash sale,,,,,,28/05/2018,28/05/2018,0.00,,5.17,,"-429,478.28"
,CS,AR,32004545,1005,100,,Cash sale,,,,,,28/05/2018,28/05/2018,0.00,,7.29,,"-429,485.57"
,CS,AR,32004551,1005,100,,Cash sale,,,,,,28/05/2018,28/05/2018,0.00,,7.29,,"-429,492.86"
,CS,AR,32004555,1005,100,,Cash sale,,,,,,28/05/2018,28/05/2018,0.00,,9.03,,"-429,501.89"
,CS,AR,32004556,1005,100,,Cash sale,,,,,,28/05/2018,28/05/2018,0.00,,7.29,,"-429,509.18"
,CS,AR,32004558,1005,100,,Cash sale,,,,,,28/05/2018,28/05/2018,0.00,,14.58,,"-429,523.76"
,CS,AR,32004559,1005,100,,Cash sale,,,,,,28/05/2018,28/05/2018,0.00,,9.13,,"-429,532.89"
,CS,AR,32004564,1005,100,,Cash sale,,,,,,28/05/2018,28/05/2018,0.00,,7.29,,"-429,540.18"
,CS,AR,32004566,1005,100,,Cash sale,,,,,,28/05/2018,28/05/2018,0.00,,7.29,,"-429,547.47"
,CS,AR,32004570,1005,100,,Cash sale,,,,,,28/05/2018,28/05/2018,0.00,,14.58,,"-429,562.05"
,CS,AR,32004586,1005,100,,Cash sale,,,,,,28/05/2018,28/05/2018,0.00,,9.84,,"-429,571.89"
,CS,AR,32004590,1005,100,,Cash sale,,,,,,28/05/2018,28/05/2018,0.00,,11.44,,"-429,583.33"
,CS,AR,32004592,1005,100,,Cash sale,,,,,,28/05/2018,28/05/2018,0.00,,7.29,,"-429,590.62"
,CS,AR,32004594,1005,100,,Cash sale,,,,,,28/05/2018,28/05/2018,0.00,,9.10,,"-429,599.72"
,CS,AR,32004596,1005,100,,Cash sale,,,,,,28/05/2018,28/05/2018,0.00,,60.71,,"-429,660.43"
,CS,AR,32004601,1005,100,,Cash sale,,,,,,28/05/2018,28/05/2018,0.00,,15.25,,"-429,675.68"
,CS,AR,32004602,1005,100,,Cash sale,,,,,,28/05/2018,28/05/2018,0.00,,10.93,,"-429,686.61"
,CS,AR,32004606,1005,100,,Cash sale,,,,,,28/05/2018,28/05/2018,0.00,,29.15,,"-429,715.76"
,CS,AR,32004608,1005,100,,Cash sale,,,,,,28/05/2018,28/05/2018,0.00,,10.93,,"-429,726.69"
,CS,AR,32004619,1005,100,,Cash sale,,,,,,28/05/2018,28/05/2018,0.00,,38.01,,"-429,764.70"
,CS,AR,32004622,1005,100,,Cash sale,,,,,,28/05/2018,28/05/2018,0.00,,3.64,,"-429,768.34"
,CS,AR,32004655,1005,100,,Cash sale,,,,,,28/05/2018,28/05/2018,0.00,,9.32,,"-429,777.66"
,CS,AR,32004657,1005,100,,Cash sale,,,,,,28/05/2018,28/05/2018,0.00,,3.28,,"-429,780.94"
,IN,AR,30315508,1005,100,,Invoice,,,,,,28/05/2018,28/05/2018,0.00,,17.80,,"-429,798.74"
,IN,AR,30315513,1005,100,,Invoice,,,,,,28/05/2018,28/05/2018,0.00,,7.29,,"-429,806.03"
,IN,AR,30315520,1005,100,,Invoice,,,,,,28/05/2018,28/05/2018,0.00,,54.69,,"-429,860.72"
,IN,AR,30315521,1005,100,,Invoice,,,,,,28/05/2018,28/05/2018,0.00,,2.03,,"-429,862.75"
,IN,AR,30315522,1005,100,,Invoice,,,,,,28/05/2018,28/05/2018,0.00,,14.18,,"-429,876.93"
,IN,AR,30315523,1005,100,,Invoice,,,,,,28/05/2018,28/05/2018,0.00,,8.10,,"-429,885.03"
,IN,AR,30315524,1005,100,,Invoice,,,,,,28/05/2018,28/05/2018,0.00,,4.05,,"-429,889.08"
,IN,AR,30315540,1005,100,,Invoice,,,,,,28/05/2018,28/05/2018,0.00,,23.25,,"-429,912.33"
,IN,AR,30315547,1005,100,,Invoice,,,,,,28/05/2018,28/05/2018,0.00,,177.97,,"-430,090.30"
,IN,AR,30315552,1005,100,,Invoice,,,,,,28/05/2018,28/05/2018,0.00,,19.28,,"-430,109.58"
,IN,AR,30315554,1005,100,,Invoice,,,,,,28/05/2018,28/05/2018,0.00,,225.64,,"-430,335.22"
,IN,AR,30315557,1005,100,,Invoice,,,,,,28/05/2018,28/05/2018,0.00,,38.00,,"-430,373.22"
,IN,AR,30315561,1005,100,,Invoice,,,,,,28/05/2018,28/05/2018,0.00,,80.59,,"-430,453.81"
,IN,AR,30315566,1005,100,,Invoice,,,,,,28/05/2018,28/05/2018,0.00,,48.00,,"-430,501.81"
,IN,AR,30315567,1005,100,,Invoice,,,,,,28/05/2018,28/05/2018,0.00,,24.00,,"-430,525.81"
,IN,AR,30315571,1005,100,,Invoice,,,,,,28/05/2018,28/05/2018,0.00,,13.77,,"-430,539.58"
,IN,AR,30315572,1005,100,,Invoice,,,,,,28/05/2018,28/05/2018,0.00,,27.97,,"-430,567.55"
,IN,AR,30315573,1005,100,,Invoice,,,,,,28/05/2018,28/05/2018,0.00,,8.26,,"-430,575.81"
,IN,AR,30315578,1005,100,,Invoice,,,,,,28/05/2018,28/05/2018,0.00,,20.00,,"-430,595.81"
,IN,AR,30315583,1005,100,,Invoice,,,,,,28/05/2018,28/05/2018,0.00,,35.47,,"-430,631.28"
,IN,AR,30315588,1005,100,,Invoice,,,,,,28/05/2018,28/05/2018,0.00,,24.00,,"-430,655.28"
,IN,AR,30315591,1005,100,,Invoice,,,,,,28/05/2018,28/05/2018,0.00,,25.17,,"-430,680.45"
,IN,AR,30315592,1005,100,,Invoice,,,,,,28/05/2018,28/05/2018,0.00,,11.27,,"-430,691.72"
,IN,AR,30315595,1005,100,,Invoice,,,,,,28/05/2018,28/05/2018,0.00,,22.71,,"-430,714.43"
,IN,AR,30315598,1005,100,,Invoice,,,,,,28/05/2018,28/05/2018,0.00,,9.56,,"-430,723.99"
,IN,AR,30315600,1005,100,,Invoice,,,,,,28/05/2018,28/05/2018,0.00,,15.51,,"-430,739.50"
,IN,AR,30315603,1005,100,,Invoice,,,,,,28/05/2018,28/05/2018,0.00,,10.34,,"-430,749.84"
,IN,AR,30315608,1005,100,,Invoice,,,,,,28/05/2018,28/05/2018,0.00,,13.78,,"-430,763.62"
,IN,AR,30315611,1005,100,,Invoice,,,,,,28/05/2018,28/05/2018,0.00,,7.88,,"-430,771.50"
,IN,AR,30315624,1005,100,,Invoice,,,,,,28/05/2018,28/05/2018,0.00,,2.12,,"-430,773.62"
,IN,AR,30315628,1005,100,,Invoice,,,,,,28/05/2018,28/05/2018,0.00,,16.95,,"-430,790.57"
,IN,AR,30315634,1005,100,,Invoice,,,,,,28/05/2018,28/05/2018,0.00,,23.26,,"-430,813.83"
,IN,AR,30315637,1005,100,,Invoice,,,,,,28/05/2018,28/05/2018,0.00,,7.29,,"-430,821.12"
,IN,AR,30315644,1005,100,,Invoice,,,,,,28/05/2018,28/05/2018,0.00,,104.59,,"-430,925.71"
,IN,AR,30315646,1005,100,,Invoice,,,,,,28/05/2018,28/05/2018,0.00,,27.97,,"-430,953.68"
,IN,AR,30315649,1005,100,,Invoice,,,,,,28/05/2018,28/05/2018,0.00,,19.12,,"-430,972.80"
,IN,AR,30315652,1005,100,,Invoice,,,,,,28/05/2018,28/05/2018,0.00,,22.54,,"-430,995.34"
,IN,AR,30315654,1005,100,,Invoice,,,,,,28/05/2018,28/05/2018,0.00,,9.03,,"-431,004.37"
,IN,AR,30315661,1005,100,,Invoice,,,,,,28/05/2018,28/05/2018,0.00,,6.36,,"-431,010.73"
,IN,AR,30315662,1005,100,,Invoice,,,,,,28/05/2018,28/05/2018,0.00,,5.51,,"-431,016.24"
,IN,AR,30315665,1005,100,,Invoice,,,,,,28/05/2018,28/05/2018,0.00,,75.00,,"-431,091.24"
,IN,AR,30315666,1005,100,,Invoice,,,,,,28/05/2018,28/05/2018,0.00,,2.12,,"-431,093.36"
,IN,AR,30315714,1005,100,,Invoice,,,,,,28/05/2018,28/05/2018,0.00,,10.93,,"-431,104.29"
,IN,AR,30315754,1005,100,,Invoice,,,,,,28/05/2018,28/05/2018,0.00,,30.51,,"-431,134.80"
,IN,AR,30315757,1005,100,,Invoice,,,,,,28/05/2018,28/05/2018,0.00,,16.27,,"-431,151.07"
,IN,AR,30315766,1005,100,,Invoice,,,,,,28/05/2018,28/05/2018,0.00,,14.58,,"-431,165.65"
,IN,AR,30315772,1005,100,,Invoice,,,,,,28/05/2018,28/05/2018,0.00,,11.02,,"-431,176.67"
,IN,AR,30315777,1005,100,,Invoice,,,,,,28/05/2018,28/05/2018,0.00,,11.48,,"-431,188.15"
,IN,AR,30315780,1005,100,,Invoice,,,,,,28/05/2018,28/05/2018,0.00,,2.63,,"-431,190.78"
,IN,AR,30315787,1005,100,,Invoice,,,,,,28/05/2018,28/05/2018,0.00,,14.58,,"-431,205.36"
,IN,AR,30315788,1005,100,,Invoice,,,,,,28/05/2018,28/05/2018,0.00,,364.41,,"-431,569.77"
,IN,AR,30315799,1005,100,,Invoice,,,,,,28/05/2018,28/05/2018,0.00,,7.29,,"-431,577.06"
,IN,AR,30315802,1005,100,,Invoice,,,,,,28/05/2018,28/05/2018,0.00,,419.07,,"-431,996.13"
,IN,AR,30315803,1005,100,,Invoice,,,,,,28/05/2018,28/05/2018,0.00,,7.29,,"-432,003.42"
,IN,AR,30315804,1005,100,,Invoice,,,,,,28/05/2018,28/05/2018,0.00,,28.00,,"-432,031.42"
,IN,AR,30315812,1005,100,,Invoice,,,,,,28/05/2018,28/05/2018,0.00,,7.75,,"-432,039.17"
,IN,AR,30315815,1005,100,,Invoice,,,,,,28/05/2018,28/05/2018,0.00,,10.93,,"-432,050.10"
,IN,AR,30315816,1005,100,,Invoice,,,,,,28/05/2018,28/05/2018,0.00,,32.83,,"-432,082.93"
,IN,AR,30315819,1005,100,,Invoice,,,,,,28/05/2018,28/05/2018,0.00,,11.23,,"-432,094.16"
,IN,AR,30315839,1005,100,,Invoice,,,,,,28/05/2018,28/05/2018,0.00,,3.53,,"-432,097.69"
,IN,AR,30315840,1005,100,,Invoice,,,,,,28/05/2018,28/05/2018,0.00,,7.05,,"-432,104.74"
,IN,AR,30315847,1005,100,,Invoice,,,,,,28/05/2018,28/05/2018,0.00,,7.29,,"-432,112.03"
,IN,AR,30315854,1005,100,,Invoice,,,,,,28/05/2018,28/05/2018,0.00,,11.70,,"-432,123.73"
,IN,AR,30315861,1005,100,,Invoice,,,,,,28/05/2018,28/05/2018,0.00,,4.29,,"-432,128.02"
,IN,AR,30315874,1005,100,,Invoice,,,,,,28/05/2018,28/05/2018,0.00,,2.58,,"-432,130.60"
,IN,AR,30315890,1005,100,,Invoice,,,,,,28/05/2018,28/05/2018,0.00,,2.14,,"-432,132.74"
,IN,AR,30315895,1005,100,,Invoice,,,,,,28/05/2018,28/05/2018,0.00,,36.08,,"-432,168.82"
,IN,AR,30315900,1005,100,,Invoice,,,,,,28/05/2018,28/05/2018,0.00,,8.21,,"-432,177.03"
,IN,AR,30315907,1005,100,,Invoice,,,,,,28/05/2018,28/05/2018,0.00,,9.62,,"-432,186.65"
,IN,AR,30315912,1005,100,,Invoice,,,,,,28/05/2018,28/05/2018,0.00,,49.92,,"-432,236.57"
,IN,AR,30315913,1005,100,,Invoice,,,,,,28/05/2018,28/05/2018,0.00,,6.86,,"-432,243.43"
,IN,AR,30315932,1005,100,,Invoice,,,,,,28/05/2018,28/05/2018,0.00,,18.01,,"-432,261.44"
,IN,AR,30315933,1005,100,,Invoice,,,,,,28/05/2018,28/05/2018,0.00,,22.01,,"-432,283.45"
,IN,AR,30315935,1005,100,,Invoice,,,,,,28/05/2018,28/05/2018,0.00,,2.00,,"-432,285.45"
,IN,AR,30315941,1005,100,,Invoice,,,,,,28/05/2018,28/05/2018,0.00,,43.75,,"-432,329.20"
,IN,AR,30315953,1005,100,,Invoice,,,,,,28/05/2018,28/05/2018,0.00,,38.65,,"-432,367.85"
,IN,AR,30315954,1005,100,,Invoice,,,,,,28/05/2018,28/05/2018,0.00,,165.47,,"-432,533.32"
,IN,AR,30315955,1005,100,,Invoice,,,,,,28/05/2018,28/05/2018,0.00,,167.80,,"-432,701.12"
,IN,AR,30315960,1005,100,,Invoice,,,,,,28/05/2018,28/05/2018,0.00,,8.42,,"-432,709.54"
,IN,AR,30315967,1005,100,,Invoice,,,,,,28/05/2018,28/05/2018,0.00,,9.64,,"-432,719.18"
,IN,AR,30315972,1005,100,,Invoice,,,,,,28/05/2018,28/05/2018,0.00,,54.66,,"-432,773.84"
,IN,AR,30315977,1005,100,,Invoice,,,,,,28/05/2018,28/05/2018,0.00,,40.04,,"-432,813.88"
,IN,AR,30315980,1005,100,,Invoice,,,,,,28/05/2018,28/05/2018,0.00,,31.86,,"-432,845.74"
,IN,AR,30316027,1005,100,,Invoice,,,,,,28/05/2018,28/05/2018,0.00,,16.00,,"-432,861.74"
,IN,AR,30316028,1005,100,,Invoice,,,,,,28/05/2018,28/05/2018,0.00,,3.64,,"-432,865.38"
,IN,AR,30316034,1005,100,,Invoice,,,,,,28/05/2018,28/05/2018,0.00,,11.29,,"-432,876.67"
,IN,AR,30316041,1005,100,,Invoice,,,,,,28/05/2018,28/05/2018,0.00,,18.17,,"-432,894.84"
,IN,AR,30316049,1005,100,,Invoice,,,,,,28/05/2018,28/05/2018,0.00,,8.21,,"-432,903.05"
,IN,AR,30316053,1005,100,,Invoice,,,,,,28/05/2018,28/05/2018,0.00,,10.93,,"-432,913.98"
,IN,AR,30316060,1005,100,,Invoice,,,,,,28/05/2018,28/05/2018,0.00,,4.08,,"-432,918.06"
,IN,AR,30316061,1005,100,,Invoice,,,,,,28/05/2018,28/05/2018,0.00,,10.21,,"-432,928.27"
,IN,AR,30316070,1005,100,,Invoice,,,,,,28/05/2018,28/05/2018,0.00,,9.96,,"-432,938.23"
,IN,AR,30316079,1005,100,,Invoice,,,,,,28/05/2018,28/05/2018,0.00,,9.11,,"-432,947.34"
,IN,AR,30316081,1005,100,,Invoice,,,,,,28/05/2018,28/05/2018,0.00,,2.00,,"-432,949.34"
,IN,AR,30316082,1005,100,,Invoice,,,,,,28/05/2018,28/05/2018,0.00,,2.00,,"-432,951.34"
,IN,AR,30316083,1005,100,,Invoice,,,,,,28/05/2018,28/05/2018,0.00,,4.15,,"-432,955.49"
,IN,AR,30316084,1005,100,,Invoice,,,,,,28/05/2018,28/05/2018,0.00,,4.15,,"-432,959.64"
,IN,AR,30316085,1005,100,,Invoice,,,,,,28/05/2018,28/05/2018,0.00,,8.31,,"-432,967.95"
,IN,AR,30316086,1005,100,,Invoice,,,,,,28/05/2018,28/05/2018,0.00,,4.15,,"-432,972.10"
,IN,AR,30316087,1005,100,,Invoice,,,,,,28/05/2018,28/05/2018,0.00,,4.15,,"-432,976.25"
,IN,AR,30316109,1005,100,,Invoice,,,,,,28/05/2018,28/05/2018,0.00,,18.22,,"-432,994.47"
,CN,AR,31018075,1005,100,,Credit Note,,,,,,29/05/2018,29/05/2018,2.03,,0.00,,"-432,992.44"
,CN,AR,31018106,1005,100,,Credit Note,,,,,,29/05/2018,29/05/2018,"3,644.07",,0.00,,"-429,348.37"
,CN,AR,31018108,1005,100,,Credit Note,,,,,,29/05/2018,29/05/2018,7.02,,0.00,,"-429,341.35"
,CN,AR,31018109,1005,100,,Credit Note,,,,,,29/05/2018,29/05/2018,"3,644.07",,0.00,,"-425,697.28"
,CS,AR,32004440,1005,100,,Cash sale,,,,,,29/05/2018,29/05/2018,0.00,,11.36,,"-425,708.64"
,CS,AR,32004441,1005,100,,Cash sale,,,,,,29/05/2018,29/05/2018,0.00,,3.64,,"-425,712.28"
,CS,AR,32004445,1005,100,,Cash sale,,,,,,29/05/2018,29/05/2018,0.00,,2.81,,"-425,715.09"
,CS,AR,32004446,1005,100,,Cash sale,,,,,,29/05/2018,29/05/2018,0.00,,10.93,,"-425,726.02"
,CS,AR,32004449,1005,100,,Cash sale,,,,,,29/05/2018,29/05/2018,0.00,,3.64,,"-425,729.66"
,CS,AR,32004453,1005,100,,Cash sale,,,,,,29/05/2018,29/05/2018,0.00,,14.58,,"-425,744.24"
,CS,AR,32004456,1005,100,,Cash sale,,,,,,29/05/2018,29/05/2018,0.00,,18.22,,"-425,762.46"
,CS,AR,32004457,1005,100,,Cash sale,,,,,,29/05/2018,29/05/2018,0.00,,9.03,,"-425,771.49"
,CS,AR,32004459,1005,100,,Cash sale,,,,,,29/05/2018,29/05/2018,0.00,,7.29,,"-425,778.78"
,CS,AR,32004465,1005,100,,Cash sale,,,,,,29/05/2018,29/05/2018,0.00,,7.29,,"-425,786.07"
,CS,AR,32004473,1005,100,,Cash sale,,,,,,29/05/2018,29/05/2018,0.00,,7.29,,"-425,793.36"
,CS,AR,32004483,1005,100,,Cash sale,,,,,,29/05/2018,29/05/2018,0.00,,10.17,,"-425,803.53"
,CS,AR,32004490,1005,100,,Cash sale,,,,,,29/05/2018,29/05/2018,0.00,,8.64,,"-425,812.17"
,CS,AR,32004492,1005,100,,Cash sale,,,,,,29/05/2018,29/05/2018,0.00,,5.61,,"-425,817.78"
,CS,AR,32004494,1005,100,,Cash sale,,,,,,29/05/2018,29/05/2018,0.00,,7.75,,"-425,825.53"
,CS,AR,32004504,1005,100,,Cash sale,,,,,,29/05/2018,29/05/2018,0.00,,3.64,,"-425,829.17"
,CS,AR,32004508,1005,100,,Cash sale,,,,,,29/05/2018,29/05/2018,0.00,,3.90,,"-425,833.07"
,CS,AR,32004509,1005,100,,Cash sale,,,,,,29/05/2018,29/05/2018,0.00,,6.74,,"-425,839.81"
,CS,AR,32004517,1005,100,,Cash sale,,,,,,29/05/2018,29/05/2018,0.00,,5.85,,"-425,845.66"
,CS,AR,32004524,1005,100,,Cash sale,,,,,,29/05/2018,29/05/2018,0.00,,18.22,,"-425,863.88"
,CS,AR,32004525,1005,100,,Cash sale,,,,,,29/05/2018,29/05/2018,0.00,,5.08,,"-425,868.96"
,CS,AR,32004526,1005,100,,Cash sale,,,,,,29/05/2018,29/05/2018,0.00,,5.08,,"-425,874.04"
,CS,AR,32004527,1005,100,,Cash sale,,,,,,29/05/2018,29/05/2018,0.00,,5.17,,"-425,879.21"
,CS,AR,32004529,1005,100,,Cash sale,,,,,,29/05/2018,29/05/2018,0.00,,10.93,,"-425,890.14"
,CS,AR,32004532,1005,100,,Cash sale,,,,,,29/05/2018,29/05/2018,0.00,,5.17,,"-425,895.31"
,CS,AR,32004534,1005,100,,Cash sale,,,,,,29/05/2018,29/05/2018,0.00,,3.90,,"-425,899.21"
,CS,AR,32004537,1005,100,,Cash sale,,,,,,29/05/2018,29/05/2018,0.00,,3.64,,"-425,902.85"
,CS,AR,32004538,1005,100,,Cash sale,,,,,,29/05/2018,29/05/2018,0.00,,5.17,,"-425,908.02"
,CS,AR,32004543,1005,100,,Cash sale,,,,,,29/05/2018,29/05/2018,0.00,,14.58,,"-425,922.60"
,CS,AR,32004544,1005,100,,Cash sale,,,,,,29/05/2018,29/05/2018,0.00,,3.64,,"-425,926.24"
,CS,AR,32004546,1005,100,,Cash sale,,,,,,29/05/2018,29/05/2018,0.00,,3.22,,"-425,929.46"
,CS,AR,32004553,1005,100,,Cash sale,,,,,,29/05/2018,29/05/2018,0.00,,19.44,,"-425,948.90"
,CS,AR,32004561,1005,100,,Cash sale,,,,,,29/05/2018,29/05/2018,0.00,,15.01,,"-425,963.91"
,CS,AR,32004563,1005,100,,Cash sale,,,,,,29/05/2018,29/05/2018,0.00,,5.64,,"-425,969.55"
,CS,AR,32004573,1005,100,,Cash sale,,,,,,29/05/2018,29/05/2018,0.00,,17.80,,"-425,987.35"
,CS,AR,32004576,1005,100,,Cash sale,,,,,,29/05/2018,29/05/2018,0.00,,7.75,,"-425,995.10"
,CS,AR,32004580,1005,100,,Cash sale,,,,,,29/05/2018,29/05/2018,0.00,,10.17,,"-426,005.27"
,CS,AR,32004581,1005,100,,Cash sale,,,,,,29/05/2018,29/05/2018,0.00,,28.00,,"-426,033.27"
,CS,AR,32004587,1005,100,,Cash sale,,,,,,29/05/2018,29/05/2018,0.00,,14.58,,"-426,047.85"
,CS,AR,32004588,1005,100,,Cash sale,,,,,,29/05/2018,29/05/2018,0.00,,6.56,,"-426,054.41"
,CS,AR,32004595,1005,100,,Cash sale,,,,,,29/05/2018,29/05/2018,0.00,,5.50,,"-426,059.91"
,CS,AR,32004600,1005,100,,Cash sale,,,,,,29/05/2018,29/05/2018,0.00,,3.64,,"-426,063.55"
,CS,AR,32004610,1005,100,,Cash sale,,,,,,29/05/2018,29/05/2018,0.00,,10.93,,"-426,074.48"
,CS,AR,32004611,1005,100,,Cash sale,,,,,,29/05/2018,29/05/2018,0.00,,7.29,,"-426,081.77"
,CS,AR,32004612,1005,100,,Cash sale,,,,,,29/05/2018,29/05/2018,0.00,,10.95,,"-426,092.72"
,CS,AR,32004618,1005,100,,Cash sale,,,,,,29/05/2018,29/05/2018,0.00,,54.66,,"-426,147.38"
,CS,AR,32004656,1005,100,,Cash sale,,,,,,29/05/2018,29/05/2018,0.00,,12.39,,"-426,159.77"
,IN,AR,30315509,1005,100,,Invoice,,,,,,29/05/2018,29/05/2018,0.00,,59.32,,"-426,219.09"
,IN,AR,30315519,1005,100,,Invoice,,,,,,29/05/2018,29/05/2018,0.00,,30.22,,"-426,249.31"
,IN,AR,30315530,1005,100,,Invoice,,,,,,29/05/2018,29/05/2018,0.00,,10.51,,"-426,259.82"
,IN,AR,30315534,1005,100,,Invoice,,,,,,29/05/2018,29/05/2018,0.00,,7.29,,"-426,267.11"
,IN,AR,30315537,1005,100,,Invoice,,,,,,29/05/2018,29/05/2018,0.00,,2.03,,"-426,269.14"
,IN,AR,30315542,1005,100,,Invoice,,,,,,29/05/2018,29/05/2018,0.00,,29.15,,"-426,298.29"
,IN,AR,30315545,1005,100,,Invoice,,,,,,29/05/2018,29/05/2018,0.00,,3.98,,"-426,302.27"
,IN,AR,30315548,1005,100,,Invoice,,,,,,29/05/2018,29/05/2018,0.00,,71.19,,"-426,373.46"
,IN,AR,30315551,1005,100,,Invoice,,,,,,29/05/2018,29/05/2018,0.00,,18.22,,"-426,391.68"
,IN,AR,30315560,1005,100,,Invoice,,,,,,29/05/2018,29/05/2018,0.00,,14.58,,"-426,406.26"
,IN,AR,30315562,1005,100,,Invoice,,,,,,29/05/2018,29/05/2018,0.00,,54.66,,"-426,460.92"
,IN,AR,30315579,1005,100,,Invoice,,,,,,29/05/2018,29/05/2018,0.00,,7.29,,"-426,468.21"
,IN,AR,30315581,1005,100,,Invoice,,,,,,29/05/2018,29/05/2018,0.00,,14.58,,"-426,482.79"
,IN,AR,30315585,1005,100,,Invoice,,,,,,29/05/2018,29/05/2018,0.00,,14.58,,"-426,497.37"
,IN,AR,30315589,1005,100,,Invoice,,,,,,29/05/2018,29/05/2018,0.00,,19.24,,"-426,516.61"
,IN,AR,30315596,1005,100,,Invoice,,,,,,29/05/2018,29/05/2018,0.00,,3.64,,"-426,520.25"
,IN,AR,30315602,1005,100,,Invoice,,,,,,29/05/2018,29/05/2018,0.00,,14.58,,"-426,534.83"
,IN,AR,30315604,1005,100,,Invoice,,,,,,29/05/2018,29/05/2018,0.00,,35.69,,"-426,570.52"
,IN,AR,30315605,1005,100,,Invoice,,,,,,29/05/2018,29/05/2018,0.00,,6.97,,"-426,577.49"
,IN,AR,30315610,1005,100,,Invoice,,,,,,29/05/2018,29/05/2018,0.00,,10.93,,"-426,588.42"
,IN,AR,30315619,1005,100,,Invoice,,,,,,29/05/2018,29/05/2018,0.00,,4.24,,"-426,592.66"
,IN,AR,30315629,1005,100,,Invoice,,,,,,29/05/2018,29/05/2018,0.00,,2.12,,"-426,594.78"
,IN,AR,30315632,1005,100,,Invoice,,,,,,29/05/2018,29/05/2018,0.00,,29.15,,"-426,623.93"
,IN,AR,30315638,1005,100,,Invoice,,,,,,29/05/2018,29/05/2018,0.00,,18.05,,"-426,641.98"
,IN,AR,30315641,1005,100,,Invoice,,,,,,29/05/2018,29/05/2018,0.00,,612.20,,"-427,254.18"
,IN,AR,30315642,1005,100,,Invoice,,,,,,29/05/2018,29/05/2018,0.00,,7.80,,"-427,261.98"
,IN,AR,30315650,1005,100,,Invoice,,,,,,29/05/2018,29/05/2018,0.00,,4.78,,"-427,266.76"
,IN,AR,30315667,1005,100,,Invoice,,,,,,29/05/2018,29/05/2018,0.00,,26.55,,"-427,293.31"
,IN,AR,30315674,1005,100,,Invoice,,,,,,29/05/2018,29/05/2018,0.00,,14.41,,"-427,307.72"
,IN,AR,30315700,1005,100,,Invoice,,,,,,29/05/2018,29/05/2018,0.00,,10.17,,"-427,317.89"
,IN,AR,30315707,1005,100,,Invoice,,,,,,29/05/2018,29/05/2018,0.00,,6.74,,"-427,324.63"
,IN,AR,30315712,1005,100,,Invoice,,,,,,29/05/2018,29/05/2018,0.00,,15.25,,"-427,339.88"
,IN,AR,30315748,1005,100,,Invoice,,,,,,29/05/2018,29/05/2018,0.00,,3.64,,"-427,343.52"
,IN,AR,30315749,1005,100,,Invoice,,,,,,29/05/2018,29/05/2018,0.00,,25.42,,"-427,368.94"
,IN,AR,30315750,1005,100,,Invoice,,,,,,29/05/2018,29/05/2018,0.00,,7.29,,"-427,376.23"
,IN,AR,30315760,1005,100,,Invoice,,,,,,29/05/2018,29/05/2018,0.00,,4.96,,"-427,381.19"
,IN,AR,30315761,1005,100,,Invoice,,,,,,29/05/2018,29/05/2018,0.00,,2.39,,"-427,383.58"
,IN,AR,30315762,1005,100,,Invoice,,,,,,29/05/2018,29/05/2018,0.00,,20.34,,"-427,403.92"
,IN,AR,30315763,1005,100,,Invoice,,,,,,29/05/2018,29/05/2018,0.00,,1.95,,"-427,405.87"
,IN,AR,30315764,1005,100,,Invoice,,,,,,29/05/2018,29/05/2018,0.00,,21.05,,"-427,426.92"
,IN,AR,30315768,1005,100,,Invoice,,,,,,29/05/2018,29/05/2018,0.00,,4.24,,"-427,431.16"
,IN,AR,30315771,1005,100,,Invoice,,,,,,29/05/2018,29/05/2018,0.00,,12.97,,"-427,444.13"
,IN,AR,30315773,1005,100,,Invoice,,,,,,29/05/2018,29/05/2018,0.00,,3.64,,"-427,447.77"
,IN,AR,30315775,1005,100,,Invoice,,,,,,29/05/2018,29/05/2018,0.00,,12.17,,"-427,459.94"
,IN,AR,30315781,1005,100,,Invoice,,,,,,29/05/2018,29/05/2018,0.00,,10.93,,"-427,470.87"
,IN,AR,30315784,1005,100,,Invoice,,,,,,29/05/2018,29/05/2018,0.00,,8.47,,"-427,479.34"
,IN,AR,30315796,1005,100,,Invoice,,,,,,29/05/2018,29/05/2018,0.00,,7.29,,"-427,486.63"
,IN,AR,30315800,1005,100,,Invoice,,,,,,29/05/2018,29/05/2018,0.00,,103.47,,"-427,590.10"
,IN,AR,30315805,1005,100,,Invoice,,,,,,29/05/2018,29/05/2018,0.00,,17.54,,"-427,607.64"
,IN,AR,30315811,1005,100,,Invoice,,,,,,29/05/2018,29/05/2018,0.00,,13.98,,"-427,621.62"
,IN,AR,30315813,1005,100,,Invoice,,,,,,29/05/2018,29/05/2018,0.00,,11.70,,"-427,633.32"
,IN,AR,30315814,1005,100,,Invoice,,,,,,29/05/2018,29/05/2018,0.00,,5.68,,"-427,639.00"
,IN,AR,30315831,1005,100,,Invoice,,,,,,29/05/2018,29/05/2018,0.00,,7.29,,"-427,646.29"
,IN,AR,30315836,1005,100,,Invoice,,,,,,29/05/2018,29/05/2018,0.00,,25.73,,"-427,672.02"
,IN,AR,30315837,1005,100,,Invoice,,,,,,29/05/2018,29/05/2018,0.00,,29.15,,"-427,701.17"
,IN,AR,30315841,1005,100,,Invoice,,,,,,29/05/2018,29/05/2018,0.00,,3.53,,"-427,704.70"
,IN,AR,30315852,1005,100,,Invoice,,,,,,29/05/2018,29/05/2018,0.00,,2.58,,"-427,707.28"
,IN,AR,30315882,1005,100,,Invoice,,,,,,29/05/2018,29/05/2018,0.00,,6.36,,"-427,713.64"
,IN,AR,30315883,1005,100,,Invoice,,,,,,29/05/2018,29/05/2018,0.00,,6.36,,"-427,720.00"
,IN,AR,30315887,1005,100,,Invoice,,,,,,29/05/2018,29/05/2018,0.00,,34.07,,"-427,754.07"
,IN,AR,30315902,1005,100,,Invoice,,,,,,29/05/2018,29/05/2018,0.00,,9.11,,"-427,763.18"
,IN,AR,30315903,1005,100,,Invoice,,,,,,29/05/2018,29/05/2018,0.00,,6.02,,"-427,769.20"
,IN,AR,30315904,1005,100,,Invoice,,,,,,29/05/2018,29/05/2018,0.00,,23.77,,"-427,792.97"
,IN,AR,30315906,1005,100,,Invoice,,,,,,29/05/2018,29/05/2018,0.00,,196.42,,"-427,989.39"
,IN,AR,30315908,1005,100,,Invoice,,,,,,29/05/2018,29/05/2018,0.00,,8.02,,"-427,997.41"
,IN,AR,30315915,1005,100,,Invoice,,,,,,29/05/2018,29/05/2018,0.00,,3.28,,"-428,000.69"
,IN,AR,30315927,1005,100,,Invoice,,,,,,29/05/2018,29/05/2018,0.00,,22.88,,"-428,023.57"
,IN,AR,30315943,1005,100,,Invoice,,,,,,29/05/2018,29/05/2018,0.00,,14.58,,"-428,038.15"
,IN,AR,30315950,1005,100,,Invoice,,,,,,29/05/2018,29/05/2018,0.00,,23.32,,"-428,061.47"
,IN,AR,30315959,1005,100,,Invoice,,,,,,29/05/2018,29/05/2018,0.00,,2.74,,"-428,064.21"
,IN,AR,30315968,1005,100,,Invoice,,,,,,29/05/2018,29/05/2018,0.00,,124.00,,"-428,188.21"
,IN,AR,30315969,1005,100,,Invoice,,,,,,29/05/2018,29/05/2018,0.00,,12.14,,"-428,200.35"
,IN,AR,30315971,1005,100,,Invoice,,,,,,29/05/2018,29/05/2018,0.00,,56.95,,"-428,257.30"
,IN,AR,30315973,1005,100,,Invoice,,,,,,29/05/2018,29/05/2018,0.00,,5.08,,"-428,262.38"
,IN,AR,30315975,1005,100,,Invoice,,,,,,29/05/2018,29/05/2018,0.00,,17.49,,"-428,279.87"
,IN,AR,30315976,1005,100,,Invoice,,,,,,29/05/2018,29/05/2018,0.00,,54.66,,"-428,334.53"
,IN,AR,30315979,1005,100,,Invoice,,,,,,29/05/2018,29/05/2018,0.00,,"3,644.07",,"-431,978.60"
,IN,AR,30315987,1005,100,,Invoice,,,,,,29/05/2018,29/05/2018,0.00,,89.49,,"-432,068.09"
,IN,AR,30316019,1005,100,,Invoice,,,,,,29/05/2018,29/05/2018,0.00,,21.36,,"-432,089.45"
,IN,AR,30316020,1005,100,,Invoice,,,,,,29/05/2018,29/05/2018,0.00,,71.19,,"-432,160.64"
,IN,AR,30316021,1005,100,,Invoice,,,,,,29/05/2018,29/05/2018,0.00,,28.47,,"-432,189.11"
,IN,AR,30316035,1005,100,,Invoice,,,,,,29/05/2018,29/05/2018,0.00,,3.76,,"-432,192.87"
,IN,AR,30316037,1005,100,,Invoice,,,,,,29/05/2018,29/05/2018,0.00,,7.02,,"-432,199.89"
,IN,AR,30316038,1005,100,,Invoice,,,,,,29/05/2018,29/05/2018,0.00,,3.51,,"-432,203.40"
,IN,AR,30316040,1005,100,,Invoice,,,,,,29/05/2018,29/05/2018,0.00,,10.00,,"-432,213.40"
,IN,AR,30316044,1005,100,,Invoice,,,,,,29/05/2018,29/05/2018,0.00,,119.00,,"-432,332.40"
,IN,AR,30316046,1005,100,,Invoice,,,,,,29/05/2018,29/05/2018,0.00,,7.02,,"-432,339.42"
,IN,AR,30316057,1005,100,,Invoice,,,,,,29/05/2018,29/05/2018,0.00,,145.76,,"-432,485.18"
,IN,AR,30316062,1005,100,,Invoice,,,,,,29/05/2018,29/05/2018,0.00,,30.64,,"-432,515.82"
,IN,AR,30316078,1005,100,,Invoice,,,,,,29/05/2018,29/05/2018,0.00,,7.75,,"-432,523.57"
,IN,AR,30316088,1005,100,,Invoice,,,,,,29/05/2018,29/05/2018,0.00,,6.23,,"-432,529.80"
,IN,AR,30316089,1005,100,,Invoice,,,,,,29/05/2018,29/05/2018,0.00,,16.61,,"-432,546.41"
,IN,AR,30316090,1005,100,,Invoice,,,,,,29/05/2018,29/05/2018,0.00,,8.31,,"-432,554.72"
,IN,AR,30316091,1005,100,,Invoice,,,,,,29/05/2018,29/05/2018,0.00,,8.31,,"-432,563.03"
,IN,AR,30316102,1005,100,,Invoice,,,,,,29/05/2018,29/05/2018,0.00,,24.15,,"-432,587.18"
,IN,AR,30316104,1005,100,,Invoice,,,,,,29/05/2018,29/05/2018,0.00,,7.29,,"-432,594.47"
,IN,AR,30316110,1005,100,,Invoice,,,,,,29/05/2018,29/05/2018,0.00,,36.44,,"-432,630.91"
,IN,AR,30316111,1005,100,,Invoice,,,,,,29/05/2018,29/05/2018,0.00,,2.03,,"-432,632.94"
,IN,AR,30316114,1005,100,,Invoice,,,,,,29/05/2018,29/05/2018,0.00,,25.51,,"-432,658.45"
,CS,AR,32004433,1005,100,,Cash sale,,,,,,30/05/2018,30/05/2018,0.00,,11.22,,"-432,669.67"
,CS,AR,32004436,1005,100,,Cash sale,,,,,,30/05/2018,30/05/2018,0.00,,14.58,,"-432,684.25"
,CS,AR,32004437,1005,100,,Cash sale,,,,,,30/05/2018,30/05/2018,0.00,,40.14,,"-432,724.39"
,CS,AR,32004447,1005,100,,Cash sale,,,,,,30/05/2018,30/05/2018,0.00,,3.64,,"-432,728.03"
,CS,AR,32004448,1005,100,,Cash sale,,,,,,30/05/2018,30/05/2018,0.00,,7.29,,"-432,735.32"
,CS,AR,32004452,1005,100,,Cash sale,,,,,,30/05/2018,30/05/2018,0.00,,7.29,,"-432,742.61"
,CS,AR,32004455,1005,100,,Cash sale,,,,,,30/05/2018,30/05/2018,0.00,,3.64,,"-432,746.25"
,CS,AR,32004461,1005,100,,Cash sale,,,,,,30/05/2018,30/05/2018,0.00,,14.58,,"-432,760.83"
,CS,AR,32004462,1005,100,,Cash sale,,,,,,30/05/2018,30/05/2018,0.00,,7.29,,"-432,768.12"
,CS,AR,32004468,1005,100,,Cash sale,,,,,,30/05/2018,30/05/2018,0.00,,5.85,,"-432,773.97"
,CS,AR,32004472,1005,100,,Cash sale,,,,,,30/05/2018,30/05/2018,0.00,,3.64,,"-432,777.61"
,CS,AR,32004475,1005,100,,Cash sale,,,,,,30/05/2018,30/05/2018,0.00,,5.86,,"-432,783.47"
,CS,AR,32004480,1005,100,,Cash sale,,,,,,30/05/2018,30/05/2018,0.00,,7.29,,"-432,790.76"
,CS,AR,32004482,1005,100,,Cash sale,,,,,,30/05/2018,30/05/2018,0.00,,7.75,,"-432,798.51"
,CS,AR,32004489,1005,100,,Cash sale,,,,,,30/05/2018,30/05/2018,0.00,,3.64,,"-432,802.15"
,CS,AR,32004495,1005,100,,Cash sale,,,,,,30/05/2018,30/05/2018,0.00,,12.92,,"-432,815.07"
,CS,AR,32004496,1005,100,,Cash sale,,,,,,30/05/2018,30/05/2018,0.00,,18.22,,"-432,833.29"
,CS,AR,32004498,1005,100,,Cash sale,,,,,,30/05/2018,30/05/2018,0.00,,10.93,,"-432,844.22"
,CS,AR,32004500,1005,100,,Cash sale,,,,,,30/05/2018,30/05/2018,0.00,,18.05,,"-432,862.27"
,CS,AR,32004501,1005,100,,Cash sale,,,,,,30/05/2018,30/05/2018,0.00,,10.72,,"-432,872.99"
,CS,AR,32004502,1005,100,,Cash sale,,,,,,30/05/2018,30/05/2018,0.00,,10.93,,"-432,883.92"
,CS,AR,32004505,1005,100,,Cash sale,,,,,,30/05/2018,30/05/2018,0.00,,3.64,,"-432,887.56"
,CS,AR,32004507,1005,100,,Cash sale,,,,,,30/05/2018,30/05/2018,0.00,,7.63,,"-432,895.19"
,CS,AR,32004512,1005,100,,Cash sale,,,,,,30/05/2018,30/05/2018,0.00,,4.32,,"-432,899.51"
,CS,AR,32004518,1005,100,,Cash sale,,,,,,30/05/2018,30/05/2018,0.00,,5.17,,"-432,904.68"
,CS,AR,32004542,1005,100,,Cash sale,,,,,,30/05/2018,30/05/2018,0.00,,10.93,,"-432,915.61"
,CS,AR,32004547,1005,100,,Cash sale,,,,,,30/05/2018,30/05/2018,0.00,,8.14,,"-432,923.75"
,CS,AR,32004560,1005,100,,Cash sale,,,,,,30/05/2018,30/05/2018,0.00,,7.29,,"-432,931.04"
,CS,AR,32004562,1005,100,,Cash sale,,,,,,30/05/2018,30/05/2018,0.00,,8.02,,"-432,939.06"
,CS,AR,32004565,1005,100,,Cash sale,,,,,,30/05/2018,30/05/2018,0.00,,7.75,,"-432,946.81"
,CS,AR,32004569,1005,100,,Cash sale,,,,,,30/05/2018,30/05/2018,0.00,,18.98,,"-432,965.79"
,CS,AR,32004574,1005,100,,Cash sale,,,,,,30/05/2018,30/05/2018,0.00,,7.29,,"-432,973.08"
,CS,AR,32004578,1005,100,,Cash sale,,,,,,30/05/2018,30/05/2018,0.00,,7.29,,"-432,980.37"
,CS,AR,32004583,1005,100,,Cash sale,,,,,,30/05/2018,30/05/2018,0.00,,5.51,,"-432,985.88"
,CS,AR,32004591,1005,100,,Cash sale,,,,,,30/05/2018,30/05/2018,0.00,,11.44,,"-432,997.32"
,CS,AR,32004593,1005,100,,Cash sale,,,,,,30/05/2018,30/05/2018,0.00,,9.10,,"-433,006.42"
,CS,AR,32004597,1005,100,,Cash sale,,,,,,30/05/2018,30/05/2018,0.00,,12.03,,"-433,018.45"
,CS,AR,32004598,1005,100,,Cash sale,,,,,,30/05/2018,30/05/2018,0.00,,182.20,,"-433,200.65"
,CS,AR,32004603,1005,100,,Cash sale,,,,,,30/05/2018,30/05/2018,0.00,,10.93,,"-433,211.58"
,CS,AR,32004605,1005,100,,Cash sale,,,,,,30/05/2018,30/05/2018,0.00,,12.14,,"-433,223.72"
,CS,AR,32004607,1005,100,,Cash sale,,,,,,30/05/2018,30/05/2018,0.00,,10.93,,"-433,234.65"
,CS,AR,32004616,1005,100,,Cash sale,,,,,,30/05/2018,30/05/2018,0.00,,10.99,,"-433,245.64"
,CS,AR,32004623,1005,100,,Cash sale,,,,,,30/05/2018,30/05/2018,0.00,,5.94,,"-433,251.58"
,IN,AR,30315510,1005,100,,Invoice,,,,,,30/05/2018,30/05/2018,0.00,,17.80,,"-433,269.38"
,IN,AR,30315514,1005,100,,Invoice,,,,,,30/05/2018,30/05/2018,0.00,,25.51,,"-433,294.89"
,IN,AR,30315516,1005,100,,Invoice,,,,,,30/05/2018,30/05/2018,0.00,,68.34,,"-433,363.23"
,IN,AR,30315517,1005,100,,Invoice,,,,,,30/05/2018,30/05/2018,0.00,,31.73,,"-433,394.96"
,IN,AR,30315525,1005,100,,Invoice,,,,,,30/05/2018,30/05/2018,0.00,,13.56,,"-433,408.52"
,IN,AR,30315526,1005,100,,Invoice,,,,,,30/05/2018,30/05/2018,0.00,,7.29,,"-433,415.81"
,IN,AR,30315528,1005,100,,Invoice,,,,,,30/05/2018,30/05/2018,0.00,,31.86,,"-433,447.67"
,IN,AR,30315531,1005,100,,Invoice,,,,,,30/05/2018,30/05/2018,0.00,,23.64,,"-433,471.31"
,IN,AR,30315532,1005,100,,Invoice,,,,,,30/05/2018,30/05/2018,0.00,,65.68,,"-433,536.99"
,IN,AR,30315535,1005,100,,Invoice,,,,,,30/05/2018,30/05/2018,0.00,,7.00,,"-433,543.99"
,IN,AR,30315549,1005,100,,Invoice,,,,,,30/05/2018,30/05/2018,0.00,,59.32,,"-433,603.31"
,IN,AR,30315555,1005,100,,Invoice,,,,,,30/05/2018,30/05/2018,0.00,,33.09,,"-433,636.40"
,IN,AR,30315559,1005,100,,Invoice,,,,,,30/05/2018,30/05/2018,0.00,,7.29,,"-433,643.69"
,IN,AR,30315564,1005,100,,Invoice,,,,,,30/05/2018,30/05/2018,0.00,,7.29,,"-433,650.98"
,IN,AR,30315568,1005,100,,Invoice,,,,,,30/05/2018,30/05/2018,0.00,,28.00,,"-433,678.98"
,IN,AR,30315575,1005,100,,Invoice,,,,,,30/05/2018,30/05/2018,0.00,,36.00,,"-433,714.98"
,IN,AR,30315584,1005,100,,Invoice,,,,,,30/05/2018,30/05/2018,0.00,,174.64,,"-433,889.62"
,IN,AR,30315593,1005,100,,Invoice,,,,,,30/05/2018,30/05/2018,0.00,,31.83,,"-433,921.45"
,IN,AR,30315612,1005,100,,Invoice,,,,,,30/05/2018,30/05/2018,0.00,,15.25,,"-433,936.70"
,IN,AR,30315620,1005,100,,Invoice,,,,,,30/05/2018,30/05/2018,0.00,,4.24,,"-433,940.94"
,IN,AR,30315623,1005,100,,Invoice,,,,,,30/05/2018,30/05/2018,0.00,,4.24,,"-433,945.18"
,IN,AR,30315625,1005,100,,Invoice,,,,,,30/05/2018,30/05/2018,0.00,,122.03,,"-434,067.21"
,IN,AR,30315627,1005,100,,Invoice,,,,,,30/05/2018,30/05/2018,0.00,,6.36,,"-434,073.57"
,IN,AR,30315633,1005,100,,Invoice,,,,,,30/05/2018,30/05/2018,0.00,,8.39,,"-434,081.96"
,IN,AR,30315636,1005,100,,Invoice,,,,,,30/05/2018,30/05/2018,0.00,,33.46,,"-434,115.42"
,IN,AR,30315639,1005,100,,Invoice,,,,,,30/05/2018,30/05/2018,0.00,,9.56,,"-434,124.98"
,IN,AR,30315645,1005,100,,Invoice,,,,,,30/05/2018,30/05/2018,0.00,,63.58,,"-434,188.56"
,IN,AR,30315664,1005,100,,Invoice,,,,,,30/05/2018,30/05/2018,0.00,,15.51,,"-434,204.07"
,IN,AR,30315670,1005,100,,Invoice,,,,,,30/05/2018,30/05/2018,0.00,,258.08,,"-434,462.15"
,IN,AR,30315701,1005,100,,Invoice,,,,,,30/05/2018,30/05/2018,0.00,,5.08,,"-434,467.23"
,IN,AR,30315704,1005,100,,Invoice,,,,,,30/05/2018,30/05/2018,0.00,,1.59,,"-434,468.82"
,IN,AR,30315753,1005,100,,Invoice,,,,,,30/05/2018,30/05/2018,0.00,,22.71,,"-434,491.53"
,IN,AR,30315770,1005,100,,Invoice,,,,,,30/05/2018,30/05/2018,0.00,,25.51,,"-434,517.04"
,IN,AR,30315779,1005,100,,Invoice,,,,,,30/05/2018,30/05/2018,0.00,,16.83,,"-434,533.87"
,IN,AR,30315785,1005,100,,Invoice,,,,,,30/05/2018,30/05/2018,0.00,,14.83,,"-434,548.70"
,IN,AR,30315789,1005,100,,Invoice,,,,,,30/05/2018,30/05/2018,0.00,,11.19,,"-434,559.89"
,IN,AR,30315795,1005,100,,Invoice,,,,,,30/05/2018,30/05/2018,0.00,,1.88,,"-434,561.77"
,IN,AR,30315798,1005,100,,Invoice,,,,,,30/05/2018,30/05/2018,0.00,,7.29,,"-434,569.06"
,IN,AR,30315801,1005,100,,Invoice,,,,,,30/05/2018,30/05/2018,0.00,,12.71,,"-434,581.77"
,IN,AR,30315821,1005,100,,Invoice,,,,,,30/05/2018,30/05/2018,0.00,,24.07,,"-434,605.84"
,IN,AR,30315824,1005,100,,Invoice,,,,,,30/05/2018,30/05/2018,0.00,,11.70,,"-434,617.54"
,IN,AR,30315828,1005,100,,Invoice,,,,,,30/05/2018,30/05/2018,0.00,,51.91,,"-434,669.45"
,IN,AR,30315842,1005,100,,Invoice,,,,,,30/05/2018,30/05/2018,0.00,,15.86,,"-434,685.31"
,IN,AR,30315843,1005,100,,Invoice,,,,,,30/05/2018,30/05/2018,0.00,,5.29,,"-434,690.60"
,IN,AR,30315844,1005,100,,Invoice,,,,,,30/05/2018,30/05/2018,0.00,,1.76,,"-434,692.36"
,IN,AR,30315846,1005,100,,Invoice,,,,,,30/05/2018,30/05/2018,0.00,,21.06,,"-434,713.42"
,IN,AR,30315851,1005,100,,Invoice,,,,,,30/05/2018,30/05/2018,0.00,,10.98,,"-434,724.40"
,IN,AR,30315853,1005,100,,Invoice,,,,,,30/05/2018,30/05/2018,0.00,,7.75,,"-434,732.15"
,IN,AR,30315855,1005,100,,Invoice,,,,,,30/05/2018,30/05/2018,0.00,,28.01,,"-434,760.16"
,IN,AR,30315856,1005,100,,Invoice,,,,,,30/05/2018,30/05/2018,0.00,,32.80,,"-434,792.96"
,IN,AR,30315857,1005,100,,Invoice,,,,,,30/05/2018,30/05/2018,0.00,,32.80,,"-434,825.76"
,IN,AR,30315860,1005,100,,Invoice,,,,,,30/05/2018,30/05/2018,0.00,,54.66,,"-434,880.42"
,IN,AR,30315877,1005,100,,Invoice,,,,,,30/05/2018,30/05/2018,0.00,,12.71,,"-434,893.13"
,IN,AR,30315886,1005,100,,Invoice,,,,,,30/05/2018,30/05/2018,0.00,,4.01,,"-434,897.14"
,IN,AR,30315888,1005,100,,Invoice,,,,,,30/05/2018,30/05/2018,0.00,,34.00,,"-434,931.14"
,IN,AR,30315891,1005,100,,Invoice,,,,,,30/05/2018,30/05/2018,0.00,,54.66,,"-434,985.80"
,IN,AR,30315894,1005,100,,Invoice,,,,,,30/05/2018,30/05/2018,0.00,,62.14,,"-435,047.94"
,IN,AR,30315898,1005,100,,Invoice,,,,,,30/05/2018,30/05/2018,0.00,,14.58,,"-435,062.52"
,IN,AR,30315899,1005,100,,Invoice,,,,,,30/05/2018,30/05/2018,0.00,,64.07,,"-435,126.59"
,IN,AR,30315901,1005,100,,Invoice,,,,,,30/05/2018,30/05/2018,0.00,,3.64,,"-435,130.23"
,IN,AR,30315914,1005,100,,Invoice,,,,,,30/05/2018,30/05/2018,0.00,,18.22,,"-435,148.45"
,IN,AR,30315924,1005,100,,Invoice,,,,,,30/05/2018,30/05/2018,0.00,,41.39,,"-435,189.84"
,IN,AR,30315928,1005,100,,Invoice,,,,,,30/05/2018,30/05/2018,0.00,,7.63,,"-435,197.47"
,IN,AR,30315929,1005,100,,Invoice,,,,,,30/05/2018,30/05/2018,0.00,,12.71,,"-435,210.18"
,IN,AR,30315930,1005,100,,Invoice,,,,,,30/05/2018,30/05/2018,0.00,,5.08,,"-435,215.26"
,IN,AR,30315940,1005,100,,Invoice,,,,,,30/05/2018,30/05/2018,0.00,,82.33,,"-435,297.59"
,IN,AR,30315942,1005,100,,Invoice,,,,,,30/05/2018,30/05/2018,0.00,,6.03,,"-435,303.62"
,IN,AR,30315945,1005,100,,Invoice,,,,,,30/05/2018,30/05/2018,0.00,,29.44,,"-435,333.06"
,IN,AR,30315946,1005,100,,Invoice,,,,,,30/05/2018,30/05/2018,0.00,,10.52,,"-435,343.58"
,IN,AR,30315949,1005,100,,Invoice,,,,,,30/05/2018,30/05/2018,0.00,,6.99,,"-435,350.57"
,IN,AR,30315956,1005,100,,Invoice,,,,,,30/05/2018,30/05/2018,0.00,,13.98,,"-435,364.55"
,IN,AR,30315965,1005,100,,Invoice,,,,,,30/05/2018,30/05/2018,0.00,,5.59,,"-435,370.14"
,IN,AR,30315966,1005,100,,Invoice,,,,,,30/05/2018,30/05/2018,0.00,,22.37,,"-435,392.51"
,IN,AR,30315982,1005,100,,Invoice,,,,,,30/05/2018,30/05/2018,0.00,,4.78,,"-435,397.29"
,IN,AR,30316036,1005,100,,Invoice,,,,,,30/05/2018,30/05/2018,0.00,,5.26,,"-435,402.55"
,IN,AR,30316039,1005,100,,Invoice,,,,,,30/05/2018,30/05/2018,0.00,,8.26,,"-435,410.81"
,IN,AR,30316048,1005,100,,Invoice,,,,,,30/05/2018,30/05/2018,0.00,,10.93,,"-435,421.74"
,IN,AR,30316050,1005,100,,Invoice,,,,,,30/05/2018,30/05/2018,0.00,,9.41,,"-435,431.15"
,IN,AR,30316052,1005,100,,Invoice,,,,,,30/05/2018,30/05/2018,0.00,,10.93,,"-435,442.08"
,IN,AR,30316058,1005,100,,Invoice,,,,,,30/05/2018,30/05/2018,0.00,,23.57,,"-435,465.65"
,IN,AR,30316059,1005,100,,Invoice,,,,,,30/05/2018,30/05/2018,0.00,,13.98,,"-435,479.63"
,IN,AR,30316075,1005,100,,Invoice,,,,,,30/05/2018,30/05/2018,0.00,,9.15,,"-435,488.78"
,IN,AR,30316092,1005,100,,Invoice,,,,,,30/05/2018,30/05/2018,0.00,,51.91,,"-435,540.69"
,IN,AR,30316093,1005,100,,Invoice,,,,,,30/05/2018,30/05/2018,0.00,,4.15,,"-435,544.84"
,IN,AR,30316094,1005,100,,Invoice,,,,,,30/05/2018,30/05/2018,0.00,,10.38,,"-435,555.22"
,IN,AR,30316095,1005,100,,Invoice,,,,,,30/05/2018,30/05/2018,0.00,,16.61,,"-435,571.83"
,IN,AR,30316098,1005,100,,Invoice,,,,,,30/05/2018,30/05/2018,0.00,,2.54,,"-435,574.37"
,IN,AR,30316100,1005,100,,Invoice,,,,,,30/05/2018,30/05/2018,0.00,,2.54,,"-435,576.91"
,IN,AR,30316107,1005,100,,Invoice,,,,,,30/05/2018,30/05/2018,0.00,,28.98,,"-435,605.89"
,CN,AR,31018085,1005,100,,Credit Note,,,,,,31/05/2018,31/05/2018,54.66,,0.00,,"-435,551.23"
,CN,AR,31018086,1005,100,,Credit Note,,,,,,31/05/2018,31/05/2018,1.82,,0.00,,"-435,549.41"
,CN,AR,31018095,1005,100,,Credit Note,,,,,,31/05/2018,31/05/2018,57.63,,0.00,,"-435,491.78"
,CN,AR,31018098,1005,100,,Credit Note,,,,,,31/05/2018,31/05/2018,704.86,,0.00,,"-434,786.92"
,CS,AR,32004431,1005,100,,Cash sale,,,,,,31/05/2018,31/05/2018,0.00,,15.04,,"-434,801.96"
,CS,AR,32004434,1005,100,,Cash sale,,,,,,31/05/2018,31/05/2018,0.00,,26.10,,"-434,828.06"
,CS,AR,32004435,1005,100,,Cash sale,,,,,,31/05/2018,31/05/2018,0.00,,26.10,,"-434,854.16"
,CS,AR,32004439,1005,100,,Cash sale,,,,,,31/05/2018,31/05/2018,0.00,,3.64,,"-434,857.80"
,CS,AR,32004442,1005,100,,Cash sale,,,,,,31/05/2018,31/05/2018,0.00,,3.64,,"-434,861.44"
,CS,AR,32004444,1005,100,,Cash sale,,,,,,31/05/2018,31/05/2018,0.00,,2.58,,"-434,864.02"
,CS,AR,32004450,1005,100,,Cash sale,,,,,,31/05/2018,31/05/2018,0.00,,7.29,,"-434,871.31"
,CS,AR,32004458,1005,100,,Cash sale,,,,,,31/05/2018,31/05/2018,0.00,,3.64,,"-434,874.95"
,CS,AR,32004471,1005,100,,Cash sale,,,,,,31/05/2018,31/05/2018,0.00,,3.01,,"-434,877.96"
,CS,AR,32004476,1005,100,,Cash sale,,,,,,31/05/2018,31/05/2018,0.00,,10.93,,"-434,888.89"
,CS,AR,32004479,1005,100,,Cash sale,,,,,,31/05/2018,31/05/2018,0.00,,7.29,,"-434,896.18"
,CS,AR,32004486,1005,100,,Cash sale,,,,,,31/05/2018,31/05/2018,0.00,,10.93,,"-434,907.11"
,CS,AR,32004488,1005,100,,Cash sale,,,,,,31/05/2018,31/05/2018,0.00,,12.03,,"-434,919.14"
,CS,AR,32004503,1005,100,,Cash sale,,,,,,31/05/2018,31/05/2018,0.00,,6.86,,"-434,926.00"
,CS,AR,32004506,1005,100,,Cash sale,,,,,,31/05/2018,31/05/2018,0.00,,18.22,,"-434,944.22"
,CS,AR,32004522,1005,100,,Cash sale,,,,,,31/05/2018,31/05/2018,0.00,,16.53,,"-434,960.75"
,CS,AR,32004523,1005,100,,Cash sale,,,,,,31/05/2018,31/05/2018,0.00,,7.29,,"-434,968.04"
,CS,AR,32004533,1005,100,,Cash sale,,,,,,31/05/2018,31/05/2018,0.00,,20.68,,"-434,988.72"
,CS,AR,32004535,1005,100,,Cash sale,,,,,,31/05/2018,31/05/2018,0.00,,18.22,,"-435,006.94"
,CS,AR,32004536,1005,100,,Cash sale,,,,,,31/05/2018,31/05/2018,0.00,,13.98,,"-435,020.92"
,CS,AR,32004539,1005,100,,Cash sale,,,,,,31/05/2018,31/05/2018,0.00,,2.58,,"-435,023.50"
,CS,AR,32004548,1005,100,,Cash sale,,,,,,31/05/2018,31/05/2018,0.00,,10.93,,"-435,034.43"
,CS,AR,32004549,1005,100,,Cash sale,,,,,,31/05/2018,31/05/2018,0.00,,10.93,,"-435,045.36"
,CS,AR,32004552,1005,100,,Cash sale,,,,,,31/05/2018,31/05/2018,0.00,,5.17,,"-435,050.53"
,CS,AR,32004557,1005,100,,Cash sale,,,,,,31/05/2018,31/05/2018,0.00,,5.17,,"-435,055.70"
,CS,AR,32004567,1005,100,,Cash sale,,,,,,31/05/2018,31/05/2018,0.00,,7.29,,"-435,062.99"
,CS,AR,32004571,1005,100,,Cash sale,,,,,,31/05/2018,31/05/2018,0.00,,10.93,,"-435,073.92"
,CS,AR,32004572,1005,100,,Cash sale,,,,,,31/05/2018,31/05/2018,0.00,,7.29,,"-435,081.21"
,CS,AR,32004575,1005,100,,Cash sale,,,,,,31/05/2018,31/05/2018,0.00,,3.64,,"-435,084.85"
,CS,AR,32004577,1005,100,,Cash sale,,,,,,31/05/2018,31/05/2018,0.00,,7.29,,"-435,092.14"
,CS,AR,32004579,1005,100,,Cash sale,,,,,,31/05/2018,31/05/2018,0.00,,3.64,,"-435,095.78"
,CS,AR,32004582,1005,100,,Cash sale,,,,,,31/05/2018,31/05/2018,0.00,,7.29,,"-435,103.07"
,CS,AR,32004584,1005,100,,Cash sale,,,,,,31/05/2018,31/05/2018,0.00,,5.93,,"-435,109.00"
,CS,AR,32004585,1005,100,,Cash sale,,,,,,31/05/2018,31/05/2018,0.00,,10.93,,"-435,119.93"
,CS,AR,32004589,1005,100,,Cash sale,,,,,,31/05/2018,31/05/2018,0.00,,7.29,,"-435,127.22"
,CS,AR,32004604,1005,100,,Cash sale,,,,,,31/05/2018,31/05/2018,0.00,,14.58,,"-435,141.80"
,CS,AR,32004613,1005,100,,Cash sale,,,,,,31/05/2018,31/05/2018,0.00,,14.58,,"-435,156.38"
,CS,AR,32004614,1005,100,,Cash sale,,,,,,31/05/2018,31/05/2018,0.00,,5.86,,"-435,162.24"
,CS,AR,32004617,1005,100,,Cash sale,,,,,,31/05/2018,31/05/2018,0.00,,10.93,,"-435,173.17"
,CS,AR,32004624,1005,100,,Cash sale,,,,,,31/05/2018,31/05/2018,0.00,,21.86,,"-435,195.03"
,CS,AR,32004658,1005,100,,Cash sale,,,,,,31/05/2018,31/05/2018,0.00,,7.29,,"-435,202.32"
,IN,AR,30315506,1005,100,,Invoice,,,,,,31/05/2018,31/05/2018,0.00,,"1,093.22",,"-436,295.54"
,IN,AR,30315507,1005,100,,Invoice,,,,,,31/05/2018,31/05/2018,0.00,,13.98,,"-436,309.52"
,IN,AR,30315511,1005,100,,Invoice,,,,,,31/05/2018,31/05/2018,0.00,,5.93,,"-436,315.45"
,IN,AR,30315515,1005,100,,Invoice,,,,,,31/05/2018,31/05/2018,0.00,,3.64,,"-436,319.09"
,IN,AR,30315518,1005,100,,Invoice,,,,,,31/05/2018,31/05/2018,0.00,,364.41,,"-436,683.50"
,IN,AR,30315527,1005,100,,Invoice,,,,,,31/05/2018,31/05/2018,0.00,,"1,532.95",,"-438,216.45"
,IN,AR,30315529,1005,100,,Invoice,,,,,,31/05/2018,31/05/2018,0.00,,3.64,,"-438,220.09"
,IN,AR,30315533,1005,100,,Invoice,,,,,,31/05/2018,31/05/2018,0.00,,7.29,,"-438,227.38"
,IN,AR,30315536,1005,100,,Invoice,,,,,,31/05/2018,31/05/2018,0.00,,364.41,,"-438,591.79"
,IN,AR,30315538,1005,100,,Invoice,,,,,,31/05/2018,31/05/2018,0.00,,14.24,,"-438,606.03"
,IN,AR,30315539,1005,100,,Invoice,,,,,,31/05/2018,31/05/2018,0.00,,182.20,,"-438,788.23"
,IN,AR,30315544,1005,100,,Invoice,,,,,,31/05/2018,31/05/2018,0.00,,43.73,,"-438,831.96"
,IN,AR,30315546,1005,100,,Invoice,,,,,,31/05/2018,31/05/2018,0.00,,3.98,,"-438,835.94"
,IN,AR,30315550,1005,100,,Invoice,,,,,,31/05/2018,31/05/2018,0.00,,66.44,,"-438,902.38"
,IN,AR,30315553,1005,100,,Invoice,,,,,,31/05/2018,31/05/2018,0.00,,"1,603.39",,"-440,505.77"
,IN,AR,30315558,1005,100,,Invoice,,,,,,31/05/2018,31/05/2018,0.00,,54.00,,"-440,559.77"
,IN,AR,30315563,1005,100,,Invoice,,,,,,31/05/2018,31/05/2018,0.00,,40.08,,"-440,599.85"
,IN,AR,30315565,1005,100,,Invoice,,,,,,31/05/2018,31/05/2018,0.00,,7.29,,"-440,607.14"
,IN,AR,30315569,1005,100,,Invoice,,,,,,31/05/2018,31/05/2018,0.00,,7.29,,"-440,614.43"
,IN,AR,30315570,1005,100,,Invoice,,,,,,31/05/2018,31/05/2018,0.00,,3.64,,"-440,618.07"
,IN,AR,30315574,1005,100,,Invoice,,,,,,31/05/2018,31/05/2018,0.00,,182.20,,"-440,800.27"
,IN,AR,30315576,1005,100,,Invoice,,,,,,31/05/2018,31/05/2018,0.00,,59.32,,"-440,859.59"
,IN,AR,30315577,1005,100,,Invoice,,,,,,31/05/2018,31/05/2018,0.00,,51.27,,"-440,910.86"
,IN,AR,30315580,1005,100,,Invoice,,,,,,31/05/2018,31/05/2018,0.00,,32.95,,"-440,943.81"
,IN,AR,30315582,1005,100,,Invoice,,,,,,31/05/2018,31/05/2018,0.00,,22.71,,"-440,966.52"
,IN,AR,30315586,1005,100,,Invoice,,,,,,31/05/2018,31/05/2018,0.00,,364.41,,"-441,330.93"
,IN,AR,30315587,1005,100,,Invoice,,,,,,31/05/2018,31/05/2018,0.00,,105.15,,"-441,436.08"
,IN,AR,30315590,1005,100,,Invoice,,,,,,31/05/2018,31/05/2018,0.00,,21.86,,"-441,457.94"
,IN,AR,30315594,1005,100,,Invoice,,,,,,31/05/2018,31/05/2018,0.00,,102.29,,"-441,560.23"
,IN,AR,30315597,1005,100,,Invoice,,,,,,31/05/2018,31/05/2018,0.00,,182.20,,"-441,742.43"
,IN,AR,30315599,1005,100,,Invoice,,,,,,31/05/2018,31/05/2018,0.00,,18.22,,"-441,760.65"
,IN,AR,30315601,1005,100,,Invoice,,,,,,31/05/2018,31/05/2018,0.00,,10.93,,"-441,771.58"
,IN,AR,30315606,1005,100,,Invoice,,,,,,31/05/2018,31/05/2018,0.00,,3.01,,"-441,774.59"
,IN,AR,30315607,1005,100,,Invoice,,,,,,31/05/2018,31/05/2018,0.00,,182.20,,"-441,956.79"
,IN,AR,30315609,1005,100,,Invoice,,,,,,31/05/2018,31/05/2018,0.00,,3.64,,"-441,960.43"
,IN,AR,30315613,1005,100,,Invoice,,,,,,31/05/2018,31/05/2018,0.00,,14.58,,"-441,975.01"
,IN,AR,30315614,1005,100,,Invoice,,,,,,31/05/2018,31/05/2018,0.00,,"1,415.67",,"-443,390.68"
,IN,AR,30315615,1005,100,,Invoice,,,,,,31/05/2018,31/05/2018,0.00,,68.42,,"-443,459.10"
,IN,AR,30315616,1005,100,,Invoice,,,,,,31/05/2018,31/05/2018,0.00,,7.02,,"-443,466.12"
,IN,AR,30315617,1005,100,,Invoice,,,,,,31/05/2018,31/05/2018,0.00,,15.79,,"-443,481.91"
,IN,AR,30315618,1005,100,,Invoice,,,,,,31/05/2018,31/05/2018,0.00,,92.97,,"-443,574.88"
,IN,AR,30315626,1005,100,,Invoice,,,,,,31/05/2018,31/05/2018,0.00,,300.85,,"-443,875.73"
,IN,AR,30315630,1005,100,,Invoice,,,,,,31/05/2018,31/05/2018,0.00,,54.66,,"-443,930.39"
,IN,AR,30315631,1005,100,,Invoice,,,,,,31/05/2018,31/05/2018,0.00,,54.66,,"-443,985.05"
,IN,AR,30315635,1005,100,,Invoice,,,,,,31/05/2018,31/05/2018,0.00,,189.94,,"-444,174.99"
,IN,AR,30315640,1005,100,,Invoice,,,,,,31/05/2018,31/05/2018,0.00,,"1,757.36",,"-445,932.35"
,IN,AR,30315643,1005,100,,Invoice,,,,,,31/05/2018,31/05/2018,0.00,,22.03,,"-445,954.38"
,IN,AR,30315647,1005,100,,Invoice,,,,,,31/05/2018,31/05/2018,0.00,,7.63,,"-445,962.01"
,IN,AR,30315648,1005,100,,Invoice,,,,,,31/05/2018,31/05/2018,0.00,,114.41,,"-446,076.42"
,IN,AR,30315651,1005,100,,Invoice,,,,,,31/05/2018,31/05/2018,0.00,,28.68,,"-446,105.10"
,IN,AR,30315653,1005,100,,Invoice,,,,,,31/05/2018,31/05/2018,0.00,,6.44,,"-446,111.54"
,IN,AR,30315655,1005,100,,Invoice,,,,,,31/05/2018,31/05/2018,0.00,,919.53,,"-447,031.07"
,IN,AR,30315656,1005,100,,Invoice,,,,,,31/05/2018,31/05/2018,0.00,,41.95,,"-447,073.02"
,IN,AR,30315657,1005,100,,Invoice,,,,,,31/05/2018,31/05/2018,0.00,,26.85,,"-447,099.87"
,IN,AR,30315658,1005,100,,Invoice,,,,,,31/05/2018,31/05/2018,0.00,,36.92,,"-447,136.79"
,IN,AR,30315659,1005,100,,Invoice,,,,,,31/05/2018,31/05/2018,0.00,,13.42,,"-447,150.21"
,IN,AR,30315660,1005,100,,Invoice,,,,,,31/05/2018,31/05/2018,0.00,,20.14,,"-447,170.35"
,IN,AR,30315663,1005,100,,Invoice,,,,,,31/05/2018,31/05/2018,0.00,,3.64,,"-447,173.99"
,IN,AR,30315668,1005,100,,Invoice,,,,,,31/05/2018,31/05/2018,0.00,,157.88,,"-447,331.87"
,IN,AR,30315669,1005,100,,Invoice,,,,,,31/05/2018,31/05/2018,0.00,,221.03,,"-447,552.90"
,IN,AR,30315671,1005,100,,Invoice,,,,,,31/05/2018,31/05/2018,0.00,,43.27,,"-447,596.17"
,IN,AR,30315672,1005,100,,Invoice,,,,,,31/05/2018,31/05/2018,0.00,,66.66,,"-447,662.83"
,IN,AR,30315673,1005,100,,Invoice,,,,,,31/05/2018,31/05/2018,0.00,,210.51,,"-447,873.34"
,IN,AR,30315675,1005,100,,Invoice,,,,,,31/05/2018,31/05/2018,0.00,,49.12,,"-447,922.46"
,IN,AR,30315676,1005,100,,Invoice,,,,,,31/05/2018,31/05/2018,0.00,,9.41,,"-447,931.87"
,IN,AR,30315677,1005,100,,Invoice,,,,,,31/05/2018,31/05/2018,0.00,,43.27,,"-447,975.14"
,IN,AR,30315678,1005,100,,Invoice,,,,,,31/05/2018,31/05/2018,0.00,,65.85,,"-448,040.99"
,IN,AR,30315679,1005,100,,Invoice,,,,,,31/05/2018,31/05/2018,0.00,,31.98,,"-448,072.97"
,IN,AR,30315680,1005,100,,Invoice,,,,,,31/05/2018,31/05/2018,0.00,,26.34,,"-448,099.31"
,IN,AR,30315681,1005,100,,Invoice,,,,,,31/05/2018,31/05/2018,0.00,,58.32,,"-448,157.63"
,IN,AR,30315682,1005,100,,Invoice,,,,,,31/05/2018,31/05/2018,0.00,,15.05,,"-448,172.68"
,IN,AR,30315683,1005,100,,Invoice,,,,,,31/05/2018,31/05/2018,0.00,,5.64,,"-448,178.32"
,IN,AR,30315684,1005,100,,Invoice,,,,,,31/05/2018,31/05/2018,0.00,,20.69,,"-448,199.01"
,IN,AR,30315685,1005,100,,Invoice,,,,,,31/05/2018,31/05/2018,0.00,,9.41,,"-448,208.42"
,IN,AR,30315686,1005,100,,Invoice,,,,,,31/05/2018,31/05/2018,0.00,,342.08,,"-448,550.50"
,IN,AR,30315687,1005,100,,Invoice,,,,,,31/05/2018,31/05/2018,0.00,,14.58,,"-448,565.08"
,IN,AR,30315688,1005,100,,Invoice,,,,,,31/05/2018,31/05/2018,0.00,,77.19,,"-448,642.27"
,IN,AR,30315689,1005,100,,Invoice,,,,,,31/05/2018,31/05/2018,0.00,,36.84,,"-448,679.11"
,IN,AR,30315690,1005,100,,Invoice,,,,,,31/05/2018,31/05/2018,0.00,,3.76,,"-448,682.87"
,IN,AR,30315691,1005,100,,Invoice,,,,,,31/05/2018,31/05/2018,0.00,,47.36,,"-448,730.23"
,IN,AR,30315692,1005,100,,Invoice,,,,,,31/05/2018,31/05/2018,0.00,,43.86,,"-448,774.09"
,IN,AR,30315693,1005,100,,Invoice,,,,,,31/05/2018,31/05/2018,0.00,,21.05,,"-448,795.14"
,IN,AR,30315694,1005,100,,Invoice,,,,,,31/05/2018,31/05/2018,0.00,,35.08,,"-448,830.22"
,IN,AR,30315695,1005,100,,Invoice,,,,,,31/05/2018,31/05/2018,0.00,,26.31,,"-448,856.53"
,IN,AR,30315696,1005,100,,Invoice,,,,,,31/05/2018,31/05/2018,0.00,,2.39,,"-448,858.92"
,IN,AR,30315697,1005,100,,Invoice,,,,,,31/05/2018,31/05/2018,0.00,,7.02,,"-448,865.94"
,IN,AR,30315698,1005,100,,Invoice,,,,,,31/05/2018,31/05/2018,0.00,,364.41,,"-449,230.35"
,IN,AR,30315702,1005,100,,Invoice,,,,,,31/05/2018,31/05/2018,0.00,,10.17,,"-449,240.52"
,IN,AR,30315703,1005,100,,Invoice,,,,,,31/05/2018,31/05/2018,0.00,,26.31,,"-449,266.83"
,IN,AR,30315705,1005,100,,Invoice,,,,,,31/05/2018,31/05/2018,0.00,,15.93,,"-449,282.76"
,IN,AR,30315706,1005,100,,Invoice,,,,,,31/05/2018,31/05/2018,0.00,,62.14,,"-449,344.90"
,IN,AR,30315708,1005,100,,Invoice,,,,,,31/05/2018,31/05/2018,0.00,,6.74,,"-449,351.64"
,IN,AR,30315709,1005,100,,Invoice,,,,,,31/05/2018,31/05/2018,0.00,,14.71,,"-449,366.35"
,IN,AR,30315710,1005,100,,Invoice,,,,,,31/05/2018,31/05/2018,0.00,,294.71,,"-449,661.06"
,IN,AR,30315711,1005,100,,Invoice,,,,,,31/05/2018,31/05/2018,0.00,,2.58,,"-449,663.64"
,IN,AR,30315713,1005,100,,Invoice,,,,,,31/05/2018,31/05/2018,0.00,,4.32,,"-449,667.96"
,IN,AR,30315715,1005,100,,Invoice,,,,,,31/05/2018,31/05/2018,0.00,,100.14,,"-449,768.10"
,IN,AR,30315716,1005,100,,Invoice,,,,,,31/05/2018,31/05/2018,0.00,,17.88,,"-449,785.98"
,IN,AR,30315717,1005,100,,Invoice,,,,,,31/05/2018,31/05/2018,0.00,,12.52,,"-449,798.50"
,IN,AR,30315718,1005,100,,Invoice,,,,,,31/05/2018,31/05/2018,0.00,,10.73,,"-449,809.23"
,IN,AR,30315719,1005,100,,Invoice,,,,,,31/05/2018,31/05/2018,0.00,,87.62,,"-449,896.85"
,IN,AR,30315720,1005,100,,Invoice,,,,,,31/05/2018,31/05/2018,0.00,,46.49,,"-449,943.34"
,IN,AR,30315721,1005,100,,Invoice,,,,,,31/05/2018,31/05/2018,0.00,,28.61,,"-449,971.95"
,IN,AR,30315722,1005,100,,Invoice,,,,,,31/05/2018,31/05/2018,0.00,,28.61,,"-450,000.56"
,IN,AR,30315723,1005,100,,Invoice,,,,,,31/05/2018,31/05/2018,0.00,,33.97,,"-450,034.53"
,IN,AR,30315724,1005,100,,Invoice,,,,,,31/05/2018,31/05/2018,0.00,,1.79,,"-450,036.32"
,IN,AR,30315725,1005,100,,Invoice,,,,,,31/05/2018,31/05/2018,0.00,,3.58,,"-450,039.90"
,IN,AR,30315726,1005,100,,Invoice,,,,,,31/05/2018,31/05/2018,0.00,,1.79,,"-450,041.69"
,IN,AR,30315727,1005,100,,Invoice,,,,,,31/05/2018,31/05/2018,0.00,,275.37,,"-450,317.06"
,IN,AR,30315728,1005,100,,Invoice,,,,,,31/05/2018,31/05/2018,0.00,,8.94,,"-450,326.00"
,IN,AR,30315729,1005,100,,Invoice,,,,,,31/05/2018,31/05/2018,0.00,,12.52,,"-450,338.52"
,IN,AR,30315730,1005,100,,Invoice,,,,,,31/05/2018,31/05/2018,0.00,,17.88,,"-450,356.40"
,IN,AR,30315731,1005,100,,Invoice,,,,,,31/05/2018,31/05/2018,0.00,,12.52,,"-450,368.92"
,IN,AR,30315733,1005,100,,Invoice,,,,,,31/05/2018,31/05/2018,0.00,,28.61,,"-450,397.53"
,IN,AR,30315734,1005,100,,Invoice,,,,,,31/05/2018,31/05/2018,0.00,,84.04,,"-450,481.57"
,IN,AR,30315735,1005,100,,Invoice,,,,,,31/05/2018,31/05/2018,0.00,,25.03,,"-450,506.60"
,IN,AR,30315736,1005,100,,Invoice,,,,,,31/05/2018,31/05/2018,0.00,,12.52,,"-450,519.12"
,IN,AR,30315737,1005,100,,Invoice,,,,,,31/05/2018,31/05/2018,0.00,,16.09,,"-450,535.21"
,IN,AR,30315738,1005,100,,Invoice,,,,,,31/05/2018,31/05/2018,0.00,,25.03,,"-450,560.24"
,IN,AR,30315739,1005,100,,Invoice,,,,,,31/05/2018,31/05/2018,0.00,,7.15,,"-450,567.39"
,IN,AR,30315740,1005,100,,Invoice,,,,,,31/05/2018,31/05/2018,0.00,,129.81,,"-450,697.20"
,IN,AR,30315741,1005,100,,Invoice,,,,,,31/05/2018,31/05/2018,0.00,,251.21,,"-450,948.41"
,IN,AR,30315742,1005,100,,Invoice,,,,,,31/05/2018,31/05/2018,0.00,,85.78,,"-451,034.19"
,IN,AR,30315743,1005,100,,Invoice,,,,,,31/05/2018,31/05/2018,0.00,,10.21,,"-451,044.40"
,IN,AR,30315744,1005,100,,Invoice,,,,,,31/05/2018,31/05/2018,0.00,,110.29,,"-451,154.69"
,IN,AR,30315745,1005,100,,Invoice,,,,,,31/05/2018,31/05/2018,0.00,,30.64,,"-451,185.33"
,IN,AR,30315746,1005,100,,Invoice,,,,,,31/05/2018,31/05/2018,0.00,,238.96,,"-451,424.29"
,IN,AR,30315747,1005,100,,Invoice,,,,,,31/05/2018,31/05/2018,0.00,,8.17,,"-451,432.46"
,IN,AR,30315752,1005,100,,Invoice,,,,,,31/05/2018,31/05/2018,0.00,,3.64,,"-451,436.10"
,IN,AR,30315755,1005,100,,Invoice,,,,,,31/05/2018,31/05/2018,0.00,,27.97,,"-451,464.07"
,IN,AR,30315756,1005,100,,Invoice,,,,,,31/05/2018,31/05/2018,0.00,,22.50,,"-451,486.57"
,IN,AR,30315759,1005,100,,Invoice,,,,,,31/05/2018,31/05/2018,0.00,,10.93,,"-451,497.50"
,IN,AR,30315765,1005,100,,Invoice,,,,,,31/05/2018,31/05/2018,0.00,,10.93,,"-451,508.43"
,IN,AR,30315767,1005,100,,Invoice,,,,,,31/05/2018,31/05/2018,0.00,,12.71,,"-451,521.14"
,IN,AR,30315769,1005,100,,Invoice,,,,,,31/05/2018,31/05/2018,0.00,,38.56,,"-451,559.70"
,IN,AR,30315774,1005,100,,Invoice,,,,,,31/05/2018,31/05/2018,0.00,,8.17,,"-451,567.87"
,IN,AR,30315776,1005,100,,Invoice,,,,,,31/05/2018,31/05/2018,0.00,,13.73,,"-451,581.60"
,IN,AR,30315778,1005,100,,Invoice,,,,,,31/05/2018,31/05/2018,0.00,,5.17,,"-451,586.77"
,IN,AR,30315782,1005,100,,Invoice,,,,,,31/05/2018,31/05/2018,0.00,,21.19,,"-451,607.96"
,IN,AR,30315786,1005,100,,Invoice,,,,,,31/05/2018,31/05/2018,0.00,,4.58,,"-451,612.54"
,IN,AR,30315790,1005,100,,Invoice,,,,,,31/05/2018,31/05/2018,0.00,,"1,106.86",,"-452,719.40"
,IN,AR,30315791,1005,100,,Invoice,,,,,,31/05/2018,31/05/2018,0.00,,684.61,,"-453,404.01"
,IN,AR,30315792,1005,100,,Invoice,,,,,,31/05/2018,31/05/2018,0.00,,58.73,,"-453,462.74"
,IN,AR,30315793,1005,100,,Invoice,,,,,,31/05/2018,31/05/2018,0.00,,45.61,,"-453,508.35"
,IN,AR,30315794,1005,100,,Invoice,,,,,,31/05/2018,31/05/2018,0.00,,7.29,,"-453,515.64"
,IN,AR,30315806,1005,100,,Invoice,,,,,,31/05/2018,31/05/2018,0.00,,6.97,,"-453,522.61"
,IN,AR,30315807,1005,100,,Invoice,,,,,,31/05/2018,31/05/2018,0.00,,14.58,,"-453,537.19"
,IN,AR,30315808,1005,100,,Invoice,,,,,,31/05/2018,31/05/2018,0.00,,364.41,,"-453,901.60"
,IN,AR,30315809,1005,100,,Invoice,,,,,,31/05/2018,31/05/2018,0.00,,11.69,,"-453,913.29"
,IN,AR,30315810,1005,100,,Invoice,,,,,,31/05/2018,31/05/2018,0.00,,16.53,,"-453,929.82"
,IN,AR,30315817,1005,100,,Invoice,,,,,,31/05/2018,31/05/2018,0.00,,25.51,,"-453,955.33"
,IN,AR,30315820,1005,100,,Invoice,,,,,,31/05/2018,31/05/2018,0.00,,98.31,,"-454,053.64"
,IN,AR,30315822,1005,100,,Invoice,,,,,,31/05/2018,31/05/2018,0.00,,15.04,,"-454,068.68"
,IN,AR,30315823,1005,100,,Invoice,,,,,,31/05/2018,31/05/2018,0.00,,54.66,,"-454,123.34"
,IN,AR,30315826,1005,100,,Invoice,,,,,,31/05/2018,31/05/2018,0.00,,16.48,,"-454,139.82"
,IN,AR,30315829,1005,100,,Invoice,,,,,,31/05/2018,31/05/2018,0.00,,15.53,,"-454,155.35"
,IN,AR,30315830,1005,100,,Invoice,,,,,,31/05/2018,31/05/2018,0.00,,10.17,,"-454,165.52"
,IN,AR,30315832,1005,100,,Invoice,,,,,,31/05/2018,31/05/2018,0.00,,176.48,,"-454,342.00"
,IN,AR,30315833,1005,100,,Invoice,,,,,,31/05/2018,31/05/2018,0.00,,21.06,,"-454,363.06"
,IN,AR,30315834,1005,100,,Invoice,,,,,,31/05/2018,31/05/2018,0.00,,8.00,,"-454,371.06"
,IN,AR,30315845,1005,100,,Invoice,,,,,,31/05/2018,31/05/2018,0.00,,3.53,,"-454,374.59"
,IN,AR,30315848,1005,100,,Invoice,,,,,,31/05/2018,31/05/2018,0.00,,10.93,,"-454,385.52"
,IN,AR,30315849,1005,100,,Invoice,,,,,,31/05/2018,31/05/2018,0.00,,14.58,,"-454,400.10"
,IN,AR,30315850,1005,100,,Invoice,,,,,,31/05/2018,31/05/2018,0.00,,2.27,,"-454,402.37"
,IN,AR,30315858,1005,100,,Invoice,,,,,,31/05/2018,31/05/2018,0.00,,704.86,,"-455,107.23"
,IN,AR,30315859,1005,100,,Invoice,,,,,,31/05/2018,31/05/2018,0.00,,704.86,,"-455,812.09"
,IN,AR,30315862,1005,100,,Invoice,,,,,,31/05/2018,31/05/2018,0.00,,5.68,,"-455,817.77"
,IN,AR,30315863,1005,100,,Invoice,,,,,,31/05/2018,31/05/2018,0.00,,135.17,,"-455,952.94"
,IN,AR,30315864,1005,100,,Invoice,,,,,,31/05/2018,31/05/2018,0.00,,27.97,,"-455,980.91"
,IN,AR,30315865,1005,100,,Invoice,,,,,,31/05/2018,31/05/2018,0.00,,58.26,,"-456,039.17"
,IN,AR,30315866,1005,100,,Invoice,,,,,,31/05/2018,31/05/2018,0.00,,16.31,,"-456,055.48"
,IN,AR,30315867,1005,100,,Invoice,,,,,,31/05/2018,31/05/2018,0.00,,39.62,,"-456,095.10"
,IN,AR,30315868,1005,100,,Invoice,,,,,,31/05/2018,31/05/2018,0.00,,39.62,,"-456,134.72"
,IN,AR,30315869,1005,100,,Invoice,,,,,,31/05/2018,31/05/2018,0.00,,30.30,,"-456,165.02"
,IN,AR,30315870,1005,100,,Invoice,,,,,,31/05/2018,31/05/2018,0.00,,60.59,,"-456,225.61"
,IN,AR,30315871,1005,100,,Invoice,,,,,,31/05/2018,31/05/2018,0.00,,41.95,,"-456,267.56"
,IN,AR,30315872,1005,100,,Invoice,,,,,,31/05/2018,31/05/2018,0.00,,18.64,,"-456,286.20"
,IN,AR,30315873,1005,100,,Invoice,,,,,,31/05/2018,31/05/2018,0.00,,858.32,,"-457,144.52"
,IN,AR,30315875,1005,100,,Invoice,,,,,,31/05/2018,31/05/2018,0.00,,21.86,,"-457,166.38"
,IN,AR,30315878,1005,100,,Invoice,,,,,,31/05/2018,31/05/2018,0.00,,14.64,,"-457,181.02"
,IN,AR,30315879,1005,100,,Invoice,,,,,,31/05/2018,31/05/2018,0.00,,13.02,,"-457,194.04"
,IN,AR,30315880,1005,100,,Invoice,,,,,,31/05/2018,31/05/2018,0.00,,40.68,,"-457,234.72"
,IN,AR,30315881,1005,100,,Invoice,,,,,,31/05/2018,31/05/2018,0.00,,4.88,,"-457,239.60"
,IN,AR,30315884,1005,100,,Invoice,,,,,,31/05/2018,31/05/2018,0.00,,15.90,,"-457,255.50"
,IN,AR,30315885,1005,100,,Invoice,,,,,,31/05/2018,31/05/2018,0.00,,23.85,,"-457,279.35"
,IN,AR,30315889,1005,100,,Invoice,,,,,,31/05/2018,31/05/2018,0.00,,26.19,,"-457,305.54"
,IN,AR,30315892,1005,100,,Invoice,,,,,,31/05/2018,31/05/2018,0.00,,14.58,,"-457,320.12"
,IN,AR,30315893,1005,100,,Invoice,,,,,,31/05/2018,31/05/2018,0.00,,148.38,,"-457,468.50"
,IN,AR,30315896,1005,100,,Invoice,,,,,,31/05/2018,31/05/2018,0.00,,209.88,,"-457,678.38"
,IN,AR,30315897,1005,100,,Invoice,,,,,,31/05/2018,31/05/2018,0.00,,461.75,,"-458,140.13"
,IN,AR,30315905,1005,100,,Invoice,,,,,,31/05/2018,31/05/2018,0.00,,17.29,,"-458,157.42"
,IN,AR,30315909,1005,100,,Invoice,,,,,,31/05/2018,31/05/2018,0.00,,12.83,,"-458,170.25"
,IN,AR,30315911,1005,100,,Invoice,,,,,,31/05/2018,31/05/2018,0.00,,10.93,,"-458,181.18"
,IN,AR,30315916,1005,100,,Invoice,,,,,,31/05/2018,31/05/2018,0.00,,13.12,,"-458,194.30"
,IN,AR,30315917,1005,100,,Invoice,,,,,,31/05/2018,31/05/2018,0.00,,294.47,,"-458,488.77"
,IN,AR,30315918,1005,100,,Invoice,,,,,,31/05/2018,31/05/2018,0.00,,30.20,,"-458,518.97"
,IN,AR,30315919,1005,100,,Invoice,,,,,,31/05/2018,31/05/2018,0.00,,35.86,,"-458,554.83"
,IN,AR,30315920,1005,100,,Invoice,,,,,,31/05/2018,31/05/2018,0.00,,18.87,,"-458,573.70"
,IN,AR,30315921,1005,100,,Invoice,,,,,,31/05/2018,31/05/2018,0.00,,15.27,,"-458,588.97"
,IN,AR,30315922,1005,100,,Invoice,,,,,,31/05/2018,31/05/2018,0.00,,7.29,,"-458,596.26"
,IN,AR,30315923,1005,100,,Invoice,,,,,,31/05/2018,31/05/2018,0.00,,54.66,,"-458,650.92"
,IN,AR,30315925,1005,100,,Invoice,,,,,,31/05/2018,31/05/2018,0.00,,18.22,,"-458,669.14"
,IN,AR,30315931,1005,100,,Invoice,,,,,,31/05/2018,31/05/2018,0.00,,16.01,,"-458,685.15"
,IN,AR,30315934,1005,100,,Invoice,,,,,,31/05/2018,31/05/2018,0.00,,20.01,,"-458,705.16"
,IN,AR,30315936,1005,100,,Invoice,,,,,,31/05/2018,31/05/2018,0.00,,8.75,,"-458,713.91"
,IN,AR,30315937,1005,100,,Invoice,,,,,,31/05/2018,31/05/2018,0.00,,14.58,,"-458,728.49"
,IN,AR,30315944,1005,100,,Invoice,,,,,,31/05/2018,31/05/2018,0.00,,102.97,,"-458,831.46"
,IN,AR,30315947,1005,100,,Invoice,,,,,,31/05/2018,31/05/2018,0.00,,54.66,,"-458,886.12"
,IN,AR,30315951,1005,100,,Invoice,,,,,,31/05/2018,31/05/2018,0.00,,364.41,,"-459,250.53"
,IN,AR,30315952,1005,100,,Invoice,,,,,,31/05/2018,31/05/2018,0.00,,18.22,,"-459,268.75"
,IN,AR,30315961,1005,100,,Invoice,,,,,,31/05/2018,31/05/2018,0.00,,8.42,,"-459,277.17"
,IN,AR,30315962,1005,100,,Invoice,,,,,,31/05/2018,31/05/2018,0.00,,38.90,,"-459,316.07"
,IN,AR,30315963,1005,100,,Invoice,,,,,,31/05/2018,31/05/2018,0.00,,10.93,,"-459,327.00"
,IN,AR,30315964,1005,100,,Invoice,,,,,,31/05/2018,31/05/2018,0.00,,5.68,,"-459,332.68"
,IN,AR,30315978,1005,100,,Invoice,,,,,,31/05/2018,31/05/2018,0.00,,81.15,,"-459,413.83"
,IN,AR,30315983,1005,100,,Invoice,,,,,,31/05/2018,31/05/2018,0.00,,4.78,,"-459,418.61"
,IN,AR,30315984,1005,100,,Invoice,,,,,,31/05/2018,31/05/2018,0.00,,119.49,,"-459,538.10"
,IN,AR,30315985,1005,100,,Invoice,,,,,,31/05/2018,31/05/2018,0.00,,11.15,,"-459,549.25"
,IN,AR,30315986,1005,100,,Invoice,,,,,,31/05/2018,31/05/2018,0.00,,23.90,,"-459,573.15"
,IN,AR,30315988,1005,100,,Invoice,,,,,,31/05/2018,31/05/2018,0.00,,806.95,,"-460,380.10"
,IN,AR,30315989,1005,100,,Invoice,,,,,,31/05/2018,31/05/2018,0.00,,13.64,,"-460,393.74"
,IN,AR,30315990,1005,100,,Invoice,,,,,,31/05/2018,31/05/2018,0.00,,7.80,,"-460,401.54"
,IN,AR,30315991,1005,100,,Invoice,,,,,,31/05/2018,31/05/2018,0.00,,25.34,,"-460,426.88"
,IN,AR,30315992,1005,100,,Invoice,,,,,,31/05/2018,31/05/2018,0.00,,7.80,,"-460,434.68"
,IN,AR,30315993,1005,100,,Invoice,,,,,,31/05/2018,31/05/2018,0.00,,31.19,,"-460,465.87"
,IN,AR,30315994,1005,100,,Invoice,,,,,,31/05/2018,31/05/2018,0.00,,11.69,,"-460,477.56"
,IN,AR,30315995,1005,100,,Invoice,,,,,,31/05/2018,31/05/2018,0.00,,9.75,,"-460,487.31"
,IN,AR,30315996,1005,100,,Invoice,,,,,,31/05/2018,31/05/2018,0.00,,37.03,,"-460,524.34"
,IN,AR,30315997,1005,100,,Invoice,,,,,,31/05/2018,31/05/2018,0.00,,54.58,,"-460,578.92"
,IN,AR,30315998,1005,100,,Invoice,,,,,,31/05/2018,31/05/2018,0.00,,17.54,,"-460,596.46"
,IN,AR,30315999,1005,100,,Invoice,,,,,,31/05/2018,31/05/2018,0.00,,17.54,,"-460,614.00"
,IN,AR,30316000,1005,100,,Invoice,,,,,,31/05/2018,31/05/2018,0.00,,113.05,,"-460,727.05"
,IN,AR,30316001,1005,100,,Invoice,,,,,,31/05/2018,31/05/2018,0.00,,25.34,,"-460,752.39"
,IN,AR,30316002,1005,100,,Invoice,,,,,,31/05/2018,31/05/2018,0.00,,13.64,,"-460,766.03"
,IN,AR,30316003,1005,100,,Invoice,,,,,,31/05/2018,31/05/2018,0.00,,15.59,,"-460,781.62"
,IN,AR,30316004,1005,100,,Invoice,,,,,,31/05/2018,31/05/2018,0.00,,13.64,,"-460,795.26"
,IN,AR,30316005,1005,100,,Invoice,,,,,,31/05/2018,31/05/2018,0.00,,17.54,,"-460,812.80"
,IN,AR,30316006,1005,100,,Invoice,,,,,,31/05/2018,31/05/2018,0.00,,9.75,,"-460,822.55"
,IN,AR,30316007,1005,100,,Invoice,,,,,,31/05/2018,31/05/2018,0.00,,793.31,,"-461,615.86"
,IN,AR,30316008,1005,100,,Invoice,,,,,,31/05/2018,31/05/2018,0.00,,52.63,,"-461,668.49"
,IN,AR,30316009,1005,100,,Invoice,,,,,,31/05/2018,31/05/2018,0.00,,7.80,,"-461,676.29"
,IN,AR,30316010,1005,100,,Invoice,,,,,,31/05/2018,31/05/2018,0.00,,40.93,,"-461,717.22"
,IN,AR,30316011,1005,100,,Invoice,,,,,,31/05/2018,31/05/2018,0.00,,740.68,,"-462,457.90"
,IN,AR,30316012,1005,100,,Invoice,,,,,,31/05/2018,31/05/2018,0.00,,15.59,,"-462,473.49"
,IN,AR,30316013,1005,100,,Invoice,,,,,,31/05/2018,31/05/2018,0.00,,5.85,,"-462,479.34"
,IN,AR,30316014,1005,100,,Invoice,,,,,,31/05/2018,31/05/2018,0.00,,17.54,,"-462,496.88"
,IN,AR,30316015,1005,100,,Invoice,,,,,,31/05/2018,31/05/2018,0.00,,9.75,,"-462,506.63"
,IN,AR,30316016,1005,100,,Invoice,,,,,,31/05/2018,31/05/2018,0.00,,33.14,,"-462,539.77"
,IN,AR,30316017,1005,100,,Invoice,,,,,,31/05/2018,31/05/2018,0.00,,93.56,,"-462,633.33"
,IN,AR,30316018,1005,100,,Invoice,,,,,,31/05/2018,31/05/2018,0.00,,46.78,,"-462,680.11"
,IN,AR,30316022,1005,100,,Invoice,,,,,,31/05/2018,31/05/2018,0.00,,54.58,,"-462,734.69"
,IN,AR,30316023,1005,100,,Invoice,,,,,,31/05/2018,31/05/2018,0.00,,16.61,,"-462,751.30"
,IN,AR,30316025,1005,100,,Invoice,,,,,,31/05/2018,31/05/2018,0.00,,24.41,,"-462,775.71"
,IN,AR,30316026,1005,100,,Invoice,,,,,,31/05/2018,31/05/2018,0.00,,8.14,,"-462,783.85"
,IN,AR,30316029,1005,100,,Invoice,,,,,,31/05/2018,31/05/2018,0.00,,15.05,,"-462,798.90"
,IN,AR,30316030,1005,100,,Invoice,,,,,,31/05/2018,31/05/2018,0.00,,11.29,,"-462,810.19"
,IN,AR,30316031,1005,100,,Invoice,,,,,,31/05/2018,31/05/2018,0.00,,11.29,,"-462,821.48"
,IN,AR,30316032,1005,100,,Invoice,,,,,,31/05/2018,31/05/2018,0.00,,5.64,,"-462,827.12"
,IN,AR,30316033,1005,100,,Invoice,,,,,,31/05/2018,31/05/2018,0.00,,3.76,,"-462,830.88"
,IN,AR,30316042,1005,100,,Invoice,,,,,,31/05/2018,31/05/2018,0.00,,45.76,,"-462,876.64"
,IN,AR,30316043,1005,100,,Invoice,,,,,,31/05/2018,31/05/2018,0.00,,11.36,,"-462,888.00"
,IN,AR,30316045,1005,100,,Invoice,,,,,,31/05/2018,31/05/2018,0.00,,875.36,,"-463,763.36"
,IN,AR,30316047,1005,100,,Invoice,,,,,,31/05/2018,31/05/2018,0.00,,11.66,,"-463,775.02"
,IN,AR,30316054,1005,100,,Invoice,,,,,,31/05/2018,31/05/2018,0.00,,316.36,,"-464,091.38"
,IN,AR,30316055,1005,100,,Invoice,,,,,,31/05/2018,31/05/2018,0.00,,350.37,,"-464,441.75"
,IN,AR,30316063,1005,100,,Invoice,,,,,,31/05/2018,31/05/2018,0.00,,7.29,,"-464,449.04"
,IN,AR,30316064,1005,100,,Invoice,,,,,,31/05/2018,31/05/2018,0.00,,36.44,,"-464,485.48"
,IN,AR,30316071,1005,100,,Invoice,,,,,,31/05/2018,31/05/2018,0.00,,27.37,,"-464,512.85"
,IN,AR,30316072,1005,100,,Invoice,,,,,,31/05/2018,31/05/2018,0.00,,46.53,,"-464,559.38"
,IN,AR,30316073,1005,100,,Invoice,,,,,,31/05/2018,31/05/2018,0.00,,19.16,,"-464,578.54"
,IN,AR,30316074,1005,100,,Invoice,,,,,,31/05/2018,31/05/2018,0.00,,8.21,,"-464,586.75"
,IN,AR,30316080,1005,100,,Invoice,,,,,,31/05/2018,31/05/2018,0.00,,3.64,,"-464,590.39"
,IN,AR,30316096,1005,100,,Invoice,,,,,,31/05/2018,31/05/2018,0.00,,4.15,,"-464,594.54"
,IN,AR,30316097,1005,100,,Invoice,,,,,,31/05/2018,31/05/2018,0.00,,2.08,,"-464,596.62"
,IN,AR,30316105,1005,100,,Invoice,,,,,,31/05/2018,31/05/2018,0.00,,12.14,,"-464,608.76"
,IN,AR,30316106,1005,100,,Invoice,,,,,,31/05/2018,31/05/2018,0.00,,7.29,,"-464,616.05"
,IN,AR,30316108,1005,100,,Invoice,,,,,,31/05/2018,31/05/2018,0.00,,18.22,,"-464,634.27"
,CS,AR,32004659,1005,100,,Cash sale,,,,,,01/06/2018,01/06/2018,0.00,,3.64,,"-464,637.91"
,CS,AR,32004660,1005,100,,Cash sale,,,,,,01/06/2018,01/06/2018,0.00,,11.22,,"-464,649.13"
,CS,AR,32004662,1005,100,,Cash sale,,,,,,01/06/2018,01/06/2018,0.00,,7.29,,"-464,656.42"
,CS,AR,32004665,1005,100,,Cash sale,,,,,,01/06/2018,01/06/2018,0.00,,9.49,,"-464,665.91"
,CS,AR,32004667,1005,100,,Cash sale,,,,,,01/06/2018,01/06/2018,0.00,,8.52,,"-464,674.43"
,CS,AR,32004669,1005,100,,Cash sale,,,,,,01/06/2018,01/06/2018,0.00,,12.17,,"-464,686.60"
,CS,AR,32004674,1005,100,,Cash sale,,,,,,01/06/2018,01/06/2018,0.00,,10.93,,"-464,697.53"
,CS,AR,32004679,1005,100,,Cash sale,,,,,,01/06/2018,01/06/2018,0.00,,14.58,,"-464,712.11"
,CS,AR,32004681,1005,100,,Cash sale,,,,,,01/06/2018,01/06/2018,0.00,,12.08,,"-464,724.19"
,CS,AR,32004687,1005,100,,Cash sale,,,,,,01/06/2018,01/06/2018,0.00,,10.93,,"-464,735.12"
,CS,AR,32004688,1005,100,,Cash sale,,,,,,01/06/2018,01/06/2018,0.00,,14.53,,"-464,749.65"
,CS,AR,32004690,1005,100,,Cash sale,,,,,,01/06/2018,01/06/2018,0.00,,7.29,,"-464,756.94"
,CS,AR,32004693,1005,100,,Cash sale,,,,,,01/06/2018,01/06/2018,0.00,,7.29,,"-464,764.23"
,CS,AR,32004694,1005,100,,Cash sale,,,,,,01/06/2018,01/06/2018,0.00,,3.64,,"-464,767.87"
,CS,AR,32004698,1005,100,,Cash sale,,,,,,01/06/2018,01/06/2018,0.00,,7.29,,"-464,775.16"
,CS,AR,32004701,1005,100,,Cash sale,,,,,,01/06/2018,01/06/2018,0.00,,7.29,,"-464,782.45"
,CS,AR,32004710,1005,100,,Cash sale,,,,,,01/06/2018,01/06/2018,0.00,,3.64,,"-464,786.09"
,CS,AR,32004717,1005,100,,Cash sale,,,,,,01/06/2018,01/06/2018,0.00,,29.15,,"-464,815.24"
,CS,AR,32004718,1005,100,,Cash sale,,,,,,01/06/2018,01/06/2018,0.00,,5.17,,"-464,820.41"
,CS,AR,32004719,1005,100,,Cash sale,,,,,,01/06/2018,01/06/2018,0.00,,12.71,,"-464,833.12"
,CS,AR,32004729,1005,100,,Cash sale,,,,,,01/06/2018,01/06/2018,0.00,,35.72,,"-464,868.84"
,CS,AR,32004731,1005,100,,Cash sale,,,,,,01/06/2018,01/06/2018,0.00,,21.98,,"-464,890.82"
,CS,AR,32004735,1005,100,,Cash sale,,,,,,01/06/2018,01/06/2018,0.00,,10.93,,"-464,901.75"
,CS,AR,32004736,1005,100,,Cash sale,,,,,,01/06/2018,01/06/2018,0.00,,10.93,,"-464,912.68"
,CS,AR,32004737,1005,100,,Cash sale,,,,,,01/06/2018,01/06/2018,0.00,,15.04,,"-464,927.72"
,CS,AR,32004738,1005,100,,Cash sale,,,,,,01/06/2018,01/06/2018,0.00,,3.01,,"-464,930.73"
,CS,AR,32004740,1005,100,,Cash sale,,,,,,01/06/2018,01/06/2018,0.00,,14.58,,"-464,945.31"
,CS,AR,32004746,1005,100,,Cash sale,,,,,,01/06/2018,01/06/2018,0.00,,14.58,,"-464,959.89"
,CS,AR,32004747,1005,100,,Cash sale,,,,,,01/06/2018,01/06/2018,0.00,,14.62,,"-464,974.51"
,CS,AR,32004751,1005,100,,Cash sale,,,,,,01/06/2018,01/06/2018,0.00,,9.49,,"-464,984.00"
,CS,AR,32004752,1005,100,,Cash sale,,,,,,01/06/2018,01/06/2018,0.00,,27.08,,"-465,011.08"
,CS,AR,32004757,1005,100,,Cash sale,,,,,,01/06/2018,01/06/2018,0.00,,7.29,,"-465,018.37"
,CS,AR,32004759,1005,100,,Cash sale,,,,,,01/06/2018,01/06/2018,0.00,,10.17,,"-465,028.54"
,CS,AR,32004760,1005,100,,Cash sale,,,,,,01/06/2018,01/06/2018,0.00,,25.51,,"-465,054.05"
,CS,AR,32004764,1005,100,,Cash sale,,,,,,01/06/2018,01/06/2018,0.00,,3.64,,"-465,057.69"
,CS,AR,32004767,1005,100,,Cash sale,,,,,,01/06/2018,01/06/2018,0.00,,14.58,,"-465,072.27"
,CS,AR,32004779,1005,100,,Cash sale,,,,,,01/06/2018,01/06/2018,0.00,,14.58,,"-465,086.85"
,CS,AR,32004783,1005,100,,Cash sale,,,,,,01/06/2018,01/06/2018,0.00,,10.93,,"-465,097.78"
,CS,AR,32004787,1005,100,,Cash sale,,,,,,01/06/2018,01/06/2018,0.00,,7.29,,"-465,105.07"
,CS,AR,32004790,1005,100,,Cash sale,,,,,,01/06/2018,01/06/2018,0.00,,7.75,,"-465,112.82"
,CS,AR,32004792,1005,100,,Cash sale,,,,,,01/06/2018,01/06/2018,0.00,,8.34,,"-465,121.16"
,CS,AR,32004796,1005,100,,Cash sale,,,,,,01/06/2018,01/06/2018,0.00,,14.58,,"-465,135.74"
,CS,AR,32004798,1005,100,,Cash sale,,,,,,01/06/2018,01/06/2018,0.00,,3.64,,"-465,139.38"
,CS,AR,32004799,1005,100,,Cash sale,,,,,,01/06/2018,01/06/2018,0.00,,14.58,,"-465,153.96"
,CS,AR,32004802,1005,100,,Cash sale,,,,,,01/06/2018,01/06/2018,0.00,,7.29,,"-465,161.25"
,CS,AR,32004809,1005,100,,Cash sale,,,,,,01/06/2018,01/06/2018,0.00,,6.12,,"-465,167.37"
,CS,AR,32004813,1005,100,,Cash sale,,,,,,01/06/2018,01/06/2018,0.00,,7.29,,"-465,174.66"
,CS,AR,32004816,1005,100,,Cash sale,,,,,,01/06/2018,01/06/2018,0.00,,48.00,,"-465,222.66"
,CS,AR,32004817,1005,100,,Cash sale,,,,,,01/06/2018,01/06/2018,0.00,,3.64,,"-465,226.30"
,CS,AR,32004822,1005,100,,Cash sale,,,,,,01/06/2018,01/06/2018,0.00,,5.08,,"-465,231.38"
,CS,AR,32004826,1005,100,,Cash sale,,,,,,01/06/2018,01/06/2018,0.00,,6.86,,"-465,238.24"
,CS,AR,32004831,1005,100,,Cash sale,,,,,,01/06/2018,01/06/2018,0.00,,3.03,,"-465,241.27"
,CS,AR,32004834,1005,100,,Cash sale,,,,,,01/06/2018,01/06/2018,0.00,,29.15,,"-465,270.42"
,CS,AR,32004841,1005,100,,Cash sale,,,,,,01/06/2018,01/06/2018,0.00,,21.25,,"-465,291.67"
,CS,AR,32004842,1005,100,,Cash sale,,,,,,01/06/2018,01/06/2018,0.00,,3.64,,"-465,295.31"
,CS,AR,32004844,1005,100,,Cash sale,,,,,,01/06/2018,01/06/2018,0.00,,10.93,,"-465,306.24"
,CS,AR,32004847,1005,100,,Cash sale,,,,,,01/06/2018,01/06/2018,0.00,,3.64,,"-465,309.88"
,CS,AR,32004849,1005,100,,Cash sale,,,,,,01/06/2018,01/06/2018,0.00,,9.15,,"-465,319.03"
,CS,AR,32004851,1005,100,,Cash sale,,,,,,01/06/2018,01/06/2018,0.00,,7.29,,"-465,326.32"
,CS,AR,32004855,1005,100,,Cash sale,,,,,,01/06/2018,01/06/2018,0.00,,14.58,,"-465,340.90"
,CS,AR,32004858,1005,100,,Cash sale,,,,,,01/06/2018,01/06/2018,0.00,,7.29,,"-465,348.19"
,CS,AR,32004860,1005,100,,Cash sale,,,,,,01/06/2018,01/06/2018,0.00,,7.29,,"-465,355.48"
,CS,AR,32004864,1005,100,,Cash sale,,,,,,01/06/2018,01/06/2018,0.00,,10.93,,"-465,366.41"
,CS,AR,32004866,1005,100,,Cash sale,,,,,,01/06/2018,01/06/2018,0.00,,10.93,,"-465,377.34"
,CS,AR,32004867,1005,100,,Cash sale,,,,,,01/06/2018,01/06/2018,0.00,,3.28,,"-465,380.62"
,CS,AR,32004870,1005,100,,Cash sale,,,,,,01/06/2018,01/06/2018,0.00,,3.64,,"-465,384.26"
,CS,AR,32004874,1005,100,,Cash sale,,,,,,01/06/2018,01/06/2018,0.00,,7.29,,"-465,391.55"
,CS,AR,32004888,1005,100,,Cash sale,,,,,,01/06/2018,01/06/2018,0.00,,9.32,,"-465,400.87"
,CS,AR,32004890,1005,100,,Cash sale,,,,,,01/06/2018,01/06/2018,0.00,,3.03,,"-465,403.90"
,CS,AR,32004893,1005,100,,Cash sale,,,,,,01/06/2018,01/06/2018,0.00,,3.64,,"-465,407.54"
,IN,AR,30316117,1005,100,,Invoice,,,,,,01/06/2018,01/06/2018,0.00,,26.69,,"-465,434.23"
,IN,AR,30316118,1005,100,,Invoice,,,,,,01/06/2018,01/06/2018,0.00,,32.63,,"-465,466.86"
,IN,AR,30316119,1005,100,,Invoice,,,,,,01/06/2018,01/06/2018,0.00,,29.66,,"-465,496.52"
,IN,AR,30316122,1005,100,,Invoice,,,,,,01/06/2018,01/06/2018,0.00,,18.22,,"-465,514.74"
,IN,AR,30316125,1005,100,,Invoice,,,,,,01/06/2018,01/06/2018,0.00,,16.78,,"-465,531.52"
,IN,AR,30316134,1005,100,,Invoice,,,,,,01/06/2018,01/06/2018,0.00,,18.22,,"-465,549.74"
,IN,AR,30316137,1005,100,,Invoice,,,,,,01/06/2018,01/06/2018,0.00,,7.29,,"-465,557.03"
,IN,AR,30316140,1005,100,,Invoice,,,,,,01/06/2018,01/06/2018,0.00,,7.29,,"-465,564.32"
,IN,AR,30316142,1005,100,,Invoice,,,,,,01/06/2018,01/06/2018,0.00,,26.57,,"-465,590.89"
,IN,AR,30316147,1005,100,,Invoice,,,,,,01/06/2018,01/06/2018,0.00,,27.47,,"-465,618.36"
,IN,AR,30316150,1005,100,,Invoice,,,,,,01/06/2018,01/06/2018,0.00,,9.19,,"-465,627.55"
,IN,AR,30316151,1005,100,,Invoice,,,,,,01/06/2018,01/06/2018,0.00,,64.04,,"-465,691.59"
,IN,AR,30316155,1005,100,,Invoice,,,,,,01/06/2018,01/06/2018,0.00,,35.59,,"-465,727.18"
,IN,AR,30316168,1005,100,,Invoice,,,,,,01/06/2018,01/06/2018,0.00,,40.00,,"-465,767.18"
,IN,AR,30316175,1005,100,,Invoice,,,,,,01/06/2018,01/06/2018,0.00,,54.66,,"-465,821.84"
,IN,AR,30316182,1005,100,,Invoice,,,,,,01/06/2018,01/06/2018,0.00,,9.73,,"-465,831.57"
,IN,AR,30316187,1005,100,,Invoice,,,,,,01/06/2018,01/06/2018,0.00,,4.75,,"-465,836.32"
,IN,AR,30316189,1005,100,,Invoice,,,,,,01/06/2018,01/06/2018,0.00,,18.00,,"-465,854.32"
,IN,AR,30316199,1005,100,,Invoice,,,,,,01/06/2018,01/06/2018,0.00,,780.96,,"-466,635.28"
,IN,AR,30316201,1005,100,,Invoice,,,,,,01/06/2018,01/06/2018,0.00,,9.70,,"-466,644.98"
,IN,AR,30316205,1005,100,,Invoice,,,,,,01/06/2018,01/06/2018,0.00,,46.00,,"-466,690.98"
,IN,AR,30316209,1005,100,,Invoice,,,,,,01/06/2018,01/06/2018,0.00,,16.78,,"-466,707.76"
,IN,AR,30316211,1005,100,,Invoice,,,,,,01/06/2018,01/06/2018,0.00,,23.29,,"-466,731.05"
,IN,AR,30316212,1005,100,,Invoice,,,,,,01/06/2018,01/06/2018,0.00,,9.03,,"-466,740.08"
,IN,AR,30316215,1005,100,,Invoice,,,,,,01/06/2018,01/06/2018,0.00,,3.64,,"-466,743.72"
,IN,AR,30316217,1005,100,,Invoice,,,,,,01/06/2018,01/06/2018,0.00,,11.15,,"-466,754.87"
,IN,AR,30316221,1005,100,,Invoice,,,,,,01/06/2018,01/06/2018,0.00,,28.00,,"-466,782.87"
,IN,AR,30316223,1005,100,,Invoice,,,,,,01/06/2018,01/06/2018,0.00,,18.22,,"-466,801.09"
,IN,AR,30316224,1005,100,,Invoice,,,,,,01/06/2018,01/06/2018,0.00,,5.17,,"-466,806.26"
,IN,AR,30316227,1005,100,,Invoice,,,,,,01/06/2018,01/06/2018,0.00,,4.80,,"-466,811.06"
,IN,AR,30316234,1005,100,,Invoice,,,,,,01/06/2018,01/06/2018,0.00,,42.71,,"-466,853.77"
,IN,AR,30316238,1005,100,,Invoice,,,,,,01/06/2018,01/06/2018,0.00,,7.29,,"-466,861.06"
,IN,AR,30316241,1005,100,,Invoice,,,,,,01/06/2018,01/06/2018,0.00,,91.10,,"-466,952.16"
,IN,AR,30316242,1005,100,,Invoice,,,,,,01/06/2018,01/06/2018,0.00,,25.85,,"-466,978.01"
,IN,AR,30316244,1005,100,,Invoice,,,,,,01/06/2018,01/06/2018,0.00,,2.39,,"-466,980.40"
,IN,AR,30316248,1005,100,,Invoice,,,,,,01/06/2018,01/06/2018,0.00,,29.15,,"-467,009.55"
,IN,AR,30316249,1005,100,,Invoice,,,,,,01/06/2018,01/06/2018,0.00,,19.58,,"-467,029.13"
,IN,AR,30316253,1005,100,,Invoice,,,,,,01/06/2018,01/06/2018,0.00,,9.03,,"-467,038.16"
,IN,AR,30316258,1005,100,,Invoice,,,,,,01/06/2018,01/06/2018,0.00,,57.42,,"-467,095.58"
,IN,AR,30316261,1005,100,,Invoice,,,,,,01/06/2018,01/06/2018,0.00,,33.66,,"-467,129.24"
,IN,AR,30316266,1005,100,,Invoice,,,,,,01/06/2018,01/06/2018,0.00,,16.73,,"-467,145.97"
,IN,AR,30316281,1005,100,,Invoice,,,,,,01/06/2018,01/06/2018,0.00,,4.24,,"-467,150.21"
,IN,AR,30316282,1005,100,,Invoice,,,,,,01/06/2018,01/06/2018,0.00,,6.02,,"-467,156.23"
,IN,AR,30316286,1005,100,,Invoice,,,,,,01/06/2018,01/06/2018,0.00,,12.71,,"-467,168.94"
,IN,AR,30316287,1005,100,,Invoice,,,,,,01/06/2018,01/06/2018,0.00,,7.63,,"-467,176.57"
,IN,AR,30316288,1005,100,,Invoice,,,,,,01/06/2018,01/06/2018,0.00,,2.54,,"-467,179.11"
,IN,AR,30316291,1005,100,,Invoice,,,,,,01/06/2018,01/06/2018,0.00,,7.63,,"-467,186.74"
,IN,AR,30316297,1005,100,,Invoice,,,,,,01/06/2018,01/06/2018,0.00,,12.71,,"-467,199.45"
,IN,AR,30316299,1005,100,,Invoice,,,,,,01/06/2018,01/06/2018,0.00,,12.71,,"-467,212.16"
,IN,AR,30316327,1005,100,,Invoice,,,,,,01/06/2018,01/06/2018,0.00,,3.64,,"-467,215.80"
,IN,AR,30316331,1005,100,,Invoice,,,,,,01/06/2018,01/06/2018,0.00,,5.93,,"-467,221.73"
,IN,AR,30316336,1005,100,,Invoice,,,,,,01/06/2018,01/06/2018,0.00,,14.58,,"-467,236.31"
,IN,AR,30316340,1005,100,,Invoice,,,,,,01/06/2018,01/06/2018,0.00,,10.93,,"-467,247.24"
,IN,AR,30316343,1005,100,,Invoice,,,,,,01/06/2018,01/06/2018,0.00,,8.47,,"-467,255.71"
,IN,AR,30316347,1005,100,,Invoice,,,,,,01/06/2018,01/06/2018,0.00,,75.66,,"-467,331.37"
,IN,AR,30316353,1005,100,,Invoice,,,,,,01/06/2018,01/06/2018,0.00,,7.29,,"-467,338.66"
,IN,AR,30316356,1005,100,,Invoice,,,,,,01/06/2018,01/06/2018,0.00,,14.58,,"-467,353.24"
,IN,AR,30316359,1005,100,,Invoice,,,,,,01/06/2018,01/06/2018,0.00,,5.17,,"-467,358.41"
,IN,AR,30316374,1005,100,,Invoice,,,,,,01/06/2018,01/06/2018,0.00,,41.53,,"-467,399.94"
,IN,AR,30316375,1005,100,,Invoice,,,,,,01/06/2018,01/06/2018,0.00,,3.88,,"-467,403.82"
,IN,AR,30316379,1005,100,,Invoice,,,,,,01/06/2018,01/06/2018,0.00,,54.66,,"-467,458.48"
,IN,AR,30316387,1005,100,,Invoice,,,,,,01/06/2018,01/06/2018,0.00,,4.85,,"-467,463.33"
,IN,AR,30316403,1005,100,,Invoice,,,,,,01/06/2018,01/06/2018,0.00,,7.29,,"-467,470.62"
,IN,AR,30316412,1005,100,,Invoice,,,,,,01/06/2018,01/06/2018,0.00,,19.47,,"-467,490.09"
,IN,AR,30316413,1005,100,,Invoice,,,,,,01/06/2018,01/06/2018,0.00,,51.10,,"-467,541.19"
,IN,AR,30316418,1005,100,,Invoice,,,,,,01/06/2018,01/06/2018,0.00,,44.09,,"-467,585.28"
,IN,AR,30316423,1005,100,,Invoice,,,,,,01/06/2018,01/06/2018,0.00,,21.25,,"-467,606.53"
,IN,AR,30316431,1005,100,,Invoice,,,,,,01/06/2018,01/06/2018,0.00,,31.53,,"-467,638.06"
,IN,AR,30316435,1005,100,,Invoice,,,,,,01/06/2018,01/06/2018,0.00,,21.52,,"-467,659.58"
,IN,AR,30316437,1005,100,,Invoice,,,,,,01/06/2018,01/06/2018,0.00,,36.44,,"-467,696.02"
,IN,AR,30316438,1005,100,,Invoice,,,,,,01/06/2018,01/06/2018,0.00,,25.42,,"-467,721.44"
,IN,AR,30316443,1005,100,,Invoice,,,,,,01/06/2018,01/06/2018,0.00,,10.00,,"-467,731.44"
,IN,AR,30316454,1005,100,,Invoice,,,,,,01/06/2018,01/06/2018,0.00,,30.11,,"-467,761.55"
,IN,AR,30316455,1005,100,,Invoice,,,,,,01/06/2018,01/06/2018,0.00,,56.77,,"-467,818.32"
,IN,AR,30316462,1005,100,,Invoice,,,,,,01/06/2018,01/06/2018,0.00,,6.89,,"-467,825.21"
,IN,AR,30316477,1005,100,,Invoice,,,,,,01/06/2018,01/06/2018,0.00,,11.36,,"-467,836.57"
,IN,AR,30316479,1005,100,,Invoice,,,,,,01/06/2018,01/06/2018,0.00,,12.08,,"-467,848.65"
,IN,AR,30316494,1005,100,,Invoice,,,,,,01/06/2018,01/06/2018,0.00,,12.00,,"-467,860.65"
,IN,AR,30316507,1005,100,,Invoice,,,,,,01/06/2018,01/06/2018,0.00,,3.64,,"-467,864.29"
,IN,AR,30316508,1005,100,,Invoice,,,,,,01/06/2018,01/06/2018,0.00,,5.83,,"-467,870.12"
,IN,AR,30316509,1005,100,,Invoice,,,,,,01/06/2018,01/06/2018,0.00,,5.47,,"-467,875.59"
,IN,AR,30316513,1005,100,,Invoice,,,,,,01/06/2018,01/06/2018,0.00,,7.29,,"-467,882.88"
,IN,AR,30316514,1005,100,,Invoice,,,,,,01/06/2018,01/06/2018,0.00,,57.20,,"-467,940.08"
,IN,AR,30316517,1005,100,,Invoice,,,,,,01/06/2018,01/06/2018,0.00,,10.93,,"-467,951.01"
,IN,AR,30316519,1005,100,,Invoice,,,,,,01/06/2018,01/06/2018,0.00,,14.58,,"-467,965.59"
,IN,AR,30316522,1005,100,,Invoice,,,,,,01/06/2018,01/06/2018,0.00,,10.21,,"-467,975.80"
,IN,AR,30316530,1005,100,,Invoice,,,,,,01/06/2018,01/06/2018,0.00,,5.51,,"-467,981.31"
,IN,AR,30316534,1005,100,,Invoice,,,,,,01/06/2018,01/06/2018,0.00,,13.94,,"-467,995.25"
,IN,AR,30316540,1005,100,,Invoice,,,,,,01/06/2018,01/06/2018,0.00,,4.00,,"-467,999.25"
,IN,AR,30316542,1005,100,,Invoice,,,,,,01/06/2018,01/06/2018,0.00,,4.15,,"-468,003.40"
,IN,AR,30316543,1005,100,,Invoice,,,,,,01/06/2018,01/06/2018,0.00,,14.53,,"-468,017.93"
,IN,AR,30316544,1005,100,,Invoice,,,,,,01/06/2018,01/06/2018,0.00,,8.31,,"-468,026.24"
,IN,AR,30316558,1005,100,,Invoice,,,,,,01/06/2018,01/06/2018,0.00,,45.51,,"-468,071.75"
,IN,AR,30316560,1005,100,,Invoice,,,,,,01/06/2018,01/06/2018,0.00,,15.17,,"-468,086.92"
,IN,AR,30316563,1005,100,,Invoice,,,,,,01/06/2018,01/06/2018,0.00,,18.22,,"-468,105.14"
,IN,AR,30316565,1005,100,,Invoice,,,,,,01/06/2018,01/06/2018,0.00,,9.10,,"-468,114.24"
,IN,AR,30316568,1005,100,,Invoice,,,,,,01/06/2018,01/06/2018,0.00,,4.07,,"-468,118.31"
,CR,AR,33000154,1005,100,,Cash Return,,,,,,02/06/2018,02/06/2018,26.10,,0.00,,"-468,092.21"
,CS,AR,32004671,1005,100,,Cash sale,,,,,,02/06/2018,02/06/2018,0.00,,3.01,,"-468,095.22"
,CS,AR,32004692,1005,100,,Cash sale,,,,,,02/06/2018,02/06/2018,0.00,,3.64,,"-468,098.86"
,CS,AR,32004699,1005,100,,Cash sale,,,,,,02/06/2018,02/06/2018,0.00,,10.93,,"-468,109.79"
,CS,AR,32004725,1005,100,,Cash sale,,,,,,02/06/2018,02/06/2018,0.00,,10.93,,"-468,120.72"
,CS,AR,32004789,1005,100,,Cash sale,,,,,,02/06/2018,02/06/2018,0.00,,7.29,,"-468,128.01"
,CS,AR,32004804,1005,100,,Cash sale,,,,,,02/06/2018,02/06/2018,0.00,,18.22,,"-468,146.23"
,CS,AR,32004823,1005,100,,Cash sale,,,,,,02/06/2018,02/06/2018,0.00,,9.11,,"-468,155.34"
,CS,AR,32004835,1005,100,,Cash sale,,,,,,02/06/2018,02/06/2018,0.00,,4.24,,"-468,159.58"
,CS,AR,32004838,1005,100,,Cash sale,,,,,,02/06/2018,02/06/2018,0.00,,25.51,,"-468,185.09"
,CS,AR,32004857,1005,100,,Cash sale,,,,,,02/06/2018,02/06/2018,0.00,,10.93,,"-468,196.02"
,CS,AR,32004871,1005,100,,Cash sale,,,,,,02/06/2018,02/06/2018,0.00,,14.58,,"-468,210.60"
,CS,AR,32004895,1005,100,,Cash sale,,,,,,02/06/2018,02/06/2018,0.00,,10.93,,"-468,221.53"
,IN,AR,30316203,1005,100,,Invoice,,,,,,02/06/2018,02/06/2018,0.00,,14.58,,"-468,236.11"
,IN,AR,30316204,1005,100,,Invoice,,,,,,02/06/2018,02/06/2018,0.00,,10.93,,"-468,247.04"
,IN,AR,30316307,1005,100,,Invoice,,,,,,02/06/2018,02/06/2018,0.00,,7.29,,"-468,254.33"
,IN,AR,30316352,1005,100,,Invoice,,,,,,02/06/2018,02/06/2018,0.00,,3.01,,"-468,257.34"
,IN,AR,30316406,1005,100,,Invoice,,,,,,02/06/2018,02/06/2018,0.00,,9.84,,"-468,267.18"
,IN,AR,30316466,1005,100,,Invoice,,,,,,02/06/2018,02/06/2018,0.00,,18.22,,"-468,285.40"
,CN,AR,31018128,1005,100,,Credit Note,,,,,,04/06/2018,04/06/2018,862.17,,0.00,,"-467,423.23"
,CS,AR,32004661,1005,100,,Cash sale,,,,,,04/06/2018,04/06/2018,0.00,,11.22,,"-467,434.45"
,CS,AR,32004666,1005,100,,Cash sale,,,,,,04/06/2018,04/06/2018,0.00,,14.24,,"-467,448.69"
,CS,AR,32004689,1005,100,,Cash sale,,,,,,04/06/2018,04/06/2018,0.00,,12.46,,"-467,461.15"
,CS,AR,32004695,1005,100,,Cash sale,,,,,,04/06/2018,04/06/2018,0.00,,8.77,,"-467,469.92"
,CS,AR,32004697,1005,100,,Cash sale,,,,,,04/06/2018,04/06/2018,0.00,,7.29,,"-467,477.21"
,CS,AR,32004700,1005,100,,Cash sale,,,,,,04/06/2018,04/06/2018,0.00,,3.64,,"-467,480.85"
,CS,AR,32004707,1005,100,,Cash sale,,,,,,04/06/2018,04/06/2018,0.00,,10.34,,"-467,491.19"
,CS,AR,32004712,1005,100,,Cash sale,,,,,,04/06/2018,04/06/2018,0.00,,7.17,,"-467,498.36"
,CS,AR,32004715,1005,100,,Cash sale,,,,,,04/06/2018,04/06/2018,0.00,,10.93,,"-467,509.29"
,CS,AR,32004716,1005,100,,Cash sale,,,,,,04/06/2018,04/06/2018,0.00,,3.64,,"-467,512.93"
,CS,AR,32004720,1005,100,,Cash sale,,,,,,04/06/2018,04/06/2018,0.00,,12.71,,"-467,525.64"
,CS,AR,32004722,1005,100,,Cash sale,,,,,,04/06/2018,04/06/2018,0.00,,3.64,,"-467,529.28"
,CS,AR,32004728,1005,100,,Cash sale,,,,,,04/06/2018,04/06/2018,0.00,,15.51,,"-467,544.79"
,CS,AR,32004734,1005,100,,Cash sale,,,,,,04/06/2018,04/06/2018,0.00,,3.64,,"-467,548.43"
,CS,AR,32004744,1005,100,,Cash sale,,,,,,04/06/2018,04/06/2018,0.00,,12.71,,"-467,561.14"
,CS,AR,32004748,1005,100,,Cash sale,,,,,,04/06/2018,04/06/2018,0.00,,14.62,,"-467,575.76"
,CS,AR,32004749,1005,100,,Cash sale,,,,,,04/06/2018,04/06/2018,0.00,,13.60,,"-467,589.36"
,CS,AR,32004753,1005,100,,Cash sale,,,,,,04/06/2018,04/06/2018,0.00,,21.06,,"-467,610.42"
,CS,AR,32004769,1005,100,,Cash sale,,,,,,04/06/2018,04/06/2018,0.00,,5.08,,"-467,615.50"
,CS,AR,32004773,1005,100,,Cash sale,,,,,,04/06/2018,04/06/2018,0.00,,14.58,,"-467,630.08"
,CS,AR,32004774,1005,100,,Cash sale,,,,,,04/06/2018,04/06/2018,0.00,,3.64,,"-467,633.72"
,CS,AR,32004776,1005,100,,Cash sale,,,,,,04/06/2018,04/06/2018,0.00,,7.29,,"-467,641.01"
,CS,AR,32004778,1005,100,,Cash sale,,,,,,04/06/2018,04/06/2018,0.00,,14.58,,"-467,655.59"
,CS,AR,32004786,1005,100,,Cash sale,,,,,,04/06/2018,04/06/2018,0.00,,7.29,,"-467,662.88"
,CS,AR,32004800,1005,100,,Cash sale,,,,,,04/06/2018,04/06/2018,0.00,,7.29,,"-467,670.17"
,CS,AR,32004806,1005,100,,Cash sale,,,,,,04/06/2018,04/06/2018,0.00,,10.17,,"-467,680.34"
,CS,AR,32004808,1005,100,,Cash sale,,,,,,04/06/2018,04/06/2018,0.00,,7.29,,"-467,687.63"
,CS,AR,32004820,1005,100,,Cash sale,,,,,,04/06/2018,04/06/2018,0.00,,14.58,,"-467,702.21"
,CS,AR,32004821,1005,100,,Cash sale,,,,,,04/06/2018,04/06/2018,0.00,,182.20,,"-467,884.41"
,CS,AR,32004825,1005,100,,Cash sale,,,,,,04/06/2018,04/06/2018,0.00,,6.56,,"-467,890.97"
,CS,AR,32004827,1005,100,,Cash sale,,,,,,04/06/2018,04/06/2018,0.00,,11.44,,"-467,902.41"
,CS,AR,32004830,1005,100,,Cash sale,,,,,,04/06/2018,04/06/2018,0.00,,5.93,,"-467,908.34"
,CS,AR,32004836,1005,100,,Cash sale,,,,,,04/06/2018,04/06/2018,0.00,,9.10,,"-467,917.44"
,CS,AR,32004845,1005,100,,Cash sale,,,,,,04/06/2018,04/06/2018,0.00,,10.93,,"-467,928.37"
,CS,AR,32004853,1005,100,,Cash sale,,,,,,04/06/2018,04/06/2018,0.00,,10.93,,"-467,939.30"
,CS,AR,32004856,1005,100,,Cash sale,,,,,,04/06/2018,04/06/2018,0.00,,3.64,,"-467,942.94"
,CS,AR,32004865,1005,100,,Cash sale,,,,,,04/06/2018,04/06/2018,0.00,,18.22,,"-467,961.16"
,CS,AR,32004872,1005,100,,Cash sale,,,,,,04/06/2018,04/06/2018,0.00,,3.64,,"-467,964.80"
,CS,AR,32004889,1005,100,,Cash sale,,,,,,04/06/2018,04/06/2018,0.00,,9.32,,"-467,974.12"
,CS,AR,32004891,1005,100,,Cash sale,,,,,,04/06/2018,04/06/2018,0.00,,7.29,,"-467,981.41"
,CS,AR,32004898,1005,100,,Cash sale,,,,,,04/06/2018,04/06/2018,0.00,,54.66,,"-468,036.07"
,IN,AR,30316116,1005,100,,Invoice,,,,,,04/06/2018,04/06/2018,0.00,,84.54,,"-468,120.61"
,IN,AR,30316120,1005,100,,Invoice,,,,,,04/06/2018,04/06/2018,0.00,,41.53,,"-468,162.14"
,IN,AR,30316124,1005,100,,Invoice,,,,,,04/06/2018,04/06/2018,0.00,,14.58,,"-468,176.72"
,IN,AR,30316127,1005,100,,Invoice,,,,,,04/06/2018,04/06/2018,0.00,,56.14,,"-468,232.86"
,IN,AR,30316129,1005,100,,Invoice,,,,,,04/06/2018,04/06/2018,0.00,,2.03,,"-468,234.89"
,IN,AR,30316130,1005,100,,Invoice,,,,,,04/06/2018,04/06/2018,0.00,,8.10,,"-468,242.99"
,IN,AR,30316131,1005,100,,Invoice,,,,,,04/06/2018,04/06/2018,0.00,,4.05,,"-468,247.04"
,IN,AR,30316132,1005,100,,Invoice,,,,,,04/06/2018,04/06/2018,0.00,,8.10,,"-468,255.14"
,IN,AR,30316133,1005,100,,Invoice,,,,,,04/06/2018,04/06/2018,0.00,,66.84,,"-468,321.98"
,IN,AR,30316141,1005,100,,Invoice,,,,,,04/06/2018,04/06/2018,0.00,,18.22,,"-468,340.20"
,IN,AR,30316148,1005,100,,Invoice,,,,,,04/06/2018,04/06/2018,0.00,,23.25,,"-468,363.45"
,IN,AR,30316152,1005,100,,Invoice,,,,,,04/06/2018,04/06/2018,0.00,,3.64,,"-468,367.09"
,IN,AR,30316156,1005,100,,Invoice,,,,,,04/06/2018,04/06/2018,0.00,,168.47,,"-468,535.56"
,IN,AR,30316159,1005,100,,Invoice,,,,,,04/06/2018,04/06/2018,0.00,,19.28,,"-468,554.84"
,IN,AR,30316161,1005,100,,Invoice,,,,,,04/06/2018,04/06/2018,0.00,,48.00,,"-468,602.84"
,IN,AR,30316165,1005,100,,Invoice,,,,,,04/06/2018,04/06/2018,0.00,,65.75,,"-468,668.59"
,IN,AR,30316167,1005,100,,Invoice,,,,,,04/06/2018,04/06/2018,0.00,,3.64,,"-468,672.23"
,IN,AR,30316169,1005,100,,Invoice,,,,,,04/06/2018,04/06/2018,0.00,,48.00,,"-468,720.23"
,IN,AR,30316170,1005,100,,Invoice,,,,,,04/06/2018,04/06/2018,0.00,,28.00,,"-468,748.23"
,IN,AR,30316176,1005,100,,Invoice,,,,,,04/06/2018,04/06/2018,0.00,,5.51,,"-468,753.74"
,IN,AR,30316177,1005,100,,Invoice,,,,,,04/06/2018,04/06/2018,0.00,,5.51,,"-468,759.25"
,IN,AR,30316179,1005,100,,Invoice,,,,,,04/06/2018,04/06/2018,0.00,,35.59,,"-468,794.84"
,IN,AR,30316180,1005,100,,Invoice,,,,,,04/06/2018,04/06/2018,0.00,,5.51,,"-468,800.35"
,IN,AR,30316183,1005,100,,Invoice,,,,,,04/06/2018,04/06/2018,0.00,,5.84,,"-468,806.19"
,IN,AR,30316190,1005,100,,Invoice,,,,,,04/06/2018,04/06/2018,0.00,,14.00,,"-468,820.19"
,IN,AR,30316192,1005,100,,Invoice,,,,,,04/06/2018,04/06/2018,0.00,,10.93,,"-468,831.12"
,IN,AR,30316197,1005,100,,Invoice,,,,,,04/06/2018,04/06/2018,0.00,,128.25,,"-468,959.37"
,IN,AR,30316206,1005,100,,Invoice,,,,,,04/06/2018,04/06/2018,0.00,,28.00,,"-468,987.37"
,IN,AR,30316210,1005,100,,Invoice,,,,,,04/06/2018,04/06/2018,0.00,,17.71,,"-469,005.08"
,IN,AR,30316214,1005,100,,Invoice,,,,,,04/06/2018,04/06/2018,0.00,,28.39,,"-469,033.47"
,IN,AR,30316220,1005,100,,Invoice,,,,,,04/06/2018,04/06/2018,0.00,,20.68,,"-469,054.15"
,IN,AR,30316225,1005,100,,Invoice,,,,,,04/06/2018,04/06/2018,0.00,,12.92,,"-469,067.07"
,IN,AR,30316228,1005,100,,Invoice,,,,,,04/06/2018,04/06/2018,0.00,,16.08,,"-469,083.15"
,IN,AR,30316233,1005,100,,Invoice,,,,,,04/06/2018,04/06/2018,0.00,,4.24,,"-469,087.39"
,IN,AR,30316235,1005,100,,Invoice,,,,,,04/06/2018,04/06/2018,0.00,,4.07,,"-469,091.46"
,IN,AR,30316240,1005,100,,Invoice,,,,,,04/06/2018,04/06/2018,0.00,,6.36,,"-469,097.82"
,IN,AR,30316243,1005,100,,Invoice,,,,,,04/06/2018,04/06/2018,0.00,,20.68,,"-469,118.50"
,IN,AR,30316246,1005,100,,Invoice,,,,,,04/06/2018,04/06/2018,0.00,,10.38,,"-469,128.88"
,IN,AR,30316247,1005,100,,Invoice,,,,,,04/06/2018,04/06/2018,0.00,,12.94,,"-469,141.82"
,IN,AR,30316250,1005,100,,Invoice,,,,,,04/06/2018,04/06/2018,0.00,,39.15,,"-469,180.97"
,IN,AR,30316259,1005,100,,Invoice,,,,,,04/06/2018,04/06/2018,0.00,,94.34,,"-469,275.31"
,IN,AR,30316262,1005,100,,Invoice,,,,,,04/06/2018,04/06/2018,0.00,,48.31,,"-469,323.62"
,IN,AR,30316267,1005,100,,Invoice,,,,,,04/06/2018,04/06/2018,0.00,,28.68,,"-469,352.30"
,IN,AR,30316268,1005,100,,Invoice,,,,,,04/06/2018,04/06/2018,0.00,,9.56,,"-469,361.86"
,IN,AR,30316269,1005,100,,Invoice,,,,,,04/06/2018,04/06/2018,0.00,,28.98,,"-469,390.84"
,IN,AR,30316271,1005,100,,Invoice,,,,,,04/06/2018,04/06/2018,0.00,,54.66,,"-469,445.50"
,IN,AR,30316272,1005,100,,Invoice,,,,,,04/06/2018,04/06/2018,0.00,,9.03,,"-469,454.53"
,IN,AR,30316273,1005,100,,Invoice,,,,,,04/06/2018,04/06/2018,0.00,,7.29,,"-469,461.82"
,IN,AR,30316274,1005,100,,Invoice,,,,,,04/06/2018,04/06/2018,0.00,,20.88,,"-469,482.70"
,IN,AR,30316276,1005,100,,Invoice,,,,,,04/06/2018,04/06/2018,0.00,,8.26,,"-469,490.96"
,IN,AR,30316277,1005,100,,Invoice,,,,,,04/06/2018,04/06/2018,0.00,,10.93,,"-469,501.89"
,IN,AR,30316284,1005,100,,Invoice,,,,,,04/06/2018,04/06/2018,0.00,,4.32,,"-469,506.21"
,IN,AR,30316289,1005,100,,Invoice,,,,,,04/06/2018,04/06/2018,0.00,,10.17,,"-469,516.38"
,IN,AR,30316290,1005,100,,Invoice,,,,,,04/06/2018,04/06/2018,0.00,,7.29,,"-469,523.67"
,IN,AR,30316302,1005,100,,Invoice,,,,,,04/06/2018,04/06/2018,0.00,,364.41,,"-469,888.08"
,IN,AR,30316308,1005,100,,Invoice,,,,,,04/06/2018,04/06/2018,0.00,,30.51,,"-469,918.59"
,IN,AR,30316310,1005,100,,Invoice,,,,,,04/06/2018,04/06/2018,0.00,,24.41,,"-469,943.00"
,IN,AR,30316314,1005,100,,Invoice,,,,,,04/06/2018,04/06/2018,0.00,,7.29,,"-469,950.29"
,IN,AR,30316317,1005,100,,Invoice,,,,,,04/06/2018,04/06/2018,0.00,,3.64,,"-469,953.93"
,IN,AR,30316319,1005,100,,Invoice,,,,,,04/06/2018,04/06/2018,0.00,,14.58,,"-469,968.51"
,IN,AR,30316322,1005,100,,Invoice,,,,,,04/06/2018,04/06/2018,0.00,,11.02,,"-469,979.53"
,IN,AR,30316323,1005,100,,Invoice,,,,,,04/06/2018,04/06/2018,0.00,,3.64,,"-469,983.17"
,IN,AR,30316325,1005,100,,Invoice,,,,,,04/06/2018,04/06/2018,0.00,,9.19,,"-469,992.36"
,IN,AR,30316326,1005,100,,Invoice,,,,,,04/06/2018,04/06/2018,0.00,,30.86,,"-470,023.22"
,IN,AR,30316329,1005,100,,Invoice,,,,,,04/06/2018,04/06/2018,0.00,,7.88,,"-470,031.10"
,IN,AR,30316349,1005,100,,Invoice,,,,,,04/06/2018,04/06/2018,0.00,,30.00,,"-470,061.10"
,IN,AR,30316360,1005,100,,Invoice,,,,,,04/06/2018,04/06/2018,0.00,,5.17,,"-470,066.27"
,IN,AR,30316364,1005,100,,Invoice,,,,,,04/06/2018,04/06/2018,0.00,,36.12,,"-470,102.39"
,IN,AR,30316366,1005,100,,Invoice,,,,,,04/06/2018,04/06/2018,0.00,,29.15,,"-470,131.54"
,IN,AR,30316369,1005,100,,Invoice,,,,,,04/06/2018,04/06/2018,0.00,,29.15,,"-470,160.69"
,IN,AR,30316377,1005,100,,Invoice,,,,,,04/06/2018,04/06/2018,0.00,,6.53,,"-470,167.22"
,IN,AR,30316400,1005,100,,Invoice,,,,,,04/06/2018,04/06/2018,0.00,,4.29,,"-470,171.51"
,IN,AR,30316416,1005,100,,Invoice,,,,,,04/06/2018,04/06/2018,0.00,,4.29,,"-470,175.80"
,IN,AR,30316419,1005,100,,Invoice,,,,,,04/06/2018,04/06/2018,0.00,,28.06,,"-470,203.86"
,IN,AR,30316420,1005,100,,Invoice,,,,,,04/06/2018,04/06/2018,0.00,,40.08,,"-470,243.94"
,IN,AR,30316421,1005,100,,Invoice,,,,,,04/06/2018,04/06/2018,0.00,,14.58,,"-470,258.52"
,IN,AR,30316426,1005,100,,Invoice,,,,,,04/06/2018,04/06/2018,0.00,,24.29,,"-470,282.81"
,IN,AR,30316429,1005,100,,Invoice,,,,,,04/06/2018,04/06/2018,0.00,,6.42,,"-470,289.23"
,IN,AR,30316430,1005,100,,Invoice,,,,,,04/06/2018,04/06/2018,0.00,,29.15,,"-470,318.38"
,IN,AR,30316432,1005,100,,Invoice,,,,,,04/06/2018,04/06/2018,0.00,,21.02,,"-470,339.40"
,IN,AR,30316433,1005,100,,Invoice,,,,,,04/06/2018,04/06/2018,0.00,,6.86,,"-470,346.26"
,IN,AR,30316441,1005,100,,Invoice,,,,,,04/06/2018,04/06/2018,0.00,,22.01,,"-470,368.27"
,IN,AR,30316444,1005,100,,Invoice,,,,,,04/06/2018,04/06/2018,0.00,,14.00,,"-470,382.27"
,IN,AR,30316450,1005,100,,Invoice,,,,,,04/06/2018,04/06/2018,0.00,,45.25,,"-470,427.52"
,IN,AR,30316457,1005,100,,Invoice,,,,,,04/06/2018,04/06/2018,0.00,,45.91,,"-470,473.43"
,IN,AR,30316458,1005,100,,Invoice,,,,,,04/06/2018,04/06/2018,0.00,,212.08,,"-470,685.51"
,IN,AR,30316460,1005,100,,Invoice,,,,,,04/06/2018,04/06/2018,0.00,,8.42,,"-470,693.93"
,IN,AR,30316463,1005,100,,Invoice,,,,,,04/06/2018,04/06/2018,0.00,,9.64,,"-470,703.57"
,IN,AR,30316476,1005,100,,Invoice,,,,,,04/06/2018,04/06/2018,0.00,,7.29,,"-470,710.86"
,IN,AR,30316480,1005,100,,Invoice,,,,,,04/06/2018,04/06/2018,0.00,,32.03,,"-470,742.89"
,IN,AR,30316481,1005,100,,Invoice,,,,,,04/06/2018,04/06/2018,0.00,,23.90,,"-470,766.79"
,IN,AR,30316482,1005,100,,Invoice,,,,,,04/06/2018,04/06/2018,0.00,,27.08,,"-470,793.87"
,IN,AR,30316495,1005,100,,Invoice,,,,,,04/06/2018,04/06/2018,0.00,,8.00,,"-470,801.87"
,IN,AR,30316496,1005,100,,Invoice,,,,,,04/06/2018,04/06/2018,0.00,,1.88,,"-470,803.75"
,IN,AR,30316501,1005,100,,Invoice,,,,,,04/06/2018,04/06/2018,0.00,,18.17,,"-470,821.92"
,IN,AR,30316510,1005,100,,Invoice,,,,,,04/06/2018,04/06/2018,0.00,,8.21,,"-470,830.13"
,IN,AR,30316518,1005,100,,Invoice,,,,,,04/06/2018,04/06/2018,0.00,,7.86,,"-470,837.99"
,IN,AR,30316520,1005,100,,Invoice,,,,,,04/06/2018,04/06/2018,0.00,,7.02,,"-470,845.01"
,IN,AR,30316523,1005,100,,Invoice,,,,,,04/06/2018,04/06/2018,0.00,,6.13,,"-470,851.14"
,IN,AR,30316535,1005,100,,Invoice,,,,,,04/06/2018,04/06/2018,0.00,,38.01,,"-470,889.15"
,IN,AR,30316537,1005,100,,Invoice,,,,,,04/06/2018,04/06/2018,0.00,,3.64,,"-470,892.79"
,IN,AR,30316541,1005,100,,Invoice,,,,,,04/06/2018,04/06/2018,0.00,,2.00,,"-470,894.79"
,IN,AR,30316545,1005,100,,Invoice,,,,,,04/06/2018,04/06/2018,0.00,,4.15,,"-470,898.94"
,IN,AR,30316546,1005,100,,Invoice,,,,,,04/06/2018,04/06/2018,0.00,,4.15,,"-470,903.09"
,IN,AR,30316547,1005,100,,Invoice,,,,,,04/06/2018,04/06/2018,0.00,,31.14,,"-470,934.23"
,IN,AR,30316548,1005,100,,Invoice,,,,,,04/06/2018,04/06/2018,0.00,,6.23,,"-470,940.46"
,IN,AR,30316549,1005,100,,Invoice,,,,,,04/06/2018,04/06/2018,0.00,,4.15,,"-470,944.61"
,IN,AR,30316559,1005,100,,Invoice,,,,,,04/06/2018,04/06/2018,0.00,,7.29,,"-470,951.90"
,IN,AR,30316562,1005,100,,Invoice,,,,,,04/06/2018,04/06/2018,0.00,,29.15,,"-470,981.05"
,IN,AR,30316564,1005,100,,Invoice,,,,,,04/06/2018,04/06/2018,0.00,,21.86,,"-471,002.91"
,IN,AR,30316571,1005,100,,Invoice,,,,,,04/06/2018,04/06/2018,0.00,,29.15,,"-471,032.06"
,IN,AR,30316572,1005,100,,Invoice,,,,,,04/06/2018,04/06/2018,0.00,,10.93,,"-471,042.99"
,IN,AR,30316573,1005,100,,Invoice,,,,,,04/06/2018,04/06/2018,0.00,,10.93,,"-471,053.92"
,CN,AR,31018117,1005,100,,Credit Note,,,,,,05/06/2018,05/06/2018,54.66,,0.00,,"-470,999.26"
,CN,AR,31018118,1005,100,,Credit Note,,,,,,05/06/2018,05/06/2018,14.58,,0.00,,"-470,984.68"
,CN,AR,31018134,1005,100,,Credit Note,,,,,,05/06/2018,05/06/2018,182.20,,0.00,,"-470,802.48"
,CN,AR,31018144,1005,100,,Credit Note,,,,,,05/06/2018,05/06/2018,29.15,,0.00,,"-470,773.33"
,CS,AR,32004668,1005,100,,Cash sale,,,,,,05/06/2018,05/06/2018,0.00,,3.64,,"-470,776.97"
,CS,AR,32004672,1005,100,,Cash sale,,,,,,05/06/2018,05/06/2018,0.00,,7.29,,"-470,784.26"
,CS,AR,32004675,1005,100,,Cash sale,,,,,,05/06/2018,05/06/2018,0.00,,3.64,,"-470,787.90"
,CS,AR,32004678,1005,100,,Cash sale,,,,,,05/06/2018,05/06/2018,0.00,,10.93,,"-470,798.83"
,CS,AR,32004682,1005,100,,Cash sale,,,,,,05/06/2018,05/06/2018,0.00,,3.01,,"-470,801.84"
,CS,AR,32004684,1005,100,,Cash sale,,,,,,05/06/2018,05/06/2018,0.00,,7.29,,"-470,809.13"
,CS,AR,32004686,1005,100,,Cash sale,,,,,,05/06/2018,05/06/2018,0.00,,7.29,,"-470,816.42"
,CS,AR,32004703,1005,100,,Cash sale,,,,,,05/06/2018,05/06/2018,0.00,,7.29,,"-470,823.71"
,CS,AR,32004705,1005,100,,Cash sale,,,,,,05/06/2018,05/06/2018,0.00,,7.29,,"-470,831.00"
,CS,AR,32004708,1005,100,,Cash sale,,,,,,05/06/2018,05/06/2018,0.00,,21.86,,"-470,852.86"
,CS,AR,32004709,1005,100,,Cash sale,,,,,,05/06/2018,05/06/2018,0.00,,10.17,,"-470,863.03"
,CS,AR,32004711,1005,100,,Cash sale,,,,,,05/06/2018,05/06/2018,0.00,,7.29,,"-470,870.32"
,CS,AR,32004714,1005,100,,Cash sale,,,,,,05/06/2018,05/06/2018,0.00,,2.16,,"-470,872.48"
,CS,AR,32004721,1005,100,,Cash sale,,,,,,05/06/2018,05/06/2018,0.00,,10.34,,"-470,882.82"
,CS,AR,32004723,1005,100,,Cash sale,,,,,,05/06/2018,05/06/2018,0.00,,9.56,,"-470,892.38"
,CS,AR,32004727,1005,100,,Cash sale,,,,,,05/06/2018,05/06/2018,0.00,,3.64,,"-470,896.02"
,CS,AR,32004742,1005,100,,Cash sale,,,,,,05/06/2018,05/06/2018,0.00,,8.58,,"-470,904.60"
,CS,AR,32004743,1005,100,,Cash sale,,,,,,05/06/2018,05/06/2018,0.00,,3.64,,"-470,908.24"
,CS,AR,32004745,1005,100,,Cash sale,,,,,,05/06/2018,05/06/2018,0.00,,9.03,,"-470,917.27"
,CS,AR,32004750,1005,100,,Cash sale,,,,,,05/06/2018,05/06/2018,0.00,,7.29,,"-470,924.56"
,CS,AR,32004755,1005,100,,Cash sale,,,,,,05/06/2018,05/06/2018,0.00,,19.45,,"-470,944.01"
,CS,AR,32004756,1005,100,,Cash sale,,,,,,05/06/2018,05/06/2018,0.00,,14.58,,"-470,958.59"
,CS,AR,32004758,1005,100,,Cash sale,,,,,,05/06/2018,05/06/2018,0.00,,7.29,,"-470,965.88"
,CS,AR,32004763,1005,100,,Cash sale,,,,,,05/06/2018,05/06/2018,0.00,,7.29,,"-470,973.17"
,CS,AR,32004768,1005,100,,Cash sale,,,,,,05/06/2018,05/06/2018,0.00,,12.92,,"-470,986.09"
,CS,AR,32004770,1005,100,,Cash sale,,,,,,05/06/2018,05/06/2018,0.00,,2.58,,"-470,988.67"
,CS,AR,32004771,1005,100,,Cash sale,,,,,,05/06/2018,05/06/2018,0.00,,15.04,,"-471,003.71"
,CS,AR,32004772,1005,100,,Cash sale,,,,,,05/06/2018,05/06/2018,0.00,,3.90,,"-471,007.61"
,CS,AR,32004777,1005,100,,Cash sale,,,,,,05/06/2018,05/06/2018,0.00,,10.93,,"-471,018.54"
,CS,AR,32004780,1005,100,,Cash sale,,,,,,05/06/2018,05/06/2018,0.00,,3.01,,"-471,021.55"
,CS,AR,32004784,1005,100,,Cash sale,,,,,,05/06/2018,05/06/2018,0.00,,7.29,,"-471,028.84"
,CS,AR,32004785,1005,100,,Cash sale,,,,,,05/06/2018,05/06/2018,0.00,,10.93,,"-471,039.77"
,CS,AR,32004793,1005,100,,Cash sale,,,,,,05/06/2018,05/06/2018,0.00,,10.93,,"-471,050.70"
,CS,AR,32004794,1005,100,,Cash sale,,,,,,05/06/2018,05/06/2018,0.00,,10.72,,"-471,061.42"
,CS,AR,32004795,1005,100,,Cash sale,,,,,,05/06/2018,05/06/2018,0.00,,14.58,,"-471,076.00"
,CS,AR,32004797,1005,100,,Cash sale,,,,,,05/06/2018,05/06/2018,0.00,,14.58,,"-471,090.58"
,CS,AR,32004801,1005,100,,Cash sale,,,,,,05/06/2018,05/06/2018,0.00,,7.29,,"-471,097.87"
,CS,AR,32004803,1005,100,,Cash sale,,,,,,05/06/2018,05/06/2018,0.00,,10.93,,"-471,108.80"
,CS,AR,32004805,1005,100,,Cash sale,,,,,,05/06/2018,05/06/2018,0.00,,29.15,,"-471,137.95"
,CS,AR,32004810,1005,100,,Cash sale,,,,,,05/06/2018,05/06/2018,0.00,,10.93,,"-471,148.88"
,CS,AR,32004811,1005,100,,Cash sale,,,,,,05/06/2018,05/06/2018,0.00,,20.34,,"-471,169.22"
,CS,AR,32004814,1005,100,,Cash sale,,,,,,05/06/2018,05/06/2018,0.00,,10.17,,"-471,179.39"
,CS,AR,32004815,1005,100,,Cash sale,,,,,,05/06/2018,05/06/2018,0.00,,40.00,,"-471,219.39"
,CS,AR,32004819,1005,100,,Cash sale,,,,,,05/06/2018,05/06/2018,0.00,,7.29,,"-471,226.68"
,CS,AR,32004824,1005,100,,Cash sale,,,,,,05/06/2018,05/06/2018,0.00,,8.20,,"-471,234.88"
,CS,AR,32004829,1005,100,,Cash sale,,,,,,05/06/2018,05/06/2018,0.00,,18.22,,"-471,253.10"
,CS,AR,32004832,1005,100,,Cash sale,,,,,,05/06/2018,05/06/2018,0.00,,5.93,,"-471,259.03"
,CS,AR,32004837,1005,100,,Cash sale,,,,,,05/06/2018,05/06/2018,0.00,,2.75,,"-471,261.78"
,CS,AR,32004843,1005,100,,Cash sale,,,,,,05/06/2018,05/06/2018,0.00,,5.47,,"-471,267.25"
,CS,AR,32004846,1005,100,,Cash sale,,,,,,05/06/2018,05/06/2018,0.00,,7.29,,"-471,274.54"
,CS,AR,32004854,1005,100,,Cash sale,,,,,,05/06/2018,05/06/2018,0.00,,3.64,,"-471,278.18"
,CS,AR,32004863,1005,100,,Cash sale,,,,,,05/06/2018,05/06/2018,0.00,,8.21,,"-471,286.39"
,CS,AR,32004894,1005,100,,Cash sale,,,,,,05/06/2018,05/06/2018,0.00,,7.29,,"-471,293.68"
,IN,AR,30316115,1005,100,,Invoice,,,,,,05/06/2018,05/06/2018,0.00,,9.03,,"-471,302.71"
,IN,AR,30316121,1005,100,,Invoice,,,,,,05/06/2018,05/06/2018,0.00,,23.73,,"-471,326.44"
,IN,AR,30316138,1005,100,,Invoice,,,,,,05/06/2018,05/06/2018,0.00,,55.17,,"-471,381.61"
,IN,AR,30316139,1005,100,,Invoice,,,,,,05/06/2018,05/06/2018,0.00,,21.02,,"-471,402.63"
,IN,AR,30316144,1005,100,,Invoice,,,,,,05/06/2018,05/06/2018,0.00,,7.29,,"-471,409.92"
,IN,AR,30316145,1005,100,,Invoice,,,,,,05/06/2018,05/06/2018,0.00,,3.50,,"-471,413.42"
,IN,AR,30316153,1005,100,,Invoice,,,,,,05/06/2018,05/06/2018,0.00,,1.99,,"-471,415.41"
,IN,AR,30316157,1005,100,,Invoice,,,,,,05/06/2018,05/06/2018,0.00,,33.22,,"-471,448.63"
,IN,AR,30316160,1005,100,,Invoice,,,,,,05/06/2018,05/06/2018,0.00,,364.41,,"-471,813.04"
,IN,AR,30316164,1005,100,,Invoice,,,,,,05/06/2018,05/06/2018,0.00,,14.58,,"-471,827.62"
,IN,AR,30316172,1005,100,,Invoice,,,,,,05/06/2018,05/06/2018,0.00,,3.64,,"-471,831.26"
,IN,AR,30316173,1005,100,,Invoice,,,,,,05/06/2018,05/06/2018,0.00,,14.24,,"-471,845.50"
,IN,AR,30316174,1005,100,,Invoice,,,,,,05/06/2018,05/06/2018,0.00,,7.29,,"-471,852.79"
,IN,AR,30316193,1005,100,,Invoice,,,,,,05/06/2018,05/06/2018,0.00,,24.71,,"-471,877.50"
,IN,AR,30316198,1005,100,,Invoice,,,,,,05/06/2018,05/06/2018,0.00,,18.22,,"-471,895.72"
,IN,AR,30316200,1005,100,,Invoice,,,,,,05/06/2018,05/06/2018,0.00,,780.96,,"-472,676.68"
,IN,AR,30316202,1005,100,,Invoice,,,,,,05/06/2018,05/06/2018,0.00,,9.70,,"-472,686.38"
,IN,AR,30316207,1005,100,,Invoice,,,,,,05/06/2018,05/06/2018,0.00,,16.48,,"-472,702.86"
,IN,AR,30316208,1005,100,,Invoice,,,,,,05/06/2018,05/06/2018,0.00,,7.29,,"-472,710.15"
,IN,AR,30316213,1005,100,,Invoice,,,,,,05/06/2018,05/06/2018,0.00,,29.15,,"-472,739.30"
,IN,AR,30316218,1005,100,,Invoice,,,,,,05/06/2018,05/06/2018,0.00,,15.93,,"-472,755.23"
,IN,AR,30316222,1005,100,,Invoice,,,,,,05/06/2018,05/06/2018,0.00,,10.50,,"-472,765.73"
,IN,AR,30316231,1005,100,,Invoice,,,,,,05/06/2018,05/06/2018,0.00,,4.24,,"-472,769.97"
,IN,AR,30316236,1005,100,,Invoice,,,,,,05/06/2018,05/06/2018,0.00,,61.02,,"-472,830.99"
,IN,AR,30316237,1005,100,,Invoice,,,,,,05/06/2018,05/06/2018,0.00,,12.71,,"-472,843.70"
,IN,AR,30316245,1005,100,,Invoice,,,,,,05/06/2018,05/06/2018,0.00,,5.17,,"-472,848.87"
,IN,AR,30316252,1005,100,,Invoice,,,,,,05/06/2018,05/06/2018,0.00,,28.68,,"-472,877.55"
,IN,AR,30316254,1005,100,,Invoice,,,,,,05/06/2018,05/06/2018,0.00,,6.02,,"-472,883.57"
,IN,AR,30316255,1005,100,,Invoice,,,,,,05/06/2018,05/06/2018,0.00,,28.68,,"-472,912.25"
,IN,AR,30316257,1005,100,,Invoice,,,,,,05/06/2018,05/06/2018,0.00,,5.85,,"-472,918.10"
,IN,AR,30316264,1005,100,,Invoice,,,,,,05/06/2018,05/06/2018,0.00,,9.43,,"-472,927.53"
,IN,AR,30316270,1005,100,,Invoice,,,,,,05/06/2018,05/06/2018,0.00,,6.44,,"-472,933.97"
,IN,AR,30316279,1005,100,,Invoice,,,,,,05/06/2018,05/06/2018,0.00,,5.17,,"-472,939.14"
,IN,AR,30316280,1005,100,,Invoice,,,,,,05/06/2018,05/06/2018,0.00,,24.51,,"-472,963.65"
,IN,AR,30316293,1005,100,,Invoice,,,,,,05/06/2018,05/06/2018,0.00,,5.85,,"-472,969.50"
,IN,AR,30316295,1005,100,,Invoice,,,,,,05/06/2018,05/06/2018,0.00,,20.34,,"-472,989.84"
,IN,AR,30316296,1005,100,,Invoice,,,,,,05/06/2018,05/06/2018,0.00,,14.58,,"-473,004.42"
,IN,AR,30316298,1005,100,,Invoice,,,,,,05/06/2018,05/06/2018,0.00,,7.29,,"-473,011.71"
,IN,AR,30316300,1005,100,,Invoice,,,,,,05/06/2018,05/06/2018,0.00,,2.12,,"-473,013.83"
,IN,AR,30316301,1005,100,,Invoice,,,,,,05/06/2018,05/06/2018,0.00,,10.93,,"-473,024.76"
,IN,AR,30316303,1005,100,,Invoice,,,,,,05/06/2018,05/06/2018,0.00,,3.90,,"-473,028.66"
,IN,AR,30316304,1005,100,,Invoice,,,,,,05/06/2018,05/06/2018,0.00,,32.80,,"-473,061.46"
,IN,AR,30316306,1005,100,,Invoice,,,,,,05/06/2018,05/06/2018,0.00,,26.69,,"-473,088.15"
,IN,AR,30316311,1005,100,,Invoice,,,,,,05/06/2018,05/06/2018,0.00,,4.08,,"-473,092.23"
,IN,AR,30316313,1005,100,,Invoice,,,,,,05/06/2018,05/06/2018,0.00,,11.57,,"-473,103.80"
,IN,AR,30316315,1005,100,,Invoice,,,,,,05/06/2018,05/06/2018,0.00,,27.97,,"-473,131.77"
,IN,AR,30316316,1005,100,,Invoice,,,,,,05/06/2018,05/06/2018,0.00,,7.02,,"-473,138.79"
,IN,AR,30316318,1005,100,,Invoice,,,,,,05/06/2018,05/06/2018,0.00,,10.93,,"-473,149.72"
,IN,AR,30316320,1005,100,,Invoice,,,,,,05/06/2018,05/06/2018,0.00,,4.24,,"-473,153.96"
,IN,AR,30316321,1005,100,,Invoice,,,,,,05/06/2018,05/06/2018,0.00,,12.71,,"-473,166.67"
,IN,AR,30316324,1005,100,,Invoice,,,,,,05/06/2018,05/06/2018,0.00,,8.24,,"-473,174.91"
,IN,AR,30316330,1005,100,,Invoice,,,,,,05/06/2018,05/06/2018,0.00,,8.47,,"-473,183.38"
,IN,AR,30316332,1005,100,,Invoice,,,,,,05/06/2018,05/06/2018,0.00,,62.29,,"-473,245.67"
,IN,AR,30316333,1005,100,,Invoice,,,,,,05/06/2018,05/06/2018,0.00,,14.83,,"-473,260.50"
,IN,AR,30316338,1005,100,,Invoice,,,,,,05/06/2018,05/06/2018,0.00,,7.29,,"-473,267.79"
,IN,AR,30316350,1005,100,,Invoice,,,,,,05/06/2018,05/06/2018,0.00,,22.81,,"-473,290.60"
,IN,AR,30316354,1005,100,,Invoice,,,,,,05/06/2018,05/06/2018,0.00,,6.97,,"-473,297.57"
,IN,AR,30316355,1005,100,,Invoice,,,,,,05/06/2018,05/06/2018,0.00,,5.85,,"-473,303.42"
,IN,AR,30316357,1005,100,,Invoice,,,,,,05/06/2018,05/06/2018,0.00,,8.26,,"-473,311.68"
,IN,AR,30316358,1005,100,,Invoice,,,,,,05/06/2018,05/06/2018,0.00,,5.59,,"-473,317.27"
,IN,AR,30316361,1005,100,,Invoice,,,,,,05/06/2018,05/06/2018,0.00,,5.86,,"-473,323.13"
,IN,AR,30316362,1005,100,,Invoice,,,,,,05/06/2018,05/06/2018,0.00,,54.66,,"-473,377.79"
,IN,AR,30316363,1005,100,,Invoice,,,,,,05/06/2018,05/06/2018,0.00,,8.52,,"-473,386.31"
,IN,AR,30316365,1005,100,,Invoice,,,,,,05/06/2018,05/06/2018,0.00,,54.66,,"-473,440.97"
,IN,AR,30316378,1005,100,,Invoice,,,,,,05/06/2018,05/06/2018,0.00,,18.22,,"-473,459.19"
,IN,AR,30316380,1005,100,,Invoice,,,,,,05/06/2018,05/06/2018,0.00,,39.49,,"-473,498.68"
,IN,AR,30316381,1005,100,,Invoice,,,,,,05/06/2018,05/06/2018,0.00,,38.59,,"-473,537.27"
,IN,AR,30316382,1005,100,,Invoice,,,,,,05/06/2018,05/06/2018,0.00,,8.01,,"-473,545.28"
,IN,AR,30316383,1005,100,,Invoice,,,,,,05/06/2018,05/06/2018,0.00,,5.29,,"-473,550.57"
,IN,AR,30316386,1005,100,,Invoice,,,,,,05/06/2018,05/06/2018,0.00,,29.15,,"-473,579.72"
,IN,AR,30316388,1005,100,,Invoice,,,,,,05/06/2018,05/06/2018,0.00,,108.05,,"-473,687.77"
,IN,AR,30316389,1005,100,,Invoice,,,,,,05/06/2018,05/06/2018,0.00,,4.24,,"-473,692.01"
,IN,AR,30316390,1005,100,,Invoice,,,,,,05/06/2018,05/06/2018,0.00,,21.90,,"-473,713.91"
,IN,AR,30316391,1005,100,,Invoice,,,,,,05/06/2018,05/06/2018,0.00,,47.37,,"-473,761.28"
,IN,AR,30316393,1005,100,,Invoice,,,,,,05/06/2018,05/06/2018,0.00,,54.66,,"-473,815.94"
,IN,AR,30316397,1005,100,,Invoice,,,,,,05/06/2018,05/06/2018,0.00,,54.66,,"-473,870.60"
,IN,AR,30316398,1005,100,,Invoice,,,,,,05/06/2018,05/06/2018,0.00,,10.93,,"-473,881.53"
,IN,AR,30316408,1005,100,,Invoice,,,,,,05/06/2018,05/06/2018,0.00,,20.67,,"-473,902.20"
,IN,AR,30316409,1005,100,,Invoice,,,,,,05/06/2018,05/06/2018,0.00,,3.18,,"-473,905.38"
,IN,AR,30316410,1005,100,,Invoice,,,,,,05/06/2018,05/06/2018,0.00,,7.95,,"-473,913.33"
,IN,AR,30316411,1005,100,,Invoice,,,,,,05/06/2018,05/06/2018,0.00,,58.83,,"-473,972.16"
,IN,AR,30316414,1005,100,,Invoice,,,,,,05/06/2018,05/06/2018,0.00,,39.75,,"-474,011.91"
,IN,AR,30316422,1005,100,,Invoice,,,,,,05/06/2018,05/06/2018,0.00,,21.86,,"-474,033.77"
,IN,AR,30316424,1005,100,,Invoice,,,,,,05/06/2018,05/06/2018,0.00,,18.21,,"-474,051.98"
,IN,AR,30316425,1005,100,,Invoice,,,,,,05/06/2018,05/06/2018,0.00,,6.02,,"-474,058.00"
,IN,AR,30316428,1005,100,,Invoice,,,,,,05/06/2018,05/06/2018,0.00,,198.97,,"-474,256.97"
,IN,AR,30316434,1005,100,,Invoice,,,,,,05/06/2018,05/06/2018,0.00,,31.04,,"-474,288.01"
,IN,AR,30316436,1005,100,,Invoice,,,,,,05/06/2018,05/06/2018,0.00,,14.58,,"-474,302.59"
,IN,AR,30316439,1005,100,,Invoice,,,,,,05/06/2018,05/06/2018,0.00,,22.88,,"-474,325.47"
,IN,AR,30316442,1005,100,,Invoice,,,,,,05/06/2018,05/06/2018,0.00,,20.01,,"-474,345.48"
,IN,AR,30316445,1005,100,,Invoice,,,,,,05/06/2018,05/06/2018,0.00,,116.27,,"-474,461.75"
,IN,AR,30316459,1005,100,,Invoice,,,,,,05/06/2018,05/06/2018,0.00,,10.95,,"-474,472.70"
,IN,AR,30316464,1005,100,,Invoice,,,,,,05/06/2018,05/06/2018,0.00,,124.00,,"-474,596.70"
,IN,AR,30316465,1005,100,,Invoice,,,,,,05/06/2018,05/06/2018,0.00,,9.10,,"-474,605.80"
,IN,AR,30316472,1005,100,,Invoice,,,,,,05/06/2018,05/06/2018,0.00,,37.97,,"-474,643.77"
,IN,AR,30316474,1005,100,,Invoice,,,,,,05/06/2018,05/06/2018,0.00,,2.54,,"-474,646.31"
,IN,AR,30316475,1005,100,,Invoice,,,,,,05/06/2018,05/06/2018,0.00,,7.29,,"-474,653.60"
,IN,AR,30316478,1005,100,,Invoice,,,,,,05/06/2018,05/06/2018,0.00,,5.68,,"-474,659.28"
,IN,AR,30316486,1005,100,,Invoice,,,,,,05/06/2018,05/06/2018,0.00,,78.64,,"-474,737.92"
,IN,AR,30316488,1005,100,,Invoice,,,,,,05/06/2018,05/06/2018,0.00,,28.47,,"-474,766.39"
,IN,AR,30316489,1005,100,,Invoice,,,,,,05/06/2018,05/06/2018,0.00,,23.73,,"-474,790.12"
,IN,AR,30316490,1005,100,,Invoice,,,,,,05/06/2018,05/06/2018,0.00,,75.94,,"-474,866.06"
,IN,AR,30316491,1005,100,,Invoice,,,,,,05/06/2018,05/06/2018,0.00,,9.49,,"-474,875.55"
,IN,AR,30316498,1005,100,,Invoice,,,,,,05/06/2018,05/06/2018,0.00,,1.75,,"-474,877.30"
,IN,AR,30316499,1005,100,,Invoice,,,,,,05/06/2018,05/06/2018,0.00,,12.00,,"-474,889.30"
,IN,AR,30316500,1005,100,,Invoice,,,,,,05/06/2018,05/06/2018,0.00,,8.90,,"-474,898.20"
,IN,AR,30316503,1005,100,,Invoice,,,,,,05/06/2018,05/06/2018,0.00,,125.05,,"-475,023.25"
,IN,AR,30316504,1005,100,,Invoice,,,,,,05/06/2018,05/06/2018,0.00,,10.93,,"-475,034.18"
,IN,AR,30316506,1005,100,,Invoice,,,,,,05/06/2018,05/06/2018,0.00,,5.26,,"-475,039.44"
,IN,AR,30316516,1005,100,,Invoice,,,,,,05/06/2018,05/06/2018,0.00,,12.14,,"-475,051.58"
,IN,AR,30316531,1005,100,,Invoice,,,,,,05/06/2018,05/06/2018,0.00,,5.59,,"-475,057.17"
,IN,AR,30316532,1005,100,,Invoice,,,,,,05/06/2018,05/06/2018,0.00,,18.22,,"-475,075.39"
,IN,AR,30316539,1005,100,,Invoice,,,,,,05/06/2018,05/06/2018,0.00,,9.11,,"-475,084.50"
,IN,AR,30316550,1005,100,,Invoice,,,,,,05/06/2018,05/06/2018,0.00,,16.61,,"-475,101.11"
,IN,AR,30316566,1005,100,,Invoice,,,,,,05/06/2018,05/06/2018,0.00,,24.27,,"-475,125.38"
,IN,AR,30316567,1005,100,,Invoice,,,,,,05/06/2018,05/06/2018,0.00,,72.88,,"-475,198.26"
,IN,AR,30316574,1005,100,,Invoice,,,,,,05/06/2018,05/06/2018,0.00,,109.32,,"-475,307.58"
,CS,AR,32004663,1005,100,,Cash sale,,,,,,06/06/2018,06/06/2018,0.00,,7.29,,"-475,314.87"
,CS,AR,32004664,1005,100,,Cash sale,,,,,,06/06/2018,06/06/2018,0.00,,35.12,,"-475,349.99"
,CS,AR,32004670,1005,100,,Cash sale,,,,,,06/06/2018,06/06/2018,0.00,,7.29,,"-475,357.28"
,CS,AR,32004676,1005,100,,Cash sale,,,,,,06/06/2018,06/06/2018,0.00,,3.64,,"-475,360.92"
,CS,AR,32004680,1005,100,,Cash sale,,,,,,06/06/2018,06/06/2018,0.00,,3.64,,"-475,364.56"
,CS,AR,32004683,1005,100,,Cash sale,,,,,,06/06/2018,06/06/2018,0.00,,3.64,,"-475,368.20"
,CS,AR,32004685,1005,100,,Cash sale,,,,,,06/06/2018,06/06/2018,0.00,,3.64,,"-475,371.84"
,CS,AR,32004691,1005,100,,Cash sale,,,,,,06/06/2018,06/06/2018,0.00,,12.03,,"-475,383.87"
,CS,AR,32004696,1005,100,,Cash sale,,,,,,06/06/2018,06/06/2018,0.00,,2.92,,"-475,386.79"
,CS,AR,32004702,1005,100,,Cash sale,,,,,,06/06/2018,06/06/2018,0.00,,15.04,,"-475,401.83"
,CS,AR,32004706,1005,100,,Cash sale,,,,,,06/06/2018,06/06/2018,0.00,,5.86,,"-475,407.69"
,CS,AR,32004713,1005,100,,Cash sale,,,,,,06/06/2018,06/06/2018,0.00,,3.64,,"-475,411.33"
,CS,AR,32004726,1005,100,,Cash sale,,,,,,06/06/2018,06/06/2018,0.00,,10.34,,"-475,421.67"
,CS,AR,32004730,1005,100,,Cash sale,,,,,,06/06/2018,06/06/2018,0.00,,7.29,,"-475,428.96"
,CS,AR,32004732,1005,100,,Cash sale,,,,,,06/06/2018,06/06/2018,0.00,,18.05,,"-475,447.01"
,CS,AR,32004733,1005,100,,Cash sale,,,,,,06/06/2018,06/06/2018,0.00,,8.58,,"-475,455.59"
,CS,AR,32004739,1005,100,,Cash sale,,,,,,06/06/2018,06/06/2018,0.00,,7.29,,"-475,462.88"
,CS,AR,32004741,1005,100,,Cash sale,,,,,,06/06/2018,06/06/2018,0.00,,7.29,,"-475,470.17"
,CS,AR,32004754,1005,100,,Cash sale,,,,,,06/06/2018,06/06/2018,0.00,,24.07,,"-475,494.24"
,CS,AR,32004761,1005,100,,Cash sale,,,,,,06/06/2018,06/06/2018,0.00,,7.29,,"-475,501.53"
,CS,AR,32004762,1005,100,,Cash sale,,,,,,06/06/2018,06/06/2018,0.00,,22.88,,"-475,524.41"
,CS,AR,32004765,1005,100,,Cash sale,,,,,,06/06/2018,06/06/2018,0.00,,21.86,,"-475,546.27"
,CS,AR,32004766,1005,100,,Cash sale,,,,,,06/06/2018,06/06/2018,0.00,,10.93,,"-475,557.20"
,CS,AR,32004775,1005,100,,Cash sale,,,,,,06/06/2018,06/06/2018,0.00,,7.29,,"-475,564.49"
,CS,AR,32004781,1005,100,,Cash sale,,,,,,06/06/2018,06/06/2018,0.00,,3.64,,"-475,568.13"
,CS,AR,32004807,1005,100,,Cash sale,,,,,,06/06/2018,06/06/2018,0.00,,6.53,,"-475,574.66"
,CS,AR,32004812,1005,100,,Cash sale,,,,,,06/06/2018,06/06/2018,0.00,,7.29,,"-475,581.95"
,CS,AR,32004818,1005,100,,Cash sale,,,,,,06/06/2018,06/06/2018,0.00,,3.64,,"-475,585.59"
,CS,AR,32004828,1005,100,,Cash sale,,,,,,06/06/2018,06/06/2018,0.00,,9.15,,"-475,594.74"
,CS,AR,32004833,1005,100,,Cash sale,,,,,,06/06/2018,06/06/2018,0.00,,7.29,,"-475,602.03"
,CS,AR,32004839,1005,100,,Cash sale,,,,,,06/06/2018,06/06/2018,0.00,,12.03,,"-475,614.06"
,CS,AR,32004840,1005,100,,Cash sale,,,,,,06/06/2018,06/06/2018,0.00,,25.51,,"-475,639.57"
,CS,AR,32004848,1005,100,,Cash sale,,,,,,06/06/2018,06/06/2018,0.00,,2.54,,"-475,642.11"
,CS,AR,32004850,1005,100,,Cash sale,,,,,,06/06/2018,06/06/2018,0.00,,10.93,,"-475,653.04"
,CS,AR,32004852,1005,100,,Cash sale,,,,,,06/06/2018,06/06/2018,0.00,,7.29,,"-475,660.33"
,CS,AR,32004859,1005,100,,Cash sale,,,,,,06/06/2018,06/06/2018,0.00,,10.93,,"-475,671.26"
,CS,AR,32004861,1005,100,,Cash sale,,,,,,06/06/2018,06/06/2018,0.00,,9.84,,"-475,681.10"
,CS,AR,32004862,1005,100,,Cash sale,,,,,,06/06/2018,06/06/2018,0.00,,29.15,,"-475,710.25"
,CS,AR,32004868,1005,100,,Cash sale,,,,,,06/06/2018,06/06/2018,0.00,,10.99,,"-475,721.24"
,CS,AR,32004869,1005,100,,Cash sale,,,,,,06/06/2018,06/06/2018,0.00,,15.53,,"-475,736.77"
,CS,AR,32004873,1005,100,,Cash sale,,,,,,06/06/2018,06/06/2018,0.00,,10.93,,"-475,747.70"
,IN,AR,30316123,1005,100,,Invoice,,,,,,06/06/2018,06/06/2018,0.00,,10.93,,"-475,758.63"
,IN,AR,30316126,1005,100,,Invoice,,,,,,06/06/2018,06/06/2018,0.00,,18.22,,"-475,776.85"
,IN,AR,30316128,1005,100,,Invoice,,,,,,06/06/2018,06/06/2018,0.00,,39.05,,"-475,815.90"
,IN,AR,30316135,1005,100,,Invoice,,,,,,06/06/2018,06/06/2018,0.00,,11.36,,"-475,827.26"
,IN,AR,30316136,1005,100,,Invoice,,,,,,06/06/2018,06/06/2018,0.00,,15.93,,"-475,843.19"
,IN,AR,30316143,1005,100,,Invoice,,,,,,06/06/2018,06/06/2018,0.00,,3.64,,"-475,846.83"
,IN,AR,30316149,1005,100,,Invoice,,,,,,06/06/2018,06/06/2018,0.00,,54.66,,"-475,901.49"
,IN,AR,30316154,1005,100,,Invoice,,,,,,06/06/2018,06/06/2018,0.00,,11.95,,"-475,913.44"
,IN,AR,30316158,1005,100,,Invoice,,,,,,06/06/2018,06/06/2018,0.00,,75.93,,"-475,989.37"
,IN,AR,30316162,1005,100,,Invoice,,,,,,06/06/2018,06/06/2018,0.00,,46.00,,"-476,035.37"
,IN,AR,30316166,1005,100,,Invoice,,,,,,06/06/2018,06/06/2018,0.00,,7.29,,"-476,042.66"
,IN,AR,30316171,1005,100,,Invoice,,,,,,06/06/2018,06/06/2018,0.00,,20.00,,"-476,062.66"
,IN,AR,30316178,1005,100,,Invoice,,,,,,06/06/2018,06/06/2018,0.00,,7.29,,"-476,069.95"
,IN,AR,30316184,1005,100,,Invoice,,,,,,06/06/2018,06/06/2018,0.00,,36.00,,"-476,105.95"
,IN,AR,30316186,1005,100,,Invoice,,,,,,06/06/2018,06/06/2018,0.00,,7.29,,"-476,113.24"
,IN,AR,30316188,1005,100,,Invoice,,,,,,06/06/2018,06/06/2018,0.00,,56.95,,"-476,170.19"
,IN,AR,30316216,1005,100,,Invoice,,,,,,06/06/2018,06/06/2018,0.00,,14.58,,"-476,184.77"
,IN,AR,30316219,1005,100,,Invoice,,,,,,06/06/2018,06/06/2018,0.00,,21.86,,"-476,206.63"
,IN,AR,30316226,1005,100,,Invoice,,,,,,06/06/2018,06/06/2018,0.00,,7.29,,"-476,213.92"
,IN,AR,30316229,1005,100,,Invoice,,,,,,06/06/2018,06/06/2018,0.00,,20.34,,"-476,234.26"
,IN,AR,30316230,1005,100,,Invoice,,,,,,06/06/2018,06/06/2018,0.00,,54.66,,"-476,288.92"
,IN,AR,30316232,1005,100,,Invoice,,,,,,06/06/2018,06/06/2018,0.00,,4.24,,"-476,293.16"
,IN,AR,30316239,1005,100,,Invoice,,,,,,06/06/2018,06/06/2018,0.00,,5.59,,"-476,298.75"
,IN,AR,30316251,1005,100,,Invoice,,,,,,06/06/2018,06/06/2018,0.00,,25.51,,"-476,324.26"
,IN,AR,30316260,1005,100,,Invoice,,,,,,06/06/2018,06/06/2018,0.00,,61.53,,"-476,385.79"
,IN,AR,30316263,1005,100,,Invoice,,,,,,06/06/2018,06/06/2018,0.00,,180.51,,"-476,566.30"
,IN,AR,30316265,1005,100,,Invoice,,,,,,06/06/2018,06/06/2018,0.00,,29.15,,"-476,595.45"
,IN,AR,30316275,1005,100,,Invoice,,,,,,06/06/2018,06/06/2018,0.00,,9.03,,"-476,604.48"
,IN,AR,30316283,1005,100,,Invoice,,,,,,06/06/2018,06/06/2018,0.00,,216.07,,"-476,820.55"
,IN,AR,30316285,1005,100,,Invoice,,,,,,06/06/2018,06/06/2018,0.00,,7.63,,"-476,828.18"
,IN,AR,30316292,1005,100,,Invoice,,,,,,06/06/2018,06/06/2018,0.00,,1.59,,"-476,829.77"
,IN,AR,30316294,1005,100,,Invoice,,,,,,06/06/2018,06/06/2018,0.00,,6.36,,"-476,836.13"
,IN,AR,30316305,1005,100,,Invoice,,,,,,06/06/2018,06/06/2018,0.00,,13.63,,"-476,849.76"
,IN,AR,30316309,1005,100,,Invoice,,,,,,06/06/2018,06/06/2018,0.00,,17.50,,"-476,867.26"
,IN,AR,30316328,1005,100,,Invoice,,,,,,06/06/2018,06/06/2018,0.00,,42.12,,"-476,909.38"
,IN,AR,30316334,1005,100,,Invoice,,,,,,06/06/2018,06/06/2018,0.00,,4.58,,"-476,913.96"
,IN,AR,30316335,1005,100,,Invoice,,,,,,06/06/2018,06/06/2018,0.00,,35.00,,"-476,948.96"
,IN,AR,30316339,1005,100,,Invoice,,,,,,06/06/2018,06/06/2018,0.00,,12.88,,"-476,961.84"
,IN,AR,30316342,1005,100,,Invoice,,,,,,06/06/2018,06/06/2018,0.00,,54.66,,"-477,016.50"
,IN,AR,30316344,1005,100,,Invoice,,,,,,06/06/2018,06/06/2018,0.00,,10.93,,"-477,027.43"
,IN,AR,30316346,1005,100,,Invoice,,,,,,06/06/2018,06/06/2018,0.00,,41.95,,"-477,069.38"
,IN,AR,30316348,1005,100,,Invoice,,,,,,06/06/2018,06/06/2018,0.00,,12.71,,"-477,082.09"
,IN,AR,30316367,1005,100,,Invoice,,,,,,06/06/2018,06/06/2018,0.00,,21.06,,"-477,103.15"
,IN,AR,30316368,1005,100,,Invoice,,,,,,06/06/2018,06/06/2018,0.00,,18.05,,"-477,121.20"
,IN,AR,30316370,1005,100,,Invoice,,,,,,06/06/2018,06/06/2018,0.00,,13.74,,"-477,134.94"
,IN,AR,30316376,1005,100,,Invoice,,,,,,06/06/2018,06/06/2018,0.00,,19.41,,"-477,154.35"
,IN,AR,30316384,1005,100,,Invoice,,,,,,06/06/2018,06/06/2018,0.00,,1.76,,"-477,156.11"
,IN,AR,30316385,1005,100,,Invoice,,,,,,06/06/2018,06/06/2018,0.00,,15.04,,"-477,171.15"
,IN,AR,30316392,1005,100,,Invoice,,,,,,06/06/2018,06/06/2018,0.00,,7.75,,"-477,178.90"
,IN,AR,30316394,1005,100,,Invoice,,,,,,06/06/2018,06/06/2018,0.00,,28.01,,"-477,206.91"
,IN,AR,30316395,1005,100,,Invoice,,,,,,06/06/2018,06/06/2018,0.00,,47.37,,"-477,254.28"
,IN,AR,30316396,1005,100,,Invoice,,,,,,06/06/2018,06/06/2018,0.00,,21.86,,"-477,276.14"
,IN,AR,30316401,1005,100,,Invoice,,,,,,06/06/2018,06/06/2018,0.00,,2.84,,"-477,278.98"
,IN,AR,30316402,1005,100,,Invoice,,,,,,06/06/2018,06/06/2018,0.00,,15.25,,"-477,294.23"
,IN,AR,30316405,1005,100,,Invoice,,,,,,06/06/2018,06/06/2018,0.00,,10.93,,"-477,305.16"
,IN,AR,30316407,1005,100,,Invoice,,,,,,06/06/2018,06/06/2018,0.00,,21.15,,"-477,326.31"
,IN,AR,30316415,1005,100,,Invoice,,,,,,06/06/2018,06/06/2018,0.00,,32.00,,"-477,358.31"
,IN,AR,30316417,1005,100,,Invoice,,,,,,06/06/2018,06/06/2018,0.00,,80.17,,"-477,438.48"
,IN,AR,30316427,1005,100,,Invoice,,,,,,06/06/2018,06/06/2018,0.00,,47.54,,"-477,486.02"
,IN,AR,30316440,1005,100,,Invoice,,,,,,06/06/2018,06/06/2018,0.00,,10.17,,"-477,496.19"
,IN,AR,30316446,1005,100,,Invoice,,,,,,06/06/2018,06/06/2018,0.00,,17.49,,"-477,513.68"
,IN,AR,30316447,1005,100,,Invoice,,,,,,06/06/2018,06/06/2018,0.00,,11.66,,"-477,525.34"
,IN,AR,30316448,1005,100,,Invoice,,,,,,06/06/2018,06/06/2018,0.00,,14.58,,"-477,539.92"
,IN,AR,30316449,1005,100,,Invoice,,,,,,06/06/2018,06/06/2018,0.00,,8.75,,"-477,548.67"
,IN,AR,30316451,1005,100,,Invoice,,,,,,06/06/2018,06/06/2018,0.00,,9.05,,"-477,557.72"
,IN,AR,30316452,1005,100,,Invoice,,,,,,06/06/2018,06/06/2018,0.00,,2.92,,"-477,560.64"
,IN,AR,30316453,1005,100,,Invoice,,,,,,06/06/2018,06/06/2018,0.00,,3.64,,"-477,564.28"
,IN,AR,30316456,1005,100,,Invoice,,,,,,06/06/2018,06/06/2018,0.00,,25.89,,"-477,590.17"
,IN,AR,30316473,1005,100,,Invoice,,,,,,06/06/2018,06/06/2018,0.00,,14.58,,"-477,604.75"
,IN,AR,30316483,1005,100,,Invoice,,,,,,06/06/2018,06/06/2018,0.00,,9.56,,"-477,614.31"
,IN,AR,30316484,1005,100,,Invoice,,,,,,06/06/2018,06/06/2018,0.00,,6.37,,"-477,620.68"
,IN,AR,30316485,1005,100,,Invoice,,,,,,06/06/2018,06/06/2018,0.00,,15.93,,"-477,636.61"
,IN,AR,30316487,1005,100,,Invoice,,,,,,06/06/2018,06/06/2018,0.00,,24.58,,"-477,661.19"
,IN,AR,30316497,1005,100,,Invoice,,,,,,06/06/2018,06/06/2018,0.00,,3.51,,"-477,664.70"
,IN,AR,30316511,1005,100,,Invoice,,,,,,06/06/2018,06/06/2018,0.00,,29.15,,"-477,693.85"
,IN,AR,30316512,1005,100,,Invoice,,,,,,06/06/2018,06/06/2018,0.00,,14.83,,"-477,708.68"
,IN,AR,30316515,1005,100,,Invoice,,,,,,06/06/2018,06/06/2018,0.00,,7.53,,"-477,716.21"
,IN,AR,30316521,1005,100,,Invoice,,,,,,06/06/2018,06/06/2018,0.00,,16.78,,"-477,732.99"
,IN,AR,30316524,1005,100,,Invoice,,,,,,06/06/2018,06/06/2018,0.00,,29.15,,"-477,762.14"
,IN,AR,30316536,1005,100,,Invoice,,,,,,06/06/2018,06/06/2018,0.00,,11.44,,"-477,773.58"
,IN,AR,30316551,1005,100,,Invoice,,,,,,06/06/2018,06/06/2018,0.00,,39.45,,"-477,813.03"
,IN,AR,30316552,1005,100,,Invoice,,,,,,06/06/2018,06/06/2018,0.00,,4.15,,"-477,817.18"
,IN,AR,30316553,1005,100,,Invoice,,,,,,06/06/2018,06/06/2018,0.00,,8.31,,"-477,825.49"
,IN,AR,30316554,1005,100,,Invoice,,,,,,06/06/2018,06/06/2018,0.00,,14.53,,"-477,840.02"
,IN,AR,30316556,1005,100,,Invoice,,,,,,06/06/2018,06/06/2018,0.00,,2.54,,"-477,842.56"
,IN,AR,30316557,1005,100,,Invoice,,,,,,06/06/2018,06/06/2018,0.00,,3.28,,"-477,845.84"
,IN,AR,30316561,1005,100,,Invoice,,,,,,06/06/2018,06/06/2018,0.00,,21.74,,"-477,867.58"
,IN,AR,30316569,1005,100,,Invoice,,,,,,06/06/2018,06/06/2018,0.00,,21.86,,"-477,889.44"
,IN,AR,30316570,1005,100,,Invoice,,,,,,06/06/2018,06/06/2018,0.00,,7.63,,"-477,897.07"
,IN,AR,30316575,1005,100,,Invoice,,,,,,06/06/2018,06/06/2018,0.00,,72.88,,"-477,969.95"
,IN,AR,30316576,1005,100,,Invoice,,,,,,06/06/2018,06/06/2018,0.00,,72.88,,"-478,042.83"
,CS,AR,32004962,1005,100,,Cash sale,,,,,,07/06/2018,07/06/2018,0.00,,29.15,,"-478,071.98"
,CS,AR,32004900,1005,100,,Cash sale,,,,,,08/06/2018,08/06/2018,0.00,,7.29,,"-478,079.27"
,CS,AR,32004901,1005,100,,Cash sale,,,,,,08/06/2018,08/06/2018,0.00,,12.03,,"-478,091.30"
,CS,AR,32004902,1005,100,,Cash sale,,,,,,08/06/2018,08/06/2018,0.00,,19.64,,"-478,110.94"
,CS,AR,32004903,1005,100,,Cash sale,,,,,,08/06/2018,08/06/2018,0.00,,16.61,,"-478,127.55"
,CS,AR,32004904,1005,100,,Cash sale,,,,,,08/06/2018,08/06/2018,0.00,,10.93,,"-478,138.48"
,CS,AR,32004905,1005,100,,Cash sale,,,,,,08/06/2018,08/06/2018,0.00,,7.29,,"-478,145.77"
,CS,AR,32004906,1005,100,,Cash sale,,,,,,08/06/2018,08/06/2018,0.00,,10.93,,"-478,156.70"
,CS,AR,32004907,1005,100,,Cash sale,,,,,,08/06/2018,08/06/2018,0.00,,3.64,,"-478,160.34"
,CS,AR,32004908,1005,100,,Cash sale,,,,,,08/06/2018,08/06/2018,0.00,,3.64,,"-478,163.98"
,CS,AR,32004909,1005,100,,Cash sale,,,,,,08/06/2018,08/06/2018,0.00,,14.58,,"-478,178.56"
,CS,AR,32004910,1005,100,,Cash sale,,,,,,08/06/2018,08/06/2018,0.00,,12.08,,"-478,190.64"
,CS,AR,32004911,1005,100,,Cash sale,,,,,,08/06/2018,08/06/2018,0.00,,14.53,,"-478,205.17"
,CS,AR,32004912,1005,100,,Cash sale,,,,,,08/06/2018,08/06/2018,0.00,,7.29,,"-478,212.46"
,CS,AR,32004913,1005,100,,Cash sale,,,,,,08/06/2018,08/06/2018,0.00,,3.64,,"-478,216.10"
,CS,AR,32004916,1005,100,,Cash sale,,,,,,08/06/2018,08/06/2018,0.00,,25.51,,"-478,241.61"
,CS,AR,32004917,1005,100,,Cash sale,,,,,,08/06/2018,08/06/2018,0.00,,15.25,,"-478,256.86"
,CS,AR,32004918,1005,100,,Cash sale,,,,,,08/06/2018,08/06/2018,0.00,,3.64,,"-478,260.50"
,CS,AR,32004919,1005,100,,Cash sale,,,,,,08/06/2018,08/06/2018,0.00,,43.97,,"-478,304.47"
,CS,AR,32004920,1005,100,,Cash sale,,,,,,08/06/2018,08/06/2018,0.00,,19.24,,"-478,323.71"
,CS,AR,32004922,1005,100,,Cash sale,,,,,,08/06/2018,08/06/2018,0.00,,10.93,,"-478,334.64"
,CS,AR,32004923,1005,100,,Cash sale,,,,,,08/06/2018,08/06/2018,0.00,,3.01,,"-478,337.65"
,CS,AR,32004924,1005,100,,Cash sale,,,,,,08/06/2018,08/06/2018,0.00,,12.71,,"-478,350.36"
,CS,AR,32004925,1005,100,,Cash sale,,,,,,08/06/2018,08/06/2018,0.00,,14.62,,"-478,364.98"
,CS,AR,32004926,1005,100,,Cash sale,,,,,,08/06/2018,08/06/2018,0.00,,3.01,,"-478,367.99"
,CS,AR,32004928,1005,100,,Cash sale,,,,,,08/06/2018,08/06/2018,0.00,,30.08,,"-478,398.07"
,CS,AR,32004929,1005,100,,Cash sale,,,,,,08/06/2018,08/06/2018,0.00,,17.80,,"-478,415.87"
,CS,AR,32004932,1005,100,,Cash sale,,,,,,08/06/2018,08/06/2018,0.00,,3.64,,"-478,419.51"
,CS,AR,32004933,1005,100,,Cash sale,,,,,,08/06/2018,08/06/2018,0.00,,43.73,,"-478,463.24"
,CS,AR,32004934,1005,100,,Cash sale,,,,,,08/06/2018,08/06/2018,0.00,,14.58,,"-478,477.82"
,CS,AR,32004935,1005,100,,Cash sale,,,,,,08/06/2018,08/06/2018,0.00,,5.17,,"-478,482.99"
,CS,AR,32004937,1005,100,,Cash sale,,,,,,08/06/2018,08/06/2018,0.00,,3.64,,"-478,486.63"
,CS,AR,32004938,1005,100,,Cash sale,,,,,,08/06/2018,08/06/2018,0.00,,10.93,,"-478,497.56"
,CS,AR,32004940,1005,100,,Cash sale,,,,,,08/06/2018,08/06/2018,0.00,,10.93,,"-478,508.49"
,CS,AR,32004941,1005,100,,Cash sale,,,,,,08/06/2018,08/06/2018,0.00,,5.17,,"-478,513.66"
,CS,AR,32004943,1005,100,,Cash sale,,,,,,08/06/2018,08/06/2018,0.00,,70.00,,"-478,583.66"
,CS,AR,32004944,1005,100,,Cash sale,,,,,,08/06/2018,08/06/2018,0.00,,3.64,,"-478,587.30"
,CS,AR,32004947,1005,100,,Cash sale,,,,,,08/06/2018,08/06/2018,0.00,,7.63,,"-478,594.93"
,CS,AR,32004948,1005,100,,Cash sale,,,,,,08/06/2018,08/06/2018,0.00,,9.15,,"-478,604.08"
,CS,AR,32004951,1005,100,,Cash sale,,,,,,08/06/2018,08/06/2018,0.00,,7.29,,"-478,611.37"
,CS,AR,32004952,1005,100,,Cash sale,,,,,,08/06/2018,08/06/2018,0.00,,18.22,,"-478,629.59"
,CS,AR,32004953,1005,100,,Cash sale,,,,,,08/06/2018,08/06/2018,0.00,,14.58,,"-478,644.17"
,CS,AR,32004954,1005,100,,Cash sale,,,,,,08/06/2018,08/06/2018,0.00,,18.21,,"-478,662.38"
,CS,AR,32004956,1005,100,,Cash sale,,,,,,08/06/2018,08/06/2018,0.00,,10.93,,"-478,673.31"
,CS,AR,32004957,1005,100,,Cash sale,,,,,,08/06/2018,08/06/2018,0.00,,5.08,,"-478,678.39"
,CS,AR,32004958,1005,100,,Cash sale,,,,,,08/06/2018,08/06/2018,0.00,,12.14,,"-478,690.53"
,CS,AR,32004959,1005,100,,Cash sale,,,,,,08/06/2018,08/06/2018,0.00,,6.23,,"-478,696.76"
,CS,AR,32004960,1005,100,,Cash sale,,,,,,08/06/2018,08/06/2018,0.00,,9.13,,"-478,705.89"
,CS,AR,32004961,1005,100,,Cash sale,,,,,,08/06/2018,08/06/2018,0.00,,10.93,,"-478,716.82"
,CS,AR,32004965,1005,100,,Cash sale,,,,,,08/06/2018,08/06/2018,0.00,,5.94,,"-478,722.76"
,CS,AR,32004966,1005,100,,Cash sale,,,,,,08/06/2018,08/06/2018,0.00,,21.86,,"-478,744.62"
,CS,AR,32004969,1005,100,,Cash sale,,,,,,08/06/2018,08/06/2018,0.00,,6.99,,"-478,751.61"
,CS,AR,32004971,1005,100,,Cash sale,,,,,,08/06/2018,08/06/2018,0.00,,3.03,,"-478,754.64"
,CS,AR,32004972,1005,100,,Cash sale,,,,,,08/06/2018,08/06/2018,0.00,,3.64,,"-478,758.28"
,CS,AR,32004973,1005,100,,Cash sale,,,,,,08/06/2018,08/06/2018,0.00,,6.56,,"-478,764.84"
,CS,AR,32004974,1005,100,,Cash sale,,,,,,08/06/2018,08/06/2018,0.00,,5.08,,"-478,769.92"
,IN,AR,30316577,1005,100,,Invoice,,,,,,08/06/2018,08/06/2018,0.00,,5.93,,"-478,775.85"
,IN,AR,30316578,1005,100,,Invoice,,,,,,08/06/2018,08/06/2018,0.00,,50.42,,"-478,826.27"
,IN,AR,30316580,1005,100,,Invoice,,,,,,08/06/2018,08/06/2018,0.00,,22.37,,"-478,848.64"
,IN,AR,30316581,1005,100,,Invoice,,,,,,08/06/2018,08/06/2018,0.00,,54.66,,"-478,903.30"
,IN,AR,30316582,1005,100,,Invoice,,,,,,08/06/2018,08/06/2018,0.00,,25.51,,"-478,928.81"
,IN,AR,30316583,1005,100,,Invoice,,,,,,08/06/2018,08/06/2018,0.00,,91.10,,"-479,019.91"
,IN,AR,30316584,1005,100,,Invoice,,,,,,08/06/2018,08/06/2018,0.00,,12.08,,"-479,031.99"
,IN,AR,30316586,1005,100,,Invoice,,,,,,08/06/2018,08/06/2018,0.00,,9.19,,"-479,041.18"
,IN,AR,30316587,1005,100,,Invoice,,,,,,08/06/2018,08/06/2018,0.00,,48.52,,"-479,089.70"
,IN,AR,30316589,1005,100,,Invoice,,,,,,08/06/2018,08/06/2018,0.00,,94.92,,"-479,184.62"
,IN,AR,30316592,1005,100,,Invoice,,,,,,08/06/2018,08/06/2018,0.00,,14.58,,"-479,199.20"
,IN,AR,30316593,1005,100,,Invoice,,,,,,08/06/2018,08/06/2018,0.00,,20.00,,"-479,219.20"
,IN,AR,30316594,1005,100,,Invoice,,,,,,08/06/2018,08/06/2018,0.00,,11.86,,"-479,231.06"
,IN,AR,30316595,1005,100,,Invoice,,,,,,08/06/2018,08/06/2018,0.00,,14.58,,"-479,245.64"
,IN,AR,30316597,1005,100,,Invoice,,,,,,08/06/2018,08/06/2018,0.00,,24.00,,"-479,269.64"
,IN,AR,30316598,1005,100,,Invoice,,,,,,08/06/2018,08/06/2018,0.00,,10.93,,"-479,280.57"
,IN,AR,30316599,1005,100,,Invoice,,,,,,08/06/2018,08/06/2018,0.00,,5.84,,"-479,286.41"
,IN,AR,30316600,1005,100,,Invoice,,,,,,08/06/2018,08/06/2018,0.00,,20.00,,"-479,306.41"
,IN,AR,30316601,1005,100,,Invoice,,,,,,08/06/2018,08/06/2018,0.00,,11.64,,"-479,318.05"
,IN,AR,30316602,1005,100,,Invoice,,,,,,08/06/2018,08/06/2018,0.00,,38.00,,"-479,356.05"
,IN,AR,30316603,1005,100,,Invoice,,,,,,08/06/2018,08/06/2018,0.00,,32.80,,"-479,388.85"
,IN,AR,30316604,1005,100,,Invoice,,,,,,08/06/2018,08/06/2018,0.00,,13.98,,"-479,402.83"
,IN,AR,30316605,1005,100,,Invoice,,,,,,08/06/2018,08/06/2018,0.00,,23.29,,"-479,426.12"
,IN,AR,30316606,1005,100,,Invoice,,,,,,08/06/2018,08/06/2018,0.00,,182.20,,"-479,608.32"
,IN,AR,30316607,1005,100,,Invoice,,,,,,08/06/2018,08/06/2018,0.00,,10.93,,"-479,619.25"
,IN,AR,30316608,1005,100,,Invoice,,,,,,08/06/2018,08/06/2018,0.00,,5.17,,"-479,624.42"
,IN,AR,30316609,1005,100,,Invoice,,,,,,08/06/2018,08/06/2018,0.00,,6.97,,"-479,631.39"
,IN,AR,30316610,1005,100,,Invoice,,,,,,08/06/2018,08/06/2018,0.00,,4.80,,"-479,636.19"
,IN,AR,30316612,1005,100,,Invoice,,,,,,08/06/2018,08/06/2018,0.00,,7.29,,"-479,643.48"
,IN,AR,30316614,1005,100,,Invoice,,,,,,08/06/2018,08/06/2018,0.00,,38.77,,"-479,682.25"
,IN,AR,30316615,1005,100,,Invoice,,,,,,08/06/2018,08/06/2018,0.00,,2.39,,"-479,684.64"
,IN,AR,30316616,1005,100,,Invoice,,,,,,08/06/2018,08/06/2018,0.00,,7.29,,"-479,691.93"
,IN,AR,30316617,1005,100,,Invoice,,,,,,08/06/2018,08/06/2018,0.00,,216.49,,"-479,908.42"
,IN,AR,30316618,1005,100,,Invoice,,,,,,08/06/2018,08/06/2018,0.00,,9.03,,"-479,917.45"
,IN,AR,30316620,1005,100,,Invoice,,,,,,08/06/2018,08/06/2018,0.00,,79.98,,"-479,997.43"
,IN,AR,30316621,1005,100,,Invoice,,,,,,08/06/2018,08/06/2018,0.00,,4.78,,"-480,002.21"
,IN,AR,30316622,1005,100,,Invoice,,,,,,08/06/2018,08/06/2018,0.00,,23.90,,"-480,026.11"
,IN,AR,30316623,1005,100,,Invoice,,,,,,08/06/2018,08/06/2018,0.00,,28.98,,"-480,055.09"
,IN,AR,30316624,1005,100,,Invoice,,,,,,08/06/2018,08/06/2018,0.00,,14.58,,"-480,069.67"
,IN,AR,30316625,1005,100,,Invoice,,,,,,08/06/2018,08/06/2018,0.00,,6.36,,"-480,076.03"
,IN,AR,30316626,1005,100,,Invoice,,,,,,08/06/2018,08/06/2018,0.00,,7.63,,"-480,083.66"
,IN,AR,30316627,1005,100,,Invoice,,,,,,08/06/2018,08/06/2018,0.00,,2.54,,"-480,086.20"
,IN,AR,30316628,1005,100,,Invoice,,,,,,08/06/2018,08/06/2018,0.00,,25.75,,"-480,111.95"
,IN,AR,30316629,1005,100,,Invoice,,,,,,08/06/2018,08/06/2018,0.00,,7.17,,"-480,119.12"
,IN,AR,30316630,1005,100,,Invoice,,,,,,08/06/2018,08/06/2018,0.00,,3.64,,"-480,122.76"
,IN,AR,30316632,1005,100,,Invoice,,,,,,08/06/2018,08/06/2018,0.00,,27.97,,"-480,150.73"
,IN,AR,30316637,1005,100,,Invoice,,,,,,08/06/2018,08/06/2018,0.00,,10.93,,"-480,161.66"
,IN,AR,30316638,1005,100,,Invoice,,,,,,08/06/2018,08/06/2018,0.00,,5.61,,"-480,167.27"
,IN,AR,30316639,1005,100,,Invoice,,,,,,08/06/2018,08/06/2018,0.00,,48.81,,"-480,216.08"
,IN,AR,30316640,1005,100,,Invoice,,,,,,08/06/2018,08/06/2018,0.00,,"1,093.22",,"-481,309.30"
,IN,AR,30316641,1005,100,,Invoice,,,,,,08/06/2018,08/06/2018,0.00,,20.48,,"-481,329.78"
,IN,AR,30316642,1005,100,,Invoice,,,,,,08/06/2018,08/06/2018,0.00,,14.58,,"-481,344.36"
,IN,AR,30316644,1005,100,,Invoice,,,,,,08/06/2018,08/06/2018,0.00,,16.53,,"-481,360.89"
,IN,AR,30316645,1005,100,,Invoice,,,,,,08/06/2018,08/06/2018,0.00,,364.41,,"-481,725.30"
,IN,AR,30316646,1005,100,,Invoice,,,,,,08/06/2018,08/06/2018,0.00,,7.29,,"-481,732.59"
,IN,AR,30316647,1005,100,,Invoice,,,,,,08/06/2018,08/06/2018,0.00,,25.55,,"-481,758.14"
,IN,AR,30316648,1005,100,,Invoice,,,,,,08/06/2018,08/06/2018,0.00,,10.00,,"-481,768.14"
,IN,AR,30316649,1005,100,,Invoice,,,,,,08/06/2018,08/06/2018,0.00,,3.64,,"-481,771.78"
,IN,AR,30316652,1005,100,,Invoice,,,,,,08/06/2018,08/06/2018,0.00,,3.53,,"-481,775.31"
,IN,AR,30316653,1005,100,,Invoice,,,,,,08/06/2018,08/06/2018,0.00,,7.29,,"-481,782.60"
,IN,AR,30316654,1005,100,,Invoice,,,,,,08/06/2018,08/06/2018,0.00,,5.34,,"-481,787.94"
,IN,AR,30316657,1005,100,,Invoice,,,,,,08/06/2018,08/06/2018,0.00,,29.15,,"-481,817.09"
,IN,AR,30316658,1005,100,,Invoice,,,,,,08/06/2018,08/06/2018,0.00,,21.86,,"-481,838.95"
,IN,AR,30316659,1005,100,,Invoice,,,,,,08/06/2018,08/06/2018,0.00,,5.86,,"-481,844.81"
,IN,AR,30316662,1005,100,,Invoice,,,,,,08/06/2018,08/06/2018,0.00,,3.64,,"-481,848.45"
,IN,AR,30316663,1005,100,,Invoice,,,,,,08/06/2018,08/06/2018,0.00,,4.88,,"-481,853.33"
,IN,AR,30316664,1005,100,,Invoice,,,,,,08/06/2018,08/06/2018,0.00,,14.31,,"-481,867.64"
,IN,AR,30316665,1005,100,,Invoice,,,,,,08/06/2018,08/06/2018,0.00,,267.12,,"-482,134.76"
,IN,AR,30316666,1005,100,,Invoice,,,,,,08/06/2018,08/06/2018,0.00,,1.59,,"-482,136.35"
,IN,AR,30316667,1005,100,,Invoice,,,,,,08/06/2018,08/06/2018,0.00,,9.54,,"-482,145.89"
,IN,AR,30316668,1005,100,,Invoice,,,,,,08/06/2018,08/06/2018,0.00,,36.91,,"-482,182.80"
,IN,AR,30316669,1005,100,,Invoice,,,,,,08/06/2018,08/06/2018,0.00,,49.75,,"-482,232.55"
,IN,AR,30316670,1005,100,,Invoice,,,,,,08/06/2018,08/06/2018,0.00,,50.11,,"-482,282.66"
,IN,AR,30316672,1005,100,,Invoice,,,,,,08/06/2018,08/06/2018,0.00,,14.58,,"-482,297.24"
,IN,AR,30316673,1005,100,,Invoice,,,,,,08/06/2018,08/06/2018,0.00,,12.14,,"-482,309.38"
,IN,AR,30316674,1005,100,,Invoice,,,,,,08/06/2018,08/06/2018,0.00,,12.97,,"-482,322.35"
,IN,AR,30316675,1005,100,,Invoice,,,,,,08/06/2018,08/06/2018,0.00,,7.29,,"-482,329.64"
,IN,AR,30316676,1005,100,,Invoice,,,,,,08/06/2018,08/06/2018,0.00,,29.15,,"-482,358.79"
,IN,AR,30316677,1005,100,,Invoice,,,,,,08/06/2018,08/06/2018,0.00,,36.78,,"-482,395.57"
,IN,AR,30316678,1005,100,,Invoice,,,,,,08/06/2018,08/06/2018,0.00,,28.69,,"-482,424.26"
,IN,AR,30316679,1005,100,,Invoice,,,,,,08/06/2018,08/06/2018,0.00,,15.25,,"-482,439.51"
,IN,AR,30316680,1005,100,,Invoice,,,,,,08/06/2018,08/06/2018,0.00,,26.01,,"-482,465.52"
,IN,AR,30316681,1005,100,,Invoice,,,,,,08/06/2018,08/06/2018,0.00,,14.00,,"-482,479.52"
,IN,AR,30316682,1005,100,,Invoice,,,,,,08/06/2018,08/06/2018,0.00,,20.01,,"-482,499.53"
,IN,AR,30316683,1005,100,,Invoice,,,,,,08/06/2018,08/06/2018,0.00,,10.00,,"-482,509.53"
,IN,AR,30316685,1005,100,,Invoice,,,,,,08/06/2018,08/06/2018,0.00,,35.58,,"-482,545.11"
,IN,AR,30316686,1005,100,,Invoice,,,,,,08/06/2018,08/06/2018,0.00,,54.67,,"-482,599.78"
,IN,AR,30316687,1005,100,,Invoice,,,,,,08/06/2018,08/06/2018,0.00,,31.54,,"-482,631.32"
,IN,AR,30316688,1005,100,,Invoice,,,,,,08/06/2018,08/06/2018,0.00,,25.51,,"-482,656.83"
,IN,AR,30316689,1005,100,,Invoice,,,,,,08/06/2018,08/06/2018,0.00,,16.83,,"-482,673.66"
,IN,AR,30316690,1005,100,,Invoice,,,,,,08/06/2018,08/06/2018,0.00,,4.59,,"-482,678.25"
,IN,AR,30316691,1005,100,,Invoice,,,,,,08/06/2018,08/06/2018,0.00,,7.29,,"-482,685.54"
,IN,AR,30316692,1005,100,,Invoice,,,,,,08/06/2018,08/06/2018,0.00,,36.61,,"-482,722.15"
,IN,AR,30316693,1005,100,,Invoice,,,,,,08/06/2018,08/06/2018,0.00,,29.15,,"-482,751.30"
,IN,AR,30316695,1005,100,,Invoice,,,,,,08/06/2018,08/06/2018,0.00,,21.86,,"-482,773.16"
,IN,AR,30316696,1005,100,,Invoice,,,,,,08/06/2018,08/06/2018,0.00,,4.83,,"-482,777.99"
,IN,AR,30316697,1005,100,,Invoice,,,,,,08/06/2018,08/06/2018,0.00,,24.41,,"-482,802.40"
,IN,AR,30316699,1005,100,,Invoice,,,,,,08/06/2018,08/06/2018,0.00,,12.00,,"-482,814.40"
,IN,AR,30316700,1005,100,,Invoice,,,,,,08/06/2018,08/06/2018,0.00,,8.21,,"-482,822.61"
,IN,AR,30316701,1005,100,,Invoice,,,,,,08/06/2018,08/06/2018,0.00,,27.54,,"-482,850.15"
,IN,AR,30316702,1005,100,,Invoice,,,,,,08/06/2018,08/06/2018,0.00,,7.29,,"-482,857.44"
,IN,AR,30316703,1005,100,,Invoice,,,,,,08/06/2018,08/06/2018,0.00,,2.80,,"-482,860.24"
,IN,AR,30316704,1005,100,,Invoice,,,,,,08/06/2018,08/06/2018,0.00,,12.25,,"-482,872.49"
,IN,AR,30316705,1005,100,,Invoice,,,,,,08/06/2018,08/06/2018,0.00,,6.13,,"-482,878.62"
,IN,AR,30316707,1005,100,,Invoice,,,,,,08/06/2018,08/06/2018,0.00,,19.92,,"-482,898.54"
,IN,AR,30316708,1005,100,,Invoice,,,,,,08/06/2018,08/06/2018,0.00,,6.00,,"-482,904.54"
,IN,AR,30316709,1005,100,,Invoice,,,,,,08/06/2018,08/06/2018,0.00,,2.00,,"-482,906.54"
,IN,AR,30316710,1005,100,,Invoice,,,,,,08/06/2018,08/06/2018,0.00,,2.08,,"-482,908.62"
,IN,AR,30316711,1005,100,,Invoice,,,,,,08/06/2018,08/06/2018,0.00,,8.31,,"-482,916.93"
,IN,AR,30316714,1005,100,,Invoice,,,,,,08/06/2018,08/06/2018,0.00,,29.15,,"-482,946.08"
,IN,AR,30316715,1005,100,,Invoice,,,,,,08/06/2018,08/06/2018,0.00,,3.64,,"-482,949.72"
,IN,AR,30316716,1005,100,,Invoice,,,,,,08/06/2018,08/06/2018,0.00,,21.86,,"-482,971.58"
,IN,AR,30316720,1005,100,,Invoice,,,,,,08/06/2018,08/06/2018,0.00,,23.32,,"-482,994.90"
,IN,AR,30316721,1005,100,,Invoice,,,,,,08/06/2018,08/06/2018,0.00,,7.75,,"-483,002.65"
,IN,AR,30316723,1005,100,,Invoice,,,,,,08/06/2018,08/06/2018,0.00,,10.93,,"-483,013.58"
,CS,AR,32004914,1005,100,,Cash sale,,,,,,09/06/2018,09/06/2018,0.00,,10.93,,"-483,024.51"
,CS,AR,32004921,1005,100,,Cash sale,,,,,,09/06/2018,09/06/2018,0.00,,7.29,,"-483,031.80"
,CS,AR,32004927,1005,100,,Cash sale,,,,,,09/06/2018,09/06/2018,0.00,,10.34,,"-483,042.14"
,CS,AR,32004930,1005,100,,Cash sale,,,,,,09/06/2018,09/06/2018,0.00,,10.93,,"-483,053.07"
,CS,AR,32004931,1005,100,,Cash sale,,,,,,09/06/2018,09/06/2018,0.00,,10.93,,"-483,064.00"
,CS,AR,32004939,1005,100,,Cash sale,,,,,,09/06/2018,09/06/2018,0.00,,20.34,,"-483,084.34"
,CS,AR,32004942,1005,100,,Cash sale,,,,,,09/06/2018,09/06/2018,0.00,,18.22,,"-483,102.56"
,CS,AR,32004945,1005,100,,Cash sale,,,,,,09/06/2018,09/06/2018,0.00,,12.03,,"-483,114.59"
,CS,AR,32004946,1005,100,,Cash sale,,,,,,09/06/2018,09/06/2018,0.00,,5.93,,"-483,120.52"
,CS,AR,32004955,1005,100,,Cash sale,,,,,,09/06/2018,09/06/2018,0.00,,7.29,,"-483,127.81"
,CS,AR,32004964,1005,100,,Cash sale,,,,,,09/06/2018,09/06/2018,0.00,,8.78,,"-483,136.59"
,CS,AR,32004970,1005,100,,Cash sale,,,,,,09/06/2018,09/06/2018,0.00,,7.29,,"-483,143.88"
,IN,AR,30316585,1005,100,,Invoice,,,,,,09/06/2018,09/06/2018,0.00,,86.65,,"-483,230.53"
,IN,AR,30316590,1005,100,,Invoice,,,,,,09/06/2018,09/06/2018,0.00,,47.46,,"-483,277.99"
,IN,AR,30316591,1005,100,,Invoice,,,,,,09/06/2018,09/06/2018,0.00,,60.17,,"-483,338.16"
,IN,AR,30316596,1005,100,,Invoice,,,,,,09/06/2018,09/06/2018,0.00,,29.15,,"-483,367.31"
,IN,AR,30316619,1005,100,,Invoice,,,,,,09/06/2018,09/06/2018,0.00,,612.20,,"-483,979.51"
,IN,AR,30316631,1005,100,,Invoice,,,,,,09/06/2018,09/06/2018,0.00,,8.39,,"-483,987.90"
,IN,AR,30316636,1005,100,,Invoice,,,,,,09/06/2018,09/06/2018,0.00,,12.03,,"-483,999.93"
,IN,AR,30316643,1005,100,,Invoice,,,,,,09/06/2018,09/06/2018,0.00,,21.86,,"-484,021.79"
,IN,AR,30316650,1005,100,,Invoice,,,,,,09/06/2018,09/06/2018,0.00,,9.29,,"-484,031.08"
,IN,AR,30316655,1005,100,,Invoice,,,,,,09/06/2018,09/06/2018,0.00,,47.37,,"-484,078.45"
,IN,AR,30316656,1005,100,,Invoice,,,,,,09/06/2018,09/06/2018,0.00,,29.15,,"-484,107.60"
,IN,AR,30316661,1005,100,,Invoice,,,,,,09/06/2018,09/06/2018,0.00,,18.22,,"-484,125.82"
,IN,AR,30316671,1005,100,,Invoice,,,,,,09/06/2018,09/06/2018,0.00,,364.41,,"-484,490.23"
,IN,AR,30316684,1005,100,,Invoice,,,,,,09/06/2018,09/06/2018,0.00,,10.93,,"-484,501.16"
,IN,AR,30316694,1005,100,,Invoice,,,,,,09/06/2018,09/06/2018,0.00,,14.58,,"-484,515.74"
,IN,AR,30316713,1005,100,,Invoice,,,,,,09/06/2018,09/06/2018,0.00,,3.64,,"-484,519.38"
,IN,AR,30316717,1005,100,,Invoice,,,,,,09/06/2018,09/06/2018,0.00,,40.08,,"-484,559.46"
,CN,AR,31018204,1005,100,,Credit Note,,,,,,11/06/2018,11/06/2018,"1,093.22",,0.00,,"-483,466.24"
,CS,AR,32004982,1005,100,,Cash sale,,,,,,11/06/2018,11/06/2018,0.00,,10.93,,"-483,477.17"
,CS,AR,32004983,1005,100,,Cash sale,,,,,,11/06/2018,11/06/2018,0.00,,29.15,,"-483,506.32"
,CS,AR,32004985,1005,100,,Cash sale,,,,,,11/06/2018,11/06/2018,0.00,,8.42,,"-483,514.74"
,CS,AR,32004996,1005,100,,Cash sale,,,,,,11/06/2018,11/06/2018,0.00,,3.64,,"-483,518.38"
,CS,AR,32005001,1005,100,,Cash sale,,,,,,11/06/2018,11/06/2018,0.00,,18.22,,"-483,536.60"
,CS,AR,32005005,1005,100,,Cash sale,,,,,,11/06/2018,11/06/2018,0.00,,7.29,,"-483,543.89"
,CS,AR,32005007,1005,100,,Cash sale,,,,,,11/06/2018,11/06/2018,0.00,,10.38,,"-483,554.27"
,CS,AR,32005015,1005,100,,Cash sale,,,,,,11/06/2018,11/06/2018,0.00,,11.69,,"-483,565.96"
,CS,AR,32005016,1005,100,,Cash sale,,,,,,11/06/2018,11/06/2018,0.00,,18.22,,"-483,584.18"
,CS,AR,32005018,1005,100,,Cash sale,,,,,,11/06/2018,11/06/2018,0.00,,14.58,,"-483,598.76"
,CS,AR,32005022,1005,100,,Cash sale,,,,,,11/06/2018,11/06/2018,0.00,,3.64,,"-483,602.40"
,CS,AR,32005033,1005,100,,Cash sale,,,,,,11/06/2018,11/06/2018,0.00,,7.29,,"-483,609.69"
,CS,AR,32005036,1005,100,,Cash sale,,,,,,11/06/2018,11/06/2018,0.00,,7.75,,"-483,617.44"
,CS,AR,32005047,1005,100,,Cash sale,,,,,,11/06/2018,11/06/2018,0.00,,12.71,,"-483,630.15"
,CS,AR,32005052,1005,100,,Cash sale,,,,,,11/06/2018,11/06/2018,0.00,,25.85,,"-483,656.00"
,CS,AR,32005064,1005,100,,Cash sale,,,,,,11/06/2018,11/06/2018,0.00,,10.93,,"-483,666.93"
,CS,AR,32005067,1005,100,,Cash sale,,,,,,11/06/2018,11/06/2018,0.00,,7.63,,"-483,674.56"
,CS,AR,32005070,1005,100,,Cash sale,,,,,,11/06/2018,11/06/2018,0.00,,14.62,,"-483,689.18"
,CS,AR,32005074,1005,100,,Cash sale,,,,,,11/06/2018,11/06/2018,0.00,,3.64,,"-483,692.82"
,CS,AR,32005076,1005,100,,Cash sale,,,,,,11/06/2018,11/06/2018,0.00,,48.14,,"-483,740.96"
,CS,AR,32005085,1005,100,,Cash sale,,,,,,11/06/2018,11/06/2018,0.00,,6.48,,"-483,747.44"
,CS,AR,32005100,1005,100,,Cash sale,,,,,,11/06/2018,11/06/2018,0.00,,7.29,,"-483,754.73"
,CS,AR,32005102,1005,100,,Cash sale,,,,,,11/06/2018,11/06/2018,0.00,,2.54,,"-483,757.27"
,CS,AR,32005112,1005,100,,Cash sale,,,,,,11/06/2018,11/06/2018,0.00,,7.29,,"-483,764.56"
,CS,AR,32005113,1005,100,,Cash sale,,,,,,11/06/2018,11/06/2018,0.00,,10.34,,"-483,774.90"
,CS,AR,32005114,1005,100,,Cash sale,,,,,,11/06/2018,11/06/2018,0.00,,3.64,,"-483,778.54"
,CS,AR,32005119,1005,100,,Cash sale,,,,,,11/06/2018,11/06/2018,0.00,,10.93,,"-483,789.47"
,CS,AR,32005120,1005,100,,Cash sale,,,,,,11/06/2018,11/06/2018,0.00,,7.29,,"-483,796.76"
,CS,AR,32005122,1005,100,,Cash sale,,,,,,11/06/2018,11/06/2018,0.00,,10.93,,"-483,807.69"
,CS,AR,32005128,1005,100,,Cash sale,,,,,,11/06/2018,11/06/2018,0.00,,7.29,,"-483,814.98"
,CS,AR,32005132,1005,100,,Cash sale,,,,,,11/06/2018,11/06/2018,0.00,,3.64,,"-483,818.62"
,CS,AR,32005133,1005,100,,Cash sale,,,,,,11/06/2018,11/06/2018,0.00,,5.17,,"-483,823.79"
,CS,AR,32005141,1005,100,,Cash sale,,,,,,11/06/2018,11/06/2018,0.00,,3.64,,"-483,827.43"
,CS,AR,32005146,1005,100,,Cash sale,,,,,,11/06/2018,11/06/2018,0.00,,7.29,,"-483,834.72"
,CS,AR,32005154,1005,100,,Cash sale,,,,,,11/06/2018,11/06/2018,0.00,,7.29,,"-483,842.01"
,CS,AR,32005165,1005,100,,Cash sale,,,,,,11/06/2018,11/06/2018,0.00,,9.84,,"-483,851.85"
,CS,AR,32005167,1005,100,,Cash sale,,,,,,11/06/2018,11/06/2018,0.00,,7.29,,"-483,859.14"
,CS,AR,32005169,1005,100,,Cash sale,,,,,,11/06/2018,11/06/2018,0.00,,9.84,,"-483,868.98"
,CS,AR,32005172,1005,100,,Cash sale,,,,,,11/06/2018,11/06/2018,0.00,,11.44,,"-483,880.42"
,CS,AR,32005182,1005,100,,Cash sale,,,,,,11/06/2018,11/06/2018,0.00,,6.07,,"-483,886.49"
,CS,AR,32005186,1005,100,,Cash sale,,,,,,11/06/2018,11/06/2018,0.00,,57.68,,"-483,944.17"
,CS,AR,32005196,1005,100,,Cash sale,,,,,,11/06/2018,11/06/2018,0.00,,5.47,,"-483,949.64"
,CS,AR,32005197,1005,100,,Cash sale,,,,,,11/06/2018,11/06/2018,0.00,,10.93,,"-483,960.57"
,CS,AR,32005210,1005,100,,Cash sale,,,,,,11/06/2018,11/06/2018,0.00,,10.34,,"-483,970.91"
,CS,AR,32005211,1005,100,,Cash sale,,,,,,11/06/2018,11/06/2018,0.00,,7.29,,"-483,978.20"
,CS,AR,32005214,1005,100,,Cash sale,,,,,,11/06/2018,11/06/2018,0.00,,3.64,,"-483,981.84"
,CS,AR,32005225,1005,100,,Cash sale,,,,,,11/06/2018,11/06/2018,0.00,,14.58,,"-483,996.42"
,CS,AR,32005232,1005,100,,Cash sale,,,,,,11/06/2018,11/06/2018,0.00,,35.08,,"-484,031.50"
,IN,AR,30316724,1005,100,,Invoice,,,,,,11/06/2018,11/06/2018,0.00,,29.66,,"-484,061.16"
,IN,AR,30316731,1005,100,,Invoice,,,,,,11/06/2018,11/06/2018,0.00,,21.86,,"-484,083.02"
,IN,AR,30316732,1005,100,,Invoice,,,,,,11/06/2018,11/06/2018,0.00,,19.64,,"-484,102.66"
,IN,AR,30316742,1005,100,,Invoice,,,,,,11/06/2018,11/06/2018,0.00,,6.08,,"-484,108.74"
,IN,AR,30316743,1005,100,,Invoice,,,,,,11/06/2018,11/06/2018,0.00,,2.03,,"-484,110.77"
,IN,AR,30316744,1005,100,,Invoice,,,,,,11/06/2018,11/06/2018,0.00,,4.05,,"-484,114.82"
,IN,AR,30316745,1005,100,,Invoice,,,,,,11/06/2018,11/06/2018,0.00,,6.08,,"-484,120.90"
,IN,AR,30316746,1005,100,,Invoice,,,,,,11/06/2018,11/06/2018,0.00,,12.15,,"-484,133.05"
,IN,AR,30316747,1005,100,,Invoice,,,,,,11/06/2018,11/06/2018,0.00,,6.08,,"-484,139.13"
,IN,AR,30316748,1005,100,,Invoice,,,,,,11/06/2018,11/06/2018,0.00,,12.15,,"-484,151.28"
,IN,AR,30316750,1005,100,,Invoice,,,,,,11/06/2018,11/06/2018,0.00,,11.86,,"-484,163.14"
,IN,AR,30316757,1005,100,,Invoice,,,,,,11/06/2018,11/06/2018,0.00,,36.44,,"-484,199.58"
,IN,AR,30316766,1005,100,,Invoice,,,,,,11/06/2018,11/06/2018,0.00,,364.41,,"-484,563.99"
,IN,AR,30316768,1005,100,,Invoice,,,,,,11/06/2018,11/06/2018,0.00,,19.03,,"-484,583.02"
,IN,AR,30316772,1005,100,,Invoice,,,,,,11/06/2018,11/06/2018,0.00,,14.58,,"-484,597.60"
,IN,AR,30316776,1005,100,,Invoice,,,,,,11/06/2018,11/06/2018,0.00,,3.88,,"-484,601.48"
,IN,AR,30316781,1005,100,,Invoice,,,,,,11/06/2018,11/06/2018,0.00,,130.51,,"-484,731.99"
,IN,AR,30316786,1005,100,,Invoice,,,,,,11/06/2018,11/06/2018,0.00,,8.26,,"-484,740.25"
,IN,AR,30316787,1005,100,,Invoice,,,,,,11/06/2018,11/06/2018,0.00,,8.26,,"-484,748.51"
,IN,AR,30316790,1005,100,,Invoice,,,,,,11/06/2018,11/06/2018,0.00,,26.00,,"-484,774.51"
,IN,AR,30316797,1005,100,,Invoice,,,,,,11/06/2018,11/06/2018,0.00,,48.78,,"-484,823.29"
,IN,AR,30316803,1005,100,,Invoice,,,,,,11/06/2018,11/06/2018,0.00,,58.00,,"-484,881.29"
,IN,AR,30316804,1005,100,,Invoice,,,,,,11/06/2018,11/06/2018,0.00,,18.00,,"-484,899.29"
,IN,AR,30316811,1005,100,,Invoice,,,,,,11/06/2018,11/06/2018,0.00,,2.75,,"-484,902.04"
,IN,AR,30316812,1005,100,,Invoice,,,,,,11/06/2018,11/06/2018,0.00,,30.51,,"-484,932.55"
,IN,AR,30316813,1005,100,,Invoice,,,,,,11/06/2018,11/06/2018,0.00,,5.51,,"-484,938.06"
,IN,AR,30316815,1005,100,,Invoice,,,,,,11/06/2018,11/06/2018,0.00,,9.73,,"-484,947.79"
,IN,AR,30316820,1005,100,,Invoice,,,,,,11/06/2018,11/06/2018,0.00,,26.00,,"-484,973.79"
,IN,AR,30316823,1005,100,,Invoice,,,,,,11/06/2018,11/06/2018,0.00,,7.29,,"-484,981.08"
,IN,AR,30316831,1005,100,,Invoice,,,,,,11/06/2018,11/06/2018,0.00,,49.12,,"-485,030.20"
,IN,AR,30316834,1005,100,,Invoice,,,,,,11/06/2018,11/06/2018,0.00,,9.70,,"-485,039.90"
,IN,AR,30316839,1005,100,,Invoice,,,,,,11/06/2018,11/06/2018,0.00,,24.00,,"-485,063.90"
,IN,AR,30316846,1005,100,,Invoice,,,,,,11/06/2018,11/06/2018,0.00,,17.71,,"-485,081.61"
,IN,AR,30316851,1005,100,,Invoice,,,,,,11/06/2018,11/06/2018,0.00,,17.03,,"-485,098.64"
,IN,AR,30316854,1005,100,,Invoice,,,,,,11/06/2018,11/06/2018,0.00,,10.93,,"-485,109.57"
,IN,AR,30316856,1005,100,,Invoice,,,,,,11/06/2018,11/06/2018,0.00,,218.64,,"-485,328.21"
,IN,AR,30316858,1005,100,,Invoice,,,,,,11/06/2018,11/06/2018,0.00,,7.97,,"-485,336.18"
,IN,AR,30316863,1005,100,,Invoice,,,,,,11/06/2018,11/06/2018,0.00,,18.09,,"-485,354.27"
,IN,AR,30316867,1005,100,,Invoice,,,,,,11/06/2018,11/06/2018,0.00,,12.92,,"-485,367.19"
,IN,AR,30316872,1005,100,,Invoice,,,,,,11/06/2018,11/06/2018,0.00,,11.48,,"-485,378.67"
,IN,AR,30316881,1005,100,,Invoice,,,,,,11/06/2018,11/06/2018,0.00,,2.12,,"-485,380.79"
,IN,AR,30316882,1005,100,,Invoice,,,,,,11/06/2018,11/06/2018,0.00,,30.51,,"-485,411.30"
,IN,AR,30316887,1005,100,,Invoice,,,,,,11/06/2018,11/06/2018,0.00,,29.66,,"-485,440.96"
,IN,AR,30316888,1005,100,,Invoice,,,,,,11/06/2018,11/06/2018,0.00,,23.26,,"-485,464.22"
,IN,AR,30316893,1005,100,,Invoice,,,,,,11/06/2018,11/06/2018,0.00,,5.93,,"-485,470.15"
,IN,AR,30316894,1005,100,,Invoice,,,,,,11/06/2018,11/06/2018,0.00,,7.76,,"-485,477.91"
,IN,AR,30316896,1005,100,,Invoice,,,,,,11/06/2018,11/06/2018,0.00,,16.73,,"-485,494.64"
,IN,AR,30316899,1005,100,,Invoice,,,,,,11/06/2018,11/06/2018,0.00,,7.29,,"-485,501.93"
,IN,AR,30316908,1005,100,,Invoice,,,,,,11/06/2018,11/06/2018,0.00,,104.59,,"-485,606.52"
,IN,AR,30316911,1005,100,,Invoice,,,,,,11/06/2018,11/06/2018,0.00,,43.22,,"-485,649.74"
,IN,AR,30316915,1005,100,,Invoice,,,,,,11/06/2018,11/06/2018,0.00,,14.34,,"-485,664.08"
,IN,AR,30316920,1005,100,,Invoice,,,,,,11/06/2018,11/06/2018,0.00,,25.76,,"-485,689.84"
,IN,AR,30316923,1005,100,,Invoice,,,,,,11/06/2018,11/06/2018,0.00,,54.66,,"-485,744.50"
,IN,AR,30316924,1005,100,,Invoice,,,,,,11/06/2018,11/06/2018,0.00,,12.03,,"-485,756.53"
,IN,AR,30316927,1005,100,,Invoice,,,,,,11/06/2018,11/06/2018,0.00,,4.24,,"-485,760.77"
,IN,AR,30316928,1005,100,,Invoice,,,,,,11/06/2018,11/06/2018,0.00,,2.75,,"-485,763.52"
,IN,AR,30316931,1005,100,,Invoice,,,,,,11/06/2018,11/06/2018,0.00,,4.24,,"-485,767.76"
,IN,AR,30316941,1005,100,,Invoice,,,,,,11/06/2018,11/06/2018,0.00,,17.80,,"-485,785.56"
,IN,AR,30316955,1005,100,,Invoice,,,,,,11/06/2018,11/06/2018,0.00,,27.54,,"-485,813.10"
,IN,AR,30316963,1005,100,,Invoice,,,,,,11/06/2018,11/06/2018,0.00,,30.51,,"-485,843.61"
,IN,AR,30316969,1005,100,,Invoice,,,,,,11/06/2018,11/06/2018,0.00,,22.37,,"-485,865.98"
,IN,AR,30316974,1005,100,,Invoice,,,,,,11/06/2018,11/06/2018,0.00,,3.64,,"-485,869.62"
,IN,AR,30316976,1005,100,,Invoice,,,,,,11/06/2018,11/06/2018,0.00,,7.29,,"-485,876.91"
,IN,AR,30316982,1005,100,,Invoice,,,,,,11/06/2018,11/06/2018,0.00,,5.51,,"-485,882.42"
,IN,AR,30316983,1005,100,,Invoice,,,,,,11/06/2018,11/06/2018,0.00,,3.64,,"-485,886.06"
,IN,AR,30316986,1005,100,,Invoice,,,,,,11/06/2018,11/06/2018,0.00,,6.08,,"-485,892.14"
,IN,AR,30316989,1005,100,,Invoice,,,,,,11/06/2018,11/06/2018,0.00,,20.67,,"-485,912.81"
,IN,AR,30316990,1005,100,,Invoice,,,,,,11/06/2018,11/06/2018,0.00,,19.64,,"-485,932.45"
,IN,AR,30316993,1005,100,,Invoice,,,,,,11/06/2018,11/06/2018,0.00,,5.25,,"-485,937.70"
,IN,AR,30317011,1005,100,,Invoice,,,,,,11/06/2018,11/06/2018,0.00,,12.00,,"-485,949.70"
,IN,AR,30317014,1005,100,,Invoice,,,,,,11/06/2018,11/06/2018,0.00,,3.01,,"-485,952.71"
,IN,AR,30317015,1005,100,,Invoice,,,,,,11/06/2018,11/06/2018,0.00,,54.66,,"-486,007.37"
,IN,AR,30317019,1005,100,,Invoice,,,,,,11/06/2018,11/06/2018,0.00,,22.03,,"-486,029.40"
,IN,AR,30317024,1005,100,,Invoice,,,,,,11/06/2018,11/06/2018,0.00,,7.75,,"-486,037.15"
,IN,AR,30317028,1005,100,,Invoice,,,,,,11/06/2018,11/06/2018,0.00,,36.12,,"-486,073.27"
,IN,AR,30317029,1005,100,,Invoice,,,,,,11/06/2018,11/06/2018,0.00,,6.74,,"-486,080.01"
,IN,AR,30317033,1005,100,,Invoice,,,,,,11/06/2018,11/06/2018,0.00,,3.20,,"-486,083.21"
,IN,AR,30317048,1005,100,,Invoice,,,,,,11/06/2018,11/06/2018,0.00,,43.73,,"-486,126.94"
,IN,AR,30317049,1005,100,,Invoice,,,,,,11/06/2018,11/06/2018,0.00,,3.53,,"-486,130.47"
,IN,AR,30317057,1005,100,,Invoice,,,,,,11/06/2018,11/06/2018,0.00,,10.93,,"-486,141.40"
,IN,AR,30317059,1005,100,,Invoice,,,,,,11/06/2018,11/06/2018,0.00,,7.29,,"-486,148.69"
,IN,AR,30317067,1005,100,,Invoice,,,,,,11/06/2018,11/06/2018,0.00,,29.15,,"-486,177.84"
,IN,AR,30317071,1005,100,,Invoice,,,,,,11/06/2018,11/06/2018,0.00,,364.41,,"-486,542.25"
,IN,AR,30317073,1005,100,,Invoice,,,,,,11/06/2018,11/06/2018,0.00,,"1,093.22",,"-487,635.47"
,IN,AR,30317074,1005,100,,Invoice,,,,,,11/06/2018,11/06/2018,0.00,,4.29,,"-487,639.76"
,IN,AR,30317075,1005,100,,Invoice,,,,,,11/06/2018,11/06/2018,0.00,,21.86,,"-487,661.62"
,IN,AR,30317080,1005,100,,Invoice,,,,,,11/06/2018,11/06/2018,0.00,,6.51,,"-487,668.13"
,IN,AR,30317092,1005,100,,Invoice,,,,,,11/06/2018,11/06/2018,0.00,,28.00,,"-487,696.13"
,IN,AR,30317094,1005,100,,Invoice,,,,,,11/06/2018,11/06/2018,0.00,,2.14,,"-487,698.27"
,IN,AR,30317098,1005,100,,Invoice,,,,,,11/06/2018,11/06/2018,0.00,,12.03,,"-487,710.30"
,IN,AR,30317108,1005,100,,Invoice,,,,,,11/06/2018,11/06/2018,0.00,,14.58,,"-487,724.88"
,IN,AR,30317109,1005,100,,Invoice,,,,,,11/06/2018,11/06/2018,0.00,,21.86,,"-487,746.74"
,IN,AR,30317110,1005,100,,Invoice,,,,,,11/06/2018,11/06/2018,0.00,,9.84,,"-487,756.58"
,IN,AR,30317113,1005,100,,Invoice,,,,,,11/06/2018,11/06/2018,0.00,,21.02,,"-487,777.60"
,IN,AR,30317115,1005,100,,Invoice,,,,,,11/06/2018,11/06/2018,0.00,,4.58,,"-487,782.18"
,IN,AR,30317116,1005,100,,Invoice,,,,,,11/06/2018,11/06/2018,0.00,,14.58,,"-487,796.76"
,IN,AR,30317118,1005,100,,Invoice,,,,,,11/06/2018,11/06/2018,0.00,,15.27,,"-487,812.03"
,IN,AR,30317128,1005,100,,Invoice,,,,,,11/06/2018,11/06/2018,0.00,,32.01,,"-487,844.04"
,IN,AR,30317130,1005,100,,Invoice,,,,,,11/06/2018,11/06/2018,0.00,,12.00,,"-487,856.04"
,IN,AR,30317134,1005,100,,Invoice,,,,,,11/06/2018,11/06/2018,0.00,,14.00,,"-487,870.04"
,IN,AR,30317136,1005,100,,Invoice,,,,,,11/06/2018,11/06/2018,0.00,,54.66,,"-487,924.70"
,IN,AR,30317137,1005,100,,Invoice,,,,,,11/06/2018,11/06/2018,0.00,,54.66,,"-487,979.36"
,IN,AR,30317142,1005,100,,Invoice,,,,,,11/06/2018,11/06/2018,0.00,,42.24,,"-488,021.60"
,IN,AR,30317151,1005,100,,Invoice,,,,,,11/06/2018,11/06/2018,0.00,,11.66,,"-488,033.26"
,IN,AR,30317154,1005,100,,Invoice,,,,,,11/06/2018,11/06/2018,0.00,,28.99,,"-488,062.25"
,IN,AR,30317155,1005,100,,Invoice,,,,,,11/06/2018,11/06/2018,0.00,,149.15,,"-488,211.40"
,IN,AR,30317158,1005,100,,Invoice,,,,,,11/06/2018,11/06/2018,0.00,,11.22,,"-488,222.62"
,IN,AR,30317163,1005,100,,Invoice,,,,,,11/06/2018,11/06/2018,0.00,,13.98,,"-488,236.60"
,IN,AR,30317166,1005,100,,Invoice,,,,,,11/06/2018,11/06/2018,0.00,,9.64,,"-488,246.24"
,IN,AR,30317188,1005,100,,Invoice,,,,,,11/06/2018,11/06/2018,0.00,,26.69,,"-488,272.93"
,IN,AR,30317191,1005,100,,Invoice,,,,,,11/06/2018,11/06/2018,0.00,,12.75,,"-488,285.68"
,IN,AR,30317208,1005,100,,Invoice,,,,,,11/06/2018,11/06/2018,0.00,,"3,133.90",,"-491,419.58"
,IN,AR,30317209,1005,100,,Invoice,,,,,,11/06/2018,11/06/2018,0.00,,10.00,,"-491,429.58"
,IN,AR,30317211,1005,100,,Invoice,,,,,,11/06/2018,11/06/2018,0.00,,3.76,,"-491,433.34"
,IN,AR,30317215,1005,100,,Invoice,,,,,,11/06/2018,11/06/2018,0.00,,20.44,,"-491,453.78"
,IN,AR,30317225,1005,100,,Invoice,,,,,,11/06/2018,11/06/2018,0.00,,8.21,,"-491,461.99"
,IN,AR,30317230,1005,100,,Invoice,,,,,,11/06/2018,11/06/2018,0.00,,54.66,,"-491,516.65"
,IN,AR,30317235,1005,100,,Invoice,,,,,,11/06/2018,11/06/2018,0.00,,10.47,,"-491,527.12"
,IN,AR,30317238,1005,100,,Invoice,,,,,,11/06/2018,11/06/2018,0.00,,4.08,,"-491,531.20"
,IN,AR,30317251,1005,100,,Invoice,,,,,,11/06/2018,11/06/2018,0.00,,9.11,,"-491,540.31"
,IN,AR,30317255,1005,100,,Invoice,,,,,,11/06/2018,11/06/2018,0.00,,29.15,,"-491,569.46"
,IN,AR,30317256,1005,100,,Invoice,,,,,,11/06/2018,11/06/2018,0.00,,4.15,,"-491,573.61"
,IN,AR,30317257,1005,100,,Invoice,,,,,,11/06/2018,11/06/2018,0.00,,8.31,,"-491,581.92"
,IN,AR,30317258,1005,100,,Invoice,,,,,,11/06/2018,11/06/2018,0.00,,4.15,,"-491,586.07"
,IN,AR,30317259,1005,100,,Invoice,,,,,,11/06/2018,11/06/2018,0.00,,6.23,,"-491,592.30"
,IN,AR,30317260,1005,100,,Invoice,,,,,,11/06/2018,11/06/2018,0.00,,8.31,,"-491,600.61"
,IN,AR,30317261,1005,100,,Invoice,,,,,,11/06/2018,11/06/2018,0.00,,4.15,,"-491,604.76"
,IN,AR,30317275,1005,100,,Invoice,,,,,,11/06/2018,11/06/2018,0.00,,9.84,,"-491,614.60"
,IN,AR,30317276,1005,100,,Invoice,,,,,,11/06/2018,11/06/2018,0.00,,36.23,,"-491,650.83"
,IN,AR,30317278,1005,100,,Invoice,,,,,,11/06/2018,11/06/2018,0.00,,54.66,,"-491,705.49"
,IN,AR,30317286,1005,100,,Invoice,,,,,,11/06/2018,11/06/2018,0.00,,21.86,,"-491,727.35"
,IN,AR,30317292,1005,100,,Invoice,,,,,,11/06/2018,11/06/2018,0.00,,29.15,,"-491,756.50"
,IN,AR,30319807,1005,100,,Invoice,,,,,,11/06/2018,11/06/2018,0.00,,182.20,,"-491,938.70"
,CS,AR,32004981,1005,100,,Cash sale,,,,,,12/06/2018,12/06/2018,0.00,,3.64,,"-491,942.34"
,CS,AR,32004986,1005,100,,Cash sale,,,,,,12/06/2018,12/06/2018,0.00,,3.64,,"-491,945.98"
,CS,AR,32004987,1005,100,,Cash sale,,,,,,12/06/2018,12/06/2018,0.00,,7.29,,"-491,953.27"
,CS,AR,32004988,1005,100,,Cash sale,,,,,,12/06/2018,12/06/2018,0.00,,18.22,,"-491,971.49"
,CS,AR,32005000,1005,100,,Cash sale,,,,,,12/06/2018,12/06/2018,0.00,,6.02,,"-491,977.51"
,CS,AR,32005003,1005,100,,Cash sale,,,,,,12/06/2018,12/06/2018,0.00,,7.29,,"-491,984.80"
,CS,AR,32005011,1005,100,,Cash sale,,,,,,12/06/2018,12/06/2018,0.00,,10.93,,"-491,995.73"
,CS,AR,32005021,1005,100,,Cash sale,,,,,,12/06/2018,12/06/2018,0.00,,18.22,,"-492,013.95"
,CS,AR,32005039,1005,100,,Cash sale,,,,,,12/06/2018,12/06/2018,0.00,,10.93,,"-492,024.88"
,CS,AR,32005041,1005,100,,Cash sale,,,,,,12/06/2018,12/06/2018,0.00,,10.93,,"-492,035.81"
,CS,AR,32005042,1005,100,,Cash sale,,,,,,12/06/2018,12/06/2018,0.00,,8.64,,"-492,044.45"
,CS,AR,32005061,1005,100,,Cash sale,,,,,,12/06/2018,12/06/2018,0.00,,7.29,,"-492,051.74"
,CS,AR,32005065,1005,100,,Cash sale,,,,,,12/06/2018,12/06/2018,0.00,,3.64,,"-492,055.38"
,CS,AR,32005072,1005,100,,Cash sale,,,,,,12/06/2018,12/06/2018,0.00,,8.98,,"-492,064.36"
,CS,AR,32005087,1005,100,,Cash sale,,,,,,12/06/2018,12/06/2018,0.00,,7.50,,"-492,071.86"
,CS,AR,32005088,1005,100,,Cash sale,,,,,,12/06/2018,12/06/2018,0.00,,6.02,,"-492,077.88"
,CS,AR,32005091,1005,100,,Cash sale,,,,,,12/06/2018,12/06/2018,0.00,,3.90,,"-492,081.78"
,CS,AR,32005095,1005,100,,Cash sale,,,,,,12/06/2018,12/06/2018,0.00,,15.04,,"-492,096.82"
,CS,AR,32005096,1005,100,,Cash sale,,,,,,12/06/2018,12/06/2018,0.00,,5.08,,"-492,101.90"
,CS,AR,32005098,1005,100,,Cash sale,,,,,,12/06/2018,12/06/2018,0.00,,7.75,,"-492,109.65"
,CS,AR,32005101,1005,100,,Cash sale,,,,,,12/06/2018,12/06/2018,0.00,,69.19,,"-492,178.84"
,CS,AR,32005103,1005,100,,Cash sale,,,,,,12/06/2018,12/06/2018,0.00,,8.39,,"-492,187.23"
,CS,AR,32005104,1005,100,,Cash sale,,,,,,12/06/2018,12/06/2018,0.00,,12.92,,"-492,200.15"
,CS,AR,32005106,1005,100,,Cash sale,,,,,,12/06/2018,12/06/2018,0.00,,18.22,,"-492,218.37"
,CS,AR,32005107,1005,100,,Cash sale,,,,,,12/06/2018,12/06/2018,0.00,,3.90,,"-492,222.27"
,CS,AR,32005108,1005,100,,Cash sale,,,,,,12/06/2018,12/06/2018,0.00,,7.29,,"-492,229.56"
,CS,AR,32005115,1005,100,,Cash sale,,,,,,12/06/2018,12/06/2018,0.00,,11.69,,"-492,241.25"
,CS,AR,32005123,1005,100,,Cash sale,,,,,,12/06/2018,12/06/2018,0.00,,10.93,,"-492,252.18"
,CS,AR,32005130,1005,100,,Cash sale,,,,,,12/06/2018,12/06/2018,0.00,,5.17,,"-492,257.35"
,CS,AR,32005139,1005,100,,Cash sale,,,,,,12/06/2018,12/06/2018,0.00,,60.17,,"-492,317.52"
,CS,AR,32005140,1005,100,,Cash sale,,,,,,12/06/2018,12/06/2018,0.00,,5.64,,"-492,323.16"
,CS,AR,32005144,1005,100,,Cash sale,,,,,,12/06/2018,12/06/2018,0.00,,5.18,,"-492,328.34"
,CS,AR,32005147,1005,100,,Cash sale,,,,,,12/06/2018,12/06/2018,0.00,,10.95,,"-492,339.29"
,CS,AR,32005148,1005,100,,Cash sale,,,,,,12/06/2018,12/06/2018,0.00,,3.64,,"-492,342.93"
,CS,AR,32005151,1005,100,,Cash sale,,,,,,12/06/2018,12/06/2018,0.00,,15.25,,"-492,358.18"
,CS,AR,32005159,1005,100,,Cash sale,,,,,,12/06/2018,12/06/2018,0.00,,22.00,,"-492,380.18"
,CS,AR,32005183,1005,100,,Cash sale,,,,,,12/06/2018,12/06/2018,0.00,,5.50,,"-492,385.68"
,CS,AR,32005190,1005,100,,Cash sale,,,,,,12/06/2018,12/06/2018,0.00,,18.22,,"-492,403.90"
,CS,AR,32005191,1005,100,,Cash sale,,,,,,12/06/2018,12/06/2018,0.00,,7.29,,"-492,411.19"
,CS,AR,32005203,1005,100,,Cash sale,,,,,,12/06/2018,12/06/2018,0.00,,10.93,,"-492,422.12"
,CS,AR,32005212,1005,100,,Cash sale,,,,,,12/06/2018,12/06/2018,0.00,,3.64,,"-492,425.76"
,CS,AR,32005215,1005,100,,Cash sale,,,,,,12/06/2018,12/06/2018,0.00,,14.58,,"-492,440.34"
,CS,AR,32005216,1005,100,,Cash sale,,,,,,12/06/2018,12/06/2018,0.00,,10.93,,"-492,451.27"
,CS,AR,32005218,1005,100,,Cash sale,,,,,,12/06/2018,12/06/2018,0.00,,10.93,,"-492,462.20"
,CS,AR,32005220,1005,100,,Cash sale,,,,,,12/06/2018,12/06/2018,0.00,,19.16,,"-492,481.36"
,CS,AR,32005221,1005,100,,Cash sale,,,,,,12/06/2018,12/06/2018,0.00,,8.75,,"-492,490.11"
,CS,AR,32005230,1005,100,,Cash sale,,,,,,12/06/2018,12/06/2018,0.00,,13.74,,"-492,503.85"
,CS,AR,32005231,1005,100,,Cash sale,,,,,,12/06/2018,12/06/2018,0.00,,7.29,,"-492,511.14"
,CS,AR,32005233,1005,100,,Cash sale,,,,,,12/06/2018,12/06/2018,0.00,,7.75,,"-492,518.89"
,CS,AR,32005254,1005,100,,Cash sale,,,,,,12/06/2018,12/06/2018,0.00,,364.41,,"-492,883.30"
,IN,AR,30316741,1005,100,,Invoice,,,,,,12/06/2018,12/06/2018,0.00,,54.95,,"-492,938.25"
,IN,AR,30316765,1005,100,,Invoice,,,,,,12/06/2018,12/06/2018,0.00,,7.00,,"-492,945.25"
,IN,AR,30316770,1005,100,,Invoice,,,,,,12/06/2018,12/06/2018,0.00,,21.86,,"-492,967.11"
,IN,AR,30316778,1005,100,,Invoice,,,,,,12/06/2018,12/06/2018,0.00,,7.97,,"-492,975.08"
,IN,AR,30316782,1005,100,,Invoice,,,,,,12/06/2018,12/06/2018,0.00,,80.68,,"-493,055.76"
,IN,AR,30316794,1005,100,,Invoice,,,,,,12/06/2018,12/06/2018,0.00,,21.86,,"-493,077.62"
,IN,AR,30316821,1005,100,,Invoice,,,,,,12/06/2018,12/06/2018,0.00,,24.00,,"-493,101.62"
,IN,AR,30316824,1005,100,,Invoice,,,,,,12/06/2018,12/06/2018,0.00,,7.29,,"-493,108.91"
,IN,AR,30316825,1005,100,,Invoice,,,,,,12/06/2018,12/06/2018,0.00,,18.22,,"-493,127.13"
,IN,AR,30316836,1005,100,,Invoice,,,,,,12/06/2018,12/06/2018,0.00,,64.53,,"-493,191.66"
,IN,AR,30316841,1005,100,,Invoice,,,,,,12/06/2018,12/06/2018,0.00,,14.58,,"-493,206.24"
,IN,AR,30316842,1005,100,,Invoice,,,,,,12/06/2018,12/06/2018,0.00,,21.98,,"-493,228.22"
,IN,AR,30316849,1005,100,,Invoice,,,,,,12/06/2018,12/06/2018,0.00,,7.29,,"-493,235.51"
,IN,AR,30316852,1005,100,,Invoice,,,,,,12/06/2018,12/06/2018,0.00,,7.29,,"-493,242.80"
,IN,AR,30316868,1005,100,,Invoice,,,,,,12/06/2018,12/06/2018,0.00,,27.46,,"-493,270.26"
,IN,AR,30316870,1005,100,,Invoice,,,,,,12/06/2018,12/06/2018,0.00,,11.99,,"-493,282.25"
,IN,AR,30316873,1005,100,,Invoice,,,,,,12/06/2018,12/06/2018,0.00,,10.17,,"-493,292.42"
,IN,AR,30316876,1005,100,,Invoice,,,,,,12/06/2018,12/06/2018,0.00,,4.32,,"-493,296.74"
,IN,AR,30316878,1005,100,,Invoice,,,,,,12/06/2018,12/06/2018,0.00,,8.47,,"-493,305.21"
,IN,AR,30316885,1005,100,,Invoice,,,,,,12/06/2018,12/06/2018,0.00,,6.36,,"-493,311.57"
,IN,AR,30316895,1005,100,,Invoice,,,,,,12/06/2018,12/06/2018,0.00,,10.93,,"-493,322.50"
,IN,AR,30316897,1005,100,,Invoice,,,,,,12/06/2018,12/06/2018,0.00,,3.90,,"-493,326.40"
,IN,AR,30316902,1005,100,,Invoice,,,,,,12/06/2018,12/06/2018,0.00,,15.04,,"-493,341.44"
,IN,AR,30316906,1005,100,,Invoice,,,,,,12/06/2018,12/06/2018,0.00,,7.80,,"-493,349.24"
,IN,AR,30316914,1005,100,,Invoice,,,,,,12/06/2018,12/06/2018,0.00,,5.17,,"-493,354.41"
,IN,AR,30316916,1005,100,,Invoice,,,,,,12/06/2018,12/06/2018,0.00,,4.78,,"-493,359.19"
,IN,AR,30316929,1005,100,,Invoice,,,,,,12/06/2018,12/06/2018,0.00,,60.59,,"-493,419.78"
,IN,AR,30316932,1005,100,,Invoice,,,,,,12/06/2018,12/06/2018,0.00,,34.72,,"-493,454.50"
,IN,AR,30316939,1005,100,,Invoice,,,,,,12/06/2018,12/06/2018,0.00,,54.66,,"-493,509.16"
,IN,AR,30316952,1005,100,,Invoice,,,,,,12/06/2018,12/06/2018,0.00,,7.29,,"-493,516.45"
,IN,AR,30316956,1005,100,,Invoice,,,,,,12/06/2018,12/06/2018,0.00,,7.29,,"-493,523.74"
,IN,AR,30316957,1005,100,,Invoice,,,,,,12/06/2018,12/06/2018,0.00,,5.85,,"-493,529.59"
,IN,AR,30316961,1005,100,,Invoice,,,,,,12/06/2018,12/06/2018,0.00,,35.59,,"-493,565.18"
,IN,AR,30316965,1005,100,,Invoice,,,,,,12/06/2018,12/06/2018,0.00,,14.63,,"-493,579.81"
,IN,AR,30316966,1005,100,,Invoice,,,,,,12/06/2018,12/06/2018,0.00,,10.93,,"-493,590.74"
,IN,AR,30316971,1005,100,,Invoice,,,,,,12/06/2018,12/06/2018,0.00,,11.57,,"-493,602.31"
,IN,AR,30316972,1005,100,,Invoice,,,,,,12/06/2018,12/06/2018,0.00,,10.17,,"-493,612.48"
,IN,AR,30316973,1005,100,,Invoice,,,,,,12/06/2018,12/06/2018,0.00,,10.53,,"-493,623.01"
,IN,AR,30316975,1005,100,,Invoice,,,,,,12/06/2018,12/06/2018,0.00,,7.29,,"-493,630.30"
,IN,AR,30316979,1005,100,,Invoice,,,,,,12/06/2018,12/06/2018,0.00,,4.24,,"-493,634.54"
,IN,AR,30317000,1005,100,,Invoice,,,,,,12/06/2018,12/06/2018,0.00,,"1,093.22",,"-494,727.76"
,IN,AR,30317001,1005,100,,Invoice,,,,,,12/06/2018,12/06/2018,0.00,,10.93,,"-494,738.69"
,IN,AR,30317002,1005,100,,Invoice,,,,,,12/06/2018,12/06/2018,0.00,,7.29,,"-494,745.98"
,IN,AR,30317006,1005,100,,Invoice,,,,,,12/06/2018,12/06/2018,0.00,,36.36,,"-494,782.34"
,IN,AR,30317012,1005,100,,Invoice,,,,,,12/06/2018,12/06/2018,0.00,,14.03,,"-494,796.37"
,IN,AR,30317013,1005,100,,Invoice,,,,,,12/06/2018,12/06/2018,0.00,,10.93,,"-494,807.30"
,IN,AR,30317022,1005,100,,Invoice,,,,,,12/06/2018,12/06/2018,0.00,,8.39,,"-494,815.69"
,IN,AR,30317023,1005,100,,Invoice,,,,,,12/06/2018,12/06/2018,0.00,,7.29,,"-494,822.98"
,IN,AR,30317026,1005,100,,Invoice,,,,,,12/06/2018,12/06/2018,0.00,,2.92,,"-494,825.90"
,IN,AR,30317039,1005,100,,Invoice,,,,,,12/06/2018,12/06/2018,0.00,,10.17,,"-494,836.07"
,IN,AR,30317041,1005,100,,Invoice,,,,,,12/06/2018,12/06/2018,0.00,,7.29,,"-494,843.36"
,IN,AR,30317042,1005,100,,Invoice,,,,,,12/06/2018,12/06/2018,0.00,,17.15,,"-494,860.51"
,IN,AR,30317045,1005,100,,Invoice,,,,,,12/06/2018,12/06/2018,0.00,,23.58,,"-494,884.09"
,IN,AR,30317046,1005,100,,Invoice,,,,,,12/06/2018,12/06/2018,0.00,,42.88,,"-494,926.97"
,IN,AR,30317050,1005,100,,Invoice,,,,,,12/06/2018,12/06/2018,0.00,,3.53,,"-494,930.50"
,IN,AR,30317076,1005,100,,Invoice,,,,,,12/06/2018,12/06/2018,0.00,,7.75,,"-494,938.25"
,IN,AR,30317085,1005,100,,Invoice,,,,,,12/06/2018,12/06/2018,0.00,,1.59,,"-494,939.84"
,IN,AR,30317089,1005,100,,Invoice,,,,,,12/06/2018,12/06/2018,0.00,,34.07,,"-494,973.91"
,IN,AR,30317095,1005,100,,Invoice,,,,,,12/06/2018,12/06/2018,0.00,,221.06,,"-495,194.97"
,IN,AR,30317102,1005,100,,Invoice,,,,,,12/06/2018,12/06/2018,0.00,,18.21,,"-495,213.18"
,IN,AR,30317106,1005,100,,Invoice,,,,,,12/06/2018,12/06/2018,0.00,,198.97,,"-495,412.15"
,IN,AR,30317123,1005,100,,Invoice,,,,,,12/06/2018,12/06/2018,0.00,,12.71,,"-495,424.86"
,IN,AR,30317157,1005,100,,Invoice,,,,,,12/06/2018,12/06/2018,0.00,,5.47,,"-495,430.33"
,IN,AR,30317168,1005,100,,Invoice,,,,,,12/06/2018,12/06/2018,0.00,,118.00,,"-495,548.33"
,IN,AR,30317174,1005,100,,Invoice,,,,,,12/06/2018,12/06/2018,0.00,,23.73,,"-495,572.06"
,IN,AR,30317175,1005,100,,Invoice,,,,,,12/06/2018,12/06/2018,0.00,,7.29,,"-495,579.35"
,IN,AR,30317180,1005,100,,Invoice,,,,,,12/06/2018,12/06/2018,0.00,,2.54,,"-495,581.89"
,IN,AR,30317183,1005,100,,Invoice,,,,,,12/06/2018,12/06/2018,0.00,,29.15,,"-495,611.04"
,IN,AR,30317186,1005,100,,Invoice,,,,,,12/06/2018,12/06/2018,0.00,,17.49,,"-495,628.53"
,IN,AR,30317192,1005,100,,Invoice,,,,,,12/06/2018,12/06/2018,0.00,,15.93,,"-495,644.46"
,IN,AR,30317199,1005,100,,Invoice,,,,,,12/06/2018,12/06/2018,0.00,,62.37,,"-495,706.83"
,IN,AR,30317201,1005,100,,Invoice,,,,,,12/06/2018,12/06/2018,0.00,,28.47,,"-495,735.30"
,IN,AR,30317202,1005,100,,Invoice,,,,,,12/06/2018,12/06/2018,0.00,,83.06,,"-495,818.36"
,IN,AR,30317205,1005,100,,Invoice,,,,,,12/06/2018,12/06/2018,0.00,,16.27,,"-495,834.63"
,IN,AR,30317213,1005,100,,Invoice,,,,,,12/06/2018,12/06/2018,0.00,,1.75,,"-495,836.38"
,IN,AR,30317218,1005,100,,Invoice,,,,,,12/06/2018,12/06/2018,0.00,,141.19,,"-495,977.57"
,IN,AR,30317221,1005,100,,Invoice,,,,,,12/06/2018,12/06/2018,0.00,,7.02,,"-495,984.59"
,IN,AR,30317243,1005,100,,Invoice,,,,,,12/06/2018,12/06/2018,0.00,,29.15,,"-496,013.74"
,IN,AR,30317254,1005,100,,Invoice,,,,,,12/06/2018,12/06/2018,0.00,,10.93,,"-496,024.67"
,IN,AR,30317262,1005,100,,Invoice,,,,,,12/06/2018,12/06/2018,0.00,,6.23,,"-496,030.90"
,IN,AR,30317263,1005,100,,Invoice,,,,,,12/06/2018,12/06/2018,0.00,,2.08,,"-496,032.98"
,IN,AR,30317264,1005,100,,Invoice,,,,,,12/06/2018,12/06/2018,0.00,,24.92,,"-496,057.90"
,IN,AR,30317265,1005,100,,Invoice,,,,,,12/06/2018,12/06/2018,0.00,,6.23,,"-496,064.13"
,IN,AR,30317266,1005,100,,Invoice,,,,,,12/06/2018,12/06/2018,0.00,,8.31,,"-496,072.44"
,IN,AR,30317277,1005,100,,Invoice,,,,,,12/06/2018,12/06/2018,0.00,,10.93,,"-496,083.37"
,IN,AR,30317281,1005,100,,Invoice,,,,,,12/06/2018,12/06/2018,0.00,,12.41,,"-496,095.78"
,IN,AR,30317282,1005,100,,Invoice,,,,,,12/06/2018,12/06/2018,0.00,,7.29,,"-496,103.07"
,IN,AR,30317288,1005,100,,Invoice,,,,,,12/06/2018,12/06/2018,0.00,,12.14,,"-496,115.21"
,IN,AR,30317289,1005,100,,Invoice,,,,,,12/06/2018,12/06/2018,0.00,,16.95,,"-496,132.16"
,IN,AR,30317290,1005,100,,Invoice,,,,,,12/06/2018,12/06/2018,0.00,,4.78,,"-496,136.94"
,CN,AR,31018160,1005,100,,Credit Note,,,,,,13/06/2018,13/06/2018,57.80,,0.00,,"-496,079.14"
,CS,AR,32004977,1005,100,,Cash sale,,,,,,13/06/2018,13/06/2018,0.00,,42.64,,"-496,121.78"
,CS,AR,32004980,1005,100,,Cash sale,,,,,,13/06/2018,13/06/2018,0.00,,18.22,,"-496,140.00"
,CS,AR,32004989,1005,100,,Cash sale,,,,,,13/06/2018,13/06/2018,0.00,,3.64,,"-496,143.64"
,CS,AR,32004990,1005,100,,Cash sale,,,,,,13/06/2018,13/06/2018,0.00,,7.29,,"-496,150.93"
,CS,AR,32004994,1005,100,,Cash sale,,,,,,13/06/2018,13/06/2018,0.00,,21.86,,"-496,172.79"
,CS,AR,32005004,1005,100,,Cash sale,,,,,,13/06/2018,13/06/2018,0.00,,7.29,,"-496,180.08"
,CS,AR,32005013,1005,100,,Cash sale,,,,,,13/06/2018,13/06/2018,0.00,,12.03,,"-496,192.11"
,CS,AR,32005026,1005,100,,Cash sale,,,,,,13/06/2018,13/06/2018,0.00,,7.29,,"-496,199.40"
,CS,AR,32005031,1005,100,,Cash sale,,,,,,13/06/2018,13/06/2018,0.00,,5.86,,"-496,205.26"
,CS,AR,32005037,1005,100,,Cash sale,,,,,,13/06/2018,13/06/2018,0.00,,12.92,,"-496,218.18"
,CS,AR,32005050,1005,100,,Cash sale,,,,,,13/06/2018,13/06/2018,0.00,,10.34,,"-496,228.52"
,CS,AR,32005054,1005,100,,Cash sale,,,,,,13/06/2018,13/06/2018,0.00,,10.93,,"-496,239.45"
,CS,AR,32005056,1005,100,,Cash sale,,,,,,13/06/2018,13/06/2018,0.00,,18.05,,"-496,257.50"
,CS,AR,32005057,1005,100,,Cash sale,,,,,,13/06/2018,13/06/2018,0.00,,8.58,,"-496,266.08"
,CS,AR,32005059,1005,100,,Cash sale,,,,,,13/06/2018,13/06/2018,0.00,,12.03,,"-496,278.11"
,CS,AR,32005063,1005,100,,Cash sale,,,,,,13/06/2018,13/06/2018,0.00,,10.93,,"-496,289.04"
,CS,AR,32005083,1005,100,,Cash sale,,,,,,13/06/2018,13/06/2018,0.00,,14.58,,"-496,303.62"
,CS,AR,32005089,1005,100,,Cash sale,,,,,,13/06/2018,13/06/2018,0.00,,3.64,,"-496,307.26"
,CS,AR,32005090,1005,100,,Cash sale,,,,,,13/06/2018,13/06/2018,0.00,,10.93,,"-496,318.19"
,CS,AR,32005094,1005,100,,Cash sale,,,,,,13/06/2018,13/06/2018,0.00,,10.93,,"-496,329.12"
,CS,AR,32005099,1005,100,,Cash sale,,,,,,13/06/2018,13/06/2018,0.00,,10.93,,"-496,340.05"
,CS,AR,32005109,1005,100,,Cash sale,,,,,,13/06/2018,13/06/2018,0.00,,21.86,,"-496,361.91"
,CS,AR,32005110,1005,100,,Cash sale,,,,,,13/06/2018,13/06/2018,0.00,,3.64,,"-496,365.55"
,CS,AR,32005116,1005,100,,Cash sale,,,,,,13/06/2018,13/06/2018,0.00,,14.58,,"-496,380.13"
,CS,AR,32005121,1005,100,,Cash sale,,,,,,13/06/2018,13/06/2018,0.00,,10.93,,"-496,391.06"
,CS,AR,32005127,1005,100,,Cash sale,,,,,,13/06/2018,13/06/2018,0.00,,14.58,,"-496,405.64"
,CS,AR,32005138,1005,100,,Cash sale,,,,,,13/06/2018,13/06/2018,0.00,,5.34,,"-496,410.98"
,CS,AR,32005145,1005,100,,Cash sale,,,,,,13/06/2018,13/06/2018,0.00,,16.61,,"-496,427.59"
,CS,AR,32005156,1005,100,,Cash sale,,,,,,13/06/2018,13/06/2018,0.00,,3.64,,"-496,431.23"
,CS,AR,32005157,1005,100,,Cash sale,,,,,,13/06/2018,13/06/2018,0.00,,16.02,,"-496,447.25"
,CS,AR,32005163,1005,100,,Cash sale,,,,,,13/06/2018,13/06/2018,0.00,,13.77,,"-496,461.02"
,CS,AR,32005170,1005,100,,Cash sale,,,,,,13/06/2018,13/06/2018,0.00,,10.93,,"-496,471.95"
,CS,AR,32005171,1005,100,,Cash sale,,,,,,13/06/2018,13/06/2018,0.00,,10.93,,"-496,482.88"
,CS,AR,32005173,1005,100,,Cash sale,,,,,,13/06/2018,13/06/2018,0.00,,9.15,,"-496,492.03"
,CS,AR,32005176,1005,100,,Cash sale,,,,,,13/06/2018,13/06/2018,0.00,,10.93,,"-496,502.96"
,CS,AR,32005187,1005,100,,Cash sale,,,,,,13/06/2018,13/06/2018,0.00,,15.04,,"-496,518.00"
,CS,AR,32005188,1005,100,,Cash sale,,,,,,13/06/2018,13/06/2018,0.00,,10.93,,"-496,528.93"
,CS,AR,32005193,1005,100,,Cash sale,,,,,,13/06/2018,13/06/2018,0.00,,7.29,,"-496,536.22"
,CS,AR,32005198,1005,100,,Cash sale,,,,,,13/06/2018,13/06/2018,0.00,,10.93,,"-496,547.15"
,CS,AR,32005201,1005,100,,Cash sale,,,,,,13/06/2018,13/06/2018,0.00,,14.58,,"-496,561.73"
,CS,AR,32005205,1005,100,,Cash sale,,,,,,13/06/2018,13/06/2018,0.00,,3.64,,"-496,565.37"
,CS,AR,32005206,1005,100,,Cash sale,,,,,,13/06/2018,13/06/2018,0.00,,9.10,,"-496,574.47"
,CS,AR,32005209,1005,100,,Cash sale,,,,,,13/06/2018,13/06/2018,0.00,,10.93,,"-496,585.40"
,CS,AR,32005238,1005,100,,Cash sale,,,,,,13/06/2018,13/06/2018,0.00,,5.94,,"-496,591.34"
,CS,AR,32005249,1005,100,,Cash sale,,,,,,13/06/2018,13/06/2018,0.00,,3.64,,"-496,594.98"
,CS,AR,32005252,1005,100,,Cash sale,,,,,,13/06/2018,13/06/2018,0.00,,10.17,,"-496,605.15"
,IN,AR,30316725,1005,100,,Invoice,,,,,,13/06/2018,13/06/2018,0.00,,38.56,,"-496,643.71"
,IN,AR,30316737,1005,100,,Invoice,,,,,,13/06/2018,13/06/2018,0.00,,25.51,,"-496,669.22"
,IN,AR,30316739,1005,100,,Invoice,,,,,,13/06/2018,13/06/2018,0.00,,53.69,,"-496,722.91"
,IN,AR,30316740,1005,100,,Invoice,,,,,,13/06/2018,13/06/2018,0.00,,14.64,,"-496,737.55"
,IN,AR,30316753,1005,100,,Invoice,,,,,,13/06/2018,13/06/2018,0.00,,21.86,,"-496,759.41"
,IN,AR,30316754,1005,100,,Invoice,,,,,,13/06/2018,13/06/2018,0.00,,17.92,,"-496,777.33"
,IN,AR,30316758,1005,100,,Invoice,,,,,,13/06/2018,13/06/2018,0.00,,57.80,,"-496,835.13"
,IN,AR,30316759,1005,100,,Invoice,,,,,,13/06/2018,13/06/2018,0.00,,21.02,,"-496,856.15"
,IN,AR,30316760,1005,100,,Invoice,,,,,,13/06/2018,13/06/2018,0.00,,78.81,,"-496,934.96"
,IN,AR,30316773,1005,100,,Invoice,,,,,,13/06/2018,13/06/2018,0.00,,364.41,,"-497,299.37"
,IN,AR,30316783,1005,100,,Invoice,,,,,,13/06/2018,13/06/2018,0.00,,30.85,,"-497,330.22"
,IN,AR,30316796,1005,100,,Invoice,,,,,,13/06/2018,13/06/2018,0.00,,10.93,,"-497,341.15"
,IN,AR,30316799,1005,100,,Invoice,,,,,,13/06/2018,13/06/2018,0.00,,10.93,,"-497,352.08"
,IN,AR,30316805,1005,100,,Invoice,,,,,,13/06/2018,13/06/2018,0.00,,18.00,,"-497,370.08"
,IN,AR,30316817,1005,100,,Invoice,,,,,,13/06/2018,13/06/2018,0.00,,40.00,,"-497,410.08"
,IN,AR,30316832,1005,100,,Invoice,,,,,,13/06/2018,13/06/2018,0.00,,177.37,,"-497,587.45"
,IN,AR,30316833,1005,100,,Invoice,,,,,,13/06/2018,13/06/2018,0.00,,650.81,,"-498,238.26"
,IN,AR,30316843,1005,100,,Invoice,,,,,,13/06/2018,13/06/2018,0.00,,6.02,,"-498,244.28"
,IN,AR,30316850,1005,100,,Invoice,,,,,,13/06/2018,13/06/2018,0.00,,34.48,,"-498,278.76"
,IN,AR,30316855,1005,100,,Invoice,,,,,,13/06/2018,13/06/2018,0.00,,3.64,,"-498,282.40"
,IN,AR,30316859,1005,100,,Invoice,,,,,,13/06/2018,13/06/2018,0.00,,9.56,,"-498,291.96"
,IN,AR,30316875,1005,100,,Invoice,,,,,,13/06/2018,13/06/2018,0.00,,25.42,,"-498,317.38"
,IN,AR,30316879,1005,100,,Invoice,,,,,,13/06/2018,13/06/2018,0.00,,4.24,,"-498,321.62"
,IN,AR,30316880,1005,100,,Invoice,,,,,,13/06/2018,13/06/2018,0.00,,4.24,,"-498,325.86"
,IN,AR,30316883,1005,100,,Invoice,,,,,,13/06/2018,13/06/2018,0.00,,58.98,,"-498,384.84"
,IN,AR,30316884,1005,100,,Invoice,,,,,,13/06/2018,13/06/2018,0.00,,6.36,,"-498,391.20"
,IN,AR,30316886,1005,100,,Invoice,,,,,,13/06/2018,13/06/2018,0.00,,5.59,,"-498,396.79"
,IN,AR,30316898,1005,100,,Invoice,,,,,,13/06/2018,13/06/2018,0.00,,10.93,,"-498,407.72"
,IN,AR,30316905,1005,100,,Invoice,,,,,,13/06/2018,13/06/2018,0.00,,16.73,,"-498,424.45"
,IN,AR,30316909,1005,100,,Invoice,,,,,,13/06/2018,13/06/2018,0.00,,59.47,,"-498,483.92"
,IN,AR,30316921,1005,100,,Invoice,,,,,,13/06/2018,13/06/2018,0.00,,12.88,,"-498,496.80"
,IN,AR,30316926,1005,100,,Invoice,,,,,,13/06/2018,13/06/2018,0.00,,14.83,,"-498,511.63"
,IN,AR,30316930,1005,100,,Invoice,,,,,,13/06/2018,13/06/2018,0.00,,18.09,,"-498,529.72"
,IN,AR,30316936,1005,100,,Invoice,,,,,,13/06/2018,13/06/2018,0.00,,296.08,,"-498,825.80"
,IN,AR,30316942,1005,100,,Invoice,,,,,,13/06/2018,13/06/2018,0.00,,5.08,,"-498,830.88"
,IN,AR,30316950,1005,100,,Invoice,,,,,,13/06/2018,13/06/2018,0.00,,17.80,,"-498,848.68"
,IN,AR,30316960,1005,100,,Invoice,,,,,,13/06/2018,13/06/2018,0.00,,22.71,,"-498,871.39"
,IN,AR,30316995,1005,100,,Invoice,,,,,,13/06/2018,13/06/2018,0.00,,29.66,,"-498,901.05"
,IN,AR,30316998,1005,100,,Invoice,,,,,,13/06/2018,13/06/2018,0.00,,13.98,,"-498,915.03"
,IN,AR,30317004,1005,100,,Invoice,,,,,,13/06/2018,13/06/2018,0.00,,19.07,,"-498,934.10"
,IN,AR,30317008,1005,100,,Invoice,,,,,,13/06/2018,13/06/2018,0.00,,7.63,,"-498,941.73"
,IN,AR,30317010,1005,100,,Invoice,,,,,,13/06/2018,13/06/2018,0.00,,18.22,,"-498,959.95"
,IN,AR,30317017,1005,100,,Invoice,,,,,,13/06/2018,13/06/2018,0.00,,8.77,,"-498,968.72"
,IN,AR,30317021,1005,100,,Invoice,,,,,,13/06/2018,13/06/2018,0.00,,14.58,,"-498,983.30"
,IN,AR,30317030,1005,100,,Invoice,,,,,,13/06/2018,13/06/2018,0.00,,24.07,,"-499,007.37"
,IN,AR,30317051,1005,100,,Invoice,,,,,,13/06/2018,13/06/2018,0.00,,14.09,,"-499,021.46"
,IN,AR,30317052,1005,100,,Invoice,,,,,,13/06/2018,13/06/2018,0.00,,1.76,,"-499,023.22"
,IN,AR,30317055,1005,100,,Invoice,,,,,,13/06/2018,13/06/2018,0.00,,27.08,,"-499,050.30"
,IN,AR,30317064,1005,100,,Invoice,,,,,,13/06/2018,13/06/2018,0.00,,10.34,,"-499,060.64"
,IN,AR,30317068,1005,100,,Invoice,,,,,,13/06/2018,13/06/2018,0.00,,26.01,,"-499,086.65"
,IN,AR,30317069,1005,100,,Invoice,,,,,,13/06/2018,13/06/2018,0.00,,32.80,,"-499,119.45"
,IN,AR,30317070,1005,100,,Invoice,,,,,,13/06/2018,13/06/2018,0.00,,32.80,,"-499,152.25"
,IN,AR,30317077,1005,100,,Invoice,,,,,,13/06/2018,13/06/2018,0.00,,10.17,,"-499,162.42"
,IN,AR,30317079,1005,100,,Invoice,,,,,,13/06/2018,13/06/2018,0.00,,10.93,,"-499,173.35"
,IN,AR,30317088,1005,100,,Invoice,,,,,,13/06/2018,13/06/2018,0.00,,8.02,,"-499,181.37"
,IN,AR,30317091,1005,100,,Invoice,,,,,,13/06/2018,13/06/2018,0.00,,36.00,,"-499,217.37"
,IN,AR,30317097,1005,100,,Invoice,,,,,,13/06/2018,13/06/2018,0.00,,78.17,,"-499,295.54"
,IN,AR,30317101,1005,100,,Invoice,,,,,,13/06/2018,13/06/2018,0.00,,3.64,,"-499,299.18"
,IN,AR,30317107,1005,100,,Invoice,,,,,,13/06/2018,13/06/2018,0.00,,7.29,,"-499,306.47"
,IN,AR,30317119,1005,100,,Invoice,,,,,,13/06/2018,13/06/2018,0.00,,18.22,,"-499,324.69"
,IN,AR,30317120,1005,100,,Invoice,,,,,,13/06/2018,13/06/2018,0.00,,31.04,,"-499,355.73"
,IN,AR,30317124,1005,100,,Invoice,,,,,,13/06/2018,13/06/2018,0.00,,5.08,,"-499,360.81"
,IN,AR,30317125,1005,100,,Invoice,,,,,,13/06/2018,13/06/2018,0.00,,2.54,,"-499,363.35"
,IN,AR,30317141,1005,100,,Invoice,,,,,,13/06/2018,13/06/2018,0.00,,96.53,,"-499,459.88"
,IN,AR,30317143,1005,100,,Invoice,,,,,,13/06/2018,13/06/2018,0.00,,3.02,,"-499,462.90"
,IN,AR,30317145,1005,100,,Invoice,,,,,,13/06/2018,13/06/2018,0.00,,16.82,,"-499,479.72"
,IN,AR,30317146,1005,100,,Invoice,,,,,,13/06/2018,13/06/2018,0.00,,6.31,,"-499,486.03"
,IN,AR,30317165,1005,100,,Invoice,,,,,,13/06/2018,13/06/2018,0.00,,8.39,,"-499,494.42"
,IN,AR,30317167,1005,100,,Invoice,,,,,,13/06/2018,13/06/2018,0.00,,3.21,,"-499,497.63"
,IN,AR,30317190,1005,100,,Invoice,,,,,,13/06/2018,13/06/2018,0.00,,7.29,,"-499,504.92"
,IN,AR,30317193,1005,100,,Invoice,,,,,,13/06/2018,13/06/2018,0.00,,9.56,,"-499,514.48"
,IN,AR,30317200,1005,100,,Invoice,,,,,,13/06/2018,13/06/2018,0.00,,36.86,,"-499,551.34"
,IN,AR,30317212,1005,100,,Invoice,,,,,,13/06/2018,13/06/2018,0.00,,3.51,,"-499,554.85"
,IN,AR,30317228,1005,100,,Invoice,,,,,,13/06/2018,13/06/2018,0.00,,7.53,,"-499,562.38"
,IN,AR,30317231,1005,100,,Invoice,,,,,,13/06/2018,13/06/2018,0.00,,7.29,,"-499,569.67"
,IN,AR,30317237,1005,100,,Invoice,,,,,,13/06/2018,13/06/2018,0.00,,13.98,,"-499,583.65"
,IN,AR,30317246,1005,100,,Invoice,,,,,,13/06/2018,13/06/2018,0.00,,29.15,,"-499,612.80"
,IN,AR,30317248,1005,100,,Invoice,,,,,,13/06/2018,13/06/2018,0.00,,9.15,,"-499,621.95"
,IN,AR,30317249,1005,100,,Invoice,,,,,,13/06/2018,13/06/2018,0.00,,3.64,,"-499,625.59"
,IN,AR,30317267,1005,100,,Invoice,,,,,,13/06/2018,13/06/2018,0.00,,56.06,,"-499,681.65"
,IN,AR,30317268,1005,100,,Invoice,,,,,,13/06/2018,13/06/2018,0.00,,6.23,,"-499,687.88"
,IN,AR,30317269,1005,100,,Invoice,,,,,,13/06/2018,13/06/2018,0.00,,8.31,,"-499,696.19"
,IN,AR,30317279,1005,100,,Invoice,,,,,,13/06/2018,13/06/2018,0.00,,29.15,,"-499,725.34"
,IN,AR,30317283,1005,100,,Invoice,,,,,,13/06/2018,13/06/2018,0.00,,24.15,,"-499,749.49"
,IN,AR,30317295,1005,100,,Invoice,,,,,,13/06/2018,13/06/2018,0.00,,29.15,,"-499,778.64"
,CN,AR,31018192,1005,100,,Credit Note,,,,,,14/06/2018,14/06/2018,29.15,,0.00,,"-499,749.49"
,CS,AR,32004975,1005,100,,Cash sale,,,,,,14/06/2018,14/06/2018,0.00,,12.03,,"-499,761.52"
,CS,AR,32004979,1005,100,,Cash sale,,,,,,14/06/2018,14/06/2018,0.00,,3.64,,"-499,765.16"
,CS,AR,32004984,1005,100,,Cash sale,,,,,,14/06/2018,14/06/2018,0.00,,2.58,,"-499,767.74"
,CS,AR,32004993,1005,100,,Cash sale,,,,,,14/06/2018,14/06/2018,0.00,,10.93,,"-499,778.67"
,CS,AR,32004995,1005,100,,Cash sale,,,,,,14/06/2018,14/06/2018,0.00,,18.22,,"-499,796.89"
,CS,AR,32004998,1005,100,,Cash sale,,,,,,14/06/2018,14/06/2018,0.00,,7.29,,"-499,804.18"
,CS,AR,32005002,1005,100,,Cash sale,,,,,,14/06/2018,14/06/2018,0.00,,3.64,,"-499,807.82"
,CS,AR,32005006,1005,100,,Cash sale,,,,,,14/06/2018,14/06/2018,0.00,,14.58,,"-499,822.40"
,CS,AR,32005009,1005,100,,Cash sale,,,,,,14/06/2018,14/06/2018,0.00,,7.29,,"-499,829.69"
,CS,AR,32005010,1005,100,,Cash sale,,,,,,14/06/2018,14/06/2018,0.00,,3.64,,"-499,833.33"
,CS,AR,32005014,1005,100,,Cash sale,,,,,,14/06/2018,14/06/2018,0.00,,7.29,,"-499,840.62"
,CS,AR,32005019,1005,100,,Cash sale,,,,,,14/06/2018,14/06/2018,0.00,,3.64,,"-499,844.26"
,CS,AR,32005020,1005,100,,Cash sale,,,,,,14/06/2018,14/06/2018,0.00,,21.86,,"-499,866.12"
,CS,AR,32005027,1005,100,,Cash sale,,,,,,14/06/2018,14/06/2018,0.00,,7.29,,"-499,873.41"
,CS,AR,32005029,1005,100,,Cash sale,,,,,,14/06/2018,14/06/2018,0.00,,3.01,,"-499,876.42"
,CS,AR,32005032,1005,100,,Cash sale,,,,,,14/06/2018,14/06/2018,0.00,,7.29,,"-499,883.71"
,CS,AR,32005035,1005,100,,Cash sale,,,,,,14/06/2018,14/06/2018,0.00,,7.29,,"-499,891.00"
,CS,AR,32005038,1005,100,,Cash sale,,,,,,14/06/2018,14/06/2018,0.00,,14.58,,"-499,905.58"
,CS,AR,32005040,1005,100,,Cash sale,,,,,,14/06/2018,14/06/2018,0.00,,3.64,,"-499,909.22"
,CS,AR,32005043,1005,100,,Cash sale,,,,,,14/06/2018,14/06/2018,0.00,,7.29,,"-499,916.51"
,CS,AR,32005049,1005,100,,Cash sale,,,,,,14/06/2018,14/06/2018,0.00,,10.34,,"-499,926.85"
,CS,AR,32005066,1005,100,,Cash sale,,,,,,14/06/2018,14/06/2018,0.00,,14.58,,"-499,941.43"
,CS,AR,32005069,1005,100,,Cash sale,,,,,,14/06/2018,14/06/2018,0.00,,18.22,,"-499,959.65"
,CS,AR,32005073,1005,100,,Cash sale,,,,,,14/06/2018,14/06/2018,0.00,,13.47,,"-499,973.12"
,CS,AR,32005078,1005,100,,Cash sale,,,,,,14/06/2018,14/06/2018,0.00,,6.86,,"-499,979.98"
,CS,AR,32005079,1005,100,,Cash sale,,,,,,14/06/2018,14/06/2018,0.00,,16.78,,"-499,996.76"
,CS,AR,32005080,1005,100,,Cash sale,,,,,,14/06/2018,14/06/2018,0.00,,8.17,,"-500,004.93"
,CS,AR,32005092,1005,100,,Cash sale,,,,,,14/06/2018,14/06/2018,0.00,,16.53,,"-500,021.46"
,CS,AR,32005105,1005,100,,Cash sale,,,,,,14/06/2018,14/06/2018,0.00,,14.58,,"-500,036.04"
,CS,AR,32005111,1005,100,,Cash sale,,,,,,14/06/2018,14/06/2018,0.00,,81.10,,"-500,117.14"
,CS,AR,32005117,1005,100,,Cash sale,,,,,,14/06/2018,14/06/2018,0.00,,10.93,,"-500,128.07"
,CS,AR,32005125,1005,100,,Cash sale,,,,,,14/06/2018,14/06/2018,0.00,,12.88,,"-500,140.95"
,CS,AR,32005129,1005,100,,Cash sale,,,,,,14/06/2018,14/06/2018,0.00,,7.75,,"-500,148.70"
,CS,AR,32005142,1005,100,,Cash sale,,,,,,14/06/2018,14/06/2018,0.00,,55.93,,"-500,204.63"
,CS,AR,32005149,1005,100,,Cash sale,,,,,,14/06/2018,14/06/2018,0.00,,3.64,,"-500,208.27"
,CS,AR,32005158,1005,100,,Cash sale,,,,,,14/06/2018,14/06/2018,0.00,,18.22,,"-500,226.49"
,CS,AR,32005164,1005,100,,Cash sale,,,,,,14/06/2018,14/06/2018,0.00,,10.93,,"-500,237.42"
,CS,AR,32005177,1005,100,,Cash sale,,,,,,14/06/2018,14/06/2018,0.00,,18.22,,"-500,255.64"
,CS,AR,32005178,1005,100,,Cash sale,,,,,,14/06/2018,14/06/2018,0.00,,25.51,,"-500,281.15"
,CS,AR,32005208,1005,100,,Cash sale,,,,,,14/06/2018,14/06/2018,0.00,,18.22,,"-500,299.37"
,CS,AR,32005217,1005,100,,Cash sale,,,,,,14/06/2018,14/06/2018,0.00,,10.93,,"-500,310.30"
,CS,AR,32005219,1005,100,,Cash sale,,,,,,14/06/2018,14/06/2018,0.00,,10.93,,"-500,321.23"
,CS,AR,32005222,1005,100,,Cash sale,,,,,,14/06/2018,14/06/2018,0.00,,7.29,,"-500,328.52"
,CS,AR,32005226,1005,100,,Cash sale,,,,,,14/06/2018,14/06/2018,0.00,,2.92,,"-500,331.44"
,CS,AR,32005227,1005,100,,Cash sale,,,,,,14/06/2018,14/06/2018,0.00,,7.29,,"-500,338.73"
,CS,AR,32005229,1005,100,,Cash sale,,,,,,14/06/2018,14/06/2018,0.00,,9.84,,"-500,348.57"
,CS,AR,32005250,1005,100,,Cash sale,,,,,,14/06/2018,14/06/2018,0.00,,7.29,,"-500,355.86"
,CS,AR,32005251,1005,100,,Cash sale,,,,,,14/06/2018,14/06/2018,0.00,,7.29,,"-500,363.15"
,CS,AR,32005256,1005,100,,Cash sale,,,,,,14/06/2018,14/06/2018,0.00,,72.88,,"-500,436.03"
,IN,AR,30316728,1005,100,,Invoice,,,,,,14/06/2018,14/06/2018,0.00,,15.04,,"-500,451.07"
,IN,AR,30316730,1005,100,,Invoice,,,,,,14/06/2018,14/06/2018,0.00,,3.64,,"-500,454.71"
,IN,AR,30316733,1005,100,,Invoice,,,,,,14/06/2018,14/06/2018,0.00,,35.59,,"-500,490.30"
,IN,AR,30316734,1005,100,,Invoice,,,,,,14/06/2018,14/06/2018,0.00,,261.03,,"-500,751.33"
,IN,AR,30316738,1005,100,,Invoice,,,,,,14/06/2018,14/06/2018,0.00,,7.29,,"-500,758.62"
,IN,AR,30316749,1005,100,,Invoice,,,,,,14/06/2018,14/06/2018,0.00,,8.10,,"-500,766.72"
,IN,AR,30316751,1005,100,,Invoice,,,,,,14/06/2018,14/06/2018,0.00,,32.54,,"-500,799.26"
,IN,AR,30316755,1005,100,,Invoice,,,,,,14/06/2018,14/06/2018,0.00,,3.64,,"-500,802.90"
,IN,AR,30316756,1005,100,,Invoice,,,,,,14/06/2018,14/06/2018,0.00,,6.08,,"-500,808.98"
,IN,AR,30316761,1005,100,,Invoice,,,,,,14/06/2018,14/06/2018,0.00,,24.15,,"-500,833.13"
,IN,AR,30316763,1005,100,,Invoice,,,,,,14/06/2018,14/06/2018,0.00,,10.93,,"-500,844.06"
,IN,AR,30316767,1005,100,,Invoice,,,,,,14/06/2018,14/06/2018,0.00,,16.27,,"-500,860.33"
,IN,AR,30316779,1005,100,,Invoice,,,,,,14/06/2018,14/06/2018,0.00,,1.99,,"-500,862.32"
,IN,AR,30316780,1005,100,,Invoice,,,,,,14/06/2018,14/06/2018,0.00,,7.97,,"-500,870.29"
,IN,AR,30316784,1005,100,,Invoice,,,,,,14/06/2018,14/06/2018,0.00,,40.34,,"-500,910.63"
,IN,AR,30316789,1005,100,,Invoice,,,,,,14/06/2018,14/06/2018,0.00,,7.29,,"-500,917.92"
,IN,AR,30316791,1005,100,,Invoice,,,,,,14/06/2018,14/06/2018,0.00,,60.00,,"-500,977.92"
,IN,AR,30316800,1005,100,,Invoice,,,,,,14/06/2018,14/06/2018,0.00,,40.08,,"-501,018.00"
,IN,AR,30316801,1005,100,,Invoice,,,,,,14/06/2018,14/06/2018,0.00,,7.29,,"-501,025.29"
,IN,AR,30316807,1005,100,,Invoice,,,,,,14/06/2018,14/06/2018,0.00,,3.64,,"-501,028.93"
,IN,AR,30316818,1005,100,,Invoice,,,,,,14/06/2018,14/06/2018,0.00,,113.90,,"-501,142.83"
,IN,AR,30316826,1005,100,,Invoice,,,,,,14/06/2018,14/06/2018,0.00,,43.93,,"-501,186.76"
,IN,AR,30316827,1005,100,,Invoice,,,,,,14/06/2018,14/06/2018,0.00,,18.22,,"-501,204.98"
,IN,AR,30316829,1005,100,,Invoice,,,,,,14/06/2018,14/06/2018,0.00,,364.41,,"-501,569.39"
,IN,AR,30316860,1005,100,,Invoice,,,,,,14/06/2018,14/06/2018,0.00,,17.53,,"-501,586.92"
,IN,AR,30316862,1005,100,,Invoice,,,,,,14/06/2018,14/06/2018,0.00,,18.22,,"-501,605.14"
,IN,AR,30316864,1005,100,,Invoice,,,,,,14/06/2018,14/06/2018,0.00,,3.64,,"-501,608.78"
,IN,AR,30316865,1005,100,,Invoice,,,,,,14/06/2018,14/06/2018,0.00,,17.50,,"-501,626.28"
,IN,AR,30316869,1005,100,,Invoice,,,,,,14/06/2018,14/06/2018,0.00,,6.02,,"-501,632.30"
,IN,AR,30316874,1005,100,,Invoice,,,,,,14/06/2018,14/06/2018,0.00,,7.29,,"-501,639.59"
,IN,AR,30316877,1005,100,,Invoice,,,,,,14/06/2018,14/06/2018,0.00,,12.03,,"-501,651.62"
,IN,AR,30316890,1005,100,,Invoice,,,,,,14/06/2018,14/06/2018,0.00,,11.66,,"-501,663.28"
,IN,AR,30316892,1005,100,,Invoice,,,,,,14/06/2018,14/06/2018,0.00,,151.14,,"-501,814.42"
,IN,AR,30316900,1005,100,,Invoice,,,,,,14/06/2018,14/06/2018,0.00,,54.66,,"-501,869.08"
,IN,AR,30316901,1005,100,,Invoice,,,,,,14/06/2018,14/06/2018,0.00,,11.36,,"-501,880.44"
,IN,AR,30316904,1005,100,,Invoice,,,,,,14/06/2018,14/06/2018,0.00,,54.66,,"-501,935.10"
,IN,AR,30316907,1005,100,,Invoice,,,,,,14/06/2018,14/06/2018,0.00,,33.90,,"-501,969.00"
,IN,AR,30316912,1005,100,,Invoice,,,,,,14/06/2018,14/06/2018,0.00,,17.80,,"-501,986.80"
,IN,AR,30316913,1005,100,,Invoice,,,,,,14/06/2018,14/06/2018,0.00,,104.24,,"-502,091.04"
,IN,AR,30316917,1005,100,,Invoice,,,,,,14/06/2018,14/06/2018,0.00,,21.51,,"-502,112.55"
,IN,AR,30316922,1005,100,,Invoice,,,,,,14/06/2018,14/06/2018,0.00,,32.20,,"-502,144.75"
,IN,AR,30316938,1005,100,,Invoice,,,,,,14/06/2018,14/06/2018,0.00,,10.93,,"-502,155.68"
,IN,AR,30316943,1005,100,,Invoice,,,,,,14/06/2018,14/06/2018,0.00,,7.63,,"-502,163.31"
,IN,AR,30316947,1005,100,,Invoice,,,,,,14/06/2018,14/06/2018,0.00,,7.63,,"-502,170.94"
,IN,AR,30316948,1005,100,,Invoice,,,,,,14/06/2018,14/06/2018,0.00,,12.87,,"-502,183.81"
,IN,AR,30316949,1005,100,,Invoice,,,,,,14/06/2018,14/06/2018,0.00,,5.17,,"-502,188.98"
,IN,AR,30316953,1005,100,,Invoice,,,,,,14/06/2018,14/06/2018,0.00,,8.47,,"-502,197.45"
,IN,AR,30316964,1005,100,,Invoice,,,,,,14/06/2018,14/06/2018,0.00,,20.34,,"-502,217.79"
,IN,AR,30316967,1005,100,,Invoice,,,,,,14/06/2018,14/06/2018,0.00,,7.50,,"-502,225.29"
,IN,AR,30316970,1005,100,,Invoice,,,,,,14/06/2018,14/06/2018,0.00,,7.29,,"-502,232.58"
,IN,AR,30316977,1005,100,,Invoice,,,,,,14/06/2018,14/06/2018,0.00,,3.64,,"-502,236.22"
,IN,AR,30316981,1005,100,,Invoice,,,,,,14/06/2018,14/06/2018,0.00,,14.58,,"-502,250.80"
,IN,AR,30316984,1005,100,,Invoice,,,,,,14/06/2018,14/06/2018,0.00,,14.58,,"-502,265.38"
,IN,AR,30316985,1005,100,,Invoice,,,,,,14/06/2018,14/06/2018,0.00,,8.17,,"-502,273.55"
,IN,AR,30316987,1005,100,,Invoice,,,,,,14/06/2018,14/06/2018,0.00,,3.04,,"-502,276.59"
,IN,AR,30316988,1005,100,,Invoice,,,,,,14/06/2018,14/06/2018,0.00,,19.22,,"-502,295.81"
,IN,AR,30316994,1005,100,,Invoice,,,,,,14/06/2018,14/06/2018,0.00,,12.71,,"-502,308.52"
,IN,AR,30316996,1005,100,,Invoice,,,,,,14/06/2018,14/06/2018,0.00,,44.49,,"-502,353.01"
,IN,AR,30316999,1005,100,,Invoice,,,,,,14/06/2018,14/06/2018,0.00,,8.39,,"-502,361.40"
,IN,AR,30317005,1005,100,,Invoice,,,,,,14/06/2018,14/06/2018,0.00,,23.26,,"-502,384.66"
,IN,AR,30317016,1005,100,,Invoice,,,,,,14/06/2018,14/06/2018,0.00,,4.64,,"-502,389.30"
,IN,AR,30317018,1005,100,,Invoice,,,,,,14/06/2018,14/06/2018,0.00,,2.92,,"-502,392.22"
,IN,AR,30317020,1005,100,,Invoice,,,,,,14/06/2018,14/06/2018,0.00,,16.53,,"-502,408.75"
,IN,AR,30317027,1005,100,,Invoice,,,,,,14/06/2018,14/06/2018,0.00,,11.36,,"-502,420.11"
,IN,AR,30317034,1005,100,,Invoice,,,,,,14/06/2018,14/06/2018,0.00,,21.06,,"-502,441.17"
,IN,AR,30317036,1005,100,,Invoice,,,,,,14/06/2018,14/06/2018,0.00,,15.17,,"-502,456.34"
,IN,AR,30317038,1005,100,,Invoice,,,,,,14/06/2018,14/06/2018,0.00,,17.47,,"-502,473.81"
,IN,AR,30317040,1005,100,,Invoice,,,,,,14/06/2018,14/06/2018,0.00,,5.08,,"-502,478.89"
,IN,AR,30317043,1005,100,,Invoice,,,,,,14/06/2018,14/06/2018,0.00,,8.00,,"-502,486.89"
,IN,AR,30317053,1005,100,,Invoice,,,,,,14/06/2018,14/06/2018,0.00,,3.53,,"-502,490.42"
,IN,AR,30317061,1005,100,,Invoice,,,,,,14/06/2018,14/06/2018,0.00,,13.63,,"-502,504.05"
,IN,AR,30317066,1005,100,,Invoice,,,,,,14/06/2018,14/06/2018,0.00,,7.29,,"-502,511.34"
,IN,AR,30317081,1005,100,,Invoice,,,,,,14/06/2018,14/06/2018,0.00,,16.27,,"-502,527.61"
,IN,AR,30317082,1005,100,,Invoice,,,,,,14/06/2018,14/06/2018,0.00,,19.53,,"-502,547.14"
,IN,AR,30317083,1005,100,,Invoice,,,,,,14/06/2018,14/06/2018,0.00,,4.88,,"-502,552.02"
,IN,AR,30317084,1005,100,,Invoice,,,,,,14/06/2018,14/06/2018,0.00,,24.41,,"-502,576.43"
,IN,AR,30317086,1005,100,,Invoice,,,,,,14/06/2018,14/06/2018,0.00,,20.67,,"-502,597.10"
,IN,AR,30317087,1005,100,,Invoice,,,,,,14/06/2018,14/06/2018,0.00,,25.44,,"-502,622.54"
,IN,AR,30317096,1005,100,,Invoice,,,,,,14/06/2018,14/06/2018,0.00,,36.34,,"-502,658.88"
,IN,AR,30317099,1005,100,,Invoice,,,,,,14/06/2018,14/06/2018,0.00,,58.13,,"-502,717.01"
,IN,AR,30317104,1005,100,,Invoice,,,,,,14/06/2018,14/06/2018,0.00,,10.93,,"-502,727.94"
,IN,AR,30317117,1005,100,,Invoice,,,,,,14/06/2018,14/06/2018,0.00,,6.56,,"-502,734.50"
,IN,AR,30317122,1005,100,,Invoice,,,,,,14/06/2018,14/06/2018,0.00,,11.86,,"-502,746.36"
,IN,AR,30317126,1005,100,,Invoice,,,,,,14/06/2018,14/06/2018,0.00,,35.59,,"-502,781.95"
,IN,AR,30317127,1005,100,,Invoice,,,,,,14/06/2018,14/06/2018,0.00,,14.00,,"-502,795.95"
,IN,AR,30317131,1005,100,,Invoice,,,,,,14/06/2018,14/06/2018,0.00,,28.01,,"-502,823.96"
,IN,AR,30317138,1005,100,,Invoice,,,,,,14/06/2018,14/06/2018,0.00,,11.66,,"-502,835.62"
,IN,AR,30317139,1005,100,,Invoice,,,,,,14/06/2018,14/06/2018,0.00,,17.49,,"-502,853.11"
,IN,AR,30317140,1005,100,,Invoice,,,,,,14/06/2018,14/06/2018,0.00,,14.58,,"-502,867.69"
,IN,AR,30317148,1005,100,,Invoice,,,,,,14/06/2018,14/06/2018,0.00,,21.91,,"-502,889.60"
,IN,AR,30317149,1005,100,,Invoice,,,,,,14/06/2018,14/06/2018,0.00,,21.86,,"-502,911.46"
,IN,AR,30317150,1005,100,,Invoice,,,,,,14/06/2018,14/06/2018,0.00,,14.58,,"-502,926.04"
,IN,AR,30317152,1005,100,,Invoice,,,,,,14/06/2018,14/06/2018,0.00,,21.86,,"-502,947.90"
,IN,AR,30317159,1005,100,,Invoice,,,,,,14/06/2018,14/06/2018,0.00,,8.42,,"-502,956.32"
,IN,AR,30317161,1005,100,,Invoice,,,,,,14/06/2018,14/06/2018,0.00,,27.46,,"-502,983.78"
,IN,AR,30317162,1005,100,,Invoice,,,,,,14/06/2018,14/06/2018,0.00,,5.68,,"-502,989.46"
,IN,AR,30317169,1005,100,,Invoice,,,,,,14/06/2018,14/06/2018,0.00,,18.20,,"-503,007.66"
,IN,AR,30317177,1005,100,,Invoice,,,,,,14/06/2018,14/06/2018,0.00,,29.15,,"-503,036.81"
,IN,AR,30317179,1005,100,,Invoice,,,,,,14/06/2018,14/06/2018,0.00,,10.93,,"-503,047.74"
,IN,AR,30317181,1005,100,,Invoice,,,,,,14/06/2018,14/06/2018,0.00,,12.14,,"-503,059.88"
,IN,AR,30317182,1005,100,,Invoice,,,,,,14/06/2018,14/06/2018,0.00,,54.66,,"-503,114.54"
,IN,AR,30317189,1005,100,,Invoice,,,,,,14/06/2018,14/06/2018,0.00,,121.73,,"-503,236.27"
,IN,AR,30317194,1005,100,,Invoice,,,,,,14/06/2018,14/06/2018,0.00,,14.34,,"-503,250.61"
,IN,AR,30317195,1005,100,,Invoice,,,,,,14/06/2018,14/06/2018,0.00,,223.05,,"-503,473.66"
,IN,AR,30317196,1005,100,,Invoice,,,,,,14/06/2018,14/06/2018,0.00,,20.71,,"-503,494.37"
,IN,AR,30317197,1005,100,,Invoice,,,,,,14/06/2018,14/06/2018,0.00,,25.49,,"-503,519.86"
,IN,AR,30317198,1005,100,,Invoice,,,,,,14/06/2018,14/06/2018,0.00,,9.56,,"-503,529.42"
,IN,AR,30317203,1005,100,,Invoice,,,,,,14/06/2018,14/06/2018,0.00,,30.85,,"-503,560.27"
,IN,AR,30317204,1005,100,,Invoice,,,,,,14/06/2018,14/06/2018,0.00,,28.47,,"-503,588.74"
,IN,AR,30317206,1005,100,,Invoice,,,,,,14/06/2018,14/06/2018,0.00,,24.41,,"-503,613.15"
,IN,AR,30317207,1005,100,,Invoice,,,,,,14/06/2018,14/06/2018,0.00,,12.20,,"-503,625.35"
,IN,AR,30317214,1005,100,,Invoice,,,,,,14/06/2018,14/06/2018,0.00,,10.00,,"-503,635.35"
,IN,AR,30317216,1005,100,,Invoice,,,,,,14/06/2018,14/06/2018,0.00,,15.25,,"-503,650.60"
,IN,AR,30317236,1005,100,,Invoice,,,,,,14/06/2018,14/06/2018,0.00,,17.80,,"-503,668.40"
,IN,AR,30317242,1005,100,,Invoice,,,,,,14/06/2018,14/06/2018,0.00,,54.66,,"-503,723.06"
,IN,AR,30317244,1005,100,,Invoice,,,,,,14/06/2018,14/06/2018,0.00,,18.22,,"-503,741.28"
,IN,AR,30317250,1005,100,,Invoice,,,,,,14/06/2018,14/06/2018,0.00,,7.25,,"-503,748.53"
,IN,AR,30317270,1005,100,,Invoice,,,,,,14/06/2018,14/06/2018,0.00,,29.07,,"-503,777.60"
,IN,AR,30317271,1005,100,,Invoice,,,,,,14/06/2018,14/06/2018,0.00,,14.53,,"-503,792.13"
,IN,AR,30317272,1005,100,,Invoice,,,,,,14/06/2018,14/06/2018,0.00,,4.15,,"-503,796.28"
,IN,AR,30317273,1005,100,,Invoice,,,,,,14/06/2018,14/06/2018,0.00,,2.08,,"-503,798.36"
,IN,AR,30317274,1005,100,,Invoice,,,,,,14/06/2018,14/06/2018,0.00,,2.08,,"-503,800.44"
,IN,AR,30317298,1005,100,,Invoice,,,,,,14/06/2018,14/06/2018,0.00,,29.15,,"-503,829.59"
,CN,AR,31018173,1005,100,,Credit Note,,,,,,15/06/2018,15/06/2018,0.93,,0.00,,"-503,828.66"
,CN,AR,31018177,1005,100,,Credit Note,,,,,,15/06/2018,15/06/2018,0.93,,0.00,,"-503,827.73"
,CN,AR,31018178,1005,100,,Credit Note,,,,,,15/06/2018,15/06/2018,18.09,,0.00,,"-503,809.64"
,CN,AR,31018198,1005,100,,Credit Note,,,,,,15/06/2018,15/06/2018,29.15,,0.00,,"-503,780.49"
,CN,AR,31018199,1005,100,,Credit Note,,,,,,15/06/2018,15/06/2018,419.07,,0.00,,"-503,361.42"
,CN,AR,31018201,1005,100,,Credit Note,,,,,,15/06/2018,15/06/2018,419.07,,0.00,,"-502,942.35"
,CN,AR,31018205,1005,100,,Credit Note,,,,,,15/06/2018,15/06/2018,30.64,,0.00,,"-502,911.71"
,CN,AR,31018206,1005,100,,Credit Note,,,,,,15/06/2018,15/06/2018,30.64,,0.00,,"-502,881.07"
,CR,AR,33000164,1005,100,,Cash Return,,,,,,15/06/2018,15/06/2018,16.78,,0.00,,"-502,864.29"
,CS,AR,32004976,1005,100,,Cash sale,,,,,,15/06/2018,15/06/2018,0.00,,11.22,,"-502,875.51"
,CS,AR,32004978,1005,100,,Cash sale,,,,,,15/06/2018,15/06/2018,0.00,,16.61,,"-502,892.12"
,CS,AR,32004999,1005,100,,Cash sale,,,,,,15/06/2018,15/06/2018,0.00,,14.49,,"-502,906.61"
,CS,AR,32005008,1005,100,,Cash sale,,,,,,15/06/2018,15/06/2018,0.00,,14.53,,"-502,921.14"
,CS,AR,32005023,1005,100,,Cash sale,,,,,,15/06/2018,15/06/2018,0.00,,3.64,,"-502,924.78"
,CS,AR,32005024,1005,100,,Cash sale,,,,,,15/06/2018,15/06/2018,0.00,,16.78,,"-502,941.56"
,CS,AR,32005025,1005,100,,Cash sale,,,,,,15/06/2018,15/06/2018,0.00,,182.20,,"-503,123.76"
,CS,AR,32005028,1005,100,,Cash sale,,,,,,15/06/2018,15/06/2018,0.00,,7.29,,"-503,131.05"
,CS,AR,32005030,1005,100,,Cash sale,,,,,,15/06/2018,15/06/2018,0.00,,10.93,,"-503,141.98"
,CS,AR,32005034,1005,100,,Cash sale,,,,,,15/06/2018,15/06/2018,0.00,,14.58,,"-503,156.56"
,CS,AR,32005044,1005,100,,Cash sale,,,,,,15/06/2018,15/06/2018,0.00,,21.86,,"-503,178.42"
,CS,AR,32005045,1005,100,,Cash sale,,,,,,15/06/2018,15/06/2018,0.00,,5.17,,"-503,183.59"
,CS,AR,32005048,1005,100,,Cash sale,,,,,,15/06/2018,15/06/2018,0.00,,15.25,,"-503,198.84"
,CS,AR,32005051,1005,100,,Cash sale,,,,,,15/06/2018,15/06/2018,0.00,,3.64,,"-503,202.48"
,CS,AR,32005053,1005,100,,Cash sale,,,,,,15/06/2018,15/06/2018,0.00,,46.71,,"-503,249.19"
,CS,AR,32005055,1005,100,,Cash sale,,,,,,15/06/2018,15/06/2018,0.00,,13.74,,"-503,262.93"
,CS,AR,32005058,1005,100,,Cash sale,,,,,,15/06/2018,15/06/2018,0.00,,7.29,,"-503,270.22"
,CS,AR,32005060,1005,100,,Cash sale,,,,,,15/06/2018,15/06/2018,0.00,,3.01,,"-503,273.23"
,CS,AR,32005062,1005,100,,Cash sale,,,,,,15/06/2018,15/06/2018,0.00,,10.93,,"-503,284.16"
,CS,AR,32005068,1005,100,,Cash sale,,,,,,15/06/2018,15/06/2018,0.00,,10.17,,"-503,294.33"
,CS,AR,32005071,1005,100,,Cash sale,,,,,,15/06/2018,15/06/2018,0.00,,23.39,,"-503,317.72"
,CS,AR,32005075,1005,100,,Cash sale,,,,,,15/06/2018,15/06/2018,0.00,,20.68,,"-503,338.40"
,CS,AR,32005077,1005,100,,Cash sale,,,,,,15/06/2018,15/06/2018,0.00,,15.04,,"-503,353.44"
,CS,AR,32005084,1005,100,,Cash sale,,,,,,15/06/2018,15/06/2018,0.00,,12.71,,"-503,366.15"
,CS,AR,32005093,1005,100,,Cash sale,,,,,,15/06/2018,15/06/2018,0.00,,3.64,,"-503,369.79"
,CS,AR,32005097,1005,100,,Cash sale,,,,,,15/06/2018,15/06/2018,0.00,,22.88,,"-503,392.67"
,CS,AR,32005118,1005,100,,Cash sale,,,,,,15/06/2018,15/06/2018,0.00,,18.22,,"-503,410.89"
,CS,AR,32005124,1005,100,,Cash sale,,,,,,15/06/2018,15/06/2018,0.00,,10.93,,"-503,421.82"
,CS,AR,32005126,1005,100,,Cash sale,,,,,,15/06/2018,15/06/2018,0.00,,10.93,,"-503,432.75"
,CS,AR,32005131,1005,100,,Cash sale,,,,,,15/06/2018,15/06/2018,0.00,,9.03,,"-503,441.78"
,CS,AR,32005134,1005,100,,Cash sale,,,,,,15/06/2018,15/06/2018,0.00,,7.29,,"-503,449.07"
,CS,AR,32005135,1005,100,,Cash sale,,,,,,15/06/2018,15/06/2018,0.00,,15.21,,"-503,464.28"
,CS,AR,32005137,1005,100,,Cash sale,,,,,,15/06/2018,15/06/2018,0.00,,5.56,,"-503,469.84"
,CS,AR,32005150,1005,100,,Cash sale,,,,,,15/06/2018,15/06/2018,0.00,,20.95,,"-503,490.79"
,CS,AR,32005152,1005,100,,Cash sale,,,,,,15/06/2018,15/06/2018,0.00,,15.25,,"-503,506.04"
,CS,AR,32005153,1005,100,,Cash sale,,,,,,15/06/2018,15/06/2018,0.00,,9.03,,"-503,515.07"
,CS,AR,32005155,1005,100,,Cash sale,,,,,,15/06/2018,15/06/2018,0.00,,4.08,,"-503,519.15"
,CS,AR,32005160,1005,100,,Cash sale,,,,,,15/06/2018,15/06/2018,0.00,,32.00,,"-503,551.15"
,CS,AR,32005161,1005,100,,Cash sale,,,,,,15/06/2018,15/06/2018,0.00,,7.29,,"-503,558.44"
,CS,AR,32005162,1005,100,,Cash sale,,,,,,15/06/2018,15/06/2018,0.00,,7.29,,"-503,565.73"
,CS,AR,32005166,1005,100,,Cash sale,,,,,,15/06/2018,15/06/2018,0.00,,9.84,,"-503,575.57"
,CS,AR,32005168,1005,100,,Cash sale,,,,,,15/06/2018,15/06/2018,0.00,,2.54,,"-503,578.11"
,CS,AR,32005174,1005,100,,Cash sale,,,,,,15/06/2018,15/06/2018,0.00,,9.15,,"-503,587.26"
,CS,AR,32005175,1005,100,,Cash sale,,,,,,15/06/2018,15/06/2018,0.00,,10.93,,"-503,598.19"
,CS,AR,32005179,1005,100,,Cash sale,,,,,,15/06/2018,15/06/2018,0.00,,9.10,,"-503,607.29"
,CS,AR,32005181,1005,100,,Cash sale,,,,,,15/06/2018,15/06/2018,0.00,,7.63,,"-503,614.92"
,CS,AR,32005184,1005,100,,Cash sale,,,,,,15/06/2018,15/06/2018,0.00,,14.58,,"-503,629.50"
,CS,AR,32005189,1005,100,,Cash sale,,,,,,15/06/2018,15/06/2018,0.00,,24.29,,"-503,653.79"
,CS,AR,32005194,1005,100,,Cash sale,,,,,,15/06/2018,15/06/2018,0.00,,12.71,,"-503,666.50"
,CS,AR,32005195,1005,100,,Cash sale,,,,,,15/06/2018,15/06/2018,0.00,,10.34,,"-503,676.84"
,CS,AR,32005199,1005,100,,Cash sale,,,,,,15/06/2018,15/06/2018,0.00,,14.58,,"-503,691.42"
,CS,AR,32005200,1005,100,,Cash sale,,,,,,15/06/2018,15/06/2018,0.00,,3.64,,"-503,695.06"
,CS,AR,32005202,1005,100,,Cash sale,,,,,,15/06/2018,15/06/2018,0.00,,3.05,,"-503,698.11"
,CS,AR,32005204,1005,100,,Cash sale,,,,,,15/06/2018,15/06/2018,0.00,,6.23,,"-503,704.34"
,CS,AR,32005207,1005,100,,Cash sale,,,,,,15/06/2018,15/06/2018,0.00,,18.22,,"-503,722.56"
,CS,AR,32005213,1005,100,,Cash sale,,,,,,15/06/2018,15/06/2018,0.00,,14.58,,"-503,737.14"
,CS,AR,32005234,1005,100,,Cash sale,,,,,,15/06/2018,15/06/2018,0.00,,9.11,,"-503,746.25"
,CS,AR,32005235,1005,100,,Cash sale,,,,,,15/06/2018,15/06/2018,0.00,,7.29,,"-503,753.54"
,CS,AR,32005237,1005,100,,Cash sale,,,,,,15/06/2018,15/06/2018,0.00,,7.29,,"-503,760.83"
,CS,AR,32005239,1005,100,,Cash sale,,,,,,15/06/2018,15/06/2018,0.00,,3.64,,"-503,764.47"
,CS,AR,32005240,1005,100,,Cash sale,,,,,,15/06/2018,15/06/2018,0.00,,7.29,,"-503,771.76"
,CS,AR,32005247,1005,100,,Cash sale,,,,,,15/06/2018,15/06/2018,0.00,,13.98,,"-503,785.74"
,CS,AR,32005248,1005,100,,Cash sale,,,,,,15/06/2018,15/06/2018,0.00,,7.29,,"-503,793.03"
,IN,AR,30316726,1005,100,,Invoice,,,,,,15/06/2018,15/06/2018,0.00,,103.81,,"-503,896.84"
,IN,AR,30316727,1005,100,,Invoice,,,,,,15/06/2018,15/06/2018,0.00,,5.93,,"-503,902.77"
,IN,AR,30316729,1005,100,,Invoice,,,,,,15/06/2018,15/06/2018,0.00,,29.15,,"-503,931.92"
,IN,AR,30316735,1005,100,,Invoice,,,,,,15/06/2018,15/06/2018,0.00,,19.58,,"-503,951.50"
,IN,AR,30316752,1005,100,,Invoice,,,,,,15/06/2018,15/06/2018,0.00,,29.15,,"-503,980.65"
,IN,AR,30316762,1005,100,,Invoice,,,,,,15/06/2018,15/06/2018,0.00,,4.83,,"-503,985.48"
,IN,AR,30316771,1005,100,,Invoice,,,,,,15/06/2018,15/06/2018,0.00,,7.29,,"-503,992.77"
,IN,AR,30316774,1005,100,,Invoice,,,,,,15/06/2018,15/06/2018,0.00,,87.46,,"-504,080.23"
,IN,AR,30316775,1005,100,,Invoice,,,,,,15/06/2018,15/06/2018,0.00,,32.15,,"-504,112.38"
,IN,AR,30316777,1005,100,,Invoice,,,,,,15/06/2018,15/06/2018,0.00,,65.98,,"-504,178.36"
,IN,AR,30316785,1005,100,,Invoice,,,,,,15/06/2018,15/06/2018,0.00,,56.95,,"-504,235.31"
,IN,AR,30316788,1005,100,,Invoice,,,,,,15/06/2018,15/06/2018,0.00,,13.77,,"-504,249.08"
,IN,AR,30316802,1005,100,,Invoice,,,,,,15/06/2018,15/06/2018,0.00,,25.51,,"-504,274.59"
,IN,AR,30316806,1005,100,,Invoice,,,,,,15/06/2018,15/06/2018,0.00,,26.00,,"-504,300.59"
,IN,AR,30316809,1005,100,,Invoice,,,,,,15/06/2018,15/06/2018,0.00,,10.93,,"-504,311.52"
,IN,AR,30316816,1005,100,,Invoice,,,,,,15/06/2018,15/06/2018,0.00,,9.73,,"-504,321.25"
,IN,AR,30316819,1005,100,,Invoice,,,,,,15/06/2018,15/06/2018,0.00,,4.75,,"-504,326.00"
,IN,AR,30316822,1005,100,,Invoice,,,,,,15/06/2018,15/06/2018,0.00,,6.00,,"-504,332.00"
,IN,AR,30316830,1005,100,,Invoice,,,,,,15/06/2018,15/06/2018,0.00,,39.75,,"-504,371.75"
,IN,AR,30316835,1005,100,,Invoice,,,,,,15/06/2018,15/06/2018,0.00,,7.76,,"-504,379.51"
,IN,AR,30316837,1005,100,,Invoice,,,,,,15/06/2018,15/06/2018,0.00,,8.39,,"-504,387.90"
,IN,AR,30316840,1005,100,,Invoice,,,,,,15/06/2018,15/06/2018,0.00,,38.00,,"-504,425.90"
,IN,AR,30316844,1005,100,,Invoice,,,,,,15/06/2018,15/06/2018,0.00,,32.80,,"-504,458.70"
,IN,AR,30316845,1005,100,,Invoice,,,,,,15/06/2018,15/06/2018,0.00,,13.98,,"-504,472.68"
,IN,AR,30316847,1005,100,,Invoice,,,,,,15/06/2018,15/06/2018,0.00,,23.29,,"-504,495.97"
,IN,AR,30316848,1005,100,,Invoice,,,,,,15/06/2018,15/06/2018,0.00,,6.02,,"-504,501.99"
,IN,AR,30316861,1005,100,,Invoice,,,,,,15/06/2018,15/06/2018,0.00,,6.37,,"-504,508.36"
,IN,AR,30316866,1005,100,,Invoice,,,,,,15/06/2018,15/06/2018,0.00,,5.17,,"-504,513.53"
,IN,AR,30316871,1005,100,,Invoice,,,,,,15/06/2018,15/06/2018,0.00,,7.19,,"-504,520.72"
,IN,AR,30316889,1005,100,,Invoice,,,,,,15/06/2018,15/06/2018,0.00,,31.02,,"-504,551.74"
,IN,AR,30316891,1005,100,,Invoice,,,,,,15/06/2018,15/06/2018,0.00,,2.39,,"-504,554.13"
,IN,AR,30316903,1005,100,,Invoice,,,,,,15/06/2018,15/06/2018,0.00,,3.01,,"-504,557.14"
,IN,AR,30316910,1005,100,,Invoice,,,,,,15/06/2018,15/06/2018,0.00,,65.63,,"-504,622.77"
,IN,AR,30316918,1005,100,,Invoice,,,,,,15/06/2018,15/06/2018,0.00,,14.34,,"-504,637.11"
,IN,AR,30316925,1005,100,,Invoice,,,,,,15/06/2018,15/06/2018,0.00,,7.29,,"-504,644.40"
,IN,AR,30316933,1005,100,,Invoice,,,,,,15/06/2018,15/06/2018,0.00,,30.63,,"-504,675.03"
,IN,AR,30316934,1005,100,,Invoice,,,,,,15/06/2018,15/06/2018,0.00,,30.63,,"-504,705.66"
,IN,AR,30316935,1005,100,,Invoice,,,,,,15/06/2018,15/06/2018,0.00,,6.02,,"-504,711.68"
,IN,AR,30316940,1005,100,,Invoice,,,,,,15/06/2018,15/06/2018,0.00,,7.17,,"-504,718.85"
,IN,AR,30316944,1005,100,,Invoice,,,,,,15/06/2018,15/06/2018,0.00,,10.17,,"-504,729.02"
,IN,AR,30316945,1005,100,,Invoice,,,,,,15/06/2018,15/06/2018,0.00,,7.63,,"-504,736.65"
,IN,AR,30316946,1005,100,,Invoice,,,,,,15/06/2018,15/06/2018,0.00,,15.25,,"-504,751.90"
,IN,AR,30316951,1005,100,,Invoice,,,,,,15/06/2018,15/06/2018,0.00,,20.34,,"-504,772.24"
,IN,AR,30316954,1005,100,,Invoice,,,,,,15/06/2018,15/06/2018,0.00,,10.59,,"-504,782.83"
,IN,AR,30316958,1005,100,,Invoice,,,,,,15/06/2018,15/06/2018,0.00,,7.29,,"-504,790.12"
,IN,AR,30316959,1005,100,,Invoice,,,,,,15/06/2018,15/06/2018,0.00,,10.34,,"-504,800.46"
,IN,AR,30316962,1005,100,,Invoice,,,,,,15/06/2018,15/06/2018,0.00,,10.93,,"-504,811.39"
,IN,AR,30316980,1005,100,,Invoice,,,,,,15/06/2018,15/06/2018,0.00,,14.83,,"-504,826.22"
,IN,AR,30316991,1005,100,,Invoice,,,,,,15/06/2018,15/06/2018,0.00,,14.03,,"-504,840.25"
,IN,AR,30316992,1005,100,,Invoice,,,,,,15/06/2018,15/06/2018,0.00,,3.64,,"-504,843.89"
,IN,AR,30317003,1005,100,,Invoice,,,,,,15/06/2018,15/06/2018,0.00,,4.24,,"-504,848.13"
,IN,AR,30317007,1005,100,,Invoice,,,,,,15/06/2018,15/06/2018,0.00,,63.46,,"-504,911.59"
,IN,AR,30317025,1005,100,,Invoice,,,,,,15/06/2018,15/06/2018,0.00,,7.75,,"-504,919.34"
,IN,AR,30317047,1005,100,,Invoice,,,,,,15/06/2018,15/06/2018,0.00,,42.88,,"-504,962.22"
,IN,AR,30317054,1005,100,,Invoice,,,,,,15/06/2018,15/06/2018,0.00,,10.57,,"-504,972.79"
,IN,AR,30317056,1005,100,,Invoice,,,,,,15/06/2018,15/06/2018,0.00,,3.64,,"-504,976.43"
,IN,AR,30317060,1005,100,,Invoice,,,,,,15/06/2018,15/06/2018,0.00,,7.27,,"-504,983.70"
,IN,AR,30317062,1005,100,,Invoice,,,,,,15/06/2018,15/06/2018,0.00,,5.49,,"-504,989.19"
,IN,AR,30317065,1005,100,,Invoice,,,,,,15/06/2018,15/06/2018,0.00,,10.93,,"-505,000.12"
,IN,AR,30317078,1005,100,,Invoice,,,,,,15/06/2018,15/06/2018,0.00,,3.64,,"-505,003.76"
,IN,AR,30317090,1005,100,,Invoice,,,,,,15/06/2018,15/06/2018,0.00,,28.39,,"-505,032.15"
,IN,AR,30317093,1005,100,,Invoice,,,,,,15/06/2018,15/06/2018,0.00,,34.04,,"-505,066.19"
,IN,AR,30317100,1005,100,,Invoice,,,,,,15/06/2018,15/06/2018,0.00,,8.21,,"-505,074.40"
,IN,AR,30317103,1005,100,,Invoice,,,,,,15/06/2018,15/06/2018,0.00,,12.14,,"-505,086.54"
,IN,AR,30317105,1005,100,,Invoice,,,,,,15/06/2018,15/06/2018,0.00,,43.22,,"-505,129.76"
,IN,AR,30317111,1005,100,,Invoice,,,,,,15/06/2018,15/06/2018,0.00,,28.03,,"-505,157.79"
,IN,AR,30317112,1005,100,,Invoice,,,,,,15/06/2018,15/06/2018,0.00,,14.58,,"-505,172.37"
,IN,AR,30317114,1005,100,,Invoice,,,,,,15/06/2018,15/06/2018,0.00,,42.03,,"-505,214.40"
,IN,AR,30317121,1005,100,,Invoice,,,,,,15/06/2018,15/06/2018,0.00,,19.13,,"-505,233.53"
,IN,AR,30317129,1005,100,,Invoice,,,,,,15/06/2018,15/06/2018,0.00,,8.00,,"-505,241.53"
,IN,AR,30317133,1005,100,,Invoice,,,,,,15/06/2018,15/06/2018,0.00,,22.01,,"-505,263.54"
,IN,AR,30317135,1005,100,,Invoice,,,,,,15/06/2018,15/06/2018,0.00,,8.00,,"-505,271.54"
,IN,AR,30317144,1005,100,,Invoice,,,,,,15/06/2018,15/06/2018,0.00,,32.85,,"-505,304.39"
,IN,AR,30317147,1005,100,,Invoice,,,,,,15/06/2018,15/06/2018,0.00,,65.18,,"-505,369.57"
,IN,AR,30317160,1005,100,,Invoice,,,,,,15/06/2018,15/06/2018,0.00,,11.48,,"-505,381.05"
,IN,AR,30317184,1005,100,,Invoice,,,,,,15/06/2018,15/06/2018,0.00,,17.03,,"-505,398.08"
,IN,AR,30317185,1005,100,,Invoice,,,,,,15/06/2018,15/06/2018,0.00,,9.66,,"-505,407.74"
,IN,AR,30317210,1005,100,,Invoice,,,,,,15/06/2018,15/06/2018,0.00,,8.00,,"-505,415.74"
,IN,AR,30317217,1005,100,,Invoice,,,,,,15/06/2018,15/06/2018,0.00,,8.52,,"-505,424.26"
,IN,AR,30317222,1005,100,,Invoice,,,,,,15/06/2018,15/06/2018,0.00,,3.64,,"-505,427.90"
,IN,AR,30317223,1005,100,,Invoice,,,,,,15/06/2018,15/06/2018,0.00,,5.83,,"-505,433.73"
,IN,AR,30317226,1005,100,,Invoice,,,,,,15/06/2018,15/06/2018,0.00,,5.47,,"-505,439.20"
,IN,AR,30317227,1005,100,,Invoice,,,,,,15/06/2018,15/06/2018,0.00,,55.08,,"-505,494.28"
,IN,AR,30317232,1005,100,,Invoice,,,,,,15/06/2018,15/06/2018,0.00,,121.69,,"-505,615.97"
,IN,AR,30317233,1005,100,,Invoice,,,,,,15/06/2018,15/06/2018,0.00,,47.37,,"-505,663.34"
,IN,AR,30317234,1005,100,,Invoice,,,,,,15/06/2018,15/06/2018,0.00,,10.93,,"-505,674.27"
,IN,AR,30317239,1005,100,,Invoice,,,,,,15/06/2018,15/06/2018,0.00,,8.17,,"-505,682.44"
,IN,AR,30317280,1005,100,,Invoice,,,,,,15/06/2018,15/06/2018,0.00,,45.51,,"-505,727.95"
,IN,AR,30317287,1005,100,,Invoice,,,,,,15/06/2018,15/06/2018,0.00,,21.86,,"-505,749.81"
,IN,AR,30317299,1005,100,,Invoice,,,,,,15/06/2018,15/06/2018,0.00,,29.15,,"-505,778.96"
,IN,AR,30317300,1005,100,,Invoice,,,,,,15/06/2018,15/06/2018,0.00,,29.15,,"-505,808.11"
,CN,AR,31018166,1005,100,,Credit Note,,,,,,16/06/2018,16/06/2018,18.31,,0.00,,"-505,789.80"
,CS,AR,32005012,1005,100,,Cash sale,,,,,,16/06/2018,16/06/2018,0.00,,7.29,,"-505,797.09"
,CS,AR,32005017,1005,100,,Cash sale,,,,,,16/06/2018,16/06/2018,0.00,,14.58,,"-505,811.67"
,CS,AR,32005086,1005,100,,Cash sale,,,,,,16/06/2018,16/06/2018,0.00,,7.29,,"-505,818.96"
,CS,AR,32005185,1005,100,,Cash sale,,,,,,16/06/2018,16/06/2018,0.00,,17.80,,"-505,836.76"
,CS,AR,32005224,1005,100,,Cash sale,,,,,,16/06/2018,16/06/2018,0.00,,7.29,,"-505,844.05"
,CS,AR,32005236,1005,100,,Cash sale,,,,,,16/06/2018,16/06/2018,0.00,,7.29,,"-505,851.34"
,IN,AR,30316814,1005,100,,Invoice,,,,,,16/06/2018,16/06/2018,0.00,,36.44,,"-505,887.78"
,IN,AR,30316838,1005,100,,Invoice,,,,,,16/06/2018,16/06/2018,0.00,,10.93,,"-505,898.71"
,IN,AR,30316919,1005,100,,Invoice,,,,,,16/06/2018,16/06/2018,0.00,,2.58,,"-505,901.29"
,CN,AR,31018273,1005,100,,Credit Note,,,,,,18/06/2018,18/06/2018,19.92,,0.00,,"-505,881.37"
,CS,AR,32005261,1005,100,,Cash sale,,,,,,18/06/2018,18/06/2018,0.00,,14.03,,"-505,895.40"
,CS,AR,32005273,1005,100,,Cash sale,,,,,,18/06/2018,18/06/2018,0.00,,16.61,,"-505,912.01"
,CS,AR,32005280,1005,100,,Cash sale,,,,,,18/06/2018,18/06/2018,0.00,,10.93,,"-505,922.94"
,CS,AR,32005284,1005,100,,Cash sale,,,,,,18/06/2018,18/06/2018,0.00,,10.93,,"-505,933.87"
,CS,AR,32005301,1005,100,,Cash sale,,,,,,18/06/2018,18/06/2018,0.00,,3.64,,"-505,937.51"
,CS,AR,32005324,1005,100,,Cash sale,,,,,,18/06/2018,18/06/2018,0.00,,7.29,,"-505,944.80"
,CS,AR,32005327,1005,100,,Cash sale,,,,,,18/06/2018,18/06/2018,0.00,,14.53,,"-505,959.33"
,CS,AR,32005332,1005,100,,Cash sale,,,,,,18/06/2018,18/06/2018,0.00,,14.58,,"-505,973.91"
,CS,AR,32005335,1005,100,,Cash sale,,,,,,18/06/2018,18/06/2018,0.00,,7.29,,"-505,981.20"
,CS,AR,32005350,1005,100,,Cash sale,,,,,,18/06/2018,18/06/2018,0.00,,7.29,,"-505,988.49"
,CS,AR,32005365,1005,100,,Cash sale,,,,,,18/06/2018,18/06/2018,0.00,,3.64,,"-505,992.13"
,CS,AR,32005367,1005,100,,Cash sale,,,,,,18/06/2018,18/06/2018,0.00,,7.29,,"-505,999.42"
,CS,AR,32005380,1005,100,,Cash sale,,,,,,18/06/2018,18/06/2018,0.00,,7.17,,"-506,006.59"
,CS,AR,32005386,1005,100,,Cash sale,,,,,,18/06/2018,18/06/2018,0.00,,7.29,,"-506,013.88"
,CS,AR,32005388,1005,100,,Cash sale,,,,,,18/06/2018,18/06/2018,0.00,,10.93,,"-506,024.81"
,CS,AR,32005413,1005,100,,Cash sale,,,,,,18/06/2018,18/06/2018,0.00,,7.29,,"-506,032.10"
,CS,AR,32005439,1005,100,,Cash sale,,,,,,18/06/2018,18/06/2018,0.00,,11.69,,"-506,043.79"
,CS,AR,32005448,1005,100,,Cash sale,,,,,,18/06/2018,18/06/2018,0.00,,24.07,,"-506,067.86"
,CS,AR,32005449,1005,100,,Cash sale,,,,,,18/06/2018,18/06/2018,0.00,,36.10,,"-506,103.96"
,CS,AR,32005461,1005,100,,Cash sale,,,,,,18/06/2018,18/06/2018,0.00,,14.58,,"-506,118.54"
,CS,AR,32005474,1005,100,,Cash sale,,,,,,18/06/2018,18/06/2018,0.00,,2.58,,"-506,121.12"
,CS,AR,32005480,1005,100,,Cash sale,,,,,,18/06/2018,18/06/2018,0.00,,2.54,,"-506,123.66"
,CS,AR,32005482,1005,100,,Cash sale,,,,,,18/06/2018,18/06/2018,0.00,,3.64,,"-506,127.30"
,CS,AR,32005486,1005,100,,Cash sale,,,,,,18/06/2018,18/06/2018,0.00,,7.29,,"-506,134.59"
,CS,AR,32005494,1005,100,,Cash sale,,,,,,18/06/2018,18/06/2018,0.00,,29.15,,"-506,163.74"
,CS,AR,32005516,1005,100,,Cash sale,,,,,,18/06/2018,18/06/2018,0.00,,7.29,,"-506,171.03"
,CS,AR,32005524,1005,100,,Cash sale,,,,,,18/06/2018,18/06/2018,0.00,,11.11,,"-506,182.14"
,CS,AR,32005533,1005,100,,Cash sale,,,,,,18/06/2018,18/06/2018,0.00,,12.17,,"-506,194.31"
,CS,AR,32005564,1005,100,,Cash sale,,,,,,18/06/2018,18/06/2018,0.00,,12.71,,"-506,207.02"
,CS,AR,32005570,1005,100,,Cash sale,,,,,,18/06/2018,18/06/2018,0.00,,6.53,,"-506,213.55"
,CS,AR,32005572,1005,100,,Cash sale,,,,,,18/06/2018,18/06/2018,0.00,,2.58,,"-506,216.13"
,CS,AR,32005593,1005,100,,Cash sale,,,,,,18/06/2018,18/06/2018,0.00,,15.25,,"-506,231.38"
,CS,AR,32005603,1005,100,,Cash sale,,,,,,18/06/2018,18/06/2018,0.00,,12.14,,"-506,243.52"
,CS,AR,32005605,1005,100,,Cash sale,,,,,,18/06/2018,18/06/2018,0.00,,3.28,,"-506,246.80"
,CS,AR,32005609,1005,100,,Cash sale,,,,,,18/06/2018,18/06/2018,0.00,,6.56,,"-506,253.36"
,CS,AR,32005612,1005,100,,Cash sale,,,,,,18/06/2018,18/06/2018,0.00,,11.44,,"-506,264.80"
,CS,AR,32005623,1005,100,,Cash sale,,,,,,18/06/2018,18/06/2018,0.00,,25.51,,"-506,290.31"
,CS,AR,32005627,1005,100,,Cash sale,,,,,,18/06/2018,18/06/2018,0.00,,3.03,,"-506,293.34"
,CS,AR,32005640,1005,100,,Cash sale,,,,,,18/06/2018,18/06/2018,0.00,,5.47,,"-506,298.81"
,CS,AR,32005650,1005,100,,Cash sale,,,,,,18/06/2018,18/06/2018,0.00,,21.86,,"-506,320.67"
,CS,AR,32005666,1005,100,,Cash sale,,,,,,18/06/2018,18/06/2018,0.00,,25.51,,"-506,346.18"
,CS,AR,32005680,1005,100,,Cash sale,,,,,,18/06/2018,18/06/2018,0.00,,3.64,,"-506,349.82"
,CS,AR,32005701,1005,100,,Cash sale,,,,,,18/06/2018,18/06/2018,0.00,,7.29,,"-506,357.11"
,CS,AR,32005706,1005,100,,Cash sale,,,,,,18/06/2018,18/06/2018,0.00,,12.14,,"-506,369.25"
,CS,AR,32005712,1005,100,,Cash sale,,,,,,18/06/2018,18/06/2018,0.00,,3.64,,"-506,372.89"
,CS,AR,32005715,1005,100,,Cash sale,,,,,,18/06/2018,18/06/2018,0.00,,5.94,,"-506,378.83"
,CS,AR,32005745,1005,100,,Cash sale,,,,,,18/06/2018,18/06/2018,0.00,,3.64,,"-506,382.47"
,CS,AR,32005751,1005,100,,Cash sale,,,,,,18/06/2018,18/06/2018,0.00,,7.29,,"-506,389.76"
,IN,AR,30317306,1005,100,,Invoice,,,,,,18/06/2018,18/06/2018,0.00,,26.69,,"-506,416.45"
,IN,AR,30317319,1005,100,,Invoice,,,,,,18/06/2018,18/06/2018,0.00,,7.29,,"-506,423.74"
,IN,AR,30317335,1005,100,,Invoice,,,,,,18/06/2018,18/06/2018,0.00,,4.05,,"-506,427.79"
,IN,AR,30317336,1005,100,,Invoice,,,,,,18/06/2018,18/06/2018,0.00,,4.05,,"-506,431.84"
,IN,AR,30317337,1005,100,,Invoice,,,,,,18/06/2018,18/06/2018,0.00,,8.10,,"-506,439.94"
,IN,AR,30317338,1005,100,,Invoice,,,,,,18/06/2018,18/06/2018,0.00,,8.10,,"-506,448.04"
,IN,AR,30317339,1005,100,,Invoice,,,,,,18/06/2018,18/06/2018,0.00,,12.15,,"-506,460.19"
,IN,AR,30317340,1005,100,,Invoice,,,,,,18/06/2018,18/06/2018,0.00,,18.23,,"-506,478.42"
,IN,AR,30317341,1005,100,,Invoice,,,,,,18/06/2018,18/06/2018,0.00,,4.05,,"-506,482.47"
,IN,AR,30317342,1005,100,,Invoice,,,,,,18/06/2018,18/06/2018,0.00,,14.18,,"-506,496.65"
,IN,AR,30317387,1005,100,,Invoice,,,,,,18/06/2018,18/06/2018,0.00,,84.54,,"-506,581.19"
,IN,AR,30317402,1005,100,,Invoice,,,,,,18/06/2018,18/06/2018,0.00,,10.93,,"-506,592.12"
,IN,AR,30317406,1005,100,,Invoice,,,,,,18/06/2018,18/06/2018,0.00,,158.98,,"-506,751.10"
,IN,AR,30317417,1005,100,,Invoice,,,,,,18/06/2018,18/06/2018,0.00,,11.02,,"-506,762.12"
,IN,AR,30317418,1005,100,,Invoice,,,,,,18/06/2018,18/06/2018,0.00,,5.51,,"-506,767.63"
,IN,AR,30317427,1005,100,,Invoice,,,,,,18/06/2018,18/06/2018,0.00,,42.00,,"-506,809.63"
,IN,AR,30317438,1005,100,,Invoice,,,,,,18/06/2018,18/06/2018,0.00,,65.75,,"-506,875.38"
,IN,AR,30317447,1005,100,,Invoice,,,,,,18/06/2018,18/06/2018,0.00,,7.29,,"-506,882.67"
,IN,AR,30317449,1005,100,,Invoice,,,,,,18/06/2018,18/06/2018,0.00,,60.00,,"-506,942.67"
,IN,AR,30317450,1005,100,,Invoice,,,,,,18/06/2018,18/06/2018,0.00,,20.00,,"-506,962.67"
,IN,AR,30317459,1005,100,,Invoice,,,,,,18/06/2018,18/06/2018,0.00,,2.75,,"-506,965.42"
,IN,AR,30317461,1005,100,,Invoice,,,,,,18/06/2018,18/06/2018,0.00,,30.51,,"-506,995.93"
,IN,AR,30317463,1005,100,,Invoice,,,,,,18/06/2018,18/06/2018,0.00,,5.51,,"-507,001.44"
,IN,AR,30317469,1005,100,,Invoice,,,,,,18/06/2018,18/06/2018,0.00,,7.29,,"-507,008.73"
,IN,AR,30317473,1005,100,,Invoice,,,,,,18/06/2018,18/06/2018,0.00,,5.84,,"-507,014.57"
,IN,AR,30317479,1005,100,,Invoice,,,,,,18/06/2018,18/06/2018,0.00,,11.69,,"-507,026.26"
,IN,AR,30317487,1005,100,,Invoice,,,,,,18/06/2018,18/06/2018,0.00,,20.00,,"-507,046.26"
,IN,AR,30317491,1005,100,,Invoice,,,,,,18/06/2018,18/06/2018,0.00,,7.29,,"-507,053.55"
,IN,AR,30317514,1005,100,,Invoice,,,,,,18/06/2018,18/06/2018,0.00,,34.00,,"-507,087.55"
,IN,AR,30317529,1005,100,,Invoice,,,,,,18/06/2018,18/06/2018,0.00,,19.32,,"-507,106.87"
,IN,AR,30317535,1005,100,,Invoice,,,,,,18/06/2018,18/06/2018,0.00,,25.55,,"-507,132.42"
,IN,AR,30317545,1005,100,,Invoice,,,,,,18/06/2018,18/06/2018,0.00,,15.51,,"-507,147.93"
,IN,AR,30317555,1005,100,,Invoice,,,,,,18/06/2018,18/06/2018,0.00,,10.34,,"-507,158.27"
,IN,AR,30317563,1005,100,,Invoice,,,,,,18/06/2018,18/06/2018,0.00,,10.34,,"-507,168.61"
,IN,AR,30317568,1005,100,,Invoice,,,,,,18/06/2018,18/06/2018,0.00,,16.08,,"-507,184.69"
,IN,AR,30317585,1005,100,,Invoice,,,,,,18/06/2018,18/06/2018,0.00,,4.24,,"-507,188.93"
,IN,AR,30317602,1005,100,,Invoice,,,,,,18/06/2018,18/06/2018,0.00,,10.93,,"-507,199.86"
,IN,AR,30317603,1005,100,,Invoice,,,,,,18/06/2018,18/06/2018,0.00,,12.71,,"-507,212.57"
,IN,AR,30317605,1005,100,,Invoice,,,,,,18/06/2018,18/06/2018,0.00,,18.09,,"-507,230.66"
,IN,AR,30317614,1005,100,,Invoice,,,,,,18/06/2018,18/06/2018,0.00,,13.35,,"-507,244.01"
,IN,AR,30317615,1005,100,,Invoice,,,,,,18/06/2018,18/06/2018,0.00,,1.48,,"-507,245.49"
,IN,AR,30317631,1005,100,,Invoice,,,,,,18/06/2018,18/06/2018,0.00,,"1,093.22",,"-508,338.71"
,IN,AR,30317633,1005,100,,Invoice,,,,,,18/06/2018,18/06/2018,0.00,,12.92,,"-508,351.63"
,IN,AR,30317642,1005,100,,Invoice,,,,,,18/06/2018,18/06/2018,0.00,,45.76,,"-508,397.39"
,IN,AR,30317654,1005,100,,Invoice,,,,,,18/06/2018,18/06/2018,0.00,,26.29,,"-508,423.68"
,IN,AR,30317655,1005,100,,Invoice,,,,,,18/06/2018,18/06/2018,0.00,,9.56,,"-508,433.24"
,IN,AR,30317660,1005,100,,Invoice,,,,,,18/06/2018,18/06/2018,0.00,,16.10,,"-508,449.34"
,IN,AR,30317669,1005,100,,Invoice,,,,,,18/06/2018,18/06/2018,0.00,,15.04,,"-508,464.38"
,IN,AR,30317681,1005,100,,Invoice,,,,,,18/06/2018,18/06/2018,0.00,,4.24,,"-508,468.62"
,IN,AR,30317684,1005,100,,Invoice,,,,,,18/06/2018,18/06/2018,0.00,,5.51,,"-508,474.13"
,IN,AR,30317686,1005,100,,Invoice,,,,,,18/06/2018,18/06/2018,0.00,,10.93,,"-508,485.06"
,IN,AR,30317700,1005,100,,Invoice,,,,,,18/06/2018,18/06/2018,0.00,,2.88,,"-508,487.94"
,IN,AR,30317731,1005,100,,Invoice,,,,,,18/06/2018,18/06/2018,0.00,,12.71,,"-508,500.65"
,IN,AR,30317818,1005,100,,Invoice,,,,,,18/06/2018,18/06/2018,0.00,,35.59,,"-508,536.24"
,IN,AR,30317826,1005,100,,Invoice,,,,,,18/06/2018,18/06/2018,0.00,,22.37,,"-508,558.61"
,IN,AR,30317834,1005,100,,Invoice,,,,,,18/06/2018,18/06/2018,0.00,,7.29,,"-508,565.90"
,IN,AR,30317844,1005,100,,Invoice,,,,,,18/06/2018,18/06/2018,0.00,,7.29,,"-508,573.19"
,IN,AR,30317846,1005,100,,Invoice,,,,,,18/06/2018,18/06/2018,0.00,,10.93,,"-508,584.12"
,IN,AR,30317853,1005,100,,Invoice,,,,,,18/06/2018,18/06/2018,0.00,,12.71,,"-508,596.83"
,IN,AR,30317854,1005,100,,Invoice,,,,,,18/06/2018,18/06/2018,0.00,,8.47,,"-508,605.30"
,IN,AR,30317855,1005,100,,Invoice,,,,,,18/06/2018,18/06/2018,0.00,,12.71,,"-508,618.01"
,IN,AR,30317862,1005,100,,Invoice,,,,,,18/06/2018,18/06/2018,0.00,,5.51,,"-508,623.52"
,IN,AR,30317864,1005,100,,Invoice,,,,,,18/06/2018,18/06/2018,0.00,,3.64,,"-508,627.16"
,IN,AR,30317871,1005,100,,Invoice,,,,,,18/06/2018,18/06/2018,0.00,,13.78,,"-508,640.94"
,IN,AR,30317877,1005,100,,Invoice,,,,,,18/06/2018,18/06/2018,0.00,,10.51,,"-508,651.45"
,IN,AR,30317912,1005,100,,Invoice,,,,,,18/06/2018,18/06/2018,0.00,,10.93,,"-508,662.38"
,IN,AR,30317918,1005,100,,Invoice,,,,,,18/06/2018,18/06/2018,0.00,,30.00,,"-508,692.38"
,IN,AR,30317942,1005,100,,Invoice,,,,,,18/06/2018,18/06/2018,0.00,,7.75,,"-508,700.13"
,IN,AR,30317948,1005,100,,Invoice,,,,,,18/06/2018,18/06/2018,0.00,,7.29,,"-508,707.42"
,IN,AR,30317953,1005,100,,Invoice,,,,,,18/06/2018,18/06/2018,0.00,,32.83,,"-508,740.25"
,IN,AR,30317959,1005,100,,Invoice,,,,,,18/06/2018,18/06/2018,0.00,,5.17,,"-508,745.42"
,IN,AR,30317981,1005,100,,Invoice,,,,,,18/06/2018,18/06/2018,0.00,,6.53,,"-508,751.95"
,IN,AR,30317989,1005,100,,Invoice,,,,,,18/06/2018,18/06/2018,0.00,,45.03,,"-508,796.98"
,IN,AR,30318008,1005,100,,Invoice,,,,,,18/06/2018,18/06/2018,0.00,,14.58,,"-508,811.56"
,IN,AR,30318022,1005,100,,Invoice,,,,,,18/06/2018,18/06/2018,0.00,,7.29,,"-508,818.85"
,IN,AR,30318027,1005,100,,Invoice,,,,,,18/06/2018,18/06/2018,0.00,,10.93,,"-508,829.78"
,IN,AR,30318048,1005,100,,Invoice,,,,,,18/06/2018,18/06/2018,0.00,,54.66,,"-508,884.44"
,IN,AR,30318049,1005,100,,Invoice,,,,,,18/06/2018,18/06/2018,0.00,,21.86,,"-508,906.30"
,IN,AR,30318057,1005,100,,Invoice,,,,,,18/06/2018,18/06/2018,0.00,,4.29,,"-508,910.59"
,IN,AR,30318073,1005,100,,Invoice,,,,,,18/06/2018,18/06/2018,0.00,,8.44,,"-508,919.03"
,IN,AR,30318109,1005,100,,Invoice,,,,,,18/06/2018,18/06/2018,0.00,,10.93,,"-508,929.96"
,IN,AR,30318115,1005,100,,Invoice,,,,,,18/06/2018,18/06/2018,0.00,,50.11,,"-508,980.07"
,IN,AR,30318130,1005,100,,Invoice,,,,,,18/06/2018,18/06/2018,0.00,,18.21,,"-508,998.28"
,IN,AR,30318147,1005,100,,Invoice,,,,,,18/06/2018,18/06/2018,0.00,,34.15,,"-509,032.43"
,IN,AR,30318151,1005,100,,Invoice,,,,,,18/06/2018,18/06/2018,0.00,,4.58,,"-509,037.01"
,IN,AR,30318172,1005,100,,Invoice,,,,,,18/06/2018,18/06/2018,0.00,,364.41,,"-509,401.42"
,IN,AR,30318191,1005,100,,Invoice,,,,,,18/06/2018,18/06/2018,0.00,,16.01,,"-509,417.43"
,IN,AR,30318200,1005,100,,Invoice,,,,,,18/06/2018,18/06/2018,0.00,,20.01,,"-509,437.44"
,IN,AR,30318210,1005,100,,Invoice,,,,,,18/06/2018,18/06/2018,0.00,,57.32,,"-509,494.76"
,IN,AR,30318231,1005,100,,Invoice,,,,,,18/06/2018,18/06/2018,0.00,,23.32,,"-509,518.08"
,IN,AR,30318236,1005,100,,Invoice,,,,,,18/06/2018,18/06/2018,0.00,,31.41,,"-509,549.49"
,IN,AR,30318238,1005,100,,Invoice,,,,,,18/06/2018,18/06/2018,0.00,,195.76,,"-509,745.25"
,IN,AR,30318244,1005,100,,Invoice,,,,,,18/06/2018,18/06/2018,0.00,,19.64,,"-509,764.89"
,IN,AR,30318283,1005,100,,Invoice,,,,,,18/06/2018,18/06/2018,0.00,,34.70,,"-509,799.59"
,IN,AR,30318287,1005,100,,Invoice,,,,,,18/06/2018,18/06/2018,0.00,,15.93,,"-509,815.52"
,IN,AR,30318349,1005,100,,Invoice,,,,,,18/06/2018,18/06/2018,0.00,,14.00,,"-509,829.52"
,IN,AR,30318358,1005,100,,Invoice,,,,,,18/06/2018,18/06/2018,0.00,,1.88,,"-509,831.40"
,IN,AR,30318359,1005,100,,Invoice,,,,,,18/06/2018,18/06/2018,0.00,,11.29,,"-509,842.69"
,IN,AR,30318369,1005,100,,Invoice,,,,,,18/06/2018,18/06/2018,0.00,,22.71,,"-509,865.40"
,IN,AR,30318373,1005,100,,Invoice,,,,,,18/06/2018,18/06/2018,0.00,,29.15,,"-509,894.55"
,IN,AR,30318381,1005,100,,Invoice,,,,,,18/06/2018,18/06/2018,0.00,,29.15,,"-509,923.70"
,IN,AR,30318390,1005,100,,Invoice,,,,,,18/06/2018,18/06/2018,0.00,,5.47,,"-509,929.17"
,IN,AR,30318418,1005,100,,Invoice,,,,,,18/06/2018,18/06/2018,0.00,,7.86,,"-509,937.03"
,IN,AR,30318420,1005,100,,Invoice,,,,,,18/06/2018,18/06/2018,0.00,,10.53,,"-509,947.56"
,IN,AR,30318423,1005,100,,Invoice,,,,,,18/06/2018,18/06/2018,0.00,,12.14,,"-509,959.70"
,IN,AR,30318427,1005,100,,Invoice,,,,,,18/06/2018,18/06/2018,0.00,,4.08,,"-509,963.78"
,IN,AR,30318438,1005,100,,Invoice,,,,,,18/06/2018,18/06/2018,0.00,,36.44,,"-510,000.22"
,IN,AR,30318443,1005,100,,Invoice,,,,,,18/06/2018,18/06/2018,0.00,,12.94,,"-510,013.16"
,IN,AR,30318446,1005,100,,Invoice,,,,,,18/06/2018,18/06/2018,0.00,,19.92,,"-510,033.08"
,IN,AR,30318451,1005,100,,Invoice,,,,,,18/06/2018,18/06/2018,0.00,,32.16,,"-510,065.24"
,IN,AR,30318472,1005,100,,Invoice,,,,,,18/06/2018,18/06/2018,0.00,,2.08,,"-510,067.32"
,IN,AR,30318473,1005,100,,Invoice,,,,,,18/06/2018,18/06/2018,0.00,,10.38,,"-510,077.70"
,IN,AR,30318474,1005,100,,Invoice,,,,,,18/06/2018,18/06/2018,0.00,,6.23,,"-510,083.93"
,IN,AR,30318475,1005,100,,Invoice,,,,,,18/06/2018,18/06/2018,0.00,,2.08,,"-510,086.01"
,IN,AR,30318476,1005,100,,Invoice,,,,,,18/06/2018,18/06/2018,0.00,,2.08,,"-510,088.09"
,IN,AR,30318477,1005,100,,Invoice,,,,,,18/06/2018,18/06/2018,0.00,,12.46,,"-510,100.55"
,IN,AR,30318515,1005,100,,Invoice,,,,,,18/06/2018,18/06/2018,0.00,,11.65,,"-510,112.20"
,IN,AR,30318524,1005,100,,Invoice,,,,,,18/06/2018,18/06/2018,0.00,,21.86,,"-510,134.06"
,IN,AR,30318535,1005,100,,Invoice,,,,,,18/06/2018,18/06/2018,0.00,,4.07,,"-510,138.13"
,IN,AP,40002288,9000,900,,Invoice,,,,,SB,19/06/2018,19/06/2018,"2,538.00",,0.00,,"-507,600.13"
,CS,AR,32005275,1005,100,,Cash sale,,,,,,19/06/2018,19/06/2018,0.00,,3.64,,"-507,603.77"
,CS,AR,32005278,1005,100,,Cash sale,,,,,,19/06/2018,19/06/2018,0.00,,7.29,,"-507,611.06"
,CS,AR,32005289,1005,100,,Cash sale,,,,,,19/06/2018,19/06/2018,0.00,,7.29,,"-507,618.35"
,CS,AR,32005313,1005,100,,Cash sale,,,,,,19/06/2018,19/06/2018,0.00,,9.03,,"-507,627.38"
,CS,AR,32005318,1005,100,,Cash sale,,,,,,19/06/2018,19/06/2018,0.00,,10.93,,"-507,638.31"
,CS,AR,32005334,1005,100,,Cash sale,,,,,,19/06/2018,19/06/2018,0.00,,10.93,,"-507,649.24"
,CS,AR,32005345,1005,100,,Cash sale,,,,,,19/06/2018,19/06/2018,0.00,,18.22,,"-507,667.46"
,CS,AR,32005354,1005,100,,Cash sale,,,,,,19/06/2018,19/06/2018,0.00,,10.93,,"-507,678.39"
,CS,AR,32005357,1005,100,,Cash sale,,,,,,19/06/2018,19/06/2018,0.00,,3.64,,"-507,682.03"
,CS,AR,32005373,1005,100,,Cash sale,,,,,,19/06/2018,19/06/2018,0.00,,10.17,,"-507,692.20"
,CS,AR,32005379,1005,100,,Cash sale,,,,,,19/06/2018,19/06/2018,0.00,,7.29,,"-507,699.49"
,CS,AR,32005383,1005,100,,Cash sale,,,,,,19/06/2018,19/06/2018,0.00,,4.32,,"-507,703.81"
,CS,AR,32005395,1005,100,,Cash sale,,,,,,19/06/2018,19/06/2018,0.00,,5.85,,"-507,709.66"
,CS,AR,32005397,1005,100,,Cash sale,,,,,,19/06/2018,19/06/2018,0.00,,7.75,,"-507,717.41"
,CS,AR,32005402,1005,100,,Cash sale,,,,,,19/06/2018,19/06/2018,0.00,,14.58,,"-507,731.99"
,CS,AR,32005424,1005,100,,Cash sale,,,,,,19/06/2018,19/06/2018,0.00,,6.43,,"-507,738.42"
,CS,AR,32005429,1005,100,,Cash sale,,,,,,19/06/2018,19/06/2018,0.00,,3.64,,"-507,742.06"
,CS,AR,32005438,1005,100,,Cash sale,,,,,,19/06/2018,19/06/2018,0.00,,6.74,,"-507,748.80"
,CS,AR,32005455,1005,100,,Cash sale,,,,,,19/06/2018,19/06/2018,0.00,,5.85,,"-507,754.65"
,CS,AR,32005468,1005,100,,Cash sale,,,,,,19/06/2018,19/06/2018,0.00,,12.92,,"-507,767.57"
,CS,AR,32005483,1005,100,,Cash sale,,,,,,19/06/2018,19/06/2018,0.00,,5.17,,"-507,772.74"
,CS,AR,32005487,1005,100,,Cash sale,,,,,,19/06/2018,19/06/2018,0.00,,3.90,,"-507,776.64"
,CS,AR,32005502,1005,100,,Cash sale,,,,,,19/06/2018,19/06/2018,0.00,,7.29,,"-507,783.93"
,CS,AR,32005528,1005,100,,Cash sale,,,,,,19/06/2018,19/06/2018,0.00,,9.66,,"-507,793.59"
,CS,AR,32005530,1005,100,,Cash sale,,,,,,19/06/2018,19/06/2018,0.00,,7.29,,"-507,800.88"
,CS,AR,32005540,1005,100,,Cash sale,,,,,,19/06/2018,19/06/2018,0.00,,10.93,,"-507,811.81"
,CS,AR,32005541,1005,100,,Cash sale,,,,,,19/06/2018,19/06/2018,0.00,,17.15,,"-507,828.96"
,CS,AR,32005544,1005,100,,Cash sale,,,,,,19/06/2018,19/06/2018,0.00,,3.76,,"-507,832.72"
,CS,AR,32005562,1005,100,,Cash sale,,,,,,19/06/2018,19/06/2018,0.00,,10.93,,"-507,843.65"
,CS,AR,32005580,1005,100,,Cash sale,,,,,,19/06/2018,19/06/2018,0.00,,7.29,,"-507,850.94"
,CS,AR,32005581,1005,100,,Cash sale,,,,,,19/06/2018,19/06/2018,0.00,,12.71,,"-507,863.65"
,CS,AR,32005583,1005,100,,Cash sale,,,,,,19/06/2018,19/06/2018,0.00,,26.00,,"-507,889.65"
,CS,AR,32005594,1005,100,,Cash sale,,,,,,19/06/2018,19/06/2018,0.00,,3.64,,"-507,893.29"
,CS,AR,32005631,1005,100,,Cash sale,,,,,,19/06/2018,19/06/2018,0.00,,5.50,,"-507,898.79"
,CS,AR,32005657,1005,100,,Cash sale,,,,,,19/06/2018,19/06/2018,0.00,,7.29,,"-507,906.08"
,CS,AR,32005662,1005,100,,Cash sale,,,,,,19/06/2018,19/06/2018,0.00,,8.00,,"-507,914.08"
,CS,AR,32005676,1005,100,,Cash sale,,,,,,19/06/2018,19/06/2018,0.00,,3.64,,"-507,917.72"
,CS,AR,32005682,1005,100,,Cash sale,,,,,,19/06/2018,19/06/2018,0.00,,7.29,,"-507,925.01"
,CS,AR,32005683,1005,100,,Cash sale,,,,,,19/06/2018,19/06/2018,0.00,,10.93,,"-507,935.94"
,CS,AR,32005687,1005,100,,Cash sale,,,,,,19/06/2018,19/06/2018,0.00,,5.47,,"-507,941.41"
,IN,AR,30317301,1005,100,,Invoice,,,,,,19/06/2018,19/06/2018,0.00,,9.03,,"-507,950.44"
,IN,AR,30317307,1005,100,,Invoice,,,,,,19/06/2018,19/06/2018,0.00,,519.07,,"-508,469.51"
,IN,AR,30317325,1005,100,,Invoice,,,,,,19/06/2018,19/06/2018,0.00,,21.86,,"-508,491.37"
,IN,AR,30317371,1005,100,,Invoice,,,,,,19/06/2018,19/06/2018,0.00,,29.15,,"-508,520.52"
,IN,AR,30317374,1005,100,,Invoice,,,,,,19/06/2018,19/06/2018,0.00,,7.29,,"-508,527.81"
,IN,AR,30317380,1005,100,,Invoice,,,,,,19/06/2018,19/06/2018,0.00,,7.29,,"-508,535.10"
,IN,AR,30317382,1005,100,,Invoice,,,,,,19/06/2018,19/06/2018,0.00,,10.50,,"-508,545.60"
,IN,AR,30317403,1005,100,,Invoice,,,,,,19/06/2018,19/06/2018,0.00,,3.98,,"-508,549.58"
,IN,AR,30317407,1005,100,,Invoice,,,,,,19/06/2018,19/06/2018,0.00,,28.47,,"-508,578.05"
,IN,AR,30317416,1005,100,,Invoice,,,,,,19/06/2018,19/06/2018,0.00,,25.51,,"-508,603.56"
,IN,AR,30317419,1005,100,,Invoice,,,,,,19/06/2018,19/06/2018,0.00,,13.77,,"-508,617.33"
,IN,AR,30317435,1005,100,,Invoice,,,,,,19/06/2018,19/06/2018,0.00,,21.86,,"-508,639.19"
,IN,AR,30317466,1005,100,,Invoice,,,,,,19/06/2018,19/06/2018,0.00,,182.20,,"-508,821.39"
,IN,AR,30317495,1005,100,,Invoice,,,,,,19/06/2018,19/06/2018,0.00,,21.86,,"-508,843.25"
,IN,AR,30317501,1005,100,,Invoice,,,,,,19/06/2018,19/06/2018,0.00,,780.96,,"-509,624.21"
,IN,AR,30317520,1005,100,,Invoice,,,,,,19/06/2018,19/06/2018,0.00,,24.73,,"-509,648.94"
,IN,AR,30317525,1005,100,,Invoice,,,,,,19/06/2018,19/06/2018,0.00,,7.29,,"-509,656.23"
,IN,AR,30317559,1005,100,,Invoice,,,,,,19/06/2018,19/06/2018,0.00,,16.47,,"-509,672.70"
,IN,AR,30317561,1005,100,,Invoice,,,,,,19/06/2018,19/06/2018,0.00,,6.97,,"-509,679.67"
,IN,AR,30317581,1005,100,,Invoice,,,,,,19/06/2018,19/06/2018,0.00,,12.71,,"-509,692.38"
,IN,AR,30317587,1005,100,,Invoice,,,,,,19/06/2018,19/06/2018,0.00,,29.15,,"-509,721.53"
,IN,AR,30317598,1005,100,,Invoice,,,,,,19/06/2018,19/06/2018,0.00,,6.36,,"-509,727.89"
,IN,AR,30317623,1005,100,,Invoice,,,,,,19/06/2018,19/06/2018,0.00,,15.04,,"-509,742.93"
,IN,AR,30317634,1005,100,,Invoice,,,,,,19/06/2018,19/06/2018,0.00,,5.85,,"-509,748.78"
,IN,AR,30317679,1005,100,,Invoice,,,,,,19/06/2018,19/06/2018,0.00,,10.93,,"-509,759.71"
,IN,AR,30317743,1005,100,,Invoice,,,,,,19/06/2018,19/06/2018,0.00,,7.29,,"-509,767.00"
,IN,AR,30317809,1005,100,,Invoice,,,,,,19/06/2018,19/06/2018,0.00,,7.29,,"-509,774.29"
,IN,AR,30317829,1005,100,,Invoice,,,,,,19/06/2018,19/06/2018,0.00,,13.22,,"-509,787.51"
,IN,AR,30317833,1005,100,,Invoice,,,,,,19/06/2018,19/06/2018,0.00,,7.17,,"-509,794.68"
,IN,AR,30317835,1005,100,,Invoice,,,,,,19/06/2018,19/06/2018,0.00,,17.80,,"-509,812.48"
,IN,AR,30317838,1005,100,,Invoice,,,,,,19/06/2018,19/06/2018,0.00,,5.85,,"-509,818.33"
,IN,AR,30317839,1005,100,,Invoice,,,,,,19/06/2018,19/06/2018,0.00,,22.81,,"-509,841.14"
,IN,AR,30317843,1005,100,,Invoice,,,,,,19/06/2018,19/06/2018,0.00,,10.93,,"-509,852.07"
,IN,AR,30317858,1005,100,,Invoice,,,,,,19/06/2018,19/06/2018,0.00,,4.24,,"-509,856.31"
,IN,AR,30317865,1005,100,,Invoice,,,,,,19/06/2018,19/06/2018,0.00,,7.63,,"-509,863.94"
,IN,AR,30317873,1005,100,,Invoice,,,,,,19/06/2018,19/06/2018,0.00,,33.66,,"-509,897.60"
,IN,AR,30317879,1005,100,,Invoice,,,,,,19/06/2018,19/06/2018,0.00,,4.24,,"-509,901.84"
,IN,AR,30317882,1005,100,,Invoice,,,,,,19/06/2018,19/06/2018,0.00,,5.93,,"-509,907.77"
,IN,AR,30317920,1005,100,,Invoice,,,,,,19/06/2018,19/06/2018,0.00,,24.56,,"-509,932.33"
,IN,AR,30317939,1005,100,,Invoice,,,,,,19/06/2018,19/06/2018,0.00,,2.80,,"-509,935.13"
,IN,AR,30317945,1005,100,,Invoice,,,,,,19/06/2018,19/06/2018,0.00,,5.86,,"-509,940.99"
,IN,AR,30317960,1005,100,,Invoice,,,,,,19/06/2018,19/06/2018,0.00,,43.73,,"-509,984.72"
,IN,AR,30317970,1005,100,,Invoice,,,,,,19/06/2018,19/06/2018,0.00,,6.07,,"-509,990.79"
,IN,AR,30317982,1005,100,,Invoice,,,,,,19/06/2018,19/06/2018,0.00,,10.93,,"-510,001.72"
,IN,AR,30317994,1005,100,,Invoice,,,,,,19/06/2018,19/06/2018,0.00,,3.53,,"-510,005.25"
,IN,AR,30318017,1005,100,,Invoice,,,,,,19/06/2018,19/06/2018,0.00,,21.86,,"-510,027.11"
,IN,AR,30318019,1005,100,,Invoice,,,,,,19/06/2018,19/06/2018,0.00,,5.17,,"-510,032.28"
,IN,AR,30318020,1005,100,,Invoice,,,,,,19/06/2018,19/06/2018,0.00,,105.93,,"-510,138.21"
,IN,AR,30318023,1005,100,,Invoice,,,,,,19/06/2018,19/06/2018,0.00,,16.42,,"-510,154.63"
,IN,AR,30318087,1005,100,,Invoice,,,,,,19/06/2018,19/06/2018,0.00,,4.77,,"-510,159.40"
,IN,AR,30318088,1005,100,,Invoice,,,,,,19/06/2018,19/06/2018,0.00,,7.95,,"-510,167.35"
,IN,AR,30318089,1005,100,,Invoice,,,,,,19/06/2018,19/06/2018,0.00,,173.31,,"-510,340.66"
,IN,AR,30318090,1005,100,,Invoice,,,,,,19/06/2018,19/06/2018,0.00,,4.77,,"-510,345.43"
,IN,AR,30318091,1005,100,,Invoice,,,,,,19/06/2018,19/06/2018,0.00,,15.90,,"-510,361.33"
,IN,AR,30318099,1005,100,,Invoice,,,,,,19/06/2018,19/06/2018,0.00,,17.03,,"-510,378.36"
,IN,AR,30318105,1005,100,,Invoice,,,,,,19/06/2018,19/06/2018,0.00,,40.00,,"-510,418.36"
,IN,AR,30318138,1005,100,,Invoice,,,,,,19/06/2018,19/06/2018,0.00,,206.62,,"-510,624.98"
,IN,AR,30318155,1005,100,,Invoice,,,,,,19/06/2018,19/06/2018,0.00,,5.47,,"-510,630.45"
,IN,AR,30318157,1005,100,,Invoice,,,,,,19/06/2018,19/06/2018,0.00,,16.40,,"-510,646.85"
,IN,AR,30318173,1005,100,,Invoice,,,,,,19/06/2018,19/06/2018,0.00,,29.15,,"-510,676.00"
,IN,AR,30318176,1005,100,,Invoice,,,,,,19/06/2018,19/06/2018,0.00,,14.58,,"-510,690.58"
,IN,AR,30318177,1005,100,,Invoice,,,,,,19/06/2018,19/06/2018,0.00,,10.93,,"-510,701.51"
,IN,AR,30318180,1005,100,,Invoice,,,,,,19/06/2018,19/06/2018,0.00,,12.71,,"-510,714.22"
,IN,AR,30318194,1005,100,,Invoice,,,,,,19/06/2018,19/06/2018,0.00,,22.01,,"-510,736.23"
,IN,AR,30318208,1005,100,,Invoice,,,,,,19/06/2018,19/06/2018,0.00,,10.93,,"-510,747.16"
,IN,AR,30318242,1005,100,,Invoice,,,,,,19/06/2018,19/06/2018,0.00,,8.21,,"-510,755.37"
,IN,AR,30318262,1005,100,,Invoice,,,,,,19/06/2018,19/06/2018,0.00,,112.00,,"-510,867.37"
,IN,AR,30318264,1005,100,,Invoice,,,,,,19/06/2018,19/06/2018,0.00,,12.14,,"-510,879.51"
,IN,AR,30318269,1005,100,,Invoice,,,,,,19/06/2018,19/06/2018,0.00,,35.59,,"-510,915.10"
,IN,AR,30318303,1005,100,,Invoice,,,,,,19/06/2018,19/06/2018,0.00,,116.61,,"-511,031.71"
,IN,AR,30318364,1005,100,,Invoice,,,,,,19/06/2018,19/06/2018,0.00,,3.51,,"-511,035.22"
,IN,AR,30318366,1005,100,,Invoice,,,,,,19/06/2018,19/06/2018,0.00,,4.00,,"-511,039.22"
,IN,AR,30318368,1005,100,,Invoice,,,,,,19/06/2018,19/06/2018,0.00,,5.93,,"-511,045.15"
,IN,AR,30318374,1005,100,,Invoice,,,,,,19/06/2018,19/06/2018,0.00,,123.03,,"-511,168.18"
,IN,AR,30318382,1005,100,,Invoice,,,,,,19/06/2018,19/06/2018,0.00,,7.02,,"-511,175.20"
,IN,AR,30318416,1005,100,,Invoice,,,,,,19/06/2018,19/06/2018,0.00,,145.76,,"-511,320.96"
,IN,AR,30318462,1005,100,,Invoice,,,,,,19/06/2018,19/06/2018,0.00,,2.42,,"-511,323.38"
,IN,AR,30318518,1005,100,,Invoice,,,,,,19/06/2018,19/06/2018,0.00,,30.34,,"-511,353.72"
,IN,AR,30318522,1005,100,,Invoice,,,,,,19/06/2018,19/06/2018,0.00,,10.93,,"-511,364.65"
,IN,AR,30318533,1005,100,,Invoice,,,,,,19/06/2018,19/06/2018,0.00,,12.14,,"-511,376.79"
,IN,AR,30318538,1005,100,,Invoice,,,,,,19/06/2018,19/06/2018,0.00,,11.86,,"-511,388.65"
,CN,AR,31018211,1005,100,,Credit Note,,,,,,20/06/2018,20/06/2018,519.07,,0.00,,"-510,869.58"
,CN,AR,31018232,1005,100,,Credit Note,,,,,,20/06/2018,20/06/2018,104.24,,0.00,,"-510,765.34"
,CN,AR,31018233,1005,100,,Credit Note,,,,,,20/06/2018,20/06/2018,17.80,,0.00,,"-510,747.54"
,CN,AR,31018243,1005,100,,Credit Note,,,,,,20/06/2018,20/06/2018,7.50,,0.00,,"-510,740.04"
,CN,AR,31018248,1005,100,,Credit Note,,,,,,20/06/2018,20/06/2018,7.53,,0.00,,"-510,732.51"
,CN,AR,31018252,1005,100,,Credit Note,,,,,,20/06/2018,20/06/2018,9.66,,0.00,,"-510,722.85"
,CS,AR,32005262,1005,100,,Cash sale,,,,,,20/06/2018,20/06/2018,0.00,,16.83,,"-510,739.68"
,CS,AR,32005269,1005,100,,Cash sale,,,,,,20/06/2018,20/06/2018,0.00,,7.29,,"-510,746.97"
,CS,AR,32005271,1005,100,,Cash sale,,,,,,20/06/2018,20/06/2018,0.00,,42.64,,"-510,789.61"
,CS,AR,32005292,1005,100,,Cash sale,,,,,,20/06/2018,20/06/2018,0.00,,3.64,,"-510,793.25"
,CS,AR,32005298,1005,100,,Cash sale,,,,,,20/06/2018,20/06/2018,0.00,,14.58,,"-510,807.83"
,CS,AR,32005308,1005,100,,Cash sale,,,,,,20/06/2018,20/06/2018,0.00,,3.64,,"-510,811.47"
,CS,AR,32005349,1005,100,,Cash sale,,,,,,20/06/2018,20/06/2018,0.00,,10.93,,"-510,822.40"
,CS,AR,32005361,1005,100,,Cash sale,,,,,,20/06/2018,20/06/2018,0.00,,2.92,,"-510,825.32"
,CS,AR,32005372,1005,100,,Cash sale,,,,,,20/06/2018,20/06/2018,0.00,,7.75,,"-510,833.07"
,CS,AR,32005398,1005,100,,Cash sale,,,,,,20/06/2018,20/06/2018,0.00,,10.34,,"-510,843.41"
,CS,AR,32005407,1005,100,,Cash sale,,,,,,20/06/2018,20/06/2018,0.00,,7.29,,"-510,850.70"
,CS,AR,32005420,1005,100,,Cash sale,,,,,,20/06/2018,20/06/2018,0.00,,10.93,,"-510,861.63"
,CS,AR,32005431,1005,100,,Cash sale,,,,,,20/06/2018,20/06/2018,0.00,,12.92,,"-510,874.55"
,CS,AR,32005436,1005,100,,Cash sale,,,,,,20/06/2018,20/06/2018,0.00,,7.00,,"-510,881.55"
,CS,AR,32005456,1005,100,,Cash sale,,,,,,20/06/2018,20/06/2018,0.00,,7.75,,"-510,889.30"
,CS,AR,32005459,1005,100,,Cash sale,,,,,,20/06/2018,20/06/2018,0.00,,14.58,,"-510,903.88"
,CS,AR,32005490,1005,100,,Cash sale,,,,,,20/06/2018,20/06/2018,0.00,,14.58,,"-510,918.46"
,CS,AR,32005500,1005,100,,Cash sale,,,,,,20/06/2018,20/06/2018,0.00,,14.58,,"-510,933.04"
,CS,AR,32005507,1005,100,,Cash sale,,,,,,20/06/2018,20/06/2018,0.00,,18.22,,"-510,951.26"
,CS,AR,32005552,1005,100,,Cash sale,,,,,,20/06/2018,20/06/2018,0.00,,16.61,,"-510,967.87"
,CS,AR,32005556,1005,100,,Cash sale,,,,,,20/06/2018,20/06/2018,0.00,,10.93,,"-510,978.80"
,CS,AR,32005558,1005,100,,Cash sale,,,,,,20/06/2018,20/06/2018,0.00,,10.93,,"-510,989.73"
,CS,AR,32005568,1005,100,,Cash sale,,,,,,20/06/2018,20/06/2018,0.00,,7.29,,"-510,997.02"
,CS,AR,32005575,1005,100,,Cash sale,,,,,,20/06/2018,20/06/2018,0.00,,7.29,,"-511,004.31"
,CS,AR,32005577,1005,100,,Cash sale,,,,,,20/06/2018,20/06/2018,0.00,,7.29,,"-511,011.60"
,CS,AR,32005578,1005,100,,Cash sale,,,,,,20/06/2018,20/06/2018,0.00,,6.86,,"-511,018.46"
,CS,AR,32005592,1005,100,,Cash sale,,,,,,20/06/2018,20/06/2018,0.00,,29.15,,"-511,047.61"
,CS,AR,32005595,1005,100,,Cash sale,,,,,,20/06/2018,20/06/2018,0.00,,8.26,,"-511,055.87"
,CS,AR,32005608,1005,100,,Cash sale,,,,,,20/06/2018,20/06/2018,0.00,,9.11,,"-511,064.98"
,CS,AR,32005613,1005,100,,Cash sale,,,,,,20/06/2018,20/06/2018,0.00,,11.44,,"-511,076.42"
,CS,AR,32005621,1005,100,,Cash sale,,,,,,20/06/2018,20/06/2018,0.00,,9.10,,"-511,085.52"
,CS,AR,32005630,1005,100,,Cash sale,,,,,,20/06/2018,20/06/2018,0.00,,14.58,,"-511,100.10"
,CS,AR,32005635,1005,100,,Cash sale,,,,,,20/06/2018,20/06/2018,0.00,,12.03,,"-511,112.13"
,CS,AR,32005642,1005,100,,Cash sale,,,,,,20/06/2018,20/06/2018,0.00,,10.93,,"-511,123.06"
,CS,AR,32005649,1005,100,,Cash sale,,,,,,20/06/2018,20/06/2018,0.00,,50.34,,"-511,173.40"
,CS,AR,32005651,1005,100,,Cash sale,,,,,,20/06/2018,20/06/2018,0.00,,2.54,,"-511,175.94"
,CS,AR,32005661,1005,100,,Cash sale,,,,,,20/06/2018,20/06/2018,0.00,,6.56,,"-511,182.50"
,CS,AR,32005667,1005,100,,Cash sale,,,,,,20/06/2018,20/06/2018,0.00,,7.29,,"-511,189.79"
,CS,AR,32005670,1005,100,,Cash sale,,,,,,20/06/2018,20/06/2018,0.00,,7.29,,"-511,197.08"
,CS,AR,32005671,1005,100,,Cash sale,,,,,,20/06/2018,20/06/2018,0.00,,7.29,,"-511,204.37"
,CS,AR,32005698,1005,100,,Cash sale,,,,,,20/06/2018,20/06/2018,0.00,,7.86,,"-511,212.23"
,IN,AR,30317303,1005,100,,Invoice,,,,,,20/06/2018,20/06/2018,0.00,,169.08,,"-511,381.31"
,IN,AR,30317308,1005,100,,Invoice,,,,,,20/06/2018,20/06/2018,0.00,,47.46,,"-511,428.77"
,IN,AR,30317330,1005,100,,Invoice,,,,,,20/06/2018,20/06/2018,0.00,,21.97,,"-511,450.74"
,IN,AR,30317352,1005,100,,Invoice,,,,,,20/06/2018,20/06/2018,0.00,,27.12,,"-511,477.86"
,IN,AR,30317358,1005,100,,Invoice,,,,,,20/06/2018,20/06/2018,0.00,,11.36,,"-511,489.22"
,IN,AR,30317362,1005,100,,Invoice,,,,,,20/06/2018,20/06/2018,0.00,,11.95,,"-511,501.17"
,IN,AR,30317367,1005,100,,Invoice,,,,,,20/06/2018,20/06/2018,0.00,,78.81,,"-511,579.98"
,IN,AR,30317375,1005,100,,Invoice,,,,,,20/06/2018,20/06/2018,0.00,,14.49,,"-511,594.47"
,IN,AR,30317390,1005,100,,Invoice,,,,,,20/06/2018,20/06/2018,0.00,,54.66,,"-511,649.13"
,IN,AR,30317398,1005,100,,Invoice,,,,,,20/06/2018,20/06/2018,0.00,,3.88,,"-511,653.01"
,IN,AR,30317443,1005,100,,Invoice,,,,,,20/06/2018,20/06/2018,0.00,,7.29,,"-511,660.30"
,IN,AR,30317451,1005,100,,Invoice,,,,,,20/06/2018,20/06/2018,0.00,,18.00,,"-511,678.30"
,IN,AR,30317468,1005,100,,Invoice,,,,,,20/06/2018,20/06/2018,0.00,,10.93,,"-511,689.23"
,IN,AR,30317477,1005,100,,Invoice,,,,,,20/06/2018,20/06/2018,0.00,,42.00,,"-511,731.23"
,IN,AR,30317480,1005,100,,Invoice,,,,,,20/06/2018,20/06/2018,0.00,,54.66,,"-511,785.89"
,IN,AR,30317498,1005,100,,Invoice,,,,,,20/06/2018,20/06/2018,0.00,,237.41,,"-512,023.30"
,IN,AR,30317513,1005,100,,Invoice,,,,,,20/06/2018,20/06/2018,0.00,,364.41,,"-512,387.71"
,IN,AR,30317522,1005,100,,Invoice,,,,,,20/06/2018,20/06/2018,0.00,,6.02,,"-512,393.73"
,IN,AR,30317530,1005,100,,Invoice,,,,,,20/06/2018,20/06/2018,0.00,,4.83,,"-512,398.56"
,IN,AR,30317558,1005,100,,Invoice,,,,,,20/06/2018,20/06/2018,0.00,,182.20,,"-512,580.76"
,IN,AR,30317573,1005,100,,Invoice,,,,,,20/06/2018,20/06/2018,0.00,,25.42,,"-512,606.18"
,IN,AR,30317583,1005,100,,Invoice,,,,,,20/06/2018,20/06/2018,0.00,,2.12,,"-512,608.30"
,IN,AR,30317595,1005,100,,Invoice,,,,,,20/06/2018,20/06/2018,0.00,,2.12,,"-512,610.42"
,IN,AR,30317600,1005,100,,Invoice,,,,,,20/06/2018,20/06/2018,0.00,,8.39,,"-512,618.81"
,IN,AR,30317626,1005,100,,Invoice,,,,,,20/06/2018,20/06/2018,0.00,,11.95,,"-512,630.76"
,IN,AR,30317638,1005,100,,Invoice,,,,,,20/06/2018,20/06/2018,0.00,,153.81,,"-512,784.57"
,IN,AR,30317643,1005,100,,Invoice,,,,,,20/06/2018,20/06/2018,0.00,,12.71,,"-512,797.28"
,IN,AR,30317644,1005,100,,Invoice,,,,,,20/06/2018,20/06/2018,0.00,,7.63,,"-512,804.91"
,IN,AR,30317645,1005,100,,Invoice,,,,,,20/06/2018,20/06/2018,0.00,,104.24,,"-512,909.15"
,IN,AR,30317651,1005,100,,Invoice,,,,,,20/06/2018,20/06/2018,0.00,,18.22,,"-512,927.37"
,IN,AR,30317652,1005,100,,Invoice,,,,,,20/06/2018,20/06/2018,0.00,,8.58,,"-512,935.95"
,IN,AR,30317688,1005,100,,Invoice,,,,,,20/06/2018,20/06/2018,0.00,,38.81,,"-512,974.76"
,IN,AR,30317695,1005,100,,Invoice,,,,,,20/06/2018,20/06/2018,0.00,,180.05,,"-513,154.81"
,IN,AR,30317713,1005,100,,Invoice,,,,,,20/06/2018,20/06/2018,0.00,,5.08,,"-513,159.89"
,IN,AR,30317714,1005,100,,Invoice,,,,,,20/06/2018,20/06/2018,0.00,,7.63,,"-513,167.52"
,IN,AR,30317724,1005,100,,Invoice,,,,,,20/06/2018,20/06/2018,0.00,,6.36,,"-513,173.88"
,IN,AR,30317732,1005,100,,Invoice,,,,,,20/06/2018,20/06/2018,0.00,,2.54,,"-513,176.42"
,IN,AR,30317748,1005,100,,Invoice,,,,,,20/06/2018,20/06/2018,0.00,,3.19,,"-513,179.61"
,IN,AR,30317815,1005,100,,Invoice,,,,,,20/06/2018,20/06/2018,0.00,,18.17,,"-513,197.78"
,IN,AR,30317823,1005,100,,Invoice,,,,,,20/06/2018,20/06/2018,0.00,,17.50,,"-513,215.28"
,IN,AR,30317836,1005,100,,Invoice,,,,,,20/06/2018,20/06/2018,0.00,,5.08,,"-513,220.36"
,IN,AR,30317851,1005,100,,Invoice,,,,,,20/06/2018,20/06/2018,0.00,,14.83,,"-513,235.19"
,IN,AR,30317856,1005,100,,Invoice,,,,,,20/06/2018,20/06/2018,0.00,,10.93,,"-513,246.12"
,IN,AR,30317874,1005,100,,Invoice,,,,,,20/06/2018,20/06/2018,0.00,,5.61,,"-513,251.73"
,IN,AR,30317878,1005,100,,Invoice,,,,,,20/06/2018,20/06/2018,0.00,,102.68,,"-513,354.41"
,IN,AR,30317883,1005,100,,Invoice,,,,,,20/06/2018,20/06/2018,0.00,,29.66,,"-513,384.07"
,IN,AR,30317891,1005,100,,Invoice,,,,,,20/06/2018,20/06/2018,0.00,,14.58,,"-513,398.65"
,IN,AR,30317902,1005,100,,Invoice,,,,,,20/06/2018,20/06/2018,0.00,,18.22,,"-513,416.87"
,IN,AR,30317905,1005,100,,Invoice,,,,,,20/06/2018,20/06/2018,0.00,,182.20,,"-513,599.07"
,IN,AR,30317908,1005,100,,Invoice,,,,,,20/06/2018,20/06/2018,0.00,,16.78,,"-513,615.85"
,IN,AR,30317913,1005,100,,Invoice,,,,,,20/06/2018,20/06/2018,0.00,,12.71,,"-513,628.56"
,IN,AR,30317925,1005,100,,Invoice,,,,,,20/06/2018,20/06/2018,0.00,,10.85,,"-513,639.41"
,IN,AR,30317965,1005,100,,Invoice,,,,,,20/06/2018,20/06/2018,0.00,,24.07,,"-513,663.48"
,IN,AR,30317995,1005,100,,Invoice,,,,,,20/06/2018,20/06/2018,0.00,,3.53,,"-513,667.01"
,IN,AR,30317996,1005,100,,Invoice,,,,,,20/06/2018,20/06/2018,0.00,,1.76,,"-513,668.77"
,IN,AR,30318005,1005,100,,Invoice,,,,,,20/06/2018,20/06/2018,0.00,,12.03,,"-513,680.80"
,IN,AR,30318009,1005,100,,Invoice,,,,,,20/06/2018,20/06/2018,0.00,,18.22,,"-513,699.02"
,IN,AR,30318010,1005,100,,Invoice,,,,,,20/06/2018,20/06/2018,0.00,,18.22,,"-513,717.24"
,IN,AR,30318015,1005,100,,Invoice,,,,,,20/06/2018,20/06/2018,0.00,,10.93,,"-513,728.17"
,IN,AR,30318028,1005,100,,Invoice,,,,,,20/06/2018,20/06/2018,0.00,,10.34,,"-513,738.51"
,IN,AR,30318030,1005,100,,Invoice,,,,,,20/06/2018,20/06/2018,0.00,,5.17,,"-513,743.68"
,IN,AR,30318042,1005,100,,Invoice,,,,,,20/06/2018,20/06/2018,0.00,,30.01,,"-513,773.69"
,IN,AR,30318044,1005,100,,Invoice,,,,,,20/06/2018,20/06/2018,0.00,,40.08,,"-513,813.77"
,IN,AR,30318045,1005,100,,Invoice,,,,,,20/06/2018,20/06/2018,0.00,,14.58,,"-513,828.35"
,IN,AR,30318054,1005,100,,Invoice,,,,,,20/06/2018,20/06/2018,0.00,,546.61,,"-514,374.96"
,IN,AR,30318076,1005,100,,Invoice,,,,,,20/06/2018,20/06/2018,0.00,,10.17,,"-514,385.13"
,IN,AR,30318096,1005,100,,Invoice,,,,,,20/06/2018,20/06/2018,0.00,,4.01,,"-514,389.14"
,IN,AR,30318103,1005,100,,Invoice,,,,,,20/06/2018,20/06/2018,0.00,,34.00,,"-514,423.14"
,IN,AR,30318112,1005,100,,Invoice,,,,,,20/06/2018,20/06/2018,0.00,,60.13,,"-514,483.27"
,IN,AR,30318114,1005,100,,Invoice,,,,,,20/06/2018,20/06/2018,0.00,,11.36,,"-514,494.63"
,IN,AR,30318122,1005,100,,Invoice,,,,,,20/06/2018,20/06/2018,0.00,,21.86,,"-514,516.49"
,IN,AR,30318128,1005,100,,Invoice,,,,,,20/06/2018,20/06/2018,0.00,,3.64,,"-514,520.13"
,IN,AR,30318140,1005,100,,Invoice,,,,,,20/06/2018,20/06/2018,0.00,,10.93,,"-514,531.06"
,IN,AR,30318162,1005,100,,Invoice,,,,,,20/06/2018,20/06/2018,0.00,,15.27,,"-514,546.33"
,IN,AR,30318168,1005,100,,Invoice,,,,,,20/06/2018,20/06/2018,0.00,,46.57,,"-514,592.90"
,IN,AR,30318181,1005,100,,Invoice,,,,,,20/06/2018,20/06/2018,0.00,,7.63,,"-514,600.53"
,IN,AR,30318211,1005,100,,Invoice,,,,,,20/06/2018,20/06/2018,0.00,,7.54,,"-514,608.07"
,IN,AR,30318215,1005,100,,Invoice,,,,,,20/06/2018,20/06/2018,0.00,,11.66,,"-514,619.73"
,IN,AR,30318222,1005,100,,Invoice,,,,,,20/06/2018,20/06/2018,0.00,,33.64,,"-514,653.37"
,IN,AR,30318228,1005,100,,Invoice,,,,,,20/06/2018,20/06/2018,0.00,,11.95,,"-514,665.32"
,IN,AR,30318229,1005,100,,Invoice,,,,,,20/06/2018,20/06/2018,0.00,,9.32,,"-514,674.64"
,IN,AR,30318233,1005,100,,Invoice,,,,,,20/06/2018,20/06/2018,0.00,,364.41,,"-515,039.05"
,IN,AR,30318241,1005,100,,Invoice,,,,,,20/06/2018,20/06/2018,0.00,,273.31,,"-515,312.36"
,IN,AR,30318251,1005,100,,Invoice,,,,,,20/06/2018,20/06/2018,0.00,,526.49,,"-515,838.85"
,IN,AR,30318256,1005,100,,Invoice,,,,,,20/06/2018,20/06/2018,0.00,,13.98,,"-515,852.83"
,IN,AR,30318259,1005,100,,Invoice,,,,,,20/06/2018,20/06/2018,0.00,,12.85,,"-515,865.68"
,IN,AR,30318266,1005,100,,Invoice,,,,,,20/06/2018,20/06/2018,0.00,,364.41,,"-516,230.09"
,IN,AR,30318288,1005,100,,Invoice,,,,,,20/06/2018,20/06/2018,0.00,,7.97,,"-516,238.06"
,IN,AR,30318289,1005,100,,Invoice,,,,,,20/06/2018,20/06/2018,0.00,,6.37,,"-516,244.43"
,IN,AR,30318340,1005,100,,Invoice,,,,,,20/06/2018,20/06/2018,0.00,,23.73,,"-516,268.16"
,IN,AR,30318341,1005,100,,Invoice,,,,,,20/06/2018,20/06/2018,0.00,,109.16,,"-516,377.32"
,IN,AR,30318342,1005,100,,Invoice,,,,,,20/06/2018,20/06/2018,0.00,,33.22,,"-516,410.54"
,IN,AR,30318362,1005,100,,Invoice,,,,,,20/06/2018,20/06/2018,0.00,,3.51,,"-516,414.05"
,IN,AR,30318403,1005,100,,Invoice,,,,,,20/06/2018,20/06/2018,0.00,,9.41,,"-516,423.46"
,IN,AR,30318425,1005,100,,Invoice,,,,,,20/06/2018,20/06/2018,0.00,,22.37,,"-516,445.83"
,IN,AR,30318439,1005,100,,Invoice,,,,,,20/06/2018,20/06/2018,0.00,,8.25,,"-516,454.08"
,IN,AR,30318444,1005,100,,Invoice,,,,,,20/06/2018,20/06/2018,0.00,,14.58,,"-516,468.66"
,IN,AR,30318450,1005,100,,Invoice,,,,,,20/06/2018,20/06/2018,0.00,,29.15,,"-516,497.81"
,IN,AR,30318458,1005,100,,Invoice,,,,,,20/06/2018,20/06/2018,0.00,,6.86,,"-516,504.67"
,IN,AR,30318478,1005,100,,Invoice,,,,,,20/06/2018,20/06/2018,0.00,,45.68,,"-516,550.35"
,IN,AR,30318479,1005,100,,Invoice,,,,,,20/06/2018,20/06/2018,0.00,,8.31,,"-516,558.66"
,IN,AR,30318480,1005,100,,Invoice,,,,,,20/06/2018,20/06/2018,0.00,,12.46,,"-516,571.12"
,IN,AR,30318481,1005,100,,Invoice,,,,,,20/06/2018,20/06/2018,0.00,,8.31,,"-516,579.43"
,IN,AR,30318502,1005,100,,Invoice,,,,,,20/06/2018,20/06/2018,0.00,,2.54,,"-516,581.97"
,IN,AR,30318503,1005,100,,Invoice,,,,,,20/06/2018,20/06/2018,0.00,,2.54,,"-516,584.51"
,IN,AR,30318519,1005,100,,Invoice,,,,,,20/06/2018,20/06/2018,0.00,,24.15,,"-516,608.66"
,IN,AR,30318541,1005,100,,Invoice,,,,,,20/06/2018,20/06/2018,0.00,,29.15,,"-516,637.81"
,CS,AR,32005259,1005,100,,Cash sale,,,,,,21/06/2018,21/06/2018,0.00,,9.03,,"-516,646.84"
,CS,AR,32005286,1005,100,,Cash sale,,,,,,21/06/2018,21/06/2018,0.00,,2.58,,"-516,649.42"
,CS,AR,32005294,1005,100,,Cash sale,,,,,,21/06/2018,21/06/2018,0.00,,3.64,,"-516,653.06"
,CS,AR,32005300,1005,100,,Cash sale,,,,,,21/06/2018,21/06/2018,0.00,,18.22,,"-516,671.28"
,CS,AR,32005303,1005,100,,Cash sale,,,,,,21/06/2018,21/06/2018,0.00,,3.64,,"-516,674.92"
,CS,AR,32005305,1005,100,,Cash sale,,,,,,21/06/2018,21/06/2018,0.00,,27.08,,"-516,702.00"
,CS,AR,32005316,1005,100,,Cash sale,,,,,,21/06/2018,21/06/2018,0.00,,3.64,,"-516,705.64"
,CS,AR,32005320,1005,100,,Cash sale,,,,,,21/06/2018,21/06/2018,0.00,,3.64,,"-516,709.28"
,CS,AR,32005338,1005,100,,Cash sale,,,,,,21/06/2018,21/06/2018,0.00,,3.64,,"-516,712.92"
,CS,AR,32005363,1005,100,,Cash sale,,,,,,21/06/2018,21/06/2018,0.00,,7.29,,"-516,720.21"
,CS,AR,32005477,1005,100,,Cash sale,,,,,,21/06/2018,21/06/2018,0.00,,7.29,,"-516,727.50"
,CS,AR,32005489,1005,100,,Cash sale,,,,,,21/06/2018,21/06/2018,0.00,,10.17,,"-516,737.67"
,CS,AR,32005492,1005,100,,Cash sale,,,,,,21/06/2018,21/06/2018,0.00,,19.58,,"-516,757.25"
,CS,AR,32005495,1005,100,,Cash sale,,,,,,21/06/2018,21/06/2018,0.00,,12.92,,"-516,770.17"
,CS,AR,32005511,1005,100,,Cash sale,,,,,,21/06/2018,21/06/2018,0.00,,6.44,,"-516,776.61"
,CS,AR,32005515,1005,100,,Cash sale,,,,,,21/06/2018,21/06/2018,0.00,,7.29,,"-516,783.90"
,CS,AR,32005522,1005,100,,Cash sale,,,,,,21/06/2018,21/06/2018,0.00,,2.58,,"-516,786.48"
,CS,AR,32005535,1005,100,,Cash sale,,,,,,21/06/2018,21/06/2018,0.00,,3.64,,"-516,790.12"
,CS,AR,32005557,1005,100,,Cash sale,,,,,,21/06/2018,21/06/2018,0.00,,7.29,,"-516,797.41"
,CS,AR,32005559,1005,100,,Cash sale,,,,,,21/06/2018,21/06/2018,0.00,,7.29,,"-516,804.70"
,CS,AR,32005571,1005,100,,Cash sale,,,,,,21/06/2018,21/06/2018,0.00,,2.58,,"-516,807.28"
,CS,AR,32005584,1005,100,,Cash sale,,,,,,21/06/2018,21/06/2018,0.00,,6.00,,"-516,813.28"
,CS,AR,32005600,1005,100,,Cash sale,,,,,,21/06/2018,21/06/2018,0.00,,8.90,,"-516,822.18"
,CS,AR,32005610,1005,100,,Cash sale,,,,,,21/06/2018,21/06/2018,0.00,,7.29,,"-516,829.47"
,CS,AR,32005628,1005,100,,Cash sale,,,,,,21/06/2018,21/06/2018,0.00,,25.51,,"-516,854.98"
,CS,AR,32005685,1005,100,,Cash sale,,,,,,21/06/2018,21/06/2018,0.00,,10.93,,"-516,865.91"
,CS,AR,32005690,1005,100,,Cash sale,,,,,,21/06/2018,21/06/2018,0.00,,14.58,,"-516,880.49"
,CS,AR,32005694,1005,100,,Cash sale,,,,,,21/06/2018,21/06/2018,0.00,,5.86,,"-516,886.35"
,CS,AR,32005700,1005,100,,Cash sale,,,,,,21/06/2018,21/06/2018,0.00,,7.29,,"-516,893.64"
,CS,AR,32005707,1005,100,,Cash sale,,,,,,21/06/2018,21/06/2018,0.00,,54.66,,"-516,948.30"
,IN,AR,30317324,1005,100,,Invoice,,,,,,21/06/2018,21/06/2018,0.00,,182.20,,"-517,130.50"
,IN,AR,30317329,1005,100,,Invoice,,,,,,21/06/2018,21/06/2018,0.00,,3.64,,"-517,134.14"
,IN,AR,30317331,1005,100,,Invoice,,,,,,21/06/2018,21/06/2018,0.00,,119.59,,"-517,253.73"
,IN,AR,30317379,1005,100,,Invoice,,,,,,21/06/2018,21/06/2018,0.00,,7.29,,"-517,261.02"
,IN,AR,30317389,1005,100,,Invoice,,,,,,21/06/2018,21/06/2018,0.00,,"1,093.22",,"-518,354.24"
,IN,AR,30317392,1005,100,,Invoice,,,,,,21/06/2018,21/06/2018,0.00,,8.39,,"-518,362.63"
,IN,AR,30317393,1005,100,,Invoice,,,,,,21/06/2018,21/06/2018,0.00,,18.22,,"-518,380.85"
,IN,AR,30317404,1005,100,,Invoice,,,,,,21/06/2018,21/06/2018,0.00,,3.98,,"-518,384.83"
,IN,AR,30317408,1005,100,,Invoice,,,,,,21/06/2018,21/06/2018,0.00,,175.59,,"-518,560.42"
,IN,AR,30317425,1005,100,,Invoice,,,,,,21/06/2018,21/06/2018,0.00,,54.66,,"-518,615.08"
,IN,AR,30317428,1005,100,,Invoice,,,,,,21/06/2018,21/06/2018,0.00,,44.00,,"-518,659.08"
,IN,AR,30317441,1005,100,,Invoice,,,,,,21/06/2018,21/06/2018,0.00,,7.29,,"-518,666.37"
,IN,AR,30317458,1005,100,,Invoice,,,,,,21/06/2018,21/06/2018,0.00,,3.64,,"-518,670.01"
,IN,AR,30317493,1005,100,,Invoice,,,,,,21/06/2018,21/06/2018,0.00,,49.42,,"-518,719.43"
,IN,AR,30317543,1005,100,,Invoice,,,,,,21/06/2018,21/06/2018,0.00,,21.86,,"-518,741.29"
,IN,AR,30317547,1005,100,,Invoice,,,,,,21/06/2018,21/06/2018,0.00,,14.58,,"-518,755.87"
,IN,AR,30317550,1005,100,,Invoice,,,,,,21/06/2018,21/06/2018,0.00,,31.50,,"-518,787.37"
,IN,AR,30317552,1005,100,,Invoice,,,,,,21/06/2018,21/06/2018,0.00,,21.86,,"-518,809.23"
,IN,AR,30317564,1005,100,,Invoice,,,,,,21/06/2018,21/06/2018,0.00,,4.80,,"-518,814.03"
,IN,AR,30317565,1005,100,,Invoice,,,,,,21/06/2018,21/06/2018,0.00,,9.59,,"-518,823.62"
,IN,AR,30317588,1005,100,,Invoice,,,,,,21/06/2018,21/06/2018,0.00,,30.51,,"-518,854.13"
,IN,AR,30317612,1005,100,,Invoice,,,,,,21/06/2018,21/06/2018,0.00,,171.56,,"-519,025.69"
,IN,AR,30317616,1005,100,,Invoice,,,,,,21/06/2018,21/06/2018,0.00,,43.98,,"-519,069.67"
,IN,AR,30317617,1005,100,,Invoice,,,,,,21/06/2018,21/06/2018,0.00,,33.46,,"-519,103.13"
,IN,AR,30317622,1005,100,,Invoice,,,,,,21/06/2018,21/06/2018,0.00,,23.90,,"-519,127.03"
,IN,AR,30317636,1005,100,,Invoice,,,,,,21/06/2018,21/06/2018,0.00,,23.73,,"-519,150.76"
,IN,AR,30317656,1005,100,,Invoice,,,,,,21/06/2018,21/06/2018,0.00,,19.12,,"-519,169.88"
,IN,AR,30317664,1005,100,,Invoice,,,,,,21/06/2018,21/06/2018,0.00,,9.66,,"-519,179.54"
,IN,AR,30317680,1005,100,,Invoice,,,,,,21/06/2018,21/06/2018,0.00,,4.24,,"-519,183.78"
,IN,AR,30317683,1005,100,,Invoice,,,,,,21/06/2018,21/06/2018,0.00,,9.03,,"-519,192.81"
,IN,AR,30317716,1005,100,,Invoice,,,,,,21/06/2018,21/06/2018,0.00,,14.58,,"-519,207.39"
,IN,AR,30317733,1005,100,,Invoice,,,,,,21/06/2018,21/06/2018,0.00,,2.54,,"-519,209.93"
,IN,AR,30317751,1005,100,,Invoice,,,,,,21/06/2018,21/06/2018,0.00,,18.39,,"-519,228.32"
,IN,AR,30317753,1005,100,,Invoice,,,,,,21/06/2018,21/06/2018,0.00,,364.41,,"-519,592.73"
,IN,AR,30317758,1005,100,,Invoice,,,,,,21/06/2018,21/06/2018,0.00,,5.17,,"-519,597.90"
,IN,AR,30317806,1005,100,,Invoice,,,,,,21/06/2018,21/06/2018,0.00,,10.59,,"-519,608.49"
,IN,AR,30317808,1005,100,,Invoice,,,,,,21/06/2018,21/06/2018,0.00,,19.07,,"-519,627.56"
,IN,AR,30317819,1005,100,,Invoice,,,,,,21/06/2018,21/06/2018,0.00,,25.42,,"-519,652.98"
,IN,AR,30317828,1005,100,,Invoice,,,,,,21/06/2018,21/06/2018,0.00,,3.64,,"-519,656.62"
,IN,AR,30317848,1005,100,,Invoice,,,,,,21/06/2018,21/06/2018,0.00,,7.29,,"-519,663.91"
,IN,AR,30317867,1005,100,,Invoice,,,,,,21/06/2018,21/06/2018,0.00,,54.66,,"-519,718.57"
,IN,AR,30317869,1005,100,,Invoice,,,,,,21/06/2018,21/06/2018,0.00,,16.47,,"-519,735.04"
,IN,AR,30317887,1005,100,,Invoice,,,,,,21/06/2018,21/06/2018,0.00,,14.00,,"-519,749.04"
,IN,AR,30317915,1005,100,,Invoice,,,,,,21/06/2018,21/06/2018,0.00,,4.32,,"-519,753.36"
,IN,AR,30317927,1005,100,,Invoice,,,,,,21/06/2018,21/06/2018,0.00,,6.97,,"-519,760.33"
,IN,AR,30317929,1005,100,,Invoice,,,,,,21/06/2018,21/06/2018,0.00,,10.93,,"-519,771.26"
,IN,AR,30317930,1005,100,,Invoice,,,,,,21/06/2018,21/06/2018,0.00,,14.62,,"-519,785.88"
,IN,AR,30317933,1005,100,,Invoice,,,,,,21/06/2018,21/06/2018,0.00,,18.22,,"-519,804.10"
,IN,AR,30317935,1005,100,,Invoice,,,,,,21/06/2018,21/06/2018,0.00,,10.93,,"-519,815.03"
,IN,AR,30317937,1005,100,,Invoice,,,,,,21/06/2018,21/06/2018,0.00,,24.79,,"-519,839.82"
,IN,AR,30317955,1005,100,,Invoice,,,,,,21/06/2018,21/06/2018,0.00,,51.69,,"-519,891.51"
,IN,AR,30317957,1005,100,,Invoice,,,,,,21/06/2018,21/06/2018,0.00,,12.71,,"-519,904.22"
,IN,AR,30317971,1005,100,,Invoice,,,,,,21/06/2018,21/06/2018,0.00,,10.99,,"-519,915.21"
,IN,AR,30317977,1005,100,,Invoice,,,,,,21/06/2018,21/06/2018,0.00,,15.53,,"-519,930.74"
,IN,AR,30317979,1005,100,,Invoice,,,,,,21/06/2018,21/06/2018,0.00,,7.63,,"-519,938.37"
,IN,AR,30317983,1005,100,,Invoice,,,,,,21/06/2018,21/06/2018,0.00,,25.55,,"-519,963.92"
,IN,AR,30317986,1005,100,,Invoice,,,,,,21/06/2018,21/06/2018,0.00,,10.00,,"-519,973.92"
,IN,AR,30317988,1005,100,,Invoice,,,,,,21/06/2018,21/06/2018,0.00,,13.14,,"-519,987.06"
,IN,AR,30317997,1005,100,,Invoice,,,,,,21/06/2018,21/06/2018,0.00,,7.05,,"-519,994.11"
,IN,AR,30318014,1005,100,,Invoice,,,,,,21/06/2018,21/06/2018,0.00,,4.54,,"-519,998.65"
,IN,AR,30318038,1005,100,,Invoice,,,,,,21/06/2018,21/06/2018,0.00,,7.86,,"-520,006.51"
,IN,AR,30318041,1005,100,,Invoice,,,,,,21/06/2018,21/06/2018,0.00,,11.70,,"-520,018.21"
,IN,AR,30318060,1005,100,,Invoice,,,,,,21/06/2018,21/06/2018,0.00,,5.68,,"-520,023.89"
,IN,AR,30318074,1005,100,,Invoice,,,,,,21/06/2018,21/06/2018,0.00,,18.22,,"-520,042.11"
,IN,AR,30318078,1005,100,,Invoice,,,,,,21/06/2018,21/06/2018,0.00,,4.88,,"-520,046.99"
,IN,AR,30318079,1005,100,,Invoice,,,,,,21/06/2018,21/06/2018,0.00,,26.03,,"-520,073.02"
,IN,AR,30318080,1005,100,,Invoice,,,,,,21/06/2018,21/06/2018,0.00,,8.14,,"-520,081.16"
,IN,AR,30318081,1005,100,,Invoice,,,,,,21/06/2018,21/06/2018,0.00,,14.64,,"-520,095.80"
,IN,AR,30318092,1005,100,,Invoice,,,,,,21/06/2018,21/06/2018,0.00,,19.08,,"-520,114.88"
,IN,AR,30318110,1005,100,,Invoice,,,,,,21/06/2018,21/06/2018,0.00,,109.02,,"-520,223.90"
,IN,AR,30318134,1005,100,,Invoice,,,,,,21/06/2018,21/06/2018,0.00,,12.03,,"-520,235.93"
,IN,AR,30318178,1005,100,,Invoice,,,,,,21/06/2018,21/06/2018,0.00,,14.58,,"-520,250.51"
,IN,AR,30318189,1005,100,,Invoice,,,,,,21/06/2018,21/06/2018,0.00,,20.01,,"-520,270.52"
,IN,AR,30318197,1005,100,,Invoice,,,,,,21/06/2018,21/06/2018,0.00,,20.01,,"-520,290.53"
,IN,AR,30318205,1005,100,,Invoice,,,,,,21/06/2018,21/06/2018,0.00,,14.58,,"-520,305.11"
,IN,AR,30318230,1005,100,,Invoice,,,,,,21/06/2018,21/06/2018,0.00,,18.22,,"-520,323.33"
,IN,AR,30318245,1005,100,,Invoice,,,,,,21/06/2018,21/06/2018,0.00,,5.61,,"-520,328.94"
,IN,AR,30318253,1005,100,,Invoice,,,,,,21/06/2018,21/06/2018,0.00,,25.17,,"-520,354.11"
,IN,AR,30318255,1005,100,,Invoice,,,,,,21/06/2018,21/06/2018,0.00,,3.64,,"-520,357.75"
,IN,AR,30318274,1005,100,,Invoice,,,,,,21/06/2018,21/06/2018,0.00,,2.54,,"-520,360.29"
,IN,AR,30318285,1005,100,,Invoice,,,,,,21/06/2018,21/06/2018,0.00,,81.15,,"-520,441.44"
,IN,AR,30318290,1005,100,,Invoice,,,,,,21/06/2018,21/06/2018,0.00,,132.24,,"-520,573.68"
,IN,AR,30318291,1005,100,,Invoice,,,,,,21/06/2018,21/06/2018,0.00,,17.53,,"-520,591.21"
,IN,AR,30318292,1005,100,,Invoice,,,,,,21/06/2018,21/06/2018,0.00,,6.37,,"-520,597.58"
,IN,AR,30318293,1005,100,,Invoice,,,,,,21/06/2018,21/06/2018,0.00,,4.78,,"-520,602.36"
,IN,AR,30318294,1005,100,,Invoice,,,,,,21/06/2018,21/06/2018,0.00,,9.56,,"-520,611.92"
,IN,AR,30318346,1005,100,,Invoice,,,,,,21/06/2018,21/06/2018,0.00,,28.47,,"-520,640.39"
,IN,AR,30318395,1005,100,,Invoice,,,,,,21/06/2018,21/06/2018,0.00,,29.15,,"-520,669.54"
,IN,AR,30318396,1005,100,,Invoice,,,,,,21/06/2018,21/06/2018,0.00,,10.93,,"-520,680.47"
,IN,AR,30318407,1005,100,,Invoice,,,,,,21/06/2018,21/06/2018,0.00,,18.20,,"-520,698.67"
,IN,AR,30318432,1005,100,,Invoice,,,,,,21/06/2018,21/06/2018,0.00,,8.17,,"-520,706.84"
,IN,AR,30318437,1005,100,,Invoice,,,,,,21/06/2018,21/06/2018,0.00,,21.86,,"-520,728.70"
,IN,AR,30318482,1005,100,,Invoice,,,,,,21/06/2018,21/06/2018,0.00,,14.53,,"-520,743.23"
,IN,AR,30318483,1005,100,,Invoice,,,,,,21/06/2018,21/06/2018,0.00,,2.08,,"-520,745.31"
,IN,AR,30318484,1005,100,,Invoice,,,,,,21/06/2018,21/06/2018,0.00,,2.08,,"-520,747.39"
,IN,AR,30318485,1005,100,,Invoice,,,,,,21/06/2018,21/06/2018,0.00,,2.08,,"-520,749.47"
,IN,AR,30318536,1005,100,,Invoice,,,,,,21/06/2018,21/06/2018,0.00,,2.03,,"-520,751.50"
,IN,AR,30318550,1005,100,,Invoice,,,,,,21/06/2018,21/06/2018,0.00,,29.15,,"-520,780.65"
,CN,AR,31018212,1005,100,,Credit Note,,,,,,22/06/2018,22/06/2018,18.98,,0.00,,"-520,761.67"
,CR,AR,33000175,1005,100,,Cash Return,,,,,,22/06/2018,22/06/2018,3.64,,0.00,,"-520,758.03"
,CS,AR,32005258,1005,100,,Cash sale,,,,,,22/06/2018,22/06/2018,0.00,,18.22,,"-520,776.25"
,CS,AR,32005263,1005,100,,Cash sale,,,,,,22/06/2018,22/06/2018,0.00,,8.42,,"-520,784.67"
,CS,AR,32005266,1005,100,,Cash sale,,,,,,22/06/2018,22/06/2018,0.00,,18.98,,"-520,803.65"
,CS,AR,32005274,1005,100,,Cash sale,,,,,,22/06/2018,22/06/2018,0.00,,25.55,,"-520,829.20"
,CS,AR,32005297,1005,100,,Cash sale,,,,,,22/06/2018,22/06/2018,0.00,,10.93,,"-520,840.13"
,CS,AR,32005306,1005,100,,Cash sale,,,,,,22/06/2018,22/06/2018,0.00,,14.58,,"-520,854.71"
,CS,AR,32005307,1005,100,,Cash sale,,,,,,22/06/2018,22/06/2018,0.00,,10.93,,"-520,865.64"
,CS,AR,32005309,1005,100,,Cash sale,,,,,,22/06/2018,22/06/2018,0.00,,3.64,,"-520,869.28"
,CS,AR,32005312,1005,100,,Cash sale,,,,,,22/06/2018,22/06/2018,0.00,,9.66,,"-520,878.94"
,CS,AR,32005315,1005,100,,Cash sale,,,,,,22/06/2018,22/06/2018,0.00,,10.93,,"-520,889.87"
,CS,AR,32005325,1005,100,,Cash sale,,,,,,22/06/2018,22/06/2018,0.00,,10.93,,"-520,900.80"
,CS,AR,32005328,1005,100,,Cash sale,,,,,,22/06/2018,22/06/2018,0.00,,14.53,,"-520,915.33"
,CS,AR,32005333,1005,100,,Cash sale,,,,,,22/06/2018,22/06/2018,0.00,,3.64,,"-520,918.97"
,CS,AR,32005339,1005,100,,Cash sale,,,,,,22/06/2018,22/06/2018,0.00,,7.29,,"-520,926.26"
,CS,AR,32005359,1005,100,,Cash sale,,,,,,22/06/2018,22/06/2018,0.00,,3.64,,"-520,929.90"
,CS,AR,32005360,1005,100,,Cash sale,,,,,,22/06/2018,22/06/2018,0.00,,3.64,,"-520,933.54"
,CS,AR,32005375,1005,100,,Cash sale,,,,,,22/06/2018,22/06/2018,0.00,,3.64,,"-520,937.18"
,CS,AR,32005381,1005,100,,Cash sale,,,,,,22/06/2018,22/06/2018,0.00,,9.03,,"-520,946.21"
,CS,AR,32005389,1005,100,,Cash sale,,,,,,22/06/2018,22/06/2018,0.00,,14.58,,"-520,960.79"
,CS,AR,32005393,1005,100,,Cash sale,,,,,,22/06/2018,22/06/2018,0.00,,22.88,,"-520,983.67"
,CS,AR,32005396,1005,100,,Cash sale,,,,,,22/06/2018,22/06/2018,0.00,,22.37,,"-521,006.04"
,CS,AR,32005400,1005,100,,Cash sale,,,,,,22/06/2018,22/06/2018,0.00,,3.64,,"-521,009.68"
,CS,AR,32005405,1005,100,,Cash sale,,,,,,22/06/2018,22/06/2018,0.00,,38.47,,"-521,048.15"
,CS,AR,32005409,1005,100,,Cash sale,,,,,,22/06/2018,22/06/2018,0.00,,33.66,,"-521,081.81"
,CS,AR,32005410,1005,100,,Cash sale,,,,,,22/06/2018,22/06/2018,0.00,,21.98,,"-521,103.79"
,CS,AR,32005414,1005,100,,Cash sale,,,,,,22/06/2018,22/06/2018,0.00,,14.58,,"-521,118.37"
,CS,AR,32005416,1005,100,,Cash sale,,,,,,22/06/2018,22/06/2018,0.00,,6.02,,"-521,124.39"
,CS,AR,32005433,1005,100,,Cash sale,,,,,,22/06/2018,22/06/2018,0.00,,5.08,,"-521,129.47"
,CS,AR,32005440,1005,100,,Cash sale,,,,,,22/06/2018,22/06/2018,0.00,,17.54,,"-521,147.01"
,CS,AR,32005451,1005,100,,Cash sale,,,,,,22/06/2018,22/06/2018,0.00,,14.58,,"-521,161.59"
,CS,AR,32005458,1005,100,,Cash sale,,,,,,22/06/2018,22/06/2018,0.00,,11.19,,"-521,172.78"
,CS,AR,32005463,1005,100,,Cash sale,,,,,,22/06/2018,22/06/2018,0.00,,3.64,,"-521,176.42"
,CS,AR,32005466,1005,100,,Cash sale,,,,,,22/06/2018,22/06/2018,0.00,,7.29,,"-521,183.71"
,CS,AR,32005472,1005,100,,Cash sale,,,,,,22/06/2018,22/06/2018,0.00,,3.64,,"-521,187.35"
,CS,AR,32005475,1005,100,,Cash sale,,,,,,22/06/2018,22/06/2018,0.00,,3.64,,"-521,190.99"
,CS,AR,32005503,1005,100,,Cash sale,,,,,,22/06/2018,22/06/2018,0.00,,29.14,,"-521,220.13"
,CS,AR,32005509,1005,100,,Cash sale,,,,,,22/06/2018,22/06/2018,0.00,,10.93,,"-521,231.06"
,CS,AR,32005512,1005,100,,Cash sale,,,,,,22/06/2018,22/06/2018,0.00,,14.63,,"-521,245.69"
,CS,AR,32005532,1005,100,,Cash sale,,,,,,22/06/2018,22/06/2018,0.00,,7.75,,"-521,253.44"
,CS,AR,32005537,1005,100,,Cash sale,,,,,,22/06/2018,22/06/2018,0.00,,3.64,,"-521,257.08"
,CS,AR,32005549,1005,100,,Cash sale,,,,,,22/06/2018,22/06/2018,0.00,,11.19,,"-521,268.27"
,CS,AR,32005565,1005,100,,Cash sale,,,,,,22/06/2018,22/06/2018,0.00,,12.71,,"-521,280.98"
,CS,AR,32005567,1005,100,,Cash sale,,,,,,22/06/2018,22/06/2018,0.00,,14.58,,"-521,295.56"
,CS,AR,32005574,1005,100,,Cash sale,,,,,,22/06/2018,22/06/2018,0.00,,27.97,,"-521,323.53"
,CS,AR,32005586,1005,100,,Cash sale,,,,,,22/06/2018,22/06/2018,0.00,,24.00,,"-521,347.53"
,CS,AR,32005590,1005,100,,Cash sale,,,,,,22/06/2018,22/06/2018,0.00,,3.64,,"-521,351.17"
,CS,AR,32005614,1005,100,,Cash sale,,,,,,22/06/2018,22/06/2018,0.00,,6.86,,"-521,358.03"
,CS,AR,32005619,1005,100,,Cash sale,,,,,,22/06/2018,22/06/2018,0.00,,5.93,,"-521,363.96"
,CS,AR,32005636,1005,100,,Cash sale,,,,,,22/06/2018,22/06/2018,0.00,,27.32,,"-521,391.28"
,CS,AR,32005639,1005,100,,Cash sale,,,,,,22/06/2018,22/06/2018,0.00,,10.93,,"-521,402.21"
,CS,AR,32005643,1005,100,,Cash sale,,,,,,22/06/2018,22/06/2018,0.00,,10.93,,"-521,413.14"
,CS,AR,32005648,1005,100,,Cash sale,,,,,,22/06/2018,22/06/2018,0.00,,3.64,,"-521,416.78"
,CS,AR,32005654,1005,100,,Cash sale,,,,,,22/06/2018,22/06/2018,0.00,,7.29,,"-521,424.07"
,CS,AR,32005655,1005,100,,Cash sale,,,,,,22/06/2018,22/06/2018,0.00,,12.20,,"-521,436.27"
,CS,AR,32005660,1005,100,,Cash sale,,,,,,22/06/2018,22/06/2018,0.00,,7.29,,"-521,443.56"
,CS,AR,32005664,1005,100,,Cash sale,,,,,,22/06/2018,22/06/2018,0.00,,10.93,,"-521,454.49"
,CS,AR,32005672,1005,100,,Cash sale,,,,,,22/06/2018,22/06/2018,0.00,,15.21,,"-521,469.70"
,CS,AR,32005674,1005,100,,Cash sale,,,,,,22/06/2018,22/06/2018,0.00,,29.15,,"-521,498.85"
,CS,AR,32005678,1005,100,,Cash sale,,,,,,22/06/2018,22/06/2018,0.00,,10.93,,"-521,509.78"
,CS,AR,32005693,1005,100,,Cash sale,,,,,,22/06/2018,22/06/2018,0.00,,18.22,,"-521,528.00"
,CS,AR,32005696,1005,100,,Cash sale,,,,,,22/06/2018,22/06/2018,0.00,,7.29,,"-521,535.29"
,CS,AR,32005721,1005,100,,Cash sale,,,,,,22/06/2018,22/06/2018,0.00,,7.29,,"-521,542.58"
,CS,AR,32005737,1005,100,,Cash sale,,,,,,22/06/2018,22/06/2018,0.00,,9.32,,"-521,551.90"
,CS,AR,32005742,1005,100,,Cash sale,,,,,,22/06/2018,22/06/2018,0.00,,6.07,,"-521,557.97"
,IN,AR,30317309,1005,100,,Invoice,,,,,,22/06/2018,22/06/2018,0.00,,50.42,,"-521,608.39"
,IN,AR,30317310,1005,100,,Invoice,,,,,,22/06/2018,22/06/2018,0.00,,5.93,,"-521,614.32"
,IN,AR,30317315,1005,100,,Invoice,,,,,,22/06/2018,22/06/2018,0.00,,40.08,,"-521,654.40"
,IN,AR,30317349,1005,100,,Invoice,,,,,,22/06/2018,22/06/2018,0.00,,16.61,,"-521,671.01"
,IN,AR,30317355,1005,100,,Invoice,,,,,,22/06/2018,22/06/2018,0.00,,21.86,,"-521,692.87"
,IN,AR,30317368,1005,100,,Invoice,,,,,,22/06/2018,22/06/2018,0.00,,31.53,,"-521,724.40"
,IN,AR,30317376,1005,100,,Invoice,,,,,,22/06/2018,22/06/2018,0.00,,16.91,,"-521,741.31"
,IN,AR,30317385,1005,100,,Invoice,,,,,,22/06/2018,22/06/2018,0.00,,10.93,,"-521,752.24"
,IN,AR,30317394,1005,100,,Invoice,,,,,,22/06/2018,22/06/2018,0.00,,65.59,,"-521,817.83"
,IN,AR,30317396,1005,100,,Invoice,,,,,,22/06/2018,22/06/2018,0.00,,13.78,,"-521,831.61"
,IN,AR,30317399,1005,100,,Invoice,,,,,,22/06/2018,22/06/2018,0.00,,97.03,,"-521,928.64"
,IN,AR,30317409,1005,100,,Invoice,,,,,,22/06/2018,22/06/2018,0.00,,45.08,,"-521,973.72"
,IN,AR,30317452,1005,100,,Invoice,,,,,,22/06/2018,22/06/2018,0.00,,40.00,,"-522,013.72"
,IN,AR,30317474,1005,100,,Invoice,,,,,,22/06/2018,22/06/2018,0.00,,11.68,,"-522,025.40"
,IN,AR,30317482,1005,100,,Invoice,,,,,,22/06/2018,22/06/2018,0.00,,7.12,,"-522,032.52"
,IN,AR,30317483,1005,100,,Invoice,,,,,,22/06/2018,22/06/2018,0.00,,85.42,,"-522,117.94"
,IN,AR,30317488,1005,100,,Invoice,,,,,,22/06/2018,22/06/2018,0.00,,22.00,,"-522,139.94"
,IN,AR,30317497,1005,100,,Invoice,,,,,,22/06/2018,22/06/2018,0.00,,22.71,,"-522,162.65"
,IN,AR,30317506,1005,100,,Invoice,,,,,,22/06/2018,22/06/2018,0.00,,13.58,,"-522,176.23"
,IN,AR,30317507,1005,100,,Invoice,,,,,,22/06/2018,22/06/2018,0.00,,13.58,,"-522,189.81"
,IN,AR,30317515,1005,100,,Invoice,,,,,,22/06/2018,22/06/2018,0.00,,46.00,,"-522,235.81"
,IN,AR,30317519,1005,100,,Invoice,,,,,,22/06/2018,22/06/2018,0.00,,18.22,,"-522,254.03"
,IN,AR,30317526,1005,100,,Invoice,,,,,,22/06/2018,22/06/2018,0.00,,13.98,,"-522,268.01"
,IN,AR,30317532,1005,100,,Invoice,,,,,,22/06/2018,22/06/2018,0.00,,23.29,,"-522,291.30"
,IN,AR,30317542,1005,100,,Invoice,,,,,,22/06/2018,22/06/2018,0.00,,7.97,,"-522,299.27"
,IN,AR,30317553,1005,100,,Invoice,,,,,,22/06/2018,22/06/2018,0.00,,2.58,,"-522,301.85"
,IN,AR,30317566,1005,100,,Invoice,,,,,,22/06/2018,22/06/2018,0.00,,7.19,,"-522,309.04"
,IN,AR,30317571,1005,100,,Invoice,,,,,,22/06/2018,22/06/2018,0.00,,7.29,,"-522,316.33"
,IN,AR,30317606,1005,100,,Invoice,,,,,,22/06/2018,22/06/2018,0.00,,28.43,,"-522,344.76"
,IN,AR,30317609,1005,100,,Invoice,,,,,,22/06/2018,22/06/2018,0.00,,7.17,,"-522,351.93"
,IN,AR,30317619,1005,100,,Invoice,,,,,,22/06/2018,22/06/2018,0.00,,"1,093.22",,"-523,445.15"
,IN,AR,30317639,1005,100,,Invoice,,,,,,22/06/2018,22/06/2018,0.00,,69.73,,"-523,514.88"
,IN,AR,30317646,1005,100,,Invoice,,,,,,22/06/2018,22/06/2018,0.00,,5.08,,"-523,519.96"
,IN,AR,30317647,1005,100,,Invoice,,,,,,22/06/2018,22/06/2018,0.00,,114.41,,"-523,634.37"
,IN,AR,30317667,1005,100,,Invoice,,,,,,22/06/2018,22/06/2018,0.00,,7.29,,"-523,641.66"
,IN,AR,30317689,1005,100,,Invoice,,,,,,22/06/2018,22/06/2018,0.00,,71.48,,"-523,713.14"
,IN,AR,30317691,1005,100,,Invoice,,,,,,22/06/2018,22/06/2018,0.00,,6.36,,"-523,719.50"
,IN,AR,30317734,1005,100,,Invoice,,,,,,22/06/2018,22/06/2018,0.00,,10.17,,"-523,729.67"
,IN,AR,30317735,1005,100,,Invoice,,,,,,22/06/2018,22/06/2018,0.00,,2.54,,"-523,732.21"
,IN,AR,30317736,1005,100,,Invoice,,,,,,22/06/2018,22/06/2018,0.00,,10.17,,"-523,742.38"
,IN,AR,30317745,1005,100,,Invoice,,,,,,22/06/2018,22/06/2018,0.00,,5.08,,"-523,747.46"
,IN,AR,30317754,1005,100,,Invoice,,,,,,22/06/2018,22/06/2018,0.00,,14.58,,"-523,762.04"
,IN,AR,30317757,1005,100,,Invoice,,,,,,22/06/2018,22/06/2018,0.00,,6.02,,"-523,768.06"
,IN,AR,30317760,1005,100,,Invoice,,,,,,22/06/2018,22/06/2018,0.00,,7.63,,"-523,775.69"
,IN,AR,30317764,1005,100,,Invoice,,,,,,22/06/2018,22/06/2018,0.00,,18.22,,"-523,793.91"
,IN,AR,30317766,1005,100,,Invoice,,,,,,22/06/2018,22/06/2018,0.00,,30.08,,"-523,823.99"
,IN,AR,30317801,1005,100,,Invoice,,,,,,22/06/2018,22/06/2018,0.00,,22.88,,"-523,846.87"
,IN,AR,30317804,1005,100,,Invoice,,,,,,22/06/2018,22/06/2018,0.00,,15.25,,"-523,862.12"
,IN,AR,30317813,1005,100,,Invoice,,,,,,22/06/2018,22/06/2018,0.00,,14.58,,"-523,876.70"
,IN,AR,30317824,1005,100,,Invoice,,,,,,22/06/2018,22/06/2018,0.00,,25.00,,"-523,901.70"
,IN,AR,30317830,1005,100,,Invoice,,,,,,22/06/2018,22/06/2018,0.00,,9.92,,"-523,911.62"
,IN,AR,30317875,1005,100,,Invoice,,,,,,22/06/2018,22/06/2018,0.00,,11.22,,"-523,922.84"
,IN,AR,30317896,1005,100,,Invoice,,,,,,22/06/2018,22/06/2018,0.00,,14.58,,"-523,937.42"
,IN,AR,30317899,1005,100,,Invoice,,,,,,22/06/2018,22/06/2018,0.00,,14.58,,"-523,952.00"
,IN,AR,30317901,1005,100,,Invoice,,,,,,22/06/2018,22/06/2018,0.00,,10.93,,"-523,962.93"
,IN,AR,30317911,1005,100,,Invoice,,,,,,22/06/2018,22/06/2018,0.00,,61.02,,"-524,023.95"
,IN,AR,30317968,1005,100,,Invoice,,,,,,22/06/2018,22/06/2018,0.00,,24.07,,"-524,048.02"
,IN,AR,30318012,1005,100,,Invoice,,,,,,22/06/2018,22/06/2018,0.00,,4.85,,"-524,052.87"
,IN,AR,30318033,1005,100,,Invoice,,,,,,22/06/2018,22/06/2018,0.00,,14.58,,"-524,067.45"
,IN,AR,30318037,1005,100,,Invoice,,,,,,22/06/2018,22/06/2018,0.00,,14.58,,"-524,082.03"
,IN,AR,30318100,1005,100,,Invoice,,,,,,22/06/2018,22/06/2018,0.00,,42.58,,"-524,124.61"
,IN,AR,30318106,1005,100,,Invoice,,,,,,22/06/2018,22/06/2018,0.00,,49.75,,"-524,174.36"
,IN,AR,30318116,1005,100,,Invoice,,,,,,22/06/2018,22/06/2018,0.00,,40.08,,"-524,214.44"
,IN,AR,30318125,1005,100,,Invoice,,,,,,22/06/2018,22/06/2018,0.00,,12.14,,"-524,226.58"
,IN,AR,30318126,1005,100,,Invoice,,,,,,22/06/2018,22/06/2018,0.00,,7.29,,"-524,233.87"
,IN,AR,30318131,1005,100,,Invoice,,,,,,22/06/2018,22/06/2018,0.00,,21.25,,"-524,255.12"
,IN,AR,30318136,1005,100,,Invoice,,,,,,22/06/2018,22/06/2018,0.00,,43.22,,"-524,298.34"
,IN,AR,30318145,1005,100,,Invoice,,,,,,22/06/2018,22/06/2018,0.00,,14.58,,"-524,312.92"
,IN,AR,30318148,1005,100,,Invoice,,,,,,22/06/2018,22/06/2018,0.00,,44.66,,"-524,357.58"
,IN,AR,30318153,1005,100,,Invoice,,,,,,22/06/2018,22/06/2018,0.00,,2.54,,"-524,360.12"
,IN,AR,30318170,1005,100,,Invoice,,,,,,22/06/2018,22/06/2018,0.00,,21.52,,"-524,381.64"
,IN,AR,30318182,1005,100,,Invoice,,,,,,22/06/2018,22/06/2018,0.00,,22.88,,"-524,404.52"
,IN,AR,30318183,1005,100,,Invoice,,,,,,22/06/2018,22/06/2018,0.00,,15.25,,"-524,419.77"
,IN,AR,30318220,1005,100,,Invoice,,,,,,22/06/2018,22/06/2018,0.00,,30.11,,"-524,449.88"
,IN,AR,30318223,1005,100,,Invoice,,,,,,22/06/2018,22/06/2018,0.00,,60.97,,"-524,510.85"
,IN,AR,30318249,1005,100,,Invoice,,,,,,22/06/2018,22/06/2018,0.00,,9.19,,"-524,520.04"
,IN,AR,30318273,1005,100,,Invoice,,,,,,22/06/2018,22/06/2018,0.00,,7.29,,"-524,527.33"
,IN,AR,30318277,1005,100,,Invoice,,,,,,22/06/2018,22/06/2018,0.00,,5.68,,"-524,533.01"
,IN,AR,30318279,1005,100,,Invoice,,,,,,22/06/2018,22/06/2018,0.00,,14.49,,"-524,547.50"
,IN,AR,30318350,1005,100,,Invoice,,,,,,22/06/2018,22/06/2018,0.00,,12.00,,"-524,559.50"
,IN,AR,30318391,1005,100,,Invoice,,,,,,22/06/2018,22/06/2018,0.00,,10.95,,"-524,570.45"
,IN,AR,30318394,1005,100,,Invoice,,,,,,22/06/2018,22/06/2018,0.00,,10.93,,"-524,581.38"
,IN,AR,30318398,1005,100,,Invoice,,,,,,22/06/2018,22/06/2018,0.00,,31.78,,"-524,613.16"
,IN,AR,30318405,1005,100,,Invoice,,,,,,22/06/2018,22/06/2018,0.00,,29.15,,"-524,642.31"
,IN,AR,30318414,1005,100,,Invoice,,,,,,22/06/2018,22/06/2018,0.00,,182.20,,"-524,824.51"
,IN,AR,30318417,1005,100,,Invoice,,,,,,22/06/2018,22/06/2018,0.00,,7.29,,"-524,831.80"
,IN,AR,30318428,1005,100,,Invoice,,,,,,22/06/2018,22/06/2018,0.00,,8.17,,"-524,839.97"
,IN,AR,30318435,1005,100,,Invoice,,,,,,22/06/2018,22/06/2018,0.00,,10.93,,"-524,850.90"
,IN,AR,30318442,1005,100,,Invoice,,,,,,22/06/2018,22/06/2018,0.00,,5.51,,"-524,856.41"
,IN,AR,30318447,1005,100,,Invoice,,,,,,22/06/2018,22/06/2018,0.00,,7.97,,"-524,864.38"
,IN,AR,30318464,1005,100,,Invoice,,,,,,22/06/2018,22/06/2018,0.00,,9.11,,"-524,873.49"
,IN,AR,30318466,1005,100,,Invoice,,,,,,22/06/2018,22/06/2018,0.00,,12.03,,"-524,885.52"
,IN,AR,30318468,1005,100,,Invoice,,,,,,22/06/2018,22/06/2018,0.00,,2.00,,"-524,887.52"
,IN,AR,30318469,1005,100,,Invoice,,,,,,22/06/2018,22/06/2018,0.00,,4.00,,"-524,891.52"
,IN,AR,30318525,1005,100,,Invoice,,,,,,22/06/2018,22/06/2018,0.00,,18.22,,"-524,909.74"
,IN,AR,30318552,1005,100,,Invoice,,,,,,22/06/2018,22/06/2018,0.00,,29.15,,"-524,938.89"
,CS,AR,32005281,1005,100,,Cash sale,,,,,,23/06/2018,23/06/2018,0.00,,9.03,,"-524,947.92"
,CS,AR,32005321,1005,100,,Cash sale,,,,,,23/06/2018,23/06/2018,0.00,,10.93,,"-524,958.85"
,CS,AR,32005385,1005,100,,Cash sale,,,,,,23/06/2018,23/06/2018,0.00,,12.03,,"-524,970.88"
,CS,AR,32005426,1005,100,,Cash sale,,,,,,23/06/2018,23/06/2018,0.00,,10.93,,"-524,981.81"
,CS,AR,32005485,1005,100,,Cash sale,,,,,,23/06/2018,23/06/2018,0.00,,6.02,,"-524,987.83"
,CS,AR,32005514,1005,100,,Cash sale,,,,,,23/06/2018,23/06/2018,0.00,,14.58,,"-525,002.41"
,CS,AR,32005520,1005,100,,Cash sale,,,,,,23/06/2018,23/06/2018,0.00,,10.93,,"-525,013.34"
,CS,AR,32005560,1005,100,,Cash sale,,,,,,23/06/2018,23/06/2018,0.00,,3.64,,"-525,016.98"
,CS,AR,32005569,1005,100,,Cash sale,,,,,,23/06/2018,23/06/2018,0.00,,14.58,,"-525,031.56"
,CS,AR,32005606,1005,100,,Cash sale,,,,,,23/06/2018,23/06/2018,0.00,,20.34,,"-525,051.90"
,CS,AR,32005626,1005,100,,Cash sale,,,,,,23/06/2018,23/06/2018,0.00,,4.24,,"-525,056.14"
,CS,AR,32005659,1005,100,,Cash sale,,,,,,23/06/2018,23/06/2018,0.00,,10.93,,"-525,067.07"
,CS,AR,32005675,1005,100,,Cash sale,,,,,,23/06/2018,23/06/2018,0.00,,10.93,,"-525,078.00"
,CS,AR,32005710,1005,100,,Cash sale,,,,,,23/06/2018,23/06/2018,0.00,,10.93,,"-525,088.93"
,CS,AR,32005711,1005,100,,Cash sale,,,,,,23/06/2018,23/06/2018,0.00,,3.64,,"-525,092.57"
,CS,AR,32005716,1005,100,,Cash sale,,,,,,23/06/2018,23/06/2018,0.00,,5.94,,"-525,098.51"
,CS,AR,32005740,1005,100,,Cash sale,,,,,,23/06/2018,23/06/2018,0.00,,10.93,,"-525,109.44"
,CS,AR,32005747,1005,100,,Cash sale,,,,,,23/06/2018,23/06/2018,0.00,,7.29,,"-525,116.73"
,IN,AR,30317322,1005,100,,Invoice,,,,,,23/06/2018,23/06/2018,0.00,,18.98,,"-525,135.71"
,IN,AR,30317410,1005,100,,Invoice,,,,,,23/06/2018,23/06/2018,0.00,,49.83,,"-525,185.54"
,IN,AR,30317426,1005,100,,Invoice,,,,,,23/06/2018,23/06/2018,0.00,,14.58,,"-525,200.12"
,IN,AR,30317523,1005,100,,Invoice,,,,,,23/06/2018,23/06/2018,0.00,,29.15,,"-525,229.27"
,IN,AR,30317762,1005,100,,Invoice,,,,,,23/06/2018,23/06/2018,0.00,,6.48,,"-525,235.75"
,IN,AR,30317845,1005,100,,Invoice,,,,,,23/06/2018,23/06/2018,0.00,,12.03,,"-525,247.78"
,IN,AR,30318142,1005,100,,Invoice,,,,,,23/06/2018,23/06/2018,0.00,,14.58,,"-525,262.36"
,IN,AR,30318201,1005,100,,Invoice,,,,,,23/06/2018,23/06/2018,0.00,,20.01,,"-525,282.37"
,IN,AR,30318216,1005,100,,Invoice,,,,,,23/06/2018,23/06/2018,0.00,,10.93,,"-525,293.30"
,IN,AR,30318282,1005,100,,Invoice,,,,,,23/06/2018,23/06/2018,0.00,,1.61,,"-525,294.91"
,IN,AR,30318529,1005,100,,Invoice,,,,,,23/06/2018,23/06/2018,0.00,,3.28,,"-525,298.19"
,IN,AR,30318542,1005,100,,Invoice,,,,,,23/06/2018,23/06/2018,0.00,,7.29,,"-525,305.48"
,IN,AR,30318554,1005,100,,Invoice,,,,,,23/06/2018,23/06/2018,0.00,,72.88,,"-525,378.36"
,IN,AR,30317923,1005,100,,Invoice,,,,,,24/06/2018,24/06/2018,0.00,,29.15,,"-525,407.51"
,CN,AR,31018235,1005,100,,Credit Note,,,,,,25/06/2018,25/06/2018,7.29,,0.00,,"-525,400.22"
,CS,AR,32005264,1005,100,,Cash sale,,,,,,25/06/2018,25/06/2018,0.00,,14.03,,"-525,414.25"
,CS,AR,32005282,1005,100,,Cash sale,,,,,,25/06/2018,25/06/2018,0.00,,3.64,,"-525,417.89"
,CS,AR,32005285,1005,100,,Cash sale,,,,,,25/06/2018,25/06/2018,0.00,,10.93,,"-525,428.82"
,CS,AR,32005295,1005,100,,Cash sale,,,,,,25/06/2018,25/06/2018,0.00,,10.93,,"-525,439.75"
,CS,AR,32005329,1005,100,,Cash sale,,,,,,25/06/2018,25/06/2018,0.00,,12.46,,"-525,452.21"
,CS,AR,32005337,1005,100,,Cash sale,,,,,,25/06/2018,25/06/2018,0.00,,10.93,,"-525,463.14"
,CS,AR,32005343,1005,100,,Cash sale,,,,,,25/06/2018,25/06/2018,0.00,,10.93,,"-525,474.07"
,CS,AR,32005368,1005,100,,Cash sale,,,,,,25/06/2018,25/06/2018,0.00,,3.64,,"-525,477.71"
,CS,AR,32005370,1005,100,,Cash sale,,,,,,25/06/2018,25/06/2018,0.00,,7.75,,"-525,485.46"
,CS,AR,32005387,1005,100,,Cash sale,,,,,,25/06/2018,25/06/2018,0.00,,3.64,,"-525,489.10"
,CS,AR,32005411,1005,100,,Cash sale,,,,,,25/06/2018,25/06/2018,0.00,,5.49,,"-525,494.59"
,CS,AR,32005415,1005,100,,Cash sale,,,,,,25/06/2018,25/06/2018,0.00,,7.29,,"-525,501.88"
,CS,AR,32005422,1005,100,,Cash sale,,,,,,25/06/2018,25/06/2018,0.00,,3.64,,"-525,505.52"
,CS,AR,32005425,1005,100,,Cash sale,,,,,,25/06/2018,25/06/2018,0.00,,3.64,,"-525,509.16"
,CS,AR,32005428,1005,100,,Cash sale,,,,,,25/06/2018,25/06/2018,0.00,,11.65,,"-525,520.81"
,CS,AR,32005434,1005,100,,Cash sale,,,,,,25/06/2018,25/06/2018,0.00,,2.54,,"-525,523.35"
,CS,AR,32005441,1005,100,,Cash sale,,,,,,25/06/2018,25/06/2018,0.00,,17.54,,"-525,540.89"
,CS,AR,32005443,1005,100,,Cash sale,,,,,,25/06/2018,25/06/2018,0.00,,6.74,,"-525,547.63"
,CS,AR,32005444,1005,100,,Cash sale,,,,,,25/06/2018,25/06/2018,0.00,,3.64,,"-525,551.27"
,CS,AR,32005446,1005,100,,Cash sale,,,,,,25/06/2018,25/06/2018,0.00,,7.12,,"-525,558.39"
,CS,AR,32005447,1005,100,,Cash sale,,,,,,25/06/2018,25/06/2018,0.00,,7.17,,"-525,565.56"
,CS,AR,32005462,1005,100,,Cash sale,,,,,,25/06/2018,25/06/2018,0.00,,14.58,,"-525,580.14"
,CS,AR,32005471,1005,100,,Cash sale,,,,,,25/06/2018,25/06/2018,0.00,,3.64,,"-525,583.78"
,CS,AR,32005476,1005,100,,Cash sale,,,,,,25/06/2018,25/06/2018,0.00,,60.17,,"-525,643.95"
,CS,AR,32005479,1005,100,,Cash sale,,,,,,25/06/2018,25/06/2018,0.00,,15.76,,"-525,659.71"
,CS,AR,32005481,1005,100,,Cash sale,,,,,,25/06/2018,25/06/2018,0.00,,5.08,,"-525,664.79"
,CS,AR,32005496,1005,100,,Cash sale,,,,,,25/06/2018,25/06/2018,0.00,,7.29,,"-525,672.08"
,CS,AR,32005497,1005,100,,Cash sale,,,,,,25/06/2018,25/06/2018,0.00,,5.17,,"-525,677.25"
,CS,AR,32005499,1005,100,,Cash sale,,,,,,25/06/2018,25/06/2018,0.00,,5.85,,"-525,683.10"
,CS,AR,32005505,1005,100,,Cash sale,,,,,,25/06/2018,25/06/2018,0.00,,7.29,,"-525,690.39"
,CS,AR,32005508,1005,100,,Cash sale,,,,,,25/06/2018,25/06/2018,0.00,,10.93,,"-525,701.32"
,CS,AR,32005518,1005,100,,Cash sale,,,,,,25/06/2018,25/06/2018,0.00,,7.29,,"-525,708.61"
,CS,AR,32005526,1005,100,,Cash sale,,,,,,25/06/2018,25/06/2018,0.00,,6.02,,"-525,714.63"
,CS,AR,32005527,1005,100,,Cash sale,,,,,,25/06/2018,25/06/2018,0.00,,21.86,,"-525,736.49"
,CS,AR,32005529,1005,100,,Cash sale,,,,,,25/06/2018,25/06/2018,0.00,,5.17,,"-525,741.66"
,CS,AR,32005531,1005,100,,Cash sale,,,,,,25/06/2018,25/06/2018,0.00,,3.20,,"-525,744.86"
,CS,AR,32005534,1005,100,,Cash sale,,,,,,25/06/2018,25/06/2018,0.00,,6.08,,"-525,750.94"
,CS,AR,32005538,1005,100,,Cash sale,,,,,,25/06/2018,25/06/2018,0.00,,3.64,,"-525,754.58"
,CS,AR,32005550,1005,100,,Cash sale,,,,,,25/06/2018,25/06/2018,0.00,,7.29,,"-525,761.87"
,CS,AR,32005554,1005,100,,Cash sale,,,,,,25/06/2018,25/06/2018,0.00,,11.86,,"-525,773.73"
,CS,AR,32005555,1005,100,,Cash sale,,,,,,25/06/2018,25/06/2018,0.00,,10.93,,"-525,784.66"
,CS,AR,32005566,1005,100,,Cash sale,,,,,,25/06/2018,25/06/2018,0.00,,17.80,,"-525,802.46"
,CS,AR,32005573,1005,100,,Cash sale,,,,,,25/06/2018,25/06/2018,0.00,,2.58,,"-525,805.04"
,CS,AR,32005597,1005,100,,Cash sale,,,,,,25/06/2018,25/06/2018,0.00,,7.29,,"-525,812.33"
,CS,AR,32005604,1005,100,,Cash sale,,,,,,25/06/2018,25/06/2018,0.00,,9.84,,"-525,822.17"
,CS,AR,32005615,1005,100,,Cash sale,,,,,,25/06/2018,25/06/2018,0.00,,11.44,,"-525,833.61"
,CS,AR,32005618,1005,100,,Cash sale,,,,,,25/06/2018,25/06/2018,0.00,,7.29,,"-525,840.90"
,CS,AR,32005629,1005,100,,Cash sale,,,,,,25/06/2018,25/06/2018,0.00,,7.29,,"-525,848.19"
,CS,AR,32005634,1005,100,,Cash sale,,,,,,25/06/2018,25/06/2018,0.00,,60.71,,"-525,908.90"
,CS,AR,32005644,1005,100,,Cash sale,,,,,,25/06/2018,25/06/2018,0.00,,7.29,,"-525,916.19"
,CS,AR,32005669,1005,100,,Cash sale,,,,,,25/06/2018,25/06/2018,0.00,,7.29,,"-525,923.48"
,CS,AR,32005681,1005,100,,Cash sale,,,,,,25/06/2018,25/06/2018,0.00,,3.64,,"-525,927.12"
,CS,AR,32005697,1005,100,,Cash sale,,,,,,25/06/2018,25/06/2018,0.00,,10.93,,"-525,938.05"
,CS,AR,32005702,1005,100,,Cash sale,,,,,,25/06/2018,25/06/2018,0.00,,7.29,,"-525,945.34"
,CS,AR,32005713,1005,100,,Cash sale,,,,,,25/06/2018,25/06/2018,0.00,,3.64,,"-525,948.98"
,CS,AR,32005738,1005,100,,Cash sale,,,,,,25/06/2018,25/06/2018,0.00,,9.32,,"-525,958.30"
,CS,AR,32005746,1005,100,,Cash sale,,,,,,25/06/2018,25/06/2018,0.00,,3.64,,"-525,961.94"
,IN,AR,30317311,1005,100,,Invoice,,,,,,25/06/2018,25/06/2018,0.00,,56.36,,"-526,018.30"
,IN,AR,30317312,1005,100,,Invoice,,,,,,25/06/2018,25/06/2018,0.00,,2.97,,"-526,021.27"
,IN,AR,30317318,1005,100,,Invoice,,,,,,25/06/2018,25/06/2018,0.00,,7.29,,"-526,028.56"
,IN,AR,30317320,1005,100,,Invoice,,,,,,25/06/2018,25/06/2018,0.00,,21.86,,"-526,050.42"
,IN,AR,30317343,1005,100,,Invoice,,,,,,25/06/2018,25/06/2018,0.00,,10.13,,"-526,060.55"
,IN,AR,30317344,1005,100,,Invoice,,,,,,25/06/2018,25/06/2018,0.00,,2.03,,"-526,062.58"
,IN,AR,30317345,1005,100,,Invoice,,,,,,25/06/2018,25/06/2018,0.00,,4.05,,"-526,066.63"
,IN,AR,30317346,1005,100,,Invoice,,,,,,25/06/2018,25/06/2018,0.00,,8.10,,"-526,074.73"
,IN,AR,30317347,1005,100,,Invoice,,,,,,25/06/2018,25/06/2018,0.00,,16.20,,"-526,090.93"
,IN,AR,30317348,1005,100,,Invoice,,,,,,25/06/2018,25/06/2018,0.00,,12.15,,"-526,103.08"
,IN,AR,30317350,1005,100,,Invoice,,,,,,25/06/2018,25/06/2018,0.00,,14.24,,"-526,117.32"
,IN,AR,30317388,1005,100,,Invoice,,,,,,25/06/2018,25/06/2018,0.00,,86.65,,"-526,203.97"
,IN,AR,30317400,1005,100,,Invoice,,,,,,25/06/2018,25/06/2018,0.00,,11.64,,"-526,215.61"
,IN,AR,30317411,1005,100,,Invoice,,,,,,25/06/2018,25/06/2018,0.00,,97.29,,"-526,312.90"
,IN,AR,30317420,1005,100,,Invoice,,,,,,25/06/2018,25/06/2018,0.00,,19.28,,"-526,332.18"
,IN,AR,30317429,1005,100,,Invoice,,,,,,25/06/2018,25/06/2018,0.00,,44.00,,"-526,376.18"
,IN,AR,30317430,1005,100,,Invoice,,,,,,25/06/2018,25/06/2018,0.00,,10.00,,"-526,386.18"
,IN,AR,30317437,1005,100,,Invoice,,,,,,25/06/2018,25/06/2018,0.00,,182.20,,"-526,568.38"
,IN,AR,30317439,1005,100,,Invoice,,,,,,25/06/2018,25/06/2018,0.00,,63.63,,"-526,632.01"
,IN,AR,30317453,1005,100,,Invoice,,,,,,25/06/2018,25/06/2018,0.00,,36.00,,"-526,668.01"
,IN,AR,30317454,1005,100,,Invoice,,,,,,25/06/2018,25/06/2018,0.00,,28.00,,"-526,696.01"
,IN,AR,30317460,1005,100,,Invoice,,,,,,25/06/2018,25/06/2018,0.00,,2.75,,"-526,698.76"
,IN,AR,30317462,1005,100,,Invoice,,,,,,25/06/2018,25/06/2018,0.00,,40.68,,"-526,739.44"
,IN,AR,30317464,1005,100,,Invoice,,,,,,25/06/2018,25/06/2018,0.00,,5.51,,"-526,744.95"
,IN,AR,30317472,1005,100,,Invoice,,,,,,25/06/2018,25/06/2018,0.00,,3.64,,"-526,748.59"
,IN,AR,30317475,1005,100,,Invoice,,,,,,25/06/2018,25/06/2018,0.00,,5.84,,"-526,754.43"
,IN,AR,30317489,1005,100,,Invoice,,,,,,25/06/2018,25/06/2018,0.00,,20.00,,"-526,774.43"
,IN,AR,30317503,1005,100,,Invoice,,,,,,25/06/2018,25/06/2018,0.00,,488.10,,"-527,262.53"
,IN,AR,30317504,1005,100,,Invoice,,,,,,25/06/2018,25/06/2018,0.00,,780.96,,"-528,043.49"
,IN,AR,30317516,1005,100,,Invoice,,,,,,25/06/2018,25/06/2018,0.00,,22.00,,"-528,065.49"
,IN,AR,30317531,1005,100,,Invoice,,,,,,25/06/2018,25/06/2018,0.00,,9.66,,"-528,075.15"
,IN,AR,30317536,1005,100,,Invoice,,,,,,25/06/2018,25/06/2018,0.00,,25.55,,"-528,100.70"
,IN,AR,30317546,1005,100,,Invoice,,,,,,25/06/2018,25/06/2018,0.00,,23.26,,"-528,123.96"
,IN,AR,30317556,1005,100,,Invoice,,,,,,25/06/2018,25/06/2018,0.00,,15.51,,"-528,139.47"
,IN,AR,30317569,1005,100,,Invoice,,,,,,25/06/2018,25/06/2018,0.00,,13.78,,"-528,153.25"
,IN,AR,30317586,1005,100,,Invoice,,,,,,25/06/2018,25/06/2018,0.00,,4.24,,"-528,157.49"
,IN,AR,30317589,1005,100,,Invoice,,,,,,25/06/2018,25/06/2018,0.00,,61.02,,"-528,218.51"
,IN,AR,30317607,1005,100,,Invoice,,,,,,25/06/2018,25/06/2018,0.00,,25.85,,"-528,244.36"
,IN,AR,30317621,1005,100,,Invoice,,,,,,25/06/2018,25/06/2018,0.00,,7.29,,"-528,251.65"
,IN,AR,30317640,1005,100,,Invoice,,,,,,25/06/2018,25/06/2018,0.00,,84.08,,"-528,335.73"
,IN,AR,30317648,1005,100,,Invoice,,,,,,25/06/2018,25/06/2018,0.00,,35.59,,"-528,371.32"
,IN,AR,30317657,1005,100,,Invoice,,,,,,25/06/2018,25/06/2018,0.00,,23.90,,"-528,395.22"
,IN,AR,30317661,1005,100,,Invoice,,,,,,25/06/2018,25/06/2018,0.00,,32.20,,"-528,427.42"
,IN,AR,30317685,1005,100,,Invoice,,,,,,25/06/2018,25/06/2018,0.00,,8.26,,"-528,435.68"
,IN,AR,30317687,1005,100,,Invoice,,,,,,25/06/2018,25/06/2018,0.00,,4.24,,"-528,439.92"
,IN,AR,30317693,1005,100,,Invoice,,,,,,25/06/2018,25/06/2018,0.00,,6.02,,"-528,445.94"
,IN,AR,30317701,1005,100,,Invoice,,,,,,25/06/2018,25/06/2018,0.00,,1.44,,"-528,447.38"
,IN,AR,30317702,1005,100,,Invoice,,,,,,25/06/2018,25/06/2018,0.00,,10.08,,"-528,457.46"
,IN,AR,30317737,1005,100,,Invoice,,,,,,25/06/2018,25/06/2018,0.00,,10.17,,"-528,467.63"
,IN,AR,30317767,1005,100,,Invoice,,,,,,25/06/2018,25/06/2018,0.00,,12.03,,"-528,479.66"
,IN,AR,30317768,1005,100,,Invoice,,,,,,25/06/2018,25/06/2018,0.00,,18.05,,"-528,497.71"
,IN,AR,30317807,1005,100,,Invoice,,,,,,25/06/2018,25/06/2018,0.00,,23.31,,"-528,521.02"
,IN,AR,30317811,1005,100,,Invoice,,,,,,25/06/2018,25/06/2018,0.00,,7.17,,"-528,528.19"
,IN,AR,30317820,1005,100,,Invoice,,,,,,25/06/2018,25/06/2018,0.00,,33.05,,"-528,561.24"
,IN,AR,30317827,1005,100,,Invoice,,,,,,25/06/2018,25/06/2018,0.00,,16.27,,"-528,577.51"
,IN,AR,30317847,1005,100,,Invoice,,,,,,25/06/2018,25/06/2018,0.00,,14.58,,"-528,592.09"
,IN,AR,30317863,1005,100,,Invoice,,,,,,25/06/2018,25/06/2018,0.00,,8.26,,"-528,600.35"
,IN,AR,30317872,1005,100,,Invoice,,,,,,25/06/2018,25/06/2018,0.00,,13.78,,"-528,614.13"
,IN,AR,30317900,1005,100,,Invoice,,,,,,25/06/2018,25/06/2018,0.00,,6.36,,"-528,620.49"
,IN,AR,30317907,1005,100,,Invoice,,,,,,25/06/2018,25/06/2018,0.00,,7.29,,"-528,627.78"
,IN,AR,30317909,1005,100,,Invoice,,,,,,25/06/2018,25/06/2018,0.00,,69.92,,"-528,697.70"
,IN,AR,30317919,1005,100,,Invoice,,,,,,25/06/2018,25/06/2018,0.00,,24.00,,"-528,721.70"
,IN,AR,30317943,1005,100,,Invoice,,,,,,25/06/2018,25/06/2018,0.00,,7.75,,"-528,729.45"
,IN,AR,30317952,1005,100,,Invoice,,,,,,25/06/2018,25/06/2018,0.00,,54.66,,"-528,784.11"
,IN,AR,30317954,1005,100,,Invoice,,,,,,25/06/2018,25/06/2018,0.00,,36.12,,"-528,820.23"
,IN,AR,30317963,1005,100,,Invoice,,,,,,25/06/2018,25/06/2018,0.00,,8.98,,"-528,829.21"
,IN,AR,30317978,1005,100,,Invoice,,,,,,25/06/2018,25/06/2018,0.00,,54.66,,"-528,883.87"
,IN,AR,30317998,1005,100,,Invoice,,,,,,25/06/2018,25/06/2018,0.00,,8.81,,"-528,892.68"
,IN,AR,30318007,1005,100,,Invoice,,,,,,25/06/2018,25/06/2018,0.00,,18.22,,"-528,910.90"
,IN,AR,30318011,1005,100,,Invoice,,,,,,25/06/2018,25/06/2018,0.00,,54.66,,"-528,965.56"
,IN,AR,30318025,1005,100,,Invoice,,,,,,25/06/2018,25/06/2018,0.00,,364.41,,"-529,329.97"
,IN,AR,30318034,1005,100,,Invoice,,,,,,25/06/2018,25/06/2018,0.00,,7.29,,"-529,337.26"
,IN,AR,30318058,1005,100,,Invoice,,,,,,25/06/2018,25/06/2018,0.00,,4.29,,"-529,341.55"
,IN,AR,30318108,1005,100,,Invoice,,,,,,25/06/2018,25/06/2018,0.00,,4.29,,"-529,345.84"
,IN,AR,30318117,1005,100,,Invoice,,,,,,25/06/2018,25/06/2018,0.00,,26.06,,"-529,371.90"
,IN,AR,30318119,1005,100,,Invoice,,,,,,25/06/2018,25/06/2018,0.00,,7.29,,"-529,379.19"
,IN,AR,30318143,1005,100,,Invoice,,,,,,25/06/2018,25/06/2018,0.00,,18.22,,"-529,397.41"
,IN,AR,30318149,1005,100,,Invoice,,,,,,25/06/2018,25/06/2018,0.00,,39.41,,"-529,436.82"
,IN,AR,30318152,1005,100,,Invoice,,,,,,25/06/2018,25/06/2018,0.00,,4.58,,"-529,441.40"
,IN,AR,30318156,1005,100,,Invoice,,,,,,25/06/2018,25/06/2018,0.00,,18.22,,"-529,459.62"
,IN,AR,30318174,1005,100,,Invoice,,,,,,25/06/2018,25/06/2018,0.00,,29.15,,"-529,488.77"
,IN,AR,30318192,1005,100,,Invoice,,,,,,25/06/2018,25/06/2018,0.00,,16.01,,"-529,504.78"
,IN,AR,30318195,1005,100,,Invoice,,,,,,25/06/2018,25/06/2018,0.00,,22.01,,"-529,526.79"
,IN,AR,30318202,1005,100,,Invoice,,,,,,25/06/2018,25/06/2018,0.00,,14.00,,"-529,540.79"
,IN,AR,30318209,1005,100,,Invoice,,,,,,25/06/2018,25/06/2018,0.00,,99.36,,"-529,640.15"
,IN,AR,30318212,1005,100,,Invoice,,,,,,25/06/2018,25/06/2018,0.00,,36.20,,"-529,676.35"
,IN,AR,30318224,1005,100,,Invoice,,,,,,25/06/2018,25/06/2018,0.00,,8.41,,"-529,684.76"
,IN,AR,30318237,1005,100,,Invoice,,,,,,25/06/2018,25/06/2018,0.00,,31.41,,"-529,716.17"
,IN,AR,30318239,1005,100,,Invoice,,,,,,25/06/2018,25/06/2018,0.00,,207.42,,"-529,923.59"
,IN,AR,30318246,1005,100,,Invoice,,,,,,25/06/2018,25/06/2018,0.00,,19.64,,"-529,943.23"
,IN,AR,30318248,1005,100,,Invoice,,,,,,25/06/2018,25/06/2018,0.00,,29.15,,"-529,972.38"
,IN,AR,30318252,1005,100,,Invoice,,,,,,25/06/2018,25/06/2018,0.00,,60.17,,"-530,032.55"
,IN,AR,30318261,1005,100,,Invoice,,,,,,25/06/2018,25/06/2018,0.00,,14.58,,"-530,047.13"
,IN,AR,30318284,1005,100,,Invoice,,,,,,25/06/2018,25/06/2018,0.00,,26.69,,"-530,073.82"
,IN,AR,30318295,1005,100,,Invoice,,,,,,25/06/2018,25/06/2018,0.00,,25.49,,"-530,099.31"
,IN,AR,30318351,1005,100,,Invoice,,,,,,25/06/2018,25/06/2018,0.00,,10.00,,"-530,109.31"
,IN,AR,30318360,1005,100,,Invoice,,,,,,25/06/2018,25/06/2018,0.00,,3.76,,"-530,113.07"
,IN,AR,30318370,1005,100,,Invoice,,,,,,25/06/2018,25/06/2018,0.00,,9.08,,"-530,122.15"
,IN,AR,30318392,1005,100,,Invoice,,,,,,25/06/2018,25/06/2018,0.00,,5.47,,"-530,127.62"
,IN,AR,30318413,1005,100,,Invoice,,,,,,25/06/2018,25/06/2018,0.00,,7.29,,"-530,134.91"
,IN,AR,30318429,1005,100,,Invoice,,,,,,25/06/2018,25/06/2018,0.00,,6.13,,"-530,141.04"
,IN,AR,30318445,1005,100,,Invoice,,,,,,25/06/2018,25/06/2018,0.00,,54.66,,"-530,195.70"
,IN,AR,30318452,1005,100,,Invoice,,,,,,25/06/2018,25/06/2018,0.00,,46.78,,"-530,242.48"
,IN,AR,30318486,1005,100,,Invoice,,,,,,25/06/2018,25/06/2018,0.00,,4.15,,"-530,246.63"
,IN,AR,30318487,1005,100,,Invoice,,,,,,25/06/2018,25/06/2018,0.00,,4.15,,"-530,250.78"
,IN,AR,30318488,1005,100,,Invoice,,,,,,25/06/2018,25/06/2018,0.00,,4.15,,"-530,254.93"
,IN,AR,30318505,1005,100,,Invoice,,,,,,25/06/2018,25/06/2018,0.00,,6.56,,"-530,261.49"
,IN,AR,30318513,1005,100,,Invoice,,,,,,25/06/2018,25/06/2018,0.00,,39.44,,"-530,300.93"
,IN,AR,30318526,1005,100,,Invoice,,,,,,25/06/2018,25/06/2018,0.00,,18.22,,"-530,319.15"
,IN,AR,30318551,1005,100,,Invoice,,,,,,25/06/2018,25/06/2018,0.00,,3.51,,"-530,322.66"
,IN,AR,30318560,1005,100,,Invoice,,,,,,25/06/2018,25/06/2018,0.00,,68.61,,"-530,391.27"
,IN,AR,30318561,1005,100,,Invoice,,,,,,25/06/2018,25/06/2018,0.00,,49.31,,"-530,440.58"
,IN,AR,30318562,1005,100,,Invoice,,,,,,25/06/2018,25/06/2018,0.00,,53.60,,"-530,494.18"
,CN,AR,31018276,1005,100,,Credit Note,,,,,,26/06/2018,26/06/2018,10.93,,0.00,,"-530,483.25"
,CN,AR,31018302,1005,100,,Credit Note,,,,,,26/06/2018,26/06/2018,10.93,,0.00,,"-530,472.32"
,CN,AR,31018309,1005,100,,Credit Note,,,,,,26/06/2018,26/06/2018,72.88,,0.00,,"-530,399.44"
,CN,AR,31018312,1005,100,,Credit Note,,,,,,26/06/2018,26/06/2018,29.15,,0.00,,"-530,370.29"
,CS,AR,32005276,1005,100,,Cash sale,,,,,,26/06/2018,26/06/2018,0.00,,3.64,,"-530,373.93"
,CS,AR,32005288,1005,100,,Cash sale,,,,,,26/06/2018,26/06/2018,0.00,,3.64,,"-530,377.57"
,CS,AR,32005290,1005,100,,Cash sale,,,,,,26/06/2018,26/06/2018,0.00,,14.58,,"-530,392.15"
,CS,AR,32005314,1005,100,,Cash sale,,,,,,26/06/2018,26/06/2018,0.00,,6.02,,"-530,398.17"
,CS,AR,32005319,1005,100,,Cash sale,,,,,,26/06/2018,26/06/2018,0.00,,10.93,,"-530,409.10"
,CS,AR,32005323,1005,100,,Cash sale,,,,,,26/06/2018,26/06/2018,0.00,,10.93,,"-530,420.03"
,CS,AR,32005346,1005,100,,Cash sale,,,,,,26/06/2018,26/06/2018,0.00,,18.22,,"-530,438.25"
,CS,AR,32005353,1005,100,,Cash sale,,,,,,26/06/2018,26/06/2018,0.00,,7.29,,"-530,445.54"
,CS,AR,32005355,1005,100,,Cash sale,,,,,,26/06/2018,26/06/2018,0.00,,3.64,,"-530,449.18"
,CS,AR,32005374,1005,100,,Cash sale,,,,,,26/06/2018,26/06/2018,0.00,,10.17,,"-530,459.35"
,CS,AR,32005376,1005,100,,Cash sale,,,,,,26/06/2018,26/06/2018,0.00,,14.58,,"-530,473.93"
,CS,AR,32005384,1005,100,,Cash sale,,,,,,26/06/2018,26/06/2018,0.00,,4.32,,"-530,478.25"
,CS,AR,32005399,1005,100,,Cash sale,,,,,,26/06/2018,26/06/2018,0.00,,5.17,,"-530,483.42"
,CS,AR,32005418,1005,100,,Cash sale,,,,,,26/06/2018,26/06/2018,0.00,,14.58,,"-530,498.00"
,CS,AR,32005430,1005,100,,Cash sale,,,,,,26/06/2018,26/06/2018,0.00,,3.64,,"-530,501.64"
,CS,AR,32005445,1005,100,,Cash sale,,,,,,26/06/2018,26/06/2018,0.00,,7.29,,"-530,508.93"
,CS,AR,32005465,1005,100,,Cash sale,,,,,,26/06/2018,26/06/2018,0.00,,2.54,,"-530,511.47"
,CS,AR,32005469,1005,100,,Cash sale,,,,,,26/06/2018,26/06/2018,0.00,,10.34,,"-530,521.81"
,CS,AR,32005484,1005,100,,Cash sale,,,,,,26/06/2018,26/06/2018,0.00,,7.75,,"-530,529.56"
,CS,AR,32005488,1005,100,,Cash sale,,,,,,26/06/2018,26/06/2018,0.00,,3.90,,"-530,533.46"
,CS,AR,32005491,1005,100,,Cash sale,,,,,,26/06/2018,26/06/2018,0.00,,9.66,,"-530,543.12"
,CS,AR,32005493,1005,100,,Cash sale,,,,,,26/06/2018,26/06/2018,0.00,,3.64,,"-530,546.76"
,CS,AR,32005504,1005,100,,Cash sale,,,,,,26/06/2018,26/06/2018,0.00,,3.64,,"-530,550.40"
,CS,AR,32005510,1005,100,,Cash sale,,,,,,26/06/2018,26/06/2018,0.00,,3.01,,"-530,553.41"
,CS,AR,32005523,1005,100,,Cash sale,,,,,,26/06/2018,26/06/2018,0.00,,5.17,,"-530,558.58"
,CS,AR,32005542,1005,100,,Cash sale,,,,,,26/06/2018,26/06/2018,0.00,,19.30,,"-530,577.88"
,CS,AR,32005543,1005,100,,Cash sale,,,,,,26/06/2018,26/06/2018,0.00,,8.02,,"-530,585.90"
,CS,AR,32005546,1005,100,,Cash sale,,,,,,26/06/2018,26/06/2018,0.00,,5.17,,"-530,591.07"
,CS,AR,32005548,1005,100,,Cash sale,,,,,,26/06/2018,26/06/2018,0.00,,16.02,,"-530,607.09"
,CS,AR,32005563,1005,100,,Cash sale,,,,,,26/06/2018,26/06/2018,0.00,,29.15,,"-530,636.24"
,CS,AR,32005582,1005,100,,Cash sale,,,,,,26/06/2018,26/06/2018,0.00,,17.80,,"-530,654.04"
,CS,AR,32005585,1005,100,,Cash sale,,,,,,26/06/2018,26/06/2018,0.00,,20.00,,"-530,674.04"
,CS,AR,32005587,1005,100,,Cash sale,,,,,,26/06/2018,26/06/2018,0.00,,38.00,,"-530,712.04"
,CS,AR,32005596,1005,100,,Cash sale,,,,,,26/06/2018,26/06/2018,0.00,,2.75,,"-530,714.79"
,CS,AR,32005607,1005,100,,Cash sale,,,,,,26/06/2018,26/06/2018,0.00,,7.29,,"-530,722.08"
,CS,AR,32005620,1005,100,,Cash sale,,,,,,26/06/2018,26/06/2018,0.00,,10.93,,"-530,733.01"
,CS,AR,32005632,1005,100,,Cash sale,,,,,,26/06/2018,26/06/2018,0.00,,2.75,,"-530,735.76"
,CS,AR,32005638,1005,100,,Cash sale,,,,,,26/06/2018,26/06/2018,0.00,,10.93,,"-530,746.69"
,CS,AR,32005641,1005,100,,Cash sale,,,,,,26/06/2018,26/06/2018,0.00,,5.47,,"-530,752.16"
,CS,AR,32005647,1005,100,,Cash sale,,,,,,26/06/2018,26/06/2018,0.00,,10.93,,"-530,763.09"
,CS,AR,32005652,1005,100,,Cash sale,,,,,,26/06/2018,26/06/2018,0.00,,5.08,,"-530,768.17"
,CS,AR,32005658,1005,100,,Cash sale,,,,,,26/06/2018,26/06/2018,0.00,,3.64,,"-530,771.81"
,CS,AR,32005663,1005,100,,Cash sale,,,,,,26/06/2018,26/06/2018,0.00,,6.07,,"-530,777.88"
,CS,AR,32005677,1005,100,,Cash sale,,,,,,26/06/2018,26/06/2018,0.00,,7.29,,"-530,785.17"
,CS,AR,32005689,1005,100,,Cash sale,,,,,,26/06/2018,26/06/2018,0.00,,10.93,,"-530,796.10"
,CS,AR,32005705,1005,100,,Cash sale,,,,,,26/06/2018,26/06/2018,0.00,,7.75,,"-530,803.85"
,CS,AR,32005741,1005,100,,Cash sale,,,,,,26/06/2018,26/06/2018,0.00,,12.39,,"-530,816.24"
,CS,AR,32005753,1005,100,,Cash sale,,,,,,26/06/2018,26/06/2018,0.00,,14.58,,"-530,830.82"
,CS,AR,32005754,1005,100,,Cash sale,,,,,,26/06/2018,26/06/2018,0.00,,10.93,,"-530,841.75"
,CS,AR,32005758,1005,100,,Cash sale,,,,,,26/06/2018,26/06/2018,0.00,,29.15,,"-530,870.90"
,IN,AR,30317334,1005,100,,Invoice,,,,,,26/06/2018,26/06/2018,0.00,,32.97,,"-530,903.87"
,IN,AR,30317356,1005,100,,Invoice,,,,,,26/06/2018,26/06/2018,0.00,,25.51,,"-530,929.38"
,IN,AR,30317381,1005,100,,Invoice,,,,,,26/06/2018,26/06/2018,0.00,,10.93,,"-530,940.31"
,IN,AR,30317405,1005,100,,Invoice,,,,,,26/06/2018,26/06/2018,0.00,,1.99,,"-530,942.30"
,IN,AR,30317412,1005,100,,Invoice,,,,,,26/06/2018,26/06/2018,0.00,,40.34,,"-530,982.64"
,IN,AR,30317424,1005,100,,Invoice,,,,,,26/06/2018,26/06/2018,0.00,,14.58,,"-530,997.22"
,IN,AR,30317436,1005,100,,Invoice,,,,,,26/06/2018,26/06/2018,0.00,,18.22,,"-531,015.44"
,IN,AR,30317445,1005,100,,Invoice,,,,,,26/06/2018,26/06/2018,0.00,,182.20,,"-531,197.64"
,IN,AR,30317492,1005,100,,Invoice,,,,,,26/06/2018,26/06/2018,0.00,,10.93,,"-531,208.57"
,IN,AR,30317505,1005,100,,Invoice,,,,,,26/06/2018,26/06/2018,0.00,,15.51,,"-531,224.08"
,IN,AR,30317510,1005,100,,Invoice,,,,,,26/06/2018,26/06/2018,0.00,,90.81,,"-531,314.89"
,IN,AR,30317521,1005,100,,Invoice,,,,,,26/06/2018,26/06/2018,0.00,,16.48,,"-531,331.37"
,IN,AR,30317549,1005,100,,Invoice,,,,,,26/06/2018,26/06/2018,0.00,,7.29,,"-531,338.66"
,IN,AR,30317560,1005,100,,Invoice,,,,,,26/06/2018,26/06/2018,0.00,,13.73,,"-531,352.39"
,IN,AR,30317562,1005,100,,Invoice,,,,,,26/06/2018,26/06/2018,0.00,,4.64,,"-531,357.03"
,IN,AR,30317567,1005,100,,Invoice,,,,,,26/06/2018,26/06/2018,0.00,,7.19,,"-531,364.22"
,IN,AR,30317575,1005,100,,Invoice,,,,,,26/06/2018,26/06/2018,0.00,,10.93,,"-531,375.15"
,IN,AR,30317580,1005,100,,Invoice,,,,,,26/06/2018,26/06/2018,0.00,,4.32,,"-531,379.47"
,IN,AR,30317582,1005,100,,Invoice,,,,,,26/06/2018,26/06/2018,0.00,,8.47,,"-531,387.94"
,IN,AR,30317597,1005,100,,Invoice,,,,,,26/06/2018,26/06/2018,0.00,,4.24,,"-531,392.18"
,IN,AR,30317599,1005,100,,Invoice,,,,,,26/06/2018,26/06/2018,0.00,,4.24,,"-531,396.42"
,IN,AR,30317611,1005,100,,Invoice,,,,,,26/06/2018,26/06/2018,0.00,,2.58,,"-531,399.00"
,IN,AR,30317624,1005,100,,Invoice,,,,,,26/06/2018,26/06/2018,0.00,,9.03,,"-531,408.03"
,IN,AR,30317635,1005,100,,Invoice,,,,,,26/06/2018,26/06/2018,0.00,,5.85,,"-531,413.88"
,IN,AR,30317650,1005,100,,Invoice,,,,,,26/06/2018,26/06/2018,0.00,,9.43,,"-531,423.31"
,IN,AR,30317658,1005,100,,Invoice,,,,,,26/06/2018,26/06/2018,0.00,,4.78,,"-531,428.09"
,IN,AR,30317730,1005,100,,Invoice,,,,,,26/06/2018,26/06/2018,0.00,,3.90,,"-531,431.99"
,IN,AR,30317750,1005,100,,Invoice,,,,,,26/06/2018,26/06/2018,0.00,,4.49,,"-531,436.48"
,IN,AR,30317756,1005,100,,Invoice,,,,,,26/06/2018,26/06/2018,0.00,,13.60,,"-531,450.08"
,IN,AR,30317803,1005,100,,Invoice,,,,,,26/06/2018,26/06/2018,0.00,,7.29,,"-531,457.37"
,IN,AR,30317810,1005,100,,Invoice,,,,,,26/06/2018,26/06/2018,0.00,,14.58,,"-531,471.95"
,IN,AR,30317812,1005,100,,Invoice,,,,,,26/06/2018,26/06/2018,0.00,,5.85,,"-531,477.80"
,IN,AR,30317817,1005,100,,Invoice,,,,,,26/06/2018,26/06/2018,0.00,,44.49,,"-531,522.29"
,IN,AR,30317831,1005,100,,Invoice,,,,,,26/06/2018,26/06/2018,0.00,,11.57,,"-531,533.86"
,IN,AR,30317837,1005,100,,Invoice,,,,,,26/06/2018,26/06/2018,0.00,,15.25,,"-531,549.11"
,IN,AR,30317840,1005,100,,Invoice,,,,,,26/06/2018,26/06/2018,0.00,,10.53,,"-531,559.64"
,IN,AR,30317842,1005,100,,Invoice,,,,,,26/06/2018,26/06/2018,0.00,,21.98,,"-531,581.62"
,IN,AR,30317852,1005,100,,Invoice,,,,,,26/06/2018,26/06/2018,0.00,,21.19,,"-531,602.81"
,IN,AR,30317857,1005,100,,Invoice,,,,,,26/06/2018,26/06/2018,0.00,,14.58,,"-531,617.39"
,IN,AR,30317859,1005,100,,Invoice,,,,,,26/06/2018,26/06/2018,0.00,,4.24,,"-531,621.63"
,IN,AR,30317866,1005,100,,Invoice,,,,,,26/06/2018,26/06/2018,0.00,,7.63,,"-531,629.26"
,IN,AR,30317880,1005,100,,Invoice,,,,,,26/06/2018,26/06/2018,0.00,,6.36,,"-531,635.62"
,IN,AR,30317884,1005,100,,Invoice,,,,,,26/06/2018,26/06/2018,0.00,,38.56,,"-531,674.18"
,IN,AR,30317886,1005,100,,Invoice,,,,,,26/06/2018,26/06/2018,0.00,,10.93,,"-531,685.11"
,IN,AR,30317892,1005,100,,Invoice,,,,,,26/06/2018,26/06/2018,0.00,,10.93,,"-531,696.04"
,IN,AR,30317914,1005,100,,Invoice,,,,,,26/06/2018,26/06/2018,0.00,,10.17,,"-531,706.21"
,IN,AR,30317921,1005,100,,Invoice,,,,,,26/06/2018,26/06/2018,0.00,,19.30,,"-531,725.51"
,IN,AR,30317940,1005,100,,Invoice,,,,,,26/06/2018,26/06/2018,0.00,,2.80,,"-531,728.31"
,IN,AR,30317941,1005,100,,Invoice,,,,,,26/06/2018,26/06/2018,0.00,,54.66,,"-531,782.97"
,IN,AR,30317944,1005,100,,Invoice,,,,,,26/06/2018,26/06/2018,0.00,,7.75,,"-531,790.72"
,IN,AR,30317946,1005,100,,Invoice,,,,,,26/06/2018,26/06/2018,0.00,,8.78,,"-531,799.50"
,IN,AR,30317949,1005,100,,Invoice,,,,,,26/06/2018,26/06/2018,0.00,,11.36,,"-531,810.86"
,IN,AR,30317990,1005,100,,Invoice,,,,,,26/06/2018,26/06/2018,0.00,,34.31,,"-531,845.17"
,IN,AR,30317999,1005,100,,Invoice,,,,,,26/06/2018,26/06/2018,0.00,,3.53,,"-531,848.70"
,IN,AR,30318031,1005,100,,Invoice,,,,,,26/06/2018,26/06/2018,0.00,,5.17,,"-531,853.87"
,IN,AR,30318035,1005,100,,Invoice,,,,,,26/06/2018,26/06/2018,0.00,,10.93,,"-531,864.80"
,IN,AR,30318036,1005,100,,Invoice,,,,,,26/06/2018,26/06/2018,0.00,,10.93,,"-531,875.73"
,IN,AR,30318046,1005,100,,Invoice,,,,,,26/06/2018,26/06/2018,0.00,,51.02,,"-531,926.75"
,IN,AR,30318047,1005,100,,Invoice,,,,,,26/06/2018,26/06/2018,0.00,,36.44,,"-531,963.19"
,IN,AR,30318059,1005,100,,Invoice,,,,,,26/06/2018,26/06/2018,0.00,,5.85,,"-531,969.04"
,IN,AR,30318077,1005,100,,Invoice,,,,,,26/06/2018,26/06/2018,0.00,,10.17,,"-531,979.21"
,IN,AR,30318093,1005,100,,Invoice,,,,,,26/06/2018,26/06/2018,0.00,,4.77,,"-531,983.98"
,IN,AR,30318101,1005,100,,Invoice,,,,,,26/06/2018,26/06/2018,0.00,,36.91,,"-532,020.89"
,IN,AR,30318129,1005,100,,Invoice,,,,,,26/06/2018,26/06/2018,0.00,,3.64,,"-532,024.53"
,IN,AR,30318132,1005,100,,Invoice,,,,,,26/06/2018,26/06/2018,0.00,,21.25,,"-532,045.78"
,IN,AR,30318139,1005,100,,Invoice,,,,,,26/06/2018,26/06/2018,0.00,,204.07,,"-532,249.85"
,IN,AR,30318144,1005,100,,Invoice,,,,,,26/06/2018,26/06/2018,0.00,,54.66,,"-532,304.51"
,IN,AR,30318166,1005,100,,Invoice,,,,,,26/06/2018,26/06/2018,0.00,,14.58,,"-532,319.09"
,IN,AR,30318167,1005,100,,Invoice,,,,,,26/06/2018,26/06/2018,0.00,,10.93,,"-532,330.02"
,IN,AR,30318184,1005,100,,Invoice,,,,,,26/06/2018,26/06/2018,0.00,,27.97,,"-532,357.99"
,IN,AR,30318185,1005,100,,Invoice,,,,,,26/06/2018,26/06/2018,0.00,,10.17,,"-532,368.16"
,IN,AR,30318186,1005,100,,Invoice,,,,,,26/06/2018,26/06/2018,0.00,,10.17,,"-532,378.33"
,IN,AR,30318218,1005,100,,Invoice,,,,,,26/06/2018,26/06/2018,0.00,,18.22,,"-532,396.55"
,IN,AR,30318243,1005,100,,Invoice,,,,,,26/06/2018,26/06/2018,0.00,,5.47,,"-532,402.02"
,IN,AR,30318263,1005,100,,Invoice,,,,,,26/06/2018,26/06/2018,0.00,,136.00,,"-532,538.02"
,IN,AR,30318270,1005,100,,Invoice,,,,,,26/06/2018,26/06/2018,0.00,,33.22,,"-532,571.24"
,IN,AR,30318271,1005,100,,Invoice,,,,,,26/06/2018,26/06/2018,0.00,,11.86,,"-532,583.10"
,IN,AR,30318272,1005,100,,Invoice,,,,,,26/06/2018,26/06/2018,0.00,,18.22,,"-532,601.32"
,IN,AR,30318275,1005,100,,Invoice,,,,,,26/06/2018,26/06/2018,0.00,,3.64,,"-532,604.96"
,IN,AR,30318302,1005,100,,Invoice,,,,,,26/06/2018,26/06/2018,0.00,,182.20,,"-532,787.16"
,IN,AR,30318304,1005,100,,Invoice,,,,,,26/06/2018,26/06/2018,0.00,,103.05,,"-532,890.21"
,IN,AR,30318343,1005,100,,Invoice,,,,,,26/06/2018,26/06/2018,0.00,,18.98,,"-532,909.19"
,IN,AR,30318344,1005,100,,Invoice,,,,,,26/06/2018,26/06/2018,0.00,,16.61,,"-532,925.80"
,IN,AR,30318345,1005,100,,Invoice,,,,,,26/06/2018,26/06/2018,0.00,,83.06,,"-533,008.86"
,IN,AR,30318361,1005,100,,Invoice,,,,,,26/06/2018,26/06/2018,0.00,,5.64,,"-533,014.50"
,IN,AR,30318363,1005,100,,Invoice,,,,,,26/06/2018,26/06/2018,0.00,,5.26,,"-533,019.76"
,IN,AR,30318365,1005,100,,Invoice,,,,,,26/06/2018,26/06/2018,0.00,,3.51,,"-533,023.27"
,IN,AR,30318367,1005,100,,Invoice,,,,,,26/06/2018,26/06/2018,0.00,,12.00,,"-533,035.27"
,IN,AR,30318375,1005,100,,Invoice,,,,,,26/06/2018,26/06/2018,0.00,,133.12,,"-533,168.39"
,IN,AR,30318376,1005,100,,Invoice,,,,,,26/06/2018,26/06/2018,0.00,,14.58,,"-533,182.97"
,IN,AR,30318378,1005,100,,Invoice,,,,,,26/06/2018,26/06/2018,0.00,,18.22,,"-533,201.19"
,IN,AR,30318383,1005,100,,Invoice,,,,,,26/06/2018,26/06/2018,0.00,,7.02,,"-533,208.21"
,IN,AR,30318397,1005,100,,Invoice,,,,,,26/06/2018,26/06/2018,0.00,,8.75,,"-533,216.96"
,IN,AR,30318404,1005,100,,Invoice,,,,,,26/06/2018,26/06/2018,0.00,,5.64,,"-533,222.60"
,IN,AR,30318424,1005,100,,Invoice,,,,,,26/06/2018,26/06/2018,0.00,,15.71,,"-533,238.31"
,IN,AR,30318436,1005,100,,Invoice,,,,,,26/06/2018,26/06/2018,0.00,,7.29,,"-533,245.60"
,IN,AR,30318489,1005,100,,Invoice,,,,,,26/06/2018,26/06/2018,0.00,,6.23,,"-533,251.83"
,IN,AR,30318490,1005,100,,Invoice,,,,,,26/06/2018,26/06/2018,0.00,,10.38,,"-533,262.21"
,IN,AR,30318491,1005,100,,Invoice,,,,,,26/06/2018,26/06/2018,0.00,,8.31,,"-533,270.52"
,IN,AR,30318508,1005,100,,Invoice,,,,,,26/06/2018,26/06/2018,0.00,,33.81,,"-533,304.33"
,IN,AR,30318516,1005,100,,Invoice,,,,,,26/06/2018,26/06/2018,0.00,,10.93,,"-533,315.26"
,IN,AR,30318517,1005,100,,Invoice,,,,,,26/06/2018,26/06/2018,0.00,,23.26,,"-533,338.52"
,IN,AR,30318539,1005,100,,Invoice,,,,,,26/06/2018,26/06/2018,0.00,,13.56,,"-533,352.08"
,IN,AR,30318543,1005,100,,Invoice,,,,,,26/06/2018,26/06/2018,0.00,,7.29,,"-533,359.37"
,IN,AR,30318544,1005,100,,Invoice,,,,,,26/06/2018,26/06/2018,0.00,,7.29,,"-533,366.66"
,IN,AR,30318545,1005,100,,Invoice,,,,,,26/06/2018,26/06/2018,0.00,,7.29,,"-533,373.95"
,IN,AR,30318546,1005,100,,Invoice,,,,,,26/06/2018,26/06/2018,0.00,,3.64,,"-533,377.59"
,IN,AR,30318547,1005,100,,Invoice,,,,,,26/06/2018,26/06/2018,0.00,,182.20,,"-533,559.79"
,IN,AR,30318563,1005,100,,Invoice,,,,,,26/06/2018,26/06/2018,0.00,,98.63,,"-533,658.42"
,IN,AR,30318564,1005,100,,Invoice,,,,,,26/06/2018,26/06/2018,0.00,,29.15,,"-533,687.57"
,IN,AR,30318565,1005,100,,Invoice,,,,,,26/06/2018,26/06/2018,0.00,,54.66,,"-533,742.23"
,IN,AR,30318567,1005,100,,Invoice,,,,,,26/06/2018,26/06/2018,0.00,,455.51,,"-534,197.74"
,CN,AR,31018227,1005,100,,Credit Note,,,,,,27/06/2018,27/06/2018,10.93,,0.00,,"-534,186.81"
,CN,AR,31018245,1005,100,,Credit Note,,,,,,27/06/2018,27/06/2018,10.93,,0.00,,"-534,175.88"
,CN,AR,31018249,1005,100,,Credit Note,,,,,,27/06/2018,27/06/2018,10.93,,0.00,,"-534,164.95"
,CN,AR,31018258,1005,100,,Credit Note,,,,,,27/06/2018,27/06/2018,3.64,,0.00,,"-534,161.31"
,CN,AR,31018264,1005,100,,Credit Note,,,,,,27/06/2018,27/06/2018,5.17,,0.00,,"-534,156.14"
,CN,AR,31018269,1005,100,,Credit Note,,,,,,27/06/2018,27/06/2018,5.17,,0.00,,"-534,150.97"
,CN,AR,31018270,1005,100,,Credit Note,,,,,,27/06/2018,27/06/2018,21.86,,0.00,,"-534,129.11"
,CN,AR,31018275,1005,100,,Credit Note,,,,,,27/06/2018,27/06/2018,14.58,,0.00,,"-534,114.53"
,CN,AR,31018307,1005,100,,Credit Note,,,,,,27/06/2018,27/06/2018,3.64,,0.00,,"-534,110.89"
,CN,AR,31018308,1005,100,,Credit Note,,,,,,27/06/2018,27/06/2018,10.93,,0.00,,"-534,099.96"
,CN,AR,31018310,1005,100,,Credit Note,,,,,,27/06/2018,27/06/2018,72.88,,0.00,,"-534,027.08"
,CS,AR,32005260,1005,100,,Cash sale,,,,,,27/06/2018,27/06/2018,0.00,,12.03,,"-534,039.11"
,CS,AR,32005265,1005,100,,Cash sale,,,,,,27/06/2018,27/06/2018,0.00,,5.61,,"-534,044.72"
,CS,AR,32005270,1005,100,,Cash sale,,,,,,27/06/2018,27/06/2018,0.00,,3.64,,"-534,048.36"
,CS,AR,32005272,1005,100,,Cash sale,,,,,,27/06/2018,27/06/2018,0.00,,37.63,,"-534,085.99"
,CS,AR,32005291,1005,100,,Cash sale,,,,,,27/06/2018,27/06/2018,0.00,,10.93,,"-534,096.92"
,CS,AR,32005293,1005,100,,Cash sale,,,,,,27/06/2018,27/06/2018,0.00,,3.64,,"-534,100.56"
,CS,AR,32005296,1005,100,,Cash sale,,,,,,27/06/2018,27/06/2018,0.00,,7.29,,"-534,107.85"
,CS,AR,32005299,1005,100,,Cash sale,,,,,,27/06/2018,27/06/2018,0.00,,10.93,,"-534,118.78"
,CS,AR,32005302,1005,100,,Cash sale,,,,,,27/06/2018,27/06/2018,0.00,,7.29,,"-534,126.07"
,CS,AR,32005304,1005,100,,Cash sale,,,,,,27/06/2018,27/06/2018,0.00,,3.64,,"-534,129.71"
,CS,AR,32005311,1005,100,,Cash sale,,,,,,27/06/2018,27/06/2018,0.00,,7.29,,"-534,137.00"
,CS,AR,32005331,1005,100,,Cash sale,,,,,,27/06/2018,27/06/2018,0.00,,3.64,,"-534,140.64"
,CS,AR,32005336,1005,100,,Cash sale,,,,,,27/06/2018,27/06/2018,0.00,,15.04,,"-534,155.68"
,CS,AR,32005340,1005,100,,Cash sale,,,,,,27/06/2018,27/06/2018,0.00,,3.64,,"-534,159.32"
,CS,AR,32005341,1005,100,,Cash sale,,,,,,27/06/2018,27/06/2018,0.00,,11.69,,"-534,171.01"
,CS,AR,32005342,1005,100,,Cash sale,,,,,,27/06/2018,27/06/2018,0.00,,10.93,,"-534,181.94"
,CS,AR,32005344,1005,100,,Cash sale,,,,,,27/06/2018,27/06/2018,0.00,,14.58,,"-534,196.52"
,CS,AR,32005358,1005,100,,Cash sale,,,,,,27/06/2018,27/06/2018,0.00,,18.09,,"-534,214.61"
,CS,AR,32005362,1005,100,,Cash sale,,,,,,27/06/2018,27/06/2018,0.00,,5.86,,"-534,220.47"
,CS,AR,32005364,1005,100,,Cash sale,,,,,,27/06/2018,27/06/2018,0.00,,7.29,,"-534,227.76"
,CS,AR,32005366,1005,100,,Cash sale,,,,,,27/06/2018,27/06/2018,0.00,,3.64,,"-534,231.40"
,CS,AR,32005382,1005,100,,Cash sale,,,,,,27/06/2018,27/06/2018,0.00,,3.64,,"-534,235.04"
,CS,AR,32005401,1005,100,,Cash sale,,,,,,27/06/2018,27/06/2018,0.00,,3.64,,"-534,238.68"
,CS,AR,32005403,1005,100,,Cash sale,,,,,,27/06/2018,27/06/2018,0.00,,25.85,,"-534,264.53"
,CS,AR,32005408,1005,100,,Cash sale,,,,,,27/06/2018,27/06/2018,0.00,,10.93,,"-534,275.46"
,CS,AR,32005412,1005,100,,Cash sale,,,,,,27/06/2018,27/06/2018,0.00,,24.07,,"-534,299.53"
,CS,AR,32005421,1005,100,,Cash sale,,,,,,27/06/2018,27/06/2018,0.00,,10.93,,"-534,310.46"
,CS,AR,32005423,1005,100,,Cash sale,,,,,,27/06/2018,27/06/2018,0.00,,6.86,,"-534,317.32"
,CS,AR,32005427,1005,100,,Cash sale,,,,,,27/06/2018,27/06/2018,0.00,,10.93,,"-534,328.25"
,CS,AR,32005432,1005,100,,Cash sale,,,,,,27/06/2018,27/06/2018,0.00,,3.64,,"-534,331.89"
,CS,AR,32005460,1005,100,,Cash sale,,,,,,27/06/2018,27/06/2018,0.00,,3.64,,"-534,335.53"
,CS,AR,32005473,1005,100,,Cash sale,,,,,,27/06/2018,27/06/2018,0.00,,3.64,,"-534,339.17"
,CS,AR,32005501,1005,100,,Cash sale,,,,,,27/06/2018,27/06/2018,0.00,,10.93,,"-534,350.10"
,CS,AR,32005545,1005,100,,Cash sale,,,,,,27/06/2018,27/06/2018,0.00,,7.29,,"-534,357.39"
,CS,AR,32005547,1005,100,,Cash sale,,,,,,27/06/2018,27/06/2018,0.00,,5.17,,"-534,362.56"
,CS,AR,32005551,1005,100,,Cash sale,,,,,,27/06/2018,27/06/2018,0.00,,3.64,,"-534,366.20"
,CS,AR,32005553,1005,100,,Cash sale,,,,,,27/06/2018,27/06/2018,0.00,,16.61,,"-534,382.81"
,CS,AR,32005576,1005,100,,Cash sale,,,,,,27/06/2018,27/06/2018,0.00,,7.29,,"-534,390.10"
,CS,AR,32005579,1005,100,,Cash sale,,,,,,27/06/2018,27/06/2018,0.00,,6.86,,"-534,396.96"
,CS,AR,32005598,1005,100,,Cash sale,,,,,,27/06/2018,27/06/2018,0.00,,7.29,,"-534,404.25"
,CS,AR,32005599,1005,100,,Cash sale,,,,,,27/06/2018,27/06/2018,0.00,,14.58,,"-534,418.83"
,CS,AR,32005602,1005,100,,Cash sale,,,,,,27/06/2018,27/06/2018,0.00,,10.93,,"-534,429.76"
,CS,AR,32005617,1005,100,,Cash sale,,,,,,27/06/2018,27/06/2018,0.00,,25.51,,"-534,455.27"
,CS,AR,32005624,1005,100,,Cash sale,,,,,,27/06/2018,27/06/2018,0.00,,7.29,,"-534,462.56"
,CS,AR,32005645,1005,100,,Cash sale,,,,,,27/06/2018,27/06/2018,0.00,,14.58,,"-534,477.14"
,CS,AR,32005653,1005,100,,Cash sale,,,,,,27/06/2018,27/06/2018,0.00,,14.58,,"-534,491.72"
,CS,AR,32005668,1005,100,,Cash sale,,,,,,27/06/2018,27/06/2018,0.00,,3.64,,"-534,495.36"
,CS,AR,32005691,1005,100,,Cash sale,,,,,,27/06/2018,27/06/2018,0.00,,7.29,,"-534,502.65"
,CS,AR,32005692,1005,100,,Cash sale,,,,,,27/06/2018,27/06/2018,0.00,,10.93,,"-534,513.58"
,CS,AR,32005717,1005,100,,Cash sale,,,,,,27/06/2018,27/06/2018,0.00,,10.93,,"-534,524.51"
,CS,AR,32005749,1005,100,,Cash sale,,,,,,27/06/2018,27/06/2018,0.00,,3.64,,"-534,528.15"
,CS,AR,32005752,1005,100,,Cash sale,,,,,,27/06/2018,27/06/2018,0.00,,5.08,,"-534,533.23"
,IN,AR,30317304,1005,100,,Invoice,,,,,,27/06/2018,27/06/2018,0.00,,84.54,,"-534,617.77"
,IN,AR,30317313,1005,100,,Invoice,,,,,,27/06/2018,27/06/2018,0.00,,5.93,,"-534,623.70"
,IN,AR,30317323,1005,100,,Invoice,,,,,,27/06/2018,27/06/2018,0.00,,22.37,,"-534,646.07"
,IN,AR,30317326,1005,100,,Invoice,,,,,,27/06/2018,27/06/2018,0.00,,10.93,,"-534,657.00"
,IN,AR,30317327,1005,100,,Invoice,,,,,,27/06/2018,27/06/2018,0.00,,25.51,,"-534,682.51"
,IN,AR,30317328,1005,100,,Invoice,,,,,,27/06/2018,27/06/2018,0.00,,7.29,,"-534,689.80"
,IN,AR,30317332,1005,100,,Invoice,,,,,,27/06/2018,27/06/2018,0.00,,34.17,,"-534,723.97"
,IN,AR,30317333,1005,100,,Invoice,,,,,,27/06/2018,27/06/2018,0.00,,31.73,,"-534,755.70"
,IN,AR,30317353,1005,100,,Invoice,,,,,,27/06/2018,27/06/2018,0.00,,16.27,,"-534,771.97"
,IN,AR,30317354,1005,100,,Invoice,,,,,,27/06/2018,27/06/2018,0.00,,3.64,,"-534,775.61"
,IN,AR,30317360,1005,100,,Invoice,,,,,,27/06/2018,27/06/2018,0.00,,14.58,,"-534,790.19"
,IN,AR,30317363,1005,100,,Invoice,,,,,,27/06/2018,27/06/2018,0.00,,13.94,,"-534,804.13"
,IN,AR,30317364,1005,100,,Invoice,,,,,,27/06/2018,27/06/2018,0.00,,14.58,,"-534,818.71"
,IN,AR,30317369,1005,100,,Invoice,,,,,,27/06/2018,27/06/2018,0.00,,13.14,,"-534,831.85"
,IN,AR,30317370,1005,100,,Invoice,,,,,,27/06/2018,27/06/2018,0.00,,81.44,,"-534,913.29"
,IN,AR,30317372,1005,100,,Invoice,,,,,,27/06/2018,27/06/2018,0.00,,10.93,,"-534,924.22"
,IN,AR,30317377,1005,100,,Invoice,,,,,,27/06/2018,27/06/2018,0.00,,12.08,,"-534,936.30"
,IN,AR,30317383,1005,100,,Invoice,,,,,,27/06/2018,27/06/2018,0.00,,7.00,,"-534,943.30"
,IN,AR,30317384,1005,100,,Invoice,,,,,,27/06/2018,27/06/2018,0.00,,109.32,,"-535,052.62"
,IN,AR,30317413,1005,100,,Invoice,,,,,,27/06/2018,27/06/2018,0.00,,40.34,,"-535,092.96"
,IN,AR,30317432,1005,100,,Invoice,,,,,,27/06/2018,27/06/2018,0.00,,14.58,,"-535,107.54"
,IN,AR,30317455,1005,100,,Invoice,,,,,,27/06/2018,27/06/2018,0.00,,16.00,,"-535,123.54"
,IN,AR,30317478,1005,100,,Invoice,,,,,,27/06/2018,27/06/2018,0.00,,34.00,,"-535,157.54"
,IN,AR,30317481,1005,100,,Invoice,,,,,,27/06/2018,27/06/2018,0.00,,10.93,,"-535,168.47"
,IN,AR,30317496,1005,100,,Invoice,,,,,,27/06/2018,27/06/2018,0.00,,10.93,,"-535,179.40"
,IN,AR,30317499,1005,100,,Invoice,,,,,,27/06/2018,27/06/2018,0.00,,136.44,,"-535,315.84"
,IN,AR,30317500,1005,100,,Invoice,,,,,,27/06/2018,27/06/2018,0.00,,57.31,,"-535,373.15"
,IN,AR,30317511,1005,100,,Invoice,,,,,,27/06/2018,27/06/2018,0.00,,14.58,,"-535,387.73"
,IN,AR,30317518,1005,100,,Invoice,,,,,,27/06/2018,27/06/2018,0.00,,7.29,,"-535,395.02"
,IN,AR,30317524,1005,100,,Invoice,,,,,,27/06/2018,27/06/2018,0.00,,21.86,,"-535,416.88"
,IN,AR,30317533,1005,100,,Invoice,,,,,,27/06/2018,27/06/2018,0.00,,34.48,,"-535,451.36"
,IN,AR,30317540,1005,100,,Invoice,,,,,,27/06/2018,27/06/2018,0.00,,72.88,,"-535,524.24"
,IN,AR,30317548,1005,100,,Invoice,,,,,,27/06/2018,27/06/2018,0.00,,7.29,,"-535,531.53"
,IN,AR,30317570,1005,100,,Invoice,,,,,,27/06/2018,27/06/2018,0.00,,18.22,,"-535,549.75"
,IN,AR,30317572,1005,100,,Invoice,,,,,,27/06/2018,27/06/2018,0.00,,10.51,,"-535,560.26"
,IN,AR,30317574,1005,100,,Invoice,,,,,,27/06/2018,27/06/2018,0.00,,25.42,,"-535,585.68"
,IN,AR,30317584,1005,100,,Invoice,,,,,,27/06/2018,27/06/2018,0.00,,4.24,,"-535,589.92"
,IN,AR,30317590,1005,100,,Invoice,,,,,,27/06/2018,27/06/2018,0.00,,61.02,,"-535,650.94"
,IN,AR,30317593,1005,100,,Invoice,,,,,,27/06/2018,27/06/2018,0.00,,15.04,,"-535,665.98"
,IN,AR,30317596,1005,100,,Invoice,,,,,,27/06/2018,27/06/2018,0.00,,4.24,,"-535,670.22"
,IN,AR,30317601,1005,100,,Invoice,,,,,,27/06/2018,27/06/2018,0.00,,8.39,,"-535,678.61"
,IN,AR,30317610,1005,100,,Invoice,,,,,,27/06/2018,27/06/2018,0.00,,7.29,,"-535,685.90"
,IN,AR,30317618,1005,100,,Invoice,,,,,,27/06/2018,27/06/2018,0.00,,16.53,,"-535,702.43"
,IN,AR,30317620,1005,100,,Invoice,,,,,,27/06/2018,27/06/2018,0.00,,25.51,,"-535,727.94"
,IN,AR,30317627,1005,100,,Invoice,,,,,,27/06/2018,27/06/2018,0.00,,38.24,,"-535,766.18"
,IN,AR,30317637,1005,100,,Invoice,,,,,,27/06/2018,27/06/2018,0.00,,22.03,,"-535,788.21"
,IN,AR,30317649,1005,100,,Invoice,,,,,,27/06/2018,27/06/2018,0.00,,53.39,,"-535,841.60"
,IN,AR,30317653,1005,100,,Invoice,,,,,,27/06/2018,27/06/2018,0.00,,8.58,,"-535,850.18"
,IN,AR,30317659,1005,100,,Invoice,,,,,,27/06/2018,27/06/2018,0.00,,14.34,,"-535,864.52"
,IN,AR,30317662,1005,100,,Invoice,,,,,,27/06/2018,27/06/2018,0.00,,9.66,,"-535,874.18"
,IN,AR,30317665,1005,100,,Invoice,,,,,,27/06/2018,27/06/2018,0.00,,16.10,,"-535,890.28"
,IN,AR,30317696,1005,100,,Invoice,,,,,,27/06/2018,27/06/2018,0.00,,148.04,,"-536,038.32"
,IN,AR,30317717,1005,100,,Invoice,,,,,,27/06/2018,27/06/2018,0.00,,10.93,,"-536,049.25"
,IN,AR,30317738,1005,100,,Invoice,,,,,,27/06/2018,27/06/2018,0.00,,5.08,,"-536,054.33"
,IN,AR,30317739,1005,100,,Invoice,,,,,,27/06/2018,27/06/2018,0.00,,2.54,,"-536,056.87"
,IN,AR,30317740,1005,100,,Invoice,,,,,,27/06/2018,27/06/2018,0.00,,2.54,,"-536,059.41"
,IN,AR,30317752,1005,100,,Invoice,,,,,,27/06/2018,27/06/2018,0.00,,25.75,,"-536,085.16"
,IN,AR,30317759,1005,100,,Invoice,,,,,,27/06/2018,27/06/2018,0.00,,8.47,,"-536,093.63"
,IN,AR,30317761,1005,100,,Invoice,,,,,,27/06/2018,27/06/2018,0.00,,10.17,,"-536,103.80"
,IN,AR,30317765,1005,100,,Invoice,,,,,,27/06/2018,27/06/2018,0.00,,10.93,,"-536,114.73"
,IN,AR,30317816,1005,100,,Invoice,,,,,,27/06/2018,27/06/2018,0.00,,18.17,,"-536,132.90"
,IN,AR,30317825,1005,100,,Invoice,,,,,,27/06/2018,27/06/2018,0.00,,10.00,,"-536,142.90"
,IN,AR,30317841,1005,100,,Invoice,,,,,,27/06/2018,27/06/2018,0.00,,7.29,,"-536,150.19"
,IN,AR,30317861,1005,100,,Invoice,,,,,,27/06/2018,27/06/2018,0.00,,10.93,,"-536,161.12"
,IN,AR,30317876,1005,100,,Invoice,,,,,,27/06/2018,27/06/2018,0.00,,30.86,,"-536,191.98"
,IN,AR,30317885,1005,100,,Invoice,,,,,,27/06/2018,27/06/2018,0.00,,23.73,,"-536,215.71"
,IN,AR,30317897,1005,100,,Invoice,,,,,,27/06/2018,27/06/2018,0.00,,3.64,,"-536,219.35"
,IN,AR,30317904,1005,100,,Invoice,,,,,,27/06/2018,27/06/2018,0.00,,6.36,,"-536,225.71"
,IN,AR,30317910,1005,100,,Invoice,,,,,,27/06/2018,27/06/2018,0.00,,25.17,,"-536,250.88"
,IN,AR,30317926,1005,100,,Invoice,,,,,,27/06/2018,27/06/2018,0.00,,5.42,,"-536,256.30"
,IN,AR,30317936,1005,100,,Invoice,,,,,,27/06/2018,27/06/2018,0.00,,10.93,,"-536,267.23"
,IN,AR,30317951,1005,100,,Invoice,,,,,,27/06/2018,27/06/2018,0.00,,76.09,,"-536,343.32"
,IN,AR,30317966,1005,100,,Invoice,,,,,,27/06/2018,27/06/2018,0.00,,24.07,,"-536,367.39"
,IN,AR,30317976,1005,100,,Invoice,,,,,,27/06/2018,27/06/2018,0.00,,41.53,,"-536,408.92"
,IN,AR,30317980,1005,100,,Invoice,,,,,,27/06/2018,27/06/2018,0.00,,5.08,,"-536,414.00"
,IN,AR,30317987,1005,100,,Invoice,,,,,,27/06/2018,27/06/2018,0.00,,8.00,,"-536,422.00"
,IN,AR,30317991,1005,100,,Invoice,,,,,,27/06/2018,27/06/2018,0.00,,29.15,,"-536,451.15"
,IN,AR,30318000,1005,100,,Invoice,,,,,,27/06/2018,27/06/2018,0.00,,1.76,,"-536,452.91"
,IN,AR,30318001,1005,100,,Invoice,,,,,,27/06/2018,27/06/2018,0.00,,14.09,,"-536,467.00"
,IN,AR,30318006,1005,100,,Invoice,,,,,,27/06/2018,27/06/2018,0.00,,18.05,,"-536,485.05"
,IN,AR,30318018,1005,100,,Invoice,,,,,,27/06/2018,27/06/2018,0.00,,10.98,,"-536,496.03"
,IN,AR,30318029,1005,100,,Invoice,,,,,,27/06/2018,27/06/2018,0.00,,10.34,,"-536,506.37"
,IN,AR,30318039,1005,100,,Invoice,,,,,,27/06/2018,27/06/2018,0.00,,7.86,,"-536,514.23"
,IN,AR,30318043,1005,100,,Invoice,,,,,,27/06/2018,27/06/2018,0.00,,32.01,,"-536,546.24"
,IN,AR,30318075,1005,100,,Invoice,,,,,,27/06/2018,27/06/2018,0.00,,7.29,,"-536,553.53"
,IN,AR,30318082,1005,100,,Invoice,,,,,,27/06/2018,27/06/2018,0.00,,3.25,,"-536,556.78"
,IN,AR,30318083,1005,100,,Invoice,,,,,,27/06/2018,27/06/2018,0.00,,11.39,,"-536,568.17"
,IN,AR,30318094,1005,100,,Invoice,,,,,,27/06/2018,27/06/2018,0.00,,39.75,,"-536,607.92"
,IN,AR,30318097,1005,100,,Invoice,,,,,,27/06/2018,27/06/2018,0.00,,4.01,,"-536,611.93"
,IN,AR,30318104,1005,100,,Invoice,,,,,,27/06/2018,27/06/2018,0.00,,36.00,,"-536,647.93"
,IN,AR,30318107,1005,100,,Invoice,,,,,,27/06/2018,27/06/2018,0.00,,18.33,,"-536,666.26"
,IN,AR,30318113,1005,100,,Invoice,,,,,,27/06/2018,27/06/2018,0.00,,80.17,,"-536,746.43"
,IN,AR,30318123,1005,100,,Invoice,,,,,,27/06/2018,27/06/2018,0.00,,7.29,,"-536,753.72"
,IN,AR,30318137,1005,100,,Invoice,,,,,,27/06/2018,27/06/2018,0.00,,32.42,,"-536,786.14"
,IN,AR,30318146,1005,100,,Invoice,,,,,,27/06/2018,27/06/2018,0.00,,7.29,,"-536,793.43"
,IN,AR,30318163,1005,100,,Invoice,,,,,,27/06/2018,27/06/2018,0.00,,10.19,,"-536,803.62"
,IN,AR,30318169,1005,100,,Invoice,,,,,,27/06/2018,27/06/2018,0.00,,38.81,,"-536,842.43"
,IN,AR,30318190,1005,100,,Invoice,,,,,,27/06/2018,27/06/2018,0.00,,12.00,,"-536,854.43"
,IN,AR,30318203,1005,100,,Invoice,,,,,,27/06/2018,27/06/2018,0.00,,18.01,,"-536,872.44"
,IN,AR,30318204,1005,100,,Invoice,,,,,,27/06/2018,27/06/2018,0.00,,103.81,,"-536,976.25"
,IN,AR,30318213,1005,100,,Invoice,,,,,,27/06/2018,27/06/2018,0.00,,3.02,,"-536,979.27"
,IN,AR,30318217,1005,100,,Invoice,,,,,,27/06/2018,27/06/2018,0.00,,4.58,,"-536,983.85"
,IN,AR,30318225,1005,100,,Invoice,,,,,,27/06/2018,27/06/2018,0.00,,29.44,,"-537,013.29"
,IN,AR,30318227,1005,100,,Invoice,,,,,,27/06/2018,27/06/2018,0.00,,9.03,,"-537,022.32"
,IN,AR,30318247,1005,100,,Invoice,,,,,,27/06/2018,27/06/2018,0.00,,5.61,,"-537,027.93"
,IN,AR,30318257,1005,100,,Invoice,,,,,,27/06/2018,27/06/2018,0.00,,8.39,,"-537,036.32"
,IN,AR,30318260,1005,100,,Invoice,,,,,,27/06/2018,27/06/2018,0.00,,9.64,,"-537,045.96"
,IN,AR,30318286,1005,100,,Invoice,,,,,,27/06/2018,27/06/2018,0.00,,81.15,,"-537,127.11"
,IN,AR,30318296,1005,100,,Invoice,,,,,,27/06/2018,27/06/2018,0.00,,6.37,,"-537,133.48"
,IN,AR,30318297,1005,100,,Invoice,,,,,,27/06/2018,27/06/2018,0.00,,98.78,,"-537,232.26"
,IN,AR,30318298,1005,100,,Invoice,,,,,,27/06/2018,27/06/2018,0.00,,15.93,,"-537,248.19"
,IN,AR,30318299,1005,100,,Invoice,,,,,,27/06/2018,27/06/2018,0.00,,6.37,,"-537,254.56"
,IN,AR,30318338,1005,100,,Invoice,,,,,,27/06/2018,27/06/2018,0.00,,36.86,,"-537,291.42"
,IN,AR,30318347,1005,100,,Invoice,,,,,,27/06/2018,27/06/2018,0.00,,20.34,,"-537,311.76"
,IN,AR,30318348,1005,100,,Invoice,,,,,,27/06/2018,27/06/2018,0.00,,22.37,,"-537,334.13"
,IN,AR,30318371,1005,100,,Invoice,,,,,,27/06/2018,27/06/2018,0.00,,15.90,,"-537,350.03"
,IN,AR,30318372,1005,100,,Invoice,,,,,,27/06/2018,27/06/2018,0.00,,13.56,,"-537,363.59"
,IN,AR,30318389,1005,100,,Invoice,,,,,,27/06/2018,27/06/2018,0.00,,"1,093.22",,"-538,456.81"
,IN,AR,30318410,1005,100,,Invoice,,,,,,27/06/2018,27/06/2018,0.00,,21.86,,"-538,478.67"
,IN,AR,30318426,1005,100,,Invoice,,,,,,27/06/2018,27/06/2018,0.00,,19.58,,"-538,498.25"
,IN,AR,30318430,1005,100,,Invoice,,,,,,27/06/2018,27/06/2018,0.00,,20.42,,"-538,518.67"
,IN,AR,30318433,1005,100,,Invoice,,,,,,27/06/2018,27/06/2018,0.00,,8.17,,"-538,526.84"
,IN,AR,30318440,1005,100,,Invoice,,,,,,27/06/2018,27/06/2018,0.00,,13.74,,"-538,540.58"
,IN,AR,30318459,1005,100,,Invoice,,,,,,27/06/2018,27/06/2018,0.00,,9.15,,"-538,549.73"
,IN,AR,30318463,1005,100,,Invoice,,,,,,27/06/2018,27/06/2018,0.00,,5.85,,"-538,555.58"
,IN,AR,30318465,1005,100,,Invoice,,,,,,27/06/2018,27/06/2018,0.00,,15.18,,"-538,570.76"
,IN,AR,30318467,1005,100,,Invoice,,,,,,27/06/2018,27/06/2018,0.00,,7.29,,"-538,578.05"
,IN,AR,30318492,1005,100,,Invoice,,,,,,27/06/2018,27/06/2018,0.00,,58.14,,"-538,636.19"
,IN,AR,30318493,1005,100,,Invoice,,,,,,27/06/2018,27/06/2018,0.00,,4.15,,"-538,640.34"
,IN,AR,30318494,1005,100,,Invoice,,,,,,27/06/2018,27/06/2018,0.00,,2.08,,"-538,642.42"
,IN,AR,30318495,1005,100,,Invoice,,,,,,27/06/2018,27/06/2018,0.00,,2.08,,"-538,644.50"
,IN,AR,30318496,1005,100,,Invoice,,,,,,27/06/2018,27/06/2018,0.00,,8.31,,"-538,652.81"
,IN,AR,30318497,1005,100,,Invoice,,,,,,27/06/2018,27/06/2018,0.00,,14.53,,"-538,667.34"
,IN,AR,30318498,1005,100,,Invoice,,,,,,27/06/2018,27/06/2018,0.00,,8.31,,"-538,675.65"
,IN,AR,30318507,1005,100,,Invoice,,,,,,27/06/2018,27/06/2018,0.00,,29.15,,"-538,704.80"
,IN,AR,30318520,1005,100,,Invoice,,,,,,27/06/2018,27/06/2018,0.00,,19.32,,"-538,724.12"
,IN,AR,30318530,1005,100,,Invoice,,,,,,27/06/2018,27/06/2018,0.00,,3.28,,"-538,727.40"
,IN,AR,30318537,1005,100,,Invoice,,,,,,27/06/2018,27/06/2018,0.00,,2.03,,"-538,729.43"
,CN,AR,31018224,1005,100,,Credit Note,,,,,,28/06/2018,28/06/2018,780.96,,0.00,,"-537,948.47"
,CN,AR,31018238,1005,100,,Credit Note,,,,,,28/06/2018,28/06/2018,22.88,,0.00,,"-537,925.59"
,CS,AR,32005267,1005,100,,Cash sale,,,,,,28/06/2018,28/06/2018,0.00,,14.24,,"-537,939.83"
,CS,AR,32005277,1005,100,,Cash sale,,,,,,28/06/2018,28/06/2018,0.00,,9.13,,"-537,948.96"
,CS,AR,32005283,1005,100,,Cash sale,,,,,,28/06/2018,28/06/2018,0.00,,14.58,,"-537,963.54"
,CS,AR,32005287,1005,100,,Cash sale,,,,,,28/06/2018,28/06/2018,0.00,,7.29,,"-537,970.83"
,CS,AR,32005310,1005,100,,Cash sale,,,,,,28/06/2018,28/06/2018,0.00,,7.29,,"-537,978.12"
,CS,AR,32005317,1005,100,,Cash sale,,,,,,28/06/2018,28/06/2018,0.00,,3.64,,"-537,981.76"
,CS,AR,32005326,1005,100,,Cash sale,,,,,,28/06/2018,28/06/2018,0.00,,10.93,,"-537,992.69"
,CS,AR,32005330,1005,100,,Cash sale,,,,,,28/06/2018,28/06/2018,0.00,,10.38,,"-538,003.07"
,CS,AR,32005352,1005,100,,Cash sale,,,,,,28/06/2018,28/06/2018,0.00,,23.29,,"-538,026.36"
,CS,AR,32005356,1005,100,,Cash sale,,,,,,28/06/2018,28/06/2018,0.00,,3.64,,"-538,030.00"
,CS,AR,32005369,1005,100,,Cash sale,,,,,,28/06/2018,28/06/2018,0.00,,14.58,,"-538,044.58"
,CS,AR,32005377,1005,100,,Cash sale,,,,,,28/06/2018,28/06/2018,0.00,,10.93,,"-538,055.51"
,CS,AR,32005378,1005,100,,Cash sale,,,,,,28/06/2018,28/06/2018,0.00,,15.51,,"-538,071.02"
,CS,AR,32005390,1005,100,,Cash sale,,,,,,28/06/2018,28/06/2018,0.00,,18.22,,"-538,089.24"
,CS,AR,32005391,1005,100,,Cash sale,,,,,,28/06/2018,28/06/2018,0.00,,5.17,,"-538,094.41"
,CS,AR,32005406,1005,100,,Cash sale,,,,,,28/06/2018,28/06/2018,0.00,,32.97,,"-538,127.38"
,CS,AR,32005417,1005,100,,Cash sale,,,,,,28/06/2018,28/06/2018,0.00,,15.04,,"-538,142.42"
,CS,AR,32005419,1005,100,,Cash sale,,,,,,28/06/2018,28/06/2018,0.00,,14.58,,"-538,157.00"
,CS,AR,32005435,1005,100,,Cash sale,,,,,,28/06/2018,28/06/2018,0.00,,15.25,,"-538,172.25"
,CS,AR,32005437,1005,100,,Cash sale,,,,,,28/06/2018,28/06/2018,0.00,,22.88,,"-538,195.13"
,CS,AR,32005442,1005,100,,Cash sale,,,,,,28/06/2018,28/06/2018,0.00,,14.62,,"-538,209.75"
,CS,AR,32005452,1005,100,,Cash sale,,,,,,28/06/2018,28/06/2018,0.00,,10.93,,"-538,220.68"
,CS,AR,32005453,1005,100,,Cash sale,,,,,,28/06/2018,28/06/2018,0.00,,12.71,,"-538,233.39"
,CS,AR,32005454,1005,100,,Cash sale,,,,,,28/06/2018,28/06/2018,0.00,,10.93,,"-538,244.32"
,CS,AR,32005464,1005,100,,Cash sale,,,,,,28/06/2018,28/06/2018,0.00,,3.64,,"-538,247.96"
,CS,AR,32005467,1005,100,,Cash sale,,,,,,28/06/2018,28/06/2018,0.00,,10.93,,"-538,258.89"
,CS,AR,32005478,1005,100,,Cash sale,,,,,,28/06/2018,28/06/2018,0.00,,3.64,,"-538,262.53"
,CS,AR,32005506,1005,100,,Cash sale,,,,,,28/06/2018,28/06/2018,0.00,,7.29,,"-538,269.82"
,CS,AR,32005513,1005,100,,Cash sale,,,,,,28/06/2018,28/06/2018,0.00,,17.56,,"-538,287.38"
,CS,AR,32005519,1005,100,,Cash sale,,,,,,28/06/2018,28/06/2018,0.00,,8.78,,"-538,296.16"
,CS,AR,32005521,1005,100,,Cash sale,,,,,,28/06/2018,28/06/2018,0.00,,19.70,,"-538,315.86"
,CS,AR,32005536,1005,100,,Cash sale,,,,,,28/06/2018,28/06/2018,0.00,,7.29,,"-538,323.15"
,CS,AR,32005539,1005,100,,Cash sale,,,,,,28/06/2018,28/06/2018,0.00,,8.34,,"-538,331.49"
,CS,AR,32005588,1005,100,,Cash sale,,,,,,28/06/2018,28/06/2018,0.00,,20.00,,"-538,351.49"
,CS,AR,32005591,1005,100,,Cash sale,,,,,,28/06/2018,28/06/2018,0.00,,7.29,,"-538,358.78"
,CS,AR,32005601,1005,100,,Cash sale,,,,,,28/06/2018,28/06/2018,0.00,,5.93,,"-538,364.71"
,CS,AR,32005611,1005,100,,Cash sale,,,,,,28/06/2018,28/06/2018,0.00,,3.64,,"-538,368.35"
,CS,AR,32005616,1005,100,,Cash sale,,,,,,28/06/2018,28/06/2018,0.00,,13.73,,"-538,382.08"
,CS,AR,32005633,1005,100,,Cash sale,,,,,,28/06/2018,28/06/2018,0.00,,21.86,,"-538,403.94"
,CS,AR,32005637,1005,100,,Cash sale,,,,,,28/06/2018,28/06/2018,0.00,,27.32,,"-538,431.26"
,CS,AR,32005646,1005,100,,Cash sale,,,,,,28/06/2018,28/06/2018,0.00,,3.64,,"-538,434.90"
,CS,AR,32005656,1005,100,,Cash sale,,,,,,28/06/2018,28/06/2018,0.00,,9.15,,"-538,444.05"
,CS,AR,32005665,1005,100,,Cash sale,,,,,,28/06/2018,28/06/2018,0.00,,23.32,,"-538,467.37"
,CS,AR,32005673,1005,100,,Cash sale,,,,,,28/06/2018,28/06/2018,0.00,,6.08,,"-538,473.45"
,CS,AR,32005679,1005,100,,Cash sale,,,,,,28/06/2018,28/06/2018,0.00,,7.29,,"-538,480.74"
,CS,AR,32005684,1005,100,,Cash sale,,,,,,28/06/2018,28/06/2018,0.00,,11.66,,"-538,492.40"
,CS,AR,32005688,1005,100,,Cash sale,,,,,,28/06/2018,28/06/2018,0.00,,10.93,,"-538,503.33"
,CS,AR,32005695,1005,100,,Cash sale,,,,,,28/06/2018,28/06/2018,0.00,,5.86,,"-538,509.19"
,CS,AR,32005703,1005,100,,Cash sale,,,,,,28/06/2018,28/06/2018,0.00,,3.64,,"-538,512.83"
,CS,AR,32005708,1005,100,,Cash sale,,,,,,28/06/2018,28/06/2018,0.00,,7.29,,"-538,520.12"
,CS,AR,32005709,1005,100,,Cash sale,,,,,,28/06/2018,28/06/2018,0.00,,3.01,,"-538,523.13"
,CS,AR,32005714,1005,100,,Cash sale,,,,,,28/06/2018,28/06/2018,0.00,,7.29,,"-538,530.42"
,CS,AR,32005719,1005,100,,Cash sale,,,,,,28/06/2018,28/06/2018,0.00,,18.22,,"-538,548.64"
,CS,AR,32005722,1005,100,,Cash sale,,,,,,28/06/2018,28/06/2018,0.00,,7.29,,"-538,555.93"
,CS,AR,32005739,1005,100,,Cash sale,,,,,,28/06/2018,28/06/2018,0.00,,6.99,,"-538,562.92"
,CS,AR,32005743,1005,100,,Cash sale,,,,,,28/06/2018,28/06/2018,0.00,,3.03,,"-538,565.95"
,CS,AR,32005750,1005,100,,Cash sale,,,,,,28/06/2018,28/06/2018,0.00,,7.29,,"-538,573.24"
,IN,AR,30317314,1005,100,,Invoice,,,,,,28/06/2018,28/06/2018,0.00,,41.53,,"-538,614.77"
,IN,AR,30317316,1005,100,,Invoice,,,,,,28/06/2018,28/06/2018,0.00,,14.58,,"-538,629.35"
,IN,AR,30317317,1005,100,,Invoice,,,,,,28/06/2018,28/06/2018,0.00,,29.15,,"-538,658.50"
,IN,AR,30317351,1005,100,,Invoice,,,,,,28/06/2018,28/06/2018,0.00,,11.86,,"-538,670.36"
,IN,AR,30317357,1005,100,,Invoice,,,,,,28/06/2018,28/06/2018,0.00,,10.93,,"-538,681.29"
,IN,AR,30317359,1005,100,,Invoice,,,,,,28/06/2018,28/06/2018,0.00,,5.68,,"-538,686.97"
,IN,AR,30317366,1005,100,,Invoice,,,,,,28/06/2018,28/06/2018,0.00,,10.93,,"-538,697.90"
,IN,AR,30317378,1005,100,,Invoice,,,,,,28/06/2018,28/06/2018,0.00,,9.66,,"-538,707.56"
,IN,AR,30317386,1005,100,,Invoice,,,,,,28/06/2018,28/06/2018,0.00,,24.41,,"-538,731.97"
,IN,AR,30317391,1005,100,,Invoice,,,,,,28/06/2018,28/06/2018,0.00,,7.29,,"-538,739.26"
,IN,AR,30317395,1005,100,,Invoice,,,,,,28/06/2018,28/06/2018,0.00,,83.81,,"-538,823.07"
,IN,AR,30317397,1005,100,,Invoice,,,,,,28/06/2018,28/06/2018,0.00,,11.48,,"-538,834.55"
,IN,AR,30317401,1005,100,,Invoice,,,,,,28/06/2018,28/06/2018,0.00,,58.22,,"-538,892.77"
,IN,AR,30317414,1005,100,,Invoice,,,,,,28/06/2018,28/06/2018,0.00,,116.27,,"-539,009.04"
,IN,AR,30317423,1005,100,,Invoice,,,,,,28/06/2018,28/06/2018,0.00,,7.29,,"-539,016.33"
,IN,AR,30317431,1005,100,,Invoice,,,,,,28/06/2018,28/06/2018,0.00,,60.00,,"-539,076.33"
,IN,AR,30317442,1005,100,,Invoice,,,,,,28/06/2018,28/06/2018,0.00,,51.02,,"-539,127.35"
,IN,AR,30317444,1005,100,,Invoice,,,,,,28/06/2018,28/06/2018,0.00,,3.64,,"-539,130.99"
,IN,AR,30317446,1005,100,,Invoice,,,,,,28/06/2018,28/06/2018,0.00,,29.15,,"-539,160.14"
,IN,AR,30317456,1005,100,,Invoice,,,,,,28/06/2018,28/06/2018,0.00,,20.00,,"-539,180.14"
,IN,AR,30317457,1005,100,,Invoice,,,,,,28/06/2018,28/06/2018,0.00,,7.29,,"-539,187.43"
,IN,AR,30317476,1005,100,,Invoice,,,,,,28/06/2018,28/06/2018,0.00,,3.89,,"-539,191.32"
,IN,AR,30317484,1005,100,,Invoice,,,,,,28/06/2018,28/06/2018,0.00,,7.12,,"-539,198.44"
,IN,AR,30317485,1005,100,,Invoice,,,,,,28/06/2018,28/06/2018,0.00,,59.32,,"-539,257.76"
,IN,AR,30317490,1005,100,,Invoice,,,,,,28/06/2018,28/06/2018,0.00,,18.00,,"-539,275.76"
,IN,AR,30317494,1005,100,,Invoice,,,,,,28/06/2018,28/06/2018,0.00,,46.68,,"-539,322.44"
,IN,AR,30317508,1005,100,,Invoice,,,,,,28/06/2018,28/06/2018,0.00,,13.58,,"-539,336.02"
,IN,AR,30317509,1005,100,,Invoice,,,,,,28/06/2018,28/06/2018,0.00,,1.94,,"-539,337.96"
,IN,AR,30317517,1005,100,,Invoice,,,,,,28/06/2018,28/06/2018,0.00,,32.00,,"-539,369.96"
,IN,AR,30317527,1005,100,,Invoice,,,,,,28/06/2018,28/06/2018,0.00,,5.59,,"-539,375.55"
,IN,AR,30317528,1005,100,,Invoice,,,,,,28/06/2018,28/06/2018,0.00,,7.29,,"-539,382.84"
,IN,AR,30317539,1005,100,,Invoice,,,,,,28/06/2018,28/06/2018,0.00,,3.64,,"-539,386.48"
,IN,AR,30317544,1005,100,,Invoice,,,,,,28/06/2018,28/06/2018,0.00,,18.22,,"-539,404.70"
,IN,AR,30317551,1005,100,,Invoice,,,,,,28/06/2018,28/06/2018,0.00,,21.00,,"-539,425.70"
,IN,AR,30317554,1005,100,,Invoice,,,,,,28/06/2018,28/06/2018,0.00,,5.17,,"-539,430.87"
,IN,AR,30317591,1005,100,,Invoice,,,,,,28/06/2018,28/06/2018,0.00,,101.69,,"-539,532.56"
,IN,AR,30317592,1005,100,,Invoice,,,,,,28/06/2018,28/06/2018,0.00,,20.34,,"-539,552.90"
,IN,AR,30317608,1005,100,,Invoice,,,,,,28/06/2018,28/06/2018,0.00,,25.85,,"-539,578.75"
,IN,AR,30317613,1005,100,,Invoice,,,,,,28/06/2018,28/06/2018,0.00,,138.88,,"-539,717.63"
,IN,AR,30317625,1005,100,,Invoice,,,,,,28/06/2018,28/06/2018,0.00,,3.01,,"-539,720.64"
,IN,AR,30317632,1005,100,,Invoice,,,,,,28/06/2018,28/06/2018,0.00,,612.20,,"-540,332.84"
,IN,AR,30317641,1005,100,,Invoice,,,,,,28/06/2018,28/06/2018,0.00,,104.59,,"-540,437.43"
,IN,AR,30317663,1005,100,,Invoice,,,,,,28/06/2018,28/06/2018,0.00,,12.88,,"-540,450.31"
,IN,AR,30317666,1005,100,,Invoice,,,,,,28/06/2018,28/06/2018,0.00,,38.64,,"-540,488.95"
,IN,AR,30317668,1005,100,,Invoice,,,,,,28/06/2018,28/06/2018,0.00,,7.29,,"-540,496.24"
,IN,AR,30317677,1005,100,,Invoice,,,,,,28/06/2018,28/06/2018,0.00,,3.01,,"-540,499.25"
,IN,AR,30317678,1005,100,,Invoice,,,,,,28/06/2018,28/06/2018,0.00,,10.93,,"-540,510.18"
,IN,AR,30317682,1005,100,,Invoice,,,,,,28/06/2018,28/06/2018,0.00,,23.49,,"-540,533.67"
,IN,AR,30317728,1005,100,,Invoice,,,,,,28/06/2018,28/06/2018,0.00,,4.78,,"-540,538.45"
,IN,AR,30317741,1005,100,,Invoice,,,,,,28/06/2018,28/06/2018,0.00,,10.17,,"-540,548.62"
,IN,AR,30317746,1005,100,,Invoice,,,,,,28/06/2018,28/06/2018,0.00,,10.17,,"-540,558.79"
,IN,AR,30317749,1005,100,,Invoice,,,,,,28/06/2018,28/06/2018,0.00,,23.90,,"-540,582.69"
,IN,AR,30317769,1005,100,,Invoice,,,,,,28/06/2018,28/06/2018,0.00,,24.07,,"-540,606.76"
,IN,AR,30317802,1005,100,,Invoice,,,,,,28/06/2018,28/06/2018,0.00,,15.25,,"-540,622.01"
,IN,AR,30317805,1005,100,,Invoice,,,,,,28/06/2018,28/06/2018,0.00,,10.59,,"-540,632.60"
,IN,AR,30317814,1005,100,,Invoice,,,,,,28/06/2018,28/06/2018,0.00,,3.64,,"-540,636.24"
,IN,AR,30317821,1005,100,,Invoice,,,,,,28/06/2018,28/06/2018,0.00,,22.88,,"-540,659.12"
,IN,AR,30317850,1005,100,,Invoice,,,,,,28/06/2018,28/06/2018,0.00,,3.64,,"-540,662.76"
,IN,AR,30317870,1005,100,,Invoice,,,,,,28/06/2018,28/06/2018,0.00,,13.73,,"-540,676.49"
,IN,AR,30317881,1005,100,,Invoice,,,,,,28/06/2018,28/06/2018,0.00,,4.24,,"-540,680.73"
,IN,AR,30317888,1005,100,,Invoice,,,,,,28/06/2018,28/06/2018,0.00,,14.58,,"-540,695.31"
,IN,AR,30317890,1005,100,,Invoice,,,,,,28/06/2018,28/06/2018,0.00,,935.01,,"-541,630.32"
,IN,AR,30317903,1005,100,,Invoice,,,,,,28/06/2018,28/06/2018,0.00,,40.08,,"-541,670.40"
,IN,AR,30317928,1005,100,,Invoice,,,,,,28/06/2018,28/06/2018,0.00,,4.64,,"-541,675.04"
,IN,AR,30317931,1005,100,,Invoice,,,,,,28/06/2018,28/06/2018,0.00,,8.77,,"-541,683.81"
,IN,AR,30317932,1005,100,,Invoice,,,,,,28/06/2018,28/06/2018,0.00,,54.66,,"-541,738.47"
,IN,AR,30317938,1005,100,,Invoice,,,,,,28/06/2018,28/06/2018,0.00,,16.53,,"-541,755.00"
,IN,AR,30317962,1005,100,,Invoice,,,,,,28/06/2018,28/06/2018,0.00,,7.29,,"-541,762.29"
,IN,AR,30317967,1005,100,,Invoice,,,,,,28/06/2018,28/06/2018,0.00,,54.66,,"-541,816.95"
,IN,AR,30317969,1005,100,,Invoice,,,,,,28/06/2018,28/06/2018,0.00,,21.06,,"-541,838.01"
,IN,AR,30317972,1005,100,,Invoice,,,,,,28/06/2018,28/06/2018,0.00,,10.99,,"-541,849.00"
,IN,AR,30317992,1005,100,,Invoice,,,,,,28/06/2018,28/06/2018,0.00,,29.55,,"-541,878.55"
,IN,AR,30318002,1005,100,,Invoice,,,,,,28/06/2018,28/06/2018,0.00,,3.53,,"-541,882.08"
,IN,AR,30318003,1005,100,,Invoice,,,,,,28/06/2018,28/06/2018,0.00,,7.05,,"-541,889.13"
,IN,AR,30318004,1005,100,,Invoice,,,,,,28/06/2018,28/06/2018,0.00,,7.05,,"-541,896.18"
,IN,AR,30318013,1005,100,,Invoice,,,,,,28/06/2018,28/06/2018,0.00,,4.85,,"-541,901.03"
,IN,AR,30318021,1005,100,,Invoice,,,,,,28/06/2018,28/06/2018,0.00,,99.58,,"-542,000.61"
,IN,AR,30318084,1005,100,,Invoice,,,,,,28/06/2018,28/06/2018,0.00,,9.76,,"-542,010.37"
,IN,AR,30318085,1005,100,,Invoice,,,,,,28/06/2018,28/06/2018,0.00,,8.14,,"-542,018.51"
,IN,AR,30318086,1005,100,,Invoice,,,,,,28/06/2018,28/06/2018,0.00,,9.76,,"-542,028.27"
,IN,AR,30318095,1005,100,,Invoice,,,,,,28/06/2018,28/06/2018,0.00,,23.85,,"-542,052.12"
,IN,AR,30318102,1005,100,,Invoice,,,,,,28/06/2018,28/06/2018,0.00,,34.07,,"-542,086.19"
,IN,AR,30318111,1005,100,,Invoice,,,,,,28/06/2018,28/06/2018,0.00,,105.99,,"-542,192.18"
,IN,AR,30318118,1005,100,,Invoice,,,,,,28/06/2018,28/06/2018,0.00,,52.11,,"-542,244.29"
,IN,AR,30318124,1005,100,,Invoice,,,,,,28/06/2018,28/06/2018,0.00,,51.02,,"-542,295.31"
,IN,AR,30318133,1005,100,,Invoice,,,,,,28/06/2018,28/06/2018,0.00,,9.11,,"-542,304.42"
,IN,AR,30318135,1005,100,,Invoice,,,,,,28/06/2018,28/06/2018,0.00,,12.03,,"-542,316.45"
,IN,AR,30318141,1005,100,,Invoice,,,,,,28/06/2018,28/06/2018,0.00,,80.17,,"-542,396.62"
,IN,AR,30318150,1005,100,,Invoice,,,,,,28/06/2018,28/06/2018,0.00,,31.53,,"-542,428.15"
,IN,AR,30318154,1005,100,,Invoice,,,,,,28/06/2018,28/06/2018,0.00,,7.63,,"-542,435.78"
,IN,AR,30318165,1005,100,,Invoice,,,,,,28/06/2018,28/06/2018,0.00,,182.20,,"-542,617.98"
,IN,AR,30318171,1005,100,,Invoice,,,,,,28/06/2018,28/06/2018,0.00,,11.95,,"-542,629.93"
,IN,AR,30318175,1005,100,,Invoice,,,,,,28/06/2018,28/06/2018,0.00,,25.51,,"-542,655.44"
,IN,AR,30318187,1005,100,,Invoice,,,,,,28/06/2018,28/06/2018,0.00,,22.88,,"-542,678.32"
,IN,AR,30318188,1005,100,,Invoice,,,,,,28/06/2018,28/06/2018,0.00,,5.08,,"-542,683.40"
,IN,AR,30318193,1005,100,,Invoice,,,,,,28/06/2018,28/06/2018,0.00,,16.01,,"-542,699.41"
,IN,AR,30318196,1005,100,,Invoice,,,,,,28/06/2018,28/06/2018,0.00,,16.01,,"-542,715.42"
,IN,AR,30318198,1005,100,,Invoice,,,,,,28/06/2018,28/06/2018,0.00,,18.01,,"-542,733.43"
,IN,AR,30318199,1005,100,,Invoice,,,,,,28/06/2018,28/06/2018,0.00,,8.00,,"-542,741.43"
,IN,AR,30318206,1005,100,,Invoice,,,,,,28/06/2018,28/06/2018,0.00,,20.41,,"-542,761.84"
,IN,AR,30318207,1005,100,,Invoice,,,,,,28/06/2018,28/06/2018,0.00,,11.66,,"-542,773.50"
,IN,AR,30318214,1005,100,,Invoice,,,,,,28/06/2018,28/06/2018,0.00,,45.25,,"-542,818.75"
,IN,AR,30318221,1005,100,,Invoice,,,,,,28/06/2018,28/06/2018,0.00,,27.37,,"-542,846.12"
,IN,AR,30318226,1005,100,,Invoice,,,,,,28/06/2018,28/06/2018,0.00,,31.54,,"-542,877.66"
,IN,AR,30318232,1005,100,,Invoice,,,,,,28/06/2018,28/06/2018,0.00,,29.15,,"-542,906.81"
,IN,AR,30318234,1005,100,,Invoice,,,,,,28/06/2018,28/06/2018,0.00,,10.93,,"-542,917.74"
,IN,AR,30318240,1005,100,,Invoice,,,,,,28/06/2018,28/06/2018,0.00,,37.29,,"-542,955.03"
,IN,AR,30318250,1005,100,,Invoice,,,,,,28/06/2018,28/06/2018,0.00,,9.19,,"-542,964.22"
,IN,AR,30318254,1005,100,,Invoice,,,,,,28/06/2018,28/06/2018,0.00,,27.46,,"-542,991.68"
,IN,AR,30318258,1005,100,,Invoice,,,,,,28/06/2018,28/06/2018,0.00,,5.08,,"-542,996.76"
,IN,AR,30318276,1005,100,,Invoice,,,,,,28/06/2018,28/06/2018,0.00,,29.15,,"-543,025.91"
,IN,AR,30318278,1005,100,,Invoice,,,,,,28/06/2018,28/06/2018,0.00,,11.36,,"-543,037.27"
,IN,AR,30318280,1005,100,,Invoice,,,,,,28/06/2018,28/06/2018,0.00,,14.49,,"-543,051.76"
,IN,AR,30318300,1005,100,,Invoice,,,,,,28/06/2018,28/06/2018,0.00,,7.97,,"-543,059.73"
,IN,AR,30318301,1005,100,,Invoice,,,,,,28/06/2018,28/06/2018,0.00,,38.24,,"-543,097.97"
,IN,AR,30318337,1005,100,,Invoice,,,,,,28/06/2018,28/06/2018,0.00,,86.02,,"-543,183.99"
,IN,AR,30318352,1005,100,,Invoice,,,,,,28/06/2018,28/06/2018,0.00,,16.00,,"-543,199.99"
,IN,AR,30318353,1005,100,,Invoice,,,,,,28/06/2018,28/06/2018,0.00,,4.00,,"-543,203.99"
,IN,AR,30318384,1005,100,,Invoice,,,,,,28/06/2018,28/06/2018,0.00,,5.83,,"-543,209.82"
,IN,AR,30318393,1005,100,,Invoice,,,,,,28/06/2018,28/06/2018,0.00,,5.47,,"-543,215.29"
,IN,AR,30318400,1005,100,,Invoice,,,,,,28/06/2018,28/06/2018,0.00,,36.02,,"-543,251.31"
,IN,AR,30318422,1005,100,,Invoice,,,,,,28/06/2018,28/06/2018,0.00,,182.20,,"-543,433.51"
,IN,AR,30318431,1005,100,,Invoice,,,,,,28/06/2018,28/06/2018,0.00,,6.13,,"-543,439.64"
,IN,AR,30318434,1005,100,,Invoice,,,,,,28/06/2018,28/06/2018,0.00,,10.21,,"-543,449.85"
,IN,AR,30318448,1005,100,,Invoice,,,,,,28/06/2018,28/06/2018,0.00,,15.93,,"-543,465.78"
,IN,AR,30318470,1005,100,,Invoice,,,,,,28/06/2018,28/06/2018,0.00,,6.00,,"-543,471.78"
,IN,AR,30318471,1005,100,,Invoice,,,,,,28/06/2018,28/06/2018,0.00,,4.00,,"-543,475.78"
,IN,AR,30318499,1005,100,,Invoice,,,,,,28/06/2018,28/06/2018,0.00,,80.97,,"-543,556.75"
,IN,AR,30318500,1005,100,,Invoice,,,,,,28/06/2018,28/06/2018,0.00,,16.61,,"-543,573.36"
,IN,AR,30318504,1005,100,,Invoice,,,,,,28/06/2018,28/06/2018,0.00,,2.54,,"-543,575.90"
,IN,AR,30318510,1005,100,,Invoice,,,,,,28/06/2018,28/06/2018,0.00,,7.29,,"-543,583.19"
,IN,AR,30318511,1005,100,,Invoice,,,,,,28/06/2018,28/06/2018,0.00,,9.11,,"-543,592.30"
,IN,AR,30318527,1005,100,,Invoice,,,,,,28/06/2018,28/06/2018,0.00,,14.58,,"-543,606.88"
,IN,AR,30318534,1005,100,,Invoice,,,,,,28/06/2018,28/06/2018,0.00,,10.93,,"-543,617.81"
,IN,AR,30318556,1005,100,,Invoice,,,,,,28/06/2018,28/06/2018,0.00,,7.29,,"-543,625.10"
,IN,AR,30318557,1005,100,,Invoice,,,,,,28/06/2018,28/06/2018,0.00,,10.93,,"-543,636.03"
,IN,AR,30318558,1005,100,,Invoice,,,,,,28/06/2018,28/06/2018,0.00,,29.15,,"-543,665.18"
,IN,AR,30318568,1005,100,,Invoice,,,,,,28/06/2018,28/06/2018,0.00,,364.41,,"-544,029.59"
,IN,AR,30319279,1005,100,,Invoice,,,,,,28/06/2018,28/06/2018,0.00,,22.88,,"-544,052.47"
,IN,AR,30331726,1005,100,,Invoice,,,,,,28/06/2018,28/06/2018,0.00,,7.29,,"-544,059.76"
,CS,AR,32012553,1005,100,,Cash sale,,,,,,28/06/2018,28/06/2018,0.00,,7.29,,"-544,067.05"
,CR,AR,33000193,1005,100,,Cash Return,,,,,,30/06/2018,30/06/2018,10.93,,0.00,,"-544,056.12"
,CS,AR,32005348,1005,100,,Cash sale,,,,,,30/06/2018,30/06/2018,0.00,,7.29,,"-544,063.41"
,CS,AR,32005394,1005,100,,Cash sale,,,,,,30/06/2018,30/06/2018,0.00,,20.34,,"-544,083.75"
,CS,AR,32005450,1005,100,,Cash sale,,,,,,30/06/2018,30/06/2018,0.00,,12.25,,"-544,096.00"
,CS,AR,32005457,1005,100,,Cash sale,,,,,,30/06/2018,30/06/2018,0.00,,10.93,,"-544,106.93"
,CS,AR,32005470,1005,100,,Cash sale,,,,,,30/06/2018,30/06/2018,0.00,,7.29,,"-544,114.22"
,CS,AR,32005561,1005,100,,Cash sale,,,,,,30/06/2018,30/06/2018,0.00,,7.29,,"-544,121.51"
,CS,AR,32005622,1005,100,,Cash sale,,,,,,30/06/2018,30/06/2018,0.00,,10.93,,"-544,132.44"
,CS,AR,32005734,1005,100,,Cash sale,,,,,,30/06/2018,30/06/2018,0.00,,7.29,,"-544,139.73"
,IN,AR,30317302,1005,100,,Invoice,,,,,,30/06/2018,30/06/2018,0.00,,9.32,,"-544,149.05"
,IN,AR,30317361,1005,100,,Invoice,,,,,,30/06/2018,30/06/2018,0.00,,"1,610.90",,"-545,759.95"
,IN,AR,30317415,1005,100,,Invoice,,,,,,30/06/2018,30/06/2018,0.00,,45.08,,"-545,805.03"
,IN,AR,30317421,1005,100,,Invoice,,,,,,30/06/2018,30/06/2018,0.00,,"1,533.47",,"-547,338.50"
,IN,AR,30317471,1005,100,,Invoice,,,,,,30/06/2018,30/06/2018,0.00,,10.93,,"-547,349.43"
,IN,AR,30317486,1005,100,,Invoice,,,,,,30/06/2018,30/06/2018,0.00,,51.27,,"-547,400.70"
,IN,AR,30317512,1005,100,,Invoice,,,,,,30/06/2018,30/06/2018,0.00,,10.93,,"-547,411.63"
,IN,AR,30317534,1005,100,,Invoice,,,,,,30/06/2018,30/06/2018,0.00,,81.23,,"-547,492.86"
,IN,AR,30317576,1005,100,,Invoice,,,,,,30/06/2018,30/06/2018,0.00,,"1,415.67",,"-548,908.53"
,IN,AR,30317577,1005,100,,Invoice,,,,,,30/06/2018,30/06/2018,0.00,,50.87,,"-548,959.40"
,IN,AR,30317578,1005,100,,Invoice,,,,,,30/06/2018,30/06/2018,0.00,,21.05,,"-548,980.45"
,IN,AR,30317579,1005,100,,Invoice,,,,,,30/06/2018,30/06/2018,0.00,,84.20,,"-549,064.65"
,IN,AR,30317594,1005,100,,Invoice,,,,,,30/06/2018,30/06/2018,0.00,,194.92,,"-549,259.57"
,IN,AR,30317630,1005,100,,Invoice,,,,,,30/06/2018,30/06/2018,0.00,,"1,950.03",,"-551,209.60"
,IN,AR,30317670,1005,100,,Invoice,,,,,,30/06/2018,30/06/2018,0.00,,703.07,,"-551,912.67"
,IN,AR,30317671,1005,100,,Invoice,,,,,,30/06/2018,30/06/2018,0.00,,33.56,,"-551,946.23"
,IN,AR,30317672,1005,100,,Invoice,,,,,,30/06/2018,30/06/2018,0.00,,41.95,,"-551,988.18"
,IN,AR,30317673,1005,100,,Invoice,,,,,,30/06/2018,30/06/2018,0.00,,25.17,,"-552,013.35"
,IN,AR,30317674,1005,100,,Invoice,,,,,,30/06/2018,30/06/2018,0.00,,8.39,,"-552,021.74"
,IN,AR,30317675,1005,100,,Invoice,,,,,,30/06/2018,30/06/2018,0.00,,11.75,,"-552,033.49"
,IN,AR,30317676,1005,100,,Invoice,,,,,,30/06/2018,30/06/2018,0.00,,3.36,,"-552,036.85"
,IN,AR,30317692,1005,100,,Invoice,,,,,,30/06/2018,30/06/2018,0.00,,131.57,,"-552,168.42"
,IN,AR,30317694,1005,100,,Invoice,,,,,,30/06/2018,30/06/2018,0.00,,166.65,,"-552,335.07"
,IN,AR,30317697,1005,100,,Invoice,,,,,,30/06/2018,30/06/2018,0.00,,37.63,,"-552,372.70"
,IN,AR,30317698,1005,100,,Invoice,,,,,,30/06/2018,30/06/2018,0.00,,50.87,,"-552,423.57"
,IN,AR,30317699,1005,100,,Invoice,,,,,,30/06/2018,30/06/2018,0.00,,147.36,,"-552,570.93"
,IN,AR,30317703,1005,100,,Invoice,,,,,,30/06/2018,30/06/2018,0.00,,35.08,,"-552,606.01"
,IN,AR,30317704,1005,100,,Invoice,,,,,,30/06/2018,30/06/2018,0.00,,11.29,,"-552,617.30"
,IN,AR,30317705,1005,100,,Invoice,,,,,,30/06/2018,30/06/2018,0.00,,33.86,,"-552,651.16"
,IN,AR,30317706,1005,100,,Invoice,,,,,,30/06/2018,30/06/2018,0.00,,33.86,,"-552,685.02"
,IN,AR,30317707,1005,100,,Invoice,,,,,,30/06/2018,30/06/2018,0.00,,35.75,,"-552,720.77"
,IN,AR,30317708,1005,100,,Invoice,,,,,,30/06/2018,30/06/2018,0.00,,15.05,,"-552,735.82"
,IN,AR,30317709,1005,100,,Invoice,,,,,,30/06/2018,30/06/2018,0.00,,45.15,,"-552,780.97"
,IN,AR,30317710,1005,100,,Invoice,,,,,,30/06/2018,30/06/2018,0.00,,5.64,,"-552,786.61"
,IN,AR,30317711,1005,100,,Invoice,,,,,,30/06/2018,30/06/2018,0.00,,13.17,,"-552,799.78"
,IN,AR,30317712,1005,100,,Invoice,,,,,,30/06/2018,30/06/2018,0.00,,7.53,,"-552,807.31"
,IN,AR,30317715,1005,100,,Invoice,,,,,,30/06/2018,30/06/2018,0.00,,361.37,,"-553,168.68"
,IN,AR,30317718,1005,100,,Invoice,,,,,,30/06/2018,30/06/2018,0.00,,61.40,,"-553,230.08"
,IN,AR,30317719,1005,100,,Invoice,,,,,,30/06/2018,30/06/2018,0.00,,54.38,,"-553,284.46"
,IN,AR,30317721,1005,100,,Invoice,,,,,,30/06/2018,30/06/2018,0.00,,3.76,,"-553,288.22"
,IN,AR,30317722,1005,100,,Invoice,,,,,,30/06/2018,30/06/2018,0.00,,38.59,,"-553,326.81"
,IN,AR,30317723,1005,100,,Invoice,,,,,,30/06/2018,30/06/2018,0.00,,61.40,,"-553,388.21"
,IN,AR,30317725,1005,100,,Invoice,,,,,,30/06/2018,30/06/2018,0.00,,15.79,,"-553,404.00"
,IN,AR,30317726,1005,100,,Invoice,,,,,,30/06/2018,30/06/2018,0.00,,15.79,,"-553,419.79"
,IN,AR,30317727,1005,100,,Invoice,,,,,,30/06/2018,30/06/2018,0.00,,17.54,,"-553,437.33"
,IN,AR,30317729,1005,100,,Invoice,,,,,,30/06/2018,30/06/2018,0.00,,3.51,,"-553,440.84"
,IN,AR,30317742,1005,100,,Invoice,,,,,,30/06/2018,30/06/2018,0.00,,15.79,,"-553,456.63"
,IN,AR,30317755,1005,100,,Invoice,,,,,,30/06/2018,30/06/2018,0.00,,389.44,,"-553,846.07"
,IN,AR,30317770,1005,100,,Invoice,,,,,,30/06/2018,30/06/2018,0.00,,73.31,,"-553,919.38"
,IN,AR,30317771,1005,100,,Invoice,,,,,,30/06/2018,30/06/2018,0.00,,17.88,,"-553,937.26"
,IN,AR,30317772,1005,100,,Invoice,,,,,,30/06/2018,30/06/2018,0.00,,55.43,,"-553,992.69"
,IN,AR,30317773,1005,100,,Invoice,,,,,,30/06/2018,30/06/2018,0.00,,35.76,,"-554,028.45"
,IN,AR,30317774,1005,100,,Invoice,,,,,,30/06/2018,30/06/2018,0.00,,21.46,,"-554,049.91"
,IN,AR,30317775,1005,100,,Invoice,,,,,,30/06/2018,30/06/2018,0.00,,19.67,,"-554,069.58"
,IN,AR,30317776,1005,100,,Invoice,,,,,,30/06/2018,30/06/2018,0.00,,5.36,,"-554,074.94"
,IN,AR,30317777,1005,100,,Invoice,,,,,,30/06/2018,30/06/2018,0.00,,26.82,,"-554,101.76"
,IN,AR,30317778,1005,100,,Invoice,,,,,,30/06/2018,30/06/2018,0.00,,10.73,,"-554,112.49"
,IN,AR,30317779,1005,100,,Invoice,,,,,,30/06/2018,30/06/2018,0.00,,3.58,,"-554,116.07"
,IN,AR,30317780,1005,100,,Invoice,,,,,,30/06/2018,30/06/2018,0.00,,1.79,,"-554,117.86"
,IN,AR,30317781,1005,100,,Invoice,,,,,,30/06/2018,30/06/2018,0.00,,216.36,,"-554,334.22"
,IN,AR,30317782,1005,100,,Invoice,,,,,,30/06/2018,30/06/2018,0.00,,17.88,,"-554,352.10"
,IN,AR,30317783,1005,100,,Invoice,,,,,,30/06/2018,30/06/2018,0.00,,14.31,,"-554,366.41"
,IN,AR,30317785,1005,100,,Invoice,,,,,,30/06/2018,30/06/2018,0.00,,26.82,,"-554,393.23"
,IN,AR,30317786,1005,100,,Invoice,,,,,,30/06/2018,30/06/2018,0.00,,67.95,,"-554,461.18"
,IN,AR,30317787,1005,100,,Invoice,,,,,,30/06/2018,30/06/2018,0.00,,28.61,,"-554,489.79"
,IN,AR,30317788,1005,100,,Invoice,,,,,,30/06/2018,30/06/2018,0.00,,12.52,,"-554,502.31"
,IN,AR,30317789,1005,100,,Invoice,,,,,,30/06/2018,30/06/2018,0.00,,14.31,,"-554,516.62"
,IN,AR,30317790,1005,100,,Invoice,,,,,,30/06/2018,30/06/2018,0.00,,32.19,,"-554,548.81"
,IN,AR,30317791,1005,100,,Invoice,,,,,,30/06/2018,30/06/2018,0.00,,3.58,,"-554,552.39"
,IN,AR,30317792,1005,100,,Invoice,,,,,,30/06/2018,30/06/2018,0.00,,16.09,,"-554,568.48"
,IN,AR,30317793,1005,100,,Invoice,,,,,,30/06/2018,30/06/2018,0.00,,108.76,,"-554,677.24"
,IN,AR,30317794,1005,100,,Invoice,,,,,,30/06/2018,30/06/2018,0.00,,214.45,,"-554,891.69"
,IN,AR,30317795,1005,100,,Invoice,,,,,,30/06/2018,30/06/2018,0.00,,81.69,,"-554,973.38"
,IN,AR,30317796,1005,100,,Invoice,,,,,,30/06/2018,30/06/2018,0.00,,2.04,,"-554,975.42"
,IN,AR,30317797,1005,100,,Invoice,,,,,,30/06/2018,30/06/2018,0.00,,14.30,,"-554,989.72"
,IN,AR,30317798,1005,100,,Invoice,,,,,,30/06/2018,30/06/2018,0.00,,120.50,,"-555,110.22"
,IN,AR,30317799,1005,100,,Invoice,,,,,,30/06/2018,30/06/2018,0.00,,38.81,,"-555,149.03"
,IN,AR,30317800,1005,100,,Invoice,,,,,,30/06/2018,30/06/2018,0.00,,279.81,,"-555,428.84"
,IN,AR,30317860,1005,100,,Invoice,,,,,,30/06/2018,30/06/2018,0.00,,46.82,,"-555,475.66"
,IN,AR,30317889,1005,100,,Invoice,,,,,,30/06/2018,30/06/2018,0.00,,"1,008.09",,"-556,483.75"
,IN,AR,30317893,1005,100,,Invoice,,,,,,30/06/2018,30/06/2018,0.00,,312.10,,"-556,795.85"
,IN,AR,30317894,1005,100,,Invoice,,,,,,30/06/2018,30/06/2018,0.00,,68.80,,"-556,864.65"
,IN,AR,30317895,1005,100,,Invoice,,,,,,30/06/2018,30/06/2018,0.00,,29.82,,"-556,894.47"
,IN,AR,30317964,1005,100,,Invoice,,,,,,30/06/2018,30/06/2018,0.00,,85.36,,"-556,979.83"
,IN,AR,30317984,1005,100,,Invoice,,,,,,30/06/2018,30/06/2018,0.00,,166.10,,"-557,145.93"
,IN,AR,30317985,1005,100,,Invoice,,,,,,30/06/2018,30/06/2018,0.00,,42.12,,"-557,188.05"
,IN,AR,30318050,1005,100,,Invoice,,,,,,30/06/2018,30/06/2018,0.00,,720.09,,"-557,908.14"
,IN,AR,30318051,1005,100,,Invoice,,,,,,30/06/2018,30/06/2018,0.00,,256.71,,"-558,164.85"
,IN,AR,30318052,1005,100,,Invoice,,,,,,30/06/2018,30/06/2018,0.00,,720.09,,"-558,884.94"
,IN,AR,30318053,1005,100,,Invoice,,,,,,30/06/2018,30/06/2018,0.00,,256.71,,"-559,141.65"
,IN,AR,30318061,1005,100,,Invoice,,,,,,30/06/2018,30/06/2018,0.00,,44.28,,"-559,185.93"
,IN,AR,30318062,1005,100,,Invoice,,,,,,30/06/2018,30/06/2018,0.00,,18.64,,"-559,204.57"
,IN,AR,30318063,1005,100,,Invoice,,,,,,30/06/2018,30/06/2018,0.00,,51.27,,"-559,255.84"
,IN,AR,30318064,1005,100,,Invoice,,,,,,30/06/2018,30/06/2018,0.00,,16.31,,"-559,272.15"
,IN,AR,30318065,1005,100,,Invoice,,,,,,30/06/2018,30/06/2018,0.00,,55.93,,"-559,328.08"
,IN,AR,30318066,1005,100,,Invoice,,,,,,30/06/2018,30/06/2018,0.00,,48.94,,"-559,377.02"
,IN,AR,30318067,1005,100,,Invoice,,,,,,30/06/2018,30/06/2018,0.00,,32.63,,"-559,409.65"
,IN,AR,30318068,1005,100,,Invoice,,,,,,30/06/2018,30/06/2018,0.00,,34.96,,"-559,444.61"
,IN,AR,30318069,1005,100,,Invoice,,,,,,30/06/2018,30/06/2018,0.00,,39.62,,"-559,484.23"
,IN,AR,30318070,1005,100,,Invoice,,,,,,30/06/2018,30/06/2018,0.00,,27.97,,"-559,512.20"
,IN,AR,30318071,1005,100,,Invoice,,,,,,30/06/2018,30/06/2018,0.00,,680.32,,"-560,192.52"
,IN,AR,30318072,1005,100,,Invoice,,,,,,30/06/2018,30/06/2018,0.00,,29.15,,"-560,221.67"
,IN,AR,30318120,1005,100,,Invoice,,,,,,30/06/2018,30/06/2018,0.00,,20.67,,"-560,242.34"
,IN,AR,30318121,1005,100,,Invoice,,,,,,30/06/2018,30/06/2018,0.00,,345.48,,"-560,587.82"
,IN,AR,30318158,1005,100,,Invoice,,,,,,30/06/2018,30/06/2018,0.00,,186.87,,"-560,774.69"
,IN,AR,30318159,1005,100,,Invoice,,,,,,30/06/2018,30/06/2018,0.00,,37.75,,"-560,812.44"
,IN,AR,30318160,1005,100,,Invoice,,,,,,30/06/2018,30/06/2018,0.00,,41.53,,"-560,853.97"
,IN,AR,30318161,1005,100,,Invoice,,,,,,30/06/2018,30/06/2018,0.00,,11.32,,"-560,865.29"
,IN,AR,30318219,1005,100,,Invoice,,,,,,30/06/2018,30/06/2018,0.00,,69.35,,"-560,934.64"
,IN,AR,30318305,1005,100,,Invoice,,,,,,30/06/2018,30/06/2018,0.00,,576.95,,"-561,511.59"
,IN,AR,30318306,1005,100,,Invoice,,,,,,30/06/2018,30/06/2018,0.00,,5.85,,"-561,517.44"
,IN,AR,30318307,1005,100,,Invoice,,,,,,30/06/2018,30/06/2018,0.00,,5.85,,"-561,523.29"
,IN,AR,30318308,1005,100,,Invoice,,,,,,30/06/2018,30/06/2018,0.00,,23.39,,"-561,546.68"
,IN,AR,30318309,1005,100,,Invoice,,,,,,30/06/2018,30/06/2018,0.00,,17.54,,"-561,564.22"
,IN,AR,30318310,1005,100,,Invoice,,,,,,30/06/2018,30/06/2018,0.00,,13.64,,"-561,577.86"
,IN,AR,30318311,1005,100,,Invoice,,,,,,30/06/2018,30/06/2018,0.00,,23.39,,"-561,601.25"
,IN,AR,30318312,1005,100,,Invoice,,,,,,30/06/2018,30/06/2018,0.00,,15.59,,"-561,616.84"
,IN,AR,30318313,1005,100,,Invoice,,,,,,30/06/2018,30/06/2018,0.00,,21.44,,"-561,638.28"
,IN,AR,30318314,1005,100,,Invoice,,,,,,30/06/2018,30/06/2018,0.00,,21.44,,"-561,659.72"
,IN,AR,30318315,1005,100,,Invoice,,,,,,30/06/2018,30/06/2018,0.00,,40.93,,"-561,700.65"
,IN,AR,30318316,1005,100,,Invoice,,,,,,30/06/2018,30/06/2018,0.00,,11.69,,"-561,712.34"
,IN,AR,30318317,1005,100,,Invoice,,,,,,30/06/2018,30/06/2018,0.00,,15.59,,"-561,727.93"
,IN,AR,30318318,1005,100,,Invoice,,,,,,30/06/2018,30/06/2018,0.00,,9.75,,"-561,737.68"
,IN,AR,30318319,1005,100,,Invoice,,,,,,30/06/2018,30/06/2018,0.00,,21.44,,"-561,759.12"
,IN,AR,30318320,1005,100,,Invoice,,,,,,30/06/2018,30/06/2018,0.00,,17.54,,"-561,776.66"
,IN,AR,30318321,1005,100,,Invoice,,,,,,30/06/2018,30/06/2018,0.00,,19.49,,"-561,796.15"
,IN,AR,30318322,1005,100,,Invoice,,,,,,30/06/2018,30/06/2018,0.00,,9.75,,"-561,805.90"
,IN,AR,30318323,1005,100,,Invoice,,,,,,30/06/2018,30/06/2018,0.00,,21.44,,"-561,827.34"
,IN,AR,30318324,1005,100,,Invoice,,,,,,30/06/2018,30/06/2018,0.00,,7.80,,"-561,835.14"
,IN,AR,30318325,1005,100,,Invoice,,,,,,30/06/2018,30/06/2018,0.00,,633.47,,"-562,468.61"
,IN,AR,30318326,1005,100,,Invoice,,,,,,30/06/2018,30/06/2018,0.00,,40.93,,"-562,509.54"
,IN,AR,30318327,1005,100,,Invoice,,,,,,30/06/2018,30/06/2018,0.00,,48.73,,"-562,558.27"
,IN,AR,30318328,1005,100,,Invoice,,,,,,30/06/2018,30/06/2018,0.00,,748.47,,"-563,306.74"
,IN,AR,30318329,1005,100,,Invoice,,,,,,30/06/2018,30/06/2018,0.00,,25.34,,"-563,332.08"
,IN,AR,30318330,1005,100,,Invoice,,,,,,30/06/2018,30/06/2018,0.00,,23.39,,"-563,355.47"
,IN,AR,30318331,1005,100,,Invoice,,,,,,30/06/2018,30/06/2018,0.00,,15.59,,"-563,371.06"
,IN,AR,30318332,1005,100,,Invoice,,,,,,30/06/2018,30/06/2018,0.00,,3.90,,"-563,374.96"
,IN,AR,30318333,1005,100,,Invoice,,,,,,30/06/2018,30/06/2018,0.00,,35.08,,"-563,410.04"
,IN,AR,30318334,1005,100,,Invoice,,,,,,30/06/2018,30/06/2018,0.00,,70.17,,"-563,480.21"
,IN,AR,30318335,1005,100,,Invoice,,,,,,30/06/2018,30/06/2018,0.00,,35.08,,"-563,515.29"
,IN,AR,30318336,1005,100,,Invoice,,,,,,30/06/2018,30/06/2018,0.00,,9.75,,"-563,525.04"
,IN,AR,30318339,1005,100,,Invoice,,,,,,30/06/2018,30/06/2018,0.00,,14.58,,"-563,539.62"
,IN,AR,30318354,1005,100,,Invoice,,,,,,30/06/2018,30/06/2018,0.00,,9.41,,"-563,549.03"
,IN,AR,30318355,1005,100,,Invoice,,,,,,30/06/2018,30/06/2018,0.00,,5.64,,"-563,554.67"
,IN,AR,30318356,1005,100,,Invoice,,,,,,30/06/2018,30/06/2018,0.00,,13.17,,"-563,567.84"
,IN,AR,30318357,1005,100,,Invoice,,,,,,30/06/2018,30/06/2018,0.00,,5.64,,"-563,573.48"
,IN,AR,30318377,1005,100,,Invoice,,,,,,30/06/2018,30/06/2018,0.00,,694.68,,"-564,268.16"
,IN,AR,30318385,1005,100,,Invoice,,,,,,30/06/2018,30/06/2018,0.00,,9.84,,"-564,278.00"
,IN,AR,30318408,1005,100,,Invoice,,,,,,30/06/2018,30/06/2018,0.00,,12.14,,"-564,290.14"
,IN,AR,30318411,1005,100,,Invoice,,,,,,30/06/2018,30/06/2018,0.00,,153.08,,"-564,443.22"
,IN,AR,30318412,1005,100,,Invoice,,,,,,30/06/2018,30/06/2018,0.00,,460.93,,"-564,904.15"
,IN,AR,30318419,1005,100,,Invoice,,,,,,30/06/2018,30/06/2018,0.00,,21.86,,"-564,926.01"
,IN,AR,30318453,1005,100,,Invoice,,,,,,30/06/2018,30/06/2018,0.00,,35.58,,"-564,961.59"
,IN,AR,30318454,1005,100,,Invoice,,,,,,30/06/2018,30/06/2018,0.00,,16.42,,"-564,978.01"
,IN,AR,30318455,1005,100,,Invoice,,,,,,30/06/2018,30/06/2018,0.00,,16.42,,"-564,994.43"
,IN,AR,30318456,1005,100,,Invoice,,,,,,30/06/2018,30/06/2018,0.00,,10.95,,"-565,005.38"
,IN,AR,30318457,1005,100,,Invoice,,,,,,30/06/2018,30/06/2018,0.00,,2.74,,"-565,008.12"
,IN,AR,30318553,1005,100,,Invoice,,,,,,30/06/2018,30/06/2018,0.00,,65.16,,"-565,073.28"
,IN,AR,30319044,1005,100,,Invoice,,,,,,01/07/2018,01/07/2018,0.00,,29.15,,"-565,102.43"
,CN,AR,31018334,1005,100,,Credit Note,,,,,,02/07/2018,02/07/2018,256.71,,0.00,,"-564,845.72"
,CN,AR,31018335,1005,100,,Credit Note,,,,,,02/07/2018,02/07/2018,720.09,,0.00,,"-564,125.63"
,CS,AR,32005763,1005,100,,Cash sale,,,,,,02/07/2018,02/07/2018,0.00,,30.86,,"-564,156.49"
,CS,AR,32005774,1005,100,,Cash sale,,,,,,02/07/2018,02/07/2018,0.00,,3.64,,"-564,160.13"
,CS,AR,32005775,1005,100,,Cash sale,,,,,,02/07/2018,02/07/2018,0.00,,14.58,,"-564,174.71"
,CS,AR,32005782,1005,100,,Cash sale,,,,,,02/07/2018,02/07/2018,0.00,,7.29,,"-564,182.00"
,CS,AR,32005783,1005,100,,Cash sale,,,,,,02/07/2018,02/07/2018,0.00,,3.64,,"-564,185.64"
,CS,AR,32005786,1005,100,,Cash sale,,,,,,02/07/2018,02/07/2018,0.00,,19.32,,"-564,204.96"
,CS,AR,32005794,1005,100,,Cash sale,,,,,,02/07/2018,02/07/2018,0.00,,16.61,,"-564,221.57"
,CS,AR,32005803,1005,100,,Cash sale,,,,,,02/07/2018,02/07/2018,0.00,,7.29,,"-564,228.86"
,CS,AR,32005804,1005,100,,Cash sale,,,,,,02/07/2018,02/07/2018,0.00,,17.54,,"-564,246.40"
,CS,AR,32005809,1005,100,,Cash sale,,,,,,02/07/2018,02/07/2018,0.00,,3.64,,"-564,250.04"
,CS,AR,32005818,1005,100,,Cash sale,,,,,,02/07/2018,02/07/2018,0.00,,3.64,,"-564,253.68"
,CS,AR,32005820,1005,100,,Cash sale,,,,,,02/07/2018,02/07/2018,0.00,,10.34,,"-564,264.02"
,CS,AR,32005827,1005,100,,Cash sale,,,,,,02/07/2018,02/07/2018,0.00,,7.29,,"-564,271.31"
,CS,AR,32005829,1005,100,,Cash sale,,,,,,02/07/2018,02/07/2018,0.00,,7.63,,"-564,278.94"
,CS,AR,32005831,1005,100,,Cash sale,,,,,,02/07/2018,02/07/2018,0.00,,12.92,,"-564,291.86"
,CS,AR,32005846,1005,100,,Cash sale,,,,,,02/07/2018,02/07/2018,0.00,,12.03,,"-564,303.89"
,CS,AR,32005850,1005,100,,Cash sale,,,,,,02/07/2018,02/07/2018,0.00,,7.29,,"-564,311.18"
,CS,AR,32005856,1005,100,,Cash sale,,,,,,02/07/2018,02/07/2018,0.00,,5.08,,"-564,316.26"
,CS,AR,32005862,1005,100,,Cash sale,,,,,,02/07/2018,02/07/2018,0.00,,17.54,,"-564,333.80"
,CS,AR,32005869,1005,100,,Cash sale,,,,,,02/07/2018,02/07/2018,0.00,,7.29,,"-564,341.09"
,CS,AR,32005886,1005,100,,Cash sale,,,,,,02/07/2018,02/07/2018,0.00,,5.08,,"-564,346.17"
,CS,AR,32005893,1005,100,,Cash sale,,,,,,02/07/2018,02/07/2018,0.00,,5.17,,"-564,351.34"
,CS,AR,32005894,1005,100,,Cash sale,,,,,,02/07/2018,02/07/2018,0.00,,7.29,,"-564,358.63"
,CS,AR,32005896,1005,100,,Cash sale,,,,,,02/07/2018,02/07/2018,0.00,,18.22,,"-564,376.85"
,CS,AR,32005898,1005,100,,Cash sale,,,,,,02/07/2018,02/07/2018,0.00,,6.02,,"-564,382.87"
,CS,AR,32005905,1005,100,,Cash sale,,,,,,02/07/2018,02/07/2018,0.00,,7.29,,"-564,390.16"
,CS,AR,32005906,1005,100,,Cash sale,,,,,,02/07/2018,02/07/2018,0.00,,6.08,,"-564,396.24"
,CS,AR,32005908,1005,100,,Cash sale,,,,,,02/07/2018,02/07/2018,0.00,,7.29,,"-564,403.53"
,CS,AR,32005930,1005,100,,Cash sale,,,,,,02/07/2018,02/07/2018,0.00,,14.58,,"-564,418.11"
,CS,AR,32005931,1005,100,,Cash sale,,,,,,02/07/2018,02/07/2018,0.00,,14.58,,"-564,432.69"
,CS,AR,32005932,1005,100,,Cash sale,,,,,,02/07/2018,02/07/2018,0.00,,5.17,,"-564,437.86"
,CS,AR,32005949,1005,100,,Cash sale,,,,,,02/07/2018,02/07/2018,0.00,,3.28,,"-564,441.14"
,CS,AR,32005950,1005,100,,Cash sale,,,,,,02/07/2018,02/07/2018,0.00,,7.29,,"-564,448.43"
,CS,AR,32005955,1005,100,,Cash sale,,,,,,02/07/2018,02/07/2018,0.00,,13.73,,"-564,462.16"
,CS,AR,32005971,1005,100,,Cash sale,,,,,,02/07/2018,02/07/2018,0.00,,7.29,,"-564,469.45"
,CS,AR,32005972,1005,100,,Cash sale,,,,,,02/07/2018,02/07/2018,0.00,,57.16,,"-564,526.61"
,CS,AR,32005973,1005,100,,Cash sale,,,,,,02/07/2018,02/07/2018,0.00,,5.47,,"-564,532.08"
,CS,AR,32005974,1005,100,,Cash sale,,,,,,02/07/2018,02/07/2018,0.00,,10.93,,"-564,543.01"
,CS,AR,32005989,1005,100,,Cash sale,,,,,,02/07/2018,02/07/2018,0.00,,3.64,,"-564,546.65"
,CS,AR,32006007,1005,100,,Cash sale,,,,,,02/07/2018,02/07/2018,0.00,,6.56,,"-564,553.21"
,CS,AR,32006010,1005,100,,Cash sale,,,,,,02/07/2018,02/07/2018,0.00,,3.64,,"-564,556.85"
,CS,AR,32006012,1005,100,,Cash sale,,,,,,02/07/2018,02/07/2018,0.00,,5.94,,"-564,562.79"
,CS,AR,32006031,1005,100,,Cash sale,,,,,,02/07/2018,02/07/2018,0.00,,13.98,,"-564,576.77"
,CS,AR,32006033,1005,100,,Cash sale,,,,,,02/07/2018,02/07/2018,0.00,,3.64,,"-564,580.41"
,CS,AR,32006035,1005,100,,Cash sale,,,,,,02/07/2018,02/07/2018,0.00,,3.64,,"-564,584.05"
,IN,AR,30318570,1005,100,,Invoice,,,,,,02/07/2018,02/07/2018,0.00,,88.98,,"-564,673.03"
,IN,AR,30318576,1005,100,,Invoice,,,,,,02/07/2018,02/07/2018,0.00,,10.93,,"-564,683.96"
,IN,AR,30318583,1005,100,,Invoice,,,,,,02/07/2018,02/07/2018,0.00,,5.41,,"-564,689.37"
,IN,AR,30318587,1005,100,,Invoice,,,,,,02/07/2018,02/07/2018,0.00,,8.10,,"-564,697.47"
,IN,AR,30318588,1005,100,,Invoice,,,,,,02/07/2018,02/07/2018,0.00,,2.03,,"-564,699.50"
,IN,AR,30318589,1005,100,,Invoice,,,,,,02/07/2018,02/07/2018,0.00,,6.08,,"-564,705.58"
,IN,AR,30318590,1005,100,,Invoice,,,,,,02/07/2018,02/07/2018,0.00,,6.08,,"-564,711.66"
,IN,AR,30318591,1005,100,,Invoice,,,,,,02/07/2018,02/07/2018,0.00,,10.13,,"-564,721.79"
,IN,AR,30318592,1005,100,,Invoice,,,,,,02/07/2018,02/07/2018,0.00,,2.03,,"-564,723.82"
,IN,AR,30318593,1005,100,,Invoice,,,,,,02/07/2018,02/07/2018,0.00,,10.13,,"-564,733.95"
,IN,AR,30318594,1005,100,,Invoice,,,,,,02/07/2018,02/07/2018,0.00,,14.24,,"-564,748.19"
,IN,AR,30318599,1005,100,,Invoice,,,,,,02/07/2018,02/07/2018,0.00,,364.41,,"-565,112.60"
,IN,AR,30318613,1005,100,,Invoice,,,,,,02/07/2018,02/07/2018,0.00,,63.41,,"-565,176.01"
,IN,AR,30318614,1005,100,,Invoice,,,,,,02/07/2018,02/07/2018,0.00,,"1,093.22",,"-566,269.23"
,IN,AR,30318617,1005,100,,Invoice,,,,,,02/07/2018,02/07/2018,0.00,,364.41,,"-566,633.64"
,IN,AR,30318623,1005,100,,Invoice,,,,,,02/07/2018,02/07/2018,0.00,,3.64,,"-566,637.28"
,IN,AR,30318628,1005,100,,Invoice,,,,,,02/07/2018,02/07/2018,0.00,,135.25,,"-566,772.53"
,IN,AR,30318634,1005,100,,Invoice,,,,,,02/07/2018,02/07/2018,0.00,,16.53,,"-566,789.06"
,IN,AR,30318635,1005,100,,Invoice,,,,,,02/07/2018,02/07/2018,0.00,,8.26,,"-566,797.32"
,IN,AR,30318637,1005,100,,Invoice,,,,,,02/07/2018,02/07/2018,0.00,,364.41,,"-567,161.73"
,IN,AR,30318641,1005,100,,Invoice,,,,,,02/07/2018,02/07/2018,0.00,,60.00,,"-567,221.73"
,IN,AR,30318648,1005,100,,Invoice,,,,,,02/07/2018,02/07/2018,0.00,,"1,093.22",,"-568,314.95"
,IN,AR,30318650,1005,100,,Invoice,,,,,,02/07/2018,02/07/2018,0.00,,46.66,,"-568,361.61"
,IN,AR,30318652,1005,100,,Invoice,,,,,,02/07/2018,02/07/2018,0.00,,29.15,,"-568,390.76"
,IN,AR,30318657,1005,100,,Invoice,,,,,,02/07/2018,02/07/2018,0.00,,7.29,,"-568,398.05"
,IN,AR,30318658,1005,100,,Invoice,,,,,,02/07/2018,02/07/2018,0.00,,54.00,,"-568,452.05"
,IN,AR,30318659,1005,100,,Invoice,,,,,,02/07/2018,02/07/2018,0.00,,22.00,,"-568,474.05"
,IN,AR,30318662,1005,100,,Invoice,,,,,,02/07/2018,02/07/2018,0.00,,2.75,,"-568,476.80"
,IN,AR,30318663,1005,100,,Invoice,,,,,,02/07/2018,02/07/2018,0.00,,30.51,,"-568,507.31"
,IN,AR,30318664,1005,100,,Invoice,,,,,,02/07/2018,02/07/2018,0.00,,11.02,,"-568,518.33"
,IN,AR,30318674,1005,100,,Invoice,,,,,,02/07/2018,02/07/2018,0.00,,16.00,,"-568,534.33"
,IN,AR,30318677,1005,100,,Invoice,,,,,,02/07/2018,02/07/2018,0.00,,10.93,,"-568,545.26"
,IN,AR,30318679,1005,100,,Invoice,,,,,,02/07/2018,02/07/2018,0.00,,29.15,,"-568,574.41"
,IN,AR,30318689,1005,100,,Invoice,,,,,,02/07/2018,02/07/2018,0.00,,38.00,,"-568,612.41"
,IN,AR,30318699,1005,100,,Invoice,,,,,,02/07/2018,02/07/2018,0.00,,17.71,,"-568,630.12"
,IN,AR,30318703,1005,100,,Invoice,,,,,,02/07/2018,02/07/2018,0.00,,19.87,,"-568,649.99"
,IN,AR,30318706,1005,100,,Invoice,,,,,,02/07/2018,02/07/2018,0.00,,10.93,,"-568,660.92"
,IN,AR,30318707,1005,100,,Invoice,,,,,,02/07/2018,02/07/2018,0.00,,14.58,,"-568,675.50"
,IN,AR,30318708,1005,100,,Invoice,,,,,,02/07/2018,02/07/2018,0.00,,364.41,,"-569,039.91"
,IN,AR,30318712,1005,100,,Invoice,,,,,,02/07/2018,02/07/2018,0.00,,18.09,,"-569,058.00"
,IN,AR,30318716,1005,100,,Invoice,,,,,,02/07/2018,02/07/2018,0.00,,10.93,,"-569,068.93"
,IN,AR,30318717,1005,100,,Invoice,,,,,,02/07/2018,02/07/2018,0.00,,7.75,,"-569,076.68"
,IN,AR,30318722,1005,100,,Invoice,,,,,,02/07/2018,02/07/2018,0.00,,7.19,,"-569,083.87"
,IN,AR,30318723,1005,100,,Invoice,,,,,,02/07/2018,02/07/2018,0.00,,18.37,,"-569,102.24"
,IN,AR,30318726,1005,100,,Invoice,,,,,,02/07/2018,02/07/2018,0.00,,"1,093.22",,"-570,195.46"
,IN,AR,30318733,1005,100,,Invoice,,,,,,02/07/2018,02/07/2018,0.00,,101.69,,"-570,297.15"
,IN,AR,30318740,1005,100,,Invoice,,,,,,02/07/2018,02/07/2018,0.00,,6.36,,"-570,303.51"
,IN,AR,30318741,1005,100,,Invoice,,,,,,02/07/2018,02/07/2018,0.00,,23.31,,"-570,326.82"
,IN,AR,30318742,1005,100,,Invoice,,,,,,02/07/2018,02/07/2018,0.00,,33.60,,"-570,360.42"
,IN,AR,30318746,1005,100,,Invoice,,,,,,02/07/2018,02/07/2018,0.00,,364.41,,"-570,724.83"
,IN,AR,30318748,1005,100,,Invoice,,,,,,02/07/2018,02/07/2018,0.00,,8.90,,"-570,733.73"
,IN,AR,30318751,1005,100,,Invoice,,,,,,02/07/2018,02/07/2018,0.00,,28.71,,"-570,762.44"
,IN,AR,30318760,1005,100,,Invoice,,,,,,02/07/2018,02/07/2018,0.00,,116.90,,"-570,879.34"
,IN,AR,30318763,1005,100,,Invoice,,,,,,02/07/2018,02/07/2018,0.00,,25.42,,"-570,904.76"
,IN,AR,30318766,1005,100,,Invoice,,,,,,02/07/2018,02/07/2018,0.00,,21.51,,"-570,926.27"
,IN,AR,30318767,1005,100,,Invoice,,,,,,02/07/2018,02/07/2018,0.00,,9.56,,"-570,935.83"
,IN,AR,30318772,1005,100,,Invoice,,,,,,02/07/2018,02/07/2018,0.00,,19.32,,"-570,955.15"
,IN,AR,30318778,1005,100,,Invoice,,,,,,02/07/2018,02/07/2018,0.00,,182.20,,"-571,137.35"
,IN,AR,30318789,1005,100,,Invoice,,,,,,02/07/2018,02/07/2018,0.00,,10.17,,"-571,147.52"
,IN,AR,30318801,1005,100,,Invoice,,,,,,02/07/2018,02/07/2018,0.00,,18.05,,"-571,165.57"
,IN,AR,30318802,1005,100,,Invoice,,,,,,02/07/2018,02/07/2018,0.00,,18.05,,"-571,183.62"
,IN,AR,30318814,1005,100,,Invoice,,,,,,02/07/2018,02/07/2018,0.00,,27.97,,"-571,211.59"
,IN,AR,30318818,1005,100,,Invoice,,,,,,02/07/2018,02/07/2018,0.00,,30.51,,"-571,242.10"
,IN,AR,30318824,1005,100,,Invoice,,,,,,02/07/2018,02/07/2018,0.00,,14.58,,"-571,256.68"
,IN,AR,30318829,1005,100,,Invoice,,,,,,02/07/2018,02/07/2018,0.00,,7.29,,"-571,263.97"
,IN,AR,30318831,1005,100,,Invoice,,,,,,02/07/2018,02/07/2018,0.00,,7.29,,"-571,271.26"
,IN,AR,30318832,1005,100,,Invoice,,,,,,02/07/2018,02/07/2018,0.00,,14.58,,"-571,285.84"
,IN,AR,30318841,1005,100,,Invoice,,,,,,02/07/2018,02/07/2018,0.00,,8.26,,"-571,294.10"
,IN,AR,30318842,1005,100,,Invoice,,,,,,02/07/2018,02/07/2018,0.00,,10.93,,"-571,305.03"
,IN,AR,30318844,1005,100,,Invoice,,,,,,02/07/2018,02/07/2018,0.00,,54.66,,"-571,359.69"
,IN,AR,30318846,1005,100,,Invoice,,,,,,02/07/2018,02/07/2018,0.00,,54.66,,"-571,414.35"
,IN,AR,30318849,1005,100,,Invoice,,,,,,02/07/2018,02/07/2018,0.00,,54.66,,"-571,469.01"
,IN,AR,30318851,1005,100,,Invoice,,,,,,02/07/2018,02/07/2018,0.00,,13.78,,"-571,482.79"
,IN,AR,30318852,1005,100,,Invoice,,,,,,02/07/2018,02/07/2018,0.00,,19.64,,"-571,502.43"
,IN,AR,30318854,1005,100,,Invoice,,,,,,02/07/2018,02/07/2018,0.00,,5.25,,"-571,507.68"
,IN,AR,30318855,1005,100,,Invoice,,,,,,02/07/2018,02/07/2018,0.00,,19.07,,"-571,526.75"
,IN,AR,30318873,1005,100,,Invoice,,,,,,02/07/2018,02/07/2018,0.00,,29.15,,"-571,555.90"
,IN,AR,30318874,1005,100,,Invoice,,,,,,02/07/2018,02/07/2018,0.00,,65.90,,"-571,621.80"
,IN,AR,30318878,1005,100,,Invoice,,,,,,02/07/2018,02/07/2018,0.00,,26.00,,"-571,647.80"
,IN,AR,30318880,1005,100,,Invoice,,,,,,02/07/2018,02/07/2018,0.00,,364.41,,"-572,012.21"
,IN,AR,30318883,1005,100,,Invoice,,,,,,02/07/2018,02/07/2018,0.00,,364.41,,"-572,376.62"
,IN,AR,30318894,1005,100,,Invoice,,,,,,02/07/2018,02/07/2018,0.00,,29.55,,"-572,406.17"
,IN,AR,30318908,1005,100,,Invoice,,,,,,02/07/2018,02/07/2018,0.00,,"2,186.44",,"-574,592.61"
,IN,AR,30318910,1005,100,,Invoice,,,,,,02/07/2018,02/07/2018,0.00,,51.91,,"-574,644.52"
,IN,AR,30318912,1005,100,,Invoice,,,,,,02/07/2018,02/07/2018,0.00,,17.47,,"-574,661.99"
,IN,AR,30318915,1005,100,,Invoice,,,,,,02/07/2018,02/07/2018,0.00,,6.53,,"-574,668.52"
,IN,AR,30318929,1005,100,,Invoice,,,,,,02/07/2018,02/07/2018,0.00,,3.64,,"-574,672.16"
,IN,AR,30318955,1005,100,,Invoice,,,,,,02/07/2018,02/07/2018,0.00,,4.29,,"-574,676.45"
,IN,AR,30318956,1005,100,,Invoice,,,,,,02/07/2018,02/07/2018,0.00,,14.62,,"-574,691.07"
,IN,AR,30318992,1005,100,,Invoice,,,,,,02/07/2018,02/07/2018,0.00,,28.06,,"-574,719.13"
,IN,AR,30318999,1005,100,,Invoice,,,,,,02/07/2018,02/07/2018,0.00,,24.29,,"-574,743.42"
,IN,AR,30319008,1005,100,,Invoice,,,,,,02/07/2018,02/07/2018,0.00,,39.41,,"-574,782.83"
,IN,AR,30319014,1005,100,,Invoice,,,,,,02/07/2018,02/07/2018,0.00,,6.86,,"-574,789.69"
,IN,AR,30319017,1005,100,,Invoice,,,,,,02/07/2018,02/07/2018,0.00,,6.56,,"-574,796.25"
,IN,AR,30319034,1005,100,,Invoice,,,,,,02/07/2018,02/07/2018,0.00,,12.00,,"-574,808.25"
,IN,AR,30319036,1005,100,,Invoice,,,,,,02/07/2018,02/07/2018,0.00,,16.01,,"-574,824.26"
,IN,AR,30319040,1005,100,,Invoice,,,,,,02/07/2018,02/07/2018,0.00,,32.01,,"-574,856.27"
,IN,AR,30319046,1005,100,,Invoice,,,,,,02/07/2018,02/07/2018,0.00,,45.25,,"-574,901.52"
,IN,AR,30319049,1005,100,,Invoice,,,,,,02/07/2018,02/07/2018,0.00,,2.92,,"-574,904.44"
,IN,AR,30319050,1005,100,,Invoice,,,,,,02/07/2018,02/07/2018,0.00,,25.51,,"-574,929.95"
,IN,AR,30319054,1005,100,,Invoice,,,,,,02/07/2018,02/07/2018,0.00,,4.20,,"-574,934.15"
,IN,AR,30319063,1005,100,,Invoice,,,,,,02/07/2018,02/07/2018,0.00,,54.66,,"-574,988.81"
,IN,AR,30319064,1005,100,,Invoice,,,,,,02/07/2018,02/07/2018,0.00,,28.99,,"-575,017.80"
,IN,AR,30319065,1005,100,,Invoice,,,,,,02/07/2018,02/07/2018,0.00,,149.15,,"-575,166.95"
,IN,AR,30319067,1005,100,,Invoice,,,,,,02/07/2018,02/07/2018,0.00,,19.64,,"-575,186.59"
,IN,AR,30319077,1005,100,,Invoice,,,,,,02/07/2018,02/07/2018,0.00,,54.66,,"-575,241.25"
,IN,AR,30319093,1005,100,,Invoice,,,,,,02/07/2018,02/07/2018,0.00,,26.69,,"-575,267.94"
,IN,AR,30319096,1005,100,,Invoice,,,,,,02/07/2018,02/07/2018,0.00,,9.56,,"-575,277.50"
,IN,AR,30319111,1005,100,,Invoice,,,,,,02/07/2018,02/07/2018,0.00,,10.00,,"-575,287.50"
,IN,AR,30319113,1005,100,,Invoice,,,,,,02/07/2018,02/07/2018,0.00,,7.53,,"-575,295.03"
,IN,AR,30319114,1005,100,,Invoice,,,,,,02/07/2018,02/07/2018,0.00,,1.88,,"-575,296.91"
,IN,AR,30319117,1005,100,,Invoice,,,,,,02/07/2018,02/07/2018,0.00,,11.02,,"-575,307.93"
,IN,AR,30319120,1005,100,,Invoice,,,,,,02/07/2018,02/07/2018,0.00,,20.44,,"-575,328.37"
,IN,AR,30319124,1005,100,,Invoice,,,,,,02/07/2018,02/07/2018,0.00,,29.15,,"-575,357.52"
,IN,AR,30319136,1005,100,,Invoice,,,,,,02/07/2018,02/07/2018,0.00,,10.95,,"-575,368.47"
,IN,AR,30319142,1005,100,,Invoice,,,,,,02/07/2018,02/07/2018,0.00,,14.58,,"-575,383.05"
,IN,AR,30319145,1005,100,,Invoice,,,,,,02/07/2018,02/07/2018,0.00,,7.02,,"-575,390.07"
,IN,AR,30319151,1005,100,,Invoice,,,,,,02/07/2018,02/07/2018,0.00,,6.13,,"-575,396.20"
,IN,AR,30319165,1005,100,,Invoice,,,,,,02/07/2018,02/07/2018,0.00,,7.97,,"-575,404.17"
,IN,AR,30319167,1005,100,,Invoice,,,,,,02/07/2018,02/07/2018,0.00,,17.54,,"-575,421.71"
,IN,AR,30319172,1005,100,,Invoice,,,,,,02/07/2018,02/07/2018,0.00,,10.38,,"-575,432.09"
,IN,AR,30319173,1005,100,,Invoice,,,,,,02/07/2018,02/07/2018,0.00,,2.08,,"-575,434.17"
,IN,AR,30319174,1005,100,,Invoice,,,,,,02/07/2018,02/07/2018,0.00,,6.23,,"-575,440.40"
,IN,AR,30319175,1005,100,,Invoice,,,,,,02/07/2018,02/07/2018,0.00,,47.75,,"-575,488.15"
,IN,AR,30319196,1005,100,,Invoice,,,,,,02/07/2018,02/07/2018,0.00,,18.22,,"-575,506.37"
,IN,AR,30319211,1005,100,,Invoice,,,,,,02/07/2018,02/07/2018,0.00,,32.80,,"-575,539.17"
,IN,AR,30319213,1005,100,,Invoice,,,,,,02/07/2018,02/07/2018,0.00,,29.15,,"-575,568.32"
,IN,AR,30319215,1005,100,,Invoice,,,,,,02/07/2018,02/07/2018,0.00,,29.15,,"-575,597.47"
,CN,AR,31018351,1005,100,,Credit Note,,,,,,03/07/2018,03/07/2018,27.87,,0.00,,"-575,569.60"
,CS,AR,32005768,1005,100,,Cash sale,,,,,,03/07/2018,03/07/2018,0.00,,14.58,,"-575,584.18"
,CS,AR,32005769,1005,100,,Cash sale,,,,,,03/07/2018,03/07/2018,0.00,,3.64,,"-575,587.82"
,CS,AR,32005781,1005,100,,Cash sale,,,,,,03/07/2018,03/07/2018,0.00,,3.64,,"-575,591.46"
,CS,AR,32005785,1005,100,,Cash sale,,,,,,03/07/2018,03/07/2018,0.00,,7.29,,"-575,598.75"
,CS,AR,32005788,1005,100,,Cash sale,,,,,,03/07/2018,03/07/2018,0.00,,3.01,,"-575,601.76"
,CS,AR,32005790,1005,100,,Cash sale,,,,,,03/07/2018,03/07/2018,0.00,,7.29,,"-575,609.05"
,CS,AR,32005800,1005,100,,Cash sale,,,,,,03/07/2018,03/07/2018,0.00,,3.64,,"-575,612.69"
,CS,AR,32005806,1005,100,,Cash sale,,,,,,03/07/2018,03/07/2018,0.00,,14.58,,"-575,627.27"
,CS,AR,32005807,1005,100,,Cash sale,,,,,,03/07/2018,03/07/2018,0.00,,14.58,,"-575,641.85"
,CS,AR,32005814,1005,100,,Cash sale,,,,,,03/07/2018,03/07/2018,0.00,,7.29,,"-575,649.14"
,CS,AR,32005824,1005,100,,Cash sale,,,,,,03/07/2018,03/07/2018,0.00,,7.29,,"-575,656.43"
,CS,AR,32005826,1005,100,,Cash sale,,,,,,03/07/2018,03/07/2018,0.00,,4.32,,"-575,660.75"
,CS,AR,32005835,1005,100,,Cash sale,,,,,,03/07/2018,03/07/2018,0.00,,7.29,,"-575,668.04"
,CS,AR,32005840,1005,100,,Cash sale,,,,,,03/07/2018,03/07/2018,0.00,,21.86,,"-575,689.90"
,CS,AR,32005841,1005,100,,Cash sale,,,,,,03/07/2018,03/07/2018,0.00,,5.17,,"-575,695.07"
,CS,AR,32005842,1005,100,,Cash sale,,,,,,03/07/2018,03/07/2018,0.00,,21.98,,"-575,717.05"
,CS,AR,32005848,1005,100,,Cash sale,,,,,,03/07/2018,03/07/2018,0.00,,7.29,,"-575,724.34"
,CS,AR,32005851,1005,100,,Cash sale,,,,,,03/07/2018,03/07/2018,0.00,,4.29,,"-575,728.63"
,CS,AR,32005853,1005,100,,Cash sale,,,,,,03/07/2018,03/07/2018,0.00,,3.64,,"-575,732.27"
,CS,AR,32005861,1005,100,,Cash sale,,,,,,03/07/2018,03/07/2018,0.00,,18.05,,"-575,750.32"
,CS,AR,32005864,1005,100,,Cash sale,,,,,,03/07/2018,03/07/2018,0.00,,13.47,,"-575,763.79"
,CS,AR,32005872,1005,100,,Cash sale,,,,,,03/07/2018,03/07/2018,0.00,,7.29,,"-575,771.08"
,CS,AR,32005877,1005,100,,Cash sale,,,,,,03/07/2018,03/07/2018,0.00,,2.54,,"-575,773.62"
,CS,AR,32005881,1005,100,,Cash sale,,,,,,03/07/2018,03/07/2018,0.00,,7.75,,"-575,781.37"
,CS,AR,32005887,1005,100,,Cash sale,,,,,,03/07/2018,03/07/2018,0.00,,3.90,,"-575,785.27"
,CS,AR,32005892,1005,100,,Cash sale,,,,,,03/07/2018,03/07/2018,0.00,,3.64,,"-575,788.91"
,CS,AR,32005902,1005,100,,Cash sale,,,,,,03/07/2018,03/07/2018,0.00,,11.19,,"-575,800.10"
,CS,AR,32005903,1005,100,,Cash sale,,,,,,03/07/2018,03/07/2018,0.00,,13.88,,"-575,813.98"
,CS,AR,32005904,1005,100,,Cash sale,,,,,,03/07/2018,03/07/2018,0.00,,7.29,,"-575,821.27"
,CS,AR,32005912,1005,100,,Cash sale,,,,,,03/07/2018,03/07/2018,0.00,,17.15,,"-575,838.42"
,CS,AR,32005918,1005,100,,Cash sale,,,,,,03/07/2018,03/07/2018,0.00,,3.64,,"-575,842.06"
,CS,AR,32005919,1005,100,,Cash sale,,,,,,03/07/2018,03/07/2018,0.00,,3.64,,"-575,845.70"
,CS,AR,32005921,1005,100,,Cash sale,,,,,,03/07/2018,03/07/2018,0.00,,3.64,,"-575,849.34"
,CS,AR,32005928,1005,100,,Cash sale,,,,,,03/07/2018,03/07/2018,0.00,,12.03,,"-575,861.37"
,CS,AR,32005929,1005,100,,Cash sale,,,,,,03/07/2018,03/07/2018,0.00,,29.15,,"-575,890.52"
,CS,AR,32005938,1005,100,,Cash sale,,,,,,03/07/2018,03/07/2018,0.00,,10.17,,"-575,900.69"
,CS,AR,32005939,1005,100,,Cash sale,,,,,,03/07/2018,03/07/2018,0.00,,22.00,,"-575,922.69"
,CS,AR,32005940,1005,100,,Cash sale,,,,,,03/07/2018,03/07/2018,0.00,,60.00,,"-575,982.69"
,CS,AR,32005945,1005,100,,Cash sale,,,,,,03/07/2018,03/07/2018,0.00,,7.29,,"-575,989.98"
,CS,AR,32005953,1005,100,,Cash sale,,,,,,03/07/2018,03/07/2018,0.00,,9.84,,"-575,999.82"
,CS,AR,32005962,1005,100,,Cash sale,,,,,,03/07/2018,03/07/2018,0.00,,5.50,,"-576,005.32"
,CS,AR,32005970,1005,100,,Cash sale,,,,,,03/07/2018,03/07/2018,0.00,,7.29,,"-576,012.61"
,CS,AR,32005984,1005,100,,Cash sale,,,,,,03/07/2018,03/07/2018,0.00,,20.41,,"-576,033.02"
,CS,AR,32005990,1005,100,,Cash sale,,,,,,03/07/2018,03/07/2018,0.00,,3.64,,"-576,036.66"
,CS,AR,32005993,1005,100,,Cash sale,,,,,,03/07/2018,03/07/2018,0.00,,7.29,,"-576,043.95"
,CS,AR,32005995,1005,100,,Cash sale,,,,,,03/07/2018,03/07/2018,0.00,,5.93,,"-576,049.88"
,CS,AR,32005998,1005,100,,Cash sale,,,,,,03/07/2018,03/07/2018,0.00,,19.16,,"-576,069.04"
,CS,AR,32006003,1005,100,,Cash sale,,,,,,03/07/2018,03/07/2018,0.00,,10.93,,"-576,079.97"
,IN,AR,30318596,1005,100,,Invoice,,,,,,03/07/2018,03/07/2018,0.00,,40.08,,"-576,120.05"
,IN,AR,30318601,1005,100,,Invoice,,,,,,03/07/2018,03/07/2018,0.00,,10.51,,"-576,130.56"
,IN,AR,30318609,1005,100,,Invoice,,,,,,03/07/2018,03/07/2018,0.00,,3.64,,"-576,134.20"
,IN,AR,30318610,1005,100,,Invoice,,,,,,03/07/2018,03/07/2018,0.00,,7.00,,"-576,141.20"
,IN,AR,30318615,1005,100,,Invoice,,,,,,03/07/2018,03/07/2018,0.00,,7.29,,"-576,148.49"
,IN,AR,30318618,1005,100,,Invoice,,,,,,03/07/2018,03/07/2018,0.00,,182.20,,"-576,330.69"
,IN,AR,30318624,1005,100,,Invoice,,,,,,03/07/2018,03/07/2018,0.00,,7.97,,"-576,338.66"
,IN,AR,30318629,1005,100,,Invoice,,,,,,03/07/2018,03/07/2018,0.00,,47.46,,"-576,386.12"
,IN,AR,30318646,1005,100,,Invoice,,,,,,03/07/2018,03/07/2018,0.00,,18.22,,"-576,404.34"
,IN,AR,30318649,1005,100,,Invoice,,,,,,03/07/2018,03/07/2018,0.00,,7.29,,"-576,411.63"
,IN,AR,30318685,1005,100,,Invoice,,,,,,03/07/2018,03/07/2018,0.00,,7.76,,"-576,419.39"
,IN,AR,30318687,1005,100,,Invoice,,,,,,03/07/2018,03/07/2018,0.00,,47.80,,"-576,467.19"
,IN,AR,30318693,1005,100,,Invoice,,,,,,03/07/2018,03/07/2018,0.00,,19.24,,"-576,486.43"
,IN,AR,30318694,1005,100,,Invoice,,,,,,03/07/2018,03/07/2018,0.00,,7.29,,"-576,493.72"
,IN,AR,30318697,1005,100,,Invoice,,,,,,03/07/2018,03/07/2018,0.00,,7.29,,"-576,501.01"
,IN,AR,30318704,1005,100,,Invoice,,,,,,03/07/2018,03/07/2018,0.00,,7.29,,"-576,508.30"
,IN,AR,30318718,1005,100,,Invoice,,,,,,03/07/2018,03/07/2018,0.00,,10.98,,"-576,519.28"
,IN,AR,30318728,1005,100,,Invoice,,,,,,03/07/2018,03/07/2018,0.00,,4.78,,"-576,524.06"
,IN,AR,30318730,1005,100,,Invoice,,,,,,03/07/2018,03/07/2018,0.00,,12.71,,"-576,536.77"
,IN,AR,30318738,1005,100,,Invoice,,,,,,03/07/2018,03/07/2018,0.00,,4.24,,"-576,541.01"
,IN,AR,30318750,1005,100,,Invoice,,,,,,03/07/2018,03/07/2018,0.00,,22.37,,"-576,563.38"
,IN,AR,30318754,1005,100,,Invoice,,,,,,03/07/2018,03/07/2018,0.00,,15.04,,"-576,578.42"
,IN,AR,30318758,1005,100,,Invoice,,,,,,03/07/2018,03/07/2018,0.00,,5.85,,"-576,584.27"
,IN,AR,30318765,1005,100,,Invoice,,,,,,03/07/2018,03/07/2018,0.00,,10.93,,"-576,595.20"
,IN,AR,30318774,1005,100,,Invoice,,,,,,03/07/2018,03/07/2018,0.00,,7.29,,"-576,602.49"
,IN,AR,30318775,1005,100,,Invoice,,,,,,03/07/2018,03/07/2018,0.00,,10.93,,"-576,613.42"
,IN,AR,30318779,1005,100,,Invoice,,,,,,03/07/2018,03/07/2018,0.00,,23.26,,"-576,636.68"
,IN,AR,30318780,1005,100,,Invoice,,,,,,03/07/2018,03/07/2018,0.00,,42.89,,"-576,679.57"
,IN,AR,30318781,1005,100,,Invoice,,,,,,03/07/2018,03/07/2018,0.00,,24.51,,"-576,704.08"
,IN,AR,30318784,1005,100,,Invoice,,,,,,03/07/2018,03/07/2018,0.00,,29.15,,"-576,733.23"
,IN,AR,30318800,1005,100,,Invoice,,,,,,03/07/2018,03/07/2018,0.00,,12.71,,"-576,745.94"
,IN,AR,30318809,1005,100,,Invoice,,,,,,03/07/2018,03/07/2018,0.00,,7.29,,"-576,753.23"
,IN,AR,30318810,1005,100,,Invoice,,,,,,03/07/2018,03/07/2018,0.00,,5.85,,"-576,759.08"
,IN,AR,30318816,1005,100,,Invoice,,,,,,03/07/2018,03/07/2018,0.00,,14.63,,"-576,773.71"
,IN,AR,30318817,1005,100,,Invoice,,,,,,03/07/2018,03/07/2018,0.00,,6.02,,"-576,779.73"
,IN,AR,30318820,1005,100,,Invoice,,,,,,03/07/2018,03/07/2018,0.00,,364.41,,"-577,144.14"
,IN,AR,30318821,1005,100,,Invoice,,,,,,03/07/2018,03/07/2018,0.00,,8.26,,"-577,152.40"
,IN,AR,30318822,1005,100,,Invoice,,,,,,03/07/2018,03/07/2018,0.00,,2.39,,"-577,154.79"
,IN,AR,30318826,1005,100,,Invoice,,,,,,03/07/2018,03/07/2018,0.00,,15.25,,"-577,170.04"
,IN,AR,30318827,1005,100,,Invoice,,,,,,03/07/2018,03/07/2018,0.00,,3.90,,"-577,173.94"
,IN,AR,30318828,1005,100,,Invoice,,,,,,03/07/2018,03/07/2018,0.00,,17.54,,"-577,191.48"
,IN,AR,30318830,1005,100,,Invoice,,,,,,03/07/2018,03/07/2018,0.00,,10.93,,"-577,202.41"
,IN,AR,30318835,1005,100,,Invoice,,,,,,03/07/2018,03/07/2018,0.00,,77.54,,"-577,279.95"
,IN,AR,30318839,1005,100,,Invoice,,,,,,03/07/2018,03/07/2018,0.00,,4.24,,"-577,284.19"
,IN,AR,30318845,1005,100,,Invoice,,,,,,03/07/2018,03/07/2018,0.00,,10.93,,"-577,295.12"
,IN,AR,30318856,1005,100,,Invoice,,,,,,03/07/2018,03/07/2018,0.00,,2.12,,"-577,297.24"
,IN,AR,30318864,1005,100,,Invoice,,,,,,03/07/2018,03/07/2018,0.00,,10.93,,"-577,308.17"
,IN,AR,30318879,1005,100,,Invoice,,,,,,03/07/2018,03/07/2018,0.00,,22.81,,"-577,330.98"
,IN,AR,30318888,1005,100,,Invoice,,,,,,03/07/2018,03/07/2018,0.00,,8.26,,"-577,339.24"
,IN,AR,30318899,1005,100,,Invoice,,,,,,03/07/2018,03/07/2018,0.00,,364.41,,"-577,703.65"
,IN,AR,30318916,1005,100,,Invoice,,,,,,03/07/2018,03/07/2018,0.00,,10.93,,"-577,714.58"
,IN,AR,30318919,1005,100,,Invoice,,,,,,03/07/2018,03/07/2018,0.00,,3.76,,"-577,718.34"
,IN,AR,30318920,1005,100,,Invoice,,,,,,03/07/2018,03/07/2018,0.00,,25.73,,"-577,744.07"
,IN,AR,30318921,1005,100,,Invoice,,,,,,03/07/2018,03/07/2018,0.00,,29.15,,"-577,773.22"
,IN,AR,30318925,1005,100,,Invoice,,,,,,03/07/2018,03/07/2018,0.00,,3.53,,"-577,776.75"
,IN,AR,30318934,1005,100,,Invoice,,,,,,03/07/2018,03/07/2018,0.00,,2.58,,"-577,779.33"
,IN,AR,30318938,1005,100,,Invoice,,,,,,03/07/2018,03/07/2018,0.00,,8.21,,"-577,787.54"
,IN,AR,30318971,1005,100,,Invoice,,,,,,03/07/2018,03/07/2018,0.00,,17.49,,"-577,805.03"
,IN,AR,30318972,1005,100,,Invoice,,,,,,03/07/2018,03/07/2018,0.00,,1.59,,"-577,806.62"
,IN,AR,30318973,1005,100,,Invoice,,,,,,03/07/2018,03/07/2018,0.00,,1.59,,"-577,808.21"
,IN,AR,30318974,1005,100,,Invoice,,,,,,03/07/2018,03/07/2018,0.00,,195.57,,"-578,003.78"
,IN,AR,30318982,1005,100,,Invoice,,,,,,03/07/2018,03/07/2018,0.00,,22.71,,"-578,026.49"
,IN,AR,30319004,1005,100,,Invoice,,,,,,03/07/2018,03/07/2018,0.00,,204.07,,"-578,230.56"
,IN,AR,30319006,1005,100,,Invoice,,,,,,03/07/2018,03/07/2018,0.00,,7.29,,"-578,237.85"
,IN,AR,30319010,1005,100,,Invoice,,,,,,03/07/2018,03/07/2018,0.00,,29.15,,"-578,267.00"
,IN,AR,30319011,1005,100,,Invoice,,,,,,03/07/2018,03/07/2018,0.00,,29.15,,"-578,296.15"
,IN,AR,30319012,1005,100,,Invoice,,,,,,03/07/2018,03/07/2018,0.00,,29.15,,"-578,325.30"
,IN,AR,30319013,1005,100,,Invoice,,,,,,03/07/2018,03/07/2018,0.00,,54.66,,"-578,379.96"
,IN,AR,30319016,1005,100,,Invoice,,,,,,03/07/2018,03/07/2018,0.00,,5.47,,"-578,385.43"
,IN,AR,30319028,1005,100,,Invoice,,,,,,03/07/2018,03/07/2018,0.00,,15.25,,"-578,400.68"
,IN,AR,30319066,1005,100,,Invoice,,,,,,03/07/2018,03/07/2018,0.00,,5.47,,"-578,406.15"
,IN,AR,30319075,1005,100,,Invoice,,,,,,03/07/2018,03/07/2018,0.00,,136.00,,"-578,542.15"
,IN,AR,30319078,1005,100,,Invoice,,,,,,03/07/2018,03/07/2018,0.00,,54.66,,"-578,596.81"
,IN,AR,30319079,1005,100,,Invoice,,,,,,03/07/2018,03/07/2018,0.00,,28.47,,"-578,625.28"
,IN,AR,30319085,1005,100,,Invoice,,,,,,03/07/2018,03/07/2018,0.00,,3.64,,"-578,628.92"
,IN,AR,30319102,1005,100,,Invoice,,,,,,03/07/2018,03/07/2018,0.00,,65.08,,"-578,694.00"
,IN,AR,30319103,1005,100,,Invoice,,,,,,03/07/2018,03/07/2018,0.00,,21.36,,"-578,715.36"
,IN,AR,30319116,1005,100,,Invoice,,,,,,03/07/2018,03/07/2018,0.00,,1.75,,"-578,717.11"
,IN,AR,30319122,1005,100,,Invoice,,,,,,03/07/2018,03/07/2018,0.00,,29.15,,"-578,746.26"
,IN,AR,30319126,1005,100,,Invoice,,,,,,03/07/2018,03/07/2018,0.00,,123.03,,"-578,869.29"
,IN,AR,30319130,1005,100,,Invoice,,,,,,03/07/2018,03/07/2018,0.00,,10.93,,"-578,880.22"
,IN,AR,30319131,1005,100,,Invoice,,,,,,03/07/2018,03/07/2018,0.00,,7.02,,"-578,887.24"
,IN,AR,30319141,1005,100,,Invoice,,,,,,03/07/2018,03/07/2018,0.00,,54.66,,"-578,941.90"
,IN,AR,30319156,1005,100,,Invoice,,,,,,03/07/2018,03/07/2018,0.00,,32.80,,"-578,974.70"
,IN,AR,30319163,1005,100,,Invoice,,,,,,03/07/2018,03/07/2018,0.00,,11.19,,"-578,985.89"
,IN,AR,30319170,1005,100,,Invoice,,,,,,03/07/2018,03/07/2018,0.00,,12.14,,"-578,998.03"
,IN,AR,30319176,1005,100,,Invoice,,,,,,03/07/2018,03/07/2018,0.00,,20.76,,"-579,018.79"
,IN,AR,30319177,1005,100,,Invoice,,,,,,03/07/2018,03/07/2018,0.00,,8.31,,"-579,027.10"
,IN,AR,30319178,1005,100,,Invoice,,,,,,03/07/2018,03/07/2018,0.00,,8.31,,"-579,035.41"
,IN,AR,30319191,1005,100,,Invoice,,,,,,03/07/2018,03/07/2018,0.00,,10.93,,"-579,046.34"
,IN,AR,30319198,1005,100,,Invoice,,,,,,03/07/2018,03/07/2018,0.00,,12.14,,"-579,058.48"
,IN,AR,30319199,1005,100,,Invoice,,,,,,03/07/2018,03/07/2018,0.00,,182.20,,"-579,240.68"
,IN,AR,30319203,1005,100,,Invoice,,,,,,03/07/2018,03/07/2018,0.00,,11.86,,"-579,252.54"
,IN,AR,30319204,1005,100,,Invoice,,,,,,03/07/2018,03/07/2018,0.00,,2.39,,"-579,254.93"
,IN,AR,30319212,1005,100,,Invoice,,,,,,03/07/2018,03/07/2018,0.00,,3.64,,"-579,258.57"
,IN,AR,30319217,1005,100,,Invoice,,,,,,03/07/2018,03/07/2018,0.00,,29.15,,"-579,287.72"
,IN,AR,30319218,1005,100,,Invoice,,,,,,03/07/2018,03/07/2018,0.00,,54.66,,"-579,342.38"
,IN,AR,30319219,1005,100,,Invoice,,,,,,03/07/2018,03/07/2018,0.00,,419.07,,"-579,761.45"
,IN,AR,30319221,1005,100,,Invoice,,,,,,03/07/2018,03/07/2018,0.00,,182.20,,"-579,943.65"
,CS,AR,32005764,1005,100,,Cash sale,,,,,,04/07/2018,04/07/2018,0.00,,11.22,,"-579,954.87"
,CS,AR,32005766,1005,100,,Cash sale,,,,,,04/07/2018,04/07/2018,0.00,,35.12,,"-579,989.99"
,CS,AR,32005773,1005,100,,Cash sale,,,,,,04/07/2018,04/07/2018,0.00,,10.93,,"-580,000.92"
,CS,AR,32005776,1005,100,,Cash sale,,,,,,04/07/2018,04/07/2018,0.00,,3.64,,"-580,004.56"
,CS,AR,32005777,1005,100,,Cash sale,,,,,,04/07/2018,04/07/2018,0.00,,10.93,,"-580,015.49"
,CS,AR,32005780,1005,100,,Cash sale,,,,,,04/07/2018,04/07/2018,0.00,,10.93,,"-580,026.42"
,CS,AR,32005791,1005,100,,Cash sale,,,,,,04/07/2018,04/07/2018,0.00,,3.64,,"-580,030.06"
,CS,AR,32005797,1005,100,,Cash sale,,,,,,04/07/2018,04/07/2018,0.00,,10.93,,"-580,040.99"
,CS,AR,32005801,1005,100,,Cash sale,,,,,,04/07/2018,04/07/2018,0.00,,10.93,,"-580,051.92"
,CS,AR,32005812,1005,100,,Cash sale,,,,,,04/07/2018,04/07/2018,0.00,,7.29,,"-580,059.21"
,CS,AR,32005815,1005,100,,Cash sale,,,,,,04/07/2018,04/07/2018,0.00,,3.64,,"-580,062.85"
,CS,AR,32005816,1005,100,,Cash sale,,,,,,04/07/2018,04/07/2018,0.00,,2.92,,"-580,065.77"
,CS,AR,32005822,1005,100,,Cash sale,,,,,,04/07/2018,04/07/2018,0.00,,12.92,,"-580,078.69"
,CS,AR,32005823,1005,100,,Cash sale,,,,,,04/07/2018,04/07/2018,0.00,,7.29,,"-580,085.98"
,CS,AR,32005825,1005,100,,Cash sale,,,,,,04/07/2018,04/07/2018,0.00,,3.64,,"-580,089.62"
,CS,AR,32005832,1005,100,,Cash sale,,,,,,04/07/2018,04/07/2018,0.00,,11.36,,"-580,100.98"
,CS,AR,32005833,1005,100,,Cash sale,,,,,,04/07/2018,04/07/2018,0.00,,7.75,,"-580,108.73"
,CS,AR,32005838,1005,100,,Cash sale,,,,,,04/07/2018,04/07/2018,0.00,,7.29,,"-580,116.02"
,CS,AR,32005843,1005,100,,Cash sale,,,,,,04/07/2018,04/07/2018,0.00,,18.05,,"-580,134.07"
,CS,AR,32005849,1005,100,,Cash sale,,,,,,04/07/2018,04/07/2018,0.00,,14.58,,"-580,148.65"
,CS,AR,32005855,1005,100,,Cash sale,,,,,,04/07/2018,04/07/2018,0.00,,5.08,,"-580,153.73"
,CS,AR,32005857,1005,100,,Cash sale,,,,,,04/07/2018,04/07/2018,0.00,,2.54,,"-580,156.27"
,CS,AR,32005866,1005,100,,Cash sale,,,,,,04/07/2018,04/07/2018,0.00,,18.09,,"-580,174.36"
,CS,AR,32005870,1005,100,,Cash sale,,,,,,04/07/2018,04/07/2018,0.00,,6.48,,"-580,180.84"
,CS,AR,32005874,1005,100,,Cash sale,,,,,,04/07/2018,04/07/2018,0.00,,7.29,,"-580,188.13"
,CS,AR,32005878,1005,100,,Cash sale,,,,,,04/07/2018,04/07/2018,0.00,,10.93,,"-580,199.06"
,CS,AR,32005883,1005,100,,Cash sale,,,,,,04/07/2018,04/07/2018,0.00,,66.19,,"-580,265.25"
,CS,AR,32005885,1005,100,,Cash sale,,,,,,04/07/2018,04/07/2018,0.00,,14.58,,"-580,279.83"
,CS,AR,32005891,1005,100,,Cash sale,,,,,,04/07/2018,04/07/2018,0.00,,10.93,,"-580,290.76"
,CS,AR,32005901,1005,100,,Cash sale,,,,,,04/07/2018,04/07/2018,0.00,,3.64,,"-580,294.40"
,CS,AR,32005910,1005,100,,Cash sale,,,,,,04/07/2018,04/07/2018,0.00,,10.93,,"-580,305.33"
,CS,AR,32005917,1005,100,,Cash sale,,,,,,04/07/2018,04/07/2018,0.00,,16.61,,"-580,321.94"
,CS,AR,32005926,1005,100,,Cash sale,,,,,,04/07/2018,04/07/2018,0.00,,22.88,,"-580,344.82"
,CS,AR,32005935,1005,100,,Cash sale,,,,,,04/07/2018,04/07/2018,0.00,,10.93,,"-580,355.75"
,CS,AR,32005937,1005,100,,Cash sale,,,,,,04/07/2018,04/07/2018,0.00,,54.66,,"-580,410.41"
,CS,AR,32005946,1005,100,,Cash sale,,,,,,04/07/2018,04/07/2018,0.00,,5.51,,"-580,415.92"
,CS,AR,32005954,1005,100,,Cash sale,,,,,,04/07/2018,04/07/2018,0.00,,7.29,,"-580,423.21"
,CS,AR,32005956,1005,100,,Cash sale,,,,,,04/07/2018,04/07/2018,0.00,,9.15,,"-580,432.36"
,CS,AR,32005964,1005,100,,Cash sale,,,,,,04/07/2018,04/07/2018,0.00,,14.58,,"-580,446.94"
,CS,AR,32005975,1005,100,,Cash sale,,,,,,04/07/2018,04/07/2018,0.00,,14.58,,"-580,461.52"
,CS,AR,32005977,1005,100,,Cash sale,,,,,,04/07/2018,04/07/2018,0.00,,3.64,,"-580,465.16"
,CS,AR,32005978,1005,100,,Cash sale,,,,,,04/07/2018,04/07/2018,0.00,,6.10,,"-580,471.26"
,CS,AR,32005982,1005,100,,Cash sale,,,,,,04/07/2018,04/07/2018,0.00,,6.56,,"-580,477.82"
,CS,AR,32005983,1005,100,,Cash sale,,,,,,04/07/2018,04/07/2018,0.00,,6.07,,"-580,483.89"
,CS,AR,32005986,1005,100,,Cash sale,,,,,,04/07/2018,04/07/2018,0.00,,10.93,,"-580,494.82"
,CS,AR,32005996,1005,100,,Cash sale,,,,,,04/07/2018,04/07/2018,0.00,,10.93,,"-580,505.75"
,CS,AR,32006008,1005,100,,Cash sale,,,,,,04/07/2018,04/07/2018,0.00,,7.29,,"-580,513.04"
,CS,AR,32006034,1005,100,,Cash sale,,,,,,04/07/2018,04/07/2018,0.00,,14.58,,"-580,527.62"
,CS,AR,32006036,1005,100,,Cash sale,,,,,,04/07/2018,04/07/2018,0.00,,3.64,,"-580,531.26"
,IN,AR,30318571,1005,100,,Invoice,,,,,,04/07/2018,04/07/2018,0.00,,32.63,,"-580,563.89"
,IN,AR,30318574,1005,100,,Invoice,,,,,,04/07/2018,04/07/2018,0.00,,3.64,,"-580,567.53"
,IN,AR,30318582,1005,100,,Invoice,,,,,,04/07/2018,04/07/2018,0.00,,14.58,,"-580,582.11"
,IN,AR,30318585,1005,100,,Invoice,,,,,,04/07/2018,04/07/2018,0.00,,14.64,,"-580,596.75"
,IN,AR,30318586,1005,100,,Invoice,,,,,,04/07/2018,04/07/2018,0.00,,90.31,,"-580,687.06"
,IN,AR,30318597,1005,100,,Invoice,,,,,,04/07/2018,04/07/2018,0.00,,8.52,,"-580,695.58"
,IN,AR,30318598,1005,100,,Invoice,,,,,,04/07/2018,04/07/2018,0.00,,7.29,,"-580,702.87"
,IN,AR,30318602,1005,100,,Invoice,,,,,,04/07/2018,04/07/2018,0.00,,15.76,,"-580,718.63"
,IN,AR,30318603,1005,100,,Invoice,,,,,,04/07/2018,04/07/2018,0.00,,60.42,,"-580,779.05"
,IN,AR,30318605,1005,100,,Invoice,,,,,,04/07/2018,04/07/2018,0.00,,7.25,,"-580,786.30"
,IN,AR,30318611,1005,100,,Invoice,,,,,,04/07/2018,04/07/2018,0.00,,182.20,,"-580,968.50"
,IN,AR,30318630,1005,100,,Invoice,,,,,,04/07/2018,04/07/2018,0.00,,66.44,,"-581,034.94"
,IN,AR,30318640,1005,100,,Invoice,,,,,,04/07/2018,04/07/2018,0.00,,7.29,,"-581,042.23"
,IN,AR,30318642,1005,100,,Invoice,,,,,,04/07/2018,04/07/2018,0.00,,60.00,,"-581,102.23"
,IN,AR,30318645,1005,100,,Invoice,,,,,,04/07/2018,04/07/2018,0.00,,23.73,,"-581,125.96"
,IN,AR,30318647,1005,100,,Invoice,,,,,,04/07/2018,04/07/2018,0.00,,3.64,,"-581,129.60"
,IN,AR,30318654,1005,100,,Invoice,,,,,,04/07/2018,04/07/2018,0.00,,14.58,,"-581,144.18"
,IN,AR,30318660,1005,100,,Invoice,,,,,,04/07/2018,04/07/2018,0.00,,34.00,,"-581,178.18"
,IN,AR,30318669,1005,100,,Invoice,,,,,,04/07/2018,04/07/2018,0.00,,9.03,,"-581,187.21"
,IN,AR,30318671,1005,100,,Invoice,,,,,,04/07/2018,04/07/2018,0.00,,36.00,,"-581,223.21"
,IN,AR,30318678,1005,100,,Invoice,,,,,,04/07/2018,04/07/2018,0.00,,18.22,,"-581,241.43"
,IN,AR,30318683,1005,100,,Invoice,,,,,,04/07/2018,04/07/2018,0.00,,161.00,,"-581,402.43"
,IN,AR,30318684,1005,100,,Invoice,,,,,,04/07/2018,04/07/2018,0.00,,681.31,,"-582,083.74"
,IN,AR,30318695,1005,100,,Invoice,,,,,,04/07/2018,04/07/2018,0.00,,9.03,,"-582,092.77"
,IN,AR,30318727,1005,100,,Invoice,,,,,,04/07/2018,04/07/2018,0.00,,25.42,,"-582,118.19"
,IN,AR,30318731,1005,100,,Invoice,,,,,,04/07/2018,04/07/2018,0.00,,4.24,,"-582,122.43"
,IN,AR,30318732,1005,100,,Invoice,,,,,,04/07/2018,04/07/2018,0.00,,4.24,,"-582,126.67"
,IN,AR,30318737,1005,100,,Invoice,,,,,,04/07/2018,04/07/2018,0.00,,2.12,,"-582,128.79"
,IN,AR,30318739,1005,100,,Invoice,,,,,,04/07/2018,04/07/2018,0.00,,8.39,,"-582,137.18"
,IN,AR,30318752,1005,100,,Invoice,,,,,,04/07/2018,04/07/2018,0.00,,21.86,,"-582,159.04"
,IN,AR,30318756,1005,100,,Invoice,,,,,,04/07/2018,04/07/2018,0.00,,19.12,,"-582,178.16"
,IN,AR,30318761,1005,100,,Invoice,,,,,,04/07/2018,04/07/2018,0.00,,65.63,,"-582,243.79"
,IN,AR,30318764,1005,100,,Invoice,,,,,,04/07/2018,04/07/2018,0.00,,30.51,,"-582,274.30"
,IN,AR,30318783,1005,100,,Invoice,,,,,,04/07/2018,04/07/2018,0.00,,186.06,,"-582,460.36"
,IN,AR,30318790,1005,100,,Invoice,,,,,,04/07/2018,04/07/2018,0.00,,2.54,,"-582,462.90"
,IN,AR,30318797,1005,100,,Invoice,,,,,,04/07/2018,04/07/2018,0.00,,1.59,,"-582,464.49"
,IN,AR,30318799,1005,100,,Invoice,,,,,,04/07/2018,04/07/2018,0.00,,7.75,,"-582,472.24"
,IN,AR,30318812,1005,100,,Invoice,,,,,,04/07/2018,04/07/2018,0.00,,15.90,,"-582,488.14"
,IN,AR,30318813,1005,100,,Invoice,,,,,,04/07/2018,04/07/2018,0.00,,7.50,,"-582,495.64"
,IN,AR,30318837,1005,100,,Invoice,,,,,,04/07/2018,04/07/2018,0.00,,10.59,,"-582,506.23"
,IN,AR,30318838,1005,100,,Invoice,,,,,,04/07/2018,04/07/2018,0.00,,14.58,,"-582,520.81"
,IN,AR,30318857,1005,100,,Invoice,,,,,,04/07/2018,04/07/2018,0.00,,20.76,,"-582,541.57"
,IN,AR,30318872,1005,100,,Invoice,,,,,,04/07/2018,04/07/2018,0.00,,36.36,,"-582,577.93"
,IN,AR,30318876,1005,100,,Invoice,,,,,,04/07/2018,04/07/2018,0.00,,15.25,,"-582,593.18"
,IN,AR,30318890,1005,100,,Invoice,,,,,,04/07/2018,04/07/2018,0.00,,5.17,,"-582,598.35"
,IN,AR,30318897,1005,100,,Invoice,,,,,,04/07/2018,04/07/2018,0.00,,16.53,,"-582,614.88"
,IN,AR,30318900,1005,100,,Invoice,,,,,,04/07/2018,04/07/2018,0.00,,24.07,,"-582,638.95"
,IN,AR,30318927,1005,100,,Invoice,,,,,,04/07/2018,04/07/2018,0.00,,15.04,,"-582,653.99"
,IN,AR,30318935,1005,100,,Invoice,,,,,,04/07/2018,04/07/2018,0.00,,63.56,,"-582,717.55"
,IN,AR,30318937,1005,100,,Invoice,,,,,,04/07/2018,04/07/2018,0.00,,29.15,,"-582,746.70"
,IN,AR,30318939,1005,100,,Invoice,,,,,,04/07/2018,04/07/2018,0.00,,14.58,,"-582,761.28"
,IN,AR,30318942,1005,100,,Invoice,,,,,,04/07/2018,04/07/2018,0.00,,7.75,,"-582,769.03"
,IN,AR,30318948,1005,100,,Invoice,,,,,,04/07/2018,04/07/2018,0.00,,50.02,,"-582,819.05"
,IN,AR,30318949,1005,100,,Invoice,,,,,,04/07/2018,04/07/2018,0.00,,51.02,,"-582,870.07"
,IN,AR,30318950,1005,100,,Invoice,,,,,,04/07/2018,04/07/2018,0.00,,25.51,,"-582,895.58"
,IN,AR,30318959,1005,100,,Invoice,,,,,,04/07/2018,04/07/2018,0.00,,7.75,,"-582,903.33"
,IN,AR,30318961,1005,100,,Invoice,,,,,,04/07/2018,04/07/2018,0.00,,15.25,,"-582,918.58"
,IN,AR,30318962,1005,100,,Invoice,,,,,,04/07/2018,04/07/2018,0.00,,7.29,,"-582,925.87"
,IN,AR,30318963,1005,100,,Invoice,,,,,,04/07/2018,04/07/2018,0.00,,6.86,,"-582,932.73"
,IN,AR,30318965,1005,100,,Invoice,,,,,,04/07/2018,04/07/2018,0.00,,10.93,,"-582,943.66"
,IN,AR,30318975,1005,100,,Invoice,,,,,,04/07/2018,04/07/2018,0.00,,9.54,,"-582,953.20"
,IN,AR,30318978,1005,100,,Invoice,,,,,,04/07/2018,04/07/2018,0.00,,6.02,,"-582,959.22"
,IN,AR,30318984,1005,100,,Invoice,,,,,,04/07/2018,04/07/2018,0.00,,40.00,,"-582,999.22"
,IN,AR,30318990,1005,100,,Invoice,,,,,,04/07/2018,04/07/2018,0.00,,84.18,,"-583,083.40"
,IN,AR,30318997,1005,100,,Invoice,,,,,,04/07/2018,04/07/2018,0.00,,8.21,,"-583,091.61"
,IN,AR,30318998,1005,100,,Invoice,,,,,,04/07/2018,04/07/2018,0.00,,3.64,,"-583,095.25"
,IN,AR,30319005,1005,100,,Invoice,,,,,,04/07/2018,04/07/2018,0.00,,7.29,,"-583,102.54"
,IN,AR,30319018,1005,100,,Invoice,,,,,,04/07/2018,04/07/2018,0.00,,7.64,,"-583,110.18"
,IN,AR,30319023,1005,100,,Invoice,,,,,,04/07/2018,04/07/2018,0.00,,18.11,,"-583,128.29"
,IN,AR,30319027,1005,100,,Invoice,,,,,,04/07/2018,04/07/2018,0.00,,36.44,,"-583,164.73"
,IN,AR,30319029,1005,100,,Invoice,,,,,,04/07/2018,04/07/2018,0.00,,5.08,,"-583,169.81"
,IN,AR,30319030,1005,100,,Invoice,,,,,,04/07/2018,04/07/2018,0.00,,5.08,,"-583,174.89"
,IN,AR,30319041,1005,100,,Invoice,,,,,,04/07/2018,04/07/2018,0.00,,12.00,,"-583,186.89"
,IN,AR,30319047,1005,100,,Invoice,,,,,,04/07/2018,04/07/2018,0.00,,6.03,,"-583,192.92"
,IN,AR,30319052,1005,100,,Invoice,,,,,,04/07/2018,04/07/2018,0.00,,364.41,,"-583,557.33"
,IN,AR,30319056,1005,100,,Invoice,,,,,,04/07/2018,04/07/2018,0.00,,15.04,,"-583,572.37"
,IN,AR,30319057,1005,100,,Invoice,,,,,,04/07/2018,04/07/2018,0.00,,23.90,,"-583,596.27"
,IN,AR,30319059,1005,100,,Invoice,,,,,,04/07/2018,04/07/2018,0.00,,2.33,,"-583,598.60"
,IN,AR,30319074,1005,100,,Invoice,,,,,,04/07/2018,04/07/2018,0.00,,9.64,,"-583,608.24"
,IN,AR,30319087,1005,100,,Invoice,,,,,,04/07/2018,04/07/2018,0.00,,7.29,,"-583,615.53"
,IN,AR,30319089,1005,100,,Invoice,,,,,,04/07/2018,04/07/2018,0.00,,182.20,,"-583,797.73"
,IN,AR,30319092,1005,100,,Invoice,,,,,,04/07/2018,04/07/2018,0.00,,23.32,,"-583,821.05"
,IN,AR,30319097,1005,100,,Invoice,,,,,,04/07/2018,04/07/2018,0.00,,6.37,,"-583,827.42"
,IN,AR,30319104,1005,100,,Invoice,,,,,,04/07/2018,04/07/2018,0.00,,37.97,,"-583,865.39"
,IN,AR,30319105,1005,100,,Invoice,,,,,,04/07/2018,04/07/2018,0.00,,118.65,,"-583,984.04"
,IN,AR,30319115,1005,100,,Invoice,,,,,,04/07/2018,04/07/2018,0.00,,3.51,,"-583,987.55"
,IN,AR,30319132,1005,100,,Invoice,,,,,,04/07/2018,04/07/2018,0.00,,3.64,,"-583,991.19"
,IN,AR,30319140,1005,100,,Invoice,,,,,,04/07/2018,04/07/2018,0.00,,7.53,,"-583,998.72"
,IN,AR,30319148,1005,100,,Invoice,,,,,,04/07/2018,04/07/2018,0.00,,10.47,,"-584,009.19"
,IN,AR,30319150,1005,100,,Invoice,,,,,,04/07/2018,04/07/2018,0.00,,16.78,,"-584,025.97"
,IN,AR,30319153,1005,100,,Invoice,,,,,,04/07/2018,04/07/2018,0.00,,14.58,,"-584,040.55"
,IN,AR,30319161,1005,100,,Invoice,,,,,,04/07/2018,04/07/2018,0.00,,8.25,,"-584,048.80"
,IN,AR,30319162,1005,100,,Invoice,,,,,,04/07/2018,04/07/2018,0.00,,15.53,,"-584,064.33"
,IN,AR,30319168,1005,100,,Invoice,,,,,,04/07/2018,04/07/2018,0.00,,6.86,,"-584,071.19"
,IN,AR,30319179,1005,100,,Invoice,,,,,,04/07/2018,04/07/2018,0.00,,39.45,,"-584,110.64"
,IN,AR,30319180,1005,100,,Invoice,,,,,,04/07/2018,04/07/2018,0.00,,12.46,,"-584,123.10"
,IN,AR,30319181,1005,100,,Invoice,,,,,,04/07/2018,04/07/2018,0.00,,8.31,,"-584,131.41"
,IN,AR,30319182,1005,100,,Invoice,,,,,,04/07/2018,04/07/2018,0.00,,8.31,,"-584,139.72"
,IN,AR,30319189,1005,100,,Invoice,,,,,,04/07/2018,04/07/2018,0.00,,2.54,,"-584,142.26"
,IN,AR,30319193,1005,100,,Invoice,,,,,,04/07/2018,04/07/2018,0.00,,73.73,,"-584,215.99"
,IN,AR,30319194,1005,100,,Invoice,,,,,,04/07/2018,04/07/2018,0.00,,7.29,,"-584,223.28"
,IN,AR,30319195,1005,100,,Invoice,,,,,,04/07/2018,04/07/2018,0.00,,16.91,,"-584,240.19"
,IN,AR,30319201,1005,100,,Invoice,,,,,,04/07/2018,04/07/2018,0.00,,7.29,,"-584,247.48"
,IN,AR,30319206,1005,100,,Invoice,,,,,,04/07/2018,04/07/2018,0.00,,10.93,,"-584,258.41"
,IN,AR,30319222,1005,100,,Invoice,,,,,,04/07/2018,04/07/2018,0.00,,419.07,,"-584,677.48"
,IN,AR,30319224,1005,100,,Invoice,,,,,,04/07/2018,04/07/2018,0.00,,54.66,,"-584,732.14"
,IN,AR,30319891,1005,100,,Invoice,,,,,,04/07/2018,04/07/2018,0.00,,54.66,,"-584,786.80"
,CN,AR,31018338,1005,100,,Credit Note,,,,,,05/07/2018,05/07/2018,51.02,,0.00,,"-584,735.78"
,CS,AR,32005761,1005,100,,Cash sale,,,,,,05/07/2018,05/07/2018,0.00,,15.04,,"-584,750.82"
,CS,AR,32005767,1005,100,,Cash sale,,,,,,05/07/2018,05/07/2018,0.00,,3.64,,"-584,754.46"
,CS,AR,32005772,1005,100,,Cash sale,,,,,,05/07/2018,05/07/2018,0.00,,5.17,,"-584,759.63"
,CS,AR,32005789,1005,100,,Cash sale,,,,,,05/07/2018,05/07/2018,0.00,,3.64,,"-584,763.27"
,CS,AR,32005798,1005,100,,Cash sale,,,,,,05/07/2018,05/07/2018,0.00,,7.29,,"-584,770.56"
,CS,AR,32005802,1005,100,,Cash sale,,,,,,05/07/2018,05/07/2018,0.00,,3.64,,"-584,774.20"
,CS,AR,32005805,1005,100,,Cash sale,,,,,,05/07/2018,05/07/2018,0.00,,7.29,,"-584,781.49"
,CS,AR,32005817,1005,100,,Cash sale,,,,,,05/07/2018,05/07/2018,0.00,,10.93,,"-584,792.42"
,CS,AR,32005819,1005,100,,Cash sale,,,,,,05/07/2018,05/07/2018,0.00,,7.29,,"-584,799.71"
,CS,AR,32005821,1005,100,,Cash sale,,,,,,05/07/2018,05/07/2018,0.00,,29.15,,"-584,828.86"
,CS,AR,32005882,1005,100,,Cash sale,,,,,,05/07/2018,05/07/2018,0.00,,3.64,,"-584,832.50"
,CS,AR,32005884,1005,100,,Cash sale,,,,,,05/07/2018,05/07/2018,0.00,,7.29,,"-584,839.79"
,CS,AR,32005889,1005,100,,Cash sale,,,,,,05/07/2018,05/07/2018,0.00,,55.93,,"-584,895.72"
,CS,AR,32005890,1005,100,,Cash sale,,,,,,05/07/2018,05/07/2018,0.00,,31.02,,"-584,926.74"
,CS,AR,32005900,1005,100,,Cash sale,,,,,,05/07/2018,05/07/2018,0.00,,9.66,,"-584,936.40"
,CS,AR,32005907,1005,100,,Cash sale,,,,,,05/07/2018,05/07/2018,0.00,,3.64,,"-584,940.04"
,CS,AR,32005914,1005,100,,Cash sale,,,,,,05/07/2018,05/07/2018,0.00,,19.58,,"-584,959.62"
,CS,AR,32005922,1005,100,,Cash sale,,,,,,05/07/2018,05/07/2018,0.00,,10.93,,"-584,970.55"
,CS,AR,32005924,1005,100,,Cash sale,,,,,,05/07/2018,05/07/2018,0.00,,10.93,,"-584,981.48"
,CS,AR,32005943,1005,100,,Cash sale,,,,,,05/07/2018,05/07/2018,0.00,,7.29,,"-584,988.77"
,CS,AR,32005958,1005,100,,Cash sale,,,,,,05/07/2018,05/07/2018,0.00,,2.97,,"-584,991.74"
,CS,AR,32005959,1005,100,,Cash sale,,,,,,05/07/2018,05/07/2018,0.00,,8.90,,"-585,000.64"
,CS,AR,32005992,1005,100,,Cash sale,,,,,,05/07/2018,05/07/2018,0.00,,182.20,,"-585,182.84"
,CS,AR,32005997,1005,100,,Cash sale,,,,,,05/07/2018,05/07/2018,0.00,,10.93,,"-585,193.77"
,CS,AR,32005999,1005,100,,Cash sale,,,,,,05/07/2018,05/07/2018,0.00,,14.58,,"-585,208.35"
,CS,AR,32006004,1005,100,,Cash sale,,,,,,05/07/2018,05/07/2018,0.00,,8.78,,"-585,217.13"
,CS,AR,32006042,1005,100,,Cash sale,,,,,,05/07/2018,05/07/2018,0.00,,10.93,,"-585,228.06"
,IN,AR,30318577,1005,100,,Invoice,,,,,,05/07/2018,05/07/2018,0.00,,21.36,,"-585,249.42"
,IN,AR,30318578,1005,100,,Invoice,,,,,,05/07/2018,05/07/2018,0.00,,364.41,,"-585,613.83"
,IN,AR,30318580,1005,100,,Invoice,,,,,,05/07/2018,05/07/2018,0.00,,14.58,,"-585,628.41"
,IN,AR,30318584,1005,100,,Invoice,,,,,,05/07/2018,05/07/2018,0.00,,7.29,,"-585,635.70"
,IN,AR,30318600,1005,100,,Invoice,,,,,,05/07/2018,05/07/2018,0.00,,546.61,,"-586,182.31"
,IN,AR,30318604,1005,100,,Invoice,,,,,,05/07/2018,05/07/2018,0.00,,7.29,,"-586,189.60"
,IN,AR,30318607,1005,100,,Invoice,,,,,,05/07/2018,05/07/2018,0.00,,7.29,,"-586,196.89"
,IN,AR,30318616,1005,100,,Invoice,,,,,,05/07/2018,05/07/2018,0.00,,"1,093.22",,"-587,290.11"
,IN,AR,30318619,1005,100,,Invoice,,,,,,05/07/2018,05/07/2018,0.00,,182.20,,"-587,472.31"
,IN,AR,30318620,1005,100,,Invoice,,,,,,05/07/2018,05/07/2018,0.00,,51.02,,"-587,523.33"
,IN,AR,30318625,1005,100,,Invoice,,,,,,05/07/2018,05/07/2018,0.00,,7.97,,"-587,531.30"
,IN,AR,30318626,1005,100,,Invoice,,,,,,05/07/2018,05/07/2018,0.00,,3.98,,"-587,535.28"
,IN,AR,30318631,1005,100,,Invoice,,,,,,05/07/2018,05/07/2018,0.00,,35.59,,"-587,570.87"
,IN,AR,30318636,1005,100,,Invoice,,,,,,05/07/2018,05/07/2018,0.00,,3.64,,"-587,574.51"
,IN,AR,30318653,1005,100,,Invoice,,,,,,05/07/2018,05/07/2018,0.00,,7.29,,"-587,581.80"
,IN,AR,30318656,1005,100,,Invoice,,,,,,05/07/2018,05/07/2018,0.00,,18.22,,"-587,600.02"
,IN,AR,30318668,1005,100,,Invoice,,,,,,05/07/2018,05/07/2018,0.00,,14.58,,"-587,614.60"
,IN,AR,30318672,1005,100,,Invoice,,,,,,05/07/2018,05/07/2018,0.00,,68.81,,"-587,683.41"
,IN,AR,30318676,1005,100,,Invoice,,,,,,05/07/2018,05/07/2018,0.00,,54.66,,"-587,738.07"
,IN,AR,30318680,1005,100,,Invoice,,,,,,05/07/2018,05/07/2018,0.00,,16.47,,"-587,754.54"
,IN,AR,30318681,1005,100,,Invoice,,,,,,05/07/2018,05/07/2018,0.00,,54.66,,"-587,809.20"
,IN,AR,30318702,1005,100,,Invoice,,,,,,05/07/2018,05/07/2018,0.00,,54.66,,"-587,863.86"
,IN,AR,30318705,1005,100,,Invoice,,,,,,05/07/2018,05/07/2018,0.00,,182.20,,"-588,046.06"
,IN,AR,30318709,1005,100,,Invoice,,,,,,05/07/2018,05/07/2018,0.00,,14.34,,"-588,060.40"
,IN,AR,30318711,1005,100,,Invoice,,,,,,05/07/2018,05/07/2018,0.00,,18.22,,"-588,078.62"
,IN,AR,30318713,1005,100,,Invoice,,,,,,05/07/2018,05/07/2018,0.00,,7.29,,"-588,085.91"
,IN,AR,30318715,1005,100,,Invoice,,,,,,05/07/2018,05/07/2018,0.00,,28.00,,"-588,113.91"
,IN,AR,30318719,1005,100,,Invoice,,,,,,05/07/2018,05/07/2018,0.00,,6.02,,"-588,119.93"
,IN,AR,30318720,1005,100,,Invoice,,,,,,05/07/2018,05/07/2018,0.00,,364.41,,"-588,484.34"
,IN,AR,30318724,1005,100,,Invoice,,,,,,05/07/2018,05/07/2018,0.00,,"1,093.22",,"-589,577.56"
,IN,AR,30318729,1005,100,,Invoice,,,,,,05/07/2018,05/07/2018,0.00,,12.03,,"-589,589.59"
,IN,AR,30318734,1005,100,,Invoice,,,,,,05/07/2018,05/07/2018,0.00,,61.02,,"-589,650.61"
,IN,AR,30318735,1005,100,,Invoice,,,,,,05/07/2018,05/07/2018,0.00,,20.34,,"-589,670.95"
,IN,AR,30318736,1005,100,,Invoice,,,,,,05/07/2018,05/07/2018,0.00,,61.02,,"-589,731.97"
,IN,AR,30318747,1005,100,,Invoice,,,,,,05/07/2018,05/07/2018,0.00,,175.64,,"-589,907.61"
,IN,AR,30318753,1005,100,,Invoice,,,,,,05/07/2018,05/07/2018,0.00,,35.85,,"-589,943.46"
,IN,AR,30318759,1005,100,,Invoice,,,,,,05/07/2018,05/07/2018,0.00,,18.64,,"-589,962.10"
,IN,AR,30318769,1005,100,,Invoice,,,,,,05/07/2018,05/07/2018,0.00,,14.34,,"-589,976.44"
,IN,AR,30318773,1005,100,,Invoice,,,,,,05/07/2018,05/07/2018,0.00,,12.88,,"-589,989.32"
,IN,AR,30318785,1005,100,,Invoice,,,,,,05/07/2018,05/07/2018,0.00,,29.15,,"-590,018.47"
,IN,AR,30318786,1005,100,,Invoice,,,,,,05/07/2018,05/07/2018,0.00,,6.36,,"-590,024.83"
,IN,AR,30318788,1005,100,,Invoice,,,,,,05/07/2018,05/07/2018,0.00,,14.58,,"-590,039.41"
,IN,AR,30318791,1005,100,,Invoice,,,,,,05/07/2018,05/07/2018,0.00,,5.08,,"-590,044.49"
,IN,AR,30318798,1005,100,,Invoice,,,,,,05/07/2018,05/07/2018,0.00,,18.39,,"-590,062.88"
,IN,AR,30318804,1005,100,,Invoice,,,,,,05/07/2018,05/07/2018,0.00,,6.13,,"-590,069.01"
,IN,AR,30318808,1005,100,,Invoice,,,,,,05/07/2018,05/07/2018,0.00,,4.24,,"-590,073.25"
,IN,AR,30318815,1005,100,,Invoice,,,,,,05/07/2018,05/07/2018,0.00,,27.97,,"-590,101.22"
,IN,AR,30318819,1005,100,,Invoice,,,,,,05/07/2018,05/07/2018,0.00,,3.64,,"-590,104.86"
,IN,AR,30318823,1005,100,,Invoice,,,,,,05/07/2018,05/07/2018,0.00,,54.66,,"-590,159.52"
,IN,AR,30318825,1005,100,,Invoice,,,,,,05/07/2018,05/07/2018,0.00,,10.93,,"-590,170.45"
,IN,AR,30318833,1005,100,,Invoice,,,,,,05/07/2018,05/07/2018,0.00,,3.64,,"-590,174.09"
,IN,AR,30318834,1005,100,,Invoice,,,,,,05/07/2018,05/07/2018,0.00,,364.41,,"-590,538.50"
,IN,AR,30318836,1005,100,,Invoice,,,,,,05/07/2018,05/07/2018,0.00,,14.83,,"-590,553.33"
,IN,AR,30318840,1005,100,,Invoice,,,,,,05/07/2018,05/07/2018,0.00,,364.41,,"-590,917.74"
,IN,AR,30318843,1005,100,,Invoice,,,,,,05/07/2018,05/07/2018,0.00,,10.17,,"-590,927.91"
,IN,AR,30318847,1005,100,,Invoice,,,,,,05/07/2018,05/07/2018,0.00,,8.17,,"-590,936.08"
,IN,AR,30318848,1005,100,,Invoice,,,,,,05/07/2018,05/07/2018,0.00,,16.47,,"-590,952.55"
,IN,AR,30318850,1005,100,,Invoice,,,,,,05/07/2018,05/07/2018,0.00,,182.20,,"-591,134.75"
,IN,AR,30318858,1005,100,,Invoice,,,,,,05/07/2018,05/07/2018,0.00,,29.66,,"-591,164.41"
,IN,AR,30318859,1005,100,,Invoice,,,,,,05/07/2018,05/07/2018,0.00,,14.00,,"-591,178.41"
,IN,AR,30318860,1005,100,,Invoice,,,,,,05/07/2018,05/07/2018,0.00,,54.66,,"-591,233.07"
,IN,AR,30318865,1005,100,,Invoice,,,,,,05/07/2018,05/07/2018,0.00,,10.93,,"-591,244.00"
,IN,AR,30318866,1005,100,,Invoice,,,,,,05/07/2018,05/07/2018,0.00,,"1,093.22",,"-592,337.22"
,IN,AR,30318867,1005,100,,Invoice,,,,,,05/07/2018,05/07/2018,0.00,,3.64,,"-592,340.86"
,IN,AR,30318882,1005,100,,Invoice,,,,,,05/07/2018,05/07/2018,0.00,,6.97,,"-592,347.83"
,IN,AR,30318885,1005,100,,Invoice,,,,,,05/07/2018,05/07/2018,0.00,,5.85,,"-592,353.68"
,IN,AR,30318886,1005,100,,Invoice,,,,,,05/07/2018,05/07/2018,0.00,,18.22,,"-592,371.90"
,IN,AR,30318887,1005,100,,Invoice,,,,,,05/07/2018,05/07/2018,0.00,,10.93,,"-592,382.83"
,IN,AR,30318889,1005,100,,Invoice,,,,,,05/07/2018,05/07/2018,0.00,,16.53,,"-592,399.36"
,IN,AR,30318892,1005,100,,Invoice,,,,,,05/07/2018,05/07/2018,0.00,,364.41,,"-592,763.77"
,IN,AR,30318893,1005,100,,Invoice,,,,,,05/07/2018,05/07/2018,0.00,,5.68,,"-592,769.45"
,IN,AR,30318896,1005,100,,Invoice,,,,,,05/07/2018,05/07/2018,0.00,,54.66,,"-592,824.11"
,IN,AR,30318901,1005,100,,Invoice,,,,,,05/07/2018,05/07/2018,0.00,,54.66,,"-592,878.77"
,IN,AR,30318902,1005,100,,Invoice,,,,,,05/07/2018,05/07/2018,0.00,,18.05,,"-592,896.82"
,IN,AR,30318903,1005,100,,Invoice,,,,,,05/07/2018,05/07/2018,0.00,,10.34,,"-592,907.16"
,IN,AR,30318904,1005,100,,Invoice,,,,,,05/07/2018,05/07/2018,0.00,,14.58,,"-592,921.74"
,IN,AR,30318906,1005,100,,Invoice,,,,,,05/07/2018,05/07/2018,0.00,,14.63,,"-592,936.37"
,IN,AR,30318907,1005,100,,Invoice,,,,,,05/07/2018,05/07/2018,0.00,,9.10,,"-592,945.47"
,IN,AR,30318911,1005,100,,Invoice,,,,,,05/07/2018,05/07/2018,0.00,,10.38,,"-592,955.85"
,IN,AR,30318913,1005,100,,Invoice,,,,,,05/07/2018,05/07/2018,0.00,,9.70,,"-592,965.55"
,IN,AR,30318914,1005,100,,Invoice,,,,,,05/07/2018,05/07/2018,0.00,,5.08,,"-592,970.63"
,IN,AR,30318918,1005,100,,Invoice,,,,,,05/07/2018,05/07/2018,0.00,,10.00,,"-592,980.63"
,IN,AR,30318923,1005,100,,Invoice,,,,,,05/07/2018,05/07/2018,0.00,,182.20,,"-593,162.83"
,IN,AR,30318926,1005,100,,Invoice,,,,,,05/07/2018,05/07/2018,0.00,,5.29,,"-593,168.12"
,IN,AR,30318932,1005,100,,Invoice,,,,,,05/07/2018,05/07/2018,0.00,,11.36,,"-593,179.48"
,IN,AR,30318933,1005,100,,Invoice,,,,,,05/07/2018,05/07/2018,0.00,,22.51,,"-593,201.99"
,IN,AR,30318945,1005,100,,Invoice,,,,,,05/07/2018,05/07/2018,0.00,,18.33,,"-593,220.32"
,IN,AR,30318947,1005,100,,Invoice,,,,,,05/07/2018,05/07/2018,0.00,,5.86,,"-593,226.18"
,IN,AR,30318952,1005,100,,Invoice,,,,,,05/07/2018,05/07/2018,0.00,,182.20,,"-593,408.38"
,IN,AR,30318954,1005,100,,Invoice,,,,,,05/07/2018,05/07/2018,0.00,,54.66,,"-593,463.04"
,IN,AR,30318957,1005,100,,Invoice,,,,,,05/07/2018,05/07/2018,0.00,,8.52,,"-593,471.56"
,IN,AR,30318958,1005,100,,Invoice,,,,,,05/07/2018,05/07/2018,0.00,,25.51,,"-593,497.07"
,IN,AR,30318960,1005,100,,Invoice,,,,,,05/07/2018,05/07/2018,0.00,,7.29,,"-593,504.36"
,IN,AR,30318966,1005,100,,Invoice,,,,,,05/07/2018,05/07/2018,0.00,,9.84,,"-593,514.20"
,IN,AR,30318967,1005,100,,Invoice,,,,,,05/07/2018,05/07/2018,0.00,,9.96,,"-593,524.16"
,IN,AR,30318968,1005,100,,Invoice,,,,,,05/07/2018,05/07/2018,0.00,,11.95,,"-593,536.11"
,IN,AR,30318969,1005,100,,Invoice,,,,,,05/07/2018,05/07/2018,0.00,,25.89,,"-593,562.00"
,IN,AR,30318970,1005,100,,Invoice,,,,,,05/07/2018,05/07/2018,0.00,,3.98,,"-593,565.98"
,IN,AR,30318976,1005,100,,Invoice,,,,,,05/07/2018,05/07/2018,0.00,,23.85,,"-593,589.83"
,IN,AR,30318977,1005,100,,Invoice,,,,,,05/07/2018,05/07/2018,0.00,,11.13,,"-593,600.96"
,IN,AR,30318980,1005,100,,Invoice,,,,,,05/07/2018,05/07/2018,0.00,,29.21,,"-593,630.17"
,IN,AR,30318986,1005,100,,Invoice,,,,,,05/07/2018,05/07/2018,0.00,,182.20,,"-593,812.37"
,IN,AR,30318989,1005,100,,Invoice,,,,,,05/07/2018,05/07/2018,0.00,,172.61,,"-593,984.98"
,IN,AR,30318991,1005,100,,Invoice,,,,,,05/07/2018,05/07/2018,0.00,,51.02,,"-594,036.00"
,IN,AR,30318994,1005,100,,Invoice,,,,,,05/07/2018,05/07/2018,0.00,,14.58,,"-594,050.58"
,IN,AR,30318995,1005,100,,Invoice,,,,,,05/07/2018,05/07/2018,0.00,,14.58,,"-594,065.16"
,IN,AR,30318996,1005,100,,Invoice,,,,,,05/07/2018,05/07/2018,0.00,,21.36,,"-594,086.52"
,IN,AR,30319003,1005,100,,Invoice,,,,,,05/07/2018,05/07/2018,0.00,,51.86,,"-594,138.38"
,IN,AR,30319015,1005,100,,Invoice,,,,,,05/07/2018,05/07/2018,0.00,,15.25,,"-594,153.63"
,IN,AR,30319019,1005,100,,Invoice,,,,,,05/07/2018,05/07/2018,0.00,,7.29,,"-594,160.92"
,IN,AR,30319021,1005,100,,Invoice,,,,,,05/07/2018,05/07/2018,0.00,,14.58,,"-594,175.50"
,IN,AR,30319022,1005,100,,Invoice,,,,,,05/07/2018,05/07/2018,0.00,,29.15,,"-594,204.65"
,IN,AR,30319026,1005,100,,Invoice,,,,,,05/07/2018,05/07/2018,0.00,,10.93,,"-594,215.58"
,IN,AR,30319031,1005,100,,Invoice,,,,,,05/07/2018,05/07/2018,0.00,,25.42,,"-594,241.00"
,IN,AR,30319033,1005,100,,Invoice,,,,,,05/07/2018,05/07/2018,0.00,,30.01,,"-594,271.01"
,IN,AR,30319037,1005,100,,Invoice,,,,,,05/07/2018,05/07/2018,0.00,,8.00,,"-594,279.01"
,IN,AR,30319038,1005,100,,Invoice,,,,,,05/07/2018,05/07/2018,0.00,,32.01,,"-594,311.02"
,IN,AR,30319043,1005,100,,Invoice,,,,,,05/07/2018,05/07/2018,0.00,,8.75,,"-594,319.77"
,IN,AR,30319045,1005,100,,Invoice,,,,,,05/07/2018,05/07/2018,0.00,,79.49,,"-594,399.26"
,IN,AR,30319058,1005,100,,Invoice,,,,,,05/07/2018,05/07/2018,0.00,,43.68,,"-594,442.94"
,IN,AR,30319061,1005,100,,Invoice,,,,,,05/07/2018,05/07/2018,0.00,,32.80,,"-594,475.74"
,IN,AR,30319068,1005,100,,Invoice,,,,,,05/07/2018,05/07/2018,0.00,,11.22,,"-594,486.96"
,IN,AR,30319070,1005,100,,Invoice,,,,,,05/07/2018,05/07/2018,0.00,,27.46,,"-594,514.42"
,IN,AR,30319071,1005,100,,Invoice,,,,,,05/07/2018,05/07/2018,0.00,,10.93,,"-594,525.35"
,IN,AR,30319073,1005,100,,Invoice,,,,,,05/07/2018,05/07/2018,0.00,,29.15,,"-594,554.50"
,IN,AR,30319076,1005,100,,Invoice,,,,,,05/07/2018,05/07/2018,0.00,,24.27,,"-594,578.77"
,IN,AR,30319088,1005,100,,Invoice,,,,,,05/07/2018,05/07/2018,0.00,,18.22,,"-594,596.99"
,IN,AR,30319094,1005,100,,Invoice,,,,,,05/07/2018,05/07/2018,0.00,,81.15,,"-594,678.14"
,IN,AR,30319098,1005,100,,Invoice,,,,,,05/07/2018,05/07/2018,0.00,,4.78,,"-594,682.92"
,IN,AR,30319099,1005,100,,Invoice,,,,,,05/07/2018,05/07/2018,0.00,,124.27,,"-594,807.19"
,IN,AR,30319100,1005,100,,Invoice,,,,,,05/07/2018,05/07/2018,0.00,,17.53,,"-594,824.72"
,IN,AR,30319101,1005,100,,Invoice,,,,,,05/07/2018,05/07/2018,0.00,,6.37,,"-594,831.09"
,IN,AR,30319107,1005,100,,Invoice,,,,,,05/07/2018,05/07/2018,0.00,,26.44,,"-594,857.53"
,IN,AR,30319118,1005,100,,Invoice,,,,,,05/07/2018,05/07/2018,0.00,,14.00,,"-594,871.53"
,IN,AR,30319127,1005,100,,Invoice,,,,,,05/07/2018,05/07/2018,0.00,,29.15,,"-594,900.68"
,IN,AR,30319128,1005,100,,Invoice,,,,,,05/07/2018,05/07/2018,0.00,,182.20,,"-595,082.88"
,IN,AR,30319144,1005,100,,Invoice,,,,,,05/07/2018,05/07/2018,0.00,,7.29,,"-595,090.17"
,IN,AR,30319149,1005,100,,Invoice,,,,,,05/07/2018,05/07/2018,0.00,,29.15,,"-595,119.32"
,IN,AR,30319154,1005,100,,Invoice,,,,,,05/07/2018,05/07/2018,0.00,,29.15,,"-595,148.47"
,IN,AR,30319164,1005,100,,Invoice,,,,,,05/07/2018,05/07/2018,0.00,,182.20,,"-595,330.67"
,IN,AR,30319169,1005,100,,Invoice,,,,,,05/07/2018,05/07/2018,0.00,,14.49,,"-595,345.16"
,IN,AR,30319171,1005,100,,Invoice,,,,,,05/07/2018,05/07/2018,0.00,,7.29,,"-595,352.45"
,IN,AR,30319183,1005,100,,Invoice,,,,,,05/07/2018,05/07/2018,0.00,,16.61,,"-595,369.06"
,IN,AR,30319184,1005,100,,Invoice,,,,,,05/07/2018,05/07/2018,0.00,,4.15,,"-595,373.21"
,IN,AR,30319185,1005,100,,Invoice,,,,,,05/07/2018,05/07/2018,0.00,,4.15,,"-595,377.36"
,IN,AR,30319192,1005,100,,Invoice,,,,,,05/07/2018,05/07/2018,0.00,,36.41,,"-595,413.77"
,IN,AR,30319207,1005,100,,Invoice,,,,,,05/07/2018,05/07/2018,0.00,,10.93,,"-595,424.70"
,IN,AR,30319226,1005,100,,Invoice,,,,,,05/07/2018,05/07/2018,0.00,,29.15,,"-595,453.85"
,IN,AR,30319847,1005,100,,Invoice,,,,,,05/07/2018,05/07/2018,0.00,,54.66,,"-595,508.51"
,IN,AR,30320154,1005,100,,Invoice,,,,,,05/07/2018,05/07/2018,0.00,,54.66,,"-595,563.17"
,CS,AR,32005759,1005,100,,Cash sale,,,,,,06/07/2018,06/07/2018,0.00,,54.95,,"-595,618.12"
,CS,AR,32005760,1005,100,,Cash sale,,,,,,06/07/2018,06/07/2018,0.00,,14.58,,"-595,632.70"
,CS,AR,32005762,1005,100,,Cash sale,,,,,,06/07/2018,06/07/2018,0.00,,14.58,,"-595,647.28"
,CS,AR,32005765,1005,100,,Cash sale,,,,,,06/07/2018,06/07/2018,0.00,,14.03,,"-595,661.31"
,CS,AR,32005770,1005,100,,Cash sale,,,,,,06/07/2018,06/07/2018,0.00,,9.13,,"-595,670.44"
,CS,AR,32005778,1005,100,,Cash sale,,,,,,06/07/2018,06/07/2018,0.00,,4.32,,"-595,674.76"
,CS,AR,32005787,1005,100,,Cash sale,,,,,,06/07/2018,06/07/2018,0.00,,7.25,,"-595,682.01"
,CS,AR,32005792,1005,100,,Cash sale,,,,,,06/07/2018,06/07/2018,0.00,,7.29,,"-595,689.30"
,CS,AR,32005793,1005,100,,Cash sale,,,,,,06/07/2018,06/07/2018,0.00,,18.22,,"-595,707.52"
,CS,AR,32005795,1005,100,,Cash sale,,,,,,06/07/2018,06/07/2018,0.00,,12.46,,"-595,719.98"
,CS,AR,32005796,1005,100,,Cash sale,,,,,,06/07/2018,06/07/2018,0.00,,10.93,,"-595,730.91"
,CS,AR,32005799,1005,100,,Cash sale,,,,,,06/07/2018,06/07/2018,0.00,,7.29,,"-595,738.20"
,CS,AR,32005808,1005,100,,Cash sale,,,,,,06/07/2018,06/07/2018,0.00,,5.59,,"-595,743.79"
,CS,AR,32005810,1005,100,,Cash sale,,,,,,06/07/2018,06/07/2018,0.00,,7.29,,"-595,751.08"
,CS,AR,32005811,1005,100,,Cash sale,,,,,,06/07/2018,06/07/2018,0.00,,6.02,,"-595,757.10"
,CS,AR,32005828,1005,100,,Cash sale,,,,,,06/07/2018,06/07/2018,0.00,,25.51,,"-595,782.61"
,CS,AR,32005830,1005,100,,Cash sale,,,,,,06/07/2018,06/07/2018,0.00,,22.88,,"-595,805.49"
,CS,AR,32005834,1005,100,,Cash sale,,,,,,06/07/2018,06/07/2018,0.00,,3.64,,"-595,809.13"
,CS,AR,32005836,1005,100,,Cash sale,,,,,,06/07/2018,06/07/2018,0.00,,12.92,,"-595,822.05"
,CS,AR,32005837,1005,100,,Cash sale,,,,,,06/07/2018,06/07/2018,0.00,,43.97,,"-595,866.02"
,CS,AR,32005844,1005,100,,Cash sale,,,,,,06/07/2018,06/07/2018,0.00,,12.86,,"-595,878.88"
,CS,AR,32005845,1005,100,,Cash sale,,,,,,06/07/2018,06/07/2018,0.00,,10.93,,"-595,889.81"
,CS,AR,32005847,1005,100,,Cash sale,,,,,,06/07/2018,06/07/2018,0.00,,9.03,,"-595,898.84"
,CS,AR,32005852,1005,100,,Cash sale,,,,,,06/07/2018,06/07/2018,0.00,,11.65,,"-595,910.49"
,CS,AR,32005854,1005,100,,Cash sale,,,,,,06/07/2018,06/07/2018,0.00,,9.03,,"-595,919.52"
,CS,AR,32005858,1005,100,,Cash sale,,,,,,06/07/2018,06/07/2018,0.00,,7.63,,"-595,927.15"
,CS,AR,32005859,1005,100,,Cash sale,,,,,,06/07/2018,06/07/2018,0.00,,18.09,,"-595,945.24"
,CS,AR,32005863,1005,100,,Cash sale,,,,,,06/07/2018,06/07/2018,0.00,,17.54,,"-595,962.78"
,CS,AR,32005865,1005,100,,Cash sale,,,,,,06/07/2018,06/07/2018,0.00,,6.02,,"-595,968.80"
,CS,AR,32005867,1005,100,,Cash sale,,,,,,06/07/2018,06/07/2018,0.00,,21.86,,"-595,990.66"
,CS,AR,32005868,1005,100,,Cash sale,,,,,,06/07/2018,06/07/2018,0.00,,17.80,,"-596,008.46"
,CS,AR,32005873,1005,100,,Cash sale,,,,,,06/07/2018,06/07/2018,0.00,,10.93,,"-596,019.39"
,CS,AR,32005875,1005,100,,Cash sale,,,,,,06/07/2018,06/07/2018,0.00,,14.58,,"-596,033.97"
,CS,AR,32005876,1005,100,,Cash sale,,,,,,06/07/2018,06/07/2018,0.00,,3.64,,"-596,037.61"
,CS,AR,32005879,1005,100,,Cash sale,,,,,,06/07/2018,06/07/2018,0.00,,10.93,,"-596,048.54"
,CS,AR,32005888,1005,100,,Cash sale,,,,,,06/07/2018,06/07/2018,0.00,,14.58,,"-596,063.12"
,CS,AR,32005895,1005,100,,Cash sale,,,,,,06/07/2018,06/07/2018,0.00,,3.64,,"-596,066.76"
,CS,AR,32005897,1005,100,,Cash sale,,,,,,06/07/2018,06/07/2018,0.00,,7.29,,"-596,074.05"
,CS,AR,32005899,1005,100,,Cash sale,,,,,,06/07/2018,06/07/2018,0.00,,10.93,,"-596,084.98"
,CS,AR,32005915,1005,100,,Cash sale,,,,,,06/07/2018,06/07/2018,0.00,,10.93,,"-596,095.91"
,CS,AR,32005920,1005,100,,Cash sale,,,,,,06/07/2018,06/07/2018,0.00,,7.29,,"-596,103.20"
,CS,AR,32005927,1005,100,,Cash sale,,,,,,06/07/2018,06/07/2018,0.00,,10.17,,"-596,113.37"
,CS,AR,32005933,1005,100,,Cash sale,,,,,,06/07/2018,06/07/2018,0.00,,3.64,,"-596,117.01"
,CS,AR,32005934,1005,100,,Cash sale,,,,,,06/07/2018,06/07/2018,0.00,,7.29,,"-596,124.30"
,CS,AR,32005936,1005,100,,Cash sale,,,,,,06/07/2018,06/07/2018,0.00,,14.58,,"-596,138.88"
,CS,AR,32005941,1005,100,,Cash sale,,,,,,06/07/2018,06/07/2018,0.00,,24.00,,"-596,162.88"
,CS,AR,32005942,1005,100,,Cash sale,,,,,,06/07/2018,06/07/2018,0.00,,3.64,,"-596,166.52"
,CS,AR,32005944,1005,100,,Cash sale,,,,,,06/07/2018,06/07/2018,0.00,,10.93,,"-596,177.45"
,CS,AR,32005947,1005,100,,Cash sale,,,,,,06/07/2018,06/07/2018,0.00,,3.64,,"-596,181.09"
,CS,AR,32005948,1005,100,,Cash sale,,,,,,06/07/2018,06/07/2018,0.00,,12.14,,"-596,193.23"
,CS,AR,32005952,1005,100,,Cash sale,,,,,,06/07/2018,06/07/2018,0.00,,7.76,,"-596,200.99"
,CS,AR,32005957,1005,100,,Cash sale,,,,,,06/07/2018,06/07/2018,0.00,,6.86,,"-596,207.85"
,CS,AR,32005961,1005,100,,Cash sale,,,,,,06/07/2018,06/07/2018,0.00,,7.63,,"-596,215.48"
,CS,AR,32005963,1005,100,,Cash sale,,,,,,06/07/2018,06/07/2018,0.00,,10.93,,"-596,226.41"
,CS,AR,32005965,1005,100,,Cash sale,,,,,,06/07/2018,06/07/2018,0.00,,57.68,,"-596,284.09"
,CS,AR,32005966,1005,100,,Cash sale,,,,,,06/07/2018,06/07/2018,0.00,,18.22,,"-596,302.31"
,CS,AR,32005967,1005,100,,Cash sale,,,,,,06/07/2018,06/07/2018,0.00,,14.58,,"-596,316.89"
,CS,AR,32005968,1005,100,,Cash sale,,,,,,06/07/2018,06/07/2018,0.00,,30.36,,"-596,347.25"
,CS,AR,32005969,1005,100,,Cash sale,,,,,,06/07/2018,06/07/2018,0.00,,10.93,,"-596,358.18"
,CS,AR,32005976,1005,100,,Cash sale,,,,,,06/07/2018,06/07/2018,0.00,,7.29,,"-596,365.47"
,CS,AR,32005979,1005,100,,Cash sale,,,,,,06/07/2018,06/07/2018,0.00,,10.38,,"-596,375.85"
,CS,AR,32005980,1005,100,,Cash sale,,,,,,06/07/2018,06/07/2018,0.00,,4.15,,"-596,380.00"
,CS,AR,32005981,1005,100,,Cash sale,,,,,,06/07/2018,06/07/2018,0.00,,11.86,,"-596,391.86"
,CS,AR,32005985,1005,100,,Cash sale,,,,,,06/07/2018,06/07/2018,0.00,,2.92,,"-596,394.78"
,CS,AR,32005987,1005,100,,Cash sale,,,,,,06/07/2018,06/07/2018,0.00,,7.75,,"-596,402.53"
,CS,AR,32005988,1005,100,,Cash sale,,,,,,06/07/2018,06/07/2018,0.00,,12.14,,"-596,414.67"
,CS,AR,32005991,1005,100,,Cash sale,,,,,,06/07/2018,06/07/2018,0.00,,9.13,,"-596,423.80"
,CS,AR,32005994,1005,100,,Cash sale,,,,,,06/07/2018,06/07/2018,0.00,,10.93,,"-596,434.73"
,CS,AR,32006001,1005,100,,Cash sale,,,,,,06/07/2018,06/07/2018,0.00,,3.64,,"-596,438.37"
,CS,AR,32006005,1005,100,,Cash sale,,,,,,06/07/2018,06/07/2018,0.00,,7.29,,"-596,445.66"
,CS,AR,32006009,1005,100,,Cash sale,,,,,,06/07/2018,06/07/2018,0.00,,25.51,,"-596,471.17"
,CS,AR,32006011,1005,100,,Cash sale,,,,,,06/07/2018,06/07/2018,0.00,,7.29,,"-596,478.46"
,CS,AR,32006032,1005,100,,Cash sale,,,,,,06/07/2018,06/07/2018,0.00,,9.32,,"-596,487.78"
,CS,AR,32006041,1005,100,,Cash sale,,,,,,06/07/2018,06/07/2018,0.00,,3.64,,"-596,491.42"
,IN,AR,30318569,1005,100,,Invoice,,,,,,06/07/2018,06/07/2018,0.00,,54.66,,"-596,546.08"
,IN,AR,30318572,1005,100,,Invoice,,,,,,06/07/2018,06/07/2018,0.00,,65.25,,"-596,611.33"
,IN,AR,30318573,1005,100,,Invoice,,,,,,06/07/2018,06/07/2018,0.00,,25.51,,"-596,636.84"
,IN,AR,30318579,1005,100,,Invoice,,,,,,06/07/2018,06/07/2018,0.00,,22.37,,"-596,659.21"
,IN,AR,30318581,1005,100,,Invoice,,,,,,06/07/2018,06/07/2018,0.00,,14.58,,"-596,673.79"
,IN,AR,30318595,1005,100,,Invoice,,,,,,06/07/2018,06/07/2018,0.00,,14.24,,"-596,688.03"
,IN,AR,30318606,1005,100,,Invoice,,,,,,06/07/2018,06/07/2018,0.00,,28.98,,"-596,717.01"
,IN,AR,30318621,1005,100,,Invoice,,,,,,06/07/2018,06/07/2018,0.00,,9.19,,"-596,726.20"
,IN,AR,30318622,1005,100,,Invoice,,,,,,06/07/2018,06/07/2018,0.00,,87.33,,"-596,813.53"
,IN,AR,30318627,1005,100,,Invoice,,,,,,06/07/2018,06/07/2018,0.00,,13.94,,"-596,827.47"
,IN,AR,30318632,1005,100,,Invoice,,,,,,06/07/2018,06/07/2018,0.00,,75.93,,"-596,903.40"
,IN,AR,30318638,1005,100,,Invoice,,,,,,06/07/2018,06/07/2018,0.00,,7.29,,"-596,910.69"
,IN,AR,30318643,1005,100,,Invoice,,,,,,06/07/2018,06/07/2018,0.00,,22.00,,"-596,932.69"
,IN,AR,30318644,1005,100,,Invoice,,,,,,06/07/2018,06/07/2018,0.00,,364.41,,"-597,297.10"
,IN,AR,30318651,1005,100,,Invoice,,,,,,06/07/2018,06/07/2018,0.00,,"1,093.22",,"-598,390.32"
,IN,AR,30318661,1005,100,,Invoice,,,,,,06/07/2018,06/07/2018,0.00,,44.00,,"-598,434.32"
,IN,AR,30318666,1005,100,,Invoice,,,,,,06/07/2018,06/07/2018,0.00,,54.66,,"-598,488.98"
,IN,AR,30318670,1005,100,,Invoice,,,,,,06/07/2018,06/07/2018,0.00,,15.57,,"-598,504.55"
,IN,AR,30318673,1005,100,,Invoice,,,,,,06/07/2018,06/07/2018,0.00,,9.49,,"-598,514.04"
,IN,AR,30318675,1005,100,,Invoice,,,,,,06/07/2018,06/07/2018,0.00,,24.00,,"-598,538.04"
,IN,AR,30318686,1005,100,,Invoice,,,,,,06/07/2018,06/07/2018,0.00,,15.53,,"-598,553.57"
,IN,AR,30318690,1005,100,,Invoice,,,,,,06/07/2018,06/07/2018,0.00,,52.00,,"-598,605.57"
,IN,AR,30318691,1005,100,,Invoice,,,,,,06/07/2018,06/07/2018,0.00,,7.29,,"-598,612.86"
,IN,AR,30318696,1005,100,,Invoice,,,,,,06/07/2018,06/07/2018,0.00,,36.44,,"-598,649.30"
,IN,AR,30318698,1005,100,,Invoice,,,,,,06/07/2018,06/07/2018,0.00,,19.58,,"-598,668.88"
,IN,AR,30318701,1005,100,,Invoice,,,,,,06/07/2018,06/07/2018,0.00,,9.03,,"-598,677.91"
,IN,AR,30318710,1005,100,,Invoice,,,,,,06/07/2018,06/07/2018,0.00,,4.78,,"-598,682.69"
,IN,AR,30318721,1005,100,,Invoice,,,,,,06/07/2018,06/07/2018,0.00,,29.15,,"-598,711.84"
,IN,AR,30318725,1005,100,,Invoice,,,,,,06/07/2018,06/07/2018,0.00,,7.29,,"-598,719.13"
,IN,AR,30318743,1005,100,,Invoice,,,,,,06/07/2018,06/07/2018,0.00,,28.43,,"-598,747.56"
,IN,AR,30318744,1005,100,,Invoice,,,,,,06/07/2018,06/07/2018,0.00,,9.56,,"-598,757.12"
,IN,AR,30318745,1005,100,,Invoice,,,,,,06/07/2018,06/07/2018,0.00,,364.41,,"-599,121.53"
,IN,AR,30318749,1005,100,,Invoice,,,,,,06/07/2018,06/07/2018,0.00,,7.76,,"-599,129.29"
,IN,AR,30318755,1005,100,,Invoice,,,,,,06/07/2018,06/07/2018,0.00,,6.02,,"-599,135.31"
,IN,AR,30318762,1005,100,,Invoice,,,,,,06/07/2018,06/07/2018,0.00,,61.53,,"-599,196.84"
,IN,AR,30318770,1005,100,,Invoice,,,,,,06/07/2018,06/07/2018,0.00,,9.56,,"-599,206.40"
,IN,AR,30318771,1005,100,,Invoice,,,,,,06/07/2018,06/07/2018,0.00,,16.73,,"-599,223.13"
,IN,AR,30318782,1005,100,,Invoice,,,,,,06/07/2018,06/07/2018,0.00,,4.24,,"-599,227.37"
,IN,AR,30318787,1005,100,,Invoice,,,,,,06/07/2018,06/07/2018,0.00,,4.78,,"-599,232.15"
,IN,AR,30318792,1005,100,,Invoice,,,,,,06/07/2018,06/07/2018,0.00,,7.63,,"-599,239.78"
,IN,AR,30318793,1005,100,,Invoice,,,,,,06/07/2018,06/07/2018,0.00,,7.63,,"-599,247.41"
,IN,AR,30318794,1005,100,,Invoice,,,,,,06/07/2018,06/07/2018,0.00,,2.54,,"-599,249.95"
,IN,AR,30318796,1005,100,,Invoice,,,,,,06/07/2018,06/07/2018,0.00,,5.08,,"-599,255.03"
,IN,AR,30318803,1005,100,,Invoice,,,,,,06/07/2018,06/07/2018,0.00,,48.14,,"-599,303.17"
,IN,AR,30318805,1005,100,,Invoice,,,,,,06/07/2018,06/07/2018,0.00,,17.80,,"-599,320.97"
,IN,AR,30318806,1005,100,,Invoice,,,,,,06/07/2018,06/07/2018,0.00,,4.24,,"-599,325.21"
,IN,AR,30318807,1005,100,,Invoice,,,,,,06/07/2018,06/07/2018,0.00,,25.42,,"-599,350.63"
,IN,AR,30318853,1005,100,,Invoice,,,,,,06/07/2018,06/07/2018,0.00,,16.83,,"-599,367.46"
,IN,AR,30318868,1005,100,,Invoice,,,,,,06/07/2018,06/07/2018,0.00,,6.36,,"-599,373.82"
,IN,AR,30318869,1005,100,,Invoice,,,,,,06/07/2018,06/07/2018,0.00,,455.51,,"-599,829.33"
,IN,AR,30318870,1005,100,,Invoice,,,,,,06/07/2018,06/07/2018,0.00,,29.15,,"-599,858.48"
,IN,AR,30318871,1005,100,,Invoice,,,,,,06/07/2018,06/07/2018,0.00,,14.83,,"-599,873.31"
,IN,AR,30318881,1005,100,,Invoice,,,,,,06/07/2018,06/07/2018,0.00,,14.58,,"-599,887.89"
,IN,AR,30318884,1005,100,,Invoice,,,,,,06/07/2018,06/07/2018,0.00,,23.41,,"-599,911.30"
,IN,AR,30318891,1005,100,,Invoice,,,,,,06/07/2018,06/07/2018,0.00,,5.17,,"-599,916.47"
,IN,AR,30318895,1005,100,,Invoice,,,,,,06/07/2018,06/07/2018,0.00,,3.64,,"-599,920.11"
,IN,AR,30318898,1005,100,,Invoice,,,,,,06/07/2018,06/07/2018,0.00,,3.64,,"-599,923.75"
,IN,AR,30318917,1005,100,,Invoice,,,,,,06/07/2018,06/07/2018,0.00,,28.39,,"-599,952.14"
,IN,AR,30318922,1005,100,,Invoice,,,,,,06/07/2018,06/07/2018,0.00,,14.58,,"-599,966.72"
,IN,AR,30318928,1005,100,,Invoice,,,,,,06/07/2018,06/07/2018,0.00,,10.93,,"-599,977.65"
,IN,AR,30318931,1005,100,,Invoice,,,,,,06/07/2018,06/07/2018,0.00,,4.85,,"-599,982.50"
,IN,AR,30318936,1005,100,,Invoice,,,,,,06/07/2018,06/07/2018,0.00,,105.93,,"-600,088.43"
,IN,AR,30318943,1005,100,,Invoice,,,,,,06/07/2018,06/07/2018,0.00,,182.20,,"-600,270.63"
,IN,AR,30318944,1005,100,,Invoice,,,,,,06/07/2018,06/07/2018,0.00,,21.86,,"-600,292.49"
,IN,AR,30318964,1005,100,,Invoice,,,,,,06/07/2018,06/07/2018,0.00,,54.66,,"-600,347.15"
,IN,AR,30318983,1005,100,,Invoice,,,,,,06/07/2018,06/07/2018,0.00,,34.07,,"-600,381.22"
,IN,AR,30318987,1005,100,,Invoice,,,,,,06/07/2018,06/07/2018,0.00,,57.61,,"-600,438.83"
,IN,AR,30318988,1005,100,,Invoice,,,,,,06/07/2018,06/07/2018,0.00,,14.58,,"-600,453.41"
,IN,AR,30318993,1005,100,,Invoice,,,,,,06/07/2018,06/07/2018,0.00,,86.19,,"-600,539.60"
,IN,AR,30319000,1005,100,,Invoice,,,,,,06/07/2018,06/07/2018,0.00,,33.39,,"-600,572.99"
,IN,AR,30319001,1005,100,,Invoice,,,,,,06/07/2018,06/07/2018,0.00,,9.03,,"-600,582.02"
,IN,AR,30319002,1005,100,,Invoice,,,,,,06/07/2018,06/07/2018,0.00,,12.03,,"-600,594.05"
,IN,AR,30319007,1005,100,,Invoice,,,,,,06/07/2018,06/07/2018,0.00,,7.29,,"-600,601.34"
,IN,AR,30319009,1005,100,,Invoice,,,,,,06/07/2018,06/07/2018,0.00,,47.29,,"-600,648.63"
,IN,AR,30319024,1005,100,,Invoice,,,,,,06/07/2018,06/07/2018,0.00,,28.69,,"-600,677.32"
,IN,AR,30319025,1005,100,,Invoice,,,,,,06/07/2018,06/07/2018,0.00,,18.22,,"-600,695.54"
,IN,AR,30319032,1005,100,,Invoice,,,,,,06/07/2018,06/07/2018,0.00,,15.25,,"-600,710.79"
,IN,AR,30319035,1005,100,,Invoice,,,,,,06/07/2018,06/07/2018,0.00,,10.00,,"-600,720.79"
,IN,AR,30319039,1005,100,,Invoice,,,,,,06/07/2018,06/07/2018,0.00,,8.00,,"-600,728.79"
,IN,AR,30319048,1005,100,,Invoice,,,,,,06/07/2018,06/07/2018,0.00,,7.29,,"-600,736.08"
,IN,AR,30319053,1005,100,,Invoice,,,,,,06/07/2018,06/07/2018,0.00,,32.85,,"-600,768.93"
,IN,AR,30319055,1005,100,,Invoice,,,,,,06/07/2018,06/07/2018,0.00,,84.10,,"-600,853.03"
,IN,AR,30319060,1005,100,,Invoice,,,,,,06/07/2018,06/07/2018,0.00,,18.22,,"-600,871.25"
,IN,AR,30319069,1005,100,,Invoice,,,,,,06/07/2018,06/07/2018,0.00,,6.89,,"-600,878.14"
,IN,AR,30319072,1005,100,,Invoice,,,,,,06/07/2018,06/07/2018,0.00,,16.78,,"-600,894.92"
,IN,AR,30319090,1005,100,,Invoice,,,,,,06/07/2018,06/07/2018,0.00,,17.03,,"-600,911.95"
,IN,AR,30319091,1005,100,,Invoice,,,,,,06/07/2018,06/07/2018,0.00,,16.91,,"-600,928.86"
,IN,AR,30319095,1005,100,,Invoice,,,,,,06/07/2018,06/07/2018,0.00,,21.86,,"-600,950.72"
,IN,AR,30319108,1005,100,,Invoice,,,,,,06/07/2018,06/07/2018,0.00,,12.20,,"-600,962.92"
,IN,AR,30319112,1005,100,,Invoice,,,,,,06/07/2018,06/07/2018,0.00,,8.00,,"-600,970.92"
,IN,AR,30319121,1005,100,,Invoice,,,,,,06/07/2018,06/07/2018,0.00,,13.56,,"-600,984.48"
,IN,AR,30319133,1005,100,,Invoice,,,,,,06/07/2018,06/07/2018,0.00,,2.92,,"-600,987.40"
,IN,AR,30319137,1005,100,,Invoice,,,,,,06/07/2018,06/07/2018,0.00,,10.95,,"-600,998.35"
,IN,AR,30319139,1005,100,,Invoice,,,,,,06/07/2018,06/07/2018,0.00,,38.14,,"-601,036.49"
,IN,AR,30319146,1005,100,,Invoice,,,,,,06/07/2018,06/07/2018,0.00,,29.15,,"-601,065.64"
,IN,AR,30319147,1005,100,,Invoice,,,,,,06/07/2018,06/07/2018,0.00,,29.15,,"-601,094.79"
,IN,AR,30319152,1005,100,,Invoice,,,,,,06/07/2018,06/07/2018,0.00,,6.13,,"-601,100.92"
,IN,AR,30319166,1005,100,,Invoice,,,,,,06/07/2018,06/07/2018,0.00,,7.97,,"-601,108.89"
,IN,AR,30319186,1005,100,,Invoice,,,,,,06/07/2018,06/07/2018,0.00,,16.61,,"-601,125.50"
,IN,AR,30319187,1005,100,,Invoice,,,,,,06/07/2018,06/07/2018,0.00,,6.23,,"-601,131.73"
,IN,AR,30319188,1005,100,,Invoice,,,,,,06/07/2018,06/07/2018,0.00,,8.31,,"-601,140.04"
,IN,AR,30319190,1005,100,,Invoice,,,,,,06/07/2018,06/07/2018,0.00,,7.63,,"-601,147.67"
,IN,AR,30319197,1005,100,,Invoice,,,,,,06/07/2018,06/07/2018,0.00,,14.58,,"-601,162.25"
,IN,AR,30319202,1005,100,,Invoice,,,,,,06/07/2018,06/07/2018,0.00,,12.71,,"-601,174.96"
,IN,AR,30319208,1005,100,,Invoice,,,,,,06/07/2018,06/07/2018,0.00,,7.29,,"-601,182.25"
,IN,AR,30319209,1005,100,,Invoice,,,,,,06/07/2018,06/07/2018,0.00,,364.41,,"-601,546.66"
,IN,AR,30319227,1005,100,,Invoice,,,,,,06/07/2018,06/07/2018,0.00,,29.15,,"-601,575.81"
,CS,AR,32005784,1005,100,,Cash sale,,,,,,07/07/2018,07/07/2018,0.00,,7.29,,"-601,583.10"
,CS,AR,32005813,1005,100,,Cash sale,,,,,,07/07/2018,07/07/2018,0.00,,23.29,,"-601,606.39"
,CS,AR,32005839,1005,100,,Cash sale,,,,,,07/07/2018,07/07/2018,0.00,,10.93,,"-601,617.32"
,CS,AR,32005860,1005,100,,Cash sale,,,,,,07/07/2018,07/07/2018,0.00,,14.58,,"-601,631.90"
,CS,AR,32005871,1005,100,,Cash sale,,,,,,07/07/2018,07/07/2018,0.00,,7.29,,"-601,639.19"
,CS,AR,32005911,1005,100,,Cash sale,,,,,,07/07/2018,07/07/2018,0.00,,10.93,,"-601,650.12"
,CS,AR,32005913,1005,100,,Cash sale,,,,,,07/07/2018,07/07/2018,0.00,,14.58,,"-601,664.70"
,CS,AR,32005923,1005,100,,Cash sale,,,,,,07/07/2018,07/07/2018,0.00,,7.29,,"-601,671.99"
,CS,AR,32005925,1005,100,,Cash sale,,,,,,07/07/2018,07/07/2018,0.00,,13.74,,"-601,685.73"
,CS,AR,32005951,1005,100,,Cash sale,,,,,,07/07/2018,07/07/2018,0.00,,3.03,,"-601,688.76"
,CS,AR,32006006,1005,100,,Cash sale,,,,,,07/07/2018,07/07/2018,0.00,,7.29,,"-601,696.05"
,IN,AR,30318633,1005,100,,Invoice,,,,,,07/07/2018,07/07/2018,0.00,,92.54,,"-601,788.59"
,IN,AR,30318688,1005,100,,Invoice,,,,,,07/07/2018,07/07/2018,0.00,,7.29,,"-601,795.88"
,IN,AR,30318757,1005,100,,Invoice,,,,,,07/07/2018,07/07/2018,0.00,,612.20,,"-602,408.08"
,IN,AR,30318776,1005,100,,Invoice,,,,,,07/07/2018,07/07/2018,0.00,,9.03,,"-602,417.11"
,IN,AR,30318777,1005,100,,Invoice,,,,,,07/07/2018,07/07/2018,0.00,,12.03,,"-602,429.14"
,IN,AR,30318795,1005,100,,Invoice,,,,,,07/07/2018,07/07/2018,0.00,,10.17,,"-602,439.31"
,IN,AR,30318875,1005,100,,Invoice,,,,,,07/07/2018,07/07/2018,0.00,,21.91,,"-602,461.22"
,IN,AR,30318930,1005,100,,Invoice,,,,,,07/07/2018,07/07/2018,0.00,,10.93,,"-602,472.15"
,IN,AR,30319042,1005,100,,Invoice,,,,,,07/07/2018,07/07/2018,0.00,,50.02,,"-602,522.17"
,IN,AR,30319119,1005,100,,Invoice,,,,,,07/07/2018,07/07/2018,0.00,,18.22,,"-602,540.39"
,IN,AR,30319135,1005,100,,Invoice,,,,,,07/07/2018,07/07/2018,0.00,,13.74,,"-602,554.13"
,IN,AR,30319138,1005,100,,Invoice,,,,,,07/07/2018,07/07/2018,0.00,,14.83,,"-602,568.96"
,CS,AR,32006002,1005,100,,Cash sale,,,,,,08/07/2018,08/07/2018,0.00,,29.15,,"-602,598.11"
,CN,AR,31018356,1005,100,,Credit Note,,,,,,09/07/2018,09/07/2018,72.88,,0.00,,"-602,525.23"
,CR,AR,33000200,1005,100,,Cash Return,,,,,,09/07/2018,09/07/2018,7.29,,0.00,,"-602,517.94"
,CS,AR,32006043,1005,100,,Cash sale,,,,,,09/07/2018,09/07/2018,0.00,,16.83,,"-602,534.77"
,CS,AR,32006045,1005,100,,Cash sale,,,,,,09/07/2018,09/07/2018,0.00,,18.22,,"-602,552.99"
,CS,AR,32006046,1005,100,,Cash sale,,,,,,09/07/2018,09/07/2018,0.00,,11.22,,"-602,564.21"
,CS,AR,32006047,1005,100,,Cash sale,,,,,,09/07/2018,09/07/2018,0.00,,3.64,,"-602,567.85"
,CS,AR,32006048,1005,100,,Cash sale,,,,,,09/07/2018,09/07/2018,0.00,,2.16,,"-602,570.01"
,CS,AR,32006049,1005,100,,Cash sale,,,,,,09/07/2018,09/07/2018,0.00,,3.64,,"-602,573.65"
,CS,AR,32006050,1005,100,,Cash sale,,,,,,09/07/2018,09/07/2018,0.00,,7.29,,"-602,580.94"
,CS,AR,32006051,1005,100,,Cash sale,,,,,,09/07/2018,09/07/2018,0.00,,10.38,,"-602,591.32"
,CS,AR,32006052,1005,100,,Cash sale,,,,,,09/07/2018,09/07/2018,0.00,,7.29,,"-602,598.61"
,CS,AR,32006053,1005,100,,Cash sale,,,,,,09/07/2018,09/07/2018,0.00,,10.93,,"-602,609.54"
,CS,AR,32006054,1005,100,,Cash sale,,,,,,09/07/2018,09/07/2018,0.00,,11.69,,"-602,621.23"
,CS,AR,32006055,1005,100,,Cash sale,,,,,,09/07/2018,09/07/2018,0.00,,14.58,,"-602,635.81"
,CS,AR,32006056,1005,100,,Cash sale,,,,,,09/07/2018,09/07/2018,0.00,,10.93,,"-602,646.74"
,CS,AR,32006057,1005,100,,Cash sale,,,,,,09/07/2018,09/07/2018,0.00,,10.93,,"-602,657.67"
,CS,AR,32006058,1005,100,,Cash sale,,,,,,09/07/2018,09/07/2018,0.00,,10.93,,"-602,668.60"
,CS,AR,32006060,1005,100,,Cash sale,,,,,,09/07/2018,09/07/2018,0.00,,3.64,,"-602,672.24"
,CS,AR,32006061,1005,100,,Cash sale,,,,,,09/07/2018,09/07/2018,0.00,,7.29,,"-602,679.53"
,CS,AR,32006062,1005,100,,Cash sale,,,,,,09/07/2018,09/07/2018,0.00,,10.34,,"-602,689.87"
,CS,AR,32006063,1005,100,,Cash sale,,,,,,09/07/2018,09/07/2018,0.00,,3.64,,"-602,693.51"
,CS,AR,32006064,1005,100,,Cash sale,,,,,,09/07/2018,09/07/2018,0.00,,10.17,,"-602,703.68"
,CS,AR,32006065,1005,100,,Cash sale,,,,,,09/07/2018,09/07/2018,0.00,,7.29,,"-602,710.97"
,CS,AR,32006066,1005,100,,Cash sale,,,,,,09/07/2018,09/07/2018,0.00,,10.99,,"-602,721.96"
,CS,AR,32006067,1005,100,,Cash sale,,,,,,09/07/2018,09/07/2018,0.00,,7.29,,"-602,729.25"
,CS,AR,32006068,1005,100,,Cash sale,,,,,,09/07/2018,09/07/2018,0.00,,18.22,,"-602,747.47"
,CS,AR,32006069,1005,100,,Cash sale,,,,,,09/07/2018,09/07/2018,0.00,,5.08,,"-602,752.55"
,CS,AR,32006070,1005,100,,Cash sale,,,,,,09/07/2018,09/07/2018,0.00,,20.47,,"-602,773.02"
,CS,AR,32006071,1005,100,,Cash sale,,,,,,09/07/2018,09/07/2018,0.00,,3.64,,"-602,776.66"
,CS,AR,32006072,1005,100,,Cash sale,,,,,,09/07/2018,09/07/2018,0.00,,9.56,,"-602,786.22"
,CS,AR,32006073,1005,100,,Cash sale,,,,,,09/07/2018,09/07/2018,0.00,,7.29,,"-602,793.51"
,CS,AR,32006074,1005,100,,Cash sale,,,,,,09/07/2018,09/07/2018,0.00,,3.64,,"-602,797.15"
,CS,AR,32006075,1005,100,,Cash sale,,,,,,09/07/2018,09/07/2018,0.00,,2.54,,"-602,799.69"
,CS,AR,32006076,1005,100,,Cash sale,,,,,,09/07/2018,09/07/2018,0.00,,7.63,,"-602,807.32"
,CS,AR,32006077,1005,100,,Cash sale,,,,,,09/07/2018,09/07/2018,0.00,,9.66,,"-602,816.98"
,CS,AR,32006078,1005,100,,Cash sale,,,,,,09/07/2018,09/07/2018,0.00,,5.85,,"-602,822.83"
,CS,AR,32006079,1005,100,,Cash sale,,,,,,09/07/2018,09/07/2018,0.00,,10.93,,"-602,833.76"
,CS,AR,32006080,1005,100,,Cash sale,,,,,,09/07/2018,09/07/2018,0.00,,10.93,,"-602,844.69"
,CS,AR,32006082,1005,100,,Cash sale,,,,,,09/07/2018,09/07/2018,0.00,,55.53,,"-602,900.22"
,CS,AR,32006083,1005,100,,Cash sale,,,,,,09/07/2018,09/07/2018,0.00,,3.64,,"-602,903.86"
,CS,AR,32006084,1005,100,,Cash sale,,,,,,09/07/2018,09/07/2018,0.00,,5.17,,"-602,909.03"
,CS,AR,32006085,1005,100,,Cash sale,,,,,,09/07/2018,09/07/2018,0.00,,6.42,,"-602,915.45"
,CS,AR,32006086,1005,100,,Cash sale,,,,,,09/07/2018,09/07/2018,0.00,,9.13,,"-602,924.58"
,CS,AR,32006087,1005,100,,Cash sale,,,,,,09/07/2018,09/07/2018,0.00,,3.64,,"-602,928.22"
,CS,AR,32006088,1005,100,,Cash sale,,,,,,09/07/2018,09/07/2018,0.00,,10.93,,"-602,939.15"
,CS,AR,32006089,1005,100,,Cash sale,,,,,,09/07/2018,09/07/2018,0.00,,6.53,,"-602,945.68"
,CS,AR,32006090,1005,100,,Cash sale,,,,,,09/07/2018,09/07/2018,0.00,,2.58,,"-602,948.26"
,CS,AR,32006091,1005,100,,Cash sale,,,,,,09/07/2018,09/07/2018,0.00,,9.84,,"-602,958.10"
,CS,AR,32006092,1005,100,,Cash sale,,,,,,09/07/2018,09/07/2018,0.00,,6.56,,"-602,964.66"
,CS,AR,32006093,1005,100,,Cash sale,,,,,,09/07/2018,09/07/2018,0.00,,13.73,,"-602,978.39"
,CS,AR,32006094,1005,100,,Cash sale,,,,,,09/07/2018,09/07/2018,0.00,,21.86,,"-603,000.25"
,CS,AR,32006096,1005,100,,Cash sale,,,,,,09/07/2018,09/07/2018,0.00,,10.93,,"-603,011.18"
,CS,AR,32006097,1005,100,,Cash sale,,,,,,09/07/2018,09/07/2018,0.00,,7.29,,"-603,018.47"
,CS,AR,32006098,1005,100,,Cash sale,,,,,,09/07/2018,09/07/2018,0.00,,3.64,,"-603,022.11"
,CS,AR,32006099,1005,100,,Cash sale,,,,,,09/07/2018,09/07/2018,0.00,,7.29,,"-603,029.40"
,CS,AR,32006100,1005,100,,Cash sale,,,,,,09/07/2018,09/07/2018,0.00,,5.94,,"-603,035.34"
,CS,AR,32006105,1005,100,,Cash sale,,,,,,09/07/2018,09/07/2018,0.00,,11.65,,"-603,046.99"
,CS,AR,32006106,1005,100,,Cash sale,,,,,,09/07/2018,09/07/2018,0.00,,6.07,,"-603,053.06"
,CS,AR,32006107,1005,100,,Cash sale,,,,,,09/07/2018,09/07/2018,0.00,,7.29,,"-603,060.35"
,CS,AR,32006108,1005,100,,Cash sale,,,,,,09/07/2018,09/07/2018,0.00,,5.17,,"-603,065.52"
,CS,AR,32006109,1005,100,,Cash sale,,,,,,09/07/2018,09/07/2018,0.00,,14.58,,"-603,080.10"
,IN,AR,30319228,1005,100,,Invoice,,,,,,09/07/2018,09/07/2018,0.00,,47.46,,"-603,127.56"
,IN,AR,30319229,1005,100,,Invoice,,,,,,09/07/2018,09/07/2018,0.00,,25.51,,"-603,153.07"
,IN,AR,30319230,1005,100,,Invoice,,,,,,09/07/2018,09/07/2018,0.00,,8.10,,"-603,161.17"
,IN,AR,30319231,1005,100,,Invoice,,,,,,09/07/2018,09/07/2018,0.00,,4.05,,"-603,165.22"
,IN,AR,30319232,1005,100,,Invoice,,,,,,09/07/2018,09/07/2018,0.00,,6.08,,"-603,171.30"
,IN,AR,30319233,1005,100,,Invoice,,,,,,09/07/2018,09/07/2018,0.00,,2.03,,"-603,173.33"
,IN,AR,30319234,1005,100,,Invoice,,,,,,09/07/2018,09/07/2018,0.00,,8.10,,"-603,181.43"
,IN,AR,30319235,1005,100,,Invoice,,,,,,09/07/2018,09/07/2018,0.00,,22.28,,"-603,203.71"
,IN,AR,30319236,1005,100,,Invoice,,,,,,09/07/2018,09/07/2018,0.00,,2.03,,"-603,205.74"
,IN,AR,30319237,1005,100,,Invoice,,,,,,09/07/2018,09/07/2018,0.00,,14.18,,"-603,219.92"
,IN,AR,30319238,1005,100,,Invoice,,,,,,09/07/2018,09/07/2018,0.00,,9.49,,"-603,229.41"
,IN,AR,30319239,1005,100,,Invoice,,,,,,09/07/2018,09/07/2018,0.00,,80.31,,"-603,309.72"
,IN,AR,30319240,1005,100,,Invoice,,,,,,09/07/2018,09/07/2018,0.00,,7.29,,"-603,317.01"
,IN,AR,30319241,1005,100,,Invoice,,,,,,09/07/2018,09/07/2018,0.00,,5.82,,"-603,322.83"
,IN,AR,30319242,1005,100,,Invoice,,,,,,09/07/2018,09/07/2018,0.00,,68.81,,"-603,391.64"
,IN,AR,30319243,1005,100,,Invoice,,,,,,09/07/2018,09/07/2018,0.00,,24.79,,"-603,416.43"
,IN,AR,30319244,1005,100,,Invoice,,,,,,09/07/2018,09/07/2018,0.00,,32.00,,"-603,448.43"
,IN,AR,30319247,1005,100,,Invoice,,,,,,09/07/2018,09/07/2018,0.00,,63.63,,"-603,512.06"
,IN,AR,30319248,1005,100,,Invoice,,,,,,09/07/2018,09/07/2018,0.00,,182.20,,"-603,694.26"
,IN,AR,30319249,1005,100,,Invoice,,,,,,09/07/2018,09/07/2018,0.00,,40.00,,"-603,734.26"
,IN,AR,30319250,1005,100,,Invoice,,,,,,09/07/2018,09/07/2018,0.00,,44.00,,"-603,778.26"
,IN,AR,30319251,1005,100,,Invoice,,,,,,09/07/2018,09/07/2018,0.00,,2.75,,"-603,781.01"
,IN,AR,30319252,1005,100,,Invoice,,,,,,09/07/2018,09/07/2018,0.00,,40.68,,"-603,821.69"
,IN,AR,30319253,1005,100,,Invoice,,,,,,09/07/2018,09/07/2018,0.00,,5.51,,"-603,827.20"
,IN,AR,30319254,1005,100,,Invoice,,,,,,09/07/2018,09/07/2018,0.00,,7.78,,"-603,834.98"
,IN,AR,30319255,1005,100,,Invoice,,,,,,09/07/2018,09/07/2018,0.00,,36.00,,"-603,870.98"
,IN,AR,30319256,1005,100,,Invoice,,,,,,09/07/2018,09/07/2018,0.00,,3.64,,"-603,874.62"
,IN,AR,30319257,1005,100,,Invoice,,,,,,09/07/2018,09/07/2018,0.00,,546.61,,"-604,421.23"
,IN,AR,30319258,1005,100,,Invoice,,,,,,09/07/2018,09/07/2018,0.00,,42.58,,"-604,463.81"
,IN,AR,30319259,1005,100,,Invoice,,,,,,09/07/2018,09/07/2018,0.00,,36.00,,"-604,499.81"
,IN,AR,30319260,1005,100,,Invoice,,,,,,09/07/2018,09/07/2018,0.00,,24.15,,"-604,523.96"
,IN,AR,30319262,1005,100,,Invoice,,,,,,09/07/2018,09/07/2018,0.00,,22.71,,"-604,546.67"
,IN,AR,30319263,1005,100,,Invoice,,,,,,09/07/2018,09/07/2018,0.00,,12.75,,"-604,559.42"
,IN,AR,30319264,1005,100,,Invoice,,,,,,09/07/2018,09/07/2018,0.00,,23.26,,"-604,582.68"
,IN,AR,30319265,1005,100,,Invoice,,,,,,09/07/2018,09/07/2018,0.00,,10.34,,"-604,593.02"
,IN,AR,30319266,1005,100,,Invoice,,,,,,09/07/2018,09/07/2018,0.00,,7.19,,"-604,600.21"
,IN,AR,30319267,1005,100,,Invoice,,,,,,09/07/2018,09/07/2018,0.00,,11.48,,"-604,611.69"
,IN,AR,30319268,1005,100,,Invoice,,,,,,09/07/2018,09/07/2018,0.00,,20.68,,"-604,632.37"
,IN,AR,30319269,1005,100,,Invoice,,,,,,09/07/2018,09/07/2018,0.00,,92.29,,"-604,724.66"
,IN,AR,30319270,1005,100,,Invoice,,,,,,09/07/2018,09/07/2018,0.00,,20.34,,"-604,745.00"
,IN,AR,30319271,1005,100,,Invoice,,,,,,09/07/2018,09/07/2018,0.00,,177.97,,"-604,922.97"
,IN,AR,30319272,1005,100,,Invoice,,,,,,09/07/2018,09/07/2018,0.00,,25.42,,"-604,948.39"
,IN,AR,30319273,1005,100,,Invoice,,,,,,09/07/2018,09/07/2018,0.00,,23.90,,"-604,972.29"
,IN,AR,30319274,1005,100,,Invoice,,,,,,09/07/2018,09/07/2018,0.00,,38.64,,"-605,010.93"
,IN,AR,30319275,1005,100,,Invoice,,,,,,09/07/2018,09/07/2018,0.00,,18.05,,"-605,028.98"
,IN,AR,30319276,1005,100,,Invoice,,,,,,09/07/2018,09/07/2018,0.00,,6.36,,"-605,035.34"
,IN,AR,30319277,1005,100,,Invoice,,,,,,09/07/2018,09/07/2018,0.00,,6.02,,"-605,041.36"
,IN,AR,30319278,1005,100,,Invoice,,,,,,09/07/2018,09/07/2018,0.00,,10.08,,"-605,051.44"
,IN,AR,30319280,1005,100,,Invoice,,,,,,09/07/2018,09/07/2018,0.00,,10.17,,"-605,061.61"
,IN,AR,30319281,1005,100,,Invoice,,,,,,09/07/2018,09/07/2018,0.00,,24.07,,"-605,085.68"
,IN,AR,30319282,1005,100,,Invoice,,,,,,09/07/2018,09/07/2018,0.00,,30.08,,"-605,115.76"
,IN,AR,30319283,1005,100,,Invoice,,,,,,09/07/2018,09/07/2018,0.00,,14.58,,"-605,130.34"
,IN,AR,30319284,1005,100,,Invoice,,,,,,09/07/2018,09/07/2018,0.00,,30.51,,"-605,160.85"
,IN,AR,30319285,1005,100,,Invoice,,,,,,09/07/2018,09/07/2018,0.00,,27.50,,"-605,188.35"
,IN,AR,30319286,1005,100,,Invoice,,,,,,09/07/2018,09/07/2018,0.00,,12.20,,"-605,200.55"
,IN,AR,30319287,1005,100,,Invoice,,,,,,09/07/2018,09/07/2018,0.00,,18.22,,"-605,218.77"
,IN,AR,30319288,1005,100,,Invoice,,,,,,09/07/2018,09/07/2018,0.00,,14.83,,"-605,233.60"
,IN,AR,30319289,1005,100,,Invoice,,,,,,09/07/2018,09/07/2018,0.00,,8.26,,"-605,241.86"
,IN,AR,30319290,1005,100,,Invoice,,,,,,09/07/2018,09/07/2018,0.00,,12.17,,"-605,254.03"
,IN,AR,30319291,1005,100,,Invoice,,,,,,09/07/2018,09/07/2018,0.00,,9.19,,"-605,263.22"
,IN,AR,30319292,1005,100,,Invoice,,,,,,09/07/2018,09/07/2018,0.00,,11.22,,"-605,274.44"
,IN,AR,30319293,1005,100,,Invoice,,,,,,09/07/2018,09/07/2018,0.00,,13.14,,"-605,287.58"
,IN,AR,30319295,1005,100,,Invoice,,,,,,09/07/2018,09/07/2018,0.00,,48.81,,"-605,336.39"
,IN,AR,30319296,1005,100,,Invoice,,,,,,09/07/2018,09/07/2018,0.00,,7.29,,"-605,343.68"
,IN,AR,30319297,1005,100,,Invoice,,,,,,09/07/2018,09/07/2018,0.00,,52.00,,"-605,395.68"
,IN,AR,30319299,1005,100,,Invoice,,,,,,09/07/2018,09/07/2018,0.00,,29.15,,"-605,424.83"
,IN,AR,30319300,1005,100,,Invoice,,,,,,09/07/2018,09/07/2018,0.00,,7.75,,"-605,432.58"
,IN,AR,30319301,1005,100,,Invoice,,,,,,09/07/2018,09/07/2018,0.00,,36.12,,"-605,468.70"
,IN,AR,30319302,1005,100,,Invoice,,,,,,09/07/2018,09/07/2018,0.00,,8.98,,"-605,477.68"
,IN,AR,30319303,1005,100,,Invoice,,,,,,09/07/2018,09/07/2018,0.00,,182.20,,"-605,659.88"
,IN,AR,30319304,1005,100,,Invoice,,,,,,09/07/2018,09/07/2018,0.00,,54.66,,"-605,714.54"
,IN,AR,30319305,1005,100,,Invoice,,,,,,09/07/2018,09/07/2018,0.00,,7.05,,"-605,721.59"
,IN,AR,30319306,1005,100,,Invoice,,,,,,09/07/2018,09/07/2018,0.00,,7.29,,"-605,728.88"
,IN,AR,30319307,1005,100,,Invoice,,,,,,09/07/2018,09/07/2018,0.00,,2.14,,"-605,731.02"
,IN,AR,30319308,1005,100,,Invoice,,,,,,09/07/2018,09/07/2018,0.00,,4.29,,"-605,735.31"
,IN,AR,30319309,1005,100,,Invoice,,,,,,09/07/2018,09/07/2018,0.00,,36.08,,"-605,771.39"
,IN,AR,30319310,1005,100,,Invoice,,,,,,09/07/2018,09/07/2018,0.00,,30.25,,"-605,801.64"
,IN,AR,30319311,1005,100,,Invoice,,,,,,09/07/2018,09/07/2018,0.00,,23.31,,"-605,824.95"
,IN,AR,30319312,1005,100,,Invoice,,,,,,09/07/2018,09/07/2018,0.00,,6.07,,"-605,831.02"
,IN,AR,30319313,1005,100,,Invoice,,,,,,09/07/2018,09/07/2018,0.00,,10.93,,"-605,841.95"
,IN,AR,30319314,1005,100,,Invoice,,,,,,09/07/2018,09/07/2018,0.00,,31.53,,"-605,873.48"
,IN,AR,30319315,1005,100,,Invoice,,,,,,09/07/2018,09/07/2018,0.00,,4.58,,"-605,878.06"
,IN,AR,30319316,1005,100,,Invoice,,,,,,09/07/2018,09/07/2018,0.00,,16.40,,"-605,894.46"
,IN,AR,30319317,1005,100,,Invoice,,,,,,09/07/2018,09/07/2018,0.00,,29.15,,"-605,923.61"
,IN,AR,30319318,1005,100,,Invoice,,,,,,09/07/2018,09/07/2018,0.00,,10.00,,"-605,933.61"
,IN,AR,30319319,1005,100,,Invoice,,,,,,09/07/2018,09/07/2018,0.00,,20.01,,"-605,953.62"
,IN,AR,30319320,1005,100,,Invoice,,,,,,09/07/2018,09/07/2018,0.00,,18.01,,"-605,971.63"
,IN,AR,30319321,1005,100,,Invoice,,,,,,09/07/2018,09/07/2018,0.00,,54.66,,"-606,026.29"
,IN,AR,30319322,1005,100,,Invoice,,,,,,09/07/2018,09/07/2018,0.00,,25.64,,"-606,051.93"
,IN,AR,30319323,1005,100,,Invoice,,,,,,09/07/2018,09/07/2018,0.00,,10.52,,"-606,062.45"
,IN,AR,30319324,1005,100,,Invoice,,,,,,09/07/2018,09/07/2018,0.00,,46.25,,"-606,108.70"
,IN,AR,30319325,1005,100,,Invoice,,,,,,09/07/2018,09/07/2018,0.00,,36.24,,"-606,144.94"
,IN,AR,30319326,1005,100,,Invoice,,,,,,09/07/2018,09/07/2018,0.00,,156.14,,"-606,301.08"
,IN,AR,30319327,1005,100,,Invoice,,,,,,09/07/2018,09/07/2018,0.00,,14.03,,"-606,315.11"
,IN,AR,30319328,1005,100,,Invoice,,,,,,09/07/2018,09/07/2018,0.00,,218.64,,"-606,533.75"
,IN,AR,30319329,1005,100,,Invoice,,,,,,09/07/2018,09/07/2018,0.00,,9.64,,"-606,543.39"
,IN,AR,30319330,1005,100,,Invoice,,,,,,09/07/2018,09/07/2018,0.00,,22.71,,"-606,566.10"
,IN,AR,30319331,1005,100,,Invoice,,,,,,09/07/2018,09/07/2018,0.00,,29.15,,"-606,595.25"
,IN,AR,30319335,1005,100,,Invoice,,,,,,09/07/2018,09/07/2018,0.00,,18.69,,"-606,613.94"
,IN,AR,30319336,1005,100,,Invoice,,,,,,09/07/2018,09/07/2018,0.00,,28.68,,"-606,642.62"
,IN,AR,30319337,1005,100,,Invoice,,,,,,09/07/2018,09/07/2018,0.00,,14.00,,"-606,656.62"
,IN,AR,30319338,1005,100,,Invoice,,,,,,09/07/2018,09/07/2018,0.00,,3.76,,"-606,660.38"
,IN,AR,30319339,1005,100,,Invoice,,,,,,09/07/2018,09/07/2018,0.00,,14.19,,"-606,674.57"
,IN,AR,30319341,1005,100,,Invoice,,,,,,09/07/2018,09/07/2018,0.00,,16.42,,"-606,690.99"
,IN,AR,30319342,1005,100,,Invoice,,,,,,09/07/2018,09/07/2018,0.00,,2.62,,"-606,693.61"
,IN,AR,30319343,1005,100,,Invoice,,,,,,09/07/2018,09/07/2018,0.00,,4.08,,"-606,697.69"
,IN,AR,30319345,1005,100,,Invoice,,,,,,09/07/2018,09/07/2018,0.00,,52.63,,"-606,750.32"
,IN,AR,30319346,1005,100,,Invoice,,,,,,09/07/2018,09/07/2018,0.00,,9.11,,"-606,759.43"
,IN,AR,30319347,1005,100,,Invoice,,,,,,09/07/2018,09/07/2018,0.00,,4.00,,"-606,763.43"
,IN,AR,30319348,1005,100,,Invoice,,,,,,09/07/2018,09/07/2018,0.00,,8.31,,"-606,771.74"
,IN,AR,30319349,1005,100,,Invoice,,,,,,09/07/2018,09/07/2018,0.00,,4.15,,"-606,775.89"
,IN,AR,30319350,1005,100,,Invoice,,,,,,09/07/2018,09/07/2018,0.00,,3.64,,"-606,779.53"
,IN,AR,30319351,1005,100,,Invoice,,,,,,09/07/2018,09/07/2018,0.00,,14.58,,"-606,794.11"
,IN,AR,30319352,1005,100,,Invoice,,,,,,09/07/2018,09/07/2018,0.00,,3.51,,"-606,797.62"
,IN,AR,30319354,1005,100,,Invoice,,,,,,09/07/2018,09/07/2018,0.00,,29.15,,"-606,826.77"
,CN,AR,31018405,1005,100,,Credit Note,,,,,,10/07/2018,10/07/2018,7.29,,0.00,,"-606,819.48"
,CR,AR,33000204,1005,100,,Cash Return,,,,,,10/07/2018,10/07/2018,22.88,,0.00,,"-606,796.60"
,CS,AR,32006132,1005,100,,Cash sale,,,,,,10/07/2018,10/07/2018,0.00,,3.64,,"-606,800.24"
,CS,AR,32006141,1005,100,,Cash sale,,,,,,10/07/2018,10/07/2018,0.00,,3.64,,"-606,803.88"
,CS,AR,32006144,1005,100,,Cash sale,,,,,,10/07/2018,10/07/2018,0.00,,10.93,,"-606,814.81"
,CS,AR,32006156,1005,100,,Cash sale,,,,,,10/07/2018,10/07/2018,0.00,,21.86,,"-606,836.67"
,CS,AR,32006157,1005,100,,Cash sale,,,,,,10/07/2018,10/07/2018,0.00,,7.29,,"-606,843.96"
,CS,AR,32006162,1005,100,,Cash sale,,,,,,10/07/2018,10/07/2018,0.00,,48.14,,"-606,892.10"
,CS,AR,32006172,1005,100,,Cash sale,,,,,,10/07/2018,10/07/2018,0.00,,6.02,,"-606,898.12"
,CS,AR,32006176,1005,100,,Cash sale,,,,,,10/07/2018,10/07/2018,0.00,,14.58,,"-606,912.70"
,CS,AR,32006206,1005,100,,Cash sale,,,,,,10/07/2018,10/07/2018,0.00,,7.29,,"-606,919.99"
,CS,AR,32006209,1005,100,,Cash sale,,,,,,10/07/2018,10/07/2018,0.00,,18.22,,"-606,938.21"
,CS,AR,32006210,1005,100,,Cash sale,,,,,,10/07/2018,10/07/2018,0.00,,14.58,,"-606,952.79"
,CS,AR,32006214,1005,100,,Cash sale,,,,,,10/07/2018,10/07/2018,0.00,,3.64,,"-606,956.43"
,CS,AR,32006227,1005,100,,Cash sale,,,,,,10/07/2018,10/07/2018,0.00,,30.51,,"-606,986.94"
,CS,AR,32006229,1005,100,,Cash sale,,,,,,10/07/2018,10/07/2018,0.00,,14.58,,"-607,001.52"
,CS,AR,32006233,1005,100,,Cash sale,,,,,,10/07/2018,10/07/2018,0.00,,4.32,,"-607,005.84"
,CS,AR,32006243,1005,100,,Cash sale,,,,,,10/07/2018,10/07/2018,0.00,,10.34,,"-607,016.18"
,CS,AR,32006246,1005,100,,Cash sale,,,,,,10/07/2018,10/07/2018,0.00,,2.84,,"-607,019.02"
,CS,AR,32006257,1005,100,,Cash sale,,,,,,10/07/2018,10/07/2018,0.00,,2.58,,"-607,021.60"
,CS,AR,32006264,1005,100,,Cash sale,,,,,,10/07/2018,10/07/2018,0.00,,10.93,,"-607,032.53"
,CS,AR,32006271,1005,100,,Cash sale,,,,,,10/07/2018,10/07/2018,0.00,,7.29,,"-607,039.82"
,CS,AR,32006285,1005,100,,Cash sale,,,,,,10/07/2018,10/07/2018,0.00,,7.12,,"-607,046.94"
,CS,AR,32006287,1005,100,,Cash sale,,,,,,10/07/2018,10/07/2018,0.00,,21.61,,"-607,068.55"
,CS,AR,32006292,1005,100,,Cash sale,,,,,,10/07/2018,10/07/2018,0.00,,5.85,,"-607,074.40"
,CS,AR,32006294,1005,100,,Cash sale,,,,,,10/07/2018,10/07/2018,0.00,,7.75,,"-607,082.15"
,CS,AR,32006304,1005,100,,Cash sale,,,,,,10/07/2018,10/07/2018,0.00,,5.08,,"-607,087.23"
,CS,AR,32006311,1005,100,,Cash sale,,,,,,10/07/2018,10/07/2018,0.00,,3.64,,"-607,090.87"
,CS,AR,32006322,1005,100,,Cash sale,,,,,,10/07/2018,10/07/2018,0.00,,10.34,,"-607,101.21"
,CS,AR,32006324,1005,100,,Cash sale,,,,,,10/07/2018,10/07/2018,0.00,,182.20,,"-607,283.41"
,CS,AR,32006326,1005,100,,Cash sale,,,,,,10/07/2018,10/07/2018,0.00,,3.90,,"-607,287.31"
,CS,AR,32006333,1005,100,,Cash sale,,,,,,10/07/2018,10/07/2018,0.00,,10.93,,"-607,298.24"
,CS,AR,32006340,1005,100,,Cash sale,,,,,,10/07/2018,10/07/2018,0.00,,7.29,,"-607,305.53"
,CS,AR,32006344,1005,100,,Cash sale,,,,,,10/07/2018,10/07/2018,0.00,,10.93,,"-607,316.46"
,CS,AR,32006348,1005,100,,Cash sale,,,,,,10/07/2018,10/07/2018,0.00,,18.22,,"-607,334.68"
,CS,AR,32006374,1005,100,,Cash sale,,,,,,10/07/2018,10/07/2018,0.00,,23.58,,"-607,358.26"
,CS,AR,32006377,1005,100,,Cash sale,,,,,,10/07/2018,10/07/2018,0.00,,3.76,,"-607,362.02"
,CS,AR,32006386,1005,100,,Cash sale,,,,,,10/07/2018,10/07/2018,0.00,,5.18,,"-607,367.20"
,CS,AR,32006395,1005,100,,Cash sale,,,,,,10/07/2018,10/07/2018,0.00,,7.29,,"-607,374.49"
,CS,AR,32006402,1005,100,,Cash sale,,,,,,10/07/2018,10/07/2018,0.00,,20.34,,"-607,394.83"
,CS,AR,32006415,1005,100,,Cash sale,,,,,,10/07/2018,10/07/2018,0.00,,24.00,,"-607,418.83"
,CS,AR,32006433,1005,100,,Cash sale,,,,,,10/07/2018,10/07/2018,0.00,,7.29,,"-607,426.12"
,CS,AR,32006448,1005,100,,Cash sale,,,,,,10/07/2018,10/07/2018,0.00,,25.51,,"-607,451.63"
,CS,AR,32006455,1005,100,,Cash sale,,,,,,10/07/2018,10/07/2018,0.00,,5.50,,"-607,457.13"
,CS,AR,32006459,1005,100,,Cash sale,,,,,,10/07/2018,10/07/2018,0.00,,10.93,,"-607,468.06"
,CS,AR,32006462,1005,100,,Cash sale,,,,,,10/07/2018,10/07/2018,0.00,,10.34,,"-607,478.40"
,CS,AR,32006466,1005,100,,Cash sale,,,,,,10/07/2018,10/07/2018,0.00,,18.22,,"-607,496.62"
,CS,AR,32006478,1005,100,,Cash sale,,,,,,10/07/2018,10/07/2018,0.00,,7.29,,"-607,503.91"
,CS,AR,32006507,1005,100,,Cash sale,,,,,,10/07/2018,10/07/2018,0.00,,7.75,,"-607,511.66"
,CS,AR,32006512,1005,100,,Cash sale,,,,,,10/07/2018,10/07/2018,0.00,,29.15,,"-607,540.81"
,CS,AR,32006550,1005,100,,Cash sale,,,,,,10/07/2018,10/07/2018,0.00,,15.25,,"-607,556.06"
,CS,AR,32006552,1005,100,,Cash sale,,,,,,10/07/2018,10/07/2018,0.00,,54.66,,"-607,610.72"
,IN,AR,30319356,1005,100,,Invoice,,,,,,10/07/2018,10/07/2018,0.00,,9.03,,"-607,619.75"
,IN,AR,30319357,1005,100,,Invoice,,,,,,10/07/2018,10/07/2018,0.00,,26.69,,"-607,646.44"
,IN,AR,30319366,1005,100,,Invoice,,,,,,10/07/2018,10/07/2018,0.00,,182.20,,"-607,828.64"
,IN,AR,30319381,1005,100,,Invoice,,,,,,10/07/2018,10/07/2018,0.00,,364.41,,"-608,193.05"
,IN,AR,30319388,1005,100,,Invoice,,,,,,10/07/2018,10/07/2018,0.00,,71.44,,"-608,264.49"
,IN,AR,30319408,1005,100,,Invoice,,,,,,10/07/2018,10/07/2018,0.00,,"1,093.22",,"-609,357.71"
,IN,AR,30319425,1005,100,,Invoice,,,,,,10/07/2018,10/07/2018,0.00,,3.64,,"-609,361.35"
,IN,AR,30319428,1005,100,,Invoice,,,,,,10/07/2018,10/07/2018,0.00,,10.50,,"-609,371.85"
,IN,AR,30319433,1005,100,,Invoice,,,,,,10/07/2018,10/07/2018,0.00,,182.20,,"-609,554.05"
,IN,AR,30319443,1005,100,,Invoice,,,,,,10/07/2018,10/07/2018,0.00,,3.98,,"-609,558.03"
,IN,AR,30319448,1005,100,,Invoice,,,,,,10/07/2018,10/07/2018,0.00,,59.32,,"-609,617.35"
,IN,AR,30319456,1005,100,,Invoice,,,,,,10/07/2018,10/07/2018,0.00,,21.86,,"-609,639.21"
,IN,AR,30319465,1005,100,,Invoice,,,,,,10/07/2018,10/07/2018,0.00,,14.58,,"-609,653.79"
,IN,AR,30319483,1005,100,,Invoice,,,,,,10/07/2018,10/07/2018,0.00,,54.66,,"-609,708.45"
,IN,AR,30319486,1005,100,,Invoice,,,,,,10/07/2018,10/07/2018,0.00,,182.20,,"-609,890.65"
,IN,AR,30319496,1005,100,,Invoice,,,,,,10/07/2018,10/07/2018,0.00,,21.86,,"-609,912.51"
,IN,AR,30319520,1005,100,,Invoice,,,,,,10/07/2018,10/07/2018,0.00,,364.41,,"-610,276.92"
,IN,AR,30319535,1005,100,,Invoice,,,,,,10/07/2018,10/07/2018,0.00,,24.73,,"-610,301.65"
,IN,AR,30319540,1005,100,,Invoice,,,,,,10/07/2018,10/07/2018,0.00,,7.29,,"-610,308.94"
,IN,AR,30319549,1005,100,,Invoice,,,,,,10/07/2018,10/07/2018,0.00,,54.66,,"-610,363.60"
,IN,AR,30319550,1005,100,,Invoice,,,,,,10/07/2018,10/07/2018,0.00,,54.66,,"-610,418.26"
,IN,AR,30319554,1005,100,,Invoice,,,,,,10/07/2018,10/07/2018,0.00,,3.64,,"-610,421.90"
,IN,AR,30319557,1005,100,,Invoice,,,,,,10/07/2018,10/07/2018,0.00,,69.24,,"-610,491.14"
,IN,AR,30319558,1005,100,,Invoice,,,,,,10/07/2018,10/07/2018,0.00,,"1,093.22",,"-611,584.36"
,IN,AR,30319560,1005,100,,Invoice,,,,,,10/07/2018,10/07/2018,0.00,,18.22,,"-611,602.58"
,IN,AR,30319566,1005,100,,Invoice,,,,,,10/07/2018,10/07/2018,0.00,,10.93,,"-611,613.51"
,IN,AR,30319572,1005,100,,Invoice,,,,,,10/07/2018,10/07/2018,0.00,,13.73,,"-611,627.24"
,IN,AR,30319587,1005,100,,Invoice,,,,,,10/07/2018,10/07/2018,0.00,,182.20,,"-611,809.44"
,IN,AR,30319588,1005,100,,Invoice,,,,,,10/07/2018,10/07/2018,0.00,,4.32,,"-611,813.76"
,IN,AR,30319589,1005,100,,Invoice,,,,,,10/07/2018,10/07/2018,0.00,,12.71,,"-611,826.47"
,IN,AR,30319599,1005,100,,Invoice,,,,,,10/07/2018,10/07/2018,0.00,,364.41,,"-612,190.88"
,IN,AR,30319600,1005,100,,Invoice,,,,,,10/07/2018,10/07/2018,0.00,,4.24,,"-612,195.12"
,IN,AR,30319601,1005,100,,Invoice,,,,,,10/07/2018,10/07/2018,0.00,,6.36,,"-612,201.48"
,IN,AR,30319621,1005,100,,Invoice,,,,,,10/07/2018,10/07/2018,0.00,,5.85,,"-612,207.33"
,IN,AR,30319626,1005,100,,Invoice,,,,,,10/07/2018,10/07/2018,0.00,,9.03,,"-612,216.36"
,IN,AR,30319632,1005,100,,Invoice,,,,,,10/07/2018,10/07/2018,0.00,,7.80,,"-612,224.16"
,IN,AR,30319644,1005,100,,Invoice,,,,,,10/07/2018,10/07/2018,0.00,,9.43,,"-612,233.59"
,IN,AR,30319646,1005,100,,Invoice,,,,,,10/07/2018,10/07/2018,0.00,,2.39,,"-612,235.98"
,IN,AR,30319651,1005,100,,Invoice,,,,,,10/07/2018,10/07/2018,0.00,,6.44,,"-612,242.42"
,IN,AR,30319676,1005,100,,Invoice,,,,,,10/07/2018,10/07/2018,0.00,,22.88,,"-612,265.30"
,IN,AR,30319685,1005,100,,Invoice,,,,,,10/07/2018,10/07/2018,0.00,,2.54,,"-612,267.84"
,IN,AR,30319686,1005,100,,Invoice,,,,,,10/07/2018,10/07/2018,0.00,,364.41,,"-612,632.25"
,IN,AR,30319699,1005,100,,Invoice,,,,,,10/07/2018,10/07/2018,0.00,,21.86,,"-612,654.11"
,IN,AR,30319709,1005,100,,Invoice,,,,,,10/07/2018,10/07/2018,0.00,,7.29,,"-612,661.40"
,IN,AR,30319718,1005,100,,Invoice,,,,,,10/07/2018,10/07/2018,0.00,,48.05,,"-612,709.45"
,IN,AR,30319729,1005,100,,Invoice,,,,,,10/07/2018,10/07/2018,0.00,,11.57,,"-612,721.02"
,IN,AR,30319733,1005,100,,Invoice,,,,,,10/07/2018,10/07/2018,0.00,,22.88,,"-612,743.90"
,IN,AR,30319738,1005,100,,Invoice,,,,,,10/07/2018,10/07/2018,0.00,,182.20,,"-612,926.10"
,IN,AR,30319739,1005,100,,Invoice,,,,,,10/07/2018,10/07/2018,0.00,,1.95,,"-612,928.05"
,IN,AR,30319741,1005,100,,Invoice,,,,,,10/07/2018,10/07/2018,0.00,,10.53,,"-612,938.58"
,IN,AR,30319755,1005,100,,Invoice,,,,,,10/07/2018,10/07/2018,0.00,,2.12,,"-612,940.70"
,IN,AR,30319758,1005,100,,Invoice,,,,,,10/07/2018,10/07/2018,0.00,,6.43,,"-612,947.13"
,IN,AR,30319762,1005,100,,Invoice,,,,,,10/07/2018,10/07/2018,0.00,,54.66,,"-613,001.79"
,IN,AR,30319770,1005,100,,Invoice,,,,,,10/07/2018,10/07/2018,0.00,,16.95,,"-613,018.74"
,IN,AR,30319773,1005,100,,Invoice,,,,,,10/07/2018,10/07/2018,0.00,,16.95,,"-613,035.69"
,IN,AR,30319776,1005,100,,Invoice,,,,,,10/07/2018,10/07/2018,0.00,,20.76,,"-613,056.45"
,IN,AR,30319789,1005,100,,Invoice,,,,,,10/07/2018,10/07/2018,0.00,,10.93,,"-613,067.38"
,IN,AR,30319796,1005,100,,Invoice,,,,,,10/07/2018,10/07/2018,0.00,,32.80,,"-613,100.18"
,IN,AR,30319811,1005,100,,Invoice,,,,,,10/07/2018,10/07/2018,0.00,,21.05,,"-613,121.23"
,IN,AR,30319817,1005,100,,Invoice,,,,,,10/07/2018,10/07/2018,0.00,,364.41,,"-613,485.64"
,IN,AR,30319820,1005,100,,Invoice,,,,,,10/07/2018,10/07/2018,0.00,,364.41,,"-613,850.05"
,IN,AR,30319826,1005,100,,Invoice,,,,,,10/07/2018,10/07/2018,0.00,,5.59,,"-613,855.64"
,IN,AR,30319831,1005,100,,Invoice,,,,,,10/07/2018,10/07/2018,0.00,,5.86,,"-613,861.50"
,IN,AR,30319837,1005,100,,Invoice,,,,,,10/07/2018,10/07/2018,0.00,,2.84,,"-613,864.34"
,IN,AR,30319868,1005,100,,Invoice,,,,,,10/07/2018,10/07/2018,0.00,,27.87,,"-613,892.21"
,IN,AR,30319871,1005,100,,Invoice,,,,,,10/07/2018,10/07/2018,0.00,,54.66,,"-613,946.87"
,IN,AR,30319872,1005,100,,Invoice,,,,,,10/07/2018,10/07/2018,0.00,,54.66,,"-614,001.53"
,IN,AR,30319873,1005,100,,Invoice,,,,,,10/07/2018,10/07/2018,0.00,,7.05,,"-614,008.58"
,IN,AR,30319898,1005,100,,Invoice,,,,,,10/07/2018,10/07/2018,0.00,,2.58,,"-614,011.16"
,IN,AR,30319899,1005,100,,Invoice,,,,,,10/07/2018,10/07/2018,0.00,,54.66,,"-614,065.82"
,IN,AR,30319900,1005,100,,Invoice,,,,,,10/07/2018,10/07/2018,0.00,,150.42,,"-614,216.24"
,IN,AR,30319903,1005,100,,Invoice,,,,,,10/07/2018,10/07/2018,0.00,,16.42,,"-614,232.66"
,IN,AR,30319910,1005,100,,Invoice,,,,,,10/07/2018,10/07/2018,0.00,,182.20,,"-614,414.86"
,IN,AR,30319944,1005,100,,Invoice,,,,,,10/07/2018,10/07/2018,0.00,,7.95,,"-614,422.81"
,IN,AR,30319945,1005,100,,Invoice,,,,,,10/07/2018,10/07/2018,0.00,,6.36,,"-614,429.17"
,IN,AR,30319955,1005,100,,Invoice,,,,,,10/07/2018,10/07/2018,0.00,,51.10,,"-614,480.27"
,IN,AR,30319977,1005,100,,Invoice,,,,,,10/07/2018,10/07/2018,0.00,,27.32,,"-614,507.59"
,IN,AR,30319980,1005,100,,Invoice,,,,,,10/07/2018,10/07/2018,0.00,,7.29,,"-614,514.88"
,IN,AR,30319983,1005,100,,Invoice,,,,,,10/07/2018,10/07/2018,0.00,,214.27,,"-614,729.15"
,IN,AR,30319988,1005,100,,Invoice,,,,,,10/07/2018,10/07/2018,0.00,,3.64,,"-614,732.79"
,IN,AR,30319993,1005,100,,Invoice,,,,,,10/07/2018,10/07/2018,0.00,,54.66,,"-614,787.45"
,IN,AR,30319997,1005,100,,Invoice,,,,,,10/07/2018,10/07/2018,0.00,,18.22,,"-614,805.67"
,IN,AR,30320015,1005,100,,Invoice,,,,,,10/07/2018,10/07/2018,0.00,,12.71,,"-614,818.38"
,IN,AR,30320039,1005,100,,Invoice,,,,,,10/07/2018,10/07/2018,0.00,,6.03,,"-614,824.41"
,IN,AR,30320047,1005,100,,Invoice,,,,,,10/07/2018,10/07/2018,0.00,,182.20,,"-615,006.61"
,IN,AR,30320069,1005,100,,Invoice,,,,,,10/07/2018,10/07/2018,0.00,,364.41,,"-615,371.02"
,IN,AR,30320076,1005,100,,Invoice,,,,,,10/07/2018,10/07/2018,0.00,,5.47,,"-615,376.49"
,IN,AR,30320080,1005,100,,Invoice,,,,,,10/07/2018,10/07/2018,0.00,,29.15,,"-615,405.64"
,IN,AR,30320090,1005,100,,Invoice,,,,,,10/07/2018,10/07/2018,0.00,,54.66,,"-615,460.30"
,IN,AR,30320095,1005,100,,Invoice,,,,,,10/07/2018,10/07/2018,0.00,,12.20,,"-615,472.50"
,IN,AR,30320097,1005,100,,Invoice,,,,,,10/07/2018,10/07/2018,0.00,,42.71,,"-615,515.21"
,IN,AR,30320105,1005,100,,Invoice,,,,,,10/07/2018,10/07/2018,0.00,,7.29,,"-615,522.50"
,IN,AR,30320107,1005,100,,Invoice,,,,,,10/07/2018,10/07/2018,0.00,,182.20,,"-615,704.70"
,IN,AR,30320113,1005,100,,Invoice,,,,,,10/07/2018,10/07/2018,0.00,,29.15,,"-615,733.85"
,IN,AR,30320114,1005,100,,Invoice,,,,,,10/07/2018,10/07/2018,0.00,,3.64,,"-615,737.49"
,IN,AR,30320123,1005,100,,Invoice,,,,,,10/07/2018,10/07/2018,0.00,,"3,644.07",,"-619,381.56"
,IN,AR,30320137,1005,100,,Invoice,,,,,,10/07/2018,10/07/2018,0.00,,127.46,,"-619,509.02"
,IN,AR,30320142,1005,100,,Invoice,,,,,,10/07/2018,10/07/2018,0.00,,116.28,,"-619,625.30"
,IN,AR,30320143,1005,100,,Invoice,,,,,,10/07/2018,10/07/2018,0.00,,26.10,,"-619,651.40"
,IN,AR,30320144,1005,100,,Invoice,,,,,,10/07/2018,10/07/2018,0.00,,26.10,,"-619,677.50"
,IN,AR,30320153,1005,100,,Invoice,,,,,,10/07/2018,10/07/2018,0.00,,7.29,,"-619,684.79"
,IN,AR,30320159,1005,100,,Invoice,,,,,,10/07/2018,10/07/2018,0.00,,5.64,,"-619,690.43"
,IN,AR,30320163,1005,100,,Invoice,,,,,,10/07/2018,10/07/2018,0.00,,3.51,,"-619,693.94"
,IN,AR,30320166,1005,100,,Invoice,,,,,,10/07/2018,10/07/2018,0.00,,29.15,,"-619,723.09"
,IN,AR,30320167,1005,100,,Invoice,,,,,,10/07/2018,10/07/2018,0.00,,8.00,,"-619,731.09"
,IN,AR,30320170,1005,100,,Invoice,,,,,,10/07/2018,10/07/2018,0.00,,29.15,,"-619,760.24"
,IN,AR,30320173,1005,100,,Invoice,,,,,,10/07/2018,10/07/2018,0.00,,143.20,,"-619,903.44"
,IN,AR,30320179,1005,100,,Invoice,,,,,,10/07/2018,10/07/2018,0.00,,7.02,,"-619,910.46"
,IN,AR,30320186,1005,100,,Invoice,,,,,,10/07/2018,10/07/2018,0.00,,54.66,,"-619,965.12"
,IN,AR,30320187,1005,100,,Invoice,,,,,,10/07/2018,10/07/2018,0.00,,54.66,,"-620,019.78"
,IN,AR,30320233,1005,100,,Invoice,,,,,,10/07/2018,10/07/2018,0.00,,5.97,,"-620,025.75"
,IN,AR,30320242,1005,100,,Invoice,,,,,,10/07/2018,10/07/2018,0.00,,2.42,,"-620,028.17"
,IN,AR,30320249,1005,100,,Invoice,,,,,,10/07/2018,10/07/2018,0.00,,6.23,,"-620,034.40"
,IN,AR,30320250,1005,100,,Invoice,,,,,,10/07/2018,10/07/2018,0.00,,4.15,,"-620,038.55"
,IN,AR,30320251,1005,100,,Invoice,,,,,,10/07/2018,10/07/2018,0.00,,12.46,,"-620,051.01"
,IN,AR,30320252,1005,100,,Invoice,,,,,,10/07/2018,10/07/2018,0.00,,6.23,,"-620,057.24"
,IN,AR,30320277,1005,100,,Invoice,,,,,,10/07/2018,10/07/2018,0.00,,9.84,,"-620,067.08"
,IN,AR,30320294,1005,100,,Invoice,,,,,,10/07/2018,10/07/2018,0.00,,29.15,,"-620,096.23"
,IN,AR,30320295,1005,100,,Invoice,,,,,,10/07/2018,10/07/2018,0.00,,13.56,,"-620,109.79"
,IN,AR,30320300,1005,100,,Invoice,,,,,,10/07/2018,10/07/2018,0.00,,10.93,,"-620,120.72"
,IN,AR,30320317,1005,100,,Invoice,,,,,,10/07/2018,10/07/2018,0.00,,364.41,,"-620,485.13"
,CN,AR,31018408,1005,100,,Credit Note,,,,,,11/07/2018,11/07/2018,29.15,,0.00,,"-620,455.98"
,CS,AR,32006117,1005,100,,Cash sale,,,,,,11/07/2018,11/07/2018,0.00,,8.42,,"-620,464.40"
,CS,AR,32006121,1005,100,,Cash sale,,,,,,11/07/2018,11/07/2018,0.00,,7.29,,"-620,471.69"
,CS,AR,32006124,1005,100,,Cash sale,,,,,,11/07/2018,11/07/2018,0.00,,7.29,,"-620,478.98"
,CS,AR,32006126,1005,100,,Cash sale,,,,,,11/07/2018,11/07/2018,0.00,,40.14,,"-620,519.12"
,CS,AR,32006145,1005,100,,Cash sale,,,,,,11/07/2018,11/07/2018,0.00,,14.58,,"-620,533.70"
,CS,AR,32006146,1005,100,,Cash sale,,,,,,11/07/2018,11/07/2018,0.00,,3.64,,"-620,537.34"
,CS,AR,32006148,1005,100,,Cash sale,,,,,,11/07/2018,11/07/2018,0.00,,7.29,,"-620,544.63"
,CS,AR,32006165,1005,100,,Cash sale,,,,,,11/07/2018,11/07/2018,0.00,,7.29,,"-620,551.92"
,CS,AR,32006166,1005,100,,Cash sale,,,,,,11/07/2018,11/07/2018,0.00,,3.64,,"-620,555.56"
,CS,AR,32006180,1005,100,,Cash sale,,,,,,11/07/2018,11/07/2018,0.00,,10.93,,"-620,566.49"
,CS,AR,32006194,1005,100,,Cash sale,,,,,,11/07/2018,11/07/2018,0.00,,12.03,,"-620,578.52"
,CS,AR,32006197,1005,100,,Cash sale,,,,,,11/07/2018,11/07/2018,0.00,,3.64,,"-620,582.16"
,CS,AR,32006217,1005,100,,Cash sale,,,,,,11/07/2018,11/07/2018,0.00,,3.64,,"-620,585.80"
,CS,AR,32006218,1005,100,,Cash sale,,,,,,11/07/2018,11/07/2018,0.00,,5.86,,"-620,591.66"
,CS,AR,32006225,1005,100,,Cash sale,,,,,,11/07/2018,11/07/2018,0.00,,10.34,,"-620,602.00"
,CS,AR,32006242,1005,100,,Cash sale,,,,,,11/07/2018,11/07/2018,0.00,,22.37,,"-620,624.37"
,CS,AR,32006248,1005,100,,Cash sale,,,,,,11/07/2018,11/07/2018,0.00,,10.34,,"-620,634.71"
,CS,AR,32006253,1005,100,,Cash sale,,,,,,11/07/2018,11/07/2018,0.00,,3.64,,"-620,638.35"
,CS,AR,32006259,1005,100,,Cash sale,,,,,,11/07/2018,11/07/2018,0.00,,21.06,,"-620,659.41"
,CS,AR,32006267,1005,100,,Cash sale,,,,,,11/07/2018,11/07/2018,0.00,,10.93,,"-620,670.34"
,CS,AR,32006298,1005,100,,Cash sale,,,,,,11/07/2018,11/07/2018,0.00,,3.64,,"-620,673.98"
,CS,AR,32006303,1005,100,,Cash sale,,,,,,11/07/2018,11/07/2018,0.00,,21.86,,"-620,695.84"
,CS,AR,32006328,1005,100,,Cash sale,,,,,,11/07/2018,11/07/2018,0.00,,25.51,,"-620,721.35"
,CS,AR,32006335,1005,100,,Cash sale,,,,,,11/07/2018,11/07/2018,0.00,,7.29,,"-620,728.64"
,CS,AR,32006342,1005,100,,Cash sale,,,,,,11/07/2018,11/07/2018,0.00,,14.58,,"-620,743.22"
,CS,AR,32006352,1005,100,,Cash sale,,,,,,11/07/2018,11/07/2018,0.00,,7.29,,"-620,750.51"
,CS,AR,32006355,1005,100,,Cash sale,,,,,,11/07/2018,11/07/2018,0.00,,7.29,,"-620,757.80"
,CS,AR,32006375,1005,100,,Cash sale,,,,,,11/07/2018,11/07/2018,0.00,,10.69,,"-620,768.49"
,CS,AR,32006388,1005,100,,Cash sale,,,,,,11/07/2018,11/07/2018,0.00,,16.61,,"-620,785.10"
,CS,AR,32006390,1005,100,,Cash sale,,,,,,11/07/2018,11/07/2018,0.00,,8.90,,"-620,794.00"
,CS,AR,32006409,1005,100,,Cash sale,,,,,,11/07/2018,11/07/2018,0.00,,7.29,,"-620,801.29"
,CS,AR,32006411,1005,100,,Cash sale,,,,,,11/07/2018,11/07/2018,0.00,,10.93,,"-620,812.22"
,CS,AR,32006413,1005,100,,Cash sale,,,,,,11/07/2018,11/07/2018,0.00,,6.86,,"-620,819.08"
,CS,AR,32006418,1005,100,,Cash sale,,,,,,11/07/2018,11/07/2018,0.00,,62.00,,"-620,881.08"
,CS,AR,32006424,1005,100,,Cash sale,,,,,,11/07/2018,11/07/2018,0.00,,8.26,,"-620,889.34"
,CS,AR,32006425,1005,100,,Cash sale,,,,,,11/07/2018,11/07/2018,0.00,,7.29,,"-620,896.63"
,CS,AR,32006437,1005,100,,Cash sale,,,,,,11/07/2018,11/07/2018,0.00,,7.29,,"-620,903.92"
,CS,AR,32006438,1005,100,,Cash sale,,,,,,11/07/2018,11/07/2018,0.00,,9.15,,"-620,913.07"
,CS,AR,32006450,1005,100,,Cash sale,,,,,,11/07/2018,11/07/2018,0.00,,10.93,,"-620,924.00"
,CS,AR,32006471,1005,100,,Cash sale,,,,,,11/07/2018,11/07/2018,0.00,,7.29,,"-620,931.29"
,CS,AR,32006479,1005,100,,Cash sale,,,,,,11/07/2018,11/07/2018,0.00,,3.28,,"-620,934.57"
,CS,AR,32006480,1005,100,,Cash sale,,,,,,11/07/2018,11/07/2018,0.00,,3.28,,"-620,937.85"
,CS,AR,32006484,1005,100,,Cash sale,,,,,,11/07/2018,11/07/2018,0.00,,7.29,,"-620,945.14"
,CS,AR,32006486,1005,100,,Cash sale,,,,,,11/07/2018,11/07/2018,0.00,,14.58,,"-620,959.72"
,CS,AR,32006487,1005,100,,Cash sale,,,,,,11/07/2018,11/07/2018,0.00,,7.29,,"-620,967.01"
,CS,AR,32006493,1005,100,,Cash sale,,,,,,11/07/2018,11/07/2018,0.00,,9.84,,"-620,976.85"
,CS,AR,32006504,1005,100,,Cash sale,,,,,,11/07/2018,11/07/2018,0.00,,7.29,,"-620,984.14"
,CS,AR,32006543,1005,100,,Cash sale,,,,,,11/07/2018,11/07/2018,0.00,,3.64,,"-620,987.78"
,CS,AR,32006547,1005,100,,Cash sale,,,,,,11/07/2018,11/07/2018,0.00,,7.29,,"-620,995.07"
,CS,AR,32006548,1005,100,,Cash sale,,,,,,11/07/2018,11/07/2018,0.00,,7.29,,"-621,002.36"
,CS,AR,32006554,1005,100,,Cash sale,,,,,,11/07/2018,11/07/2018,0.00,,7.29,,"-621,009.65"
,IN,AR,30319359,1005,100,,Invoice,,,,,,11/07/2018,11/07/2018,0.00,,35.59,,"-621,045.24"
,IN,AR,30319372,1005,100,,Invoice,,,,,,11/07/2018,11/07/2018,0.00,,329.71,,"-621,374.95"
,IN,AR,30319374,1005,100,,Invoice,,,,,,11/07/2018,11/07/2018,0.00,,364.41,,"-621,739.36"
,IN,AR,30319382,1005,100,,Invoice,,,,,,11/07/2018,11/07/2018,0.00,,31.73,,"-621,771.09"
,IN,AR,30319383,1005,100,,Invoice,,,,,,11/07/2018,11/07/2018,0.00,,56.14,,"-621,827.23"
,IN,AR,30319401,1005,100,,Invoice,,,,,,11/07/2018,11/07/2018,0.00,,21.69,,"-621,848.92"
,IN,AR,30319406,1005,100,,Invoice,,,,,,11/07/2018,11/07/2018,0.00,,27.88,,"-621,876.80"
,IN,AR,30319413,1005,100,,Invoice,,,,,,11/07/2018,11/07/2018,0.00,,26.27,,"-621,903.07"
,IN,AR,30319414,1005,100,,Invoice,,,,,,11/07/2018,11/07/2018,0.00,,94.58,,"-621,997.65"
,IN,AR,30319419,1005,100,,Invoice,,,,,,11/07/2018,11/07/2018,0.00,,25.51,,"-622,023.16"
,IN,AR,30319420,1005,100,,Invoice,,,,,,11/07/2018,11/07/2018,0.00,,14.49,,"-622,037.65"
,IN,AR,30319449,1005,100,,Invoice,,,,,,11/07/2018,11/07/2018,0.00,,87.80,,"-622,125.45"
,IN,AR,30319471,1005,100,,Invoice,,,,,,11/07/2018,11/07/2018,0.00,,7.29,,"-622,132.74"
,IN,AR,30319477,1005,100,,Invoice,,,,,,11/07/2018,11/07/2018,0.00,,30.00,,"-622,162.74"
,IN,AR,30319484,1005,100,,Invoice,,,,,,11/07/2018,11/07/2018,0.00,,21.86,,"-622,184.60"
,IN,AR,30319499,1005,100,,Invoice,,,,,,11/07/2018,11/07/2018,0.00,,62.00,,"-622,246.60"
,IN,AR,30319502,1005,100,,Invoice,,,,,,11/07/2018,11/07/2018,0.00,,7.29,,"-622,253.89"
,IN,AR,30319509,1005,100,,Invoice,,,,,,11/07/2018,11/07/2018,0.00,,10.93,,"-622,264.82"
,IN,AR,30319522,1005,100,,Invoice,,,,,,11/07/2018,11/07/2018,0.00,,346.56,,"-622,611.38"
,IN,AR,30319527,1005,100,,Invoice,,,,,,11/07/2018,11/07/2018,0.00,,15.53,,"-622,626.91"
,IN,AR,30319551,1005,100,,Invoice,,,,,,11/07/2018,11/07/2018,0.00,,31.83,,"-622,658.74"
,IN,AR,30319585,1005,100,,Invoice,,,,,,11/07/2018,11/07/2018,0.00,,27.97,,"-622,686.71"
,IN,AR,30319592,1005,100,,Invoice,,,,,,11/07/2018,11/07/2018,0.00,,2.12,,"-622,688.83"
,IN,AR,30319597,1005,100,,Invoice,,,,,,11/07/2018,11/07/2018,0.00,,4.24,,"-622,693.07"
,IN,AR,30319603,1005,100,,Invoice,,,,,,11/07/2018,11/07/2018,0.00,,2.80,,"-622,695.87"
,IN,AR,30319619,1005,100,,Invoice,,,,,,11/07/2018,11/07/2018,0.00,,26.29,,"-622,722.16"
,IN,AR,30319629,1005,100,,Invoice,,,,,,11/07/2018,11/07/2018,0.00,,11.95,,"-622,734.11"
,IN,AR,30319636,1005,100,,Invoice,,,,,,11/07/2018,11/07/2018,0.00,,45.12,,"-622,779.23"
,IN,AR,30319667,1005,100,,Invoice,,,,,,11/07/2018,11/07/2018,0.00,,112.03,,"-622,891.26"
,IN,AR,30319695,1005,100,,Invoice,,,,,,11/07/2018,11/07/2018,0.00,,15.25,,"-622,906.51"
,IN,AR,30319697,1005,100,,Invoice,,,,,,11/07/2018,11/07/2018,0.00,,364.41,,"-623,270.92"
,IN,AR,30319714,1005,100,,Invoice,,,,,,11/07/2018,11/07/2018,0.00,,10.34,,"-623,281.26"
,IN,AR,30319716,1005,100,,Invoice,,,,,,11/07/2018,11/07/2018,0.00,,15.90,,"-623,297.16"
,IN,AR,30319743,1005,100,,Invoice,,,,,,11/07/2018,11/07/2018,0.00,,22.03,,"-623,319.19"
,IN,AR,30319768,1005,100,,Invoice,,,,,,11/07/2018,11/07/2018,0.00,,11.22,,"-623,330.41"
,IN,AR,30319777,1005,100,,Invoice,,,,,,11/07/2018,11/07/2018,0.00,,38.56,,"-623,368.97"
,IN,AR,30319786,1005,100,,Invoice,,,,,,11/07/2018,11/07/2018,0.00,,5.59,,"-623,374.56"
,IN,AR,30319800,1005,100,,Invoice,,,,,,11/07/2018,11/07/2018,0.00,,36.36,,"-623,410.92"
,IN,AR,30319804,1005,100,,Invoice,,,,,,11/07/2018,11/07/2018,0.00,,12.71,,"-623,423.63"
,IN,AR,30319814,1005,100,,Invoice,,,,,,11/07/2018,11/07/2018,0.00,,5.42,,"-623,429.05"
,IN,AR,30319839,1005,100,,Invoice,,,,,,11/07/2018,11/07/2018,0.00,,35.26,,"-623,464.31"
,IN,AR,30319845,1005,100,,Invoice,,,,,,11/07/2018,11/07/2018,0.00,,36.10,,"-623,500.41"
,IN,AR,30319874,1005,100,,Invoice,,,,,,11/07/2018,11/07/2018,0.00,,1.76,,"-623,502.17"
,IN,AR,30319875,1005,100,,Invoice,,,,,,11/07/2018,11/07/2018,0.00,,12.33,,"-623,514.50"
,IN,AR,30319876,1005,100,,Invoice,,,,,,11/07/2018,11/07/2018,0.00,,1.76,,"-623,516.26"
,IN,AR,30319884,1005,100,,Invoice,,,,,,11/07/2018,11/07/2018,0.00,,27.08,,"-623,543.34"
,IN,AR,30319907,1005,100,,Invoice,,,,,,11/07/2018,11/07/2018,0.00,,5.17,,"-623,548.51"
,IN,AR,30319916,1005,100,,Invoice,,,,,,11/07/2018,11/07/2018,0.00,,20.01,,"-623,568.52"
,IN,AR,30319918,1005,100,,Invoice,,,,,,11/07/2018,11/07/2018,0.00,,58.31,,"-623,626.83"
,IN,AR,30319919,1005,100,,Invoice,,,,,,11/07/2018,11/07/2018,0.00,,36.44,,"-623,663.27"
,IN,AR,30319932,1005,100,,Invoice,,,,,,11/07/2018,11/07/2018,0.00,,5.08,,"-623,668.35"
,IN,AR,30319958,1005,100,,Invoice,,,,,,11/07/2018,11/07/2018,0.00,,38.00,,"-623,706.35"
,IN,AR,30319965,1005,100,,Invoice,,,,,,11/07/2018,11/07/2018,0.00,,78.17,,"-623,784.52"
,IN,AR,30319968,1005,100,,Invoice,,,,,,11/07/2018,11/07/2018,0.00,,11.36,,"-623,795.88"
,IN,AR,30319973,1005,100,,Invoice,,,,,,11/07/2018,11/07/2018,0.00,,14.58,,"-623,810.46"
,IN,AR,30320001,1005,100,,Invoice,,,,,,11/07/2018,11/07/2018,0.00,,12.73,,"-623,823.19"
,IN,AR,30320003,1005,100,,Invoice,,,,,,11/07/2018,11/07/2018,0.00,,56.92,,"-623,880.11"
,IN,AR,30320016,1005,100,,Invoice,,,,,,11/07/2018,11/07/2018,0.00,,12.71,,"-623,892.82"
,IN,AR,30320029,1005,100,,Invoice,,,,,,11/07/2018,11/07/2018,0.00,,16.01,,"-623,908.83"
,IN,AR,30320044,1005,100,,Invoice,,,,,,11/07/2018,11/07/2018,0.00,,2.92,,"-623,911.75"
,IN,AR,30320049,1005,100,,Invoice,,,,,,11/07/2018,11/07/2018,0.00,,12.62,,"-623,924.37"
,IN,AR,30320060,1005,100,,Invoice,,,,,,11/07/2018,11/07/2018,0.00,,9.03,,"-623,933.40"
,IN,AR,30320062,1005,100,,Invoice,,,,,,11/07/2018,11/07/2018,0.00,,13.94,,"-623,947.34"
,IN,AR,30320065,1005,100,,Invoice,,,,,,11/07/2018,11/07/2018,0.00,,2.33,,"-623,949.67"
,IN,AR,30320087,1005,100,,Invoice,,,,,,11/07/2018,11/07/2018,0.00,,5.59,,"-623,955.26"
,IN,AR,30320092,1005,100,,Invoice,,,,,,11/07/2018,11/07/2018,0.00,,134.00,,"-624,089.26"
,IN,AR,30320111,1005,100,,Invoice,,,,,,11/07/2018,11/07/2018,0.00,,7.63,,"-624,096.89"
,IN,AR,30320124,1005,100,,Invoice,,,,,,11/07/2018,11/07/2018,0.00,,3.19,,"-624,100.08"
,IN,AR,30320161,1005,100,,Invoice,,,,,,11/07/2018,11/07/2018,0.00,,5.26,,"-624,105.34"
,IN,AR,30320195,1005,100,,Invoice,,,,,,11/07/2018,11/07/2018,0.00,,9.41,,"-624,114.75"
,IN,AR,30320201,1005,100,,Invoice,,,,,,11/07/2018,11/07/2018,0.00,,145.76,,"-624,260.51"
,IN,AR,30320206,1005,100,,Invoice,,,,,,11/07/2018,11/07/2018,0.00,,22.37,,"-624,282.88"
,IN,AR,30320208,1005,100,,Invoice,,,,,,11/07/2018,11/07/2018,0.00,,81.69,,"-624,364.57"
,IN,AR,30320223,1005,100,,Invoice,,,,,,11/07/2018,11/07/2018,0.00,,8.25,,"-624,372.82"
,IN,AR,30320239,1005,100,,Invoice,,,,,,11/07/2018,11/07/2018,0.00,,13.73,,"-624,386.55"
,IN,AR,30320253,1005,100,,Invoice,,,,,,11/07/2018,11/07/2018,0.00,,60.21,,"-624,446.76"
,IN,AR,30320254,1005,100,,Invoice,,,,,,11/07/2018,11/07/2018,0.00,,4.15,,"-624,450.91"
,IN,AR,30320255,1005,100,,Invoice,,,,,,11/07/2018,11/07/2018,0.00,,12.46,,"-624,463.37"
,IN,AR,30320256,1005,100,,Invoice,,,,,,11/07/2018,11/07/2018,0.00,,6.23,,"-624,469.60"
,IN,AR,30320275,1005,100,,Invoice,,,,,,11/07/2018,11/07/2018,0.00,,2.54,,"-624,472.14"
,IN,AR,30320286,1005,100,,Invoice,,,,,,11/07/2018,11/07/2018,0.00,,24.15,,"-624,496.29"
,IN,AR,30320301,1005,100,,Invoice,,,,,,11/07/2018,11/07/2018,0.00,,2.39,,"-624,498.68"
,IN,AR,30320302,1005,100,,Invoice,,,,,,11/07/2018,11/07/2018,0.00,,29.15,,"-624,527.83"
,IN,AR,30320303,1005,100,,Invoice,,,,,,11/07/2018,11/07/2018,0.00,,364.41,,"-624,892.24"
,IN,AR,30320313,1005,100,,Invoice,,,,,,11/07/2018,11/07/2018,0.00,,29.15,,"-624,921.39"
,IN,AR,30320318,1005,100,,Invoice,,,,,,11/07/2018,11/07/2018,0.00,,32.95,,"-624,954.34"
,IN,AR,30320319,1005,100,,Invoice,,,,,,11/07/2018,11/07/2018,0.00,,8.24,,"-624,962.58"
,IN,AR,30320320,1005,100,,Invoice,,,,,,11/07/2018,11/07/2018,0.00,,8.24,,"-624,970.82"
,IN,AR,30320321,1005,100,,Invoice,,,,,,11/07/2018,11/07/2018,0.00,,8.24,,"-624,979.06"
,IN,AR,30320328,1005,100,,Invoice,,,,,,11/07/2018,11/07/2018,0.00,,364.41,,"-625,343.47"
,CN,AR,31018363,1005,100,,Credit Note,,,,,,12/07/2018,12/07/2018,71.19,,0.00,,"-625,272.28"
,CN,AR,31018379,1005,100,,Credit Note,,,,,,12/07/2018,12/07/2018,0.61,,0.00,,"-625,271.67"
,CS,AR,32006112,1005,100,,Cash sale,,,,,,12/07/2018,12/07/2018,0.00,,12.03,,"-625,283.70"
,CS,AR,32006128,1005,100,,Cash sale,,,,,,12/07/2018,12/07/2018,0.00,,3.64,,"-625,287.34"
,CS,AR,32006143,1005,100,,Cash sale,,,,,,12/07/2018,12/07/2018,0.00,,7.29,,"-625,294.63"
,CS,AR,32006150,1005,100,,Cash sale,,,,,,12/07/2018,12/07/2018,0.00,,7.29,,"-625,301.92"
,CS,AR,32006160,1005,100,,Cash sale,,,,,,12/07/2018,12/07/2018,0.00,,3.64,,"-625,305.56"
,CS,AR,32006163,1005,100,,Cash sale,,,,,,12/07/2018,12/07/2018,0.00,,14.58,,"-625,320.14"
,CS,AR,32006169,1005,100,,Cash sale,,,,,,12/07/2018,12/07/2018,0.00,,7.29,,"-625,327.43"
,CS,AR,32006174,1005,100,,Cash sale,,,,,,12/07/2018,12/07/2018,0.00,,7.29,,"-625,334.72"
,CS,AR,32006186,1005,100,,Cash sale,,,,,,12/07/2018,12/07/2018,0.00,,10.93,,"-625,345.65"
,CS,AR,32006187,1005,100,,Cash sale,,,,,,12/07/2018,12/07/2018,0.00,,3.64,,"-625,349.29"
,CS,AR,32006216,1005,100,,Cash sale,,,,,,12/07/2018,12/07/2018,0.00,,3.01,,"-625,352.30"
,CS,AR,32006220,1005,100,,Cash sale,,,,,,12/07/2018,12/07/2018,0.00,,7.29,,"-625,359.59"
,CS,AR,32006256,1005,100,,Cash sale,,,,,,12/07/2018,12/07/2018,0.00,,14.58,,"-625,374.17"
,CS,AR,32006274,1005,100,,Cash sale,,,,,,12/07/2018,12/07/2018,0.00,,2.54,,"-625,376.71"
,CS,AR,32006275,1005,100,,Cash sale,,,,,,12/07/2018,12/07/2018,0.00,,12.71,,"-625,389.42"
,CS,AR,32006314,1005,100,,Cash sale,,,,,,12/07/2018,12/07/2018,0.00,,3.64,,"-625,393.06"
,CS,AR,32006318,1005,100,,Cash sale,,,,,,12/07/2018,12/07/2018,0.00,,3.64,,"-625,396.70"
,CS,AR,32006327,1005,100,,Cash sale,,,,,,12/07/2018,12/07/2018,0.00,,7.63,,"-625,404.33"
,CS,AR,32006330,1005,100,,Cash sale,,,,,,12/07/2018,12/07/2018,0.00,,64.32,,"-625,468.65"
,CS,AR,32006343,1005,100,,Cash sale,,,,,,12/07/2018,12/07/2018,0.00,,6.02,,"-625,474.67"
,CS,AR,32006380,1005,100,,Cash sale,,,,,,12/07/2018,12/07/2018,0.00,,16.78,,"-625,491.45"
,CS,AR,32006384,1005,100,,Cash sale,,,,,,12/07/2018,12/07/2018,0.00,,7.29,,"-625,498.74"
,CS,AR,32006398,1005,100,,Cash sale,,,,,,12/07/2018,12/07/2018,0.00,,7.29,,"-625,506.03"
,CS,AR,32006405,1005,100,,Cash sale,,,,,,12/07/2018,12/07/2018,0.00,,2.58,,"-625,508.61"
,CS,AR,32006427,1005,100,,Cash sale,,,,,,12/07/2018,12/07/2018,0.00,,11.86,,"-625,520.47"
,CS,AR,32006429,1005,100,,Cash sale,,,,,,12/07/2018,12/07/2018,0.00,,10.93,,"-625,531.40"
,CS,AR,32006442,1005,100,,Cash sale,,,,,,12/07/2018,12/07/2018,0.00,,8.90,,"-625,540.30"
,CS,AR,32006444,1005,100,,Cash sale,,,,,,12/07/2018,12/07/2018,0.00,,9.10,,"-625,549.40"
,CS,AR,32006446,1005,100,,Cash sale,,,,,,12/07/2018,12/07/2018,0.00,,10.93,,"-625,560.33"
,CS,AR,32006468,1005,100,,Cash sale,,,,,,12/07/2018,12/07/2018,0.00,,5.47,,"-625,565.80"
,CS,AR,32006497,1005,100,,Cash sale,,,,,,12/07/2018,12/07/2018,0.00,,7.29,,"-625,573.09"
,CS,AR,32006501,1005,100,,Cash sale,,,,,,12/07/2018,12/07/2018,0.00,,5.86,,"-625,578.95"
,CS,AR,32006508,1005,100,,Cash sale,,,,,,12/07/2018,12/07/2018,0.00,,10.93,,"-625,589.88"
,CS,AR,32006523,1005,100,,Cash sale,,,,,,12/07/2018,12/07/2018,0.00,,3.64,,"-625,593.52"
,CS,AR,32006541,1005,100,,Cash sale,,,,,,12/07/2018,12/07/2018,0.00,,10.93,,"-625,604.45"
,CS,AR,32006544,1005,100,,Cash sale,,,,,,12/07/2018,12/07/2018,0.00,,7.29,,"-625,611.74"
,IN,AR,30319364,1005,100,,Invoice,,,,,,12/07/2018,12/07/2018,0.00,,9.03,,"-625,620.77"
,IN,AR,30319367,1005,100,,Invoice,,,,,,12/07/2018,12/07/2018,0.00,,3.64,,"-625,624.41"
,IN,AR,30319379,1005,100,,Invoice,,,,,,12/07/2018,12/07/2018,0.00,,29.15,,"-625,653.56"
,IN,AR,30319386,1005,100,,Invoice,,,,,,12/07/2018,12/07/2018,0.00,,364.41,,"-626,017.97"
,IN,AR,30319402,1005,100,,Invoice,,,,,,12/07/2018,12/07/2018,0.00,,182.20,,"-626,200.17"
,IN,AR,30319423,1005,100,,Invoice,,,,,,12/07/2018,12/07/2018,0.00,,18.22,,"-626,218.39"
,IN,AR,30319434,1005,100,,Invoice,,,,,,12/07/2018,12/07/2018,0.00,,8.39,,"-626,226.78"
,IN,AR,30319437,1005,100,,Invoice,,,,,,12/07/2018,12/07/2018,0.00,,40.08,,"-626,266.86"
,IN,AR,30319444,1005,100,,Invoice,,,,,,12/07/2018,12/07/2018,0.00,,3.98,,"-626,270.84"
,IN,AR,30319450,1005,100,,Invoice,,,,,,12/07/2018,12/07/2018,0.00,,56.95,,"-626,327.79"
,IN,AR,30319461,1005,100,,Invoice,,,,,,12/07/2018,12/07/2018,0.00,,80.00,,"-626,407.79"
,IN,AR,30319464,1005,100,,Invoice,,,,,,12/07/2018,12/07/2018,0.00,,2.97,,"-626,410.76"
,IN,AR,30319472,1005,100,,Invoice,,,,,,12/07/2018,12/07/2018,0.00,,7.29,,"-626,418.05"
,IN,AR,30319473,1005,100,,Invoice,,,,,,12/07/2018,12/07/2018,0.00,,182.20,,"-626,600.25"
,IN,AR,30319485,1005,100,,Invoice,,,,,,12/07/2018,12/07/2018,0.00,,7.29,,"-626,607.54"
,IN,AR,30319492,1005,100,,Invoice,,,,,,12/07/2018,12/07/2018,0.00,,182.20,,"-626,789.74"
,IN,AR,30319493,1005,100,,Invoice,,,,,,12/07/2018,12/07/2018,0.00,,54.66,,"-626,844.40"
,IN,AR,30319501,1005,100,,Invoice,,,,,,12/07/2018,12/07/2018,0.00,,546.61,,"-627,391.01"
,IN,AR,30319503,1005,100,,Invoice,,,,,,12/07/2018,12/07/2018,0.00,,71.19,,"-627,462.20"
,IN,AR,30319510,1005,100,,Invoice,,,,,,12/07/2018,12/07/2018,0.00,,46.68,,"-627,508.88"
,IN,AR,30319524,1005,100,,Invoice,,,,,,12/07/2018,12/07/2018,0.00,,959.93,,"-628,468.81"
,IN,AR,30319552,1005,100,,Invoice,,,,,,12/07/2018,12/07/2018,0.00,,364.41,,"-628,833.22"
,IN,AR,30319564,1005,100,,Invoice,,,,,,12/07/2018,12/07/2018,0.00,,18.22,,"-628,851.44"
,IN,AR,30319567,1005,100,,Invoice,,,,,,12/07/2018,12/07/2018,0.00,,24.50,,"-628,875.94"
,IN,AR,30319569,1005,100,,Invoice,,,,,,12/07/2018,12/07/2018,0.00,,14.58,,"-628,890.52"
,IN,AR,30319579,1005,100,,Invoice,,,,,,12/07/2018,12/07/2018,0.00,,182.20,,"-629,072.72"
,IN,AR,30319594,1005,100,,Invoice,,,,,,12/07/2018,12/07/2018,0.00,,54.66,,"-629,127.38"
,IN,AR,30319602,1005,100,,Invoice,,,,,,12/07/2018,12/07/2018,0.00,,54.66,,"-629,182.04"
,IN,AR,30319611,1005,100,,Invoice,,,,,,12/07/2018,12/07/2018,0.00,,7.29,,"-629,189.33"
,IN,AR,30319613,1005,100,,Invoice,,,,,,12/07/2018,12/07/2018,0.00,,171.56,,"-629,360.89"
,IN,AR,30319617,1005,100,,Invoice,,,,,,12/07/2018,12/07/2018,0.00,,7.29,,"-629,368.18"
,IN,AR,30319634,1005,100,,Invoice,,,,,,12/07/2018,12/07/2018,0.00,,22.03,,"-629,390.21"
,IN,AR,30319647,1005,100,,Invoice,,,,,,12/07/2018,12/07/2018,0.00,,19.12,,"-629,409.33"
,IN,AR,30319653,1005,100,,Invoice,,,,,,12/07/2018,12/07/2018,0.00,,16.10,,"-629,425.43"
,IN,AR,30319659,1005,100,,Invoice,,,,,,12/07/2018,12/07/2018,0.00,,12.71,,"-629,438.14"
,IN,AR,30319669,1005,100,,Invoice,,,,,,12/07/2018,12/07/2018,0.00,,21.86,,"-629,460.00"
,IN,AR,30319670,1005,100,,Invoice,,,,,,12/07/2018,12/07/2018,0.00,,10.93,,"-629,470.93"
,IN,AR,30319671,1005,100,,Invoice,,,,,,12/07/2018,12/07/2018,0.00,,10.59,,"-629,481.52"
,IN,AR,30319674,1005,100,,Invoice,,,,,,12/07/2018,12/07/2018,0.00,,71.19,,"-629,552.71"
,IN,AR,30319677,1005,100,,Invoice,,,,,,12/07/2018,12/07/2018,0.00,,15.25,,"-629,567.96"
,IN,AR,30319678,1005,100,,Invoice,,,,,,12/07/2018,12/07/2018,0.00,,5.08,,"-629,573.04"
,IN,AR,30319689,1005,100,,Invoice,,,,,,12/07/2018,12/07/2018,0.00,,18.39,,"-629,591.43"
,IN,AR,30319691,1005,100,,Invoice,,,,,,12/07/2018,12/07/2018,0.00,,5.17,,"-629,596.60"
,IN,AR,30319698,1005,100,,Invoice,,,,,,12/07/2018,12/07/2018,0.00,,4.32,,"-629,600.92"
,IN,AR,30319720,1005,100,,Invoice,,,,,,12/07/2018,12/07/2018,0.00,,20.34,,"-629,621.26"
,IN,AR,30319764,1005,100,,Invoice,,,,,,12/07/2018,12/07/2018,0.00,,13.73,,"-629,634.99"
,IN,AR,30319778,1005,100,,Invoice,,,,,,12/07/2018,12/07/2018,0.00,,14.83,,"-629,649.82"
,IN,AR,30319783,1005,100,,Invoice,,,,,,12/07/2018,12/07/2018,0.00,,10.50,,"-629,660.32"
,IN,AR,30319784,1005,100,,Invoice,,,,,,12/07/2018,12/07/2018,0.00,,3.01,,"-629,663.33"
,IN,AR,30319792,1005,100,,Invoice,,,,,,12/07/2018,12/07/2018,0.00,,3.64,,"-629,666.97"
,IN,AR,30319798,1005,100,,Invoice,,,,,,12/07/2018,12/07/2018,0.00,,20.68,,"-629,687.65"
,IN,AR,30319815,1005,100,,Invoice,,,,,,12/07/2018,12/07/2018,0.00,,6.97,,"-629,694.62"
,IN,AR,30319818,1005,100,,Invoice,,,,,,12/07/2018,12/07/2018,0.00,,8.77,,"-629,703.39"
,IN,AR,30319822,1005,100,,Invoice,,,,,,12/07/2018,12/07/2018,0.00,,22.03,,"-629,725.42"
,IN,AR,30319848,1005,100,,Invoice,,,,,,12/07/2018,12/07/2018,0.00,,15.04,,"-629,740.46"
,IN,AR,30319853,1005,100,,Invoice,,,,,,12/07/2018,12/07/2018,0.00,,17.47,,"-629,757.93"
,IN,AR,30319855,1005,100,,Invoice,,,,,,12/07/2018,12/07/2018,0.00,,5.08,,"-629,763.01"
,IN,AR,30319864,1005,100,,Invoice,,,,,,12/07/2018,12/07/2018,0.00,,10.00,,"-629,773.01"
,IN,AR,30319877,1005,100,,Invoice,,,,,,12/07/2018,12/07/2018,0.00,,3.53,,"-629,776.54"
,IN,AR,30319887,1005,100,,Invoice,,,,,,12/07/2018,12/07/2018,0.00,,18.22,,"-629,794.76"
,IN,AR,30319893,1005,100,,Invoice,,,,,,12/07/2018,12/07/2018,0.00,,9.08,,"-629,803.84"
,IN,AR,30319905,1005,100,,Invoice,,,,,,12/07/2018,12/07/2018,0.00,,29.15,,"-629,832.99"
,IN,AR,30319912,1005,100,,Invoice,,,,,,12/07/2018,12/07/2018,0.00,,10.93,,"-629,843.92"
,IN,AR,30319913,1005,100,,Invoice,,,,,,12/07/2018,12/07/2018,0.00,,10.47,,"-629,854.39"
,IN,AR,30319914,1005,100,,Invoice,,,,,,12/07/2018,12/07/2018,0.00,,54.66,,"-629,909.05"
,IN,AR,30319924,1005,100,,Invoice,,,,,,12/07/2018,12/07/2018,0.00,,7.29,,"-629,916.34"
,IN,AR,30319926,1005,100,,Invoice,,,,,,12/07/2018,12/07/2018,0.00,,2.84,,"-629,919.18"
,IN,AR,30319930,1005,100,,Invoice,,,,,,12/07/2018,12/07/2018,0.00,,7.29,,"-629,926.47"
,IN,AR,30319934,1005,100,,Invoice,,,,,,12/07/2018,12/07/2018,0.00,,29.15,,"-629,955.62"
,IN,AR,30319936,1005,100,,Invoice,,,,,,12/07/2018,12/07/2018,0.00,,7.97,,"-629,963.59"
,IN,AR,30319937,1005,100,,Invoice,,,,,,12/07/2018,12/07/2018,0.00,,9.96,,"-629,973.55"
,IN,AR,30319938,1005,100,,Invoice,,,,,,12/07/2018,12/07/2018,0.00,,5.97,,"-629,979.52"
,IN,AR,30319939,1005,100,,Invoice,,,,,,12/07/2018,12/07/2018,0.00,,21.91,,"-630,001.43"
,IN,AR,30319946,1005,100,,Invoice,,,,,,12/07/2018,12/07/2018,0.00,,22.26,,"-630,023.69"
,IN,AR,30319947,1005,100,,Invoice,,,,,,12/07/2018,12/07/2018,0.00,,44.52,,"-630,068.21"
,IN,AR,30319963,1005,100,,Invoice,,,,,,12/07/2018,12/07/2018,0.00,,187.75,,"-630,255.96"
,IN,AR,30319999,1005,100,,Invoice,,,,,,12/07/2018,12/07/2018,0.00,,6.56,,"-630,262.52"
,IN,AR,30320020,1005,100,,Invoice,,,,,,12/07/2018,12/07/2018,0.00,,14.00,,"-630,276.52"
,IN,AR,30320023,1005,100,,Invoice,,,,,,12/07/2018,12/07/2018,0.00,,8.00,,"-630,284.52"
,IN,AR,30320027,1005,100,,Invoice,,,,,,12/07/2018,12/07/2018,0.00,,26.01,,"-630,310.53"
,IN,AR,30320033,1005,100,,Invoice,,,,,,12/07/2018,12/07/2018,0.00,,17.49,,"-630,328.02"
,IN,AR,30320034,1005,100,,Invoice,,,,,,12/07/2018,12/07/2018,0.00,,34.98,,"-630,363.00"
,IN,AR,30320037,1005,100,,Invoice,,,,,,12/07/2018,12/07/2018,0.00,,182.20,,"-630,545.20"
,IN,AR,30320050,1005,100,,Invoice,,,,,,12/07/2018,12/07/2018,0.00,,23.13,,"-630,568.33"
,IN,AR,30320067,1005,100,,Invoice,,,,,,12/07/2018,12/07/2018,0.00,,29.15,,"-630,597.48"
,IN,AR,30320084,1005,100,,Invoice,,,,,,12/07/2018,12/07/2018,0.00,,27.46,,"-630,624.94"
,IN,AR,30320086,1005,100,,Invoice,,,,,,12/07/2018,12/07/2018,0.00,,8.52,,"-630,633.46"
,IN,AR,30320120,1005,100,,Invoice,,,,,,12/07/2018,12/07/2018,0.00,,81.15,,"-630,714.61"
,IN,AR,30320125,1005,100,,Invoice,,,,,,12/07/2018,12/07/2018,0.00,,111.53,,"-630,826.14"
,IN,AR,30320126,1005,100,,Invoice,,,,,,12/07/2018,12/07/2018,0.00,,9.56,,"-630,835.70"
,IN,AR,30320127,1005,100,,Invoice,,,,,,12/07/2018,12/07/2018,0.00,,22.31,,"-630,858.01"
,IN,AR,30320128,1005,100,,Invoice,,,,,,12/07/2018,12/07/2018,0.00,,17.53,,"-630,875.54"
,IN,AR,30320129,1005,100,,Invoice,,,,,,12/07/2018,12/07/2018,0.00,,6.37,,"-630,881.91"
,IN,AR,30320148,1005,100,,Invoice,,,,,,12/07/2018,12/07/2018,0.00,,28.47,,"-630,910.38"
,IN,AR,30320178,1005,100,,Invoice,,,,,,12/07/2018,12/07/2018,0.00,,29.15,,"-630,939.53"
,IN,AR,30320185,1005,100,,Invoice,,,,,,12/07/2018,12/07/2018,0.00,,5.49,,"-630,945.02"
,IN,AR,30320188,1005,100,,Invoice,,,,,,12/07/2018,12/07/2018,0.00,,54.66,,"-630,999.68"
,IN,AR,30320212,1005,100,,Invoice,,,,,,12/07/2018,12/07/2018,0.00,,8.17,,"-631,007.85"
,IN,AR,30320214,1005,100,,Invoice,,,,,,12/07/2018,12/07/2018,0.00,,9.84,,"-631,017.69"
,IN,AR,30320216,1005,100,,Invoice,,,,,,12/07/2018,12/07/2018,0.00,,25.51,,"-631,043.20"
,IN,AR,30320226,1005,100,,Invoice,,,,,,12/07/2018,12/07/2018,0.00,,10.35,,"-631,053.55"
,IN,AR,30320246,1005,100,,Invoice,,,,,,12/07/2018,12/07/2018,0.00,,3.64,,"-631,057.19"
,IN,AR,30320257,1005,100,,Invoice,,,,,,12/07/2018,12/07/2018,0.00,,8.31,,"-631,065.50"
,IN,AR,30320258,1005,100,,Invoice,,,,,,12/07/2018,12/07/2018,0.00,,4.15,,"-631,069.65"
,IN,AR,30320259,1005,100,,Invoice,,,,,,12/07/2018,12/07/2018,0.00,,2.08,,"-631,071.73"
,IN,AR,30320260,1005,100,,Invoice,,,,,,12/07/2018,12/07/2018,0.00,,4.15,,"-631,075.88"
,IN,AR,30320273,1005,100,,Invoice,,,,,,12/07/2018,12/07/2018,0.00,,12.71,,"-631,088.59"
,IN,AR,30320284,1005,100,,Invoice,,,,,,12/07/2018,12/07/2018,0.00,,17.06,,"-631,105.65"
,IN,AR,30320292,1005,100,,Invoice,,,,,,12/07/2018,12/07/2018,0.00,,4.07,,"-631,109.72"
,IN,AR,30320312,1005,100,,Invoice,,,,,,12/07/2018,12/07/2018,0.00,,182.20,,"-631,291.92"
,IN,AR,30320326,1005,100,,Invoice,,,,,,12/07/2018,12/07/2018,0.00,,419.07,,"-631,710.99"
,IN,AR,30320329,1005,100,,Invoice,,,,,,12/07/2018,12/07/2018,0.00,,29.15,,"-631,740.14"
,CN,AR,31018382,1005,100,,Credit Note,,,,,,13/07/2018,13/07/2018,54.66,,0.00,,"-631,685.48"
,CN,AR,31018397,1005,100,,Credit Note,,,,,,13/07/2018,13/07/2018,81.69,,0.00,,"-631,603.79"
,CN,AR,31018409,1005,100,,Credit Note,,,,,,13/07/2018,13/07/2018,10.93,,0.00,,"-631,592.86"
,CS,AR,32006110,1005,100,,Cash sale,,,,,,13/07/2018,13/07/2018,0.00,,27.47,,"-631,620.33"
,CS,AR,32006111,1005,100,,Cash sale,,,,,,13/07/2018,13/07/2018,0.00,,10.93,,"-631,631.26"
,CS,AR,32006114,1005,100,,Cash sale,,,,,,13/07/2018,13/07/2018,0.00,,14.58,,"-631,645.84"
,CS,AR,32006118,1005,100,,Cash sale,,,,,,13/07/2018,13/07/2018,0.00,,14.03,,"-631,659.87"
,CS,AR,32006130,1005,100,,Cash sale,,,,,,13/07/2018,13/07/2018,0.00,,19.87,,"-631,679.74"
,CS,AR,32006131,1005,100,,Cash sale,,,,,,13/07/2018,13/07/2018,0.00,,14.58,,"-631,694.32"
,CS,AR,32006135,1005,100,,Cash sale,,,,,,13/07/2018,13/07/2018,0.00,,7.29,,"-631,701.61"
,CS,AR,32006137,1005,100,,Cash sale,,,,,,13/07/2018,13/07/2018,0.00,,7.29,,"-631,708.90"
,CS,AR,32006138,1005,100,,Cash sale,,,,,,13/07/2018,13/07/2018,0.00,,7.29,,"-631,716.19"
,CS,AR,32006140,1005,100,,Cash sale,,,,,,13/07/2018,13/07/2018,0.00,,7.29,,"-631,723.48"
,CS,AR,32006151,1005,100,,Cash sale,,,,,,13/07/2018,13/07/2018,0.00,,14.58,,"-631,738.06"
,CS,AR,32006153,1005,100,,Cash sale,,,,,,13/07/2018,13/07/2018,0.00,,3.64,,"-631,741.70"
,CS,AR,32006164,1005,100,,Cash sale,,,,,,13/07/2018,13/07/2018,0.00,,7.29,,"-631,748.99"
,CS,AR,32006168,1005,100,,Cash sale,,,,,,13/07/2018,13/07/2018,0.00,,3.64,,"-631,752.63"
,CS,AR,32006171,1005,100,,Cash sale,,,,,,13/07/2018,13/07/2018,0.00,,12.08,,"-631,764.71"
,CS,AR,32006183,1005,100,,Cash sale,,,,,,13/07/2018,13/07/2018,0.00,,14.58,,"-631,779.29"
,CS,AR,32006184,1005,100,,Cash sale,,,,,,13/07/2018,13/07/2018,0.00,,12.46,,"-631,791.75"
,CS,AR,32006190,1005,100,,Cash sale,,,,,,13/07/2018,13/07/2018,0.00,,3.64,,"-631,795.39"
,CS,AR,32006201,1005,100,,Cash sale,,,,,,13/07/2018,13/07/2018,0.00,,7.29,,"-631,802.68"
,CS,AR,32006203,1005,100,,Cash sale,,,,,,13/07/2018,13/07/2018,0.00,,7.29,,"-631,809.97"
,CS,AR,32006204,1005,100,,Cash sale,,,,,,13/07/2018,13/07/2018,0.00,,5.85,,"-631,815.82"
,CS,AR,32006223,1005,100,,Cash sale,,,,,,13/07/2018,13/07/2018,0.00,,10.93,,"-631,826.75"
,CS,AR,32006228,1005,100,,Cash sale,,,,,,13/07/2018,13/07/2018,0.00,,7.29,,"-631,834.04"
,CS,AR,32006230,1005,100,,Cash sale,,,,,,13/07/2018,13/07/2018,0.00,,10.93,,"-631,844.97"
,CS,AR,32006235,1005,100,,Cash sale,,,,,,13/07/2018,13/07/2018,0.00,,7.29,,"-631,852.26"
,CS,AR,32006237,1005,100,,Cash sale,,,,,,13/07/2018,13/07/2018,0.00,,18.22,,"-631,870.48"
,CS,AR,32006238,1005,100,,Cash sale,,,,,,13/07/2018,13/07/2018,0.00,,5.17,,"-631,875.65"
,CS,AR,32006240,1005,100,,Cash sale,,,,,,13/07/2018,13/07/2018,0.00,,7.63,,"-631,883.28"
,CS,AR,32006252,1005,100,,Cash sale,,,,,,13/07/2018,13/07/2018,0.00,,43.97,,"-631,927.25"
,CS,AR,32006261,1005,100,,Cash sale,,,,,,13/07/2018,13/07/2018,0.00,,10.93,,"-631,938.18"
,CS,AR,32006262,1005,100,,Cash sale,,,,,,13/07/2018,13/07/2018,0.00,,18.05,,"-631,956.23"
,CS,AR,32006266,1005,100,,Cash sale,,,,,,13/07/2018,13/07/2018,0.00,,18.22,,"-631,974.45"
,CS,AR,32006270,1005,100,,Cash sale,,,,,,13/07/2018,13/07/2018,0.00,,11.65,,"-631,986.10"
,CS,AR,32006282,1005,100,,Cash sale,,,,,,13/07/2018,13/07/2018,0.00,,29.24,,"-632,015.34"
,CS,AR,32006289,1005,100,,Cash sale,,,,,,13/07/2018,13/07/2018,0.00,,7.63,,"-632,022.97"
,CS,AR,32006296,1005,100,,Cash sale,,,,,,13/07/2018,13/07/2018,0.00,,18.22,,"-632,041.19"
,CS,AR,32006307,1005,100,,Cash sale,,,,,,13/07/2018,13/07/2018,0.00,,14.58,,"-632,055.77"
,CS,AR,32006339,1005,100,,Cash sale,,,,,,13/07/2018,13/07/2018,0.00,,25.51,,"-632,081.28"
,CS,AR,32006347,1005,100,,Cash sale,,,,,,13/07/2018,13/07/2018,0.00,,26.34,,"-632,107.62"
,CS,AR,32006356,1005,100,,Cash sale,,,,,,13/07/2018,13/07/2018,0.00,,10.93,,"-632,118.55"
,CS,AR,32006358,1005,100,,Cash sale,,,,,,13/07/2018,13/07/2018,0.00,,14.58,,"-632,133.13"
,CS,AR,32006365,1005,100,,Cash sale,,,,,,13/07/2018,13/07/2018,0.00,,3.64,,"-632,136.77"
,CS,AR,32006368,1005,100,,Cash sale,,,,,,13/07/2018,13/07/2018,0.00,,29.15,,"-632,165.92"
,CS,AR,32006372,1005,100,,Cash sale,,,,,,13/07/2018,13/07/2018,0.00,,8.34,,"-632,174.26"
,CS,AR,32006382,1005,100,,Cash sale,,,,,,13/07/2018,13/07/2018,0.00,,3.64,,"-632,177.90"
,CS,AR,32006387,1005,100,,Cash sale,,,,,,13/07/2018,13/07/2018,0.00,,14.58,,"-632,192.48"
,CS,AR,32006391,1005,100,,Cash sale,,,,,,13/07/2018,13/07/2018,0.00,,10.93,,"-632,203.41"
,CS,AR,32006403,1005,100,,Cash sale,,,,,,13/07/2018,13/07/2018,0.00,,15.25,,"-632,218.66"
,CS,AR,32006419,1005,100,,Cash sale,,,,,,13/07/2018,13/07/2018,0.00,,30.00,,"-632,248.66"
,CS,AR,32006420,1005,100,,Cash sale,,,,,,13/07/2018,13/07/2018,0.00,,3.64,,"-632,252.30"
,CS,AR,32006439,1005,100,,Cash sale,,,,,,13/07/2018,13/07/2018,0.00,,9.15,,"-632,261.45"
,CS,AR,32006463,1005,100,,Cash sale,,,,,,13/07/2018,13/07/2018,0.00,,10.93,,"-632,272.38"
,CS,AR,32006472,1005,100,,Cash sale,,,,,,13/07/2018,13/07/2018,0.00,,7.29,,"-632,279.67"
,CS,AR,32006475,1005,100,,Cash sale,,,,,,13/07/2018,13/07/2018,0.00,,7.29,,"-632,286.96"
,CS,AR,32006476,1005,100,,Cash sale,,,,,,13/07/2018,13/07/2018,0.00,,47.54,,"-632,334.50"
,CS,AR,32006477,1005,100,,Cash sale,,,,,,13/07/2018,13/07/2018,0.00,,6.10,,"-632,340.60"
,CS,AR,32006483,1005,100,,Cash sale,,,,,,13/07/2018,13/07/2018,0.00,,29.15,,"-632,369.75"
,CS,AR,32006488,1005,100,,Cash sale,,,,,,13/07/2018,13/07/2018,0.00,,12.17,,"-632,381.92"
,CS,AR,32006489,1005,100,,Cash sale,,,,,,13/07/2018,13/07/2018,0.00,,21.86,,"-632,403.78"
,CS,AR,32006491,1005,100,,Cash sale,,,,,,13/07/2018,13/07/2018,0.00,,7.29,,"-632,411.07"
,CS,AR,32006513,1005,100,,Cash sale,,,,,,13/07/2018,13/07/2018,0.00,,5.94,,"-632,417.01"
,CS,AR,32006515,1005,100,,Cash sale,,,,,,13/07/2018,13/07/2018,0.00,,10.93,,"-632,427.94"
,CS,AR,32006538,1005,100,,Cash sale,,,,,,13/07/2018,13/07/2018,0.00,,9.32,,"-632,437.26"
,CS,AR,32006555,1005,100,,Cash sale,,,,,,13/07/2018,13/07/2018,0.00,,10.93,,"-632,448.19"
,CS,AR,32006557,1005,100,,Cash sale,,,,,,13/07/2018,13/07/2018,0.00,,54.66,,"-632,502.85"
,IN,AR,30319360,1005,100,,Invoice,,,,,,13/07/2018,13/07/2018,0.00,,38.56,,"-632,541.41"
,IN,AR,30319365,1005,100,,Invoice,,,,,,13/07/2018,13/07/2018,0.00,,47.37,,"-632,588.78"
,IN,AR,30319375,1005,100,,Invoice,,,,,,13/07/2018,13/07/2018,0.00,,16.78,,"-632,605.56"
,IN,AR,30319387,1005,100,,Invoice,,,,,,13/07/2018,13/07/2018,0.00,,7.29,,"-632,612.85"
,IN,AR,30319398,1005,100,,Invoice,,,,,,13/07/2018,13/07/2018,0.00,,11.86,,"-632,624.71"
,IN,AR,30319403,1005,100,,Invoice,,,,,,13/07/2018,13/07/2018,0.00,,32.80,,"-632,657.51"
,IN,AR,30319421,1005,100,,Invoice,,,,,,13/07/2018,13/07/2018,0.00,,12.08,,"-632,669.59"
,IN,AR,30319426,1005,100,,Invoice,,,,,,13/07/2018,13/07/2018,0.00,,7.29,,"-632,676.88"
,IN,AR,30319439,1005,100,,Invoice,,,,,,13/07/2018,13/07/2018,0.00,,13.78,,"-632,690.66"
,IN,AR,30319441,1005,100,,Invoice,,,,,,13/07/2018,13/07/2018,0.00,,77.63,,"-632,768.29"
,IN,AR,30319451,1005,100,,Invoice,,,,,,13/07/2018,13/07/2018,0.00,,49.83,,"-632,818.12"
,IN,AR,30319478,1005,100,,Invoice,,,,,,13/07/2018,13/07/2018,0.00,,28.00,,"-632,846.12"
,IN,AR,30319479,1005,100,,Invoice,,,,,,13/07/2018,13/07/2018,0.00,,8.00,,"-632,854.12"
,IN,AR,30319497,1005,100,,Invoice,,,,,,13/07/2018,13/07/2018,0.00,,5.84,,"-632,859.96"
,IN,AR,30319504,1005,100,,Invoice,,,,,,13/07/2018,13/07/2018,0.00,,4.75,,"-632,864.71"
,IN,AR,30319505,1005,100,,Invoice,,,,,,13/07/2018,13/07/2018,0.00,,18.00,,"-632,882.71"
,IN,AR,30319521,1005,100,,Invoice,,,,,,13/07/2018,13/07/2018,0.00,,11.36,,"-632,894.07"
,IN,AR,30319528,1005,100,,Invoice,,,,,,13/07/2018,13/07/2018,0.00,,19.41,,"-632,913.48"
,IN,AR,30319529,1005,100,,Invoice,,,,,,13/07/2018,13/07/2018,0.00,,3.88,,"-632,917.36"
,IN,AR,30319531,1005,100,,Invoice,,,,,,13/07/2018,13/07/2018,0.00,,38.00,,"-632,955.36"
,IN,AR,30319533,1005,100,,Invoice,,,,,,13/07/2018,13/07/2018,0.00,,3.64,,"-632,959.00"
,IN,AR,30319539,1005,100,,Invoice,,,,,,13/07/2018,13/07/2018,0.00,,32.80,,"-632,991.80"
,IN,AR,30319544,1005,100,,Invoice,,,,,,13/07/2018,13/07/2018,0.00,,13.98,,"-633,005.78"
,IN,AR,30319548,1005,100,,Invoice,,,,,,13/07/2018,13/07/2018,0.00,,23.29,,"-633,029.07"
,IN,AR,30319559,1005,100,,Invoice,,,,,,13/07/2018,13/07/2018,0.00,,7.97,,"-633,037.04"
,IN,AR,30319570,1005,100,,Invoice,,,,,,13/07/2018,13/07/2018,0.00,,7.75,,"-633,044.79"
,IN,AR,30319580,1005,100,,Invoice,,,,,,13/07/2018,13/07/2018,0.00,,4.80,,"-633,049.59"
,IN,AR,30319583,1005,100,,Invoice,,,,,,13/07/2018,13/07/2018,0.00,,10.93,,"-633,060.52"
,IN,AR,30319607,1005,100,,Invoice,,,,,,13/07/2018,13/07/2018,0.00,,36.19,,"-633,096.71"
,IN,AR,30319610,1005,100,,Invoice,,,,,,13/07/2018,13/07/2018,0.00,,4.78,,"-633,101.49"
,IN,AR,30319622,1005,100,,Invoice,,,,,,13/07/2018,13/07/2018,0.00,,21.86,,"-633,123.35"
,IN,AR,30319624,1005,100,,Invoice,,,,,,13/07/2018,13/07/2018,0.00,,29.15,,"-633,152.50"
,IN,AR,30319627,1005,100,,Invoice,,,,,,13/07/2018,13/07/2018,0.00,,6.02,,"-633,158.52"
,IN,AR,30319637,1005,100,,Invoice,,,,,,13/07/2018,13/07/2018,0.00,,75.88,,"-633,234.40"
,IN,AR,30319640,1005,100,,Invoice,,,,,,13/07/2018,13/07/2018,0.00,,5.61,,"-633,240.01"
,IN,AR,30319666,1005,100,,Invoice,,,,,,13/07/2018,13/07/2018,0.00,,81.69,,"-633,321.70"
,IN,AR,30319679,1005,100,,Invoice,,,,,,13/07/2018,13/07/2018,0.00,,2.54,,"-633,324.24"
,IN,AR,30319684,1005,100,,Invoice,,,,,,13/07/2018,13/07/2018,0.00,,7.29,,"-633,331.53"
,IN,AR,30319693,1005,100,,Invoice,,,,,,13/07/2018,13/07/2018,0.00,,14.83,,"-633,346.36"
,IN,AR,30319702,1005,100,,Invoice,,,,,,13/07/2018,13/07/2018,0.00,,15.04,,"-633,361.40"
,IN,AR,30319705,1005,100,,Invoice,,,,,,13/07/2018,13/07/2018,0.00,,17.80,,"-633,379.20"
,IN,AR,30319744,1005,100,,Invoice,,,,,,13/07/2018,13/07/2018,0.00,,3.64,,"-633,382.84"
,IN,AR,30319752,1005,100,,Invoice,,,,,,13/07/2018,13/07/2018,0.00,,10.59,,"-633,393.43"
,IN,AR,30319766,1005,100,,Invoice,,,,,,13/07/2018,13/07/2018,0.00,,4.59,,"-633,398.02"
,IN,AR,30319788,1005,100,,Invoice,,,,,,13/07/2018,13/07/2018,0.00,,3.64,,"-633,401.66"
,IN,AR,30319793,1005,100,,Invoice,,,,,,13/07/2018,13/07/2018,0.00,,10.93,,"-633,412.59"
,IN,AR,30319794,1005,100,,Invoice,,,,,,13/07/2018,13/07/2018,0.00,,7.29,,"-633,419.88"
,IN,AR,30319806,1005,100,,Invoice,,,,,,13/07/2018,13/07/2018,0.00,,54.66,,"-633,474.54"
,IN,AR,30319828,1005,100,,Invoice,,,,,,13/07/2018,13/07/2018,0.00,,5.17,,"-633,479.71"
,IN,AR,30319850,1005,100,,Invoice,,,,,,13/07/2018,13/07/2018,0.00,,13.74,,"-633,493.45"
,IN,AR,30319866,1005,100,,Invoice,,,,,,13/07/2018,13/07/2018,0.00,,54.66,,"-633,548.11"
,IN,AR,30319867,1005,100,,Invoice,,,,,,13/07/2018,13/07/2018,0.00,,54.66,,"-633,602.77"
,IN,AR,30319878,1005,100,,Invoice,,,,,,13/07/2018,13/07/2018,0.00,,7.05,,"-633,609.82"
,IN,AR,30319879,1005,100,,Invoice,,,,,,13/07/2018,13/07/2018,0.00,,7.05,,"-633,616.87"
,IN,AR,30319890,1005,100,,Invoice,,,,,,13/07/2018,13/07/2018,0.00,,4.85,,"-633,621.72"
,IN,AR,30319892,1005,100,,Invoice,,,,,,13/07/2018,13/07/2018,0.00,,10.68,,"-633,632.40"
,IN,AR,30319956,1005,100,,Invoice,,,,,,13/07/2018,13/07/2018,0.00,,25.55,,"-633,657.95"
,IN,AR,30319961,1005,100,,Invoice,,,,,,13/07/2018,13/07/2018,0.00,,52.37,,"-633,710.32"
,IN,AR,30319969,1005,100,,Invoice,,,,,,13/07/2018,13/07/2018,0.00,,52.11,,"-633,762.43"
,IN,AR,30319978,1005,100,,Invoice,,,,,,13/07/2018,13/07/2018,0.00,,21.25,,"-633,783.68"
,IN,AR,30319981,1005,100,,Invoice,,,,,,13/07/2018,13/07/2018,0.00,,19.45,,"-633,803.13"
,IN,AR,30319991,1005,100,,Invoice,,,,,,13/07/2018,13/07/2018,0.00,,7.29,,"-633,810.42"
,IN,AR,30319992,1005,100,,Invoice,,,,,,13/07/2018,13/07/2018,0.00,,10.93,,"-633,821.35"
,IN,AR,30319994,1005,100,,Invoice,,,,,,13/07/2018,13/07/2018,0.00,,49.92,,"-633,871.27"
,IN,AR,30320005,1005,100,,Invoice,,,,,,13/07/2018,13/07/2018,0.00,,31.08,,"-633,902.35"
,IN,AR,30320017,1005,100,,Invoice,,,,,,13/07/2018,13/07/2018,0.00,,20.34,,"-633,922.69"
,IN,AR,30320030,1005,100,,Invoice,,,,,,13/07/2018,13/07/2018,0.00,,32.01,,"-633,954.70"
,IN,AR,30320048,1005,100,,Invoice,,,,,,13/07/2018,13/07/2018,0.00,,35.58,,"-633,990.28"
,IN,AR,30320051,1005,100,,Invoice,,,,,,13/07/2018,13/07/2018,0.00,,52.57,,"-634,042.85"
,IN,AR,30320068,1005,100,,Invoice,,,,,,13/07/2018,13/07/2018,0.00,,23.32,,"-634,066.17"
,IN,AR,30320082,1005,100,,Invoice,,,,,,13/07/2018,13/07/2018,0.00,,11.48,,"-634,077.65"
,IN,AR,30320083,1005,100,,Invoice,,,,,,13/07/2018,13/07/2018,0.00,,7.29,,"-634,084.94"
,IN,AR,30320109,1005,100,,Invoice,,,,,,13/07/2018,13/07/2018,0.00,,10.93,,"-634,095.87"
,IN,AR,30320116,1005,100,,Invoice,,,,,,13/07/2018,13/07/2018,0.00,,14.19,,"-634,110.06"
,IN,AR,30320117,1005,100,,Invoice,,,,,,13/07/2018,13/07/2018,0.00,,19.32,,"-634,129.38"
,IN,AR,30320158,1005,100,,Invoice,,,,,,13/07/2018,13/07/2018,0.00,,10.00,,"-634,139.38"
,IN,AR,30320175,1005,100,,Invoice,,,,,,13/07/2018,13/07/2018,0.00,,29.15,,"-634,168.53"
,IN,AR,30320181,1005,100,,Invoice,,,,,,13/07/2018,13/07/2018,0.00,,5.83,,"-634,174.36"
,IN,AR,30320189,1005,100,,Invoice,,,,,,13/07/2018,13/07/2018,0.00,,8.21,,"-634,182.57"
,IN,AR,30320193,1005,100,,Invoice,,,,,,13/07/2018,13/07/2018,0.00,,29.66,,"-634,212.23"
,IN,AR,30320205,1005,100,,Invoice,,,,,,13/07/2018,13/07/2018,0.00,,14.83,,"-634,227.06"
,IN,AR,30320209,1005,100,,Invoice,,,,,,13/07/2018,13/07/2018,0.00,,10.21,,"-634,237.27"
,IN,AR,30320230,1005,100,,Invoice,,,,,,13/07/2018,13/07/2018,0.00,,54.66,,"-634,291.93"
,IN,AR,30320234,1005,100,,Invoice,,,,,,13/07/2018,13/07/2018,0.00,,5.97,,"-634,297.90"
,IN,AR,30320244,1005,100,,Invoice,,,,,,13/07/2018,13/07/2018,0.00,,15.18,,"-634,313.08"
,IN,AR,30320261,1005,100,,Invoice,,,,,,13/07/2018,13/07/2018,0.00,,6.23,,"-634,319.31"
,IN,AR,30320280,1005,100,,Invoice,,,,,,13/07/2018,13/07/2018,0.00,,18.21,,"-634,337.52"
,IN,AR,30320289,1005,100,,Invoice,,,,,,13/07/2018,13/07/2018,0.00,,14.58,,"-634,352.10"
,IN,AR,30320291,1005,100,,Invoice,,,,,,13/07/2018,13/07/2018,0.00,,54.66,,"-634,406.76"
,IN,AR,30320293,1005,100,,Invoice,,,,,,13/07/2018,13/07/2018,0.00,,2.03,,"-634,408.79"
,IN,AR,30320297,1005,100,,Invoice,,,,,,13/07/2018,13/07/2018,0.00,,10.93,,"-634,419.72"
,IN,AR,30320298,1005,100,,Invoice,,,,,,13/07/2018,13/07/2018,0.00,,10.93,,"-634,430.65"
,IN,AR,30320299,1005,100,,Invoice,,,,,,13/07/2018,13/07/2018,0.00,,10.93,,"-634,441.58"
,IN,AR,30320330,1005,100,,Invoice,,,,,,13/07/2018,13/07/2018,0.00,,42.05,,"-634,483.63"
,IN,AR,30320331,1005,100,,Invoice,,,,,,13/07/2018,13/07/2018,0.00,,10.93,,"-634,494.56"
,CS,AR,32006196,1005,100,,Cash sale,,,,,,14/07/2018,14/07/2018,0.00,,29.15,,"-634,523.71"
,CS,AR,32006198,1005,100,,Cash sale,,,,,,14/07/2018,14/07/2018,0.00,,3.64,,"-634,527.35"
,CS,AR,32006212,1005,100,,Cash sale,,,,,,14/07/2018,14/07/2018,0.00,,7.29,,"-634,534.64"
,CS,AR,32006408,1005,100,,Cash sale,,,,,,14/07/2018,14/07/2018,0.00,,18.22,,"-634,552.86"
,CS,AR,32006453,1005,100,,Cash sale,,,,,,14/07/2018,14/07/2018,0.00,,29.15,,"-634,582.01"
,CS,AR,32006464,1005,100,,Cash sale,,,,,,14/07/2018,14/07/2018,0.00,,10.93,,"-634,592.94"
,CS,AR,32006465,1005,100,,Cash sale,,,,,,14/07/2018,14/07/2018,0.00,,33.39,,"-634,626.33"
,CS,AR,32006506,1005,100,,Cash sale,,,,,,14/07/2018,14/07/2018,0.00,,5.85,,"-634,632.18"
,IN,AR,30319400,1005,100,,Invoice,,,,,,14/07/2018,14/07/2018,0.00,,9.03,,"-634,641.21"
,IN,AR,30319417,1005,100,,Invoice,,,,,,14/07/2018,14/07/2018,0.00,,6.02,,"-634,647.23"
,IN,AR,30319440,1005,100,,Invoice,,,,,,14/07/2018,14/07/2018,0.00,,21.86,,"-634,669.09"
,IN,AR,30319713,1005,100,,Invoice,,,,,,14/07/2018,14/07/2018,0.00,,3.64,,"-634,672.73"
,IN,AR,30319775,1005,100,,Invoice,,,,,,14/07/2018,14/07/2018,0.00,,3.64,,"-634,676.37"
,IN,AR,30319785,1005,100,,Invoice,,,,,,14/07/2018,14/07/2018,0.00,,18.05,,"-634,694.42"
,IN,AR,30319803,1005,100,,Invoice,,,,,,14/07/2018,14/07/2018,0.00,,14.58,,"-634,709.00"
,IN,AR,30319870,1005,100,,Invoice,,,,,,14/07/2018,14/07/2018,0.00,,9.29,,"-634,718.29"
,IN,AR,30319906,1005,100,,Invoice,,,,,,14/07/2018,14/07/2018,0.00,,3.64,,"-634,721.93"
,IN,AR,30320096,1005,100,,Invoice,,,,,,14/07/2018,14/07/2018,0.00,,6.23,,"-634,728.16"
,IN,AR,30320150,1005,100,,Invoice,,,,,,14/07/2018,14/07/2018,0.00,,30.51,,"-634,758.67"
,IN,AR,30320151,1005,100,,Invoice,,,,,,14/07/2018,14/07/2018,0.00,,"2,343.05",,"-637,101.72"
,IN,AR,30320171,1005,100,,Invoice,,,,,,14/07/2018,14/07/2018,0.00,,9.84,,"-637,111.56"
,CN,AR,31018359,1005,100,,Credit Note,,,,,,16/07/2018,16/07/2018,7.29,,0.00,,"-637,104.27"
,CN,AR,31018391,1005,100,,Credit Note,,,,,,16/07/2018,16/07/2018,28.01,,0.00,,"-637,076.26"
,CS,AR,32006119,1005,100,,Cash sale,,,,,,16/07/2018,16/07/2018,0.00,,22.44,,"-637,098.70"
,CS,AR,32006159,1005,100,,Cash sale,,,,,,16/07/2018,16/07/2018,0.00,,3.64,,"-637,102.34"
,CS,AR,32006185,1005,100,,Cash sale,,,,,,16/07/2018,16/07/2018,0.00,,12.46,,"-637,114.80"
,CS,AR,32006199,1005,100,,Cash sale,,,,,,16/07/2018,16/07/2018,0.00,,3.64,,"-637,118.44"
,CS,AR,32006205,1005,100,,Cash sale,,,,,,16/07/2018,16/07/2018,0.00,,11.69,,"-637,130.13"
,CS,AR,32006222,1005,100,,Cash sale,,,,,,16/07/2018,16/07/2018,0.00,,3.64,,"-637,133.77"
,CS,AR,32006224,1005,100,,Cash sale,,,,,,16/07/2018,16/07/2018,0.00,,7.75,,"-637,141.52"
,CS,AR,32006236,1005,100,,Cash sale,,,,,,16/07/2018,16/07/2018,0.00,,3.64,,"-637,145.16"
,CS,AR,32006241,1005,100,,Cash sale,,,,,,16/07/2018,16/07/2018,0.00,,22.88,,"-637,168.04"
,CS,AR,32006245,1005,100,,Cash sale,,,,,,16/07/2018,16/07/2018,0.00,,3.64,,"-637,171.68"
,CS,AR,32006258,1005,100,,Cash sale,,,,,,16/07/2018,16/07/2018,0.00,,16.48,,"-637,188.16"
,CS,AR,32006276,1005,100,,Cash sale,,,,,,16/07/2018,16/07/2018,0.00,,7.63,,"-637,195.79"
,CS,AR,32006283,1005,100,,Cash sale,,,,,,16/07/2018,16/07/2018,0.00,,5.44,,"-637,201.23"
,CS,AR,32006291,1005,100,,Cash sale,,,,,,16/07/2018,16/07/2018,0.00,,10.93,,"-637,212.16"
,CS,AR,32006299,1005,100,,Cash sale,,,,,,16/07/2018,16/07/2018,0.00,,7.29,,"-637,219.45"
,CS,AR,32006313,1005,100,,Cash sale,,,,,,16/07/2018,16/07/2018,0.00,,3.64,,"-637,223.09"
,CS,AR,32006320,1005,100,,Cash sale,,,,,,16/07/2018,16/07/2018,0.00,,5.08,,"-637,228.17"
,CS,AR,32006334,1005,100,,Cash sale,,,,,,16/07/2018,16/07/2018,0.00,,9.03,,"-637,237.20"
,CS,AR,32006341,1005,100,,Cash sale,,,,,,16/07/2018,16/07/2018,0.00,,10.93,,"-637,248.13"
,CS,AR,32006351,1005,100,,Cash sale,,,,,,16/07/2018,16/07/2018,0.00,,3.64,,"-637,251.77"
,CS,AR,32006359,1005,100,,Cash sale,,,,,,16/07/2018,16/07/2018,0.00,,44.43,,"-637,296.20"
,CS,AR,32006366,1005,100,,Cash sale,,,,,,16/07/2018,16/07/2018,0.00,,7.29,,"-637,303.49"
,CS,AR,32006369,1005,100,,Cash sale,,,,,,16/07/2018,16/07/2018,0.00,,6.08,,"-637,309.57"
,CS,AR,32006378,1005,100,,Cash sale,,,,,,16/07/2018,16/07/2018,0.00,,7.29,,"-637,316.86"
,CS,AR,32006401,1005,100,,Cash sale,,,,,,16/07/2018,16/07/2018,0.00,,2.75,,"-637,319.61"
,CS,AR,32006404,1005,100,,Cash sale,,,,,,16/07/2018,16/07/2018,0.00,,15.25,,"-637,334.86"
,CS,AR,32006426,1005,100,,Cash sale,,,,,,16/07/2018,16/07/2018,0.00,,14.58,,"-637,349.44"
,CS,AR,32006430,1005,100,,Cash sale,,,,,,16/07/2018,16/07/2018,0.00,,6.56,,"-637,356.00"
,CS,AR,32006431,1005,100,,Cash sale,,,,,,16/07/2018,16/07/2018,0.00,,3.64,,"-637,359.64"
,CS,AR,32006440,1005,100,,Cash sale,,,,,,16/07/2018,16/07/2018,0.00,,13.73,,"-637,373.37"
,CS,AR,32006454,1005,100,,Cash sale,,,,,,16/07/2018,16/07/2018,0.00,,4.24,,"-637,377.61"
,CS,AR,32006473,1005,100,,Cash sale,,,,,,16/07/2018,16/07/2018,0.00,,10.93,,"-637,388.54"
,CS,AR,32006492,1005,100,,Cash sale,,,,,,16/07/2018,16/07/2018,0.00,,3.64,,"-637,392.18"
,CS,AR,32006499,1005,100,,Cash sale,,,,,,16/07/2018,16/07/2018,0.00,,29.15,,"-637,421.33"
,CS,AR,32006511,1005,100,,Cash sale,,,,,,16/07/2018,16/07/2018,0.00,,3.64,,"-637,424.97"
,CS,AR,32006542,1005,100,,Cash sale,,,,,,16/07/2018,16/07/2018,0.00,,7.29,,"-637,432.26"
,IN,AR,30319361,1005,100,,Invoice,,,,,,16/07/2018,16/07/2018,0.00,,14.83,,"-637,447.09"
,IN,AR,30319362,1005,100,,Invoice,,,,,,16/07/2018,16/07/2018,0.00,,47.46,,"-637,494.55"
,IN,AR,30319370,1005,100,,Invoice,,,,,,16/07/2018,16/07/2018,0.00,,21.86,,"-637,516.41"
,IN,AR,30319389,1005,100,,Invoice,,,,,,16/07/2018,16/07/2018,0.00,,8.10,,"-637,524.51"
,IN,AR,30319390,1005,100,,Invoice,,,,,,16/07/2018,16/07/2018,0.00,,4.05,,"-637,528.56"
,IN,AR,30319391,1005,100,,Invoice,,,,,,16/07/2018,16/07/2018,0.00,,10.13,,"-637,538.69"
,IN,AR,30319392,1005,100,,Invoice,,,,,,16/07/2018,16/07/2018,0.00,,8.10,,"-637,546.79"
,IN,AR,30319393,1005,100,,Invoice,,,,,,16/07/2018,16/07/2018,0.00,,2.03,,"-637,548.82"
,IN,AR,30319394,1005,100,,Invoice,,,,,,16/07/2018,16/07/2018,0.00,,16.20,,"-637,565.02"
,IN,AR,30319395,1005,100,,Invoice,,,,,,16/07/2018,16/07/2018,0.00,,4.05,,"-637,569.07"
,IN,AR,30319396,1005,100,,Invoice,,,,,,16/07/2018,16/07/2018,0.00,,18.23,,"-637,587.30"
,IN,AR,30319397,1005,100,,Invoice,,,,,,16/07/2018,16/07/2018,0.00,,4.05,,"-637,591.35"
,IN,AR,30319399,1005,100,,Invoice,,,,,,16/07/2018,16/07/2018,0.00,,7.12,,"-637,598.47"
,IN,AR,30319411,1005,100,,Invoice,,,,,,16/07/2018,16/07/2018,0.00,,7.29,,"-637,605.76"
,IN,AR,30319430,1005,100,,Invoice,,,,,,16/07/2018,16/07/2018,0.00,,82.43,,"-637,688.19"
,IN,AR,30319442,1005,100,,Invoice,,,,,,16/07/2018,16/07/2018,0.00,,3.64,,"-637,691.83"
,IN,AR,30319452,1005,100,,Invoice,,,,,,16/07/2018,16/07/2018,0.00,,154.24,,"-637,846.07"
,IN,AR,30319458,1005,100,,Invoice,,,,,,16/07/2018,16/07/2018,0.00,,19.28,,"-637,865.35"
,IN,AR,30319462,1005,100,,Invoice,,,,,,16/07/2018,16/07/2018,0.00,,76.00,,"-637,941.35"
,IN,AR,30319468,1005,100,,Invoice,,,,,,16/07/2018,16/07/2018,0.00,,76.35,,"-638,017.70"
,IN,AR,30319475,1005,100,,Invoice,,,,,,16/07/2018,16/07/2018,0.00,,3.64,,"-638,021.34"
,IN,AR,30319480,1005,100,,Invoice,,,,,,16/07/2018,16/07/2018,0.00,,48.00,,"-638,069.34"
,IN,AR,30319481,1005,100,,Invoice,,,,,,16/07/2018,16/07/2018,0.00,,14.00,,"-638,083.34"
,IN,AR,30319488,1005,100,,Invoice,,,,,,16/07/2018,16/07/2018,0.00,,2.75,,"-638,086.09"
,IN,AR,30319490,1005,100,,Invoice,,,,,,16/07/2018,16/07/2018,0.00,,43.22,,"-638,129.31"
,IN,AR,30319491,1005,100,,Invoice,,,,,,16/07/2018,16/07/2018,0.00,,11.02,,"-638,140.33"
,IN,AR,30319494,1005,100,,Invoice,,,,,,16/07/2018,16/07/2018,0.00,,10.93,,"-638,151.26"
,IN,AR,30319498,1005,100,,Invoice,,,,,,16/07/2018,16/07/2018,0.00,,9.73,,"-638,160.99"
,IN,AR,30319506,1005,100,,Invoice,,,,,,16/07/2018,16/07/2018,0.00,,16.00,,"-638,176.99"
,IN,AR,30319508,1005,100,,Invoice,,,,,,16/07/2018,16/07/2018,0.00,,7.29,,"-638,184.28"
,IN,AR,30319515,1005,100,,Invoice,,,,,,16/07/2018,16/07/2018,0.00,,18.22,,"-638,202.50"
,IN,AR,30319525,1005,100,,Invoice,,,,,,16/07/2018,16/07/2018,0.00,,24.41,,"-638,226.91"
,IN,AR,30319532,1005,100,,Invoice,,,,,,16/07/2018,16/07/2018,0.00,,26.00,,"-638,252.91"
,IN,AR,30319545,1005,100,,Invoice,,,,,,16/07/2018,16/07/2018,0.00,,19.32,,"-638,272.23"
,IN,AR,30319553,1005,100,,Invoice,,,,,,16/07/2018,16/07/2018,0.00,,17.03,,"-638,289.26"
,IN,AR,30319555,1005,100,,Invoice,,,,,,16/07/2018,16/07/2018,0.00,,7.29,,"-638,296.55"
,IN,AR,30319561,1005,100,,Invoice,,,,,,16/07/2018,16/07/2018,0.00,,21.86,,"-638,318.41"
,IN,AR,30319563,1005,100,,Invoice,,,,,,16/07/2018,16/07/2018,0.00,,31.02,,"-638,349.43"
,IN,AR,30319571,1005,100,,Invoice,,,,,,16/07/2018,16/07/2018,0.00,,10.34,,"-638,359.77"
,IN,AR,30319577,1005,100,,Invoice,,,,,,16/07/2018,16/07/2018,0.00,,7.29,,"-638,367.06"
,IN,AR,30319578,1005,100,,Invoice,,,,,,16/07/2018,16/07/2018,0.00,,10.93,,"-638,377.99"
,IN,AR,30319582,1005,100,,Invoice,,,,,,16/07/2018,16/07/2018,0.00,,16.08,,"-638,394.07"
,IN,AR,30319584,1005,100,,Invoice,,,,,,16/07/2018,16/07/2018,0.00,,7.88,,"-638,401.95"
,IN,AR,30319595,1005,100,,Invoice,,,,,,16/07/2018,16/07/2018,0.00,,26.44,,"-638,428.39"
,IN,AR,30319596,1005,100,,Invoice,,,,,,16/07/2018,16/07/2018,0.00,,61.02,,"-638,489.41"
,IN,AR,30319606,1005,100,,Invoice,,,,,,16/07/2018,16/07/2018,0.00,,14.83,,"-638,504.24"
,IN,AR,30319608,1005,100,,Invoice,,,,,,16/07/2018,16/07/2018,0.00,,28.43,,"-638,532.67"
,IN,AR,30319615,1005,100,,Invoice,,,,,,16/07/2018,16/07/2018,0.00,,8.90,,"-638,541.57"
,IN,AR,30319638,1005,100,,Invoice,,,,,,16/07/2018,16/07/2018,0.00,,92.29,,"-638,633.86"
,IN,AR,30319648,1005,100,,Invoice,,,,,,16/07/2018,16/07/2018,0.00,,23.90,,"-638,657.76"
,IN,AR,30319649,1005,100,,Invoice,,,,,,16/07/2018,16/07/2018,0.00,,9.56,,"-638,667.32"
,IN,AR,30319652,1005,100,,Invoice,,,,,,16/07/2018,16/07/2018,0.00,,35.42,,"-638,702.74"
,IN,AR,30319655,1005,100,,Invoice,,,,,,16/07/2018,16/07/2018,0.00,,15.04,,"-638,717.78"
,IN,AR,30319661,1005,100,,Invoice,,,,,,16/07/2018,16/07/2018,0.00,,4.24,,"-638,722.02"
,IN,AR,30319662,1005,100,,Invoice,,,,,,16/07/2018,16/07/2018,0.00,,7.29,,"-638,729.31"
,IN,AR,30319663,1005,100,,Invoice,,,,,,16/07/2018,16/07/2018,0.00,,5.51,,"-638,734.82"
,IN,AR,30319665,1005,100,,Invoice,,,,,,16/07/2018,16/07/2018,0.00,,10.59,,"-638,745.41"
,IN,AR,30319680,1005,100,,Invoice,,,,,,16/07/2018,16/07/2018,0.00,,5.08,,"-638,750.49"
,IN,AR,30319703,1005,100,,Invoice,,,,,,16/07/2018,16/07/2018,0.00,,33.09,,"-638,783.58"
,IN,AR,30319704,1005,100,,Invoice,,,,,,16/07/2018,16/07/2018,0.00,,30.08,,"-638,813.66"
,IN,AR,30319721,1005,100,,Invoice,,,,,,16/07/2018,16/07/2018,0.00,,30.51,,"-638,844.17"
,IN,AR,30319726,1005,100,,Invoice,,,,,,16/07/2018,16/07/2018,0.00,,28.47,,"-638,872.64"
,IN,AR,30319732,1005,100,,Invoice,,,,,,16/07/2018,16/07/2018,0.00,,14.58,,"-638,887.22"
,IN,AR,30319745,1005,100,,Invoice,,,,,,16/07/2018,16/07/2018,0.00,,7.29,,"-638,894.51"
,IN,AR,30319747,1005,100,,Invoice,,,,,,16/07/2018,16/07/2018,0.00,,10.93,,"-638,905.44"
,IN,AR,30319749,1005,100,,Invoice,,,,,,16/07/2018,16/07/2018,0.00,,12.71,,"-638,918.15"
,IN,AR,30319759,1005,100,,Invoice,,,,,,16/07/2018,16/07/2018,0.00,,8.26,,"-638,926.41"
,IN,AR,30319760,1005,100,,Invoice,,,,,,16/07/2018,16/07/2018,0.00,,7.29,,"-638,933.70"
,IN,AR,30319769,1005,100,,Invoice,,,,,,16/07/2018,16/07/2018,0.00,,30.86,,"-638,964.56"
,IN,AR,30319771,1005,100,,Invoice,,,,,,16/07/2018,16/07/2018,0.00,,15.76,,"-638,980.32"
,IN,AR,30319802,1005,100,,Invoice,,,,,,16/07/2018,16/07/2018,0.00,,75.66,,"-639,055.98"
,IN,AR,30319808,1005,100,,Invoice,,,,,,16/07/2018,16/07/2018,0.00,,54.66,,"-639,110.64"
,IN,AR,30319810,1005,100,,Invoice,,,,,,16/07/2018,16/07/2018,0.00,,24.00,,"-639,134.64"
,IN,AR,30319829,1005,100,,Invoice,,,,,,16/07/2018,16/07/2018,0.00,,7.75,,"-639,142.39"
,IN,AR,30319841,1005,100,,Invoice,,,,,,16/07/2018,16/07/2018,0.00,,32.83,,"-639,175.22"
,IN,AR,30319857,1005,100,,Invoice,,,,,,16/07/2018,16/07/2018,0.00,,54.66,,"-639,229.88"
,IN,AR,30319858,1005,100,,Invoice,,,,,,16/07/2018,16/07/2018,0.00,,6.53,,"-639,236.41"
,IN,AR,30319886,1005,100,,Invoice,,,,,,16/07/2018,16/07/2018,0.00,,7.29,,"-639,243.70"
,IN,AR,30319889,1005,100,,Invoice,,,,,,16/07/2018,16/07/2018,0.00,,54.66,,"-639,298.36"
,IN,AR,30319927,1005,100,,Invoice,,,,,,16/07/2018,16/07/2018,0.00,,7.29,,"-639,305.65"
,IN,AR,30319962,1005,100,,Invoice,,,,,,16/07/2018,16/07/2018,0.00,,2.14,,"-639,307.79"
,IN,AR,30319966,1005,100,,Invoice,,,,,,16/07/2018,16/07/2018,0.00,,40.08,,"-639,347.87"
,IN,AR,30319970,1005,100,,Invoice,,,,,,16/07/2018,16/07/2018,0.00,,36.08,,"-639,383.95"
,IN,AR,30319989,1005,100,,Invoice,,,,,,16/07/2018,16/07/2018,0.00,,10.93,,"-639,394.88"
,IN,AR,30319995,1005,100,,Invoice,,,,,,16/07/2018,16/07/2018,0.00,,39.41,,"-639,434.29"
,IN,AR,30319996,1005,100,,Invoice,,,,,,16/07/2018,16/07/2018,0.00,,6.86,,"-639,441.15"
,IN,AR,30320022,1005,100,,Invoice,,,,,,16/07/2018,16/07/2018,0.00,,28.01,,"-639,469.16"
,IN,AR,30320024,1005,100,,Invoice,,,,,,16/07/2018,16/07/2018,0.00,,28.01,,"-639,497.17"
,IN,AR,30320031,1005,100,,Invoice,,,,,,16/07/2018,16/07/2018,0.00,,32.01,,"-639,529.18"
,IN,AR,30320040,1005,100,,Invoice,,,,,,16/07/2018,16/07/2018,0.00,,25.64,,"-639,554.82"
,IN,AR,30320052,1005,100,,Invoice,,,,,,16/07/2018,16/07/2018,0.00,,18.92,,"-639,573.74"
,IN,AR,30320074,1005,100,,Invoice,,,,,,16/07/2018,16/07/2018,0.00,,31.41,,"-639,605.15"
,IN,AR,30320075,1005,100,,Invoice,,,,,,16/07/2018,16/07/2018,0.00,,153.81,,"-639,758.96"
,IN,AR,30320078,1005,100,,Invoice,,,,,,16/07/2018,16/07/2018,0.00,,33.66,,"-639,792.62"
,IN,AR,30320081,1005,100,,Invoice,,,,,,16/07/2018,16/07/2018,0.00,,15.25,,"-639,807.87"
,IN,AR,30320115,1005,100,,Invoice,,,,,,16/07/2018,16/07/2018,0.00,,7.29,,"-639,815.16"
,IN,AR,30320119,1005,100,,Invoice,,,,,,16/07/2018,16/07/2018,0.00,,42.71,,"-639,857.87"
,IN,AR,30320130,1005,100,,Invoice,,,,,,16/07/2018,16/07/2018,0.00,,22.31,,"-639,880.18"
,IN,AR,30320140,1005,100,,Invoice,,,,,,16/07/2018,16/07/2018,0.00,,10.93,,"-639,891.11"
,IN,AR,30320141,1005,100,,Invoice,,,,,,16/07/2018,16/07/2018,0.00,,51.61,,"-639,942.72"
,IN,AR,30320155,1005,100,,Invoice,,,,,,16/07/2018,16/07/2018,0.00,,25.36,,"-639,968.08"
,IN,AR,30320160,1005,100,,Invoice,,,,,,16/07/2018,16/07/2018,0.00,,3.76,,"-639,971.84"
,IN,AR,30320169,1005,100,,Invoice,,,,,,16/07/2018,16/07/2018,0.00,,29.15,,"-640,000.99"
,IN,AR,30320190,1005,100,,Invoice,,,,,,16/07/2018,16/07/2018,0.00,,19.16,,"-640,020.15"
,IN,AR,30320191,1005,100,,Invoice,,,,,,16/07/2018,16/07/2018,0.00,,10.93,,"-640,031.08"
,IN,AR,30320210,1005,100,,Invoice,,,,,,16/07/2018,16/07/2018,0.00,,8.17,,"-640,039.25"
,IN,AR,30320238,1005,100,,Invoice,,,,,,16/07/2018,16/07/2018,0.00,,35.08,,"-640,074.33"
,IN,AR,30320262,1005,100,,Invoice,,,,,,16/07/2018,16/07/2018,0.00,,8.31,,"-640,082.64"
,IN,AR,30320263,1005,100,,Invoice,,,,,,16/07/2018,16/07/2018,0.00,,6.23,,"-640,088.87"
,IN,AR,30320264,1005,100,,Invoice,,,,,,16/07/2018,16/07/2018,0.00,,10.38,,"-640,099.25"
,IN,AR,30320290,1005,100,,Invoice,,,,,,16/07/2018,16/07/2018,0.00,,14.58,,"-640,113.83"
,IN,AR,30320306,1005,100,,Invoice,,,,,,16/07/2018,16/07/2018,0.00,,7.02,,"-640,120.85"
,IN,AR,30320333,1005,100,,Invoice,,,,,,16/07/2018,16/07/2018,0.00,,364.41,,"-640,485.26"
,IN,AR,30320334,1005,100,,Invoice,,,,,,16/07/2018,16/07/2018,0.00,,364.41,,"-640,849.67"
,IN,AR,30320335,1005,100,,Invoice,,,,,,16/07/2018,16/07/2018,0.00,,364.41,,"-641,214.08"
,IN,AR,30320336,1005,100,,Invoice,,,,,,16/07/2018,16/07/2018,0.00,,364.41,,"-641,578.49"
,IN,AR,30320337,1005,100,,Invoice,,,,,,16/07/2018,16/07/2018,0.00,,364.41,,"-641,942.90"
,IN,AR,30320338,1005,100,,Invoice,,,,,,16/07/2018,16/07/2018,0.00,,364.41,,"-642,307.31"
,IN,AR,30320339,1005,100,,Invoice,,,,,,16/07/2018,16/07/2018,0.00,,364.41,,"-642,671.72"
,IN,AR,30320340,1005,100,,Invoice,,,,,,16/07/2018,16/07/2018,0.00,,364.41,,"-643,036.13"
,IN,AR,30320341,1005,100,,Invoice,,,,,,16/07/2018,16/07/2018,0.00,,364.41,,"-643,400.54"
,IN,AR,30320342,1005,100,,Invoice,,,,,,16/07/2018,16/07/2018,0.00,,364.41,,"-643,764.95"
,IN,AR,30320343,1005,100,,Invoice,,,,,,16/07/2018,16/07/2018,0.00,,364.41,,"-644,129.36"
,IN,AR,30320344,1005,100,,Invoice,,,,,,16/07/2018,16/07/2018,0.00,,364.41,,"-644,493.77"
,IN,AR,30320345,1005,100,,Invoice,,,,,,16/07/2018,16/07/2018,0.00,,364.41,,"-644,858.18"
,IN,AR,30320346,1005,100,,Invoice,,,,,,16/07/2018,16/07/2018,0.00,,364.41,,"-645,222.59"
,CN,AR,31018407,1005,100,,Credit Note,,,,,,17/07/2018,17/07/2018,7.29,,0.00,,"-645,215.30"
,CN,AR,31018410,1005,100,,Credit Note,,,,,,17/07/2018,17/07/2018,10.93,,0.00,,"-645,204.37"
,CS,AR,32006133,1005,100,,Cash sale,,,,,,17/07/2018,17/07/2018,0.00,,7.29,,"-645,211.66"
,CS,AR,32006142,1005,100,,Cash sale,,,,,,17/07/2018,17/07/2018,0.00,,3.64,,"-645,215.30"
,CS,AR,32006149,1005,100,,Cash sale,,,,,,17/07/2018,17/07/2018,0.00,,3.64,,"-645,218.94"
,CS,AR,32006158,1005,100,,Cash sale,,,,,,17/07/2018,17/07/2018,0.00,,7.29,,"-645,226.23"
,CS,AR,32006161,1005,100,,Cash sale,,,,,,17/07/2018,17/07/2018,0.00,,10.93,,"-645,237.16"
,CS,AR,32006173,1005,100,,Cash sale,,,,,,17/07/2018,17/07/2018,0.00,,9.03,,"-645,246.19"
,CS,AR,32006177,1005,100,,Cash sale,,,,,,17/07/2018,17/07/2018,0.00,,10.93,,"-645,257.12"
,CS,AR,32006182,1005,100,,Cash sale,,,,,,17/07/2018,17/07/2018,0.00,,7.29,,"-645,264.41"
,CS,AR,32006191,1005,100,,Cash sale,,,,,,17/07/2018,17/07/2018,0.00,,14.58,,"-645,278.99"
,CS,AR,32006192,1005,100,,Cash sale,,,,,,17/07/2018,17/07/2018,0.00,,3.64,,"-645,282.63"
,CS,AR,32006211,1005,100,,Cash sale,,,,,,17/07/2018,17/07/2018,0.00,,14.58,,"-645,297.21"
,CS,AR,32006215,1005,100,,Cash sale,,,,,,17/07/2018,17/07/2018,0.00,,14.58,,"-645,311.79"
,CS,AR,32006231,1005,100,,Cash sale,,,,,,17/07/2018,17/07/2018,0.00,,18.22,,"-645,330.01"
,CS,AR,32006232,1005,100,,Cash sale,,,,,,17/07/2018,17/07/2018,0.00,,4.78,,"-645,334.79"
,CS,AR,32006234,1005,100,,Cash sale,,,,,,17/07/2018,17/07/2018,0.00,,4.32,,"-645,339.11"
,CS,AR,32006247,1005,100,,Cash sale,,,,,,17/07/2018,17/07/2018,0.00,,5.68,,"-645,344.79"
,CS,AR,32006250,1005,100,,Cash sale,,,,,,17/07/2018,17/07/2018,0.00,,10.93,,"-645,355.72"
,CS,AR,32006265,1005,100,,Cash sale,,,,,,17/07/2018,17/07/2018,0.00,,14.58,,"-645,370.30"
,CS,AR,32006269,1005,100,,Cash sale,,,,,,17/07/2018,17/07/2018,0.00,,4.29,,"-645,374.59"
,CS,AR,32006272,1005,100,,Cash sale,,,,,,17/07/2018,17/07/2018,0.00,,3.64,,"-645,378.23"
,CS,AR,32006279,1005,100,,Cash sale,,,,,,17/07/2018,17/07/2018,0.00,,12.03,,"-645,390.26"
,CS,AR,32006280,1005,100,,Cash sale,,,,,,17/07/2018,17/07/2018,0.00,,1.95,,"-645,392.21"
,CS,AR,32006281,1005,100,,Cash sale,,,,,,17/07/2018,17/07/2018,0.00,,8.98,,"-645,401.19"
,CS,AR,32006284,1005,100,,Cash sale,,,,,,17/07/2018,17/07/2018,0.00,,7.29,,"-645,408.48"
,CS,AR,32006288,1005,100,,Cash sale,,,,,,17/07/2018,17/07/2018,0.00,,18.22,,"-645,426.70"
,CS,AR,32006300,1005,100,,Cash sale,,,,,,17/07/2018,17/07/2018,0.00,,10.93,,"-645,437.63"
,CS,AR,32006305,1005,100,,Cash sale,,,,,,17/07/2018,17/07/2018,0.00,,2.54,,"-645,440.17"
,CS,AR,32006310,1005,100,,Cash sale,,,,,,17/07/2018,17/07/2018,0.00,,10.34,,"-645,450.51"
,CS,AR,32006312,1005,100,,Cash sale,,,,,,17/07/2018,17/07/2018,0.00,,3.64,,"-645,454.15"
,CS,AR,32006317,1005,100,,Cash sale,,,,,,17/07/2018,17/07/2018,0.00,,69.19,,"-645,523.34"
,CS,AR,32006323,1005,100,,Cash sale,,,,,,17/07/2018,17/07/2018,0.00,,10.34,,"-645,533.68"
,CS,AR,32006325,1005,100,,Cash sale,,,,,,17/07/2018,17/07/2018,0.00,,18.22,,"-645,551.90"
,CS,AR,32006329,1005,100,,Cash sale,,,,,,17/07/2018,17/07/2018,0.00,,7.29,,"-645,559.19"
,CS,AR,32006338,1005,100,,Cash sale,,,,,,17/07/2018,17/07/2018,0.00,,7.29,,"-645,566.48"
,CS,AR,32006349,1005,100,,Cash sale,,,,,,17/07/2018,17/07/2018,0.00,,18.22,,"-645,584.70"
,CS,AR,32006357,1005,100,,Cash sale,,,,,,17/07/2018,17/07/2018,0.00,,7.75,,"-645,592.45"
,CS,AR,32006392,1005,100,,Cash sale,,,,,,17/07/2018,17/07/2018,0.00,,10.95,,"-645,603.40"
,CS,AR,32006393,1005,100,,Cash sale,,,,,,17/07/2018,17/07/2018,0.00,,5.47,,"-645,608.87"
,CS,AR,32006394,1005,100,,Cash sale,,,,,,17/07/2018,17/07/2018,0.00,,7.29,,"-645,616.16"
,CS,AR,32006397,1005,100,,Cash sale,,,,,,17/07/2018,17/07/2018,0.00,,7.29,,"-645,623.45"
,CS,AR,32006400,1005,100,,Cash sale,,,,,,17/07/2018,17/07/2018,0.00,,29.15,,"-645,652.60"
,CS,AR,32006414,1005,100,,Cash sale,,,,,,17/07/2018,17/07/2018,0.00,,5.08,,"-645,657.68"
,CS,AR,32006416,1005,100,,Cash sale,,,,,,17/07/2018,17/07/2018,0.00,,34.00,,"-645,691.68"
,CS,AR,32006423,1005,100,,Cash sale,,,,,,17/07/2018,17/07/2018,0.00,,3.64,,"-645,695.32"
,CS,AR,32006434,1005,100,,Cash sale,,,,,,17/07/2018,17/07/2018,0.00,,5.47,,"-645,700.79"
,CS,AR,32006456,1005,100,,Cash sale,,,,,,17/07/2018,17/07/2018,0.00,,8.25,,"-645,709.04"
,CS,AR,32006457,1005,100,,Cash sale,,,,,,17/07/2018,17/07/2018,0.00,,14.58,,"-645,723.62"
,CS,AR,32006461,1005,100,,Cash sale,,,,,,17/07/2018,17/07/2018,0.00,,48.57,,"-645,772.19"
,CS,AR,32006467,1005,100,,Cash sale,,,,,,17/07/2018,17/07/2018,0.00,,7.29,,"-645,779.48"
,CS,AR,32006481,1005,100,,Cash sale,,,,,,17/07/2018,17/07/2018,0.00,,6.56,,"-645,786.04"
,CS,AR,32006490,1005,100,,Cash sale,,,,,,17/07/2018,17/07/2018,0.00,,7.29,,"-645,793.33"
,CS,AR,32006496,1005,100,,Cash sale,,,,,,17/07/2018,17/07/2018,0.00,,54.66,,"-645,847.99"
,CS,AR,32006498,1005,100,,Cash sale,,,,,,17/07/2018,17/07/2018,0.00,,5.47,,"-645,853.46"
,CS,AR,32006500,1005,100,,Cash sale,,,,,,17/07/2018,17/07/2018,0.00,,8.75,,"-645,862.21"
,CS,AR,32006540,1005,100,,Cash sale,,,,,,17/07/2018,17/07/2018,0.00,,9.30,,"-645,871.51"
,CS,AR,32006551,1005,100,,Cash sale,,,,,,17/07/2018,17/07/2018,0.00,,7.29,,"-645,878.80"
,CS,AR,32006558,1005,100,,Cash sale,,,,,,17/07/2018,17/07/2018,0.00,,10.93,,"-645,889.73"
,IN,AR,30319358,1005,100,,Invoice,,,,,,17/07/2018,17/07/2018,0.00,,249.40,,"-646,139.13"
,IN,AR,30319410,1005,100,,Invoice,,,,,,17/07/2018,17/07/2018,0.00,,21.30,,"-646,160.43"
,IN,AR,30319427,1005,100,,Invoice,,,,,,17/07/2018,17/07/2018,0.00,,7.29,,"-646,167.72"
,IN,AR,30319429,1005,100,,Invoice,,,,,,17/07/2018,17/07/2018,0.00,,7.00,,"-646,174.72"
,IN,AR,30319431,1005,100,,Invoice,,,,,,17/07/2018,17/07/2018,0.00,,25.51,,"-646,200.23"
,IN,AR,30319432,1005,100,,Invoice,,,,,,17/07/2018,17/07/2018,0.00,,14.58,,"-646,214.81"
,IN,AR,30319445,1005,100,,Invoice,,,,,,17/07/2018,17/07/2018,0.00,,1.99,,"-646,216.80"
,IN,AR,30319453,1005,100,,Invoice,,,,,,17/07/2018,17/07/2018,0.00,,37.97,,"-646,254.77"
,IN,AR,30319457,1005,100,,Invoice,,,,,,17/07/2018,17/07/2018,0.00,,14.58,,"-646,269.35"
,IN,AR,30319460,1005,100,,Invoice,,,,,,17/07/2018,17/07/2018,0.00,,29.15,,"-646,298.50"
,IN,AR,30319466,1005,100,,Invoice,,,,,,17/07/2018,17/07/2018,0.00,,25.51,,"-646,324.01"
,IN,AR,30319467,1005,100,,Invoice,,,,,,17/07/2018,17/07/2018,0.00,,7.29,,"-646,331.30"
,IN,AR,30319530,1005,100,,Invoice,,,,,,17/07/2018,17/07/2018,0.00,,93.20,,"-646,424.50"
,IN,AR,30319534,1005,100,,Invoice,,,,,,17/07/2018,17/07/2018,0.00,,25.51,,"-646,450.01"
,IN,AR,30319536,1005,100,,Invoice,,,,,,17/07/2018,17/07/2018,0.00,,13.74,,"-646,463.75"
,IN,AR,30319537,1005,100,,Invoice,,,,,,17/07/2018,17/07/2018,0.00,,7.29,,"-646,471.04"
,IN,AR,30319543,1005,100,,Invoice,,,,,,17/07/2018,17/07/2018,0.00,,18.05,,"-646,489.09"
,IN,AR,30319574,1005,100,,Invoice,,,,,,17/07/2018,17/07/2018,0.00,,9.29,,"-646,498.38"
,IN,AR,30319581,1005,100,,Invoice,,,,,,17/07/2018,17/07/2018,0.00,,11.99,,"-646,510.37"
,IN,AR,30319590,1005,100,,Invoice,,,,,,17/07/2018,17/07/2018,0.00,,16.95,,"-646,527.32"
,IN,AR,30319612,1005,100,,Invoice,,,,,,17/07/2018,17/07/2018,0.00,,5.17,,"-646,532.49"
,IN,AR,30319618,1005,100,,Invoice,,,,,,17/07/2018,17/07/2018,0.00,,3.03,,"-646,535.52"
,IN,AR,30319628,1005,100,,Invoice,,,,,,17/07/2018,17/07/2018,0.00,,9.03,,"-646,544.55"
,IN,AR,30319633,1005,100,,Invoice,,,,,,17/07/2018,17/07/2018,0.00,,5.85,,"-646,550.40"
,IN,AR,30319658,1005,100,,Invoice,,,,,,17/07/2018,17/07/2018,0.00,,7.29,,"-646,557.69"
,IN,AR,30319673,1005,100,,Invoice,,,,,,17/07/2018,17/07/2018,0.00,,25.51,,"-646,583.20"
,IN,AR,30319681,1005,100,,Invoice,,,,,,17/07/2018,17/07/2018,0.00,,20.34,,"-646,603.54"
,IN,AR,30319688,1005,100,,Invoice,,,,,,17/07/2018,17/07/2018,0.00,,8.98,,"-646,612.52"
,IN,AR,30319696,1005,100,,Invoice,,,,,,17/07/2018,17/07/2018,0.00,,15.25,,"-646,627.77"
,IN,AR,30319700,1005,100,,Invoice,,,,,,17/07/2018,17/07/2018,0.00,,14.58,,"-646,642.35"
,IN,AR,30319701,1005,100,,Invoice,,,,,,17/07/2018,17/07/2018,0.00,,7.29,,"-646,649.64"
,IN,AR,30319707,1005,100,,Invoice,,,,,,17/07/2018,17/07/2018,0.00,,19.07,,"-646,668.71"
,IN,AR,30319710,1005,100,,Invoice,,,,,,17/07/2018,17/07/2018,0.00,,7.29,,"-646,676.00"
,IN,AR,30319712,1005,100,,Invoice,,,,,,17/07/2018,17/07/2018,0.00,,7.80,,"-646,683.80"
,IN,AR,30319719,1005,100,,Invoice,,,,,,17/07/2018,17/07/2018,0.00,,30.25,,"-646,714.05"
,IN,AR,30319723,1005,100,,Invoice,,,,,,17/07/2018,17/07/2018,0.00,,7.29,,"-646,721.34"
,IN,AR,30319724,1005,100,,Invoice,,,,,,17/07/2018,17/07/2018,0.00,,10.93,,"-646,732.27"
,IN,AR,30319730,1005,100,,Invoice,,,,,,17/07/2018,17/07/2018,0.00,,13.22,,"-646,745.49"
,IN,AR,30319731,1005,100,,Invoice,,,,,,17/07/2018,17/07/2018,0.00,,2.39,,"-646,747.88"
,IN,AR,30319734,1005,100,,Invoice,,,,,,17/07/2018,17/07/2018,0.00,,20.34,,"-646,768.22"
,IN,AR,30319740,1005,100,,Invoice,,,,,,17/07/2018,17/07/2018,0.00,,3.90,,"-646,772.12"
,IN,AR,30319742,1005,100,,Invoice,,,,,,17/07/2018,17/07/2018,0.00,,15.79,,"-646,787.91"
,IN,AR,30319746,1005,100,,Invoice,,,,,,17/07/2018,17/07/2018,0.00,,12.03,,"-646,799.94"
,IN,AR,30319750,1005,100,,Invoice,,,,,,17/07/2018,17/07/2018,0.00,,21.19,,"-646,821.13"
,IN,AR,30319751,1005,100,,Invoice,,,,,,17/07/2018,17/07/2018,0.00,,12.71,,"-646,833.84"
,IN,AR,30319756,1005,100,,Invoice,,,,,,17/07/2018,17/07/2018,0.00,,4.24,,"-646,838.08"
,IN,AR,30319767,1005,100,,Invoice,,,,,,17/07/2018,17/07/2018,0.00,,6.89,,"-646,844.97"
,IN,AR,30319774,1005,100,,Invoice,,,,,,17/07/2018,17/07/2018,0.00,,8.47,,"-646,853.44"
,IN,AR,30319779,1005,100,,Invoice,,,,,,17/07/2018,17/07/2018,0.00,,59.32,,"-646,912.76"
,IN,AR,30319801,1005,100,,Invoice,,,,,,17/07/2018,17/07/2018,0.00,,64.32,,"-646,977.08"
,IN,AR,30319812,1005,100,,Invoice,,,,,,17/07/2018,17/07/2018,0.00,,24.56,,"-647,001.64"
,IN,AR,30319825,1005,100,,Invoice,,,,,,17/07/2018,17/07/2018,0.00,,14.58,,"-647,016.22"
,IN,AR,30319827,1005,100,,Invoice,,,,,,17/07/2018,17/07/2018,0.00,,2.80,,"-647,019.02"
,IN,AR,30319830,1005,100,,Invoice,,,,,,17/07/2018,17/07/2018,0.00,,5.17,,"-647,024.19"
,IN,AR,30319832,1005,100,,Invoice,,,,,,17/07/2018,17/07/2018,0.00,,5.86,,"-647,030.05"
,IN,AR,30319842,1005,100,,Invoice,,,,,,17/07/2018,17/07/2018,0.00,,29.15,,"-647,059.20"
,IN,AR,30319849,1005,100,,Invoice,,,,,,17/07/2018,17/07/2018,0.00,,9.10,,"-647,068.30"
,IN,AR,30319860,1005,100,,Invoice,,,,,,17/07/2018,17/07/2018,0.00,,3.64,,"-647,071.94"
,IN,AR,30319862,1005,100,,Invoice,,,,,,17/07/2018,17/07/2018,0.00,,17.15,,"-647,089.09"
,IN,AR,30319863,1005,100,,Invoice,,,,,,17/07/2018,17/07/2018,0.00,,39.11,,"-647,128.20"
,IN,AR,30319869,1005,100,,Invoice,,,,,,17/07/2018,17/07/2018,0.00,,23.58,,"-647,151.78"
,IN,AR,30319880,1005,100,,Invoice,,,,,,17/07/2018,17/07/2018,0.00,,5.29,,"-647,157.07"
,IN,AR,30319901,1005,100,,Invoice,,,,,,17/07/2018,17/07/2018,0.00,,154.66,,"-647,311.73"
,IN,AR,30319904,1005,100,,Invoice,,,,,,17/07/2018,17/07/2018,0.00,,54.66,,"-647,366.39"
,IN,AR,30319925,1005,100,,Invoice,,,,,,17/07/2018,17/07/2018,0.00,,6.43,,"-647,372.82"
,IN,AR,30319935,1005,100,,Invoice,,,,,,17/07/2018,17/07/2018,0.00,,10.93,,"-647,383.75"
,IN,AR,30319948,1005,100,,Invoice,,,,,,17/07/2018,17/07/2018,0.00,,19.08,,"-647,402.83"
,IN,AR,30319949,1005,100,,Invoice,,,,,,17/07/2018,17/07/2018,0.00,,3.18,,"-647,406.01"
,IN,AR,30319950,1005,100,,Invoice,,,,,,17/07/2018,17/07/2018,0.00,,4.77,,"-647,410.78"
,IN,AR,30319951,1005,100,,Invoice,,,,,,17/07/2018,17/07/2018,0.00,,219.42,,"-647,630.20"
,IN,AR,30319972,1005,100,,Invoice,,,,,,17/07/2018,17/07/2018,0.00,,10.93,,"-647,641.13"
,IN,AR,30319979,1005,100,,Invoice,,,,,,17/07/2018,17/07/2018,0.00,,33.39,,"-647,674.52"
,IN,AR,30319984,1005,100,,Invoice,,,,,,17/07/2018,17/07/2018,0.00,,224.47,,"-647,898.99"
,IN,AR,30319990,1005,100,,Invoice,,,,,,17/07/2018,17/07/2018,0.00,,10.93,,"-647,909.92"
,IN,AR,30320013,1005,100,,Invoice,,,,,,17/07/2018,17/07/2018,0.00,,7.29,,"-647,917.21"
,IN,AR,30320025,1005,100,,Invoice,,,,,,17/07/2018,17/07/2018,0.00,,22.01,,"-647,939.22"
,IN,AR,30320059,1005,100,,Invoice,,,,,,17/07/2018,17/07/2018,0.00,,7.29,,"-647,946.51"
,IN,AR,30320077,1005,100,,Invoice,,,,,,17/07/2018,17/07/2018,0.00,,5.47,,"-647,951.98"
,IN,AR,30320091,1005,100,,Invoice,,,,,,17/07/2018,17/07/2018,0.00,,9.64,,"-647,961.62"
,IN,AR,30320093,1005,100,,Invoice,,,,,,17/07/2018,17/07/2018,0.00,,100.00,,"-648,061.62"
,IN,AR,30320094,1005,100,,Invoice,,,,,,17/07/2018,17/07/2018,0.00,,18.20,,"-648,079.82"
,IN,AR,30320098,1005,100,,Invoice,,,,,,17/07/2018,17/07/2018,0.00,,33.22,,"-648,113.04"
,IN,AR,30320106,1005,100,,Invoice,,,,,,17/07/2018,17/07/2018,0.00,,7.29,,"-648,120.33"
,IN,AR,30320112,1005,100,,Invoice,,,,,,17/07/2018,17/07/2018,0.00,,2.54,,"-648,122.87"
,IN,AR,30320131,1005,100,,Invoice,,,,,,17/07/2018,17/07/2018,0.00,,9.56,,"-648,132.43"
,IN,AR,30320138,1005,100,,Invoice,,,,,,17/07/2018,17/07/2018,0.00,,97.63,,"-648,230.06"
,IN,AR,30320145,1005,100,,Invoice,,,,,,17/07/2018,17/07/2018,0.00,,16.61,,"-648,246.67"
,IN,AR,30320156,1005,100,,Invoice,,,,,,17/07/2018,17/07/2018,0.00,,19.02,,"-648,265.69"
,IN,AR,30320164,1005,100,,Invoice,,,,,,17/07/2018,17/07/2018,0.00,,3.51,,"-648,269.20"
,IN,AR,30320168,1005,100,,Invoice,,,,,,17/07/2018,17/07/2018,0.00,,8.00,,"-648,277.20"
,IN,AR,30320174,1005,100,,Invoice,,,,,,17/07/2018,17/07/2018,0.00,,121.02,,"-648,398.22"
,IN,AR,30320180,1005,100,,Invoice,,,,,,17/07/2018,17/07/2018,0.00,,8.77,,"-648,406.99"
,IN,AR,30320182,1005,100,,Invoice,,,,,,17/07/2018,17/07/2018,0.00,,29.15,,"-648,436.14"
,IN,AR,30320192,1005,100,,Invoice,,,,,,17/07/2018,17/07/2018,0.00,,14.58,,"-648,450.72"
,IN,AR,30320202,1005,100,,Invoice,,,,,,17/07/2018,17/07/2018,0.00,,54.66,,"-648,505.38"
,IN,AR,30320219,1005,100,,Invoice,,,,,,17/07/2018,17/07/2018,0.00,,36.44,,"-648,541.82"
,IN,AR,30320227,1005,100,,Invoice,,,,,,17/07/2018,17/07/2018,0.00,,8.39,,"-648,550.21"
,IN,AR,30320235,1005,100,,Invoice,,,,,,17/07/2018,17/07/2018,0.00,,7.97,,"-648,558.18"
,IN,AR,30320245,1005,100,,Invoice,,,,,,17/07/2018,17/07/2018,0.00,,9.11,,"-648,567.29"
,IN,AR,30320265,1005,100,,Invoice,,,,,,17/07/2018,17/07/2018,0.00,,24.92,,"-648,592.21"
,IN,AR,30320272,1005,100,,Invoice,,,,,,17/07/2018,17/07/2018,0.00,,25.42,,"-648,617.63"
,IN,AR,30320285,1005,100,,Invoice,,,,,,17/07/2018,17/07/2018,0.00,,7.29,,"-648,624.92"
,IN,AR,30320296,1005,100,,Invoice,,,,,,17/07/2018,17/07/2018,0.00,,15.25,,"-648,640.17"
,IN,AR,30320322,1005,100,,Invoice,,,,,,17/07/2018,17/07/2018,0.00,,16.47,,"-648,656.64"
,IN,AR,30320323,1005,100,,Invoice,,,,,,17/07/2018,17/07/2018,0.00,,16.47,,"-648,673.11"
,IN,AR,30320324,1005,100,,Invoice,,,,,,17/07/2018,17/07/2018,0.00,,16.47,,"-648,689.58"
,IN,AR,30320358,1005,100,,Invoice,,,,,,17/07/2018,17/07/2018,0.00,,29.15,,"-648,718.73"
,CN,AR,31018371,1005,100,,Credit Note,,,,,,18/07/2018,18/07/2018,8.58,,0.00,,"-648,710.15"
,CN,AR,31018399,1005,100,,Credit Note,,,,,,18/07/2018,18/07/2018,54.66,,0.00,,"-648,655.49"
,CN,AR,31018414,1005,100,,Credit Note,,,,,,18/07/2018,18/07/2018,10.93,,0.00,,"-648,644.56"
,CS,AR,32006122,1005,100,,Cash sale,,,,,,18/07/2018,18/07/2018,0.00,,3.64,,"-648,648.20"
,CS,AR,32006125,1005,100,,Cash sale,,,,,,18/07/2018,18/07/2018,0.00,,3.64,,"-648,651.84"
,CS,AR,32006127,1005,100,,Cash sale,,,,,,18/07/2018,18/07/2018,0.00,,37.63,,"-648,689.47"
,CS,AR,32006136,1005,100,,Cash sale,,,,,,18/07/2018,18/07/2018,0.00,,10.93,,"-648,700.40"
,CS,AR,32006147,1005,100,,Cash sale,,,,,,18/07/2018,18/07/2018,0.00,,3.64,,"-648,704.04"
,CS,AR,32006154,1005,100,,Cash sale,,,,,,18/07/2018,18/07/2018,0.00,,3.64,,"-648,707.68"
,CS,AR,32006167,1005,100,,Cash sale,,,,,,18/07/2018,18/07/2018,0.00,,3.64,,"-648,711.32"
,CS,AR,32006178,1005,100,,Cash sale,,,,,,18/07/2018,18/07/2018,0.00,,3.64,,"-648,714.96"
,CS,AR,32006179,1005,100,,Cash sale,,,,,,18/07/2018,18/07/2018,0.00,,7.29,,"-648,722.25"
,CS,AR,32006181,1005,100,,Cash sale,,,,,,18/07/2018,18/07/2018,0.00,,7.29,,"-648,729.54"
,CS,AR,32006189,1005,100,,Cash sale,,,,,,18/07/2018,18/07/2018,0.00,,3.64,,"-648,733.18"
,CS,AR,32006193,1005,100,,Cash sale,,,,,,18/07/2018,18/07/2018,0.00,,7.29,,"-648,740.47"
,CS,AR,32006195,1005,100,,Cash sale,,,,,,18/07/2018,18/07/2018,0.00,,9.03,,"-648,749.50"
,CS,AR,32006219,1005,100,,Cash sale,,,,,,18/07/2018,18/07/2018,0.00,,5.86,,"-648,755.36"
,CS,AR,32006226,1005,100,,Cash sale,,,,,,18/07/2018,18/07/2018,0.00,,10.34,,"-648,765.70"
,CS,AR,32006249,1005,100,,Cash sale,,,,,,18/07/2018,18/07/2018,0.00,,12.92,,"-648,778.62"
,CS,AR,32006251,1005,100,,Cash sale,,,,,,18/07/2018,18/07/2018,0.00,,31.02,,"-648,809.64"
,CS,AR,32006254,1005,100,,Cash sale,,,,,,18/07/2018,18/07/2018,0.00,,7.29,,"-648,816.93"
,CS,AR,32006260,1005,100,,Cash sale,,,,,,18/07/2018,18/07/2018,0.00,,21.06,,"-648,837.99"
,CS,AR,32006268,1005,100,,Cash sale,,,,,,18/07/2018,18/07/2018,0.00,,14.58,,"-648,852.57"
,CS,AR,32006273,1005,100,,Cash sale,,,,,,18/07/2018,18/07/2018,0.00,,25.85,,"-648,878.42"
,CS,AR,32006278,1005,100,,Cash sale,,,,,,18/07/2018,18/07/2018,0.00,,7.00,,"-648,885.42"
,CS,AR,32006293,1005,100,,Cash sale,,,,,,18/07/2018,18/07/2018,0.00,,7.75,,"-648,893.17"
,CS,AR,32006306,1005,100,,Cash sale,,,,,,18/07/2018,18/07/2018,0.00,,7.29,,"-648,900.46"
,CS,AR,32006309,1005,100,,Cash sale,,,,,,18/07/2018,18/07/2018,0.00,,10.93,,"-648,911.39"
,CS,AR,32006336,1005,100,,Cash sale,,,,,,18/07/2018,18/07/2018,0.00,,10.93,,"-648,922.32"
,CS,AR,32006346,1005,100,,Cash sale,,,,,,18/07/2018,18/07/2018,0.00,,3.64,,"-648,925.96"
,CS,AR,32006350,1005,100,,Cash sale,,,,,,18/07/2018,18/07/2018,0.00,,7.29,,"-648,933.25"
,CS,AR,32006379,1005,100,,Cash sale,,,,,,18/07/2018,18/07/2018,0.00,,18.69,,"-648,951.94"
,CS,AR,32006383,1005,100,,Cash sale,,,,,,18/07/2018,18/07/2018,0.00,,7.29,,"-648,959.23"
,CS,AR,32006389,1005,100,,Cash sale,,,,,,18/07/2018,18/07/2018,0.00,,16.61,,"-648,975.84"
,CS,AR,32006396,1005,100,,Cash sale,,,,,,18/07/2018,18/07/2018,0.00,,10.93,,"-648,986.77"
,CS,AR,32006399,1005,100,,Cash sale,,,,,,18/07/2018,18/07/2018,0.00,,7.29,,"-648,994.06"
,CS,AR,32006407,1005,100,,Cash sale,,,,,,18/07/2018,18/07/2018,0.00,,5.17,,"-648,999.23"
,CS,AR,32006410,1005,100,,Cash sale,,,,,,18/07/2018,18/07/2018,0.00,,10.93,,"-649,010.16"
,CS,AR,32006432,1005,100,,Cash sale,,,,,,18/07/2018,18/07/2018,0.00,,2.54,,"-649,012.70"
,CS,AR,32006441,1005,100,,Cash sale,,,,,,18/07/2018,18/07/2018,0.00,,9.15,,"-649,021.85"
,CS,AR,32006443,1005,100,,Cash sale,,,,,,18/07/2018,18/07/2018,0.00,,14.58,,"-649,036.43"
,CS,AR,32006445,1005,100,,Cash sale,,,,,,18/07/2018,18/07/2018,0.00,,9.10,,"-649,045.53"
,CS,AR,32006452,1005,100,,Cash sale,,,,,,18/07/2018,18/07/2018,0.00,,8.90,,"-649,054.43"
,CS,AR,32006458,1005,100,,Cash sale,,,,,,18/07/2018,18/07/2018,0.00,,10.93,,"-649,065.36"
,CS,AR,32006474,1005,100,,Cash sale,,,,,,18/07/2018,18/07/2018,0.00,,14.58,,"-649,079.94"
,CS,AR,32006482,1005,100,,Cash sale,,,,,,18/07/2018,18/07/2018,0.00,,6.07,,"-649,086.01"
,CS,AR,32006485,1005,100,,Cash sale,,,,,,18/07/2018,18/07/2018,0.00,,3.64,,"-649,089.65"
,CS,AR,32006495,1005,100,,Cash sale,,,,,,18/07/2018,18/07/2018,0.00,,3.64,,"-649,093.29"
,CS,AR,32006505,1005,100,,Cash sale,,,,,,18/07/2018,18/07/2018,0.00,,7.29,,"-649,100.58"
,CS,AR,32006539,1005,100,,Cash sale,,,,,,18/07/2018,18/07/2018,0.00,,16.31,,"-649,116.89"
,IN,AR,30319363,1005,100,,Invoice,,,,,,18/07/2018,18/07/2018,0.00,,35.59,,"-649,152.48"
,IN,AR,30319371,1005,100,,Invoice,,,,,,18/07/2018,18/07/2018,0.00,,14.03,,"-649,166.51"
,IN,AR,30319378,1005,100,,Invoice,,,,,,18/07/2018,18/07/2018,0.00,,21.86,,"-649,188.37"
,IN,AR,30319384,1005,100,,Invoice,,,,,,18/07/2018,18/07/2018,0.00,,65.90,,"-649,254.27"
,IN,AR,30319385,1005,100,,Invoice,,,,,,18/07/2018,18/07/2018,0.00,,29.29,,"-649,283.56"
,IN,AR,30319404,1005,100,,Invoice,,,,,,18/07/2018,18/07/2018,0.00,,8.52,,"-649,292.08"
,IN,AR,30319405,1005,100,,Invoice,,,,,,18/07/2018,18/07/2018,0.00,,21.86,,"-649,313.94"
,IN,AR,30319407,1005,100,,Invoice,,,,,,18/07/2018,18/07/2018,0.00,,19.92,,"-649,333.86"
,IN,AR,30319415,1005,100,,Invoice,,,,,,18/07/2018,18/07/2018,0.00,,26.27,,"-649,360.13"
,IN,AR,30319416,1005,100,,Invoice,,,,,,18/07/2018,18/07/2018,0.00,,65.68,,"-649,425.81"
,IN,AR,30319418,1005,100,,Invoice,,,,,,18/07/2018,18/07/2018,0.00,,3.64,,"-649,429.45"
,IN,AR,30319422,1005,100,,Invoice,,,,,,18/07/2018,18/07/2018,0.00,,31.40,,"-649,460.85"
,IN,AR,30319454,1005,100,,Invoice,,,,,,18/07/2018,18/07/2018,0.00,,97.29,,"-649,558.14"
,IN,AR,30319482,1005,100,,Invoice,,,,,,18/07/2018,18/07/2018,0.00,,46.00,,"-649,604.14"
,IN,AR,30319500,1005,100,,Invoice,,,,,,18/07/2018,18/07/2018,0.00,,50.00,,"-649,654.14"
,IN,AR,30319507,1005,100,,Invoice,,,,,,18/07/2018,18/07/2018,0.00,,10.00,,"-649,664.14"
,IN,AR,30319523,1005,100,,Invoice,,,,,,18/07/2018,18/07/2018,0.00,,226.49,,"-649,890.63"
,IN,AR,30319538,1005,100,,Invoice,,,,,,18/07/2018,18/07/2018,0.00,,12.03,,"-649,902.66"
,IN,AR,30319546,1005,100,,Invoice,,,,,,18/07/2018,18/07/2018,0.00,,8.05,,"-649,910.71"
,IN,AR,30319556,1005,100,,Invoice,,,,,,18/07/2018,18/07/2018,0.00,,10.93,,"-649,921.64"
,IN,AR,30319575,1005,100,,Invoice,,,,,,18/07/2018,18/07/2018,0.00,,6.97,,"-649,928.61"
,IN,AR,30319586,1005,100,,Invoice,,,,,,18/07/2018,18/07/2018,0.00,,25.42,,"-649,954.03"
,IN,AR,30319591,1005,100,,Invoice,,,,,,18/07/2018,18/07/2018,0.00,,4.24,,"-649,958.27"
,IN,AR,30319593,1005,100,,Invoice,,,,,,18/07/2018,18/07/2018,0.00,,4.24,,"-649,962.51"
,IN,AR,30319598,1005,100,,Invoice,,,,,,18/07/2018,18/07/2018,0.00,,2.12,,"-649,964.63"
,IN,AR,30319604,1005,100,,Invoice,,,,,,18/07/2018,18/07/2018,0.00,,8.39,,"-649,973.02"
,IN,AR,30319616,1005,100,,Invoice,,,,,,18/07/2018,18/07/2018,0.00,,46.57,,"-650,019.59"
,IN,AR,30319623,1005,100,,Invoice,,,,,,18/07/2018,18/07/2018,0.00,,18.22,,"-650,037.81"
,IN,AR,30319630,1005,100,,Invoice,,,,,,18/07/2018,18/07/2018,0.00,,23.90,,"-650,061.71"
,IN,AR,30319639,1005,100,,Invoice,,,,,,18/07/2018,18/07/2018,0.00,,77.93,,"-650,139.64"
,IN,AR,30319641,1005,100,,Invoice,,,,,,18/07/2018,18/07/2018,0.00,,157.63,,"-650,297.27"
,IN,AR,30319642,1005,100,,Invoice,,,,,,18/07/2018,18/07/2018,0.00,,55.93,,"-650,353.20"
,IN,AR,30319656,1005,100,,Invoice,,,,,,18/07/2018,18/07/2018,0.00,,6.02,,"-650,359.22"
,IN,AR,30319657,1005,100,,Invoice,,,,,,18/07/2018,18/07/2018,0.00,,6.02,,"-650,365.24"
,IN,AR,30319664,1005,100,,Invoice,,,,,,18/07/2018,18/07/2018,0.00,,23.26,,"-650,388.50"
,IN,AR,30319668,1005,100,,Invoice,,,,,,18/07/2018,18/07/2018,0.00,,256.08,,"-650,644.58"
,IN,AR,30319675,1005,100,,Invoice,,,,,,18/07/2018,18/07/2018,0.00,,7.17,,"-650,651.75"
,IN,AR,30319682,1005,100,,Invoice,,,,,,18/07/2018,18/07/2018,0.00,,5.08,,"-650,656.83"
,IN,AR,30319683,1005,100,,Invoice,,,,,,18/07/2018,18/07/2018,0.00,,5.08,,"-650,661.91"
,IN,AR,30319690,1005,100,,Invoice,,,,,,18/07/2018,18/07/2018,0.00,,14.71,,"-650,676.62"
,IN,AR,30319694,1005,100,,Invoice,,,,,,18/07/2018,18/07/2018,0.00,,2.12,,"-650,678.74"
,IN,AR,30319706,1005,100,,Invoice,,,,,,18/07/2018,18/07/2018,0.00,,10.59,,"-650,689.33"
,IN,AR,30319711,1005,100,,Invoice,,,,,,18/07/2018,18/07/2018,0.00,,9.56,,"-650,698.89"
,IN,AR,30319717,1005,100,,Invoice,,,,,,18/07/2018,18/07/2018,0.00,,18.17,,"-650,717.06"
,IN,AR,30319735,1005,100,,Invoice,,,,,,18/07/2018,18/07/2018,0.00,,7.63,,"-650,724.69"
,IN,AR,30319754,1005,100,,Invoice,,,,,,18/07/2018,18/07/2018,0.00,,21.86,,"-650,746.55"
,IN,AR,30319757,1005,100,,Invoice,,,,,,18/07/2018,18/07/2018,0.00,,7.29,,"-650,753.84"
,IN,AR,30319780,1005,100,,Invoice,,,,,,18/07/2018,18/07/2018,0.00,,44.49,,"-650,798.33"
,IN,AR,30319791,1005,100,,Invoice,,,,,,18/07/2018,18/07/2018,0.00,,18.22,,"-650,816.55"
,IN,AR,30319797,1005,100,,Invoice,,,,,,18/07/2018,18/07/2018,0.00,,14.58,,"-650,831.13"
,IN,AR,30319805,1005,100,,Invoice,,,,,,18/07/2018,18/07/2018,0.00,,15.25,,"-650,846.38"
,IN,AR,30319824,1005,100,,Invoice,,,,,,18/07/2018,18/07/2018,0.00,,3.64,,"-650,850.02"
,IN,AR,30319840,1005,100,,Invoice,,,,,,18/07/2018,18/07/2018,0.00,,364.41,,"-651,214.43"
,IN,AR,30319844,1005,100,,Invoice,,,,,,18/07/2018,18/07/2018,0.00,,7.29,,"-651,221.72"
,IN,AR,30319846,1005,100,,Invoice,,,,,,18/07/2018,18/07/2018,0.00,,33.09,,"-651,254.81"
,IN,AR,30319881,1005,100,,Invoice,,,,,,18/07/2018,18/07/2018,0.00,,5.29,,"-651,260.10"
,IN,AR,30319882,1005,100,,Invoice,,,,,,18/07/2018,18/07/2018,0.00,,1.76,,"-651,261.86"
,IN,AR,30319885,1005,100,,Invoice,,,,,,18/07/2018,18/07/2018,0.00,,18.05,,"-651,279.91"
,IN,AR,30319897,1005,100,,Invoice,,,,,,18/07/2018,18/07/2018,0.00,,182.20,,"-651,462.11"
,IN,AR,30319902,1005,100,,Invoice,,,,,,18/07/2018,18/07/2018,0.00,,3.64,,"-651,465.75"
,IN,AR,30319908,1005,100,,Invoice,,,,,,18/07/2018,18/07/2018,0.00,,23.26,,"-651,489.01"
,IN,AR,30319917,1005,100,,Invoice,,,,,,18/07/2018,18/07/2018,0.00,,36.01,,"-651,525.02"
,IN,AR,30319920,1005,100,,Invoice,,,,,,18/07/2018,18/07/2018,0.00,,40.08,,"-651,565.10"
,IN,AR,30319921,1005,100,,Invoice,,,,,,18/07/2018,18/07/2018,0.00,,32.80,,"-651,597.90"
,IN,AR,30319928,1005,100,,Invoice,,,,,,18/07/2018,18/07/2018,0.00,,"1,341.02",,"-652,938.92"
,IN,AR,30319933,1005,100,,Invoice,,,,,,18/07/2018,18/07/2018,0.00,,15.25,,"-652,954.17"
,IN,AR,30319954,1005,100,,Invoice,,,,,,18/07/2018,18/07/2018,0.00,,10.03,,"-652,964.20"
,IN,AR,30319957,1005,100,,Invoice,,,,,,18/07/2018,18/07/2018,0.00,,53.94,,"-653,018.14"
,IN,AR,30319959,1005,100,,Invoice,,,,,,18/07/2018,18/07/2018,0.00,,36.00,,"-653,054.14"
,IN,AR,30319967,1005,100,,Invoice,,,,,,18/07/2018,18/07/2018,0.00,,100.21,,"-653,154.35"
,IN,AR,30319971,1005,100,,Invoice,,,,,,18/07/2018,18/07/2018,0.00,,36.08,,"-653,190.43"
,IN,AR,30319974,1005,100,,Invoice,,,,,,18/07/2018,18/07/2018,0.00,,14.58,,"-653,205.01"
,IN,AR,30319982,1005,100,,Invoice,,,,,,18/07/2018,18/07/2018,0.00,,25.93,,"-653,230.94"
,IN,AR,30319985,1005,100,,Invoice,,,,,,18/07/2018,18/07/2018,0.00,,16.95,,"-653,247.89"
,IN,AR,30319986,1005,100,,Invoice,,,,,,18/07/2018,18/07/2018,0.00,,3.64,,"-653,251.53"
,IN,AR,30319987,1005,100,,Invoice,,,,,,18/07/2018,18/07/2018,0.00,,3.03,,"-653,254.56"
,IN,AR,30320002,1005,100,,Invoice,,,,,,18/07/2018,18/07/2018,0.00,,10.19,,"-653,264.75"
,IN,AR,30320004,1005,100,,Invoice,,,,,,18/07/2018,18/07/2018,0.00,,49.15,,"-653,313.90"
,IN,AR,30320007,1005,100,,Invoice,,,,,,18/07/2018,18/07/2018,0.00,,182.20,,"-653,496.10"
,IN,AR,30320008,1005,100,,Invoice,,,,,,18/07/2018,18/07/2018,0.00,,182.20,,"-653,678.30"
,IN,AR,30320010,1005,100,,Invoice,,,,,,18/07/2018,18/07/2018,0.00,,32.80,,"-653,711.10"
,IN,AR,30320012,1005,100,,Invoice,,,,,,18/07/2018,18/07/2018,0.00,,32.80,,"-653,743.90"
,IN,AR,30320018,1005,100,,Invoice,,,,,,18/07/2018,18/07/2018,0.00,,5.08,,"-653,748.98"
,IN,AR,30320032,1005,100,,Invoice,,,,,,18/07/2018,18/07/2018,0.00,,24.01,,"-653,772.99"
,IN,AR,30320038,1005,100,,Invoice,,,,,,18/07/2018,18/07/2018,0.00,,105.04,,"-653,878.03"
,IN,AR,30320041,1005,100,,Invoice,,,,,,18/07/2018,18/07/2018,0.00,,9.05,,"-653,887.08"
,IN,AR,30320053,1005,100,,Invoice,,,,,,18/07/2018,18/07/2018,0.00,,27.33,,"-653,914.41"
,IN,AR,30320054,1005,100,,Invoice,,,,,,18/07/2018,18/07/2018,0.00,,10.52,,"-653,924.93"
,IN,AR,30320055,1005,100,,Invoice,,,,,,18/07/2018,18/07/2018,0.00,,8.41,,"-653,933.34"
,IN,AR,30320061,1005,100,,Invoice,,,,,,18/07/2018,18/07/2018,0.00,,15.04,,"-653,948.38"
,IN,AR,30320063,1005,100,,Invoice,,,,,,18/07/2018,18/07/2018,0.00,,15.93,,"-653,964.31"
,IN,AR,30320064,1005,100,,Invoice,,,,,,18/07/2018,18/07/2018,0.00,,7.29,,"-653,971.60"
,IN,AR,30320066,1005,100,,Invoice,,,,,,18/07/2018,18/07/2018,0.00,,2.33,,"-653,973.93"
,IN,AR,30320108,1005,100,,Invoice,,,,,,18/07/2018,18/07/2018,0.00,,54.66,,"-654,028.59"
,IN,AR,30320110,1005,100,,Invoice,,,,,,18/07/2018,18/07/2018,0.00,,14.58,,"-654,043.17"
,IN,AR,30320118,1005,100,,Invoice,,,,,,18/07/2018,18/07/2018,0.00,,14.58,,"-654,057.75"
,IN,AR,30320132,1005,100,,Invoice,,,,,,18/07/2018,18/07/2018,0.00,,19.12,,"-654,076.87"
,IN,AR,30320133,1005,100,,Invoice,,,,,,18/07/2018,18/07/2018,0.00,,6.37,,"-654,083.24"
,IN,AR,30320146,1005,100,,Invoice,,,,,,18/07/2018,18/07/2018,0.00,,30.85,,"-654,114.09"
,IN,AR,30320147,1005,100,,Invoice,,,,,,18/07/2018,18/07/2018,0.00,,137.64,,"-654,251.73"
,IN,AR,30320157,1005,100,,Invoice,,,,,,18/07/2018,18/07/2018,0.00,,6.34,,"-654,258.07"
,IN,AR,30320162,1005,100,,Invoice,,,,,,18/07/2018,18/07/2018,0.00,,3.51,,"-654,261.58"
,IN,AR,30320165,1005,100,,Invoice,,,,,,18/07/2018,18/07/2018,0.00,,8.26,,"-654,269.84"
,IN,AR,30320184,1005,100,,Invoice,,,,,,18/07/2018,18/07/2018,0.00,,9.84,,"-654,279.68"
,IN,AR,30320196,1005,100,,Invoice,,,,,,18/07/2018,18/07/2018,0.00,,7.53,,"-654,287.21"
,IN,AR,30320203,1005,100,,Invoice,,,,,,18/07/2018,18/07/2018,0.00,,7.02,,"-654,294.23"
,IN,AR,30320204,1005,100,,Invoice,,,,,,18/07/2018,18/07/2018,0.00,,54.66,,"-654,348.89"
,IN,AR,30320207,1005,100,,Invoice,,,,,,18/07/2018,18/07/2018,0.00,,19.58,,"-654,368.47"
,IN,AR,30320215,1005,100,,Invoice,,,,,,18/07/2018,18/07/2018,0.00,,7.29,,"-654,375.76"
,IN,AR,30320224,1005,100,,Invoice,,,,,,18/07/2018,18/07/2018,0.00,,16.48,,"-654,392.24"
,IN,AR,30320231,1005,100,,Invoice,,,,,,18/07/2018,18/07/2018,0.00,,14.58,,"-654,406.82"
,IN,AR,30320240,1005,100,,Invoice,,,,,,18/07/2018,18/07/2018,0.00,,9.15,,"-654,415.97"
,IN,AR,30320248,1005,100,,Invoice,,,,,,18/07/2018,18/07/2018,0.00,,7.29,,"-654,423.26"
,IN,AR,30320266,1005,100,,Invoice,,,,,,18/07/2018,18/07/2018,0.00,,56.06,,"-654,479.32"
,IN,AR,30320267,1005,100,,Invoice,,,,,,18/07/2018,18/07/2018,0.00,,12.46,,"-654,491.78"
,IN,AR,30320268,1005,100,,Invoice,,,,,,18/07/2018,18/07/2018,0.00,,14.53,,"-654,506.31"
,IN,AR,30320269,1005,100,,Invoice,,,,,,18/07/2018,18/07/2018,0.00,,4.15,,"-654,510.46"
,IN,AR,30320274,1005,100,,Invoice,,,,,,18/07/2018,18/07/2018,0.00,,2.54,,"-654,513.00"
,IN,AR,30320279,1005,100,,Invoice,,,,,,18/07/2018,18/07/2018,0.00,,45.89,,"-654,558.89"
,IN,AR,30320281,1005,100,,Invoice,,,,,,18/07/2018,18/07/2018,0.00,,29.15,,"-654,588.04"
,IN,AR,30320282,1005,100,,Invoice,,,,,,18/07/2018,18/07/2018,0.00,,51.58,,"-654,639.62"
,IN,AR,30320287,1005,100,,Invoice,,,,,,18/07/2018,18/07/2018,0.00,,26.57,,"-654,666.19"
,IN,AR,30320307,1005,100,,Invoice,,,,,,18/07/2018,18/07/2018,0.00,,54.66,,"-654,720.85"
,IN,AR,30320325,1005,100,,Invoice,,,,,,18/07/2018,18/07/2018,0.00,,2.75,,"-654,723.60"
,IN,AR,30320359,1005,100,,Invoice,,,,,,18/07/2018,18/07/2018,0.00,,10.93,,"-654,734.53"
,CN,AR,31018403,1005,100,,Credit Note,,,,,,19/07/2018,19/07/2018,10.93,,0.00,,"-654,723.60"
,CN,AR,31018412,1005,100,,Credit Note,,,,,,19/07/2018,19/07/2018,"4,737.29",,0.00,,"-649,986.31"
,CS,AR,32006113,1005,100,,Cash sale,,,,,,19/07/2018,19/07/2018,0.00,,12.03,,"-649,998.34"
,CS,AR,32006115,1005,100,,Cash sale,,,,,,19/07/2018,19/07/2018,0.00,,21.86,,"-650,020.20"
,CS,AR,32006129,1005,100,,Cash sale,,,,,,19/07/2018,19/07/2018,0.00,,7.29,,"-650,027.49"
,CS,AR,32006139,1005,100,,Cash sale,,,,,,19/07/2018,19/07/2018,0.00,,5.17,,"-650,032.66"
,CS,AR,32006152,1005,100,,Cash sale,,,,,,19/07/2018,19/07/2018,0.00,,25.51,,"-650,058.17"
,CS,AR,32006170,1005,100,,Cash sale,,,,,,19/07/2018,19/07/2018,0.00,,10.93,,"-650,069.10"
,CS,AR,32006175,1005,100,,Cash sale,,,,,,19/07/2018,19/07/2018,0.00,,7.29,,"-650,076.39"
,CS,AR,32006188,1005,100,,Cash sale,,,,,,19/07/2018,19/07/2018,0.00,,14.58,,"-650,090.97"
,CS,AR,32006200,1005,100,,Cash sale,,,,,,19/07/2018,19/07/2018,0.00,,3.64,,"-650,094.61"
,CS,AR,32006202,1005,100,,Cash sale,,,,,,19/07/2018,19/07/2018,0.00,,10.93,,"-650,105.54"
,CS,AR,32006207,1005,100,,Cash sale,,,,,,19/07/2018,19/07/2018,0.00,,3.64,,"-650,109.18"
,CS,AR,32006208,1005,100,,Cash sale,,,,,,19/07/2018,19/07/2018,0.00,,18.22,,"-650,127.40"
,CS,AR,32006213,1005,100,,Cash sale,,,,,,19/07/2018,19/07/2018,0.00,,10.93,,"-650,138.33"
,CS,AR,32006221,1005,100,,Cash sale,,,,,,19/07/2018,19/07/2018,0.00,,10.93,,"-650,149.26"
,CS,AR,32006244,1005,100,,Cash sale,,,,,,19/07/2018,19/07/2018,0.00,,12.92,,"-650,162.18"
,CS,AR,32006255,1005,100,,Cash sale,,,,,,19/07/2018,19/07/2018,0.00,,10.93,,"-650,173.11"
,CS,AR,32006263,1005,100,,Cash sale,,,,,,19/07/2018,19/07/2018,0.00,,15.04,,"-650,188.15"
,CS,AR,32006277,1005,100,,Cash sale,,,,,,19/07/2018,19/07/2018,0.00,,12.71,,"-650,200.86"
,CS,AR,32006286,1005,100,,Cash sale,,,,,,19/07/2018,19/07/2018,0.00,,20.68,,"-650,221.54"
,CS,AR,32006290,1005,100,,Cash sale,,,,,,19/07/2018,19/07/2018,0.00,,17.80,,"-650,239.34"
,CS,AR,32006295,1005,100,,Cash sale,,,,,,19/07/2018,19/07/2018,0.00,,7.29,,"-650,246.63"
,CS,AR,32006297,1005,100,,Cash sale,,,,,,19/07/2018,19/07/2018,0.00,,3.64,,"-650,250.27"
,CS,AR,32006301,1005,100,,Cash sale,,,,,,19/07/2018,19/07/2018,0.00,,19.28,,"-650,269.55"
,CS,AR,32006302,1005,100,,Cash sale,,,,,,19/07/2018,19/07/2018,0.00,,7.29,,"-650,276.84"
,CS,AR,32006308,1005,100,,Cash sale,,,,,,19/07/2018,19/07/2018,0.00,,7.29,,"-650,284.13"
,CS,AR,32006315,1005,100,,Cash sale,,,,,,19/07/2018,19/07/2018,0.00,,3.64,,"-650,287.77"
,CS,AR,32006319,1005,100,,Cash sale,,,,,,19/07/2018,19/07/2018,0.00,,7.29,,"-650,295.06"
,CS,AR,32006321,1005,100,,Cash sale,,,,,,19/07/2018,19/07/2018,0.00,,6.02,,"-650,301.08"
,CS,AR,32006331,1005,100,,Cash sale,,,,,,19/07/2018,19/07/2018,0.00,,39.15,,"-650,340.23"
,CS,AR,32006332,1005,100,,Cash sale,,,,,,19/07/2018,19/07/2018,0.00,,7.29,,"-650,347.52"
,CS,AR,32006337,1005,100,,Cash sale,,,,,,19/07/2018,19/07/2018,0.00,,10.93,,"-650,358.45"
,CS,AR,32006345,1005,100,,Cash sale,,,,,,19/07/2018,19/07/2018,0.00,,12.88,,"-650,371.33"
,CS,AR,32006360,1005,100,,Cash sale,,,,,,19/07/2018,19/07/2018,0.00,,21.86,,"-650,393.19"
,CS,AR,32006362,1005,100,,Cash sale,,,,,,19/07/2018,19/07/2018,0.00,,9.66,,"-650,402.85"
,CS,AR,32006363,1005,100,,Cash sale,,,,,,19/07/2018,19/07/2018,0.00,,10.93,,"-650,413.78"
,CS,AR,32006364,1005,100,,Cash sale,,,,,,19/07/2018,19/07/2018,0.00,,7.75,,"-650,421.53"
,CS,AR,32006370,1005,100,,Cash sale,,,,,,19/07/2018,19/07/2018,0.00,,7.29,,"-650,428.82"
,CS,AR,32006373,1005,100,,Cash sale,,,,,,19/07/2018,19/07/2018,0.00,,10.93,,"-650,439.75"
,CS,AR,32006376,1005,100,,Cash sale,,,,,,19/07/2018,19/07/2018,0.00,,14.58,,"-650,454.33"
,CS,AR,32006381,1005,100,,Cash sale,,,,,,19/07/2018,19/07/2018,0.00,,16.78,,"-650,471.11"
,CS,AR,32006385,1005,100,,Cash sale,,,,,,19/07/2018,19/07/2018,0.00,,3.64,,"-650,474.75"
,CS,AR,32006406,1005,100,,Cash sale,,,,,,19/07/2018,19/07/2018,0.00,,2.58,,"-650,477.33"
,CS,AR,32006412,1005,100,,Cash sale,,,,,,19/07/2018,19/07/2018,0.00,,7.29,,"-650,484.62"
,CS,AR,32006417,1005,100,,Cash sale,,,,,,19/07/2018,19/07/2018,0.00,,8.00,,"-650,492.62"
,CS,AR,32006421,1005,100,,Cash sale,,,,,,19/07/2018,19/07/2018,0.00,,14.58,,"-650,507.20"
,CS,AR,32006422,1005,100,,Cash sale,,,,,,19/07/2018,19/07/2018,0.00,,15.17,,"-650,522.37"
,CS,AR,32006428,1005,100,,Cash sale,,,,,,19/07/2018,19/07/2018,0.00,,5.93,,"-650,528.30"
,CS,AR,32006435,1005,100,,Cash sale,,,,,,19/07/2018,19/07/2018,0.00,,9.84,,"-650,538.14"
,CS,AR,32006436,1005,100,,Cash sale,,,,,,19/07/2018,19/07/2018,0.00,,10.93,,"-650,549.07"
,CS,AR,32006449,1005,100,,Cash sale,,,,,,19/07/2018,19/07/2018,0.00,,10.93,,"-650,560.00"
,CS,AR,32006460,1005,100,,Cash sale,,,,,,19/07/2018,19/07/2018,0.00,,14.58,,"-650,574.58"
,CS,AR,32006469,1005,100,,Cash sale,,,,,,19/07/2018,19/07/2018,0.00,,5.47,,"-650,580.05"
,CS,AR,32006470,1005,100,,Cash sale,,,,,,19/07/2018,19/07/2018,0.00,,10.93,,"-650,590.98"
,CS,AR,32006494,1005,100,,Cash sale,,,,,,19/07/2018,19/07/2018,0.00,,10.93,,"-650,601.91"
,CS,AR,32006502,1005,100,,Cash sale,,,,,,19/07/2018,19/07/2018,0.00,,5.86,,"-650,607.77"
,CS,AR,32006509,1005,100,,Cash sale,,,,,,19/07/2018,19/07/2018,0.00,,10.93,,"-650,618.70"
,CS,AR,32006510,1005,100,,Cash sale,,,,,,19/07/2018,19/07/2018,0.00,,10.93,,"-650,629.63"
,CS,AR,32006545,1005,100,,Cash sale,,,,,,19/07/2018,19/07/2018,0.00,,7.29,,"-650,636.92"
,IN,AR,30319368,1005,100,,Invoice,,,,,,19/07/2018,19/07/2018,0.00,,3.64,,"-650,640.56"
,IN,AR,30319376,1005,100,,Invoice,,,,,,19/07/2018,19/07/2018,0.00,,10.93,,"-650,651.49"
,IN,AR,30319380,1005,100,,Invoice,,,,,,19/07/2018,19/07/2018,0.00,,10.93,,"-650,662.42"
,IN,AR,30319409,1005,100,,Invoice,,,,,,19/07/2018,19/07/2018,0.00,,3.64,,"-650,666.06"
,IN,AR,30319424,1005,100,,Invoice,,,,,,19/07/2018,19/07/2018,0.00,,7.29,,"-650,673.35"
,IN,AR,30319438,1005,100,,Invoice,,,,,,19/07/2018,19/07/2018,0.00,,65.59,,"-650,738.94"
,IN,AR,30319446,1005,100,,Invoice,,,,,,19/07/2018,19/07/2018,0.00,,1.99,,"-650,740.93"
,IN,AR,30319447,1005,100,,Invoice,,,,,,19/07/2018,19/07/2018,0.00,,5.97,,"-650,746.90"
,IN,AR,30319455,1005,100,,Invoice,,,,,,19/07/2018,19/07/2018,0.00,,75.93,,"-650,822.83"
,IN,AR,30319459,1005,100,,Invoice,,,,,,19/07/2018,19/07/2018,0.00,,3.64,,"-650,826.47"
,IN,AR,30319463,1005,100,,Invoice,,,,,,19/07/2018,19/07/2018,0.00,,58.00,,"-650,884.47"
,IN,AR,30319470,1005,100,,Invoice,,,,,,19/07/2018,19/07/2018,0.00,,3.64,,"-650,888.11"
,IN,AR,30319474,1005,100,,Invoice,,,,,,19/07/2018,19/07/2018,0.00,,10.93,,"-650,899.04"
,IN,AR,30319487,1005,100,,Invoice,,,,,,19/07/2018,19/07/2018,0.00,,7.29,,"-650,906.33"
,IN,AR,30319495,1005,100,,Invoice,,,,,,19/07/2018,19/07/2018,0.00,,14.58,,"-650,920.91"
,IN,AR,30319511,1005,100,,Invoice,,,,,,19/07/2018,19/07/2018,0.00,,32.95,,"-650,953.86"
,IN,AR,30319526,1005,100,,Invoice,,,,,,19/07/2018,19/07/2018,0.00,,569.45,,"-651,523.31"
,IN,AR,30319562,1005,100,,Invoice,,,,,,19/07/2018,19/07/2018,0.00,,14.58,,"-651,537.89"
,IN,AR,30319565,1005,100,,Invoice,,,,,,19/07/2018,19/07/2018,0.00,,10.93,,"-651,548.82"
,IN,AR,30319568,1005,100,,Invoice,,,,,,19/07/2018,19/07/2018,0.00,,35.00,,"-651,583.82"
,IN,AR,30319576,1005,100,,Invoice,,,,,,19/07/2018,19/07/2018,0.00,,3.64,,"-651,587.46"
,IN,AR,30319609,1005,100,,Invoice,,,,,,19/07/2018,19/07/2018,0.00,,17.49,,"-651,604.95"
,IN,AR,30319614,1005,100,,Invoice,,,,,,19/07/2018,19/07/2018,0.00,,206.28,,"-651,811.23"
,IN,AR,30319620,1005,100,,Invoice,,,,,,19/07/2018,19/07/2018,0.00,,21.51,,"-651,832.74"
,IN,AR,30319625,1005,100,,Invoice,,,,,,19/07/2018,19/07/2018,0.00,,33.46,,"-651,866.20"
,IN,AR,30319635,1005,100,,Invoice,,,,,,19/07/2018,19/07/2018,0.00,,22.03,,"-651,888.23"
,IN,AR,30319643,1005,100,,Invoice,,,,,,19/07/2018,19/07/2018,0.00,,10.17,,"-651,898.40"
,IN,AR,30319645,1005,100,,Invoice,,,,,,19/07/2018,19/07/2018,0.00,,364.41,,"-652,262.81"
,IN,AR,30319650,1005,100,,Invoice,,,,,,19/07/2018,19/07/2018,0.00,,21.51,,"-652,284.32"
,IN,AR,30319654,1005,100,,Invoice,,,,,,19/07/2018,19/07/2018,0.00,,6.44,,"-652,290.76"
,IN,AR,30319660,1005,100,,Invoice,,,,,,19/07/2018,19/07/2018,0.00,,8.47,,"-652,299.23"
,IN,AR,30319672,1005,100,,Invoice,,,,,,19/07/2018,19/07/2018,0.00,,8.47,,"-652,307.70"
,IN,AR,30319692,1005,100,,Invoice,,,,,,19/07/2018,19/07/2018,0.00,,5.17,,"-652,312.87"
,IN,AR,30319708,1005,100,,Invoice,,,,,,19/07/2018,19/07/2018,0.00,,21.19,,"-652,334.06"
,IN,AR,30319722,1005,100,,Invoice,,,,,,19/07/2018,19/07/2018,0.00,,30.51,,"-652,364.57"
,IN,AR,30319725,1005,100,,Invoice,,,,,,19/07/2018,19/07/2018,0.00,,30.00,,"-652,394.57"
,IN,AR,30319753,1005,100,,Invoice,,,,,,19/07/2018,19/07/2018,0.00,,4.24,,"-652,398.81"
,IN,AR,30319765,1005,100,,Invoice,,,,,,19/07/2018,19/07/2018,0.00,,13.73,,"-652,412.54"
,IN,AR,30319772,1005,100,,Invoice,,,,,,19/07/2018,19/07/2018,0.00,,14.83,,"-652,427.37"
,IN,AR,30319781,1005,100,,Invoice,,,,,,19/07/2018,19/07/2018,0.00,,9.15,,"-652,436.52"
,IN,AR,30319782,1005,100,,Invoice,,,,,,19/07/2018,19/07/2018,0.00,,10.93,,"-652,447.45"
,IN,AR,30319787,1005,100,,Invoice,,,,,,19/07/2018,19/07/2018,0.00,,14.58,,"-652,462.03"
,IN,AR,30319790,1005,100,,Invoice,,,,,,19/07/2018,19/07/2018,0.00,,18.22,,"-652,480.25"
,IN,AR,30319795,1005,100,,Invoice,,,,,,19/07/2018,19/07/2018,0.00,,10.93,,"-652,491.18"
,IN,AR,30319816,1005,100,,Invoice,,,,,,19/07/2018,19/07/2018,0.00,,6.97,,"-652,498.15"
,IN,AR,30319819,1005,100,,Invoice,,,,,,19/07/2018,19/07/2018,0.00,,8.77,,"-652,506.92"
,IN,AR,30319821,1005,100,,Invoice,,,,,,19/07/2018,19/07/2018,0.00,,21.86,,"-652,528.78"
,IN,AR,30319823,1005,100,,Invoice,,,,,,19/07/2018,19/07/2018,0.00,,30.30,,"-652,559.08"
,IN,AR,30319854,1005,100,,Invoice,,,,,,19/07/2018,19/07/2018,0.00,,11.64,,"-652,570.72"
,IN,AR,30319856,1005,100,,Invoice,,,,,,19/07/2018,19/07/2018,0.00,,10.17,,"-652,580.89"
,IN,AR,30319861,1005,100,,Invoice,,,,,,19/07/2018,19/07/2018,0.00,,14.19,,"-652,595.08"
,IN,AR,30319865,1005,100,,Invoice,,,,,,19/07/2018,19/07/2018,0.00,,14.00,,"-652,609.08"
,IN,AR,30319883,1005,100,,Invoice,,,,,,19/07/2018,19/07/2018,0.00,,3.53,,"-652,612.61"
,IN,AR,30319888,1005,100,,Invoice,,,,,,19/07/2018,19/07/2018,0.00,,3.64,,"-652,616.25"
,IN,AR,30319894,1005,100,,Invoice,,,,,,19/07/2018,19/07/2018,0.00,,6.81,,"-652,623.06"
,IN,AR,30319896,1005,100,,Invoice,,,,,,19/07/2018,19/07/2018,0.00,,10.98,,"-652,634.04"
,IN,AR,30319909,1005,100,,Invoice,,,,,,19/07/2018,19/07/2018,0.00,,182.20,,"-652,816.24"
,IN,AR,30319915,1005,100,,Invoice,,,,,,19/07/2018,19/07/2018,0.00,,8.78,,"-652,825.02"
,IN,AR,30319931,1005,100,,Invoice,,,,,,19/07/2018,19/07/2018,0.00,,10.93,,"-652,835.95"
,IN,AR,30319940,1005,100,,Invoice,,,,,,19/07/2018,19/07/2018,0.00,,9.96,,"-652,845.91"
,IN,AR,30319941,1005,100,,Invoice,,,,,,19/07/2018,19/07/2018,0.00,,9.96,,"-652,855.87"
,IN,AR,30319942,1005,100,,Invoice,,,,,,19/07/2018,19/07/2018,0.00,,3.98,,"-652,859.85"
,IN,AR,30319943,1005,100,,Invoice,,,,,,19/07/2018,19/07/2018,0.00,,15.93,,"-652,875.78"
,IN,AR,30319952,1005,100,,Invoice,,,,,,19/07/2018,19/07/2018,0.00,,23.85,,"-652,899.63"
,IN,AR,30319953,1005,100,,Invoice,,,,,,19/07/2018,19/07/2018,0.00,,17.49,,"-652,917.12"
,IN,AR,30319964,1005,100,,Invoice,,,,,,19/07/2018,19/07/2018,0.00,,224.08,,"-653,141.20"
,IN,AR,30319975,1005,100,,Invoice,,,,,,19/07/2018,19/07/2018,0.00,,36.44,,"-653,177.64"
,IN,AR,30319976,1005,100,,Invoice,,,,,,19/07/2018,19/07/2018,0.00,,7.29,,"-653,184.93"
,IN,AR,30319998,1005,100,,Invoice,,,,,,19/07/2018,19/07/2018,0.00,,22.88,,"-653,207.81"
,IN,AR,30320000,1005,100,,Invoice,,,,,,19/07/2018,19/07/2018,0.00,,6.56,,"-653,214.37"
,IN,AR,30320019,1005,100,,Invoice,,,,,,19/07/2018,19/07/2018,0.00,,45.76,,"-653,260.13"
,IN,AR,30320021,1005,100,,Invoice,,,,,,19/07/2018,19/07/2018,0.00,,20.01,,"-653,280.14"
,IN,AR,30320026,1005,100,,Invoice,,,,,,19/07/2018,19/07/2018,0.00,,8.00,,"-653,288.14"
,IN,AR,30320028,1005,100,,Invoice,,,,,,19/07/2018,19/07/2018,0.00,,28.01,,"-653,316.15"
,IN,AR,30320035,1005,100,,Invoice,,,,,,19/07/2018,19/07/2018,0.00,,17.49,,"-653,333.64"
,IN,AR,30320036,1005,100,,Invoice,,,,,,19/07/2018,19/07/2018,0.00,,14.58,,"-653,348.22"
,IN,AR,30320042,1005,100,,Invoice,,,,,,19/07/2018,19/07/2018,0.00,,7.29,,"-653,355.51"
,IN,AR,30320056,1005,100,,Invoice,,,,,,19/07/2018,19/07/2018,0.00,,21.03,,"-653,376.54"
,IN,AR,30320057,1005,100,,Invoice,,,,,,19/07/2018,19/07/2018,0.00,,12.62,,"-653,389.16"
,IN,AR,30320072,1005,100,,Invoice,,,,,,19/07/2018,19/07/2018,0.00,,14.58,,"-653,403.74"
,IN,AR,30320079,1005,100,,Invoice,,,,,,19/07/2018,19/07/2018,0.00,,8.42,,"-653,412.16"
,IN,AR,30320085,1005,100,,Invoice,,,,,,19/07/2018,19/07/2018,0.00,,20.59,,"-653,432.75"
,IN,AR,30320121,1005,100,,Invoice,,,,,,19/07/2018,19/07/2018,0.00,,81.15,,"-653,513.90"
,IN,AR,30320134,1005,100,,Invoice,,,,,,19/07/2018,19/07/2018,0.00,,3.19,,"-653,517.09"
,IN,AR,30320135,1005,100,,Invoice,,,,,,19/07/2018,19/07/2018,0.00,,109.93,,"-653,627.02"
,IN,AR,30320136,1005,100,,Invoice,,,,,,19/07/2018,19/07/2018,0.00,,20.71,,"-653,647.73"
,IN,AR,30320139,1005,100,,Invoice,,,,,,19/07/2018,19/07/2018,0.00,,15.21,,"-653,662.94"
,IN,AR,30320152,1005,100,,Invoice,,,,,,19/07/2018,19/07/2018,0.00,,28.47,,"-653,691.41"
,IN,AR,30320177,1005,100,,Invoice,,,,,,19/07/2018,19/07/2018,0.00,,14.58,,"-653,705.99"
,IN,AR,30320194,1005,100,,Invoice,,,,,,19/07/2018,19/07/2018,0.00,,7.29,,"-653,713.28"
,IN,AR,30320197,1005,100,,Invoice,,,,,,19/07/2018,19/07/2018,0.00,,18.20,,"-653,731.48"
,IN,AR,30320200,1005,100,,Invoice,,,,,,19/07/2018,19/07/2018,0.00,,18.22,,"-653,749.70"
,IN,AR,30320211,1005,100,,Invoice,,,,,,19/07/2018,19/07/2018,0.00,,77.61,,"-653,827.31"
,IN,AR,30320213,1005,100,,Invoice,,,,,,19/07/2018,19/07/2018,0.00,,6.13,,"-653,833.44"
,IN,AR,30320222,1005,100,,Invoice,,,,,,19/07/2018,19/07/2018,0.00,,182.20,,"-654,015.64"
,IN,AR,30320225,1005,100,,Invoice,,,,,,19/07/2018,19/07/2018,0.00,,29.15,,"-654,044.79"
,IN,AR,30320229,1005,100,,Invoice,,,,,,19/07/2018,19/07/2018,0.00,,54.66,,"-654,099.45"
,IN,AR,30320243,1005,100,,Invoice,,,,,,19/07/2018,19/07/2018,0.00,,7.25,,"-654,106.70"
,IN,AR,30320247,1005,100,,Invoice,,,,,,19/07/2018,19/07/2018,0.00,,3.64,,"-654,110.34"
,IN,AR,30320270,1005,100,,Invoice,,,,,,19/07/2018,19/07/2018,0.00,,31.14,,"-654,141.48"
,IN,AR,30320271,1005,100,,Invoice,,,,,,19/07/2018,19/07/2018,0.00,,70.59,,"-654,212.07"
,IN,AR,30320276,1005,100,,Invoice,,,,,,19/07/2018,19/07/2018,0.00,,2.54,,"-654,214.61"
,IN,AR,30320288,1005,100,,Invoice,,,,,,19/07/2018,19/07/2018,0.00,,12.08,,"-654,226.69"
,IN,AR,30320304,1005,100,,Invoice,,,,,,19/07/2018,19/07/2018,0.00,,29.15,,"-654,255.84"
,CN,AR,31018467,1005,100,,Credit Note,,,,,,20/07/2018,20/07/2018,7.29,,0.00,,"-654,248.55"
,CN,AR,31018473,1005,100,,Credit Note,,,,,,20/07/2018,20/07/2018,"2,343.05",,0.00,,"-651,905.50"
,CS,AR,32006560,1005,100,,Cash sale,,,,,,20/07/2018,20/07/2018,0.00,,14.58,,"-651,920.08"
,CS,AR,32006563,1005,100,,Cash sale,,,,,,20/07/2018,20/07/2018,0.00,,11.22,,"-651,931.30"
,CS,AR,32006573,1005,100,,Cash sale,,,,,,20/07/2018,20/07/2018,0.00,,11.36,,"-651,942.66"
,CS,AR,32006577,1005,100,,Cash sale,,,,,,20/07/2018,20/07/2018,0.00,,6.08,,"-651,948.74"
,CS,AR,32006581,1005,100,,Cash sale,,,,,,20/07/2018,20/07/2018,0.00,,10.93,,"-651,959.67"
,CS,AR,32006582,1005,100,,Cash sale,,,,,,20/07/2018,20/07/2018,0.00,,7.29,,"-651,966.96"
,CS,AR,32006587,1005,100,,Cash sale,,,,,,20/07/2018,20/07/2018,0.00,,14.58,,"-651,981.54"
,CS,AR,32006605,1005,100,,Cash sale,,,,,,20/07/2018,20/07/2018,0.00,,72.20,,"-652,053.74"
,CS,AR,32006609,1005,100,,Cash sale,,,,,,20/07/2018,20/07/2018,0.00,,12.08,,"-652,065.82"
,CS,AR,32006613,1005,100,,Cash sale,,,,,,20/07/2018,20/07/2018,0.00,,18.22,,"-652,084.04"
,CS,AR,32006619,1005,100,,Cash sale,,,,,,20/07/2018,20/07/2018,0.00,,14.58,,"-652,098.62"
,CS,AR,32006621,1005,100,,Cash sale,,,,,,20/07/2018,20/07/2018,0.00,,14.53,,"-652,113.15"
,CS,AR,32006627,1005,100,,Cash sale,,,,,,20/07/2018,20/07/2018,0.00,,7.29,,"-652,120.44"
,CS,AR,32006628,1005,100,,Cash sale,,,,,,20/07/2018,20/07/2018,0.00,,3.64,,"-652,124.08"
,CS,AR,32006635,1005,100,,Cash sale,,,,,,20/07/2018,20/07/2018,0.00,,3.64,,"-652,127.72"
,CS,AR,32006645,1005,100,,Cash sale,,,,,,20/07/2018,20/07/2018,0.00,,8.39,,"-652,136.11"
,CS,AR,32006649,1005,100,,Cash sale,,,,,,20/07/2018,20/07/2018,0.00,,9.03,,"-652,145.14"
,CS,AR,32006653,1005,100,,Cash sale,,,,,,20/07/2018,20/07/2018,0.00,,10.93,,"-652,156.07"
,CS,AR,32006666,1005,100,,Cash sale,,,,,,20/07/2018,20/07/2018,0.00,,7.29,,"-652,163.36"
,CS,AR,32006673,1005,100,,Cash sale,,,,,,20/07/2018,20/07/2018,0.00,,12.03,,"-652,175.39"
,CS,AR,32006681,1005,100,,Cash sale,,,,,,20/07/2018,20/07/2018,0.00,,25.51,,"-652,200.90"
,CS,AR,32006684,1005,100,,Cash sale,,,,,,20/07/2018,20/07/2018,0.00,,2.58,,"-652,203.48"
,CS,AR,32006688,1005,100,,Cash sale,,,,,,20/07/2018,20/07/2018,0.00,,20.34,,"-652,223.82"
,CS,AR,32006701,1005,100,,Cash sale,,,,,,20/07/2018,20/07/2018,0.00,,7.29,,"-652,231.11"
,CS,AR,32006704,1005,100,,Cash sale,,,,,,20/07/2018,20/07/2018,0.00,,82.43,,"-652,313.54"
,CS,AR,32006740,1005,100,,Cash sale,,,,,,20/07/2018,20/07/2018,0.00,,14.58,,"-652,328.12"
,CS,AR,32006741,1005,100,,Cash sale,,,,,,20/07/2018,20/07/2018,0.00,,29.24,,"-652,357.36"
,CS,AR,32006743,1005,100,,Cash sale,,,,,,20/07/2018,20/07/2018,0.00,,6.74,,"-652,364.10"
,CS,AR,32006745,1005,100,,Cash sale,,,,,,20/07/2018,20/07/2018,0.00,,6.02,,"-652,370.12"
,CS,AR,32006753,1005,100,,Cash sale,,,,,,20/07/2018,20/07/2018,0.00,,14.58,,"-652,384.70"
,CS,AR,32006773,1005,100,,Cash sale,,,,,,20/07/2018,20/07/2018,0.00,,3.64,,"-652,388.34"
,CS,AR,32006776,1005,100,,Cash sale,,,,,,20/07/2018,20/07/2018,0.00,,10.93,,"-652,399.27"
,CS,AR,32006804,1005,100,,Cash sale,,,,,,20/07/2018,20/07/2018,0.00,,21.86,,"-652,421.13"
,CS,AR,32006813,1005,100,,Cash sale,,,,,,20/07/2018,20/07/2018,0.00,,14.58,,"-652,435.71"
,CS,AR,32006815,1005,100,,Cash sale,,,,,,20/07/2018,20/07/2018,0.00,,6.02,,"-652,441.73"
,CS,AR,32006819,1005,100,,Cash sale,,,,,,20/07/2018,20/07/2018,0.00,,29.26,,"-652,470.99"
,CS,AR,32006838,1005,100,,Cash sale,,,,,,20/07/2018,20/07/2018,0.00,,10.34,,"-652,481.33"
,CS,AR,32006853,1005,100,,Cash sale,,,,,,20/07/2018,20/07/2018,0.00,,7.29,,"-652,488.62"
,CS,AR,32006872,1005,100,,Cash sale,,,,,,20/07/2018,20/07/2018,0.00,,15.25,,"-652,503.87"
,CS,AR,32006879,1005,100,,Cash sale,,,,,,20/07/2018,20/07/2018,0.00,,7.29,,"-652,511.16"
,CS,AR,32006888,1005,100,,Cash sale,,,,,,20/07/2018,20/07/2018,0.00,,3.64,,"-652,514.80"
,CS,AR,32006890,1005,100,,Cash sale,,,,,,20/07/2018,20/07/2018,0.00,,21.86,,"-652,536.66"
,CS,AR,32006894,1005,100,,Cash sale,,,,,,20/07/2018,20/07/2018,0.00,,12.03,,"-652,548.69"
,CS,AR,32006908,1005,100,,Cash sale,,,,,,20/07/2018,20/07/2018,0.00,,9.15,,"-652,557.84"
,CS,AR,32006913,1005,100,,Cash sale,,,,,,20/07/2018,20/07/2018,0.00,,29.15,,"-652,586.99"
,CS,AR,32006914,1005,100,,Cash sale,,,,,,20/07/2018,20/07/2018,0.00,,10.93,,"-652,597.92"
,CS,AR,32006934,1005,100,,Cash sale,,,,,,20/07/2018,20/07/2018,0.00,,24.29,,"-652,622.21"
,CS,AR,32006939,1005,100,,Cash sale,,,,,,20/07/2018,20/07/2018,0.00,,7.29,,"-652,629.50"
,CS,AR,32006943,1005,100,,Cash sale,,,,,,20/07/2018,20/07/2018,0.00,,7.29,,"-652,636.79"
,CS,AR,32006947,1005,100,,Cash sale,,,,,,20/07/2018,20/07/2018,0.00,,5.08,,"-652,641.87"
,CS,AR,32006949,1005,100,,Cash sale,,,,,,20/07/2018,20/07/2018,0.00,,3.64,,"-652,645.51"
,CS,AR,32006951,1005,100,,Cash sale,,,,,,20/07/2018,20/07/2018,0.00,,6.10,,"-652,651.61"
,CS,AR,32006958,1005,100,,Cash sale,,,,,,20/07/2018,20/07/2018,0.00,,4.15,,"-652,655.76"
,CS,AR,32006961,1005,100,,Cash sale,,,,,,20/07/2018,20/07/2018,0.00,,29.15,,"-652,684.91"
,CS,AR,32006978,1005,100,,Cash sale,,,,,,20/07/2018,20/07/2018,0.00,,7.29,,"-652,692.20"
,CS,AR,32006984,1005,100,,Cash sale,,,,,,20/07/2018,20/07/2018,0.00,,10.93,,"-652,703.13"
,CS,AR,32006988,1005,100,,Cash sale,,,,,,20/07/2018,20/07/2018,0.00,,10.93,,"-652,714.06"
,CS,AR,32006989,1005,100,,Cash sale,,,,,,20/07/2018,20/07/2018,0.00,,182.20,,"-652,896.26"
,CS,AR,32006995,1005,100,,Cash sale,,,,,,20/07/2018,20/07/2018,0.00,,3.64,,"-652,899.90"
,CS,AR,32006999,1005,100,,Cash sale,,,,,,20/07/2018,20/07/2018,0.00,,18.22,,"-652,918.12"
,CS,AR,32007005,1005,100,,Cash sale,,,,,,20/07/2018,20/07/2018,0.00,,6.02,,"-652,924.14"
,CS,AR,32007008,1005,100,,Cash sale,,,,,,20/07/2018,20/07/2018,0.00,,7.29,,"-652,931.43"
,CS,AR,32007024,1005,100,,Cash sale,,,,,,20/07/2018,20/07/2018,0.00,,4.66,,"-652,936.09"
,CS,AR,32007028,1005,100,,Cash sale,,,,,,20/07/2018,20/07/2018,0.00,,6.07,,"-652,942.16"
,CS,AR,32007032,1005,100,,Cash sale,,,,,,20/07/2018,20/07/2018,0.00,,18.22,,"-652,960.38"
,CS,AR,32007045,1005,100,,Cash sale,,,,,,20/07/2018,20/07/2018,0.00,,10.93,,"-652,971.31"
,IN,AR,30320361,1005,100,,Invoice,,,,,,20/07/2018,20/07/2018,0.00,,5.93,,"-652,977.24"
,IN,AR,30320362,1005,100,,Invoice,,,,,,20/07/2018,20/07/2018,0.00,,17.80,,"-652,995.04"
,IN,AR,30320370,1005,100,,Invoice,,,,,,20/07/2018,20/07/2018,0.00,,40.08,,"-653,035.12"
,IN,AR,30320376,1005,100,,Invoice,,,,,,20/07/2018,20/07/2018,0.00,,19.58,,"-653,054.70"
,IN,AR,30320377,1005,100,,Invoice,,,,,,20/07/2018,20/07/2018,0.00,,14.58,,"-653,069.28"
,IN,AR,30320400,1005,100,,Invoice,,,,,,20/07/2018,20/07/2018,0.00,,11.86,,"-653,081.14"
,IN,AR,30320404,1005,100,,Invoice,,,,,,20/07/2018,20/07/2018,0.00,,25.51,,"-653,106.65"
,IN,AR,30320414,1005,100,,Invoice,,,,,,20/07/2018,20/07/2018,0.00,,9.66,,"-653,116.31"
,IN,AR,30320422,1005,100,,Invoice,,,,,,20/07/2018,20/07/2018,0.00,,48.61,,"-653,164.92"
,IN,AR,30320428,1005,100,,Invoice,,,,,,20/07/2018,20/07/2018,0.00,,3.64,,"-653,168.56"
,IN,AR,30320431,1005,100,,Invoice,,,,,,20/07/2018,20/07/2018,0.00,,25.26,,"-653,193.82"
,IN,AR,30320433,1005,100,,Invoice,,,,,,20/07/2018,20/07/2018,0.00,,100.92,,"-653,294.74"
,IN,AR,30320440,1005,100,,Invoice,,,,,,20/07/2018,20/07/2018,0.00,,30.85,,"-653,325.59"
,IN,AR,30320457,1005,100,,Invoice,,,,,,20/07/2018,20/07/2018,0.00,,10.93,,"-653,336.52"
,IN,AR,30320467,1005,100,,Invoice,,,,,,20/07/2018,20/07/2018,0.00,,10.93,,"-653,347.45"
,IN,AR,30320475,1005,100,,Invoice,,,,,,20/07/2018,20/07/2018,0.00,,10.00,,"-653,357.45"
,IN,AR,30320499,1005,100,,Invoice,,,,,,20/07/2018,20/07/2018,0.00,,9.73,,"-653,367.18"
,IN,AR,30320504,1005,100,,Invoice,,,,,,20/07/2018,20/07/2018,0.00,,4.75,,"-653,371.93"
,IN,AR,30320507,1005,100,,Invoice,,,,,,20/07/2018,20/07/2018,0.00,,18.00,,"-653,389.93"
,IN,AR,30320529,1005,100,,Invoice,,,,,,20/07/2018,20/07/2018,0.00,,7.29,,"-653,397.22"
,IN,AR,30320532,1005,100,,Invoice,,,,,,20/07/2018,20/07/2018,0.00,,17.47,,"-653,414.69"
,IN,AR,30320533,1005,100,,Invoice,,,,,,20/07/2018,20/07/2018,0.00,,9.70,,"-653,424.39"
,IN,AR,30320541,1005,100,,Invoice,,,,,,20/07/2018,20/07/2018,0.00,,40.00,,"-653,464.39"
,IN,AR,30320545,1005,100,,Invoice,,,,,,20/07/2018,20/07/2018,0.00,,3.64,,"-653,468.03"
,IN,AR,30320554,1005,100,,Invoice,,,,,,20/07/2018,20/07/2018,0.00,,21.86,,"-653,489.89"
,IN,AR,30320561,1005,100,,Invoice,,,,,,20/07/2018,20/07/2018,0.00,,23.29,,"-653,513.18"
,IN,AR,30320571,1005,100,,Invoice,,,,,,20/07/2018,20/07/2018,0.00,,3.64,,"-653,516.82"
,IN,AR,30320573,1005,100,,Invoice,,,,,,20/07/2018,20/07/2018,0.00,,3.19,,"-653,520.01"
,IN,AR,30320586,1005,100,,Invoice,,,,,,20/07/2018,20/07/2018,0.00,,7.75,,"-653,527.76"
,IN,AR,30320593,1005,100,,Invoice,,,,,,20/07/2018,20/07/2018,0.00,,4.64,,"-653,532.40"
,IN,AR,30320594,1005,100,,Invoice,,,,,,20/07/2018,20/07/2018,0.00,,2.32,,"-653,534.72"
,IN,AR,30320599,1005,100,,Invoice,,,,,,20/07/2018,20/07/2018,0.00,,7.19,,"-653,541.91"
,IN,AR,30320617,1005,100,,Invoice,,,,,,20/07/2018,20/07/2018,0.00,,61.02,,"-653,602.93"
,IN,AR,30320631,1005,100,,Invoice,,,,,,20/07/2018,20/07/2018,0.00,,42.37,,"-653,645.30"
,IN,AR,30320632,1005,100,,Invoice,,,,,,20/07/2018,20/07/2018,0.00,,33.60,,"-653,678.90"
,IN,AR,30320636,1005,100,,Invoice,,,,,,20/07/2018,20/07/2018,0.00,,4.78,,"-653,683.68"
,IN,AR,30320645,1005,100,,Invoice,,,,,,20/07/2018,20/07/2018,0.00,,13.98,,"-653,697.66"
,IN,AR,30320649,1005,100,,Invoice,,,,,,20/07/2018,20/07/2018,0.00,,6.02,,"-653,703.68"
,IN,AR,30320660,1005,100,,Invoice,,,,,,20/07/2018,20/07/2018,0.00,,79.98,,"-653,783.66"
,IN,AR,30320671,1005,100,,Invoice,,,,,,20/07/2018,20/07/2018,0.00,,9.56,,"-653,793.22"
,IN,AR,30320685,1005,100,,Invoice,,,,,,20/07/2018,20/07/2018,0.00,,10.93,,"-653,804.15"
,IN,AR,30320694,1005,100,,Invoice,,,,,,20/07/2018,20/07/2018,0.00,,28.71,,"-653,832.86"
,IN,AR,30320710,1005,100,,Invoice,,,,,,20/07/2018,20/07/2018,0.00,,4.24,,"-653,837.10"
,IN,AR,30320716,1005,100,,Invoice,,,,,,20/07/2018,20/07/2018,0.00,,5.08,,"-653,842.18"
,IN,AR,30320717,1005,100,,Invoice,,,,,,20/07/2018,20/07/2018,0.00,,10.17,,"-653,852.35"
,IN,AR,30320718,1005,100,,Invoice,,,,,,20/07/2018,20/07/2018,0.00,,10.17,,"-653,862.52"
,IN,AR,30320724,1005,100,,Invoice,,,,,,20/07/2018,20/07/2018,0.00,,7.63,,"-653,870.15"
,IN,AR,30320732,1005,100,,Invoice,,,,,,20/07/2018,20/07/2018,0.00,,45.13,,"-653,915.28"
,IN,AR,30320736,1005,100,,Invoice,,,,,,20/07/2018,20/07/2018,0.00,,20.34,,"-653,935.62"
,IN,AR,30320741,1005,100,,Invoice,,,,,,20/07/2018,20/07/2018,0.00,,6.36,,"-653,941.98"
,IN,AR,30320743,1005,100,,Invoice,,,,,,20/07/2018,20/07/2018,0.00,,12.71,,"-653,954.69"
,IN,AR,30320751,1005,100,,Invoice,,,,,,20/07/2018,20/07/2018,0.00,,11.19,,"-653,965.88"
,IN,AR,30320779,1005,100,,Invoice,,,,,,20/07/2018,20/07/2018,0.00,,7.29,,"-653,973.17"
,IN,AR,30320787,1005,100,,Invoice,,,,,,20/07/2018,20/07/2018,0.00,,10.59,,"-653,983.76"
,IN,AR,30320795,1005,100,,Invoice,,,,,,20/07/2018,20/07/2018,0.00,,19.07,,"-654,002.83"
,IN,AR,30320809,1005,100,,Invoice,,,,,,20/07/2018,20/07/2018,0.00,,14.03,,"-654,016.86"
,IN,AR,30320827,1005,100,,Invoice,,,,,,20/07/2018,20/07/2018,0.00,,6.36,,"-654,023.22"
,IN,AR,30320832,1005,100,,Invoice,,,,,,20/07/2018,20/07/2018,0.00,,10.59,,"-654,033.81"
,IN,AR,30320862,1005,100,,Invoice,,,,,,20/07/2018,20/07/2018,0.00,,5.17,,"-654,038.98"
,IN,AR,30320912,1005,100,,Invoice,,,,,,20/07/2018,20/07/2018,0.00,,14.58,,"-654,053.56"
,IN,AR,30320913,1005,100,,Invoice,,,,,,20/07/2018,20/07/2018,0.00,,29.15,,"-654,082.71"
,IN,AR,30320914,1005,100,,Invoice,,,,,,20/07/2018,20/07/2018,0.00,,1.76,,"-654,084.47"
,IN,AR,30320926,1005,100,,Invoice,,,,,,20/07/2018,20/07/2018,0.00,,10.93,,"-654,095.40"
,IN,AR,30320928,1005,100,,Invoice,,,,,,20/07/2018,20/07/2018,0.00,,4.85,,"-654,100.25"
,IN,AR,30320945,1005,100,,Invoice,,,,,,20/07/2018,20/07/2018,0.00,,32.80,,"-654,133.05"
,IN,AR,30320948,1005,100,,Invoice,,,,,,20/07/2018,20/07/2018,0.00,,6.02,,"-654,139.07"
,IN,AR,30320965,1005,100,,Invoice,,,,,,20/07/2018,20/07/2018,0.00,,18.22,,"-654,157.29"
,IN,AR,30320967,1005,100,,Invoice,,,,,,20/07/2018,20/07/2018,0.00,,10.20,,"-654,167.49"
,IN,AR,30320968,1005,100,,Invoice,,,,,,20/07/2018,20/07/2018,0.00,,16.88,,"-654,184.37"
,IN,AR,30320980,1005,100,,Invoice,,,,,,20/07/2018,20/07/2018,0.00,,15.90,,"-654,200.27"
,IN,AR,30320992,1005,100,,Invoice,,,,,,20/07/2018,20/07/2018,0.00,,36.91,,"-654,237.18"
,IN,AR,30320997,1005,100,,Invoice,,,,,,20/07/2018,20/07/2018,0.00,,70.00,,"-654,307.18"
,IN,AR,30320998,1005,100,,Invoice,,,,,,20/07/2018,20/07/2018,0.00,,28.81,,"-654,335.99"
,IN,AR,30321007,1005,100,,Invoice,,,,,,20/07/2018,20/07/2018,0.00,,42.09,,"-654,378.08"
,IN,AR,30321014,1005,100,,Invoice,,,,,,20/07/2018,20/07/2018,0.00,,69.41,,"-654,447.49"
,IN,AR,30321018,1005,100,,Invoice,,,,,,20/07/2018,20/07/2018,0.00,,21.25,,"-654,468.74"
,IN,AR,30321022,1005,100,,Invoice,,,,,,20/07/2018,20/07/2018,0.00,,12.03,,"-654,480.77"
,IN,AR,30321027,1005,100,,Invoice,,,,,,20/07/2018,20/07/2018,0.00,,21.61,,"-654,502.38"
,IN,AR,30321033,1005,100,,Invoice,,,,,,20/07/2018,20/07/2018,0.00,,21.86,,"-654,524.24"
,IN,AR,30321037,1005,100,,Invoice,,,,,,20/07/2018,20/07/2018,0.00,,36.43,,"-654,560.67"
,IN,AR,30321038,1005,100,,Invoice,,,,,,20/07/2018,20/07/2018,0.00,,10.93,,"-654,571.60"
,IN,AR,30321040,1005,100,,Invoice,,,,,,20/07/2018,20/07/2018,0.00,,60.42,,"-654,632.02"
,IN,AR,30321050,1005,100,,Invoice,,,,,,20/07/2018,20/07/2018,0.00,,18.22,,"-654,650.24"
,IN,AR,30321054,1005,100,,Invoice,,,,,,20/07/2018,20/07/2018,0.00,,18.22,,"-654,668.46"
,IN,AR,30321058,1005,100,,Invoice,,,,,,20/07/2018,20/07/2018,0.00,,16.74,,"-654,685.20"
,IN,AR,30321064,1005,100,,Invoice,,,,,,20/07/2018,20/07/2018,0.00,,20.34,,"-654,705.54"
,IN,AR,30321071,1005,100,,Invoice,,,,,,20/07/2018,20/07/2018,0.00,,12.00,,"-654,717.54"
,IN,AR,30321079,1005,100,,Invoice,,,,,,20/07/2018,20/07/2018,0.00,,14.00,,"-654,731.54"
,IN,AR,30321080,1005,100,,Invoice,,,,,,20/07/2018,20/07/2018,0.00,,40.01,,"-654,771.55"
,IN,AR,30321104,1005,100,,Invoice,,,,,,20/07/2018,20/07/2018,0.00,,32.85,,"-654,804.40"
,IN,AR,30321106,1005,100,,Invoice,,,,,,20/07/2018,20/07/2018,0.00,,4.20,,"-654,808.60"
,IN,AR,30321107,1005,100,,Invoice,,,,,,20/07/2018,20/07/2018,0.00,,52.57,,"-654,861.17"
,IN,AR,30321131,1005,100,,Invoice,,,,,,20/07/2018,20/07/2018,0.00,,9.19,,"-654,870.36"
,IN,AR,30321133,1005,100,,Invoice,,,,,,20/07/2018,20/07/2018,0.00,,7.29,,"-654,877.65"
,IN,AR,30321158,1005,100,,Invoice,,,,,,20/07/2018,20/07/2018,0.00,,25.51,,"-654,903.16"
,IN,AR,30321161,1005,100,,Invoice,,,,,,20/07/2018,20/07/2018,0.00,,14.19,,"-654,917.35"
,IN,AR,30321163,1005,100,,Invoice,,,,,,20/07/2018,20/07/2018,0.00,,14.49,,"-654,931.84"
,IN,AR,30321199,1005,100,,Invoice,,,,,,20/07/2018,20/07/2018,0.00,,24.00,,"-654,955.84"
,IN,AR,30321219,1005,100,,Invoice,,,,,,20/07/2018,20/07/2018,0.00,,15.25,,"-654,971.09"
,IN,AR,30321238,1005,100,,Invoice,,,,,,20/07/2018,20/07/2018,0.00,,2.92,,"-654,974.01"
,IN,AR,30321244,1005,100,,Invoice,,,,,,20/07/2018,20/07/2018,0.00,,10.95,,"-654,984.96"
,IN,AR,30321252,1005,100,,Invoice,,,,,,20/07/2018,20/07/2018,0.00,,50.85,,"-655,035.81"
,IN,AR,30321261,1005,100,,Invoice,,,,,,20/07/2018,20/07/2018,0.00,,76.06,,"-655,111.87"
,IN,AR,30321269,1005,100,,Invoice,,,,,,20/07/2018,20/07/2018,0.00,,8.17,,"-655,120.04"
,IN,AR,30321291,1005,100,,Invoice,,,,,,20/07/2018,20/07/2018,0.00,,5.51,,"-655,125.55"
,IN,AR,30321307,1005,100,,Invoice,,,,,,20/07/2018,20/07/2018,0.00,,7.29,,"-655,132.84"
,IN,AR,30321310,1005,100,,Invoice,,,,,,20/07/2018,20/07/2018,0.00,,6.00,,"-655,138.84"
,IN,AR,30321317,1005,100,,Invoice,,,,,,20/07/2018,20/07/2018,0.00,,6.23,,"-655,145.07"
,IN,AR,30321318,1005,100,,Invoice,,,,,,20/07/2018,20/07/2018,0.00,,12.46,,"-655,157.53"
,IN,AR,30321319,1005,100,,Invoice,,,,,,20/07/2018,20/07/2018,0.00,,12.46,,"-655,169.99"
,IN,AR,30321362,1005,100,,Invoice,,,,,,20/07/2018,20/07/2018,0.00,,19.66,,"-655,189.65"
,IN,AR,30321365,1005,100,,Invoice,,,,,,20/07/2018,20/07/2018,0.00,,20.16,,"-655,209.81"
,IN,AR,30321366,1005,100,,Invoice,,,,,,20/07/2018,20/07/2018,0.00,,30.34,,"-655,240.15"
,IN,AR,30321370,1005,100,,Invoice,,,,,,20/07/2018,20/07/2018,0.00,,18.22,,"-655,258.37"
,IN,AR,30321375,1005,100,,Invoice,,,,,,20/07/2018,20/07/2018,0.00,,6.56,,"-655,264.93"
,IN,AR,30321382,1005,100,,Invoice,,,,,,20/07/2018,20/07/2018,0.00,,10.93,,"-655,275.86"
,IN,AR,30321385,1005,100,,Invoice,,,,,,20/07/2018,20/07/2018,0.00,,29.15,,"-655,305.01"
,IN,AR,30321399,1005,100,,Invoice,,,,,,20/07/2018,20/07/2018,0.00,,7.29,,"-655,312.30"
,IN,AR,30321414,1005,100,,Invoice,,,,,,20/07/2018,20/07/2018,0.00,,14.58,,"-655,326.88"
,IN,AR,30321420,1005,100,,Invoice,,,,,,20/07/2018,20/07/2018,0.00,,29.15,,"-655,356.03"
,IN,AR,30321423,1005,100,,Invoice,,,,,,20/07/2018,20/07/2018,0.00,,419.07,,"-655,775.10"
,CN,AR,31018433,1005,100,,Credit Note,,,,,,21/07/2018,21/07/2018,3.64,,0.00,,"-655,771.46"
,CN,AR,31018441,1005,100,,Credit Note,,,,,,21/07/2018,21/07/2018,5.17,,0.00,,"-655,766.29"
,CN,AR,31018456,1005,100,,Credit Note,,,,,,21/07/2018,21/07/2018,18.22,,0.00,,"-655,748.07"
,CN,AR,31018458,1005,100,,Credit Note,,,,,,21/07/2018,21/07/2018,18.22,,0.00,,"-655,729.85"
,CN,AR,31018460,1005,100,,Credit Note,,,,,,21/07/2018,21/07/2018,7.29,,0.00,,"-655,722.56"
,CN,AR,31018472,1005,100,,Credit Note,,,,,,21/07/2018,21/07/2018,10.93,,0.00,,"-655,711.63"
,CN,AR,31018477,1005,100,,Credit Note,,,,,,21/07/2018,21/07/2018,10.93,,0.00,,"-655,700.70"
,CN,AR,31018490,1005,100,,Credit Note,,,,,,21/07/2018,21/07/2018,7.29,,0.00,,"-655,693.41"
,CN,AR,31018491,1005,100,,Credit Note,,,,,,21/07/2018,21/07/2018,7.29,,0.00,,"-655,686.12"
,CS,AR,32006580,1005,100,,Cash sale,,,,,,21/07/2018,21/07/2018,0.00,,3.01,,"-655,689.13"
,CS,AR,32006608,1005,100,,Cash sale,,,,,,21/07/2018,21/07/2018,0.00,,7.29,,"-655,696.42"
,CS,AR,32006751,1005,100,,Cash sale,,,,,,21/07/2018,21/07/2018,0.00,,10.21,,"-655,706.63"
,CS,AR,32006866,1005,100,,Cash sale,,,,,,21/07/2018,21/07/2018,0.00,,3.64,,"-655,710.27"
,CS,AR,32006924,1005,100,,Cash sale,,,,,,21/07/2018,21/07/2018,0.00,,3.64,,"-655,713.91"
,CS,AR,32006955,1005,100,,Cash sale,,,,,,21/07/2018,21/07/2018,0.00,,10.93,,"-655,724.84"
,CS,AR,32006964,1005,100,,Cash sale,,,,,,21/07/2018,21/07/2018,0.00,,37.90,,"-655,762.74"
,CS,AR,32006975,1005,100,,Cash sale,,,,,,21/07/2018,21/07/2018,0.00,,10.93,,"-655,773.67"
,CS,AR,32006993,1005,100,,Cash sale,,,,,,21/07/2018,21/07/2018,0.00,,18.22,,"-655,791.89"
,CS,AR,32007042,1005,100,,Cash sale,,,,,,21/07/2018,21/07/2018,0.00,,7.29,,"-655,799.18"
,IN,AR,30320363,1005,100,,Invoice,,,,,,21/07/2018,21/07/2018,0.00,,88.98,,"-655,888.16"
,IN,AR,30320441,1005,100,,Invoice,,,,,,21/07/2018,21/07/2018,0.00,,28.47,,"-655,916.63"
,IN,AR,30320522,1005,100,,Invoice,,,,,,21/07/2018,21/07/2018,0.00,,29.15,,"-655,945.78"
,IN,AR,30320539,1005,100,,Invoice,,,,,,21/07/2018,21/07/2018,0.00,,10.93,,"-655,956.71"
,IN,AR,30320750,1005,100,,Invoice,,,,,,21/07/2018,21/07/2018,0.00,,7.29,,"-655,964.00"
,IN,AR,30320824,1005,100,,Invoice,,,,,,21/07/2018,21/07/2018,0.00,,12.88,,"-655,976.88"
,IN,AR,30320826,1005,100,,Invoice,,,,,,21/07/2018,21/07/2018,0.00,,3.64,,"-655,980.52"
,IN,AR,30320876,1005,100,,Invoice,,,,,,21/07/2018,21/07/2018,0.00,,10.93,,"-655,991.45"
,IN,AR,30320905,1005,100,,Invoice,,,,,,21/07/2018,21/07/2018,0.00,,5.17,,"-655,996.62"
,IN,AR,30320910,1005,100,,Invoice,,,,,,21/07/2018,21/07/2018,0.00,,25.51,,"-656,022.13"
,IN,AR,30321047,1005,100,,Invoice,,,,,,21/07/2018,21/07/2018,0.00,,18.22,,"-656,040.35"
,IN,AR,30321055,1005,100,,Invoice,,,,,,21/07/2018,21/07/2018,0.00,,18.22,,"-656,058.57"
,IN,AR,30321062,1005,100,,Invoice,,,,,,21/07/2018,21/07/2018,0.00,,7.29,,"-656,065.86"
,IN,AR,30321248,1005,100,,Invoice,,,,,,21/07/2018,21/07/2018,0.00,,182.20,,"-656,248.06"
,IN,AR,30321303,1005,100,,Invoice,,,,,,21/07/2018,21/07/2018,0.00,,15.18,,"-656,263.24"
,IN,AR,30321380,1005,100,,Invoice,,,,,,21/07/2018,21/07/2018,0.00,,10.93,,"-656,274.17"
,IN,AR,30321400,1005,100,,Invoice,,,,,,21/07/2018,21/07/2018,0.00,,7.29,,"-656,281.46"
,IN,AR,30321224,1005,100,,Invoice,,,,,,22/07/2018,22/07/2018,0.00,,54.66,,"-656,336.12"
,CN,AR,31018455,1005,100,,Credit Note,,,,,,23/07/2018,23/07/2018,68.31,,0.00,,"-656,267.81"
,CN,AR,31018493,1005,100,,Credit Note,,,,,,23/07/2018,23/07/2018,29.15,,0.00,,"-656,238.66"
,CS,AR,32006564,1005,100,,Cash sale,,,,,,23/07/2018,23/07/2018,0.00,,22.44,,"-656,261.10"
,CS,AR,32006585,1005,100,,Cash sale,,,,,,23/07/2018,23/07/2018,0.00,,10.93,,"-656,272.03"
,CS,AR,32006594,1005,100,,Cash sale,,,,,,23/07/2018,23/07/2018,0.00,,18.22,,"-656,290.25"
,CS,AR,32006601,1005,100,,Cash sale,,,,,,23/07/2018,23/07/2018,0.00,,3.64,,"-656,293.89"
,CS,AR,32006622,1005,100,,Cash sale,,,,,,23/07/2018,23/07/2018,0.00,,12.46,,"-656,306.35"
,CS,AR,32006631,1005,100,,Cash sale,,,,,,23/07/2018,23/07/2018,0.00,,7.29,,"-656,313.64"
,CS,AR,32006633,1005,100,,Cash sale,,,,,,23/07/2018,23/07/2018,0.00,,10.93,,"-656,324.57"
,CS,AR,32006638,1005,100,,Cash sale,,,,,,23/07/2018,23/07/2018,0.00,,14.58,,"-656,339.15"
,CS,AR,32006639,1005,100,,Cash sale,,,,,,23/07/2018,23/07/2018,0.00,,14.58,,"-656,353.73"
,CS,AR,32006646,1005,100,,Cash sale,,,,,,23/07/2018,23/07/2018,0.00,,7.29,,"-656,361.02"
,CS,AR,32006654,1005,100,,Cash sale,,,,,,23/07/2018,23/07/2018,0.00,,3.64,,"-656,364.66"
,CS,AR,32006659,1005,100,,Cash sale,,,,,,23/07/2018,23/07/2018,0.00,,3.64,,"-656,368.30"
,CS,AR,32006662,1005,100,,Cash sale,,,,,,23/07/2018,23/07/2018,0.00,,10.34,,"-656,378.64"
,CS,AR,32006679,1005,100,,Cash sale,,,,,,23/07/2018,23/07/2018,0.00,,7.29,,"-656,385.93"
,CS,AR,32006689,1005,100,,Cash sale,,,,,,23/07/2018,23/07/2018,0.00,,5.08,,"-656,391.01"
,CS,AR,32006697,1005,100,,Cash sale,,,,,,23/07/2018,23/07/2018,0.00,,3.64,,"-656,394.65"
,CS,AR,32006709,1005,100,,Cash sale,,,,,,23/07/2018,23/07/2018,0.00,,21.98,,"-656,416.63"
,CS,AR,32006712,1005,100,,Cash sale,,,,,,23/07/2018,23/07/2018,0.00,,12.86,,"-656,429.49"
,CS,AR,32006714,1005,100,,Cash sale,,,,,,23/07/2018,23/07/2018,0.00,,3.64,,"-656,433.13"
,CS,AR,32006727,1005,100,,Cash sale,,,,,,23/07/2018,23/07/2018,0.00,,10.93,,"-656,444.06"
,CS,AR,32006734,1005,100,,Cash sale,,,,,,23/07/2018,23/07/2018,0.00,,12.71,,"-656,456.77"
,CS,AR,32006746,1005,100,,Cash sale,,,,,,23/07/2018,23/07/2018,0.00,,4.75,,"-656,461.52"
,CS,AR,32006757,1005,100,,Cash sale,,,,,,23/07/2018,23/07/2018,0.00,,4.32,,"-656,465.84"
,CS,AR,32006767,1005,100,,Cash sale,,,,,,23/07/2018,23/07/2018,0.00,,14.58,,"-656,480.42"
,CS,AR,32006780,1005,100,,Cash sale,,,,,,23/07/2018,23/07/2018,0.00,,3.64,,"-656,484.06"
,CS,AR,32006784,1005,100,,Cash sale,,,,,,23/07/2018,23/07/2018,0.00,,2.54,,"-656,486.60"
,CS,AR,32006794,1005,100,,Cash sale,,,,,,23/07/2018,23/07/2018,0.00,,7.29,,"-656,493.89"
,CS,AR,32006799,1005,100,,Cash sale,,,,,,23/07/2018,23/07/2018,0.00,,15.51,,"-656,509.40"
,CS,AR,32006806,1005,100,,Cash sale,,,,,,23/07/2018,23/07/2018,0.00,,7.29,,"-656,516.69"
,CS,AR,32006808,1005,100,,Cash sale,,,,,,23/07/2018,23/07/2018,0.00,,7.29,,"-656,523.98"
,CS,AR,32006811,1005,100,,Cash sale,,,,,,23/07/2018,23/07/2018,0.00,,18.22,,"-656,542.20"
,CS,AR,32006829,1005,100,,Cash sale,,,,,,23/07/2018,23/07/2018,0.00,,3.64,,"-656,545.84"
,CS,AR,32006830,1005,100,,Cash sale,,,,,,23/07/2018,23/07/2018,0.00,,5.17,,"-656,551.01"
,CS,AR,32006833,1005,100,,Cash sale,,,,,,23/07/2018,23/07/2018,0.00,,7.29,,"-656,558.30"
,CS,AR,32006835,1005,100,,Cash sale,,,,,,23/07/2018,23/07/2018,0.00,,3.64,,"-656,561.94"
,CS,AR,32006836,1005,100,,Cash sale,,,,,,23/07/2018,23/07/2018,0.00,,3.20,,"-656,565.14"
,CS,AR,32006839,1005,100,,Cash sale,,,,,,23/07/2018,23/07/2018,0.00,,12.17,,"-656,577.31"
,CS,AR,32006851,1005,100,,Cash sale,,,,,,23/07/2018,23/07/2018,0.00,,3.64,,"-656,580.95"
,CS,AR,32006871,1005,100,,Cash sale,,,,,,23/07/2018,23/07/2018,0.00,,28.81,,"-656,609.76"
,CS,AR,32006873,1005,100,,Cash sale,,,,,,23/07/2018,23/07/2018,0.00,,12.71,,"-656,622.47"
,CS,AR,32006898,1005,100,,Cash sale,,,,,,23/07/2018,23/07/2018,0.00,,9.84,,"-656,632.31"
,CS,AR,32006900,1005,100,,Cash sale,,,,,,23/07/2018,23/07/2018,0.00,,7.29,,"-656,639.60"
,CS,AR,32006909,1005,100,,Cash sale,,,,,,23/07/2018,23/07/2018,0.00,,11.44,,"-656,651.04"
,CS,AR,32006916,1005,100,,Cash sale,,,,,,23/07/2018,23/07/2018,0.00,,10.93,,"-656,661.97"
,CS,AR,32006935,1005,100,,Cash sale,,,,,,23/07/2018,23/07/2018,0.00,,18.21,,"-656,680.18"
,CS,AR,32006969,1005,100,,Cash sale,,,,,,23/07/2018,23/07/2018,0.00,,7.29,,"-656,687.47"
,CS,AR,32006980,1005,100,,Cash sale,,,,,,23/07/2018,23/07/2018,0.00,,3.64,,"-656,691.11"
,CS,AR,32006990,1005,100,,Cash sale,,,,,,23/07/2018,23/07/2018,0.00,,14.58,,"-656,705.69"
,CS,AR,32007006,1005,100,,Cash sale,,,,,,23/07/2018,23/07/2018,0.00,,7.29,,"-656,712.98"
,CS,AR,32007029,1005,100,,Cash sale,,,,,,23/07/2018,23/07/2018,0.00,,3.03,,"-656,716.01"
,CS,AR,32007033,1005,100,,Cash sale,,,,,,23/07/2018,23/07/2018,0.00,,3.64,,"-656,719.65"
,IN,AR,30320364,1005,100,,Invoice,,,,,,23/07/2018,23/07/2018,0.00,,29.66,,"-656,749.31"
,IN,AR,30320365,1005,100,,Invoice,,,,,,23/07/2018,23/07/2018,0.00,,41.53,,"-656,790.84"
,IN,AR,30320372,1005,100,,Invoice,,,,,,23/07/2018,23/07/2018,0.00,,14.58,,"-656,805.42"
,IN,AR,30320384,1005,100,,Invoice,,,,,,23/07/2018,23/07/2018,0.00,,8.10,,"-656,813.52"
,IN,AR,30320385,1005,100,,Invoice,,,,,,23/07/2018,23/07/2018,0.00,,2.03,,"-656,815.55"
,IN,AR,30320386,1005,100,,Invoice,,,,,,23/07/2018,23/07/2018,0.00,,10.13,,"-656,825.68"
,IN,AR,30320387,1005,100,,Invoice,,,,,,23/07/2018,23/07/2018,0.00,,6.08,,"-656,831.76"
,IN,AR,30320388,1005,100,,Invoice,,,,,,23/07/2018,23/07/2018,0.00,,4.05,,"-656,835.81"
,IN,AR,30320389,1005,100,,Invoice,,,,,,23/07/2018,23/07/2018,0.00,,16.20,,"-656,852.01"
,IN,AR,30320390,1005,100,,Invoice,,,,,,23/07/2018,23/07/2018,0.00,,14.18,,"-656,866.19"
,IN,AR,30320401,1005,100,,Invoice,,,,,,23/07/2018,23/07/2018,0.00,,9.49,,"-656,875.68"
,IN,AR,30320413,1005,100,,Invoice,,,,,,23/07/2018,23/07/2018,0.00,,25.51,,"-656,901.19"
,IN,AR,30320423,1005,100,,Invoice,,,,,,23/07/2018,23/07/2018,0.00,,95.11,,"-656,996.30"
,IN,AR,30320429,1005,100,,Invoice,,,,,,23/07/2018,23/07/2018,0.00,,7.29,,"-657,003.59"
,IN,AR,30320442,1005,100,,Invoice,,,,,,23/07/2018,23/07/2018,0.00,,194.58,,"-657,198.17"
,IN,AR,30320468,1005,100,,Invoice,,,,,,23/07/2018,23/07/2018,0.00,,61.51,,"-657,259.68"
,IN,AR,30320474,1005,100,,Invoice,,,,,,23/07/2018,23/07/2018,0.00,,3.64,,"-657,263.32"
,IN,AR,30320476,1005,100,,Invoice,,,,,,23/07/2018,23/07/2018,0.00,,52.00,,"-657,315.32"
,IN,AR,30320477,1005,100,,Invoice,,,,,,23/07/2018,23/07/2018,0.00,,24.00,,"-657,339.32"
,IN,AR,30320478,1005,100,,Invoice,,,,,,23/07/2018,23/07/2018,0.00,,52.00,,"-657,391.32"
,IN,AR,30320487,1005,100,,Invoice,,,,,,23/07/2018,23/07/2018,0.00,,8.26,,"-657,399.58"
,IN,AR,30320488,1005,100,,Invoice,,,,,,23/07/2018,23/07/2018,0.00,,13.77,,"-657,413.35"
,IN,AR,30320489,1005,100,,Invoice,,,,,,23/07/2018,23/07/2018,0.00,,5.51,,"-657,418.86"
,IN,AR,30320491,1005,100,,Invoice,,,,,,23/07/2018,23/07/2018,0.00,,40.68,,"-657,459.54"
,IN,AR,30320493,1005,100,,Invoice,,,,,,23/07/2018,23/07/2018,0.00,,5.51,,"-657,465.05"
,IN,AR,30320503,1005,100,,Invoice,,,,,,23/07/2018,23/07/2018,0.00,,14.62,,"-657,479.67"
,IN,AR,30320508,1005,100,,Invoice,,,,,,23/07/2018,23/07/2018,0.00,,20.00,,"-657,499.67"
,IN,AR,30320512,1005,100,,Invoice,,,,,,23/07/2018,23/07/2018,0.00,,3.64,,"-657,503.31"
,IN,AR,30320542,1005,100,,Invoice,,,,,,23/07/2018,23/07/2018,0.00,,42.00,,"-657,545.31"
,IN,AR,30320558,1005,100,,Invoice,,,,,,23/07/2018,23/07/2018,0.00,,12.88,,"-657,558.19"
,IN,AR,30320566,1005,100,,Invoice,,,,,,23/07/2018,23/07/2018,0.00,,22.71,,"-657,580.90"
,IN,AR,30320568,1005,100,,Invoice,,,,,,23/07/2018,23/07/2018,0.00,,182.20,,"-657,763.10"
,IN,AR,30320581,1005,100,,Invoice,,,,,,23/07/2018,23/07/2018,0.00,,36.19,,"-657,799.29"
,IN,AR,30320588,1005,100,,Invoice,,,,,,23/07/2018,23/07/2018,0.00,,10.34,,"-657,809.63"
,IN,AR,30320603,1005,100,,Invoice,,,,,,23/07/2018,23/07/2018,0.00,,13.78,,"-657,823.41"
,IN,AR,30320615,1005,100,,Invoice,,,,,,23/07/2018,23/07/2018,0.00,,12.71,,"-657,836.12"
,IN,AR,30320618,1005,100,,Invoice,,,,,,23/07/2018,23/07/2018,0.00,,52.88,,"-657,889.00"
,IN,AR,30320633,1005,100,,Invoice,,,,,,23/07/2018,23/07/2018,0.00,,36.19,,"-657,925.19"
,IN,AR,30320641,1005,100,,Invoice,,,,,,23/07/2018,23/07/2018,0.00,,5.93,,"-657,931.12"
,IN,AR,30320661,1005,100,,Invoice,,,,,,23/07/2018,23/07/2018,0.00,,84.08,,"-658,015.20"
,IN,AR,30320666,1005,100,,Invoice,,,,,,23/07/2018,23/07/2018,0.00,,33.05,,"-658,048.25"
,IN,AR,30320672,1005,100,,Invoice,,,,,,23/07/2018,23/07/2018,0.00,,23.90,,"-658,072.15"
,IN,AR,30320673,1005,100,,Invoice,,,,,,23/07/2018,23/07/2018,0.00,,21.51,,"-658,093.66"
,IN,AR,30320680,1005,100,,Invoice,,,,,,23/07/2018,23/07/2018,0.00,,28.98,,"-658,122.64"
,IN,AR,30320687,1005,100,,Invoice,,,,,,23/07/2018,23/07/2018,0.00,,15.04,,"-658,137.68"
,IN,AR,30320691,1005,100,,Invoice,,,,,,23/07/2018,23/07/2018,0.00,,4.24,,"-658,141.92"
,IN,AR,30320695,1005,100,,Invoice,,,,,,23/07/2018,23/07/2018,0.00,,9.03,,"-658,150.95"
,IN,AR,30320697,1005,100,,Invoice,,,,,,23/07/2018,23/07/2018,0.00,,10.93,,"-658,161.88"
,IN,AR,30320712,1005,100,,Invoice,,,,,,23/07/2018,23/07/2018,0.00,,6.02,,"-658,167.90"
,IN,AR,30320719,1005,100,,Invoice,,,,,,23/07/2018,23/07/2018,0.00,,10.17,,"-658,178.07"
,IN,AR,30320733,1005,100,,Invoice,,,,,,23/07/2018,23/07/2018,0.00,,27.08,,"-658,205.15"
,IN,AR,30320740,1005,100,,Invoice,,,,,,23/07/2018,23/07/2018,0.00,,8.47,,"-658,213.62"
,IN,AR,30320758,1005,100,,Invoice,,,,,,23/07/2018,23/07/2018,0.00,,33.05,,"-658,246.67"
,IN,AR,30320764,1005,100,,Invoice,,,,,,23/07/2018,23/07/2018,0.00,,22.37,,"-658,269.04"
,IN,AR,30320782,1005,100,,Invoice,,,,,,23/07/2018,23/07/2018,0.00,,14.58,,"-658,283.62"
,IN,AR,30320798,1005,100,,Invoice,,,,,,23/07/2018,23/07/2018,0.00,,8.26,,"-658,291.88"
,IN,AR,30320800,1005,100,,Invoice,,,,,,23/07/2018,23/07/2018,0.00,,7.29,,"-658,299.17"
,IN,AR,30320807,1005,100,,Invoice,,,,,,23/07/2018,23/07/2018,0.00,,11.48,,"-658,310.65"
,IN,AR,30320810,1005,100,,Invoice,,,,,,23/07/2018,23/07/2018,0.00,,28.05,,"-658,338.70"
,IN,AR,30320813,1005,100,,Invoice,,,,,,23/07/2018,23/07/2018,0.00,,18.39,,"-658,357.09"
,IN,AR,30320831,1005,100,,Invoice,,,,,,23/07/2018,23/07/2018,0.00,,16.95,,"-658,374.04"
,IN,AR,30320835,1005,100,,Invoice,,,,,,23/07/2018,23/07/2018,0.00,,182.20,,"-658,556.24"
,IN,AR,30320838,1005,100,,Invoice,,,,,,23/07/2018,23/07/2018,0.00,,65.90,,"-658,622.14"
,IN,AR,30320843,1005,100,,Invoice,,,,,,23/07/2018,23/07/2018,0.00,,32.00,,"-658,654.14"
,IN,AR,30320863,1005,100,,Invoice,,,,,,23/07/2018,23/07/2018,0.00,,7.75,,"-658,661.89"
,IN,AR,30320871,1005,100,,Invoice,,,,,,23/07/2018,23/07/2018,0.00,,26.26,,"-658,688.15"
,IN,AR,30320878,1005,100,,Invoice,,,,,,23/07/2018,23/07/2018,0.00,,13.47,,"-658,701.62"
,IN,AR,30320887,1005,100,,Invoice,,,,,,23/07/2018,23/07/2018,0.00,,54.66,,"-658,756.28"
,IN,AR,30320892,1005,100,,Invoice,,,,,,23/07/2018,23/07/2018,0.00,,41.53,,"-658,797.81"
,IN,AR,30320900,1005,100,,Invoice,,,,,,23/07/2018,23/07/2018,0.00,,21.86,,"-658,819.67"
,IN,AR,30320924,1005,100,,Invoice,,,,,,23/07/2018,23/07/2018,0.00,,10.93,,"-658,830.60"
,IN,AR,30320946,1005,100,,Invoice,,,,,,23/07/2018,23/07/2018,0.00,,10.93,,"-658,841.53"
,IN,AR,30320961,1005,100,,Invoice,,,,,,23/07/2018,23/07/2018,0.00,,2.14,,"-658,843.67"
,IN,AR,30320966,1005,100,,Invoice,,,,,,23/07/2018,23/07/2018,0.00,,10.93,,"-658,854.60"
,IN,AR,30320972,1005,100,,Invoice,,,,,,23/07/2018,23/07/2018,0.00,,9.15,,"-658,863.75"
,IN,AR,30320981,1005,100,,Invoice,,,,,,23/07/2018,23/07/2018,0.00,,1.59,,"-658,865.34"
,IN,AR,30321000,1005,100,,Invoice,,,,,,23/07/2018,23/07/2018,0.00,,4.29,,"-658,869.63"
,IN,AR,30321002,1005,100,,Invoice,,,,,,23/07/2018,23/07/2018,0.00,,109.02,,"-658,978.65"
,IN,AR,30321008,1005,100,,Invoice,,,,,,23/07/2018,23/07/2018,0.00,,32.07,,"-659,010.72"
,IN,AR,30321015,1005,100,,Invoice,,,,,,23/07/2018,23/07/2018,0.00,,15.25,,"-659,025.97"
,IN,AR,30321019,1005,100,,Invoice,,,,,,23/07/2018,23/07/2018,0.00,,24.29,,"-659,050.26"
,IN,AR,30321026,1005,100,,Invoice,,,,,,23/07/2018,23/07/2018,0.00,,27.32,,"-659,077.58"
,IN,AR,30321041,1005,100,,Invoice,,,,,,23/07/2018,23/07/2018,0.00,,68.31,,"-659,145.89"
,IN,AR,30321042,1005,100,,Invoice,,,,,,23/07/2018,23/07/2018,0.00,,52.54,,"-659,198.43"
,IN,AR,30321045,1005,100,,Invoice,,,,,,23/07/2018,23/07/2018,0.00,,6.86,,"-659,205.29"
,IN,AR,30321072,1005,100,,Invoice,,,,,,23/07/2018,23/07/2018,0.00,,8.00,,"-659,213.29"
,IN,AR,30321075,1005,100,,Invoice,,,,,,23/07/2018,23/07/2018,0.00,,18.01,,"-659,231.30"
,IN,AR,30321081,1005,100,,Invoice,,,,,,23/07/2018,23/07/2018,0.00,,24.01,,"-659,255.31"
,IN,AR,30321097,1005,100,,Invoice,,,,,,23/07/2018,23/07/2018,0.00,,69.39,,"-659,324.70"
,IN,AR,30321115,1005,100,,Invoice,,,,,,23/07/2018,23/07/2018,0.00,,2.33,,"-659,327.03"
,IN,AR,30321121,1005,100,,Invoice,,,,,,23/07/2018,23/07/2018,0.00,,33.82,,"-659,360.85"
,IN,AR,30321123,1005,100,,Invoice,,,,,,23/07/2018,23/07/2018,0.00,,193.43,,"-659,554.28"
,IN,AR,30321128,1005,100,,Invoice,,,,,,23/07/2018,23/07/2018,0.00,,14.03,,"-659,568.31"
,IN,AR,30321136,1005,100,,Invoice,,,,,,23/07/2018,23/07/2018,0.00,,7.29,,"-659,575.60"
,IN,AR,30321139,1005,100,,Invoice,,,,,,23/07/2018,23/07/2018,0.00,,9.64,,"-659,585.24"
,IN,AR,30321156,1005,100,,Invoice,,,,,,23/07/2018,23/07/2018,0.00,,54.66,,"-659,639.90"
,IN,AR,30321166,1005,100,,Invoice,,,,,,23/07/2018,23/07/2018,0.00,,26.69,,"-659,666.59"
,IN,AR,30321173,1005,100,,Invoice,,,,,,23/07/2018,23/07/2018,0.00,,20.71,,"-659,687.30"
,IN,AR,30321200,1005,100,,Invoice,,,,,,23/07/2018,23/07/2018,0.00,,12.00,,"-659,699.30"
,IN,AR,30321204,1005,100,,Invoice,,,,,,23/07/2018,23/07/2018,0.00,,7.53,,"-659,706.83"
,IN,AR,30321205,1005,100,,Invoice,,,,,,23/07/2018,23/07/2018,0.00,,3.76,,"-659,710.59"
,IN,AR,30321231,1005,100,,Invoice,,,,,,23/07/2018,23/07/2018,0.00,,54.66,,"-659,765.25"
,IN,AR,30321245,1005,100,,Invoice,,,,,,23/07/2018,23/07/2018,0.00,,13.69,,"-659,778.94"
,IN,AR,30321258,1005,100,,Invoice,,,,,,23/07/2018,23/07/2018,0.00,,18.22,,"-659,797.16"
,IN,AR,30321259,1005,100,,Invoice,,,,,,23/07/2018,23/07/2018,0.00,,3.64,,"-659,800.80"
,IN,AR,30321264,1005,100,,Invoice,,,,,,23/07/2018,23/07/2018,0.00,,5.24,,"-659,806.04"
,IN,AR,30321270,1005,100,,Invoice,,,,,,23/07/2018,23/07/2018,0.00,,4.08,,"-659,810.12"
,IN,AR,30321288,1005,100,,Invoice,,,,,,23/07/2018,23/07/2018,0.00,,10.99,,"-659,821.11"
,IN,AR,30321298,1005,100,,Invoice,,,,,,23/07/2018,23/07/2018,0.00,,43.86,,"-659,864.97"
,IN,AR,30321311,1005,100,,Invoice,,,,,,23/07/2018,23/07/2018,0.00,,4.00,,"-659,868.97"
,IN,AR,30321312,1005,100,,Invoice,,,,,,23/07/2018,23/07/2018,0.00,,4.00,,"-659,872.97"
,IN,AR,30321320,1005,100,,Invoice,,,,,,23/07/2018,23/07/2018,0.00,,10.38,,"-659,883.35"
,IN,AR,30321321,1005,100,,Invoice,,,,,,23/07/2018,23/07/2018,0.00,,10.38,,"-659,893.73"
,IN,AR,30321322,1005,100,,Invoice,,,,,,23/07/2018,23/07/2018,0.00,,4.15,,"-659,897.88"
,IN,AR,30321323,1005,100,,Invoice,,,,,,23/07/2018,23/07/2018,0.00,,8.31,,"-659,906.19"
,IN,AR,30321324,1005,100,,Invoice,,,,,,23/07/2018,23/07/2018,0.00,,41.53,,"-659,947.72"
,IN,AR,30321325,1005,100,,Invoice,,,,,,23/07/2018,23/07/2018,0.00,,4.15,,"-659,951.87"
,IN,AR,30321326,1005,100,,Invoice,,,,,,23/07/2018,23/07/2018,0.00,,4.15,,"-659,956.02"
,IN,AR,30321371,1005,100,,Invoice,,,,,,23/07/2018,23/07/2018,0.00,,14.58,,"-659,970.60"
,IN,AR,30321396,1005,100,,Invoice,,,,,,23/07/2018,23/07/2018,0.00,,1.75,,"-659,972.35"
,IN,AR,30321410,1005,100,,Invoice,,,,,,23/07/2018,23/07/2018,0.00,,31.54,,"-660,003.89"
,CN,AR,31018427,1005,100,,Credit Note,,,,,,24/07/2018,24/07/2018,2.50,,0.00,,"-660,001.39"
,CN,AR,31018470,1005,100,,Credit Note,,,,,,24/07/2018,24/07/2018,81.15,,0.00,,"-659,920.24"
,CS,AR,32006575,1005,100,,Cash sale,,,,,,24/07/2018,24/07/2018,0.00,,3.64,,"-659,923.88"
,CS,AR,32006589,1005,100,,Cash sale,,,,,,24/07/2018,24/07/2018,0.00,,7.29,,"-659,931.17"
,CS,AR,32006592,1005,100,,Cash sale,,,,,,24/07/2018,24/07/2018,0.00,,14.58,,"-659,945.75"
,CS,AR,32006611,1005,100,,Cash sale,,,,,,24/07/2018,24/07/2018,0.00,,6.02,,"-659,951.77"
,CS,AR,32006614,1005,100,,Cash sale,,,,,,24/07/2018,24/07/2018,0.00,,7.29,,"-659,959.06"
,CS,AR,32006616,1005,100,,Cash sale,,,,,,24/07/2018,24/07/2018,0.00,,7.29,,"-659,966.35"
,CS,AR,32006642,1005,100,,Cash sale,,,,,,24/07/2018,24/07/2018,0.00,,18.22,,"-659,984.57"
,CS,AR,32006652,1005,100,,Cash sale,,,,,,24/07/2018,24/07/2018,0.00,,21.86,,"-660,006.43"
,CS,AR,32006667,1005,100,,Cash sale,,,,,,24/07/2018,24/07/2018,0.00,,14.58,,"-660,021.01"
,CS,AR,32006669,1005,100,,Cash sale,,,,,,24/07/2018,24/07/2018,0.00,,3.64,,"-660,024.65"
,CS,AR,32006670,1005,100,,Cash sale,,,,,,24/07/2018,24/07/2018,0.00,,4.32,,"-660,028.97"
,CS,AR,32006672,1005,100,,Cash sale,,,,,,24/07/2018,24/07/2018,0.00,,5.17,,"-660,034.14"
,CS,AR,32006675,1005,100,,Cash sale,,,,,,24/07/2018,24/07/2018,0.00,,4.32,,"-660,038.46"
,CS,AR,32006698,1005,100,,Cash sale,,,,,,24/07/2018,24/07/2018,0.00,,2.84,,"-660,041.30"
,CS,AR,32006719,1005,100,,Cash sale,,,,,,24/07/2018,24/07/2018,0.00,,9.03,,"-660,050.33"
,CS,AR,32006722,1005,100,,Cash sale,,,,,,24/07/2018,24/07/2018,0.00,,10.93,,"-660,061.26"
,CS,AR,32006730,1005,100,,Cash sale,,,,,,24/07/2018,24/07/2018,0.00,,11.65,,"-660,072.91"
,CS,AR,32006731,1005,100,,Cash sale,,,,,,24/07/2018,24/07/2018,0.00,,3.64,,"-660,076.55"
,CS,AR,32006764,1005,100,,Cash sale,,,,,,24/07/2018,24/07/2018,0.00,,4.78,,"-660,081.33"
,CS,AR,32006770,1005,100,,Cash sale,,,,,,24/07/2018,24/07/2018,0.00,,10.93,,"-660,092.26"
,CS,AR,32006777,1005,100,,Cash sale,,,,,,24/07/2018,24/07/2018,0.00,,12.92,,"-660,105.18"
,CS,AR,32006787,1005,100,,Cash sale,,,,,,24/07/2018,24/07/2018,0.00,,7.75,,"-660,112.93"
,CS,AR,32006790,1005,100,,Cash sale,,,,,,24/07/2018,24/07/2018,0.00,,3.90,,"-660,116.83"
,CS,AR,32006827,1005,100,,Cash sale,,,,,,24/07/2018,24/07/2018,0.00,,5.17,,"-660,122.00"
,CS,AR,32006828,1005,100,,Cash sale,,,,,,24/07/2018,24/07/2018,0.00,,55.53,,"-660,177.53"
,CS,AR,32006847,1005,100,,Cash sale,,,,,,24/07/2018,24/07/2018,0.00,,1.88,,"-660,179.41"
,CS,AR,32006864,1005,100,,Cash sale,,,,,,24/07/2018,24/07/2018,0.00,,14.58,,"-660,193.99"
,CS,AR,32006875,1005,100,,Cash sale,,,,,,24/07/2018,24/07/2018,0.00,,15.04,,"-660,209.03"
,CS,AR,32006881,1005,100,,Cash sale,,,,,,24/07/2018,24/07/2018,0.00,,7.63,,"-660,216.66"
,CS,AR,32006883,1005,100,,Cash sale,,,,,,24/07/2018,24/07/2018,0.00,,18.00,,"-660,234.66"
,CS,AR,32006885,1005,100,,Cash sale,,,,,,24/07/2018,24/07/2018,0.00,,42.00,,"-660,276.66"
,CS,AR,32006929,1005,100,,Cash sale,,,,,,24/07/2018,24/07/2018,0.00,,5.50,,"-660,282.16"
,CS,AR,32006941,1005,100,,Cash sale,,,,,,24/07/2018,24/07/2018,0.00,,5.47,,"-660,287.63"
,CS,AR,32006954,1005,100,,Cash sale,,,,,,24/07/2018,24/07/2018,0.00,,7.29,,"-660,294.92"
,CS,AR,32006968,1005,100,,Cash sale,,,,,,24/07/2018,24/07/2018,0.00,,3.64,,"-660,298.56"
,CS,AR,32006977,1005,100,,Cash sale,,,,,,24/07/2018,24/07/2018,0.00,,3.64,,"-660,302.20"
,CS,AR,32006985,1005,100,,Cash sale,,,,,,24/07/2018,24/07/2018,0.00,,19.16,,"-660,321.36"
,CS,AR,32006991,1005,100,,Cash sale,,,,,,24/07/2018,24/07/2018,0.00,,14.58,,"-660,335.94"
,CS,AR,32007000,1005,100,,Cash sale,,,,,,24/07/2018,24/07/2018,0.00,,7.29,,"-660,343.23"
,CS,AR,32007003,1005,100,,Cash sale,,,,,,24/07/2018,24/07/2018,0.00,,10.34,,"-660,353.57"
,CS,AR,32007009,1005,100,,Cash sale,,,,,,24/07/2018,24/07/2018,0.00,,5.94,,"-660,359.51"
,CS,AR,32007027,1005,100,,Cash sale,,,,,,24/07/2018,24/07/2018,0.00,,6.19,,"-660,365.70"
,CS,AR,32007047,1005,100,,Cash sale,,,,,,24/07/2018,24/07/2018,0.00,,3.64,,"-660,369.34"
,CS,AR,32007050,1005,100,,Cash sale,,,,,,24/07/2018,24/07/2018,0.00,,5.17,,"-660,374.51"
,IN,AR,30320383,1005,100,,Invoice,,,,,,24/07/2018,24/07/2018,0.00,,38.47,,"-660,412.98"
,IN,AR,30320419,1005,100,,Invoice,,,,,,24/07/2018,24/07/2018,0.00,,7.29,,"-660,420.27"
,IN,AR,30320420,1005,100,,Invoice,,,,,,24/07/2018,24/07/2018,0.00,,7.00,,"-660,427.27"
,IN,AR,30320443,1005,100,,Invoice,,,,,,24/07/2018,24/07/2018,0.00,,90.17,,"-660,517.44"
,IN,AR,30320465,1005,100,,Invoice,,,,,,24/07/2018,24/07/2018,0.00,,21.86,,"-660,539.30"
,IN,AR,30320471,1005,100,,Invoice,,,,,,24/07/2018,24/07/2018,0.00,,61.95,,"-660,601.25"
,IN,AR,30320505,1005,100,,Invoice,,,,,,24/07/2018,24/07/2018,0.00,,130.51,,"-660,731.76"
,IN,AR,30320518,1005,100,,Invoice,,,,,,24/07/2018,24/07/2018,0.00,,25.51,,"-660,757.27"
,IN,AR,30320525,1005,100,,Invoice,,,,,,24/07/2018,24/07/2018,0.00,,585.72,,"-661,342.99"
,IN,AR,30320528,1005,100,,Invoice,,,,,,24/07/2018,24/07/2018,0.00,,12.92,,"-661,355.91"
,IN,AR,30320550,1005,100,,Invoice,,,,,,24/07/2018,24/07/2018,0.00,,19.24,,"-661,375.15"
,IN,AR,30320591,1005,100,,Invoice,,,,,,24/07/2018,24/07/2018,0.00,,16.47,,"-661,391.62"
,IN,AR,30320598,1005,100,,Invoice,,,,,,24/07/2018,24/07/2018,0.00,,29.15,,"-661,420.77"
,IN,AR,30320611,1005,100,,Invoice,,,,,,24/07/2018,24/07/2018,0.00,,12.03,,"-661,432.80"
,IN,AR,30320612,1005,100,,Invoice,,,,,,24/07/2018,24/07/2018,0.00,,12.71,,"-661,445.51"
,IN,AR,30320625,1005,100,,Invoice,,,,,,24/07/2018,24/07/2018,0.00,,4.24,,"-661,449.75"
,IN,AR,30320627,1005,100,,Invoice,,,,,,24/07/2018,24/07/2018,0.00,,6.36,,"-661,456.11"
,IN,AR,30320650,1005,100,,Invoice,,,,,,24/07/2018,24/07/2018,0.00,,6.02,,"-661,462.13"
,IN,AR,30320657,1005,100,,Invoice,,,,,,24/07/2018,24/07/2018,0.00,,5.85,,"-661,467.98"
,IN,AR,30320670,1005,100,,Invoice,,,,,,24/07/2018,24/07/2018,0.00,,9.43,,"-661,477.41"
,IN,AR,30320674,1005,100,,Invoice,,,,,,24/07/2018,24/07/2018,0.00,,7.17,,"-661,484.58"
,IN,AR,30320698,1005,100,,Invoice,,,,,,24/07/2018,24/07/2018,0.00,,8.58,,"-661,493.16"
,IN,AR,30320702,1005,100,,Invoice,,,,,,24/07/2018,24/07/2018,0.00,,55.93,,"-661,549.09"
,IN,AR,30320730,1005,100,,Invoice,,,,,,24/07/2018,24/07/2018,0.00,,22.88,,"-661,571.97"
,IN,AR,30320738,1005,100,,Invoice,,,,,,24/07/2018,24/07/2018,0.00,,7.29,,"-661,579.26"
,IN,AR,30320745,1005,100,,Invoice,,,,,,24/07/2018,24/07/2018,0.00,,7.29,,"-661,586.55"
,IN,AR,30320747,1005,100,,Invoice,,,,,,24/07/2018,24/07/2018,0.00,,5.85,,"-661,592.40"
,IN,AR,30320754,1005,100,,Invoice,,,,,,24/07/2018,24/07/2018,0.00,,35.59,,"-661,627.99"
,IN,AR,30320757,1005,100,,Invoice,,,,,,24/07/2018,24/07/2018,0.00,,10.00,,"-661,637.99"
,IN,AR,30320763,1005,100,,Invoice,,,,,,24/07/2018,24/07/2018,0.00,,3.01,,"-661,641.00"
,IN,AR,30320768,1005,100,,Invoice,,,,,,24/07/2018,24/07/2018,0.00,,11.57,,"-661,652.57"
,IN,AR,30320771,1005,100,,Invoice,,,,,,24/07/2018,24/07/2018,0.00,,12.71,,"-661,665.28"
,IN,AR,30320775,1005,100,,Invoice,,,,,,24/07/2018,24/07/2018,0.00,,10.53,,"-661,675.81"
,IN,AR,30320785,1005,100,,Invoice,,,,,,24/07/2018,24/07/2018,0.00,,21.19,,"-661,697.00"
,IN,AR,30320793,1005,100,,Invoice,,,,,,24/07/2018,24/07/2018,0.00,,6.36,,"-661,703.36"
,IN,AR,30320814,1005,100,,Invoice,,,,,,24/07/2018,24/07/2018,0.00,,8.47,,"-661,711.83"
,IN,AR,30320822,1005,100,,Invoice,,,,,,24/07/2018,24/07/2018,0.00,,3.64,,"-661,715.47"
,IN,AR,30320845,1005,100,,Invoice,,,,,,24/07/2018,24/07/2018,0.00,,28.07,,"-661,743.54"
,IN,AR,30320857,1005,100,,Invoice,,,,,,24/07/2018,24/07/2018,0.00,,11.02,,"-661,754.56"
,IN,AR,30320859,1005,100,,Invoice,,,,,,24/07/2018,24/07/2018,0.00,,5.59,,"-661,760.15"
,IN,AR,30320866,1005,100,,Invoice,,,,,,24/07/2018,24/07/2018,0.00,,5.86,,"-661,766.01"
,IN,AR,30320882,1005,100,,Invoice,,,,,,24/07/2018,24/07/2018,0.00,,18.05,,"-661,784.06"
,IN,AR,30320897,1005,100,,Invoice,,,,,,24/07/2018,24/07/2018,0.00,,21.86,,"-661,805.92"
,IN,AR,30320898,1005,100,,Invoice,,,,,,24/07/2018,24/07/2018,0.00,,11.36,,"-661,817.28"
,IN,AR,30320899,1005,100,,Invoice,,,,,,24/07/2018,24/07/2018,0.00,,8.58,,"-661,825.86"
,IN,AR,30320907,1005,100,,Invoice,,,,,,24/07/2018,24/07/2018,0.00,,25.73,,"-661,851.59"
,IN,AR,30320915,1005,100,,Invoice,,,,,,24/07/2018,24/07/2018,0.00,,5.29,,"-661,856.88"
,IN,AR,30320932,1005,100,,Invoice,,,,,,24/07/2018,24/07/2018,0.00,,5.17,,"-661,862.05"
,IN,AR,30320934,1005,100,,Invoice,,,,,,24/07/2018,24/07/2018,0.00,,161.02,,"-662,023.07"
,IN,AR,30320937,1005,100,,Invoice,,,,,,24/07/2018,24/07/2018,0.00,,10.95,,"-662,034.02"
,IN,AR,30320942,1005,100,,Invoice,,,,,,24/07/2018,24/07/2018,0.00,,109.32,,"-662,143.34"
,IN,AR,30320982,1005,100,,Invoice,,,,,,24/07/2018,24/07/2018,0.00,,6.36,,"-662,149.70"
,IN,AR,30320993,1005,100,,Invoice,,,,,,24/07/2018,24/07/2018,0.00,,31.23,,"-662,180.93"
,IN,AR,30321023,1005,100,,Invoice,,,,,,24/07/2018,24/07/2018,0.00,,12.03,,"-662,192.96"
,IN,AR,30321030,1005,100,,Invoice,,,,,,24/07/2018,24/07/2018,0.00,,227.03,,"-662,419.99"
,IN,AR,30321034,1005,100,,Invoice,,,,,,24/07/2018,24/07/2018,0.00,,29.15,,"-662,449.14"
,IN,AR,30321065,1005,100,,Invoice,,,,,,24/07/2018,24/07/2018,0.00,,12.71,,"-662,461.85"
,IN,AR,30321087,1005,100,,Invoice,,,,,,24/07/2018,24/07/2018,0.00,,116.27,,"-662,578.12"
,IN,AR,30321126,1005,100,,Invoice,,,,,,24/07/2018,24/07/2018,0.00,,5.47,,"-662,583.59"
,IN,AR,30321142,1005,100,,Invoice,,,,,,24/07/2018,24/07/2018,0.00,,158.00,,"-662,741.59"
,IN,AR,30321145,1005,100,,Invoice,,,,,,24/07/2018,24/07/2018,0.00,,45.08,,"-662,786.67"
,IN,AR,30321152,1005,100,,Invoice,,,,,,24/07/2018,24/07/2018,0.00,,3.64,,"-662,790.31"
,IN,AR,30321165,1005,100,,Invoice,,,,,,24/07/2018,24/07/2018,0.00,,0.81,,"-662,791.12"
,IN,AR,30321169,1005,100,,Invoice,,,,,,24/07/2018,24/07/2018,0.00,,81.15,,"-662,872.27"
,IN,AR,30321183,1005,100,,Invoice,,,,,,24/07/2018,24/07/2018,0.00,,84.07,,"-662,956.34"
,IN,AR,30321185,1005,100,,Invoice,,,,,,24/07/2018,24/07/2018,0.00,,21.36,,"-662,977.70"
,IN,AR,30321186,1005,100,,Invoice,,,,,,24/07/2018,24/07/2018,0.00,,23.73,,"-663,001.43"
,IN,AR,30321187,1005,100,,Invoice,,,,,,24/07/2018,24/07/2018,0.00,,104.42,,"-663,105.85"
,IN,AR,30321194,1005,100,,Invoice,,,,,,24/07/2018,24/07/2018,0.00,,32.54,,"-663,138.39"
,IN,AR,30321206,1005,100,,Invoice,,,,,,24/07/2018,24/07/2018,0.00,,3.76,,"-663,142.15"
,IN,AR,30321210,1005,100,,Invoice,,,,,,24/07/2018,24/07/2018,0.00,,3.51,,"-663,145.66"
,IN,AR,30321213,1005,100,,Invoice,,,,,,24/07/2018,24/07/2018,0.00,,14.00,,"-663,159.66"
,IN,AR,30321217,1005,100,,Invoice,,,,,,24/07/2018,24/07/2018,0.00,,5.93,,"-663,165.59"
,IN,AR,30321225,1005,100,,Invoice,,,,,,24/07/2018,24/07/2018,0.00,,147.24,,"-663,312.83"
,IN,AR,30321228,1005,100,,Invoice,,,,,,24/07/2018,24/07/2018,0.00,,29.15,,"-663,341.98"
,IN,AR,30321236,1005,100,,Invoice,,,,,,24/07/2018,24/07/2018,0.00,,7.02,,"-663,349.00"
,IN,AR,30321249,1005,100,,Invoice,,,,,,24/07/2018,24/07/2018,0.00,,182.20,,"-663,531.20"
,IN,AR,30321251,1005,100,,Invoice,,,,,,24/07/2018,24/07/2018,0.00,,29.15,,"-663,560.35"
,IN,AR,30321253,1005,100,,Invoice,,,,,,24/07/2018,24/07/2018,0.00,,36.02,,"-663,596.37"
,IN,AR,30321256,1005,100,,Invoice,,,,,,24/07/2018,24/07/2018,0.00,,12.14,,"-663,608.51"
,IN,AR,30321267,1005,100,,Invoice,,,,,,24/07/2018,24/07/2018,0.00,,7.86,,"-663,616.37"
,IN,AR,30321271,1005,100,,Invoice,,,,,,24/07/2018,24/07/2018,0.00,,57.19,,"-663,673.56"
,IN,AR,30321282,1005,100,,Invoice,,,,,,24/07/2018,24/07/2018,0.00,,25.51,,"-663,699.07"
,IN,AR,30321292,1005,100,,Invoice,,,,,,24/07/2018,24/07/2018,0.00,,15.53,,"-663,714.60"
,IN,AR,30321295,1005,100,,Invoice,,,,,,24/07/2018,24/07/2018,0.00,,13.94,,"-663,728.54"
,IN,AR,30321304,1005,100,,Invoice,,,,,,24/07/2018,24/07/2018,0.00,,15.18,,"-663,743.72"
,IN,AR,30321327,1005,100,,Invoice,,,,,,24/07/2018,24/07/2018,0.00,,22.84,,"-663,766.56"
,IN,AR,30321328,1005,100,,Invoice,,,,,,24/07/2018,24/07/2018,0.00,,2.08,,"-663,768.64"
,IN,AR,30321329,1005,100,,Invoice,,,,,,24/07/2018,24/07/2018,0.00,,4.15,,"-663,772.79"
,IN,AR,30321330,1005,100,,Invoice,,,,,,24/07/2018,24/07/2018,0.00,,4.15,,"-663,776.94"
,IN,AR,30321331,1005,100,,Invoice,,,,,,24/07/2018,24/07/2018,0.00,,4.15,,"-663,781.09"
,IN,AR,30321332,1005,100,,Invoice,,,,,,24/07/2018,24/07/2018,0.00,,4.15,,"-663,785.24"
,IN,AR,30321355,1005,100,,Invoice,,,,,,24/07/2018,24/07/2018,0.00,,25.42,,"-663,810.66"
,IN,AR,30321357,1005,100,,Invoice,,,,,,24/07/2018,24/07/2018,0.00,,12.08,,"-663,822.74"
,IN,AR,30321359,1005,100,,Invoice,,,,,,24/07/2018,24/07/2018,0.00,,10.93,,"-663,833.67"
,IN,AR,30321378,1005,100,,Invoice,,,,,,24/07/2018,24/07/2018,0.00,,10.17,,"-663,843.84"
,IN,AR,30321422,1005,100,,Invoice,,,,,,24/07/2018,24/07/2018,0.00,,24.27,,"-663,868.11"
,IN,AR,30321424,1005,100,,Invoice,,,,,,24/07/2018,24/07/2018,0.00,,29.15,,"-663,897.26"
,IN,AR,30321426,1005,100,,Invoice,,,,,,24/07/2018,24/07/2018,0.00,,29.15,,"-663,926.41"
,CN,AR,31018478,1005,100,,Credit Note,,,,,,25/07/2018,25/07/2018,57.19,,0.00,,"-663,869.22"
,CR,AR,33000212,1005,100,,Cash Return,,,,,,25/07/2018,25/07/2018,18.98,,0.00,,"-663,850.24"
,CS,AR,32006565,1005,100,,Cash sale,,,,,,25/07/2018,25/07/2018,0.00,,8.42,,"-663,858.66"
,CS,AR,32006570,1005,100,,Cash sale,,,,,,25/07/2018,25/07/2018,0.00,,35.12,,"-663,893.78"
,CS,AR,32006572,1005,100,,Cash sale,,,,,,25/07/2018,25/07/2018,0.00,,18.98,,"-663,912.76"
,CS,AR,32006595,1005,100,,Cash sale,,,,,,25/07/2018,25/07/2018,0.00,,3.64,,"-663,916.40"
,CS,AR,32006598,1005,100,,Cash sale,,,,,,25/07/2018,25/07/2018,0.00,,18.22,,"-663,934.62"
,CS,AR,32006603,1005,100,,Cash sale,,,,,,25/07/2018,25/07/2018,0.00,,7.29,,"-663,941.91"
,CS,AR,32006625,1005,100,,Cash sale,,,,,,25/07/2018,25/07/2018,0.00,,7.29,,"-663,949.20"
,CS,AR,32006632,1005,100,,Cash sale,,,,,,25/07/2018,25/07/2018,0.00,,12.03,,"-663,961.23"
,CS,AR,32006647,1005,100,,Cash sale,,,,,,25/07/2018,25/07/2018,0.00,,7.29,,"-663,968.52"
,CS,AR,32006656,1005,100,,Cash sale,,,,,,25/07/2018,25/07/2018,0.00,,5.86,,"-663,974.38"
,CS,AR,32006665,1005,100,,Cash sale,,,,,,25/07/2018,25/07/2018,0.00,,10.34,,"-663,984.72"
,CS,AR,32006674,1005,100,,Cash sale,,,,,,25/07/2018,25/07/2018,0.00,,3.64,,"-663,988.36"
,CS,AR,32006678,1005,100,,Cash sale,,,,,,25/07/2018,25/07/2018,0.00,,10.93,,"-663,999.29"
,CS,AR,32006682,1005,100,,Cash sale,,,,,,25/07/2018,25/07/2018,0.00,,18.22,,"-664,017.51"
,CS,AR,32006694,1005,100,,Cash sale,,,,,,25/07/2018,25/07/2018,0.00,,10.34,,"-664,027.85"
,CS,AR,32006696,1005,100,,Cash sale,,,,,,25/07/2018,25/07/2018,0.00,,14.58,,"-664,042.43"
,CS,AR,32006700,1005,100,,Cash sale,,,,,,25/07/2018,25/07/2018,0.00,,10.34,,"-664,052.77"
,CS,AR,32006706,1005,100,,Cash sale,,,,,,25/07/2018,25/07/2018,0.00,,10.93,,"-664,063.70"
,CS,AR,32006707,1005,100,,Cash sale,,,,,,25/07/2018,25/07/2018,0.00,,14.58,,"-664,078.28"
,CS,AR,32006711,1005,100,,Cash sale,,,,,,25/07/2018,25/07/2018,0.00,,27.08,,"-664,105.36"
,CS,AR,32006718,1005,100,,Cash sale,,,,,,25/07/2018,25/07/2018,0.00,,7.29,,"-664,112.65"
,CS,AR,32006725,1005,100,,Cash sale,,,,,,25/07/2018,25/07/2018,0.00,,10.93,,"-664,123.58"
,CS,AR,32006735,1005,100,,Cash sale,,,,,,25/07/2018,25/07/2018,0.00,,5.08,,"-664,128.66"
,CS,AR,32006766,1005,100,,Cash sale,,,,,,25/07/2018,25/07/2018,0.00,,25.42,,"-664,154.08"
,CS,AR,32006801,1005,100,,Cash sale,,,,,,25/07/2018,25/07/2018,0.00,,7.29,,"-664,161.37"
,CS,AR,32006824,1005,100,,Cash sale,,,,,,25/07/2018,25/07/2018,0.00,,7.29,,"-664,168.66"
,CS,AR,32006834,1005,100,,Cash sale,,,,,,25/07/2018,25/07/2018,0.00,,3.64,,"-664,172.30"
,CS,AR,32006844,1005,100,,Cash sale,,,,,,25/07/2018,25/07/2018,0.00,,10.93,,"-664,183.23"
,CS,AR,32006845,1005,100,,Cash sale,,,,,,25/07/2018,25/07/2018,0.00,,30.02,,"-664,213.25"
,CS,AR,32006859,1005,100,,Cash sale,,,,,,25/07/2018,25/07/2018,0.00,,16.61,,"-664,229.86"
,CS,AR,32006860,1005,100,,Cash sale,,,,,,25/07/2018,25/07/2018,0.00,,8.90,,"-664,238.76"
,CS,AR,32006861,1005,100,,Cash sale,,,,,,25/07/2018,25/07/2018,0.00,,10.93,,"-664,249.69"
,CS,AR,32006868,1005,100,,Cash sale,,,,,,25/07/2018,25/07/2018,0.00,,3.64,,"-664,253.33"
,CS,AR,32006880,1005,100,,Cash sale,,,,,,25/07/2018,25/07/2018,0.00,,10.93,,"-664,264.26"
,CS,AR,32006892,1005,100,,Cash sale,,,,,,25/07/2018,25/07/2018,0.00,,8.26,,"-664,272.52"
,CS,AR,32006893,1005,100,,Cash sale,,,,,,25/07/2018,25/07/2018,0.00,,54.66,,"-664,327.18"
,CS,AR,32006896,1005,100,,Cash sale,,,,,,25/07/2018,25/07/2018,0.00,,10.93,,"-664,338.11"
,CS,AR,32006907,1005,100,,Cash sale,,,,,,25/07/2018,25/07/2018,0.00,,10.93,,"-664,349.04"
,CS,AR,32006910,1005,100,,Cash sale,,,,,,25/07/2018,25/07/2018,0.00,,9.15,,"-664,358.19"
,CS,AR,32006918,1005,100,,Cash sale,,,,,,25/07/2018,25/07/2018,0.00,,21.86,,"-664,380.05"
,CS,AR,32006919,1005,100,,Cash sale,,,,,,25/07/2018,25/07/2018,0.00,,9.10,,"-664,389.15"
,CS,AR,32006922,1005,100,,Cash sale,,,,,,25/07/2018,25/07/2018,0.00,,10.93,,"-664,400.08"
,CS,AR,32006933,1005,100,,Cash sale,,,,,,25/07/2018,25/07/2018,0.00,,29.15,,"-664,429.23"
,CS,AR,32006944,1005,100,,Cash sale,,,,,,25/07/2018,25/07/2018,0.00,,7.29,,"-664,436.52"
,CS,AR,32006950,1005,100,,Cash sale,,,,,,25/07/2018,25/07/2018,0.00,,5.08,,"-664,441.60"
,CS,AR,32006972,1005,100,,Cash sale,,,,,,25/07/2018,25/07/2018,0.00,,7.29,,"-664,448.89"
,CS,AR,32006973,1005,100,,Cash sale,,,,,,25/07/2018,25/07/2018,0.00,,7.29,,"-664,456.18"
,CS,AR,32007036,1005,100,,Cash sale,,,,,,25/07/2018,25/07/2018,0.00,,3.64,,"-664,459.82"
,CS,AR,32007055,1005,100,,Cash sale,,,,,,25/07/2018,25/07/2018,0.00,,3.64,,"-664,463.46"
,IN,AR,30320367,1005,100,,Invoice,,,,,,25/07/2018,25/07/2018,0.00,,44.49,,"-664,507.95"
,IN,AR,30320379,1005,100,,Invoice,,,,,,25/07/2018,25/07/2018,0.00,,14.58,,"-664,522.53"
,IN,AR,30320381,1005,100,,Invoice,,,,,,25/07/2018,25/07/2018,0.00,,58.58,,"-664,581.11"
,IN,AR,30320382,1005,100,,Invoice,,,,,,25/07/2018,25/07/2018,0.00,,41.49,,"-664,622.60"
,IN,AR,30320403,1005,100,,Invoice,,,,,,25/07/2018,25/07/2018,0.00,,18.98,,"-664,641.58"
,IN,AR,30320406,1005,100,,Invoice,,,,,,25/07/2018,25/07/2018,0.00,,5.68,,"-664,647.26"
,IN,AR,30320407,1005,100,,Invoice,,,,,,25/07/2018,25/07/2018,0.00,,7.29,,"-664,654.55"
,IN,AR,30320409,1005,100,,Invoice,,,,,,25/07/2018,25/07/2018,0.00,,76.19,,"-664,730.74"
,IN,AR,30320410,1005,100,,Invoice,,,,,,25/07/2018,25/07/2018,0.00,,26.27,,"-664,757.01"
,IN,AR,30320415,1005,100,,Invoice,,,,,,25/07/2018,25/07/2018,0.00,,19.32,,"-664,776.33"
,IN,AR,30320444,1005,100,,Invoice,,,,,,25/07/2018,25/07/2018,0.00,,78.31,,"-664,854.64"
,IN,AR,30320460,1005,100,,Invoice,,,,,,25/07/2018,25/07/2018,0.00,,72.00,,"-664,926.64"
,IN,AR,30320472,1005,100,,Invoice,,,,,,25/07/2018,25/07/2018,0.00,,10.93,,"-664,937.57"
,IN,AR,30320479,1005,100,,Invoice,,,,,,25/07/2018,25/07/2018,0.00,,44.00,,"-664,981.57"
,IN,AR,30320485,1005,100,,Invoice,,,,,,25/07/2018,25/07/2018,0.00,,10.93,,"-664,992.50"
,IN,AR,30320496,1005,100,,Invoice,,,,,,25/07/2018,25/07/2018,0.00,,364.41,,"-665,356.91"
,IN,AR,30320500,1005,100,,Invoice,,,,,,25/07/2018,25/07/2018,0.00,,11.68,,"-665,368.59"
,IN,AR,30320502,1005,100,,Invoice,,,,,,25/07/2018,25/07/2018,0.00,,70.00,,"-665,438.59"
,IN,AR,30320511,1005,100,,Invoice,,,,,,25/07/2018,25/07/2018,0.00,,182.20,,"-665,620.79"
,IN,AR,30320514,1005,100,,Invoice,,,,,,25/07/2018,25/07/2018,0.00,,7.29,,"-665,628.08"
,IN,AR,30320524,1005,100,,Invoice,,,,,,25/07/2018,25/07/2018,0.00,,245.59,,"-665,873.67"
,IN,AR,30320564,1005,100,,Invoice,,,,,,25/07/2018,25/07/2018,0.00,,37.14,,"-665,910.81"
,IN,AR,30320596,1005,100,,Invoice,,,,,,25/07/2018,25/07/2018,0.00,,7.29,,"-665,918.10"
,IN,AR,30320606,1005,100,,Invoice,,,,,,25/07/2018,25/07/2018,0.00,,5.08,,"-665,923.18"
,IN,AR,30320609,1005,100,,Invoice,,,,,,25/07/2018,25/07/2018,0.00,,25.42,,"-665,948.60"
,IN,AR,30320614,1005,100,,Invoice,,,,,,25/07/2018,25/07/2018,0.00,,4.24,,"-665,952.84"
,IN,AR,30320616,1005,100,,Invoice,,,,,,25/07/2018,25/07/2018,0.00,,182.20,,"-666,135.04"
,IN,AR,30320619,1005,100,,Invoice,,,,,,25/07/2018,25/07/2018,0.00,,20.34,,"-666,155.38"
,IN,AR,30320623,1005,100,,Invoice,,,,,,25/07/2018,25/07/2018,0.00,,4.24,,"-666,159.62"
,IN,AR,30320629,1005,100,,Invoice,,,,,,25/07/2018,25/07/2018,0.00,,11.19,,"-666,170.81"
,IN,AR,30320647,1005,100,,Invoice,,,,,,25/07/2018,25/07/2018,0.00,,18.22,,"-666,189.03"
,IN,AR,30320662,1005,100,,Invoice,,,,,,25/07/2018,25/07/2018,0.00,,71.78,,"-666,260.81"
,IN,AR,30320679,1005,100,,Invoice,,,,,,25/07/2018,25/07/2018,0.00,,2.58,,"-666,263.39"
,IN,AR,30320689,1005,100,,Invoice,,,,,,25/07/2018,25/07/2018,0.00,,14.58,,"-666,277.97"
,IN,AR,30320708,1005,100,,Invoice,,,,,,25/07/2018,25/07/2018,0.00,,57.19,,"-666,335.16"
,IN,AR,30320713,1005,100,,Invoice,,,,,,25/07/2018,25/07/2018,0.00,,256.08,,"-666,591.24"
,IN,AR,30320720,1005,100,,Invoice,,,,,,25/07/2018,25/07/2018,0.00,,5.08,,"-666,596.32"
,IN,AR,30320726,1005,100,,Invoice,,,,,,25/07/2018,25/07/2018,0.00,,23.39,,"-666,619.71"
,IN,AR,30320728,1005,100,,Invoice,,,,,,25/07/2018,25/07/2018,0.00,,18.39,,"-666,638.10"
,IN,AR,30320734,1005,100,,Invoice,,,,,,25/07/2018,25/07/2018,0.00,,33.09,,"-666,671.19"
,IN,AR,30320748,1005,100,,Invoice,,,,,,25/07/2018,25/07/2018,0.00,,25.51,,"-666,696.70"
,IN,AR,30320753,1005,100,,Invoice,,,,,,25/07/2018,25/07/2018,0.00,,20.44,,"-666,717.14"
,IN,AR,30320761,1005,100,,Invoice,,,,,,25/07/2018,25/07/2018,0.00,,14.63,,"-666,731.77"
,IN,AR,30320772,1005,100,,Invoice,,,,,,25/07/2018,25/07/2018,0.00,,5.08,,"-666,736.85"
,IN,AR,30320781,1005,100,,Invoice,,,,,,25/07/2018,25/07/2018,0.00,,6.02,,"-666,742.87"
,IN,AR,30320791,1005,100,,Invoice,,,,,,25/07/2018,25/07/2018,0.00,,21.86,,"-666,764.73"
,IN,AR,30320797,1005,100,,Invoice,,,,,,25/07/2018,25/07/2018,0.00,,3.64,,"-666,768.37"
,IN,AR,30320811,1005,100,,Invoice,,,,,,25/07/2018,25/07/2018,0.00,,11.22,,"-666,779.59"
,IN,AR,30320816,1005,100,,Invoice,,,,,,25/07/2018,25/07/2018,0.00,,38.56,,"-666,818.15"
,IN,AR,30320817,1005,100,,Invoice,,,,,,25/07/2018,25/07/2018,0.00,,53.39,,"-666,871.54"
,IN,AR,30320825,1005,100,,Invoice,,,,,,25/07/2018,25/07/2018,0.00,,1.88,,"-666,873.42"
,IN,AR,30320829,1005,100,,Invoice,,,,,,25/07/2018,25/07/2018,0.00,,14.58,,"-666,888.00"
,IN,AR,30320836,1005,100,,Invoice,,,,,,25/07/2018,25/07/2018,0.00,,97.88,,"-666,985.88"
,IN,AR,30320848,1005,100,,Invoice,,,,,,25/07/2018,25/07/2018,0.00,,13.56,,"-666,999.44"
,IN,AR,30320850,1005,100,,Invoice,,,,,,25/07/2018,25/07/2018,0.00,,"1,093.22",,"-668,092.66"
,IN,AR,30320853,1005,100,,Invoice,,,,,,25/07/2018,25/07/2018,0.00,,54.66,,"-668,147.32"
,IN,AR,30320854,1005,100,,Invoice,,,,,,25/07/2018,25/07/2018,0.00,,54.66,,"-668,201.98"
,IN,AR,30320869,1005,100,,Invoice,,,,,,25/07/2018,25/07/2018,0.00,,17.03,,"-668,219.01"
,IN,AR,30320873,1005,100,,Invoice,,,,,,25/07/2018,25/07/2018,0.00,,364.41,,"-668,583.42"
,IN,AR,30320877,1005,100,,Invoice,,,,,,25/07/2018,25/07/2018,0.00,,182.20,,"-668,765.62"
,IN,AR,30320880,1005,100,,Invoice,,,,,,25/07/2018,25/07/2018,0.00,,24.07,,"-668,789.69"
,IN,AR,30320901,1005,100,,Invoice,,,,,,25/07/2018,25/07/2018,0.00,,36.10,,"-668,825.79"
,IN,AR,30320906,1005,100,,Invoice,,,,,,25/07/2018,25/07/2018,0.00,,7.75,,"-668,833.54"
,IN,AR,30320908,1005,100,,Invoice,,,,,,25/07/2018,25/07/2018,0.00,,60.03,,"-668,893.57"
,IN,AR,30320916,1005,100,,Invoice,,,,,,25/07/2018,25/07/2018,0.00,,1.76,,"-668,895.33"
,IN,AR,30320917,1005,100,,Invoice,,,,,,25/07/2018,25/07/2018,0.00,,10.57,,"-668,905.90"
,IN,AR,30320918,1005,100,,Invoice,,,,,,25/07/2018,25/07/2018,0.00,,14.09,,"-668,919.99"
,IN,AR,30320923,1005,100,,Invoice,,,,,,25/07/2018,25/07/2018,0.00,,18.05,,"-668,938.04"
,IN,AR,30320941,1005,100,,Invoice,,,,,,25/07/2018,25/07/2018,0.00,,5.17,,"-668,943.21"
,IN,AR,30320947,1005,100,,Invoice,,,,,,25/07/2018,25/07/2018,0.00,,14.58,,"-668,957.79"
,IN,AR,30320950,1005,100,,Invoice,,,,,,25/07/2018,25/07/2018,0.00,,182.20,,"-669,139.99"
,IN,AR,30320951,1005,100,,Invoice,,,,,,25/07/2018,25/07/2018,0.00,,30.01,,"-669,170.00"
,IN,AR,30320952,1005,100,,Invoice,,,,,,25/07/2018,25/07/2018,0.00,,54.66,,"-669,224.66"
,IN,AR,30320953,1005,100,,Invoice,,,,,,25/07/2018,25/07/2018,0.00,,51.02,,"-669,275.68"
,IN,AR,30320991,1005,100,,Invoice,,,,,,25/07/2018,25/07/2018,0.00,,6.02,,"-669,281.70"
,IN,AR,30320996,1005,100,,Invoice,,,,,,25/07/2018,25/07/2018,0.00,,38.00,,"-669,319.70"
,IN,AR,30321004,1005,100,,Invoice,,,,,,25/07/2018,25/07/2018,0.00,,98.21,,"-669,417.91"
,IN,AR,30321009,1005,100,,Invoice,,,,,,25/07/2018,25/07/2018,0.00,,32.07,,"-669,449.98"
,IN,AR,30321012,1005,100,,Invoice,,,,,,25/07/2018,25/07/2018,0.00,,10.93,,"-669,460.91"
,IN,AR,30321028,1005,100,,Invoice,,,,,,25/07/2018,25/07/2018,0.00,,43.22,,"-669,504.13"
,IN,AR,30321032,1005,100,,Invoice,,,,,,25/07/2018,25/07/2018,0.00,,14.83,,"-669,518.96"
,IN,AR,30321052,1005,100,,Invoice,,,,,,25/07/2018,25/07/2018,0.00,,10.19,,"-669,529.15"
,IN,AR,30321056,1005,100,,Invoice,,,,,,25/07/2018,25/07/2018,0.00,,10.93,,"-669,540.08"
,IN,AR,30321057,1005,100,,Invoice,,,,,,25/07/2018,25/07/2018,0.00,,43.97,,"-669,584.05"
,IN,AR,30321066,1005,100,,Invoice,,,,,,25/07/2018,25/07/2018,0.00,,7.63,,"-669,591.68"
,IN,AR,30321067,1005,100,,Invoice,,,,,,25/07/2018,25/07/2018,0.00,,10.17,,"-669,601.85"
,IN,AR,30321068,1005,100,,Invoice,,,,,,25/07/2018,25/07/2018,0.00,,22.88,,"-669,624.73"
,IN,AR,30321082,1005,100,,Invoice,,,,,,25/07/2018,25/07/2018,0.00,,22.01,,"-669,646.74"
,IN,AR,30321096,1005,100,,Invoice,,,,,,25/07/2018,25/07/2018,0.00,,53.94,,"-669,700.68"
,IN,AR,30321098,1005,100,,Invoice,,,,,,25/07/2018,25/07/2018,0.00,,4.53,,"-669,705.21"
,IN,AR,30321101,1005,100,,Invoice,,,,,,25/07/2018,25/07/2018,0.00,,11.66,,"-669,716.87"
,IN,AR,30321108,1005,100,,Invoice,,,,,,25/07/2018,25/07/2018,0.00,,31.54,,"-669,748.41"
,IN,AR,30321109,1005,100,,Invoice,,,,,,25/07/2018,25/07/2018,0.00,,16.82,,"-669,765.23"
,IN,AR,30321113,1005,100,,Invoice,,,,,,25/07/2018,25/07/2018,0.00,,12.03,,"-669,777.26"
,IN,AR,30321114,1005,100,,Invoice,,,,,,25/07/2018,25/07/2018,0.00,,17.92,,"-669,795.18"
,IN,AR,30321135,1005,100,,Invoice,,,,,,25/07/2018,25/07/2018,0.00,,13.98,,"-669,809.16"
,IN,AR,30321138,1005,100,,Invoice,,,,,,25/07/2018,25/07/2018,0.00,,22.37,,"-669,831.53"
,IN,AR,30321144,1005,100,,Invoice,,,,,,25/07/2018,25/07/2018,0.00,,9.10,,"-669,840.63"
,IN,AR,30321160,1005,100,,Invoice,,,,,,25/07/2018,25/07/2018,0.00,,18.20,,"-669,858.83"
,IN,AR,30321174,1005,100,,Invoice,,,,,,25/07/2018,25/07/2018,0.00,,4.78,,"-669,863.61"
,IN,AR,30321209,1005,100,,Invoice,,,,,,25/07/2018,25/07/2018,0.00,,7.02,,"-669,870.63"
,IN,AR,30321214,1005,100,,Invoice,,,,,,25/07/2018,25/07/2018,0.00,,2.00,,"-669,872.63"
,IN,AR,30321239,1005,100,,Invoice,,,,,,25/07/2018,25/07/2018,0.00,,11.66,,"-669,884.29"
,IN,AR,30321242,1005,100,,Invoice,,,,,,25/07/2018,25/07/2018,0.00,,54.66,,"-669,938.95"
,IN,AR,30321243,1005,100,,Invoice,,,,,,25/07/2018,25/07/2018,0.00,,29.15,,"-669,968.10"
,IN,AR,30321255,1005,100,,Invoice,,,,,,25/07/2018,25/07/2018,0.00,,9.41,,"-669,977.51"
,IN,AR,30321268,1005,100,,Invoice,,,,,,25/07/2018,25/07/2018,0.00,,22.37,,"-669,999.88"
,IN,AR,30321276,1005,100,,Invoice,,,,,,25/07/2018,25/07/2018,0.00,,14.58,,"-670,014.46"
,IN,AR,30321300,1005,100,,Invoice,,,,,,25/07/2018,25/07/2018,0.00,,11.44,,"-670,025.90"
,IN,AR,30321301,1005,100,,Invoice,,,,,,25/07/2018,25/07/2018,0.00,,7.25,,"-670,033.15"
,IN,AR,30321333,1005,100,,Invoice,,,,,,25/07/2018,25/07/2018,0.00,,56.06,,"-670,089.21"
,IN,AR,30321334,1005,100,,Invoice,,,,,,25/07/2018,25/07/2018,0.00,,8.31,,"-670,097.52"
,IN,AR,30321335,1005,100,,Invoice,,,,,,25/07/2018,25/07/2018,0.00,,18.69,,"-670,116.21"
,IN,AR,30321336,1005,100,,Invoice,,,,,,25/07/2018,25/07/2018,0.00,,8.31,,"-670,124.52"
,IN,AR,30321361,1005,100,,Invoice,,,,,,25/07/2018,25/07/2018,0.00,,24.27,,"-670,148.79"
,IN,AR,30321368,1005,100,,Invoice,,,,,,25/07/2018,25/07/2018,0.00,,16.91,,"-670,165.70"
,IN,AR,30321408,1005,100,,Invoice,,,,,,25/07/2018,25/07/2018,0.00,,41.19,,"-670,206.89"
,IN,AR,30321409,1005,100,,Invoice,,,,,,25/07/2018,25/07/2018,0.00,,21.97,,"-670,228.86"
,IN,AR,30321412,1005,100,,Invoice,,,,,,25/07/2018,25/07/2018,0.00,,10.93,,"-670,239.79"
,IN,AR,30321418,1005,100,,Invoice,,,,,,25/07/2018,25/07/2018,0.00,,14.58,,"-670,254.37"
,IN,AR,30321427,1005,100,,Invoice,,,,,,25/07/2018,25/07/2018,0.00,,29.15,,"-670,283.52"
,CS,AR,32006561,1005,100,,Cash sale,,,,,,26/07/2018,26/07/2018,0.00,,9.03,,"-670,292.55"
,CS,AR,32006562,1005,100,,Cash sale,,,,,,26/07/2018,26/07/2018,0.00,,14.58,,"-670,307.13"
,CS,AR,32006586,1005,100,,Cash sale,,,,,,26/07/2018,26/07/2018,0.00,,2.58,,"-670,309.71"
,CS,AR,32006597,1005,100,,Cash sale,,,,,,26/07/2018,26/07/2018,0.00,,18.22,,"-670,327.93"
,CS,AR,32006604,1005,100,,Cash sale,,,,,,26/07/2018,26/07/2018,0.00,,7.29,,"-670,335.22"
,CS,AR,32006606,1005,100,,Cash sale,,,,,,26/07/2018,26/07/2018,0.00,,51.14,,"-670,386.36"
,CS,AR,32006626,1005,100,,Cash sale,,,,,,26/07/2018,26/07/2018,0.00,,7.29,,"-670,393.65"
,CS,AR,32006640,1005,100,,Cash sale,,,,,,26/07/2018,26/07/2018,0.00,,10.93,,"-670,404.58"
,CS,AR,32006651,1005,100,,Cash sale,,,,,,26/07/2018,26/07/2018,0.00,,7.29,,"-670,411.87"
,CS,AR,32006657,1005,100,,Cash sale,,,,,,26/07/2018,26/07/2018,0.00,,7.29,,"-670,419.16"
,CS,AR,32006661,1005,100,,Cash sale,,,,,,26/07/2018,26/07/2018,0.00,,7.29,,"-670,426.45"
,CS,AR,32006692,1005,100,,Cash sale,,,,,,26/07/2018,26/07/2018,0.00,,3.90,,"-670,430.35"
,CS,AR,32006693,1005,100,,Cash sale,,,,,,26/07/2018,26/07/2018,0.00,,22.37,,"-670,452.72"
,CS,AR,32006744,1005,100,,Cash sale,,,,,,26/07/2018,26/07/2018,0.00,,13.47,,"-670,466.19"
,CS,AR,32006750,1005,100,,Cash sale,,,,,,26/07/2018,26/07/2018,0.00,,16.78,,"-670,482.97"
,CS,AR,32006763,1005,100,,Cash sale,,,,,,26/07/2018,26/07/2018,0.00,,14.58,,"-670,497.55"
,CS,AR,32006782,1005,100,,Cash sale,,,,,,26/07/2018,26/07/2018,0.00,,7.29,,"-670,504.84"
,CS,AR,32006795,1005,100,,Cash sale,,,,,,26/07/2018,26/07/2018,0.00,,55.93,,"-670,560.77"
,CS,AR,32006796,1005,100,,Cash sale,,,,,,26/07/2018,26/07/2018,0.00,,3.64,,"-670,564.41"
,CS,AR,32006797,1005,100,,Cash sale,,,,,,26/07/2018,26/07/2018,0.00,,36.19,,"-670,600.60"
,CS,AR,32006810,1005,100,,Cash sale,,,,,,26/07/2018,26/07/2018,0.00,,2.16,,"-670,602.76"
,CS,AR,32006821,1005,100,,Cash sale,,,,,,26/07/2018,26/07/2018,0.00,,3.64,,"-670,606.40"
,CS,AR,32006825,1005,100,,Cash sale,,,,,,26/07/2018,26/07/2018,0.00,,19.70,,"-670,626.10"
,CS,AR,32006832,1005,100,,Cash sale,,,,,,26/07/2018,26/07/2018,0.00,,16.53,,"-670,642.63"
,CS,AR,32006840,1005,100,,Cash sale,,,,,,26/07/2018,26/07/2018,0.00,,7.29,,"-670,649.92"
,CS,AR,32006852,1005,100,,Cash sale,,,,,,26/07/2018,26/07/2018,0.00,,16.78,,"-670,666.70"
,CS,AR,32006857,1005,100,,Cash sale,,,,,,26/07/2018,26/07/2018,0.00,,3.64,,"-670,670.34"
,CS,AR,32006870,1005,100,,Cash sale,,,,,,26/07/2018,26/07/2018,0.00,,7.29,,"-670,677.63"
,CS,AR,32006878,1005,100,,Cash sale,,,,,,26/07/2018,26/07/2018,0.00,,6.53,,"-670,684.16"
,CS,AR,32006895,1005,100,,Cash sale,,,,,,26/07/2018,26/07/2018,0.00,,5.93,,"-670,690.09"
,CS,AR,32006897,1005,100,,Cash sale,,,,,,26/07/2018,26/07/2018,0.00,,10.93,,"-670,701.02"
,CS,AR,32006904,1005,100,,Cash sale,,,,,,26/07/2018,26/07/2018,0.00,,6.56,,"-670,707.58"
,CS,AR,32006906,1005,100,,Cash sale,,,,,,26/07/2018,26/07/2018,0.00,,7.29,,"-670,714.87"
,CS,AR,32006928,1005,100,,Cash sale,,,,,,26/07/2018,26/07/2018,0.00,,14.58,,"-670,729.45"
,CS,AR,32006936,1005,100,,Cash sale,,,,,,26/07/2018,26/07/2018,0.00,,18.21,,"-670,747.66"
,CS,AR,32006956,1005,100,,Cash sale,,,,,,26/07/2018,26/07/2018,0.00,,12.92,,"-670,760.58"
,CS,AR,32006987,1005,100,,Cash sale,,,,,,26/07/2018,26/07/2018,0.00,,14.58,,"-670,775.16"
,CS,AR,32006994,1005,100,,Cash sale,,,,,,26/07/2018,26/07/2018,0.00,,5.86,,"-670,781.02"
,CS,AR,32006998,1005,100,,Cash sale,,,,,,26/07/2018,26/07/2018,0.00,,6.56,,"-670,787.58"
,CS,AR,32007025,1005,100,,Cash sale,,,,,,26/07/2018,26/07/2018,0.00,,23.31,,"-670,810.89"
,CS,AR,32007037,1005,100,,Cash sale,,,,,,26/07/2018,26/07/2018,0.00,,3.64,,"-670,814.53"
,CS,AR,32007051,1005,100,,Cash sale,,,,,,26/07/2018,26/07/2018,0.00,,7.29,,"-670,821.82"
,IN,AR,30320375,1005,100,,Invoice,,,,,,26/07/2018,26/07/2018,0.00,,45.08,,"-670,866.90"
,IN,AR,30320380,1005,100,,Invoice,,,,,,26/07/2018,26/07/2018,0.00,,3.64,,"-670,870.54"
,IN,AR,30320408,1005,100,,Invoice,,,,,,26/07/2018,26/07/2018,0.00,,3.64,,"-670,874.18"
,IN,AR,30320417,1005,100,,Invoice,,,,,,26/07/2018,26/07/2018,0.00,,10.93,,"-670,885.11"
,IN,AR,30320430,1005,100,,Invoice,,,,,,26/07/2018,26/07/2018,0.00,,72.88,,"-670,957.99"
,IN,AR,30320437,1005,100,,Invoice,,,,,,26/07/2018,26/07/2018,0.00,,7.97,,"-670,965.96"
,IN,AR,30320438,1005,100,,Invoice,,,,,,26/07/2018,26/07/2018,0.00,,17.92,,"-670,983.88"
,IN,AR,30320445,1005,100,,Invoice,,,,,,26/07/2018,26/07/2018,0.00,,59.32,,"-671,043.20"
,IN,AR,30320452,1005,100,,Invoice,,,,,,26/07/2018,26/07/2018,0.00,,25.51,,"-671,068.71"
,IN,AR,30320453,1005,100,,Invoice,,,,,,26/07/2018,26/07/2018,0.00,,7.29,,"-671,076.00"
,IN,AR,30320455,1005,100,,Invoice,,,,,,26/07/2018,26/07/2018,0.00,,7.29,,"-671,083.29"
,IN,AR,30320459,1005,100,,Invoice,,,,,,26/07/2018,26/07/2018,0.00,,54.66,,"-671,137.95"
,IN,AR,30320473,1005,100,,Invoice,,,,,,26/07/2018,26/07/2018,0.00,,7.29,,"-671,145.24"
,IN,AR,30320483,1005,100,,Invoice,,,,,,26/07/2018,26/07/2018,0.00,,54.66,,"-671,199.90"
,IN,AR,30320484,1005,100,,Invoice,,,,,,26/07/2018,26/07/2018,0.00,,7.29,,"-671,207.19"
,IN,AR,30320516,1005,100,,Invoice,,,,,,26/07/2018,26/07/2018,0.00,,46.68,,"-671,253.87"
,IN,AR,30320523,1005,100,,Invoice,,,,,,26/07/2018,26/07/2018,0.00,,10.93,,"-671,264.80"
,IN,AR,30320534,1005,100,,Invoice,,,,,,26/07/2018,26/07/2018,0.00,,9.70,,"-671,274.50"
,IN,AR,30320548,1005,100,,Invoice,,,,,,26/07/2018,26/07/2018,0.00,,364.41,,"-671,638.91"
,IN,AR,30320560,1005,100,,Invoice,,,,,,26/07/2018,26/07/2018,0.00,,364.41,,"-672,003.32"
,IN,AR,30320569,1005,100,,Invoice,,,,,,26/07/2018,26/07/2018,0.00,,364.41,,"-672,367.73"
,IN,AR,30320574,1005,100,,Invoice,,,,,,26/07/2018,26/07/2018,0.00,,3.19,,"-672,370.92"
,IN,AR,30320579,1005,100,,Invoice,,,,,,26/07/2018,26/07/2018,0.00,,21.86,,"-672,392.78"
,IN,AR,30320583,1005,100,,Invoice,,,,,,26/07/2018,26/07/2018,0.00,,14.58,,"-672,407.36"
,IN,AR,30320597,1005,100,,Invoice,,,,,,26/07/2018,26/07/2018,0.00,,9.03,,"-672,416.39"
,IN,AR,30320600,1005,100,,Invoice,,,,,,26/07/2018,26/07/2018,0.00,,16.79,,"-672,433.18"
,IN,AR,30320607,1005,100,,Invoice,,,,,,26/07/2018,26/07/2018,0.00,,3.64,,"-672,436.82"
,IN,AR,30320630,1005,100,,Invoice,,,,,,26/07/2018,26/07/2018,0.00,,16.95,,"-672,453.77"
,IN,AR,30320638,1005,100,,Invoice,,,,,,26/07/2018,26/07/2018,0.00,,7.29,,"-672,461.06"
,IN,AR,30320640,1005,100,,Invoice,,,,,,26/07/2018,26/07/2018,0.00,,210.36,,"-672,671.42"
,IN,AR,30320643,1005,100,,Invoice,,,,,,26/07/2018,26/07/2018,0.00,,7.29,,"-672,678.71"
,IN,AR,30320646,1005,100,,Invoice,,,,,,26/07/2018,26/07/2018,0.00,,39.15,,"-672,717.86"
,IN,AR,30320653,1005,100,,Invoice,,,,,,26/07/2018,26/07/2018,0.00,,19.12,,"-672,736.98"
,IN,AR,30320659,1005,100,,Invoice,,,,,,26/07/2018,26/07/2018,0.00,,23.73,,"-672,760.71"
,IN,AR,30320667,1005,100,,Invoice,,,,,,26/07/2018,26/07/2018,0.00,,129.66,,"-672,890.37"
,IN,AR,30320668,1005,100,,Invoice,,,,,,26/07/2018,26/07/2018,0.00,,5.08,,"-672,895.45"
,IN,AR,30320675,1005,100,,Invoice,,,,,,26/07/2018,26/07/2018,0.00,,21.51,,"-672,916.96"
,IN,AR,30320681,1005,100,,Invoice,,,,,,26/07/2018,26/07/2018,0.00,,12.88,,"-672,929.84"
,IN,AR,30320682,1005,100,,Invoice,,,,,,26/07/2018,26/07/2018,0.00,,6.44,,"-672,936.28"
,IN,AR,30320684,1005,100,,Invoice,,,,,,26/07/2018,26/07/2018,0.00,,45.08,,"-672,981.36"
,IN,AR,30320703,1005,100,,Invoice,,,,,,26/07/2018,26/07/2018,0.00,,15.51,,"-672,996.87"
,IN,AR,30320727,1005,100,,Invoice,,,,,,26/07/2018,26/07/2018,0.00,,25.49,,"-673,022.36"
,IN,AR,30320729,1005,100,,Invoice,,,,,,26/07/2018,26/07/2018,0.00,,5.17,,"-673,027.53"
,IN,AR,30320744,1005,100,,Invoice,,,,,,26/07/2018,26/07/2018,0.00,,21.19,,"-673,048.72"
,IN,AR,30320752,1005,100,,Invoice,,,,,,26/07/2018,26/07/2018,0.00,,7.75,,"-673,056.47"
,IN,AR,30320759,1005,100,,Invoice,,,,,,26/07/2018,26/07/2018,0.00,,20.34,,"-673,076.81"
,IN,AR,30320762,1005,100,,Invoice,,,,,,26/07/2018,26/07/2018,0.00,,17.50,,"-673,094.31"
,IN,AR,30320790,1005,100,,Invoice,,,,,,26/07/2018,26/07/2018,0.00,,8.47,,"-673,102.78"
,IN,AR,30320792,1005,100,,Invoice,,,,,,26/07/2018,26/07/2018,0.00,,3.64,,"-673,106.42"
,IN,AR,30320804,1005,100,,Invoice,,,,,,26/07/2018,26/07/2018,0.00,,8.17,,"-673,114.59"
,IN,AR,30320806,1005,100,,Invoice,,,,,,26/07/2018,26/07/2018,0.00,,13.73,,"-673,128.32"
,IN,AR,30320819,1005,100,,Invoice,,,,,,26/07/2018,26/07/2018,0.00,,54.66,,"-673,182.98"
,IN,AR,30320821,1005,100,,Invoice,,,,,,26/07/2018,26/07/2018,0.00,,759.58,,"-673,942.56"
,IN,AR,30320823,1005,100,,Invoice,,,,,,26/07/2018,26/07/2018,0.00,,14.58,,"-673,957.14"
,IN,AR,30320840,1005,100,,Invoice,,,,,,26/07/2018,26/07/2018,0.00,,182.20,,"-674,139.34"
,IN,AR,30320841,1005,100,,Invoice,,,,,,26/07/2018,26/07/2018,0.00,,15.25,,"-674,154.59"
,IN,AR,30320842,1005,100,,Invoice,,,,,,26/07/2018,26/07/2018,0.00,,10.17,,"-674,164.76"
,IN,AR,30320847,1005,100,,Invoice,,,,,,26/07/2018,26/07/2018,0.00,,54.66,,"-674,219.42"
,IN,AR,30320849,1005,100,,Invoice,,,,,,26/07/2018,26/07/2018,0.00,,6.97,,"-674,226.39"
,IN,AR,30320852,1005,100,,Invoice,,,,,,26/07/2018,26/07/2018,0.00,,11.69,,"-674,238.08"
,IN,AR,30320856,1005,100,,Invoice,,,,,,26/07/2018,26/07/2018,0.00,,10.93,,"-674,249.01"
,IN,AR,30320858,1005,100,,Invoice,,,,,,26/07/2018,26/07/2018,0.00,,22.03,,"-674,271.04"
,IN,AR,30320861,1005,100,,Invoice,,,,,,26/07/2018,26/07/2018,0.00,,54.66,,"-674,325.70"
,IN,AR,30320875,1005,100,,Invoice,,,,,,26/07/2018,26/07/2018,0.00,,21.19,,"-674,346.89"
,IN,AR,30320888,1005,100,,Invoice,,,,,,26/07/2018,26/07/2018,0.00,,19.24,,"-674,366.13"
,IN,AR,30320894,1005,100,,Invoice,,,,,,26/07/2018,26/07/2018,0.00,,15.53,,"-674,381.66"
,IN,AR,30320895,1005,100,,Invoice,,,,,,26/07/2018,26/07/2018,0.00,,7.63,,"-674,389.29"
,IN,AR,30320903,1005,100,,Invoice,,,,,,26/07/2018,26/07/2018,0.00,,8.00,,"-674,397.29"
,IN,AR,30320927,1005,100,,Invoice,,,,,,26/07/2018,26/07/2018,0.00,,7.29,,"-674,404.58"
,IN,AR,30320930,1005,100,,Invoice,,,,,,26/07/2018,26/07/2018,0.00,,6.81,,"-674,411.39"
,IN,AR,30320958,1005,100,,Invoice,,,,,,26/07/2018,26/07/2018,0.00,,54.66,,"-674,466.05"
,IN,AR,30320969,1005,100,,Invoice,,,,,,26/07/2018,26/07/2018,0.00,,5.17,,"-674,471.22"
,IN,AR,30320970,1005,100,,Invoice,,,,,,26/07/2018,26/07/2018,0.00,,10.93,,"-674,482.15"
,IN,AR,30320971,1005,100,,Invoice,,,,,,26/07/2018,26/07/2018,0.00,,12.71,,"-674,494.86"
,IN,AR,30320975,1005,100,,Invoice,,,,,,26/07/2018,26/07/2018,0.00,,11.95,,"-674,506.81"
,IN,AR,30320976,1005,100,,Invoice,,,,,,26/07/2018,26/07/2018,0.00,,11.95,,"-674,518.76"
,IN,AR,30320977,1005,100,,Invoice,,,,,,26/07/2018,26/07/2018,0.00,,5.97,,"-674,524.73"
,IN,AR,30320978,1005,100,,Invoice,,,,,,26/07/2018,26/07/2018,0.00,,27.88,,"-674,552.61"
,IN,AR,30320979,1005,100,,Invoice,,,,,,26/07/2018,26/07/2018,0.00,,11.95,,"-674,564.56"
,IN,AR,30320983,1005,100,,Invoice,,,,,,26/07/2018,26/07/2018,0.00,,28.62,,"-674,593.18"
,IN,AR,30320984,1005,100,,Invoice,,,,,,26/07/2018,26/07/2018,0.00,,23.85,,"-674,617.03"
,IN,AR,30320985,1005,100,,Invoice,,,,,,26/07/2018,26/07/2018,0.00,,19.08,,"-674,636.11"
,IN,AR,30320999,1005,100,,Invoice,,,,,,26/07/2018,26/07/2018,0.00,,47.14,,"-674,683.25"
,IN,AR,30321003,1005,100,,Invoice,,,,,,26/07/2018,26/07/2018,0.00,,236.20,,"-674,919.45"
,IN,AR,30321005,1005,100,,Invoice,,,,,,26/07/2018,26/07/2018,0.00,,7.29,,"-674,926.74"
,IN,AR,30321013,1005,100,,Invoice,,,,,,26/07/2018,26/07/2018,0.00,,8.26,,"-674,935.00"
,IN,AR,30321017,1005,100,,Invoice,,,,,,26/07/2018,26/07/2018,0.00,,3.64,,"-674,938.64"
,IN,AR,30321060,1005,100,,Invoice,,,,,,26/07/2018,26/07/2018,0.00,,14.58,,"-674,953.22"
,IN,AR,30321070,1005,100,,Invoice,,,,,,26/07/2018,26/07/2018,0.00,,18.01,,"-674,971.23"
,IN,AR,30321076,1005,100,,Invoice,,,,,,26/07/2018,26/07/2018,0.00,,12.00,,"-674,983.23"
,IN,AR,30321078,1005,100,,Invoice,,,,,,26/07/2018,26/07/2018,0.00,,30.01,,"-675,013.24"
,IN,AR,30321088,1005,100,,Invoice,,,,,,26/07/2018,26/07/2018,0.00,,17.49,,"-675,030.73"
,IN,AR,30321089,1005,100,,Invoice,,,,,,26/07/2018,26/07/2018,0.00,,2.92,,"-675,033.65"
,IN,AR,30321090,1005,100,,Invoice,,,,,,26/07/2018,26/07/2018,0.00,,11.66,,"-675,045.31"
,IN,AR,30321091,1005,100,,Invoice,,,,,,26/07/2018,26/07/2018,0.00,,14.58,,"-675,059.89"
,IN,AR,30321092,1005,100,,Invoice,,,,,,26/07/2018,26/07/2018,0.00,,11.66,,"-675,071.55"
,IN,AR,30321095,1005,100,,Invoice,,,,,,26/07/2018,26/07/2018,0.00,,14.58,,"-675,086.13"
,IN,AR,30321099,1005,100,,Invoice,,,,,,26/07/2018,26/07/2018,0.00,,51.29,,"-675,137.42"
,IN,AR,30321110,1005,100,,Invoice,,,,,,26/07/2018,26/07/2018,0.00,,8.41,,"-675,145.83"
,IN,AR,30321116,1005,100,,Invoice,,,,,,26/07/2018,26/07/2018,0.00,,29.15,,"-675,174.98"
,IN,AR,30321119,1005,100,,Invoice,,,,,,26/07/2018,26/07/2018,0.00,,40.08,,"-675,215.06"
,IN,AR,30321124,1005,100,,Invoice,,,,,,26/07/2018,26/07/2018,0.00,,37.29,,"-675,252.35"
,IN,AR,30321129,1005,100,,Invoice,,,,,,26/07/2018,26/07/2018,0.00,,5.61,,"-675,257.96"
,IN,AR,30321134,1005,100,,Invoice,,,,,,26/07/2018,26/07/2018,0.00,,25.17,,"-675,283.13"
,IN,AR,30321137,1005,100,,Invoice,,,,,,26/07/2018,26/07/2018,0.00,,54.66,,"-675,337.79"
,IN,AR,30321162,1005,100,,Invoice,,,,,,26/07/2018,26/07/2018,0.00,,8.52,,"-675,346.31"
,IN,AR,30321164,1005,100,,Invoice,,,,,,26/07/2018,26/07/2018,0.00,,9.66,,"-675,355.97"
,IN,AR,30321170,1005,100,,Invoice,,,,,,26/07/2018,26/07/2018,0.00,,81.15,,"-675,437.12"
,IN,AR,30321175,1005,100,,Invoice,,,,,,26/07/2018,26/07/2018,0.00,,7.97,,"-675,445.09"
,IN,AR,30321176,1005,100,,Invoice,,,,,,26/07/2018,26/07/2018,0.00,,106.75,,"-675,551.84"
,IN,AR,30321177,1005,100,,Invoice,,,,,,26/07/2018,26/07/2018,0.00,,23.90,,"-675,575.74"
,IN,AR,30321178,1005,100,,Invoice,,,,,,26/07/2018,26/07/2018,0.00,,14.34,,"-675,590.08"
,IN,AR,30321179,1005,100,,Invoice,,,,,,26/07/2018,26/07/2018,0.00,,39.83,,"-675,629.91"
,IN,AR,30321195,1005,100,,Invoice,,,,,,26/07/2018,26/07/2018,0.00,,26.44,,"-675,656.35"
,IN,AR,30321221,1005,100,,Invoice,,,,,,26/07/2018,26/07/2018,0.00,,29.15,,"-675,685.50"
,IN,AR,30321240,1005,100,,Invoice,,,,,,26/07/2018,26/07/2018,0.00,,8.75,,"-675,694.25"
,IN,AR,30321257,1005,100,,Invoice,,,,,,26/07/2018,26/07/2018,0.00,,182.20,,"-675,876.45"
,IN,AR,30321277,1005,100,,Invoice,,,,,,26/07/2018,26/07/2018,0.00,,32.80,,"-675,909.25"
,IN,AR,30321337,1005,100,,Invoice,,,,,,26/07/2018,26/07/2018,0.00,,49.83,,"-675,959.08"
,IN,AR,30321338,1005,100,,Invoice,,,,,,26/07/2018,26/07/2018,0.00,,20.76,,"-675,979.84"
,IN,AR,30321339,1005,100,,Invoice,,,,,,26/07/2018,26/07/2018,0.00,,95.51,,"-676,075.35"
,IN,AR,30321340,1005,100,,Invoice,,,,,,26/07/2018,26/07/2018,0.00,,2.08,,"-676,077.43"
,IN,AR,30321341,1005,100,,Invoice,,,,,,26/07/2018,26/07/2018,0.00,,2.08,,"-676,079.51"
,IN,AR,30321342,1005,100,,Invoice,,,,,,26/07/2018,26/07/2018,0.00,,6.23,,"-676,085.74"
,IN,AR,30321351,1005,100,,Invoice,,,,,,26/07/2018,26/07/2018,0.00,,10.93,,"-676,096.67"
,IN,AR,30321376,1005,100,,Invoice,,,,,,26/07/2018,26/07/2018,0.00,,2.03,,"-676,098.70"
,IN,AR,30321381,1005,100,,Invoice,,,,,,26/07/2018,26/07/2018,0.00,,29.15,,"-676,127.85"
,IN,AR,30321384,1005,100,,Invoice,,,,,,26/07/2018,26/07/2018,0.00,,14.58,,"-676,142.43"
,IN,AR,30321428,1005,100,,Invoice,,,,,,26/07/2018,26/07/2018,0.00,,10.93,,"-676,153.36"
,CN,AR,31018432,1005,100,,Credit Note,,,,,,27/07/2018,27/07/2018,41.95,,0.00,,"-676,111.41"
,CS,AR,32006559,1005,100,,Cash sale,,,,,,27/07/2018,27/07/2018,0.00,,13.74,,"-676,125.15"
,CS,AR,32006566,1005,100,,Cash sale,,,,,,27/07/2018,27/07/2018,0.00,,16.83,,"-676,141.98"
,CS,AR,32006568,1005,100,,Cash sale,,,,,,27/07/2018,27/07/2018,0.00,,11.19,,"-676,153.17"
,CS,AR,32006574,1005,100,,Cash sale,,,,,,27/07/2018,27/07/2018,0.00,,8.52,,"-676,161.69"
,CS,AR,32006578,1005,100,,Cash sale,,,,,,27/07/2018,27/07/2018,0.00,,12.17,,"-676,173.86"
,CS,AR,32006583,1005,100,,Cash sale,,,,,,27/07/2018,27/07/2018,0.00,,7.29,,"-676,181.15"
,CS,AR,32006610,1005,100,,Cash sale,,,,,,27/07/2018,27/07/2018,0.00,,14.49,,"-676,195.64"
,CS,AR,32006620,1005,100,,Cash sale,,,,,,27/07/2018,27/07/2018,0.00,,18.22,,"-676,213.86"
,CS,AR,32006623,1005,100,,Cash sale,,,,,,27/07/2018,27/07/2018,0.00,,12.46,,"-676,226.32"
,CS,AR,32006629,1005,100,,Cash sale,,,,,,27/07/2018,27/07/2018,0.00,,3.64,,"-676,229.96"
,CS,AR,32006636,1005,100,,Cash sale,,,,,,27/07/2018,27/07/2018,0.00,,8.77,,"-676,238.73"
,CS,AR,32006641,1005,100,,Cash sale,,,,,,27/07/2018,27/07/2018,0.00,,25.25,,"-676,263.98"
,CS,AR,32006648,1005,100,,Cash sale,,,,,,27/07/2018,27/07/2018,0.00,,23.29,,"-676,287.27"
,CS,AR,32006683,1005,100,,Cash sale,,,,,,27/07/2018,27/07/2018,0.00,,7.29,,"-676,294.56"
,CS,AR,32006685,1005,100,,Cash sale,,,,,,27/07/2018,27/07/2018,0.00,,2.58,,"-676,297.14"
,CS,AR,32006690,1005,100,,Cash sale,,,,,,27/07/2018,27/07/2018,0.00,,12.71,,"-676,309.85"
,CS,AR,32006702,1005,100,,Cash sale,,,,,,27/07/2018,27/07/2018,0.00,,3.64,,"-676,313.49"
,CS,AR,32006705,1005,100,,Cash sale,,,,,,27/07/2018,27/07/2018,0.00,,35.72,,"-676,349.21"
,CS,AR,32006708,1005,100,,Cash sale,,,,,,27/07/2018,27/07/2018,0.00,,5.61,,"-676,354.82"
,CS,AR,32006717,1005,100,,Cash sale,,,,,,27/07/2018,27/07/2018,0.00,,10.93,,"-676,365.75"
,CS,AR,32006720,1005,100,,Cash sale,,,,,,27/07/2018,27/07/2018,0.00,,3.01,,"-676,368.76"
,CS,AR,32006721,1005,100,,Cash sale,,,,,,27/07/2018,27/07/2018,0.00,,21.06,,"-676,389.82"
,CS,AR,32006724,1005,100,,Cash sale,,,,,,27/07/2018,27/07/2018,0.00,,18.22,,"-676,408.04"
,CS,AR,32006736,1005,100,,Cash sale,,,,,,27/07/2018,27/07/2018,0.00,,10.17,,"-676,418.21"
,CS,AR,32006754,1005,100,,Cash sale,,,,,,27/07/2018,27/07/2018,0.00,,7.29,,"-676,425.50"
,CS,AR,32006755,1005,100,,Cash sale,,,,,,27/07/2018,27/07/2018,0.00,,15.25,,"-676,440.75"
,CS,AR,32006759,1005,100,,Cash sale,,,,,,27/07/2018,27/07/2018,0.00,,10.34,,"-676,451.09"
,CS,AR,32006761,1005,100,,Cash sale,,,,,,27/07/2018,27/07/2018,0.00,,10.93,,"-676,462.02"
,CS,AR,32006771,1005,100,,Cash sale,,,,,,27/07/2018,27/07/2018,0.00,,3.64,,"-676,465.66"
,CS,AR,32006774,1005,100,,Cash sale,,,,,,27/07/2018,27/07/2018,0.00,,14.58,,"-676,480.24"
,CS,AR,32006805,1005,100,,Cash sale,,,,,,27/07/2018,27/07/2018,0.00,,25.51,,"-676,505.75"
,CS,AR,32006814,1005,100,,Cash sale,,,,,,27/07/2018,27/07/2018,0.00,,10.93,,"-676,516.68"
,CS,AR,32006817,1005,100,,Cash sale,,,,,,27/07/2018,27/07/2018,0.00,,7.29,,"-676,523.97"
,CS,AR,32006818,1005,100,,Cash sale,,,,,,27/07/2018,27/07/2018,0.00,,10.93,,"-676,534.90"
,CS,AR,32006826,1005,100,,Cash sale,,,,,,27/07/2018,27/07/2018,0.00,,5.17,,"-676,540.07"
,CS,AR,32006837,1005,100,,Cash sale,,,,,,27/07/2018,27/07/2018,0.00,,7.29,,"-676,547.36"
,CS,AR,32006843,1005,100,,Cash sale,,,,,,27/07/2018,27/07/2018,0.00,,13.90,,"-676,561.26"
,CS,AR,32006854,1005,100,,Cash sale,,,,,,27/07/2018,27/07/2018,0.00,,3.64,,"-676,564.90"
,CS,AR,32006855,1005,100,,Cash sale,,,,,,27/07/2018,27/07/2018,0.00,,7.29,,"-676,572.19"
,CS,AR,32006863,1005,100,,Cash sale,,,,,,27/07/2018,27/07/2018,0.00,,7.29,,"-676,579.48"
,CS,AR,32006877,1005,100,,Cash sale,,,,,,27/07/2018,27/07/2018,0.00,,29.15,,"-676,608.63"
,CS,AR,32006886,1005,100,,Cash sale,,,,,,27/07/2018,27/07/2018,0.00,,44.00,,"-676,652.63"
,CS,AR,32006889,1005,100,,Cash sale,,,,,,27/07/2018,27/07/2018,0.00,,3.64,,"-676,656.27"
,CS,AR,32006899,1005,100,,Cash sale,,,,,,27/07/2018,27/07/2018,0.00,,13.12,,"-676,669.39"
,CS,AR,32006901,1005,100,,Cash sale,,,,,,27/07/2018,27/07/2018,0.00,,25.51,,"-676,694.90"
,CS,AR,32006903,1005,100,,Cash sale,,,,,,27/07/2018,27/07/2018,0.00,,5.18,,"-676,700.08"
,CS,AR,32006911,1005,100,,Cash sale,,,,,,27/07/2018,27/07/2018,0.00,,6.86,,"-676,706.94"
,CS,AR,32006915,1005,100,,Cash sale,,,,,,27/07/2018,27/07/2018,0.00,,10.93,,"-676,717.87"
,CS,AR,32006926,1005,100,,Cash sale,,,,,,27/07/2018,27/07/2018,0.00,,15.25,,"-676,733.12"
,CS,AR,32006932,1005,100,,Cash sale,,,,,,27/07/2018,27/07/2018,0.00,,42.50,,"-676,775.62"
,CS,AR,32006945,1005,100,,Cash sale,,,,,,27/07/2018,27/07/2018,0.00,,10.93,,"-676,786.55"
,CS,AR,32006948,1005,100,,Cash sale,,,,,,27/07/2018,27/07/2018,0.00,,5.08,,"-676,791.63"
,CS,AR,32006957,1005,100,,Cash sale,,,,,,27/07/2018,27/07/2018,0.00,,54.66,,"-676,846.29"
,CS,AR,32006959,1005,100,,Cash sale,,,,,,27/07/2018,27/07/2018,0.00,,6.23,,"-676,852.52"
,CS,AR,32006960,1005,100,,Cash sale,,,,,,27/07/2018,27/07/2018,0.00,,5.93,,"-676,858.45"
,CS,AR,32006963,1005,100,,Cash sale,,,,,,27/07/2018,27/07/2018,0.00,,25.51,,"-676,883.96"
,CS,AR,32006965,1005,100,,Cash sale,,,,,,27/07/2018,27/07/2018,0.00,,20.41,,"-676,904.37"
,CS,AR,32006971,1005,100,,Cash sale,,,,,,27/07/2018,27/07/2018,0.00,,7.29,,"-676,911.66"
,CS,AR,32006974,1005,100,,Cash sale,,,,,,27/07/2018,27/07/2018,0.00,,15.21,,"-676,926.87"
,CS,AR,32006979,1005,100,,Cash sale,,,,,,27/07/2018,27/07/2018,0.00,,10.93,,"-676,937.80"
,CS,AR,32006996,1005,100,,Cash sale,,,,,,27/07/2018,27/07/2018,0.00,,3.64,,"-676,941.44"
,CS,AR,32007011,1005,100,,Cash sale,,,,,,27/07/2018,27/07/2018,0.00,,10.93,,"-676,952.37"
,CS,AR,32007039,1005,100,,Cash sale,,,,,,27/07/2018,27/07/2018,0.00,,12.71,,"-676,965.08"
,CS,AR,32007046,1005,100,,Cash sale,,,,,,27/07/2018,27/07/2018,0.00,,7.29,,"-676,972.37"
,CS,AR,32007053,1005,100,,Cash sale,,,,,,27/07/2018,27/07/2018,0.00,,10.93,,"-676,983.30"
,IN,AR,30320368,1005,100,,Invoice,,,,,,27/07/2018,27/07/2018,0.00,,20.76,,"-677,004.06"
,IN,AR,30320371,1005,100,,Invoice,,,,,,27/07/2018,27/07/2018,0.00,,36.44,,"-677,040.50"
,IN,AR,30320374,1005,100,,Invoice,,,,,,27/07/2018,27/07/2018,0.00,,364.41,,"-677,404.91"
,IN,AR,30320402,1005,100,,Invoice,,,,,,27/07/2018,27/07/2018,0.00,,9.49,,"-677,414.40"
,IN,AR,30320405,1005,100,,Invoice,,,,,,27/07/2018,27/07/2018,0.00,,21.86,,"-677,436.26"
,IN,AR,30320411,1005,100,,Invoice,,,,,,27/07/2018,27/07/2018,0.00,,10.51,,"-677,446.77"
,IN,AR,30320416,1005,100,,Invoice,,,,,,27/07/2018,27/07/2018,0.00,,24.15,,"-677,470.92"
,IN,AR,30320427,1005,100,,Invoice,,,,,,27/07/2018,27/07/2018,0.00,,54.03,,"-677,524.95"
,IN,AR,30320432,1005,100,,Invoice,,,,,,27/07/2018,27/07/2018,0.00,,18.37,,"-677,543.32"
,IN,AR,30320434,1005,100,,Invoice,,,,,,27/07/2018,27/07/2018,0.00,,79.57,,"-677,622.89"
,IN,AR,30320446,1005,100,,Invoice,,,,,,27/07/2018,27/07/2018,0.00,,45.08,,"-677,667.97"
,IN,AR,30320461,1005,100,,Invoice,,,,,,27/07/2018,27/07/2018,0.00,,56.00,,"-677,723.97"
,IN,AR,30320463,1005,100,,Invoice,,,,,,27/07/2018,27/07/2018,0.00,,54.66,,"-677,778.63"
,IN,AR,30320464,1005,100,,Invoice,,,,,,27/07/2018,27/07/2018,0.00,,23.73,,"-677,802.36"
,IN,AR,30320480,1005,100,,Invoice,,,,,,27/07/2018,27/07/2018,0.00,,44.00,,"-677,846.36"
,IN,AR,30320495,1005,100,,Invoice,,,,,,27/07/2018,27/07/2018,0.00,,364.41,,"-678,210.77"
,IN,AR,30320498,1005,100,,Invoice,,,,,,27/07/2018,27/07/2018,0.00,,182.20,,"-678,392.97"
,IN,AR,30320506,1005,100,,Invoice,,,,,,27/07/2018,27/07/2018,0.00,,7.12,,"-678,400.09"
,IN,AR,30320509,1005,100,,Invoice,,,,,,27/07/2018,27/07/2018,0.00,,14.00,,"-678,414.09"
,IN,AR,30320535,1005,100,,Invoice,,,,,,27/07/2018,27/07/2018,0.00,,19.41,,"-678,433.50"
,IN,AR,30320536,1005,100,,Invoice,,,,,,27/07/2018,27/07/2018,0.00,,9.70,,"-678,443.20"
,IN,AR,30320537,1005,100,,Invoice,,,,,,27/07/2018,27/07/2018,0.00,,69.31,,"-678,512.51"
,IN,AR,30320543,1005,100,,Invoice,,,,,,27/07/2018,27/07/2018,0.00,,58.00,,"-678,570.51"
,IN,AR,30320546,1005,100,,Invoice,,,,,,27/07/2018,27/07/2018,0.00,,7.29,,"-678,577.80"
,IN,AR,30320555,1005,100,,Invoice,,,,,,27/07/2018,27/07/2018,0.00,,29.15,,"-678,606.95"
,IN,AR,30320557,1005,100,,Invoice,,,,,,27/07/2018,27/07/2018,0.00,,19.58,,"-678,626.53"
,IN,AR,30320572,1005,100,,Invoice,,,,,,27/07/2018,27/07/2018,0.00,,3.64,,"-678,630.17"
,IN,AR,30320585,1005,100,,Invoice,,,,,,27/07/2018,27/07/2018,0.00,,28.00,,"-678,658.17"
,IN,AR,30320587,1005,100,,Invoice,,,,,,27/07/2018,27/07/2018,0.00,,7.75,,"-678,665.92"
,IN,AR,30320592,1005,100,,Invoice,,,,,,27/07/2018,27/07/2018,0.00,,182.20,,"-678,848.12"
,IN,AR,30320601,1005,100,,Invoice,,,,,,27/07/2018,27/07/2018,0.00,,9.59,,"-678,857.71"
,IN,AR,30320622,1005,100,,Invoice,,,,,,27/07/2018,27/07/2018,0.00,,18.05,,"-678,875.76"
,IN,AR,30320634,1005,100,,Invoice,,,,,,27/07/2018,27/07/2018,0.00,,49.11,,"-678,924.87"
,IN,AR,30320637,1005,100,,Invoice,,,,,,27/07/2018,27/07/2018,0.00,,4.78,,"-678,929.65"
,IN,AR,30320651,1005,100,,Invoice,,,,,,27/07/2018,27/07/2018,0.00,,6.02,,"-678,935.67"
,IN,AR,30320663,1005,100,,Invoice,,,,,,27/07/2018,27/07/2018,0.00,,65.63,,"-679,001.30"
,IN,AR,30320690,1005,100,,Invoice,,,,,,27/07/2018,27/07/2018,0.00,,12.71,,"-679,014.01"
,IN,AR,30320700,1005,100,,Invoice,,,,,,27/07/2018,27/07/2018,0.00,,364.41,,"-679,378.42"
,IN,AR,30320704,1005,100,,Invoice,,,,,,27/07/2018,27/07/2018,0.00,,12.92,,"-679,391.34"
,IN,AR,30320706,1005,100,,Invoice,,,,,,27/07/2018,27/07/2018,0.00,,54.66,,"-679,446.00"
,IN,AR,30320709,1005,100,,Invoice,,,,,,27/07/2018,27/07/2018,0.00,,9.03,,"-679,455.03"
,IN,AR,30320711,1005,100,,Invoice,,,,,,27/07/2018,27/07/2018,0.00,,2.12,,"-679,457.15"
,IN,AR,30320714,1005,100,,Invoice,,,,,,27/07/2018,27/07/2018,0.00,,40.08,,"-679,497.23"
,IN,AR,30320715,1005,100,,Invoice,,,,,,27/07/2018,27/07/2018,0.00,,2.39,,"-679,499.62"
,IN,AR,30320721,1005,100,,Invoice,,,,,,27/07/2018,27/07/2018,0.00,,2.54,,"-679,502.16"
,IN,AR,30320722,1005,100,,Invoice,,,,,,27/07/2018,27/07/2018,0.00,,10.17,,"-679,512.33"
,IN,AR,30320725,1005,100,,Invoice,,,,,,27/07/2018,27/07/2018,0.00,,5.08,,"-679,517.41"
,IN,AR,30320737,1005,100,,Invoice,,,,,,27/07/2018,27/07/2018,0.00,,15.25,,"-679,532.66"
,IN,AR,30320742,1005,100,,Invoice,,,,,,27/07/2018,27/07/2018,0.00,,12.71,,"-679,545.37"
,IN,AR,30320749,1005,100,,Invoice,,,,,,27/07/2018,27/07/2018,0.00,,10.93,,"-679,556.30"
,IN,AR,30320756,1005,100,,Invoice,,,,,,27/07/2018,27/07/2018,0.00,,14.58,,"-679,570.88"
,IN,AR,30320777,1005,100,,Invoice,,,,,,27/07/2018,27/07/2018,0.00,,10.99,,"-679,581.87"
,IN,AR,30320812,1005,100,,Invoice,,,,,,27/07/2018,27/07/2018,0.00,,11.22,,"-679,593.09"
,IN,AR,30320818,1005,100,,Invoice,,,,,,27/07/2018,27/07/2018,0.00,,21.00,,"-679,614.09"
,IN,AR,30320828,1005,100,,Invoice,,,,,,27/07/2018,27/07/2018,0.00,,4.24,,"-679,618.33"
,IN,AR,30320830,1005,100,,Invoice,,,,,,27/07/2018,27/07/2018,0.00,,12.71,,"-679,631.04"
,IN,AR,30320851,1005,100,,Invoice,,,,,,27/07/2018,27/07/2018,0.00,,20.48,,"-679,651.52"
,IN,AR,30320864,1005,100,,Invoice,,,,,,27/07/2018,27/07/2018,0.00,,5.17,,"-679,656.69"
,IN,AR,30320911,1005,100,,Invoice,,,,,,27/07/2018,27/07/2018,0.00,,29.15,,"-679,685.84"
,IN,AR,30320919,1005,100,,Invoice,,,,,,27/07/2018,27/07/2018,0.00,,8.81,,"-679,694.65"
,IN,AR,30320920,1005,100,,Invoice,,,,,,27/07/2018,27/07/2018,0.00,,3.53,,"-679,698.18"
,IN,AR,30320929,1005,100,,Invoice,,,,,,27/07/2018,27/07/2018,0.00,,4.85,,"-679,703.03"
,IN,AR,30320933,1005,100,,Invoice,,,,,,27/07/2018,27/07/2018,0.00,,54.66,,"-679,757.69"
,IN,AR,30320963,1005,100,,Invoice,,,,,,27/07/2018,27/07/2018,0.00,,7.75,,"-679,765.44"
,IN,AR,30320964,1005,100,,Invoice,,,,,,27/07/2018,27/07/2018,0.00,,5.68,,"-679,771.12"
,IN,AR,30320986,1005,100,,Invoice,,,,,,27/07/2018,27/07/2018,0.00,,241.68,,"-680,012.80"
,IN,AR,30320994,1005,100,,Invoice,,,,,,27/07/2018,27/07/2018,0.00,,28.39,,"-680,041.19"
,IN,AR,30321010,1005,100,,Invoice,,,,,,27/07/2018,27/07/2018,0.00,,32.07,,"-680,073.26"
,IN,AR,30321016,1005,100,,Invoice,,,,,,27/07/2018,27/07/2018,0.00,,8.21,,"-680,081.47"
,IN,AR,30321020,1005,100,,Invoice,,,,,,27/07/2018,27/07/2018,0.00,,24.29,,"-680,105.76"
,IN,AR,30321024,1005,100,,Invoice,,,,,,27/07/2018,27/07/2018,0.00,,18.05,,"-680,123.81"
,IN,AR,30321025,1005,100,,Invoice,,,,,,27/07/2018,27/07/2018,0.00,,12.03,,"-680,135.84"
,IN,AR,30321029,1005,100,,Invoice,,,,,,27/07/2018,27/07/2018,0.00,,10.81,,"-680,146.65"
,IN,AR,30321039,1005,100,,Invoice,,,,,,27/07/2018,27/07/2018,0.00,,10.93,,"-680,157.58"
,IN,AR,30321043,1005,100,,Invoice,,,,,,27/07/2018,27/07/2018,0.00,,55.17,,"-680,212.75"
,IN,AR,30321048,1005,100,,Invoice,,,,,,27/07/2018,27/07/2018,0.00,,7.29,,"-680,220.04"
,IN,AR,30321059,1005,100,,Invoice,,,,,,27/07/2018,27/07/2018,0.00,,31.08,,"-680,251.12"
,IN,AR,30321069,1005,100,,Invoice,,,,,,27/07/2018,27/07/2018,0.00,,12.71,,"-680,263.83"
,IN,AR,30321073,1005,100,,Invoice,,,,,,27/07/2018,27/07/2018,0.00,,14.00,,"-680,277.83"
,IN,AR,30321083,1005,100,,Invoice,,,,,,27/07/2018,27/07/2018,0.00,,40.01,,"-680,317.84"
,IN,AR,30321085,1005,100,,Invoice,,,,,,27/07/2018,27/07/2018,0.00,,54.66,,"-680,372.50"
,IN,AR,30321086,1005,100,,Invoice,,,,,,27/07/2018,27/07/2018,0.00,,54.66,,"-680,427.16"
,IN,AR,30321093,1005,100,,Invoice,,,,,,27/07/2018,27/07/2018,0.00,,5.83,,"-680,432.99"
,IN,AR,30321105,1005,100,,Invoice,,,,,,27/07/2018,27/07/2018,0.00,,27.37,,"-680,460.36"
,IN,AR,30321111,1005,100,,Invoice,,,,,,27/07/2018,27/07/2018,0.00,,73.59,,"-680,533.95"
,IN,AR,30321132,1005,100,,Invoice,,,,,,27/07/2018,27/07/2018,0.00,,9.19,,"-680,543.14"
,IN,AR,30321151,1005,100,,Invoice,,,,,,27/07/2018,27/07/2018,0.00,,9.84,,"-680,552.98"
,IN,AR,30321180,1005,100,,Invoice,,,,,,27/07/2018,27/07/2018,0.00,,28.68,,"-680,581.66"
,IN,AR,30321201,1005,100,,Invoice,,,,,,27/07/2018,27/07/2018,0.00,,16.00,,"-680,597.66"
,IN,AR,30321203,1005,100,,Invoice,,,,,,27/07/2018,27/07/2018,0.00,,29.15,,"-680,626.81"
,IN,AR,30321227,1005,100,,Invoice,,,,,,27/07/2018,27/07/2018,0.00,,29.15,,"-680,655.96"
,IN,AR,30321232,1005,100,,Invoice,,,,,,27/07/2018,27/07/2018,0.00,,29.15,,"-680,685.11"
,IN,AR,30321233,1005,100,,Invoice,,,,,,27/07/2018,27/07/2018,0.00,,27.03,,"-680,712.14"
,IN,AR,30321246,1005,100,,Invoice,,,,,,27/07/2018,27/07/2018,0.00,,16.42,,"-680,728.56"
,IN,AR,30321250,1005,100,,Invoice,,,,,,27/07/2018,27/07/2018,0.00,,364.41,,"-681,092.97"
,IN,AR,30321254,1005,100,,Invoice,,,,,,27/07/2018,27/07/2018,0.00,,27.54,,"-681,120.51"
,IN,AR,30321263,1005,100,,Invoice,,,,,,27/07/2018,27/07/2018,0.00,,7.29,,"-681,127.80"
,IN,AR,30321272,1005,100,,Invoice,,,,,,27/07/2018,27/07/2018,0.00,,8.17,,"-681,135.97"
,IN,AR,30321296,1005,100,,Invoice,,,,,,27/07/2018,27/07/2018,0.00,,3.98,,"-681,139.95"
,IN,AR,30321305,1005,100,,Invoice,,,,,,27/07/2018,27/07/2018,0.00,,15.18,,"-681,155.13"
,IN,AR,30321313,1005,100,,Invoice,,,,,,27/07/2018,27/07/2018,0.00,,6.00,,"-681,161.13"
,IN,AR,30321314,1005,100,,Invoice,,,,,,27/07/2018,27/07/2018,0.00,,2.00,,"-681,163.13"
,IN,AR,30321354,1005,100,,Invoice,,,,,,27/07/2018,27/07/2018,0.00,,54.66,,"-681,217.79"
,IN,AR,30321356,1005,100,,Invoice,,,,,,27/07/2018,27/07/2018,0.00,,5.08,,"-681,222.87"
,IN,AR,30321372,1005,100,,Invoice,,,,,,27/07/2018,27/07/2018,0.00,,54.66,,"-681,277.53"
,IN,AR,30321373,1005,100,,Invoice,,,,,,27/07/2018,27/07/2018,0.00,,14.58,,"-681,292.11"
,IN,AR,30321377,1005,100,,Invoice,,,,,,27/07/2018,27/07/2018,0.00,,2.03,,"-681,294.14"
,IN,AR,30321387,1005,100,,Invoice,,,,,,27/07/2018,27/07/2018,0.00,,29.15,,"-681,323.29"
,IN,AR,30321401,1005,100,,Invoice,,,,,,27/07/2018,27/07/2018,0.00,,7.29,,"-681,330.58"
,CS,AR,32006593,1005,100,,Cash sale,,,,,,28/07/2018,28/07/2018,0.00,,7.29,,"-681,337.87"
,CS,AR,32006668,1005,100,,Cash sale,,,,,,28/07/2018,28/07/2018,0.00,,9.03,,"-681,346.90"
,CS,AR,32006729,1005,100,,Cash sale,,,,,,28/07/2018,28/07/2018,0.00,,18.22,,"-681,365.12"
,CS,AR,32006733,1005,100,,Cash sale,,,,,,28/07/2018,28/07/2018,0.00,,7.75,,"-681,372.87"
,CS,AR,32006760,1005,100,,Cash sale,,,,,,28/07/2018,28/07/2018,0.00,,7.29,,"-681,380.16"
,CS,AR,32006822,1005,100,,Cash sale,,,,,,28/07/2018,28/07/2018,0.00,,3.64,,"-681,383.80"
,CS,AR,32006867,1005,100,,Cash sale,,,,,,28/07/2018,28/07/2018,0.00,,10.93,,"-681,394.73"
,CS,AR,32006917,1005,100,,Cash sale,,,,,,28/07/2018,28/07/2018,0.00,,5.93,,"-681,400.66"
,CS,AR,32006940,1005,100,,Cash sale,,,,,,28/07/2018,28/07/2018,0.00,,12.92,,"-681,413.58"
,CS,AR,32006952,1005,100,,Cash sale,,,,,,28/07/2018,28/07/2018,0.00,,12.20,,"-681,425.78"
,CS,AR,32007002,1005,100,,Cash sale,,,,,,28/07/2018,28/07/2018,0.00,,5.85,,"-681,431.63"
,CS,AR,32007004,1005,100,,Cash sale,,,,,,28/07/2018,28/07/2018,0.00,,3.64,,"-681,435.27"
,IN,AR,30320447,1005,100,,Invoice,,,,,,28/07/2018,28/07/2018,0.00,,59.32,,"-681,494.59"
,IN,AR,30320538,1005,100,,Invoice,,,,,,28/07/2018,28/07/2018,0.00,,14.58,,"-681,509.17"
,IN,AR,30320540,1005,100,,Invoice,,,,,,28/07/2018,28/07/2018,0.00,,7.29,,"-681,516.46"
,IN,AR,30320589,1005,100,,Invoice,,,,,,28/07/2018,28/07/2018,0.00,,10.34,,"-681,526.80"
,IN,AR,30320656,1005,100,,Invoice,,,,,,28/07/2018,28/07/2018,0.00,,612.20,,"-682,139.00"
,IN,AR,30320931,1005,100,,Invoice,,,,,,28/07/2018,28/07/2018,0.00,,10.93,,"-682,149.93"
,IN,AR,30320957,1005,100,,Invoice,,,,,,28/07/2018,28/07/2018,0.00,,3.64,,"-682,153.57"
,IN,AR,30321094,1005,100,,Invoice,,,,,,28/07/2018,28/07/2018,0.00,,4.24,,"-682,157.81"
,IN,AR,30321157,1005,100,,Invoice,,,,,,28/07/2018,28/07/2018,0.00,,14.58,,"-682,172.39"
,IN,AR,30321216,1005,100,,Invoice,,,,,,28/07/2018,28/07/2018,0.00,,18.22,,"-682,190.61"
,IN,AR,30321309,1005,100,,Invoice,,,,,,28/07/2018,28/07/2018,0.00,,7.29,,"-682,197.90"
,IN,AR,30321411,1005,100,,Invoice,,,,,,28/07/2018,28/07/2018,0.00,,31.54,,"-682,229.44"
,CS,AR,32006876,1005,100,,Cash sale,,,,,,29/07/2018,29/07/2018,0.00,,29.15,,"-682,258.59"
,CS,AR,32006567,1005,100,,Cash sale,,,,,,30/07/2018,30/07/2018,0.00,,14.03,,"-682,272.62"
,CS,AR,32006571,1005,100,,Cash sale,,,,,,30/07/2018,30/07/2018,0.00,,7.12,,"-682,279.74"
,CS,AR,32006588,1005,100,,Cash sale,,,,,,30/07/2018,30/07/2018,0.00,,7.29,,"-682,287.03"
,CS,AR,32006602,1005,100,,Cash sale,,,,,,30/07/2018,30/07/2018,0.00,,7.29,,"-682,294.32"
,CS,AR,32006617,1005,100,,Cash sale,,,,,,30/07/2018,30/07/2018,0.00,,3.64,,"-682,297.96"
,CS,AR,32006618,1005,100,,Cash sale,,,,,,30/07/2018,30/07/2018,0.00,,10.93,,"-682,308.89"
,CS,AR,32006624,1005,100,,Cash sale,,,,,,30/07/2018,30/07/2018,0.00,,12.46,,"-682,321.35"
,CS,AR,32006634,1005,100,,Cash sale,,,,,,30/07/2018,30/07/2018,0.00,,10.93,,"-682,332.28"
,CS,AR,32006637,1005,100,,Cash sale,,,,,,30/07/2018,30/07/2018,0.00,,8.77,,"-682,341.05"
,CS,AR,32006655,1005,100,,Cash sale,,,,,,30/07/2018,30/07/2018,0.00,,3.64,,"-682,344.69"
,CS,AR,32006658,1005,100,,Cash sale,,,,,,30/07/2018,30/07/2018,0.00,,3.64,,"-682,348.33"
,CS,AR,32006660,1005,100,,Cash sale,,,,,,30/07/2018,30/07/2018,0.00,,3.64,,"-682,351.97"
,CS,AR,32006663,1005,100,,Cash sale,,,,,,30/07/2018,30/07/2018,0.00,,10.34,,"-682,362.31"
,CS,AR,32006677,1005,100,,Cash sale,,,,,,30/07/2018,30/07/2018,0.00,,3.64,,"-682,365.95"
,CS,AR,32006680,1005,100,,Cash sale,,,,,,30/07/2018,30/07/2018,0.00,,7.29,,"-682,373.24"
,CS,AR,32006691,1005,100,,Cash sale,,,,,,30/07/2018,30/07/2018,0.00,,12.71,,"-682,385.95"
,CS,AR,32006710,1005,100,,Cash sale,,,,,,30/07/2018,30/07/2018,0.00,,19.24,,"-682,405.19"
,CS,AR,32006713,1005,100,,Cash sale,,,,,,30/07/2018,30/07/2018,0.00,,10.72,,"-682,415.91"
,CS,AR,32006715,1005,100,,Cash sale,,,,,,30/07/2018,30/07/2018,0.00,,3.64,,"-682,419.55"
,CS,AR,32006716,1005,100,,Cash sale,,,,,,30/07/2018,30/07/2018,0.00,,10.93,,"-682,430.48"
,CS,AR,32006726,1005,100,,Cash sale,,,,,,30/07/2018,30/07/2018,0.00,,3.64,,"-682,434.12"
,CS,AR,32006728,1005,100,,Cash sale,,,,,,30/07/2018,30/07/2018,0.00,,10.93,,"-682,445.05"
,CS,AR,32006737,1005,100,,Cash sale,,,,,,30/07/2018,30/07/2018,0.00,,7.63,,"-682,452.68"
,CS,AR,32006742,1005,100,,Cash sale,,,,,,30/07/2018,30/07/2018,0.00,,29.24,,"-682,481.92"
,CS,AR,32006747,1005,100,,Cash sale,,,,,,30/07/2018,30/07/2018,0.00,,42.12,,"-682,524.04"
,CS,AR,32006748,1005,100,,Cash sale,,,,,,30/07/2018,30/07/2018,0.00,,30.08,,"-682,554.12"
,CS,AR,32006749,1005,100,,Cash sale,,,,,,30/07/2018,30/07/2018,0.00,,6.86,,"-682,560.98"
,CS,AR,32006756,1005,100,,Cash sale,,,,,,30/07/2018,30/07/2018,0.00,,7.29,,"-682,568.27"
,CS,AR,32006768,1005,100,,Cash sale,,,,,,30/07/2018,30/07/2018,0.00,,7.29,,"-682,575.56"
,CS,AR,32006772,1005,100,,Cash sale,,,,,,30/07/2018,30/07/2018,0.00,,15.04,,"-682,590.60"
,CS,AR,32006783,1005,100,,Cash sale,,,,,,30/07/2018,30/07/2018,0.00,,15.76,,"-682,606.36"
,CS,AR,32006785,1005,100,,Cash sale,,,,,,30/07/2018,30/07/2018,0.00,,2.54,,"-682,608.90"
,CS,AR,32006789,1005,100,,Cash sale,,,,,,30/07/2018,30/07/2018,0.00,,7.29,,"-682,616.19"
,CS,AR,32006793,1005,100,,Cash sale,,,,,,30/07/2018,30/07/2018,0.00,,10.17,,"-682,626.36"
,CS,AR,32006798,1005,100,,Cash sale,,,,,,30/07/2018,30/07/2018,0.00,,10.93,,"-682,637.29"
,CS,AR,32006800,1005,100,,Cash sale,,,,,,30/07/2018,30/07/2018,0.00,,8.77,,"-682,646.06"
,CS,AR,32006809,1005,100,,Cash sale,,,,,,30/07/2018,30/07/2018,0.00,,3.64,,"-682,649.70"
,CS,AR,32006812,1005,100,,Cash sale,,,,,,30/07/2018,30/07/2018,0.00,,14.58,,"-682,664.28"
,CS,AR,32006816,1005,100,,Cash sale,,,,,,30/07/2018,30/07/2018,0.00,,6.02,,"-682,670.30"
,CS,AR,32006820,1005,100,,Cash sale,,,,,,30/07/2018,30/07/2018,0.00,,18.22,,"-682,688.52"
,CS,AR,32006849,1005,100,,Cash sale,,,,,,30/07/2018,30/07/2018,0.00,,7.29,,"-682,695.81"
,CS,AR,32006856,1005,100,,Cash sale,,,,,,30/07/2018,30/07/2018,0.00,,14.58,,"-682,710.39"
,CS,AR,32006869,1005,100,,Cash sale,,,,,,30/07/2018,30/07/2018,0.00,,5.49,,"-682,715.88"
,CS,AR,32006912,1005,100,,Cash sale,,,,,,30/07/2018,30/07/2018,0.00,,13.73,,"-682,729.61"
,CS,AR,32006931,1005,100,,Cash sale,,,,,,30/07/2018,30/07/2018,0.00,,6.86,,"-682,736.47"
,CS,AR,32006946,1005,100,,Cash sale,,,,,,30/07/2018,30/07/2018,0.00,,7.29,,"-682,743.76"
,CS,AR,32006970,1005,100,,Cash sale,,,,,,30/07/2018,30/07/2018,0.00,,7.29,,"-682,751.05"
,CS,AR,32006992,1005,100,,Cash sale,,,,,,30/07/2018,30/07/2018,0.00,,3.64,,"-682,754.69"
,CS,AR,32007007,1005,100,,Cash sale,,,,,,30/07/2018,30/07/2018,0.00,,7.29,,"-682,761.98"
,CS,AR,32007026,1005,100,,Cash sale,,,,,,30/07/2018,30/07/2018,0.00,,11.65,,"-682,773.63"
,CS,AR,32007030,1005,100,,Cash sale,,,,,,30/07/2018,30/07/2018,0.00,,3.03,,"-682,776.66"
,CS,AR,32007031,1005,100,,Cash sale,,,,,,30/07/2018,30/07/2018,0.00,,10.93,,"-682,787.59"
,CS,AR,32007034,1005,100,,Cash sale,,,,,,30/07/2018,30/07/2018,0.00,,7.29,,"-682,794.88"
,CS,AR,32007038,1005,100,,Cash sale,,,,,,30/07/2018,30/07/2018,0.00,,7.29,,"-682,802.17"
,CS,AR,32007040,1005,100,,Cash sale,,,,,,30/07/2018,30/07/2018,0.00,,5.17,,"-682,807.34"
,CS,AR,32007054,1005,100,,Cash sale,,,,,,30/07/2018,30/07/2018,0.00,,29.15,,"-682,836.49"
,CS,AR,32007056,1005,100,,Cash sale,,,,,,30/07/2018,30/07/2018,0.00,,10.93,,"-682,847.42"
,IN,AR,30320369,1005,100,,Invoice,,,,,,30/07/2018,30/07/2018,0.00,,77.12,,"-682,924.54"
,IN,AR,30320373,1005,100,,Invoice,,,,,,30/07/2018,30/07/2018,0.00,,32.80,,"-682,957.34"
,IN,AR,30320391,1005,100,,Invoice,,,,,,30/07/2018,30/07/2018,0.00,,2.03,,"-682,959.37"
,IN,AR,30320392,1005,100,,Invoice,,,,,,30/07/2018,30/07/2018,0.00,,4.05,,"-682,963.42"
,IN,AR,30320393,1005,100,,Invoice,,,,,,30/07/2018,30/07/2018,0.00,,6.08,,"-682,969.50"
,IN,AR,30320394,1005,100,,Invoice,,,,,,30/07/2018,30/07/2018,0.00,,4.05,,"-682,973.55"
,IN,AR,30320395,1005,100,,Invoice,,,,,,30/07/2018,30/07/2018,0.00,,2.03,,"-682,975.58"
,IN,AR,30320396,1005,100,,Invoice,,,,,,30/07/2018,30/07/2018,0.00,,2.03,,"-682,977.61"
,IN,AR,30320397,1005,100,,Invoice,,,,,,30/07/2018,30/07/2018,0.00,,20.25,,"-682,997.86"
,IN,AR,30320398,1005,100,,Invoice,,,,,,30/07/2018,30/07/2018,0.00,,14.18,,"-683,012.04"
,IN,AR,30320412,1005,100,,Invoice,,,,,,30/07/2018,30/07/2018,0.00,,3.64,,"-683,015.68"
,IN,AR,30320424,1005,100,,Invoice,,,,,,30/07/2018,30/07/2018,0.00,,99.34,,"-683,115.02"
,IN,AR,30320426,1005,100,,Invoice,,,,,,30/07/2018,30/07/2018,0.00,,54.66,,"-683,169.68"
,IN,AR,30320435,1005,100,,Invoice,,,,,,30/07/2018,30/07/2018,0.00,,5.82,,"-683,175.50"
,IN,AR,30320436,1005,100,,Invoice,,,,,,30/07/2018,30/07/2018,0.00,,10.93,,"-683,186.43"
,IN,AR,30320448,1005,100,,Invoice,,,,,,30/07/2018,30/07/2018,0.00,,125.76,,"-683,312.19"
,IN,AR,30320451,1005,100,,Invoice,,,,,,30/07/2018,30/07/2018,0.00,,13.77,,"-683,325.96"
,IN,AR,30320462,1005,100,,Invoice,,,,,,30/07/2018,30/07/2018,0.00,,40.00,,"-683,365.96"
,IN,AR,30320469,1005,100,,Invoice,,,,,,30/07/2018,30/07/2018,0.00,,61.51,,"-683,427.47"
,IN,AR,30320481,1005,100,,Invoice,,,,,,30/07/2018,30/07/2018,0.00,,38.00,,"-683,465.47"
,IN,AR,30320482,1005,100,,Invoice,,,,,,30/07/2018,30/07/2018,0.00,,28.00,,"-683,493.47"
,IN,AR,30320490,1005,100,,Invoice,,,,,,30/07/2018,30/07/2018,0.00,,2.75,,"-683,496.22"
,IN,AR,30320492,1005,100,,Invoice,,,,,,30/07/2018,30/07/2018,0.00,,43.22,,"-683,539.44"
,IN,AR,30320494,1005,100,,Invoice,,,,,,30/07/2018,30/07/2018,0.00,,8.26,,"-683,547.70"
,IN,AR,30320501,1005,100,,Invoice,,,,,,30/07/2018,30/07/2018,0.00,,11.68,,"-683,559.38"
,IN,AR,30320510,1005,100,,Invoice,,,,,,30/07/2018,30/07/2018,0.00,,24.00,,"-683,583.38"
,IN,AR,30320519,1005,100,,Invoice,,,,,,30/07/2018,30/07/2018,0.00,,14.58,,"-683,597.96"
,IN,AR,30320527,1005,100,,Invoice,,,,,,30/07/2018,30/07/2018,0.00,,"1,025.01",,"-684,622.97"
,IN,AR,30320544,1005,100,,Invoice,,,,,,30/07/2018,30/07/2018,0.00,,26.00,,"-684,648.97"
,IN,AR,30320549,1005,100,,Invoice,,,,,,30/07/2018,30/07/2018,0.00,,7.29,,"-684,656.26"
,IN,AR,30320553,1005,100,,Invoice,,,,,,30/07/2018,30/07/2018,0.00,,9.03,,"-684,665.29"
,IN,AR,30320559,1005,100,,Invoice,,,,,,30/07/2018,30/07/2018,0.00,,19.32,,"-684,684.61"
,IN,AR,30320565,1005,100,,Invoice,,,,,,30/07/2018,30/07/2018,0.00,,29.15,,"-684,713.76"
,IN,AR,30320567,1005,100,,Invoice,,,,,,30/07/2018,30/07/2018,0.00,,28.39,,"-684,742.15"
,IN,AR,30320570,1005,100,,Invoice,,,,,,30/07/2018,30/07/2018,0.00,,7.29,,"-684,749.44"
,IN,AR,30320575,1005,100,,Invoice,,,,,,30/07/2018,30/07/2018,0.00,,3.19,,"-684,752.63"
,IN,AR,30320576,1005,100,,Invoice,,,,,,30/07/2018,30/07/2018,0.00,,4.78,,"-684,757.41"
,IN,AR,30320580,1005,100,,Invoice,,,,,,30/07/2018,30/07/2018,0.00,,14.58,,"-684,771.99"
,IN,AR,30320590,1005,100,,Invoice,,,,,,30/07/2018,30/07/2018,0.00,,7.75,,"-684,779.74"
,IN,AR,30320604,1005,100,,Invoice,,,,,,30/07/2018,30/07/2018,0.00,,16.08,,"-684,795.82"
,IN,AR,30320608,1005,100,,Invoice,,,,,,30/07/2018,30/07/2018,0.00,,5.25,,"-684,801.07"
,IN,AR,30320620,1005,100,,Invoice,,,,,,30/07/2018,30/07/2018,0.00,,91.53,,"-684,892.60"
,IN,AR,30320635,1005,100,,Invoice,,,,,,30/07/2018,30/07/2018,0.00,,23.26,,"-684,915.86"
,IN,AR,30320642,1005,100,,Invoice,,,,,,30/07/2018,30/07/2018,0.00,,8.90,,"-684,924.76"
,IN,AR,30320664,1005,100,,Invoice,,,,,,30/07/2018,30/07/2018,0.00,,92.29,,"-685,017.05"
,IN,AR,30320669,1005,100,,Invoice,,,,,,30/07/2018,30/07/2018,0.00,,48.31,,"-685,065.36"
,IN,AR,30320676,1005,100,,Invoice,,,,,,30/07/2018,30/07/2018,0.00,,16.73,,"-685,082.09"
,IN,AR,30320677,1005,100,,Invoice,,,,,,30/07/2018,30/07/2018,0.00,,14.34,,"-685,096.43"
,IN,AR,30320678,1005,100,,Invoice,,,,,,30/07/2018,30/07/2018,0.00,,10.93,,"-685,107.36"
,IN,AR,30320683,1005,100,,Invoice,,,,,,30/07/2018,30/07/2018,0.00,,45.08,,"-685,152.44"
,IN,AR,30320686,1005,100,,Invoice,,,,,,30/07/2018,30/07/2018,0.00,,54.66,,"-685,207.10"
,IN,AR,30320688,1005,100,,Invoice,,,,,,30/07/2018,30/07/2018,0.00,,18.05,,"-685,225.15"
,IN,AR,30320692,1005,100,,Invoice,,,,,,30/07/2018,30/07/2018,0.00,,4.24,,"-685,229.39"
,IN,AR,30320696,1005,100,,Invoice,,,,,,30/07/2018,30/07/2018,0.00,,8.26,,"-685,237.65"
,IN,AR,30320707,1005,100,,Invoice,,,,,,30/07/2018,30/07/2018,0.00,,6.36,,"-685,244.01"
,IN,AR,30320723,1005,100,,Invoice,,,,,,30/07/2018,30/07/2018,0.00,,12.71,,"-685,256.72"
,IN,AR,30320760,1005,100,,Invoice,,,,,,30/07/2018,30/07/2018,0.00,,33.05,,"-685,289.77"
,IN,AR,30320765,1005,100,,Invoice,,,,,,30/07/2018,30/07/2018,0.00,,20.34,,"-685,310.11"
,IN,AR,30320770,1005,100,,Invoice,,,,,,30/07/2018,30/07/2018,0.00,,18.22,,"-685,328.33"
,IN,AR,30320780,1005,100,,Invoice,,,,,,30/07/2018,30/07/2018,0.00,,3.64,,"-685,331.97"
,IN,AR,30320783,1005,100,,Invoice,,,,,,30/07/2018,30/07/2018,0.00,,14.58,,"-685,346.55"
,IN,AR,30320799,1005,100,,Invoice,,,,,,30/07/2018,30/07/2018,0.00,,8.26,,"-685,354.81"
,IN,AR,30320801,1005,100,,Invoice,,,,,,30/07/2018,30/07/2018,0.00,,7.29,,"-685,362.10"
,IN,AR,30320808,1005,100,,Invoice,,,,,,30/07/2018,30/07/2018,0.00,,16.08,,"-685,378.18"
,IN,AR,30320820,1005,100,,Invoice,,,,,,30/07/2018,30/07/2018,0.00,,8.39,,"-685,386.57"
,IN,AR,30320833,1005,100,,Invoice,,,,,,30/07/2018,30/07/2018,0.00,,14.83,,"-685,401.40"
,IN,AR,30320839,1005,100,,Invoice,,,,,,30/07/2018,30/07/2018,0.00,,73.22,,"-685,474.62"
,IN,AR,30320844,1005,100,,Invoice,,,,,,30/07/2018,30/07/2018,0.00,,24.00,,"-685,498.62"
,IN,AR,30320865,1005,100,,Invoice,,,,,,30/07/2018,30/07/2018,0.00,,7.75,,"-685,506.37"
,IN,AR,30320868,1005,100,,Invoice,,,,,,30/07/2018,30/07/2018,0.00,,12.97,,"-685,519.34"
,IN,AR,30320872,1005,100,,Invoice,,,,,,30/07/2018,30/07/2018,0.00,,36.12,,"-685,555.46"
,IN,AR,30320879,1005,100,,Invoice,,,,,,30/07/2018,30/07/2018,0.00,,8.98,,"-685,564.44"
,IN,AR,30320884,1005,100,,Invoice,,,,,,30/07/2018,30/07/2018,0.00,,14.58,,"-685,579.02"
,IN,AR,30320889,1005,100,,Invoice,,,,,,30/07/2018,30/07/2018,0.00,,54.66,,"-685,633.68"
,IN,AR,30320893,1005,100,,Invoice,,,,,,30/07/2018,30/07/2018,0.00,,51.91,,"-685,685.59"
,IN,AR,30320896,1005,100,,Invoice,,,,,,30/07/2018,30/07/2018,0.00,,6.53,,"-685,692.12"
,IN,AR,30320925,1005,100,,Invoice,,,,,,30/07/2018,30/07/2018,0.00,,7.29,,"-685,699.41"
,IN,AR,30320936,1005,100,,Invoice,,,,,,30/07/2018,30/07/2018,0.00,,29.15,,"-685,728.56"
,IN,AR,30320949,1005,100,,Invoice,,,,,,30/07/2018,30/07/2018,0.00,,29.15,,"-685,757.71"
,IN,AR,30320955,1005,100,,Invoice,,,,,,30/07/2018,30/07/2018,0.00,,54.66,,"-685,812.37"
,IN,AR,30320956,1005,100,,Invoice,,,,,,30/07/2018,30/07/2018,0.00,,54.66,,"-685,867.03"
,IN,AR,30320962,1005,100,,Invoice,,,,,,30/07/2018,30/07/2018,0.00,,4.29,,"-685,871.32"
,IN,AR,30320987,1005,100,,Invoice,,,,,,30/07/2018,30/07/2018,0.00,,1.59,,"-685,872.91"
,IN,AR,30321001,1005,100,,Invoice,,,,,,30/07/2018,30/07/2018,0.00,,4.29,,"-685,877.20"
,IN,AR,30321006,1005,100,,Invoice,,,,,,30/07/2018,30/07/2018,0.00,,14.19,,"-685,891.39"
,IN,AR,30321011,1005,100,,Invoice,,,,,,30/07/2018,30/07/2018,0.00,,40.08,,"-685,931.47"
,IN,AR,30321021,1005,100,,Invoice,,,,,,30/07/2018,30/07/2018,0.00,,27.32,,"-685,958.79"
,IN,AR,30321035,1005,100,,Invoice,,,,,,30/07/2018,30/07/2018,0.00,,7.29,,"-685,966.08"
,IN,AR,30321044,1005,100,,Invoice,,,,,,30/07/2018,30/07/2018,0.00,,39.41,,"-686,005.49"
,IN,AR,30321046,1005,100,,Invoice,,,,,,30/07/2018,30/07/2018,0.00,,6.86,,"-686,012.35"
,IN,AR,30321051,1005,100,,Invoice,,,,,,30/07/2018,30/07/2018,0.00,,6.56,,"-686,018.91"
,IN,AR,30321061,1005,100,,Invoice,,,,,,30/07/2018,30/07/2018,0.00,,21.86,,"-686,040.77"
,IN,AR,30321074,1005,100,,Invoice,,,,,,30/07/2018,30/07/2018,0.00,,10.00,,"-686,050.77"
,IN,AR,30321077,1005,100,,Invoice,,,,,,30/07/2018,30/07/2018,0.00,,14.00,,"-686,064.77"
,IN,AR,30321084,1005,100,,Invoice,,,,,,30/07/2018,30/07/2018,0.00,,22.01,,"-686,086.78"
,IN,AR,30321100,1005,100,,Invoice,,,,,,30/07/2018,30/07/2018,0.00,,51.29,,"-686,138.07"
,IN,AR,30321102,1005,100,,Invoice,,,,,,30/07/2018,30/07/2018,0.00,,14.58,,"-686,152.65"
,IN,AR,30321112,1005,100,,Invoice,,,,,,30/07/2018,30/07/2018,0.00,,10.52,,"-686,163.17"
,IN,AR,30321117,1005,100,,Invoice,,,,,,30/07/2018,30/07/2018,0.00,,18.21,,"-686,181.38"
,IN,AR,30321122,1005,100,,Invoice,,,,,,30/07/2018,30/07/2018,0.00,,31.41,,"-686,212.79"
,IN,AR,30321125,1005,100,,Invoice,,,,,,30/07/2018,30/07/2018,0.00,,160.81,,"-686,373.60"
,IN,AR,30321130,1005,100,,Invoice,,,,,,30/07/2018,30/07/2018,0.00,,16.83,,"-686,390.43"
,IN,AR,30321140,1005,100,,Invoice,,,,,,30/07/2018,30/07/2018,0.00,,9.64,,"-686,400.07"
,IN,AR,30321141,1005,100,,Invoice,,,,,,30/07/2018,30/07/2018,0.00,,14.58,,"-686,414.65"
,IN,AR,30321167,1005,100,,Invoice,,,,,,30/07/2018,30/07/2018,0.00,,26.69,,"-686,441.34"
,IN,AR,30321181,1005,100,,Invoice,,,,,,30/07/2018,30/07/2018,0.00,,25.49,,"-686,466.83"
,IN,AR,30321182,1005,100,,Invoice,,,,,,30/07/2018,30/07/2018,0.00,,20.71,,"-686,487.54"
,IN,AR,30321184,1005,100,,Invoice,,,,,,30/07/2018,30/07/2018,0.00,,44.24,,"-686,531.78"
,IN,AR,30321202,1005,100,,Invoice,,,,,,30/07/2018,30/07/2018,0.00,,8.00,,"-686,539.78"
,IN,AR,30321207,1005,100,,Invoice,,,,,,30/07/2018,30/07/2018,0.00,,1.88,,"-686,541.66"
,IN,AR,30321208,1005,100,,Invoice,,,,,,30/07/2018,30/07/2018,0.00,,5.64,,"-686,547.30"
,IN,AR,30321218,1005,100,,Invoice,,,,,,30/07/2018,30/07/2018,0.00,,20.44,,"-686,567.74"
,IN,AR,30321222,1005,100,,Invoice,,,,,,30/07/2018,30/07/2018,0.00,,15.93,,"-686,583.67"
,IN,AR,30321223,1005,100,,Invoice,,,,,,30/07/2018,30/07/2018,0.00,,3.28,,"-686,586.95"
,IN,AR,30321247,1005,100,,Invoice,,,,,,30/07/2018,30/07/2018,0.00,,10.95,,"-686,597.90"
,IN,AR,30321265,1005,100,,Invoice,,,,,,30/07/2018,30/07/2018,0.00,,5.24,,"-686,603.14"
,IN,AR,30321266,1005,100,,Invoice,,,,,,30/07/2018,30/07/2018,0.00,,7.02,,"-686,610.16"
,IN,AR,30321273,1005,100,,Invoice,,,,,,30/07/2018,30/07/2018,0.00,,4.08,,"-686,614.24"
,IN,AR,30321289,1005,100,,Invoice,,,,,,30/07/2018,30/07/2018,0.00,,13.74,,"-686,627.98"
,IN,AR,30321299,1005,100,,Invoice,,,,,,30/07/2018,30/07/2018,0.00,,35.08,,"-686,663.06"
,IN,AR,30321315,1005,100,,Invoice,,,,,,30/07/2018,30/07/2018,0.00,,4.00,,"-686,667.06"
,IN,AR,30321316,1005,100,,Invoice,,,,,,30/07/2018,30/07/2018,0.00,,2.00,,"-686,669.06"
,IN,AR,30321343,1005,100,,Invoice,,,,,,30/07/2018,30/07/2018,0.00,,12.46,,"-686,681.52"
,IN,AR,30321344,1005,100,,Invoice,,,,,,30/07/2018,30/07/2018,0.00,,4.15,,"-686,685.67"
,IN,AR,30321345,1005,100,,Invoice,,,,,,30/07/2018,30/07/2018,0.00,,6.23,,"-686,691.90"
,IN,AR,30321346,1005,100,,Invoice,,,,,,30/07/2018,30/07/2018,0.00,,4.15,,"-686,696.05"
,IN,AR,30321347,1005,100,,Invoice,,,,,,30/07/2018,30/07/2018,0.00,,6.23,,"-686,702.28"
,IN,AR,30321348,1005,100,,Invoice,,,,,,30/07/2018,30/07/2018,0.00,,4.15,,"-686,706.43"
,IN,AR,30321374,1005,100,,Invoice,,,,,,30/07/2018,30/07/2018,0.00,,18.22,,"-686,724.65"
,IN,AR,30321397,1005,100,,Invoice,,,,,,30/07/2018,30/07/2018,0.00,,1.75,,"-686,726.40"
,IN,AR,30321404,1005,100,,Invoice,,,,,,30/07/2018,30/07/2018,0.00,,50.00,,"-686,776.40"
,IN,AR,30321429,1005,100,,Invoice,,,,,,30/07/2018,30/07/2018,0.00,,182.20,,"-686,958.60"
,IN,AR,30321431,1005,100,,Invoice,,,,,,30/07/2018,30/07/2018,0.00,,10.93,,"-686,969.53"
,CS,AR,32006576,1005,100,,Cash sale,,,,,,31/07/2018,31/07/2018,0.00,,3.64,,"-686,973.17"
,CS,AR,32006590,1005,100,,Cash sale,,,,,,31/07/2018,31/07/2018,0.00,,7.29,,"-686,980.46"
,CS,AR,32006591,1005,100,,Cash sale,,,,,,31/07/2018,31/07/2018,0.00,,7.29,,"-686,987.75"
,CS,AR,32006596,1005,100,,Cash sale,,,,,,31/07/2018,31/07/2018,0.00,,7.29,,"-686,995.04"
,CS,AR,32006599,1005,100,,Cash sale,,,,,,31/07/2018,31/07/2018,0.00,,21.86,,"-687,016.90"
,CS,AR,32006600,1005,100,,Cash sale,,,,,,31/07/2018,31/07/2018,0.00,,7.29,,"-687,024.19"
,CS,AR,32006607,1005,100,,Cash sale,,,,,,31/07/2018,31/07/2018,0.00,,42.12,,"-687,066.31"
,CS,AR,32006612,1005,100,,Cash sale,,,,,,31/07/2018,31/07/2018,0.00,,9.03,,"-687,075.34"
,CS,AR,32006615,1005,100,,Cash sale,,,,,,31/07/2018,31/07/2018,0.00,,10.93,,"-687,086.27"
,CS,AR,32006630,1005,100,,Cash sale,,,,,,31/07/2018,31/07/2018,0.00,,7.29,,"-687,093.56"
,CS,AR,32006643,1005,100,,Cash sale,,,,,,31/07/2018,31/07/2018,0.00,,14.58,,"-687,108.14"
,CS,AR,32006650,1005,100,,Cash sale,,,,,,31/07/2018,31/07/2018,0.00,,10.93,,"-687,119.07"
,CS,AR,32006676,1005,100,,Cash sale,,,,,,31/07/2018,31/07/2018,0.00,,4.32,,"-687,123.39"
,CS,AR,32006686,1005,100,,Cash sale,,,,,,31/07/2018,31/07/2018,0.00,,2.81,,"-687,126.20"
,CS,AR,32006695,1005,100,,Cash sale,,,,,,31/07/2018,31/07/2018,0.00,,10.34,,"-687,136.54"
,CS,AR,32006699,1005,100,,Cash sale,,,,,,31/07/2018,31/07/2018,0.00,,2.84,,"-687,139.38"
,CS,AR,32006703,1005,100,,Cash sale,,,,,,31/07/2018,31/07/2018,0.00,,14.58,,"-687,153.96"
,CS,AR,32006723,1005,100,,Cash sale,,,,,,31/07/2018,31/07/2018,0.00,,7.29,,"-687,161.25"
,CS,AR,32006732,1005,100,,Cash sale,,,,,,31/07/2018,31/07/2018,0.00,,3.64,,"-687,164.89"
,CS,AR,32006738,1005,100,,Cash sale,,,,,,31/07/2018,31/07/2018,0.00,,2.54,,"-687,167.43"
,CS,AR,32006739,1005,100,,Cash sale,,,,,,31/07/2018,31/07/2018,0.00,,12.03,,"-687,179.46"
,CS,AR,32006758,1005,100,,Cash sale,,,,,,31/07/2018,31/07/2018,0.00,,7.80,,"-687,187.26"
,CS,AR,32006762,1005,100,,Cash sale,,,,,,31/07/2018,31/07/2018,0.00,,3.64,,"-687,190.90"
,CS,AR,32006765,1005,100,,Cash sale,,,,,,31/07/2018,31/07/2018,0.00,,10.93,,"-687,201.83"
,CS,AR,32006769,1005,100,,Cash sale,,,,,,31/07/2018,31/07/2018,0.00,,7.29,,"-687,209.12"
,CS,AR,32006775,1005,100,,Cash sale,,,,,,31/07/2018,31/07/2018,0.00,,7.29,,"-687,216.41"
,CS,AR,32006778,1005,100,,Cash sale,,,,,,31/07/2018,31/07/2018,0.00,,15.51,,"-687,231.92"
,CS,AR,32006779,1005,100,,Cash sale,,,,,,31/07/2018,31/07/2018,0.00,,3.64,,"-687,235.56"
,CS,AR,32006781,1005,100,,Cash sale,,,,,,31/07/2018,31/07/2018,0.00,,14.58,,"-687,250.14"
,CS,AR,32006786,1005,100,,Cash sale,,,,,,31/07/2018,31/07/2018,0.00,,8.39,,"-687,258.53"
,CS,AR,32006788,1005,100,,Cash sale,,,,,,31/07/2018,31/07/2018,0.00,,7.75,,"-687,266.28"
,CS,AR,32006791,1005,100,,Cash sale,,,,,,31/07/2018,31/07/2018,0.00,,7.80,,"-687,274.08"
,CS,AR,32006792,1005,100,,Cash sale,,,,,,31/07/2018,31/07/2018,0.00,,7.29,,"-687,281.37"
,CS,AR,32006803,1005,100,,Cash sale,,,,,,31/07/2018,31/07/2018,0.00,,7.29,,"-687,288.66"
,CS,AR,32006807,1005,100,,Cash sale,,,,,,31/07/2018,31/07/2018,0.00,,29.15,,"-687,317.81"
,CS,AR,32006831,1005,100,,Cash sale,,,,,,31/07/2018,31/07/2018,0.00,,3.64,,"-687,321.45"
,CS,AR,32006846,1005,100,,Cash sale,,,,,,31/07/2018,31/07/2018,0.00,,12.86,,"-687,334.31"
,CS,AR,32006848,1005,100,,Cash sale,,,,,,31/07/2018,31/07/2018,0.00,,3.76,,"-687,338.07"
,CS,AR,32006850,1005,100,,Cash sale,,,,,,31/07/2018,31/07/2018,0.00,,10.93,,"-687,349.00"
,CS,AR,32006858,1005,100,,Cash sale,,,,,,31/07/2018,31/07/2018,0.00,,5.18,,"-687,354.18"
,CS,AR,32006862,1005,100,,Cash sale,,,,,,31/07/2018,31/07/2018,0.00,,3.64,,"-687,357.82"
,CS,AR,32006865,1005,100,,Cash sale,,,,,,31/07/2018,31/07/2018,0.00,,7.29,,"-687,365.11"
,CS,AR,32006874,1005,100,,Cash sale,,,,,,31/07/2018,31/07/2018,0.00,,17.80,,"-687,382.91"
,CS,AR,32006882,1005,100,,Cash sale,,,,,,31/07/2018,31/07/2018,0.00,,5.08,,"-687,387.99"
,CS,AR,32006884,1005,100,,Cash sale,,,,,,31/07/2018,31/07/2018,0.00,,28.00,,"-687,415.99"
,CS,AR,32006887,1005,100,,Cash sale,,,,,,31/07/2018,31/07/2018,0.00,,54.00,,"-687,469.99"
,CS,AR,32006891,1005,100,,Cash sale,,,,,,31/07/2018,31/07/2018,0.00,,7.29,,"-687,477.28"
,CS,AR,32006902,1005,100,,Cash sale,,,,,,31/07/2018,31/07/2018,0.00,,8.20,,"-687,485.48"
,CS,AR,32006905,1005,100,,Cash sale,,,,,,31/07/2018,31/07/2018,0.00,,6.56,,"-687,492.04"
,CS,AR,32006920,1005,100,,Cash sale,,,,,,31/07/2018,31/07/2018,0.00,,6.07,,"-687,498.11"
,CS,AR,32006921,1005,100,,Cash sale,,,,,,31/07/2018,31/07/2018,0.00,,10.93,,"-687,509.04"
,CS,AR,32006927,1005,100,,Cash sale,,,,,,31/07/2018,31/07/2018,0.00,,18.22,,"-687,527.26"
,CS,AR,32006930,1005,100,,Cash sale,,,,,,31/07/2018,31/07/2018,0.00,,5.50,,"-687,532.76"
,CS,AR,32006937,1005,100,,Cash sale,,,,,,31/07/2018,31/07/2018,0.00,,7.29,,"-687,540.05"
,CS,AR,32006942,1005,100,,Cash sale,,,,,,31/07/2018,31/07/2018,0.00,,5.47,,"-687,545.52"
,CS,AR,32006966,1005,100,,Cash sale,,,,,,31/07/2018,31/07/2018,0.00,,8.75,,"-687,554.27"
,CS,AR,32006967,1005,100,,Cash sale,,,,,,31/07/2018,31/07/2018,0.00,,7.75,,"-687,562.02"
,CS,AR,32006976,1005,100,,Cash sale,,,,,,31/07/2018,31/07/2018,0.00,,10.93,,"-687,572.95"
,CS,AR,32006983,1005,100,,Cash sale,,,,,,31/07/2018,31/07/2018,0.00,,10.93,,"-687,583.88"
,CS,AR,32006986,1005,100,,Cash sale,,,,,,31/07/2018,31/07/2018,0.00,,5.47,,"-687,589.35"
,CS,AR,32006997,1005,100,,Cash sale,,,,,,31/07/2018,31/07/2018,0.00,,10.93,,"-687,600.28"
,CS,AR,32007001,1005,100,,Cash sale,,,,,,31/07/2018,31/07/2018,0.00,,7.29,,"-687,607.57"
,CS,AR,32007048,1005,100,,Cash sale,,,,,,31/07/2018,31/07/2018,0.00,,7.29,,"-687,614.86"
,IN,AR,30320360,1005,100,,Invoice,,,,,,31/07/2018,31/07/2018,0.00,,12.03,,"-687,626.89"
,IN,AR,30320378,1005,100,,Invoice,,,,,,31/07/2018,31/07/2018,0.00,,14.58,,"-687,641.47"
,IN,AR,30320399,1005,100,,Invoice,,,,,,31/07/2018,31/07/2018,0.00,,6.08,,"-687,647.55"
,IN,AR,30320421,1005,100,,Invoice,,,,,,31/07/2018,31/07/2018,0.00,,7.00,,"-687,654.55"
,IN,AR,30320439,1005,100,,Invoice,,,,,,31/07/2018,31/07/2018,0.00,,3.98,,"-687,658.53"
,IN,AR,30320449,1005,100,,Invoice,,,,,,31/07/2018,31/07/2018,0.00,,28.47,,"-687,687.00"
,IN,AR,30320450,1005,100,,Invoice,,,,,,31/07/2018,31/07/2018,0.00,,29.15,,"-687,716.15"
,IN,AR,30320466,1005,100,,Invoice,,,,,,31/07/2018,31/07/2018,0.00,,21.86,,"-687,738.01"
,IN,AR,30320470,1005,100,,Invoice,,,,,,31/07/2018,31/07/2018,0.00,,29.15,,"-687,767.16"
,IN,AR,30320513,1005,100,,Invoice,,,,,,31/07/2018,31/07/2018,0.00,,10.93,,"-687,778.09"
,IN,AR,30320551,1005,100,,Invoice,,,,,,31/07/2018,31/07/2018,0.00,,8.25,,"-687,786.34"
,IN,AR,30320552,1005,100,,Invoice,,,,,,31/07/2018,31/07/2018,0.00,,7.29,,"-687,793.63"
,IN,AR,30320556,1005,100,,Invoice,,,,,,31/07/2018,31/07/2018,0.00,,10.93,,"-687,804.56"
,IN,AR,30320563,1005,100,,Invoice,,,,,,31/07/2018,31/07/2018,0.00,,7.29,,"-687,811.85"
,IN,AR,30320577,1005,100,,Invoice,,,,,,31/07/2018,31/07/2018,0.00,,9.56,,"-687,821.41"
,IN,AR,30320578,1005,100,,Invoice,,,,,,31/07/2018,31/07/2018,0.00,,14.34,,"-687,835.75"
,IN,AR,30320582,1005,100,,Invoice,,,,,,31/07/2018,31/07/2018,0.00,,36.19,,"-687,871.94"
,IN,AR,30320584,1005,100,,Invoice,,,,,,31/07/2018,31/07/2018,0.00,,10.93,,"-687,882.87"
,IN,AR,30320595,1005,100,,Invoice,,,,,,31/07/2018,31/07/2018,0.00,,6.97,,"-687,889.84"
,IN,AR,30320602,1005,100,,Invoice,,,,,,31/07/2018,31/07/2018,0.00,,9.59,,"-687,899.43"
,IN,AR,30320613,1005,100,,Invoice,,,,,,31/07/2018,31/07/2018,0.00,,8.47,,"-687,907.90"
,IN,AR,30320621,1005,100,,Invoice,,,,,,31/07/2018,31/07/2018,0.00,,56.95,,"-687,964.85"
,IN,AR,30320626,1005,100,,Invoice,,,,,,31/07/2018,31/07/2018,0.00,,4.24,,"-687,969.09"
,IN,AR,30320628,1005,100,,Invoice,,,,,,31/07/2018,31/07/2018,0.00,,4.24,,"-687,973.33"
,IN,AR,30320639,1005,100,,Invoice,,,,,,31/07/2018,31/07/2018,0.00,,2.58,,"-687,975.91"
,IN,AR,30320644,1005,100,,Invoice,,,,,,31/07/2018,31/07/2018,0.00,,19.12,,"-687,995.03"
,IN,AR,30320652,1005,100,,Invoice,,,,,,31/07/2018,31/07/2018,0.00,,9.03,,"-688,004.06"
,IN,AR,30320658,1005,100,,Invoice,,,,,,31/07/2018,31/07/2018,0.00,,5.85,,"-688,009.91"
,IN,AR,30320665,1005,100,,Invoice,,,,,,31/07/2018,31/07/2018,0.00,,3.64,,"-688,013.55"
,IN,AR,30320693,1005,100,,Invoice,,,,,,31/07/2018,31/07/2018,0.00,,3.64,,"-688,017.19"
,IN,AR,30320699,1005,100,,Invoice,,,,,,31/07/2018,31/07/2018,0.00,,6.43,,"-688,023.62"
,IN,AR,30320731,1005,100,,Invoice,,,,,,31/07/2018,31/07/2018,0.00,,27.97,,"-688,051.59"
,IN,AR,30320739,1005,100,,Invoice,,,,,,31/07/2018,31/07/2018,0.00,,7.29,,"-688,058.88"
,IN,AR,30320746,1005,100,,Invoice,,,,,,31/07/2018,31/07/2018,0.00,,10.93,,"-688,069.81"
,IN,AR,30320755,1005,100,,Invoice,,,,,,31/07/2018,31/07/2018,0.00,,32.03,,"-688,101.84"
,IN,AR,30320769,1005,100,,Invoice,,,,,,31/07/2018,31/07/2018,0.00,,11.57,,"-688,113.41"
,IN,AR,30320773,1005,100,,Invoice,,,,,,31/07/2018,31/07/2018,0.00,,12.71,,"-688,126.12"
,IN,AR,30320774,1005,100,,Invoice,,,,,,31/07/2018,31/07/2018,0.00,,3.90,,"-688,130.02"
,IN,AR,30320776,1005,100,,Invoice,,,,,,31/07/2018,31/07/2018,0.00,,17.54,,"-688,147.56"
,IN,AR,30320786,1005,100,,Invoice,,,,,,31/07/2018,31/07/2018,0.00,,19.07,,"-688,166.63"
,IN,AR,30320788,1005,100,,Invoice,,,,,,31/07/2018,31/07/2018,0.00,,8.47,,"-688,175.10"
,IN,AR,30320789,1005,100,,Invoice,,,,,,31/07/2018,31/07/2018,0.00,,14.83,,"-688,189.93"
,IN,AR,30320794,1005,100,,Invoice,,,,,,31/07/2018,31/07/2018,0.00,,4.24,,"-688,194.17"
,IN,AR,30320796,1005,100,,Invoice,,,,,,31/07/2018,31/07/2018,0.00,,12.71,,"-688,206.88"
,IN,AR,30320802,1005,100,,Invoice,,,,,,31/07/2018,31/07/2018,0.00,,5.08,,"-688,211.96"
,IN,AR,30320805,1005,100,,Invoice,,,,,,31/07/2018,31/07/2018,0.00,,18.25,,"-688,230.21"
,IN,AR,30320815,1005,100,,Invoice,,,,,,31/07/2018,31/07/2018,0.00,,8.47,,"-688,238.68"
,IN,AR,30320846,1005,100,,Invoice,,,,,,31/07/2018,31/07/2018,0.00,,24.56,,"-688,263.24"
,IN,AR,30320855,1005,100,,Invoice,,,,,,31/07/2018,31/07/2018,0.00,,14.58,,"-688,277.82"
,IN,AR,30320860,1005,100,,Invoice,,,,,,31/07/2018,31/07/2018,0.00,,5.59,,"-688,283.41"
,IN,AR,30320867,1005,100,,Invoice,,,,,,31/07/2018,31/07/2018,0.00,,8.78,,"-688,292.19"
,IN,AR,30320883,1005,100,,Invoice,,,,,,31/07/2018,31/07/2018,0.00,,42.12,,"-688,334.31"
,IN,AR,30320886,1005,100,,Invoice,,,,,,31/07/2018,31/07/2018,0.00,,12.14,,"-688,346.45"
,IN,AR,30320902,1005,100,,Invoice,,,,,,31/07/2018,31/07/2018,0.00,,33.09,,"-688,379.54"
,IN,AR,30320904,1005,100,,Invoice,,,,,,31/07/2018,31/07/2018,0.00,,18.22,,"-688,397.76"
,IN,AR,30320909,1005,100,,Invoice,,,,,,31/07/2018,31/07/2018,0.00,,30.02,,"-688,427.78"
,IN,AR,30320921,1005,100,,Invoice,,,,,,31/07/2018,31/07/2018,0.00,,5.29,,"-688,433.07"
,IN,AR,30320922,1005,100,,Invoice,,,,,,31/07/2018,31/07/2018,0.00,,5.29,,"-688,438.36"
,IN,AR,30320935,1005,100,,Invoice,,,,,,31/07/2018,31/07/2018,0.00,,131.36,,"-688,569.72"
,IN,AR,30320943,1005,100,,Invoice,,,,,,31/07/2018,31/07/2018,0.00,,32.80,,"-688,602.52"
,IN,AR,30320944,1005,100,,Invoice,,,,,,31/07/2018,31/07/2018,0.00,,7.29,,"-688,609.81"
,IN,AR,30320973,1005,100,,Invoice,,,,,,31/07/2018,31/07/2018,0.00,,18.22,,"-688,628.03"
,IN,AR,30320988,1005,100,,Invoice,,,,,,31/07/2018,31/07/2018,0.00,,6.36,,"-688,634.39"
,IN,AR,30320989,1005,100,,Invoice,,,,,,31/07/2018,31/07/2018,0.00,,6.36,,"-688,640.75"
,IN,AR,30320990,1005,100,,Invoice,,,,,,31/07/2018,31/07/2018,0.00,,27.03,,"-688,667.78"
,IN,AR,30320995,1005,100,,Invoice,,,,,,31/07/2018,31/07/2018,0.00,,65.30,,"-688,733.08"
,IN,AR,30321031,1005,100,,Invoice,,,,,,31/07/2018,31/07/2018,0.00,,206.62,,"-688,939.70"
,IN,AR,30321036,1005,100,,Invoice,,,,,,31/07/2018,31/07/2018,0.00,,14.58,,"-688,954.28"
,IN,AR,30321103,1005,100,,Invoice,,,,,,31/07/2018,31/07/2018,0.00,,18.22,,"-688,972.50"
,IN,AR,30321127,1005,100,,Invoice,,,,,,31/07/2018,31/07/2018,0.00,,5.47,,"-688,977.97"
,IN,AR,30321143,1005,100,,Invoice,,,,,,31/07/2018,31/07/2018,0.00,,82.00,,"-689,059.97"
,IN,AR,30321149,1005,100,,Invoice,,,,,,31/07/2018,31/07/2018,0.00,,35.59,,"-689,095.56"
,IN,AR,30321153,1005,100,,Invoice,,,,,,31/07/2018,31/07/2018,0.00,,3.64,,"-689,099.20"
,IN,AR,30321154,1005,100,,Invoice,,,,,,31/07/2018,31/07/2018,0.00,,6.56,,"-689,105.76"
,IN,AR,30321159,1005,100,,Invoice,,,,,,31/07/2018,31/07/2018,0.00,,7.63,,"-689,113.39"
,IN,AR,30321188,1005,100,,Invoice,,,,,,31/07/2018,31/07/2018,0.00,,28.47,,"-689,141.86"
,IN,AR,30321189,1005,100,,Invoice,,,,,,31/07/2018,31/07/2018,0.00,,45.08,,"-689,186.94"
,IN,AR,30321190,1005,100,,Invoice,,,,,,31/07/2018,31/07/2018,0.00,,123.40,,"-689,310.34"
,IN,AR,30321191,1005,100,,Invoice,,,,,,31/07/2018,31/07/2018,0.00,,2.37,,"-689,312.71"
,IN,AR,30321197,1005,100,,Invoice,,,,,,31/07/2018,31/07/2018,0.00,,20.34,,"-689,333.05"
,IN,AR,30321198,1005,100,,Invoice,,,,,,31/07/2018,31/07/2018,0.00,,7.29,,"-689,340.34"
,IN,AR,30321211,1005,100,,Invoice,,,,,,31/07/2018,31/07/2018,0.00,,5.26,,"-689,345.60"
,IN,AR,30321212,1005,100,,Invoice,,,,,,31/07/2018,31/07/2018,0.00,,11.02,,"-689,356.62"
,IN,AR,30321215,1005,100,,Invoice,,,,,,31/07/2018,31/07/2018,0.00,,10.00,,"-689,366.62"
,IN,AR,30321226,1005,100,,Invoice,,,,,,31/07/2018,31/07/2018,0.00,,145.22,,"-689,511.84"
,IN,AR,30321237,1005,100,,Invoice,,,,,,31/07/2018,31/07/2018,0.00,,7.02,,"-689,518.86"
,IN,AR,30321262,1005,100,,Invoice,,,,,,31/07/2018,31/07/2018,0.00,,145.76,,"-689,664.62"
,IN,AR,30321274,1005,100,,Invoice,,,,,,31/07/2018,31/07/2018,0.00,,46.97,,"-689,711.59"
,IN,AR,30321275,1005,100,,Invoice,,,,,,31/07/2018,31/07/2018,0.00,,36.76,,"-689,748.35"
,IN,AR,30321286,1005,100,,Invoice,,,,,,31/07/2018,31/07/2018,0.00,,40.08,,"-689,788.43"
,IN,AR,30321293,1005,100,,Invoice,,,,,,31/07/2018,31/07/2018,0.00,,11.19,,"-689,799.62"
,IN,AR,30321297,1005,100,,Invoice,,,,,,31/07/2018,31/07/2018,0.00,,7.97,,"-689,807.59"
,IN,AR,30321306,1005,100,,Invoice,,,,,,31/07/2018,31/07/2018,0.00,,54.66,,"-689,862.25"
,IN,AR,30321349,1005,100,,Invoice,,,,,,31/07/2018,31/07/2018,0.00,,8.31,,"-689,870.56"
,IN,AR,30321350,1005,100,,Invoice,,,,,,31/07/2018,31/07/2018,0.00,,20.76,,"-689,891.32"
,IN,AR,30321358,1005,100,,Invoice,,,,,,31/07/2018,31/07/2018,0.00,,14.49,,"-689,905.81"
,IN,AR,30321367,1005,100,,Invoice,,,,,,31/07/2018,31/07/2018,0.00,,7.29,,"-689,913.10"
,IN,AR,30321379,1005,100,,Invoice,,,,,,31/07/2018,31/07/2018,0.00,,13.56,,"-689,926.66"
,IN,AR,30321419,1005,100,,Invoice,,,,,,31/07/2018,31/07/2018,0.00,,7.29,,"-689,933.95"
,IN,AR,30321432,1005,100,,Invoice,,,,,,31/07/2018,31/07/2018,0.00,,419.07,,"-690,353.02"
,IN,AR,30321435,1005,100,,Invoice,,,,,,31/07/2018,31/07/2018,0.00,,11.65,,"-690,364.67"
,IN,AR,30321463,1005,100,,Invoice,,,,,,31/07/2018,31/07/2018,0.00,,"1,844.74",,"-692,209.41"
,IN,AR,30321495,1005,100,,Invoice,,,,,,31/07/2018,31/07/2018,0.00,,"1,789.83",,"-693,999.24"
,IN,AR,30321527,1005,100,,Invoice,,,,,,31/07/2018,31/07/2018,0.00,,86.23,,"-694,085.47"
,IN,AR,30321556,1005,100,,Invoice,,,,,,31/07/2018,31/07/2018,0.00,,75.21,,"-694,160.68"
,IN,AR,30321583,1005,100,,Invoice,,,,,,31/07/2018,31/07/2018,0.00,,"1,794.58",,"-695,955.26"
,IN,AR,30321584,1005,100,,Invoice,,,,,,31/07/2018,31/07/2018,0.00,,63.15,,"-696,018.41"
,IN,AR,30321585,1005,100,,Invoice,,,,,,31/07/2018,31/07/2018,0.00,,21.05,,"-696,039.46"
,IN,AR,30321586,1005,100,,Invoice,,,,,,31/07/2018,31/07/2018,0.00,,105.25,,"-696,144.71"
,IN,AR,30321593,1005,100,,Invoice,,,,,,31/07/2018,31/07/2018,0.00,,190.68,,"-696,335.39"
,IN,AR,30321612,1005,100,,Invoice,,,,,,31/07/2018,31/07/2018,0.00,,"1,792.24",,"-698,127.63"
,IN,AR,30321634,1005,100,,Invoice,,,,,,31/07/2018,31/07/2018,0.00,,657.76,,"-698,785.39"
,IN,AR,30321635,1005,100,,Invoice,,,,,,31/07/2018,31/07/2018,0.00,,16.78,,"-698,802.17"
,IN,AR,30321636,1005,100,,Invoice,,,,,,31/07/2018,31/07/2018,0.00,,15.10,,"-698,817.27"
,IN,AR,30321637,1005,100,,Invoice,,,,,,31/07/2018,31/07/2018,0.00,,13.42,,"-698,830.69"
,IN,AR,30321638,1005,100,,Invoice,,,,,,31/07/2018,31/07/2018,0.00,,11.75,,"-698,842.44"
,IN,AR,30321639,1005,100,,Invoice,,,,,,31/07/2018,31/07/2018,0.00,,5.03,,"-698,847.47"
,IN,AR,30321647,1005,100,,Invoice,,,,,,31/07/2018,31/07/2018,0.00,,175.42,,"-699,022.89"
,IN,AR,30321649,1005,100,,Invoice,,,,,,31/07/2018,31/07/2018,0.00,,210.51,,"-699,233.40"
,IN,AR,30321652,1005,100,,Invoice,,,,,,31/07/2018,31/07/2018,0.00,,43.27,,"-699,276.67"
,IN,AR,30321653,1005,100,,Invoice,,,,,,31/07/2018,31/07/2018,0.00,,54.38,,"-699,331.05"
,IN,AR,30321654,1005,100,,Invoice,,,,,,31/07/2018,31/07/2018,0.00,,196.47,,"-699,527.52"
,IN,AR,30321656,1005,100,,Invoice,,,,,,31/07/2018,31/07/2018,0.00,,50.87,,"-699,578.39"
,IN,AR,30321657,1005,100,,Invoice,,,,,,31/07/2018,31/07/2018,0.00,,15.05,,"-699,593.44"
,IN,AR,30321658,1005,100,,Invoice,,,,,,31/07/2018,31/07/2018,0.00,,41.39,,"-699,634.83"
,IN,AR,30321659,1005,100,,Invoice,,,,,,31/07/2018,31/07/2018,0.00,,54.56,,"-699,689.39"
,IN,AR,30321660,1005,100,,Invoice,,,,,,31/07/2018,31/07/2018,0.00,,33.86,,"-699,723.25"
,IN,AR,30321661,1005,100,,Invoice,,,,,,31/07/2018,31/07/2018,0.00,,31.98,,"-699,755.23"
,IN,AR,30321662,1005,100,,Invoice,,,,,,31/07/2018,31/07/2018,0.00,,54.56,,"-699,809.79"
,IN,AR,30321663,1005,100,,Invoice,,,,,,31/07/2018,31/07/2018,0.00,,26.34,,"-699,836.13"
,IN,AR,30321664,1005,100,,Invoice,,,,,,31/07/2018,31/07/2018,0.00,,5.64,,"-699,841.77"
,IN,AR,30321665,1005,100,,Invoice,,,,,,31/07/2018,31/07/2018,0.00,,7.53,,"-699,849.30"
,IN,AR,30321666,1005,100,,Invoice,,,,,,31/07/2018,31/07/2018,0.00,,387.69,,"-700,236.99"
,IN,AR,30321667,1005,100,,Invoice,,,,,,31/07/2018,31/07/2018,0.00,,61.40,,"-700,298.39"
,IN,AR,30321668,1005,100,,Invoice,,,,,,31/07/2018,31/07/2018,0.00,,66.66,,"-700,365.05"
,IN,AR,30321669,1005,100,,Invoice,,,,,,31/07/2018,31/07/2018,0.00,,11.29,,"-700,376.34"
,IN,AR,30321670,1005,100,,Invoice,,,,,,31/07/2018,31/07/2018,0.00,,38.59,,"-700,414.93"
,IN,AR,30321671,1005,100,,Invoice,,,,,,31/07/2018,31/07/2018,0.00,,43.86,,"-700,458.79"
,IN,AR,30321673,1005,100,,Invoice,,,,,,31/07/2018,31/07/2018,0.00,,17.54,,"-700,476.33"
,IN,AR,30321674,1005,100,,Invoice,,,,,,31/07/2018,31/07/2018,0.00,,17.54,,"-700,493.87"
,IN,AR,30321675,1005,100,,Invoice,,,,,,31/07/2018,31/07/2018,0.00,,22.81,,"-700,516.68"
,IN,AR,30321677,1005,100,,Invoice,,,,,,31/07/2018,31/07/2018,0.00,,3.51,,"-700,520.19"
,IN,AR,30321685,1005,100,,Invoice,,,,,,31/07/2018,31/07/2018,0.00,,19.30,,"-700,539.49"
,IN,AR,30321694,1005,100,,Invoice,,,,,,31/07/2018,31/07/2018,0.00,,294.71,,"-700,834.20"
,IN,AR,30321699,1005,100,,Invoice,,,,,,31/07/2018,31/07/2018,0.00,,112.65,,"-700,946.85"
,IN,AR,30321700,1005,100,,Invoice,,,,,,31/07/2018,31/07/2018,0.00,,5.36,,"-700,952.21"
,IN,AR,30321701,1005,100,,Invoice,,,,,,31/07/2018,31/07/2018,0.00,,25.03,,"-700,977.24"
,IN,AR,30321702,1005,100,,Invoice,,,,,,31/07/2018,31/07/2018,0.00,,48.28,,"-701,025.52"
,IN,AR,30321703,1005,100,,Invoice,,,,,,31/07/2018,31/07/2018,0.00,,37.55,,"-701,063.07"
,IN,AR,30321704,1005,100,,Invoice,,,,,,31/07/2018,31/07/2018,0.00,,26.82,,"-701,089.89"
,IN,AR,30321705,1005,100,,Invoice,,,,,,31/07/2018,31/07/2018,0.00,,26.82,,"-701,116.71"
,IN,AR,30321706,1005,100,,Invoice,,,,,,31/07/2018,31/07/2018,0.00,,46.49,,"-701,163.20"
,IN,AR,30321707,1005,100,,Invoice,,,,,,31/07/2018,31/07/2018,0.00,,259.28,,"-701,422.48"
,IN,AR,30321708,1005,100,,Invoice,,,,,,31/07/2018,31/07/2018,0.00,,10.73,,"-701,433.21"
,IN,AR,30321709,1005,100,,Invoice,,,,,,31/07/2018,31/07/2018,0.00,,21.46,,"-701,454.67"
,IN,AR,30321710,1005,100,,Invoice,,,,,,31/07/2018,31/07/2018,0.00,,12.52,,"-701,467.19"
,IN,AR,30321712,1005,100,,Invoice,,,,,,31/07/2018,31/07/2018,0.00,,59.01,,"-701,526.20"
,IN,AR,30321713,1005,100,,Invoice,,,,,,31/07/2018,31/07/2018,0.00,,89.41,,"-701,615.61"
,IN,AR,30321714,1005,100,,Invoice,,,,,,31/07/2018,31/07/2018,0.00,,33.97,,"-701,649.58"
,IN,AR,30321715,1005,100,,Invoice,,,,,,31/07/2018,31/07/2018,0.00,,14.31,,"-701,663.89"
,IN,AR,30321716,1005,100,,Invoice,,,,,,31/07/2018,31/07/2018,0.00,,10.73,,"-701,674.62"
,IN,AR,30321717,1005,100,,Invoice,,,,,,31/07/2018,31/07/2018,0.00,,42.92,,"-701,717.54"
,IN,AR,30321718,1005,100,,Invoice,,,,,,31/07/2018,31/07/2018,0.00,,17.88,,"-701,735.42"
,IN,AR,30321719,1005,100,,Invoice,,,,,,31/07/2018,31/07/2018,0.00,,16.09,,"-701,751.51"
,IN,AR,30321720,1005,100,,Invoice,,,,,,31/07/2018,31/07/2018,0.00,,26.82,,"-701,778.33"
,IN,AR,30321721,1005,100,,Invoice,,,,,,31/07/2018,31/07/2018,0.00,,129.81,,"-701,908.14"
,IN,AR,30321722,1005,100,,Invoice,,,,,,31/07/2018,31/07/2018,0.00,,220.58,,"-702,128.72"
,IN,AR,30321723,1005,100,,Invoice,,,,,,31/07/2018,31/07/2018,0.00,,77.61,,"-702,206.33"
,IN,AR,30321724,1005,100,,Invoice,,,,,,31/07/2018,31/07/2018,0.00,,12.25,,"-702,218.58"
,IN,AR,30321725,1005,100,,Invoice,,,,,,31/07/2018,31/07/2018,0.00,,185.86,,"-702,404.44"
,IN,AR,30321726,1005,100,,Invoice,,,,,,31/07/2018,31/07/2018,0.00,,79.65,,"-702,484.09"
,IN,AR,30321727,1005,100,,Invoice,,,,,,31/07/2018,31/07/2018,0.00,,388.05,,"-702,872.14"
,IN,AR,30321728,1005,100,,Invoice,,,,,,31/07/2018,31/07/2018,0.00,,8.17,,"-702,880.31"
,IN,AR,30321756,1005,100,,Invoice,,,,,,31/07/2018,31/07/2018,0.00,,63.35,,"-702,943.66"
,IN,AR,30321773,1005,100,,Invoice,,,,,,31/07/2018,31/07/2018,0.00,,"1,461.19",,"-704,404.85"
,IN,AR,30321774,1005,100,,Invoice,,,,,,31/07/2018,31/07/2018,0.00,,379.22,,"-704,784.07"
,IN,AR,30321775,1005,100,,Invoice,,,,,,31/07/2018,31/07/2018,0.00,,90.61,,"-704,874.68"
,IN,AR,30321776,1005,100,,Invoice,,,,,,31/07/2018,31/07/2018,0.00,,38.59,,"-704,913.27"
,IN,AR,30321777,1005,100,,Invoice,,,,,,31/07/2018,31/07/2018,0.00,,38.59,,"-704,951.86"
,IN,AR,30321811,1005,100,,Invoice,,,,,,31/07/2018,31/07/2018,0.00,,98.31,,"-705,050.17"
,IN,AR,30321824,1005,100,,Invoice,,,,,,31/07/2018,31/07/2018,0.00,,166.10,,"-705,216.27"
,IN,AR,30321852,1005,100,,Invoice,,,,,,31/07/2018,31/07/2018,0.00,,58.26,,"-705,274.53"
,IN,AR,30321853,1005,100,,Invoice,,,,,,31/07/2018,31/07/2018,0.00,,25.64,,"-705,300.17"
,IN,AR,30321854,1005,100,,Invoice,,,,,,31/07/2018,31/07/2018,0.00,,69.92,,"-705,370.09"
,IN,AR,30321855,1005,100,,Invoice,,,,,,31/07/2018,31/07/2018,0.00,,18.64,,"-705,388.73"
,IN,AR,30321856,1005,100,,Invoice,,,,,,31/07/2018,31/07/2018,0.00,,48.94,,"-705,437.67"
,IN,AR,30321857,1005,100,,Invoice,,,,,,31/07/2018,31/07/2018,0.00,,76.91,,"-705,514.58"
,IN,AR,30321858,1005,100,,Invoice,,,,,,31/07/2018,31/07/2018,0.00,,46.61,,"-705,561.19"
,IN,AR,30321859,1005,100,,Invoice,,,,,,31/07/2018,31/07/2018,0.00,,34.96,,"-705,596.15"
,IN,AR,30321860,1005,100,,Invoice,,,,,,31/07/2018,31/07/2018,0.00,,44.28,,"-705,640.43"
,IN,AR,30321861,1005,100,,Invoice,,,,,,31/07/2018,31/07/2018,0.00,,32.63,,"-705,673.06"
,IN,AR,30321862,1005,100,,Invoice,,,,,,31/07/2018,31/07/2018,0.00,,819.10,,"-706,492.16"
,IN,AR,30321896,1005,100,,Invoice,,,,,,31/07/2018,31/07/2018,0.00,,9.54,,"-706,501.70"
,IN,AR,30321897,1005,100,,Invoice,,,,,,31/07/2018,31/07/2018,0.00,,475.03,,"-706,976.73"
,IN,AR,30321902,1005,100,,Invoice,,,,,,31/07/2018,31/07/2018,0.00,,59.75,,"-707,036.48"
,IN,AR,30321921,1005,100,,Invoice,,,,,,31/07/2018,31/07/2018,0.00,,237.84,,"-707,274.32"
,IN,AR,30321950,1005,100,,Invoice,,,,,,31/07/2018,31/07/2018,0.00,,71.45,,"-707,345.77"
,IN,AR,30322014,1005,100,,Invoice,,,,,,31/07/2018,31/07/2018,0.00,,693.90,,"-708,039.67"
,IN,AR,30322015,1005,100,,Invoice,,,,,,31/07/2018,31/07/2018,0.00,,7.80,,"-708,047.47"
,IN,AR,30322016,1005,100,,Invoice,,,,,,31/07/2018,31/07/2018,0.00,,17.54,,"-708,065.01"
,IN,AR,30322017,1005,100,,Invoice,,,,,,31/07/2018,31/07/2018,0.00,,21.44,,"-708,086.45"
,IN,AR,30322018,1005,100,,Invoice,,,,,,31/07/2018,31/07/2018,0.00,,29.24,,"-708,115.69"
,IN,AR,30322019,1005,100,,Invoice,,,,,,31/07/2018,31/07/2018,0.00,,19.49,,"-708,135.18"
,IN,AR,30322020,1005,100,,Invoice,,,,,,31/07/2018,31/07/2018,0.00,,15.59,,"-708,150.77"
,IN,AR,30322021,1005,100,,Invoice,,,,,,31/07/2018,31/07/2018,0.00,,17.54,,"-708,168.31"
,IN,AR,30322022,1005,100,,Invoice,,,,,,31/07/2018,31/07/2018,0.00,,38.98,,"-708,207.29"
,IN,AR,30322023,1005,100,,Invoice,,,,,,31/07/2018,31/07/2018,0.00,,27.29,,"-708,234.58"
,IN,AR,30322024,1005,100,,Invoice,,,,,,31/07/2018,31/07/2018,0.00,,68.22,,"-708,302.80"
,IN,AR,30322025,1005,100,,Invoice,,,,,,31/07/2018,31/07/2018,0.00,,19.49,,"-708,322.29"
,IN,AR,30322026,1005,100,,Invoice,,,,,,31/07/2018,31/07/2018,0.00,,9.75,,"-708,332.04"
,IN,AR,30322027,1005,100,,Invoice,,,,,,31/07/2018,31/07/2018,0.00,,13.64,,"-708,345.68"
,IN,AR,30322028,1005,100,,Invoice,,,,,,31/07/2018,31/07/2018,0.00,,3.90,,"-708,349.58"
,IN,AR,30322029,1005,100,,Invoice,,,,,,31/07/2018,31/07/2018,0.00,,19.49,,"-708,369.07"
,IN,AR,30322030,1005,100,,Invoice,,,,,,31/07/2018,31/07/2018,0.00,,7.80,,"-708,376.87"
,IN,AR,30322031,1005,100,,Invoice,,,,,,31/07/2018,31/07/2018,0.00,,17.54,,"-708,394.41"
,IN,AR,30322032,1005,100,,Invoice,,,,,,31/07/2018,31/07/2018,0.00,,656.86,,"-709,051.27"
,IN,AR,30322033,1005,100,,Invoice,,,,,,31/07/2018,31/07/2018,0.00,,37.03,,"-709,088.30"
,IN,AR,30322034,1005,100,,Invoice,,,,,,31/07/2018,31/07/2018,0.00,,50.68,,"-709,138.98"
,IN,AR,30322035,1005,100,,Invoice,,,,,,31/07/2018,31/07/2018,0.00,,9.75,,"-709,148.73"
,IN,AR,30322036,1005,100,,Invoice,,,,,,31/07/2018,31/07/2018,0.00,,13.64,,"-709,162.37"
,IN,AR,30322037,1005,100,,Invoice,,,,,,31/07/2018,31/07/2018,0.00,,11.69,,"-709,174.06"
,IN,AR,30322038,1005,100,,Invoice,,,,,,31/07/2018,31/07/2018,0.00,,91.61,,"-709,265.67"
,IN,AR,30322039,1005,100,,Invoice,,,,,,31/07/2018,31/07/2018,0.00,,31.19,,"-709,296.86"
,IN,AR,30322040,1005,100,,Invoice,,,,,,31/07/2018,31/07/2018,0.00,,9.75,,"-709,306.61"
,IN,AR,30322041,1005,100,,Invoice,,,,,,31/07/2018,31/07/2018,0.00,,9.75,,"-709,316.36"
,IN,AR,30322042,1005,100,,Invoice,,,,,,31/07/2018,31/07/2018,0.00,,5.85,,"-709,322.21"
,IN,AR,30322043,1005,100,,Invoice,,,,,,31/07/2018,31/07/2018,0.00,,672.46,,"-709,994.67"
,IN,AR,30322044,1005,100,,Invoice,,,,,,31/07/2018,31/07/2018,0.00,,7.80,,"-710,002.47"
,IN,AR,30322045,1005,100,,Invoice,,,,,,31/07/2018,31/07/2018,0.00,,50.68,,"-710,053.15"
,IN,AR,30322046,1005,100,,Invoice,,,,,,31/07/2018,31/07/2018,0.00,,27.29,,"-710,080.44"
,IN,AR,30322057,1005,100,,Invoice,,,,,,31/07/2018,31/07/2018,0.00,,24.46,,"-710,104.90"
,IN,AR,30322058,1005,100,,Invoice,,,,,,31/07/2018,31/07/2018,0.00,,15.05,,"-710,119.95"
,IN,AR,30322059,1005,100,,Invoice,,,,,,31/07/2018,31/07/2018,0.00,,16.93,,"-710,136.88"
,IN,AR,30322060,1005,100,,Invoice,,,,,,31/07/2018,31/07/2018,0.00,,16.93,,"-710,153.81"
,IN,AR,30322061,1005,100,,Invoice,,,,,,31/07/2018,31/07/2018,0.00,,11.29,,"-710,165.10"
,IN,AR,30322072,1005,100,,Invoice,,,,,,31/07/2018,31/07/2018,0.00,,677.14,,"-710,842.24"
,IN,AR,30322073,1005,100,,Invoice,,,,,,31/07/2018,31/07/2018,0.00,,677.14,,"-711,519.38"
,IN,AR,30322074,1005,100,,Invoice,,,,,,31/07/2018,31/07/2018,0.00,,677.14,,"-712,196.52"
,IN,AR,30322089,1005,100,,Invoice,,,,,,31/07/2018,31/07/2018,0.00,,280.64,,"-712,477.16"
,IN,AR,30322090,1005,100,,Invoice,,,,,,31/07/2018,31/07/2018,0.00,,258.53,,"-712,735.69"
,IN,AR,30322114,1005,100,,Invoice,,,,,,31/07/2018,31/07/2018,0.00,,54.75,,"-712,790.44"
,IN,AR,30322115,1005,100,,Invoice,,,,,,31/07/2018,31/07/2018,0.00,,24.64,,"-712,815.08"
,IN,AR,30322116,1005,100,,Invoice,,,,,,31/07/2018,31/07/2018,0.00,,10.95,,"-712,826.03"
,IN,AR,30322117,1005,100,,Invoice,,,,,,31/07/2018,31/07/2018,0.00,,5.47,,"-712,831.50"
,IN,AR,30322118,1005,100,,Invoice,,,,,,31/07/2018,31/07/2018,0.00,,5.47,,"-712,836.97"
,IN,AR,30322170,1005,100,,Invoice,,,,,,31/07/2018,31/07/2018,0.00,,173.76,,"-713,010.73"
,IN,AR,30322214,1005,100,,Invoice,,,,,,31/07/2018,31/07/2018,0.00,,"1,226.98",,"-714,237.71"
,CR,AR,33000226,1005,100,,Cash Return,,,,,,01/08/2018,01/08/2018,3.64,,0.00,,"-714,234.07"
,CS,AR,32007059,1005,100,,Cash sale,,,,,,01/08/2018,01/08/2018,0.00,,22.44,,"-714,256.51"
,CS,AR,32007063,1005,100,,Cash sale,,,,,,01/08/2018,01/08/2018,0.00,,40.14,,"-714,296.65"
,CS,AR,32007070,1005,100,,Cash sale,,,,,,01/08/2018,01/08/2018,0.00,,7.29,,"-714,303.94"
,CS,AR,32007078,1005,100,,Cash sale,,,,,,01/08/2018,01/08/2018,0.00,,7.29,,"-714,311.23"
,CS,AR,32007083,1005,100,,Cash sale,,,,,,01/08/2018,01/08/2018,0.00,,10.93,,"-714,322.16"
,CS,AR,32007087,1005,100,,Cash sale,,,,,,01/08/2018,01/08/2018,0.00,,3.64,,"-714,325.80"
,CS,AR,32007093,1005,100,,Cash sale,,,,,,01/08/2018,01/08/2018,0.00,,3.64,,"-714,329.44"
,CS,AR,32007094,1005,100,,Cash sale,,,,,,01/08/2018,01/08/2018,0.00,,21.86,,"-714,351.30"
,CS,AR,32007098,1005,100,,Cash sale,,,,,,01/08/2018,01/08/2018,0.00,,9.03,,"-714,360.33"
,CS,AR,32007112,1005,100,,Cash sale,,,,,,01/08/2018,01/08/2018,0.00,,10.93,,"-714,371.26"
,CS,AR,32007114,1005,100,,Cash sale,,,,,,01/08/2018,01/08/2018,0.00,,2.92,,"-714,374.18"
,CS,AR,32007117,1005,100,,Cash sale,,,,,,01/08/2018,01/08/2018,0.00,,10.93,,"-714,385.11"
,CS,AR,32007122,1005,100,,Cash sale,,,,,,01/08/2018,01/08/2018,0.00,,10.34,,"-714,395.45"
,CS,AR,32007127,1005,100,,Cash sale,,,,,,01/08/2018,01/08/2018,0.00,,3.64,,"-714,399.09"
,CS,AR,32007135,1005,100,,Cash sale,,,,,,01/08/2018,01/08/2018,0.00,,12.14,,"-714,411.23"
,CS,AR,32007139,1005,100,,Cash sale,,,,,,01/08/2018,01/08/2018,0.00,,10.34,,"-714,421.57"
,CS,AR,32007141,1005,100,,Cash sale,,,,,,01/08/2018,01/08/2018,0.00,,23.26,,"-714,444.83"
,CS,AR,32007143,1005,100,,Cash sale,,,,,,01/08/2018,01/08/2018,0.00,,7.29,,"-714,452.12"
,CS,AR,32007145,1005,100,,Cash sale,,,,,,01/08/2018,01/08/2018,0.00,,24.07,,"-714,476.19"
,CS,AR,32007153,1005,100,,Cash sale,,,,,,01/08/2018,01/08/2018,0.00,,10.93,,"-714,487.12"
,CS,AR,32007154,1005,100,,Cash sale,,,,,,01/08/2018,01/08/2018,0.00,,3.64,,"-714,490.76"
,CS,AR,32007155,1005,100,,Cash sale,,,,,,01/08/2018,01/08/2018,0.00,,7.63,,"-714,498.39"
,CS,AR,32007165,1005,100,,Cash sale,,,,,,01/08/2018,01/08/2018,0.00,,10.93,,"-714,509.32"
,CS,AR,32007166,1005,100,,Cash sale,,,,,,01/08/2018,01/08/2018,0.00,,5.17,,"-714,514.49"
,CS,AR,32007178,1005,100,,Cash sale,,,,,,01/08/2018,01/08/2018,0.00,,66.19,,"-714,580.68"
,CS,AR,32007183,1005,100,,Cash sale,,,,,,01/08/2018,01/08/2018,0.00,,18.22,,"-714,598.90"
,CS,AR,32007191,1005,100,,Cash sale,,,,,,01/08/2018,01/08/2018,0.00,,7.29,,"-714,606.19"
,CS,AR,32007198,1005,100,,Cash sale,,,,,,01/08/2018,01/08/2018,0.00,,3.64,,"-714,609.83"
,CS,AR,32007203,1005,100,,Cash sale,,,,,,01/08/2018,01/08/2018,0.00,,2.58,,"-714,612.41"
,CS,AR,32007212,1005,100,,Cash sale,,,,,,01/08/2018,01/08/2018,0.00,,5.34,,"-714,617.75"
,CS,AR,32007215,1005,100,,Cash sale,,,,,,01/08/2018,01/08/2018,0.00,,16.61,,"-714,634.36"
,CS,AR,32007217,1005,100,,Cash sale,,,,,,01/08/2018,01/08/2018,0.00,,7.29,,"-714,641.65"
,CS,AR,32007219,1005,100,,Cash sale,,,,,,01/08/2018,01/08/2018,0.00,,14.58,,"-714,656.23"
,CS,AR,32007225,1005,100,,Cash sale,,,,,,01/08/2018,01/08/2018,0.00,,7.29,,"-714,663.52"
,CS,AR,32007227,1005,100,,Cash sale,,,,,,01/08/2018,01/08/2018,0.00,,7.29,,"-714,670.81"
,CS,AR,32007228,1005,100,,Cash sale,,,,,,01/08/2018,01/08/2018,0.00,,9.15,,"-714,679.96"
,CS,AR,32007236,1005,100,,Cash sale,,,,,,01/08/2018,01/08/2018,0.00,,9.11,,"-714,689.07"
,CS,AR,32007241,1005,100,,Cash sale,,,,,,01/08/2018,01/08/2018,0.00,,9.15,,"-714,698.22"
,CS,AR,32007253,1005,100,,Cash sale,,,,,,01/08/2018,01/08/2018,0.00,,7.29,,"-714,705.51"
,CS,AR,32007254,1005,100,,Cash sale,,,,,,01/08/2018,01/08/2018,0.00,,14.58,,"-714,720.09"
,CS,AR,32007255,1005,100,,Cash sale,,,,,,01/08/2018,01/08/2018,0.00,,14.83,,"-714,734.92"
,CS,AR,32007259,1005,100,,Cash sale,,,,,,01/08/2018,01/08/2018,0.00,,18.05,,"-714,752.97"
,CS,AR,32007260,1005,100,,Cash sale,,,,,,01/08/2018,01/08/2018,0.00,,7.29,,"-714,760.26"
,CS,AR,32007266,1005,100,,Cash sale,,,,,,01/08/2018,01/08/2018,0.00,,10.93,,"-714,771.19"
,CS,AR,32007270,1005,100,,Cash sale,,,,,,01/08/2018,01/08/2018,0.00,,41.95,,"-714,813.14"
,CS,AR,32007275,1005,100,,Cash sale,,,,,,01/08/2018,01/08/2018,0.00,,3.64,,"-714,816.78"
,CS,AR,32007288,1005,100,,Cash sale,,,,,,01/08/2018,01/08/2018,0.00,,3.64,,"-714,820.42"
,CS,AR,32007293,1005,100,,Cash sale,,,,,,01/08/2018,01/08/2018,0.00,,3.64,,"-714,824.06"
,CS,AR,32007329,1005,100,,Cash sale,,,,,,01/08/2018,01/08/2018,0.00,,7.29,,"-714,831.35"
,CS,AR,32007333,1005,100,,Cash sale,,,,,,01/08/2018,01/08/2018,0.00,,7.29,,"-714,838.64"
,CS,AR,32007334,1005,100,,Cash sale,,,,,,01/08/2018,01/08/2018,0.00,,54.66,,"-714,893.30"
,IN,AR,30321436,1005,100,,Invoice,,,,,,01/08/2018,01/08/2018,0.00,,38.56,,"-714,931.86"
,IN,AR,30321437,1005,100,,Invoice,,,,,,01/08/2018,01/08/2018,0.00,,17.80,,"-714,949.66"
,IN,AR,30321447,1005,100,,Invoice,,,,,,01/08/2018,01/08/2018,0.00,,80.54,,"-715,030.20"
,IN,AR,30321448,1005,100,,Invoice,,,,,,01/08/2018,01/08/2018,0.00,,31.73,,"-715,061.93"
,IN,AR,30321457,1005,100,,Invoice,,,,,,01/08/2018,01/08/2018,0.00,,16.27,,"-715,078.20"
,IN,AR,30321460,1005,100,,Invoice,,,,,,01/08/2018,01/08/2018,0.00,,2.84,,"-715,081.04"
,IN,AR,30321465,1005,100,,Invoice,,,,,,01/08/2018,01/08/2018,0.00,,31.53,,"-715,112.57"
,IN,AR,30321466,1005,100,,Invoice,,,,,,01/08/2018,01/08/2018,0.00,,78.81,,"-715,191.38"
,IN,AR,30321468,1005,100,,Invoice,,,,,,01/08/2018,01/08/2018,0.00,,29.15,,"-715,220.53"
,IN,AR,30321469,1005,100,,Invoice,,,,,,01/08/2018,01/08/2018,0.00,,19.32,,"-715,239.85"
,IN,AR,30321482,1005,100,,Invoice,,,,,,01/08/2018,01/08/2018,0.00,,54.66,,"-715,294.51"
,IN,AR,30321484,1005,100,,Invoice,,,,,,01/08/2018,01/08/2018,0.00,,5.97,,"-715,300.48"
,IN,AR,30321487,1005,100,,Invoice,,,,,,01/08/2018,01/08/2018,0.00,,106.78,,"-715,407.26"
,IN,AR,30321503,1005,100,,Invoice,,,,,,01/08/2018,01/08/2018,0.00,,18.22,,"-715,425.48"
,IN,AR,30321504,1005,100,,Invoice,,,,,,01/08/2018,01/08/2018,0.00,,7.29,,"-715,432.77"
,IN,AR,30321506,1005,100,,Invoice,,,,,,01/08/2018,01/08/2018,0.00,,32.00,,"-715,464.77"
,IN,AR,30321516,1005,100,,Invoice,,,,,,01/08/2018,01/08/2018,0.00,,10.93,,"-715,475.70"
,IN,AR,30321523,1005,100,,Invoice,,,,,,01/08/2018,01/08/2018,0.00,,60.00,,"-715,535.70"
,IN,AR,30321541,1005,100,,Invoice,,,,,,01/08/2018,01/08/2018,0.00,,267.42,,"-715,803.12"
,IN,AR,30321561,1005,100,,Invoice,,,,,,01/08/2018,01/08/2018,0.00,,10.93,,"-715,814.05"
,IN,AR,30321582,1005,100,,Invoice,,,,,,01/08/2018,01/08/2018,0.00,,25.42,,"-715,839.47"
,IN,AR,30321589,1005,100,,Invoice,,,,,,01/08/2018,01/08/2018,0.00,,4.24,,"-715,843.71"
,IN,AR,30321592,1005,100,,Invoice,,,,,,01/08/2018,01/08/2018,0.00,,16.27,,"-715,859.98"
,IN,AR,30321594,1005,100,,Invoice,,,,,,01/08/2018,01/08/2018,0.00,,2.12,,"-715,862.10"
,IN,AR,30321596,1005,100,,Invoice,,,,,,01/08/2018,01/08/2018,0.00,,8.39,,"-715,870.49"
,IN,AR,30321607,1005,100,,Invoice,,,,,,01/08/2018,01/08/2018,0.00,,7.29,,"-715,877.78"
,IN,AR,30321611,1005,100,,Invoice,,,,,,01/08/2018,01/08/2018,0.00,,9.56,,"-715,887.34"
,IN,AR,30321616,1005,100,,Invoice,,,,,,01/08/2018,01/08/2018,0.00,,67.68,,"-715,955.02"
,IN,AR,30321645,1005,100,,Invoice,,,,,,01/08/2018,01/08/2018,0.00,,9.32,,"-715,964.34"
,IN,AR,30321650,1005,100,,Invoice,,,,,,01/08/2018,01/08/2018,0.00,,256.08,,"-716,220.42"
,IN,AR,30321678,1005,100,,Invoice,,,,,,01/08/2018,01/08/2018,0.00,,7.63,,"-716,228.05"
,IN,AR,30321679,1005,100,,Invoice,,,,,,01/08/2018,01/08/2018,0.00,,5.08,,"-716,233.13"
,IN,AR,30321680,1005,100,,Invoice,,,,,,01/08/2018,01/08/2018,0.00,,5.08,,"-716,238.21"
,IN,AR,30321691,1005,100,,Invoice,,,,,,01/08/2018,01/08/2018,0.00,,3.19,,"-716,241.40"
,IN,AR,30321693,1005,100,,Invoice,,,,,,01/08/2018,01/08/2018,0.00,,33.10,,"-716,274.50"
,IN,AR,30321696,1005,100,,Invoice,,,,,,01/08/2018,01/08/2018,0.00,,8.47,,"-716,282.97"
,IN,AR,30321736,1005,100,,Invoice,,,,,,01/08/2018,01/08/2018,0.00,,22.71,,"-716,305.68"
,IN,AR,30321754,1005,100,,Invoice,,,,,,01/08/2018,01/08/2018,0.00,,18.22,,"-716,323.90"
,IN,AR,30321767,1005,100,,Invoice,,,,,,01/08/2018,01/08/2018,0.00,,41.53,,"-716,365.43"
,IN,AR,30321772,1005,100,,Invoice,,,,,,01/08/2018,01/08/2018,0.00,,16.78,,"-716,382.21"
,IN,AR,30321779,1005,100,,Invoice,,,,,,01/08/2018,01/08/2018,0.00,,364.41,,"-716,746.62"
,IN,AR,30321786,1005,100,,Invoice,,,,,,01/08/2018,01/08/2018,0.00,,58.73,,"-716,805.35"
,IN,AR,30321788,1005,100,,Invoice,,,,,,01/08/2018,01/08/2018,0.00,,15.25,,"-716,820.60"
,IN,AR,30321793,1005,100,,Invoice,,,,,,01/08/2018,01/08/2018,0.00,,10.85,,"-716,831.45"
,IN,AR,30321806,1005,100,,Invoice,,,,,,01/08/2018,01/08/2018,0.00,,50.11,,"-716,881.56"
,IN,AR,30321812,1005,100,,Invoice,,,,,,01/08/2018,01/08/2018,0.00,,30.08,,"-716,911.64"
,IN,AR,30321815,1005,100,,Invoice,,,,,,01/08/2018,01/08/2018,0.00,,54.66,,"-716,966.30"
,IN,AR,30321816,1005,100,,Invoice,,,,,,01/08/2018,01/08/2018,0.00,,54.66,,"-717,020.96"
,IN,AR,30321827,1005,100,,Invoice,,,,,,01/08/2018,01/08/2018,0.00,,1.76,,"-717,022.72"
,IN,AR,30321831,1005,100,,Invoice,,,,,,01/08/2018,01/08/2018,0.00,,24.07,,"-717,046.79"
,IN,AR,30321833,1005,100,,Invoice,,,,,,01/08/2018,01/08/2018,0.00,,10.93,,"-717,057.72"
,IN,AR,30321841,1005,100,,Invoice,,,,,,01/08/2018,01/08/2018,0.00,,15.51,,"-717,073.23"
,IN,AR,30321845,1005,100,,Invoice,,,,,,01/08/2018,01/08/2018,0.00,,30.01,,"-717,103.24"
,IN,AR,30321846,1005,100,,Invoice,,,,,,01/08/2018,01/08/2018,0.00,,51.02,,"-717,154.26"
,IN,AR,30321847,1005,100,,Invoice,,,,,,01/08/2018,01/08/2018,0.00,,36.44,,"-717,190.70"
,IN,AR,30321865,1005,100,,Invoice,,,,,,01/08/2018,01/08/2018,0.00,,10.17,,"-717,200.87"
,IN,AR,30321879,1005,100,,Invoice,,,,,,01/08/2018,01/08/2018,0.00,,6.02,,"-717,206.89"
,IN,AR,30321883,1005,100,,Invoice,,,,,,01/08/2018,01/08/2018,0.00,,44.00,,"-717,250.89"
,IN,AR,30321886,1005,100,,Invoice,,,,,,01/08/2018,01/08/2018,0.00,,54.99,,"-717,305.88"
,IN,AR,30321891,1005,100,,Invoice,,,,,,01/08/2018,01/08/2018,0.00,,100.21,,"-717,406.09"
,IN,AR,30321893,1005,100,,Invoice,,,,,,01/08/2018,01/08/2018,0.00,,28.06,,"-717,434.15"
,IN,AR,30321898,1005,100,,Invoice,,,,,,01/08/2018,01/08/2018,0.00,,14.58,,"-717,448.73"
,IN,AR,30321906,1005,100,,Invoice,,,,,,01/08/2018,01/08/2018,0.00,,36.74,,"-717,485.47"
,IN,AR,30321910,1005,100,,Invoice,,,,,,01/08/2018,01/08/2018,0.00,,7.29,,"-717,492.76"
,IN,AR,30321911,1005,100,,Invoice,,,,,,01/08/2018,01/08/2018,0.00,,14.58,,"-717,507.34"
,IN,AR,30321922,1005,100,,Invoice,,,,,,01/08/2018,01/08/2018,0.00,,10.19,,"-717,517.53"
,IN,AR,30321924,1005,100,,Invoice,,,,,,01/08/2018,01/08/2018,0.00,,43.97,,"-717,561.50"
,IN,AR,30321929,1005,100,,Invoice,,,,,,01/08/2018,01/08/2018,0.00,,7.63,,"-717,569.13"
,IN,AR,30321940,1005,100,,Invoice,,,,,,01/08/2018,01/08/2018,0.00,,20.01,,"-717,589.14"
,IN,AR,30321945,1005,100,,Invoice,,,,,,01/08/2018,01/08/2018,0.00,,28.39,,"-717,617.53"
,IN,AR,30321946,1005,100,,Invoice,,,,,,01/08/2018,01/08/2018,0.00,,3.02,,"-717,620.55"
,IN,AR,30321949,1005,100,,Invoice,,,,,,01/08/2018,01/08/2018,0.00,,5.83,,"-717,626.38"
,IN,AR,30321952,1005,100,,Invoice,,,,,,01/08/2018,01/08/2018,0.00,,16.82,,"-717,643.20"
,IN,AR,30321953,1005,100,,Invoice,,,,,,01/08/2018,01/08/2018,0.00,,6.31,,"-717,649.51"
,IN,AR,30321961,1005,100,,Invoice,,,,,,01/08/2018,01/08/2018,0.00,,11.95,,"-717,661.46"
,IN,AR,30321980,1005,100,,Invoice,,,,,,01/08/2018,01/08/2018,0.00,,5.59,,"-717,667.05"
,IN,AR,30321995,1005,100,,Invoice,,,,,,01/08/2018,01/08/2018,0.00,,3.64,,"-717,670.69"
,IN,AR,30322004,1005,100,,Invoice,,,,,,01/08/2018,01/08/2018,0.00,,11.15,,"-717,681.84"
,IN,AR,30322010,1005,100,,Invoice,,,,,,01/08/2018,01/08/2018,0.00,,13.56,,"-717,695.40"
,IN,AR,30322063,1005,100,,Invoice,,,,,,01/08/2018,01/08/2018,0.00,,7.02,,"-717,702.42"
,IN,AR,30322067,1005,100,,Invoice,,,,,,01/08/2018,01/08/2018,0.00,,13.56,,"-717,715.98"
,IN,AR,30322068,1005,100,,Invoice,,,,,,01/08/2018,01/08/2018,0.00,,11.36,,"-717,727.34"
,IN,AR,30322084,1005,100,,Invoice,,,,,,01/08/2018,01/08/2018,0.00,,3.64,,"-717,730.98"
,IN,AR,30322085,1005,100,,Invoice,,,,,,01/08/2018,01/08/2018,0.00,,9.41,,"-717,740.39"
,IN,AR,30322088,1005,100,,Invoice,,,,,,01/08/2018,01/08/2018,0.00,,10.93,,"-717,751.32"
,IN,AR,30322096,1005,100,,Invoice,,,,,,01/08/2018,01/08/2018,0.00,,12.14,,"-717,763.46"
,IN,AR,30322099,1005,100,,Invoice,,,,,,01/08/2018,01/08/2018,0.00,,22.37,,"-717,785.83"
,IN,AR,30322103,1005,100,,Invoice,,,,,,01/08/2018,01/08/2018,0.00,,21.86,,"-717,807.69"
,IN,AR,30322119,1005,100,,Invoice,,,,,,01/08/2018,01/08/2018,0.00,,11.44,,"-717,819.13"
,IN,AR,30322132,1005,100,,Invoice,,,,,,01/08/2018,01/08/2018,0.00,,78.90,,"-717,898.03"
,IN,AR,30322133,1005,100,,Invoice,,,,,,01/08/2018,01/08/2018,0.00,,16.61,,"-717,914.64"
,IN,AR,30322134,1005,100,,Invoice,,,,,,01/08/2018,01/08/2018,0.00,,16.61,,"-717,931.25"
,IN,AR,30322148,1005,100,,Invoice,,,,,,01/08/2018,01/08/2018,0.00,,7.63,,"-717,938.88"
,IN,AR,30322154,1005,100,,Invoice,,,,,,01/08/2018,01/08/2018,0.00,,30.34,,"-717,969.22"
,IN,AR,30322158,1005,100,,Invoice,,,,,,01/08/2018,01/08/2018,0.00,,21.74,,"-717,990.96"
,IN,AR,30322166,1005,100,,Invoice,,,,,,01/08/2018,01/08/2018,0.00,,14.58,,"-718,005.54"
,IN,AR,30322172,1005,100,,Invoice,,,,,,01/08/2018,01/08/2018,0.00,,7.29,,"-718,012.83"
,IN,AR,30322173,1005,100,,Invoice,,,,,,01/08/2018,01/08/2018,0.00,,300.00,,"-718,312.83"
,IN,AR,30322180,1005,100,,Invoice,,,,,,01/08/2018,01/08/2018,0.00,,57.66,,"-718,370.49"
,IN,AR,30322190,1005,100,,Invoice,,,,,,01/08/2018,01/08/2018,0.00,,30.76,,"-718,401.25"
,IN,AR,30322192,1005,100,,Invoice,,,,,,01/08/2018,01/08/2018,0.00,,29.15,,"-718,430.40"
,CS,AR,32007057,1005,100,,Cash sale,,,,,,02/08/2018,02/08/2018,0.00,,15.04,,"-718,445.44"
,CS,AR,32007058,1005,100,,Cash sale,,,,,,02/08/2018,02/08/2018,0.00,,21.86,,"-718,467.30"
,CS,AR,32007066,1005,100,,Cash sale,,,,,,02/08/2018,02/08/2018,0.00,,3.64,,"-718,470.94"
,CS,AR,32007072,1005,100,,Cash sale,,,,,,02/08/2018,02/08/2018,0.00,,5.17,,"-718,476.11"
,CS,AR,32007073,1005,100,,Cash sale,,,,,,02/08/2018,02/08/2018,0.00,,11.22,,"-718,487.33"
,CS,AR,32007080,1005,100,,Cash sale,,,,,,02/08/2018,02/08/2018,0.00,,25.51,,"-718,512.84"
,CS,AR,32007086,1005,100,,Cash sale,,,,,,02/08/2018,02/08/2018,0.00,,3.64,,"-718,516.48"
,CS,AR,32007091,1005,100,,Cash sale,,,,,,02/08/2018,02/08/2018,0.00,,3.64,,"-718,520.12"
,CS,AR,32007097,1005,100,,Cash sale,,,,,,02/08/2018,02/08/2018,0.00,,7.29,,"-718,527.41"
,CS,AR,32007105,1005,100,,Cash sale,,,,,,02/08/2018,02/08/2018,0.00,,7.29,,"-718,534.70"
,CS,AR,32007113,1005,100,,Cash sale,,,,,,02/08/2018,02/08/2018,0.00,,3.01,,"-718,537.71"
,CS,AR,32007115,1005,100,,Cash sale,,,,,,02/08/2018,02/08/2018,0.00,,10.93,,"-718,548.64"
,CS,AR,32007124,1005,100,,Cash sale,,,,,,02/08/2018,02/08/2018,0.00,,7.29,,"-718,555.93"
,CS,AR,32007146,1005,100,,Cash sale,,,,,,02/08/2018,02/08/2018,0.00,,6.43,,"-718,562.36"
,CS,AR,32007152,1005,100,,Cash sale,,,,,,02/08/2018,02/08/2018,0.00,,7.80,,"-718,570.16"
,CS,AR,32007168,1005,100,,Cash sale,,,,,,02/08/2018,02/08/2018,0.00,,3.64,,"-718,573.80"
,CS,AR,32007176,1005,100,,Cash sale,,,,,,02/08/2018,02/08/2018,0.00,,7.29,,"-718,581.09"
,CS,AR,32007184,1005,100,,Cash sale,,,,,,02/08/2018,02/08/2018,0.00,,9.66,,"-718,590.75"
,CS,AR,32007186,1005,100,,Cash sale,,,,,,02/08/2018,02/08/2018,0.00,,30.76,,"-718,621.51"
,CS,AR,32007189,1005,100,,Cash sale,,,,,,02/08/2018,02/08/2018,0.00,,3.64,,"-718,625.15"
,CS,AR,32007197,1005,100,,Cash sale,,,,,,02/08/2018,02/08/2018,0.00,,9.66,,"-718,634.81"
,CS,AR,32007213,1005,100,,Cash sale,,,,,,02/08/2018,02/08/2018,0.00,,22.37,,"-718,657.18"
,CS,AR,32007224,1005,100,,Cash sale,,,,,,02/08/2018,02/08/2018,0.00,,10.93,,"-718,668.11"
,CS,AR,32007240,1005,100,,Cash sale,,,,,,02/08/2018,02/08/2018,0.00,,7.29,,"-718,675.40"
,CS,AR,32007246,1005,100,,Cash sale,,,,,,02/08/2018,02/08/2018,0.00,,29.15,,"-718,704.55"
,CS,AR,32007247,1005,100,,Cash sale,,,,,,02/08/2018,02/08/2018,0.00,,20.76,,"-718,725.31"
,CS,AR,32007249,1005,100,,Cash sale,,,,,,02/08/2018,02/08/2018,0.00,,25.51,,"-718,750.82"
,CS,AR,32007256,1005,100,,Cash sale,,,,,,02/08/2018,02/08/2018,0.00,,14.58,,"-718,765.40"
,CS,AR,32007283,1005,100,,Cash sale,,,,,,02/08/2018,02/08/2018,0.00,,7.29,,"-718,772.69"
,CS,AR,32007295,1005,100,,Cash sale,,,,,,02/08/2018,02/08/2018,0.00,,7.29,,"-718,779.98"
,CS,AR,32007296,1005,100,,Cash sale,,,,,,02/08/2018,02/08/2018,0.00,,6.56,,"-718,786.54"
,CS,AR,32007301,1005,100,,Cash sale,,,,,,02/08/2018,02/08/2018,0.00,,18.22,,"-718,804.76"
,CS,AR,32007304,1005,100,,Cash sale,,,,,,02/08/2018,02/08/2018,0.00,,5.94,,"-718,810.70"
,CS,AR,32007326,1005,100,,Cash sale,,,,,,02/08/2018,02/08/2018,0.00,,7.29,,"-718,817.99"
,IN,AR,30321442,1005,100,,Invoice,,,,,,02/08/2018,02/08/2018,0.00,,3.64,,"-718,821.63"
,IN,AR,30321446,1005,100,,Invoice,,,,,,02/08/2018,02/08/2018,0.00,,3.64,,"-718,825.27"
,IN,AR,30321471,1005,100,,Invoice,,,,,,02/08/2018,02/08/2018,0.00,,10.93,,"-718,836.20"
,IN,AR,30321479,1005,100,,Invoice,,,,,,02/08/2018,02/08/2018,0.00,,69.24,,"-718,905.44"
,IN,AR,30321485,1005,100,,Invoice,,,,,,02/08/2018,02/08/2018,0.00,,1.99,,"-718,907.43"
,IN,AR,30321488,1005,100,,Invoice,,,,,,02/08/2018,02/08/2018,0.00,,52.20,,"-718,959.63"
,IN,AR,30321499,1005,100,,Invoice,,,,,,02/08/2018,02/08/2018,0.00,,60.00,,"-719,019.63"
,IN,AR,30321511,1005,100,,Invoice,,,,,,02/08/2018,02/08/2018,0.00,,7.29,,"-719,026.92"
,IN,AR,30321517,1005,100,,Invoice,,,,,,02/08/2018,02/08/2018,0.00,,14.58,,"-719,041.50"
,IN,AR,30321518,1005,100,,Invoice,,,,,,02/08/2018,02/08/2018,0.00,,21.86,,"-719,063.36"
,IN,AR,30321525,1005,100,,Invoice,,,,,,02/08/2018,02/08/2018,0.00,,64.07,,"-719,127.43"
,IN,AR,30321535,1005,100,,Invoice,,,,,,02/08/2018,02/08/2018,0.00,,32.95,,"-719,160.38"
,IN,AR,30321536,1005,100,,Invoice,,,,,,02/08/2018,02/08/2018,0.00,,21.86,,"-719,182.24"
,IN,AR,30321539,1005,100,,Invoice,,,,,,02/08/2018,02/08/2018,0.00,,14.58,,"-719,196.82"
,IN,AR,30321566,1005,100,,Invoice,,,,,,02/08/2018,02/08/2018,0.00,,18.22,,"-719,215.04"
,IN,AR,30321568,1005,100,,Invoice,,,,,,02/08/2018,02/08/2018,0.00,,18.22,,"-719,233.26"
,IN,AR,30321569,1005,100,,Invoice,,,,,,02/08/2018,02/08/2018,0.00,,38.50,,"-719,271.76"
,IN,AR,30321578,1005,100,,Invoice,,,,,,02/08/2018,02/08/2018,0.00,,7.63,,"-719,279.39"
,IN,AR,30321595,1005,100,,Invoice,,,,,,02/08/2018,02/08/2018,0.00,,7.29,,"-719,286.68"
,IN,AR,30321598,1005,100,,Invoice,,,,,,02/08/2018,02/08/2018,0.00,,40.25,,"-719,326.93"
,IN,AR,30321602,1005,100,,Invoice,,,,,,02/08/2018,02/08/2018,0.00,,214.45,,"-719,541.38"
,IN,AR,30321615,1005,100,,Invoice,,,,,,02/08/2018,02/08/2018,0.00,,30.51,,"-719,571.89"
,IN,AR,30321620,1005,100,,Invoice,,,,,,02/08/2018,02/08/2018,0.00,,86.44,,"-719,658.33"
,IN,AR,30321621,1005,100,,Invoice,,,,,,02/08/2018,02/08/2018,0.00,,5.08,,"-719,663.41"
,IN,AR,30321624,1005,100,,Invoice,,,,,,02/08/2018,02/08/2018,0.00,,29.15,,"-719,692.56"
,IN,AR,30321626,1005,100,,Invoice,,,,,,02/08/2018,02/08/2018,0.00,,28.68,,"-719,721.24"
,IN,AR,30321632,1005,100,,Invoice,,,,,,02/08/2018,02/08/2018,0.00,,32.20,,"-719,753.44"
,IN,AR,30321646,1005,100,,Invoice,,,,,,02/08/2018,02/08/2018,0.00,,15.51,,"-719,768.95"
,IN,AR,30321651,1005,100,,Invoice,,,,,,02/08/2018,02/08/2018,0.00,,18.22,,"-719,787.17"
,IN,AR,30321672,1005,100,,Invoice,,,,,,02/08/2018,02/08/2018,0.00,,6.36,,"-719,793.53"
,IN,AR,30321695,1005,100,,Invoice,,,,,,02/08/2018,02/08/2018,0.00,,5.17,,"-719,798.70"
,IN,AR,30321738,1005,100,,Invoice,,,,,,02/08/2018,02/08/2018,0.00,,30.51,,"-719,829.21"
,IN,AR,30321741,1005,100,,Invoice,,,,,,02/08/2018,02/08/2018,0.00,,17.50,,"-719,846.71"
,IN,AR,30321760,1005,100,,Invoice,,,,,,02/08/2018,02/08/2018,0.00,,13.73,,"-719,860.44"
,IN,AR,30321765,1005,100,,Invoice,,,,,,02/08/2018,02/08/2018,0.00,,21.19,,"-719,881.63"
,IN,AR,30321768,1005,100,,Invoice,,,,,,02/08/2018,02/08/2018,0.00,,47.46,,"-719,929.09"
,IN,AR,30321770,1005,100,,Invoice,,,,,,02/08/2018,02/08/2018,0.00,,9.15,,"-719,938.24"
,IN,AR,30321778,1005,100,,Invoice,,,,,,02/08/2018,02/08/2018,0.00,,7.29,,"-719,945.53"
,IN,AR,30321783,1005,100,,Invoice,,,,,,02/08/2018,02/08/2018,0.00,,21.19,,"-719,966.72"
,IN,AR,30321784,1005,100,,Invoice,,,,,,02/08/2018,02/08/2018,0.00,,38.77,,"-720,005.49"
,IN,AR,30321794,1005,100,,Invoice,,,,,,02/08/2018,02/08/2018,0.00,,6.97,,"-720,012.46"
,IN,AR,30321796,1005,100,,Invoice,,,,,,02/08/2018,02/08/2018,0.00,,8.77,,"-720,021.23"
,IN,AR,30321797,1005,100,,Invoice,,,,,,02/08/2018,02/08/2018,0.00,,21.86,,"-720,043.09"
,IN,AR,30321798,1005,100,,Invoice,,,,,,02/08/2018,02/08/2018,0.00,,10.93,,"-720,054.02"
,IN,AR,30321799,1005,100,,Invoice,,,,,,02/08/2018,02/08/2018,0.00,,27.54,,"-720,081.56"
,IN,AR,30321814,1005,100,,Invoice,,,,,,02/08/2018,02/08/2018,0.00,,14.63,,"-720,096.19"
,IN,AR,30321817,1005,100,,Invoice,,,,,,02/08/2018,02/08/2018,0.00,,15.53,,"-720,111.72"
,IN,AR,30321818,1005,100,,Invoice,,,,,,02/08/2018,02/08/2018,0.00,,10.17,,"-720,121.89"
,IN,AR,30321822,1005,100,,Invoice,,,,,,02/08/2018,02/08/2018,0.00,,17.03,,"-720,138.92"
,IN,AR,30321825,1005,100,,Invoice,,,,,,02/08/2018,02/08/2018,0.00,,8.00,,"-720,146.92"
,IN,AR,30321828,1005,100,,Invoice,,,,,,02/08/2018,02/08/2018,0.00,,1.76,,"-720,148.68"
,IN,AR,30321837,1005,100,,Invoice,,,,,,02/08/2018,02/08/2018,0.00,,8.24,,"-720,156.92"
,IN,AR,30321843,1005,100,,Invoice,,,,,,02/08/2018,02/08/2018,0.00,,15.71,,"-720,172.63"
,IN,AR,30321844,1005,100,,Invoice,,,,,,02/08/2018,02/08/2018,0.00,,11.70,,"-720,184.33"
,IN,AR,30321863,1005,100,,Invoice,,,,,,02/08/2018,02/08/2018,0.00,,2.58,,"-720,186.91"
,IN,AR,30321866,1005,100,,Invoice,,,,,,02/08/2018,02/08/2018,0.00,,5.97,,"-720,192.88"
,IN,AR,30321867,1005,100,,Invoice,,,,,,02/08/2018,02/08/2018,0.00,,15.93,,"-720,208.81"
,IN,AR,30321868,1005,100,,Invoice,,,,,,02/08/2018,02/08/2018,0.00,,11.95,,"-720,220.76"
,IN,AR,30321869,1005,100,,Invoice,,,,,,02/08/2018,02/08/2018,0.00,,25.89,,"-720,246.65"
,IN,AR,30321871,1005,100,,Invoice,,,,,,02/08/2018,02/08/2018,0.00,,15.90,,"-720,262.55"
,IN,AR,30321889,1005,100,,Invoice,,,,,,02/08/2018,02/08/2018,0.00,,14.58,,"-720,277.13"
,IN,AR,30321890,1005,100,,Invoice,,,,,,02/08/2018,02/08/2018,0.00,,205.92,,"-720,483.05"
,IN,AR,30321901,1005,100,,Invoice,,,,,,02/08/2018,02/08/2018,0.00,,3.64,,"-720,486.69"
,IN,AR,30321905,1005,100,,Invoice,,,,,,02/08/2018,02/08/2018,0.00,,5.93,,"-720,492.62"
,IN,AR,30321920,1005,100,,Invoice,,,,,,02/08/2018,02/08/2018,0.00,,6.56,,"-720,499.18"
,IN,AR,30321927,1005,100,,Invoice,,,,,,02/08/2018,02/08/2018,0.00,,8.90,,"-720,508.08"
,IN,AR,30321934,1005,100,,Invoice,,,,,,02/08/2018,02/08/2018,0.00,,20.01,,"-720,528.09"
,IN,AR,30321936,1005,100,,Invoice,,,,,,02/08/2018,02/08/2018,0.00,,14.00,,"-720,542.09"
,IN,AR,30321938,1005,100,,Invoice,,,,,,02/08/2018,02/08/2018,0.00,,26.01,,"-720,568.10"
,IN,AR,30321943,1005,100,,Invoice,,,,,,02/08/2018,02/08/2018,0.00,,14.58,,"-720,582.68"
,IN,AR,30321944,1005,100,,Invoice,,,,,,02/08/2018,02/08/2018,0.00,,11.66,,"-720,594.34"
,IN,AR,30321954,1005,100,,Invoice,,,,,,02/08/2018,02/08/2018,0.00,,27.33,,"-720,621.67"
,IN,AR,30321955,1005,100,,Invoice,,,,,,02/08/2018,02/08/2018,0.00,,10.52,,"-720,632.19"
,IN,AR,30321963,1005,100,,Invoice,,,,,,02/08/2018,02/08/2018,0.00,,14.58,,"-720,646.77"
,IN,AR,30321968,1005,100,,Invoice,,,,,,02/08/2018,02/08/2018,0.00,,25.51,,"-720,672.28"
,IN,AR,30321973,1005,100,,Invoice,,,,,,02/08/2018,02/08/2018,0.00,,11.22,,"-720,683.50"
,IN,AR,30321978,1005,100,,Invoice,,,,,,02/08/2018,02/08/2018,0.00,,25.17,,"-720,708.67"
,IN,AR,30321996,1005,100,,Invoice,,,,,,02/08/2018,02/08/2018,0.00,,14.58,,"-720,723.25"
,IN,AR,30321997,1005,100,,Invoice,,,,,,02/08/2018,02/08/2018,0.00,,25.51,,"-720,748.76"
,IN,AR,30322003,1005,100,,Invoice,,,,,,02/08/2018,02/08/2018,0.00,,81.15,,"-720,829.91"
,IN,AR,30322005,1005,100,,Invoice,,,,,,02/08/2018,02/08/2018,0.00,,3.19,,"-720,833.10"
,IN,AR,30322006,1005,100,,Invoice,,,,,,02/08/2018,02/08/2018,0.00,,109.93,,"-720,943.03"
,IN,AR,30322007,1005,100,,Invoice,,,,,,02/08/2018,02/08/2018,0.00,,19.12,,"-720,962.15"
,IN,AR,30322049,1005,100,,Invoice,,,,,,02/08/2018,02/08/2018,0.00,,30.51,,"-720,992.66"
,IN,AR,30322082,1005,100,,Invoice,,,,,,02/08/2018,02/08/2018,0.00,,29.15,,"-721,021.81"
,IN,AR,30322092,1005,100,,Invoice,,,,,,02/08/2018,02/08/2018,0.00,,5.86,,"-721,027.67"
,IN,AR,30322097,1005,100,,Invoice,,,,,,02/08/2018,02/08/2018,0.00,,10.47,,"-721,038.14"
,IN,AR,30322102,1005,100,,Invoice,,,,,,02/08/2018,02/08/2018,0.00,,16.34,,"-721,054.48"
,IN,AR,30322127,1005,100,,Invoice,,,,,,02/08/2018,02/08/2018,0.00,,3.64,,"-721,058.12"
,IN,AR,30322135,1005,100,,Invoice,,,,,,02/08/2018,02/08/2018,0.00,,26.99,,"-721,085.11"
,IN,AR,30322136,1005,100,,Invoice,,,,,,02/08/2018,02/08/2018,0.00,,2.08,,"-721,087.19"
,IN,AR,30322137,1005,100,,Invoice,,,,,,02/08/2018,02/08/2018,0.00,,4.15,,"-721,091.34"
,IN,AR,30322138,1005,100,,Invoice,,,,,,02/08/2018,02/08/2018,0.00,,4.15,,"-721,095.49"
,IN,AR,30322153,1005,100,,Invoice,,,,,,02/08/2018,02/08/2018,0.00,,18.22,,"-721,113.71"
,IN,AR,30322174,1005,100,,Invoice,,,,,,02/08/2018,02/08/2018,0.00,,675.00,,"-721,788.71"
,IN,AR,30322181,1005,100,,Invoice,,,,,,02/08/2018,02/08/2018,0.00,,13.73,,"-721,802.44"
,IN,AR,30322183,1005,100,,Invoice,,,,,,02/08/2018,02/08/2018,0.00,,31.54,,"-721,833.98"
,IN,AR,30322195,1005,100,,Invoice,,,,,,02/08/2018,02/08/2018,0.00,,692.37,,"-722,526.35"
,IN,AR,30331724,1005,100,,Invoice,,,,,,02/08/2018,02/08/2018,0.00,,12.71,,"-722,539.06"
,CS,AR,32007060,1005,100,,Cash sale,,,,,,03/08/2018,03/08/2018,0.00,,11.22,,"-722,550.28"
,CS,AR,32007062,1005,100,,Cash sale,,,,,,03/08/2018,03/08/2018,0.00,,10.93,,"-722,561.21"
,CS,AR,32007064,1005,100,,Cash sale,,,,,,03/08/2018,03/08/2018,0.00,,11.86,,"-722,573.07"
,CS,AR,32007067,1005,100,,Cash sale,,,,,,03/08/2018,03/08/2018,0.00,,11.36,,"-722,584.43"
,CS,AR,32007068,1005,100,,Cash sale,,,,,,03/08/2018,03/08/2018,0.00,,6.08,,"-722,590.51"
,CS,AR,32007079,1005,100,,Cash sale,,,,,,03/08/2018,03/08/2018,0.00,,10.93,,"-722,601.44"
,CS,AR,32007081,1005,100,,Cash sale,,,,,,03/08/2018,03/08/2018,0.00,,3.64,,"-722,605.08"
,CS,AR,32007089,1005,100,,Cash sale,,,,,,03/08/2018,03/08/2018,0.00,,12.08,,"-722,617.16"
,CS,AR,32007095,1005,100,,Cash sale,,,,,,03/08/2018,03/08/2018,0.00,,14.58,,"-722,631.74"
,CS,AR,32007100,1005,100,,Cash sale,,,,,,03/08/2018,03/08/2018,0.00,,3.64,,"-722,635.38"
,CS,AR,32007108,1005,100,,Cash sale,,,,,,03/08/2018,03/08/2018,0.00,,7.29,,"-722,642.67"
,CS,AR,32007110,1005,100,,Cash sale,,,,,,03/08/2018,03/08/2018,0.00,,25.87,,"-722,668.54"
,CS,AR,32007118,1005,100,,Cash sale,,,,,,03/08/2018,03/08/2018,0.00,,10.93,,"-722,679.47"
,CS,AR,32007125,1005,100,,Cash sale,,,,,,03/08/2018,03/08/2018,0.00,,7.29,,"-722,686.76"
,CS,AR,32007130,1005,100,,Cash sale,,,,,,03/08/2018,03/08/2018,0.00,,36.44,,"-722,723.20"
,CS,AR,32007131,1005,100,,Cash sale,,,,,,03/08/2018,03/08/2018,0.00,,2.58,,"-722,725.78"
,CS,AR,32007133,1005,100,,Cash sale,,,,,,03/08/2018,03/08/2018,0.00,,15.25,,"-722,741.03"
,CS,AR,32007140,1005,100,,Cash sale,,,,,,03/08/2018,03/08/2018,0.00,,3.64,,"-722,744.67"
,CS,AR,32007142,1005,100,,Cash sale,,,,,,03/08/2018,03/08/2018,0.00,,71.44,,"-722,816.11"
,CS,AR,32007148,1005,100,,Cash sale,,,,,,03/08/2018,03/08/2018,0.00,,10.93,,"-722,827.04"
,CS,AR,32007150,1005,100,,Cash sale,,,,,,03/08/2018,03/08/2018,0.00,,6.02,,"-722,833.06"
,CS,AR,32007151,1005,100,,Cash sale,,,,,,03/08/2018,03/08/2018,0.00,,21.06,,"-722,854.12"
,CS,AR,32007156,1005,100,,Cash sale,,,,,,03/08/2018,03/08/2018,0.00,,7.63,,"-722,861.75"
,CS,AR,32007159,1005,100,,Cash sale,,,,,,03/08/2018,03/08/2018,0.00,,18.09,,"-722,879.84"
,CS,AR,32007163,1005,100,,Cash sale,,,,,,03/08/2018,03/08/2018,0.00,,12.25,,"-722,892.09"
,CS,AR,32007170,1005,100,,Cash sale,,,,,,03/08/2018,03/08/2018,0.00,,3.64,,"-722,895.73"
,CS,AR,32007171,1005,100,,Cash sale,,,,,,03/08/2018,03/08/2018,0.00,,22.88,,"-722,918.61"
,CS,AR,32007177,1005,100,,Cash sale,,,,,,03/08/2018,03/08/2018,0.00,,7.29,,"-722,925.90"
,CS,AR,32007187,1005,100,,Cash sale,,,,,,03/08/2018,03/08/2018,0.00,,10.34,,"-722,936.24"
,CS,AR,32007194,1005,100,,Cash sale,,,,,,03/08/2018,03/08/2018,0.00,,18.22,,"-722,954.46"
,CS,AR,32007199,1005,100,,Cash sale,,,,,,03/08/2018,03/08/2018,0.00,,23.41,,"-722,977.87"
,CS,AR,32007202,1005,100,,Cash sale,,,,,,03/08/2018,03/08/2018,0.00,,10.93,,"-722,988.80"
,CS,AR,32007204,1005,100,,Cash sale,,,,,,03/08/2018,03/08/2018,0.00,,23.26,,"-723,012.06"
,CS,AR,32007208,1005,100,,Cash sale,,,,,,03/08/2018,03/08/2018,0.00,,12.92,,"-723,024.98"
,CS,AR,32007223,1005,100,,Cash sale,,,,,,03/08/2018,03/08/2018,0.00,,9.03,,"-723,034.01"
,CS,AR,32007226,1005,100,,Cash sale,,,,,,03/08/2018,03/08/2018,0.00,,7.29,,"-723,041.30"
,CS,AR,32007230,1005,100,,Cash sale,,,,,,03/08/2018,03/08/2018,0.00,,34.00,,"-723,075.30"
,CS,AR,32007232,1005,100,,Cash sale,,,,,,03/08/2018,03/08/2018,0.00,,7.29,,"-723,082.59"
,CS,AR,32007234,1005,100,,Cash sale,,,,,,03/08/2018,03/08/2018,0.00,,12.03,,"-723,094.62"
,CS,AR,32007239,1005,100,,Cash sale,,,,,,03/08/2018,03/08/2018,0.00,,17.80,,"-723,112.42"
,CS,AR,32007242,1005,100,,Cash sale,,,,,,03/08/2018,03/08/2018,0.00,,4.58,,"-723,117.00"
,CS,AR,32007245,1005,100,,Cash sale,,,,,,03/08/2018,03/08/2018,0.00,,5.93,,"-723,122.93"
,CS,AR,32007261,1005,100,,Cash sale,,,,,,03/08/2018,03/08/2018,0.00,,24.29,,"-723,147.22"
,CS,AR,32007264,1005,100,,Cash sale,,,,,,03/08/2018,03/08/2018,0.00,,3.64,,"-723,150.86"
,CS,AR,32007265,1005,100,,Cash sale,,,,,,03/08/2018,03/08/2018,0.00,,5.47,,"-723,156.33"
,CS,AR,32007267,1005,100,,Cash sale,,,,,,03/08/2018,03/08/2018,0.00,,7.29,,"-723,163.62"
,CS,AR,32007269,1005,100,,Cash sale,,,,,,03/08/2018,03/08/2018,0.00,,3.64,,"-723,167.26"
,CS,AR,32007271,1005,100,,Cash sale,,,,,,03/08/2018,03/08/2018,0.00,,6.10,,"-723,173.36"
,CS,AR,32007273,1005,100,,Cash sale,,,,,,03/08/2018,03/08/2018,0.00,,4.15,,"-723,177.51"
,CS,AR,32007278,1005,100,,Cash sale,,,,,,03/08/2018,03/08/2018,0.00,,21.86,,"-723,199.37"
,CS,AR,32007280,1005,100,,Cash sale,,,,,,03/08/2018,03/08/2018,0.00,,10.93,,"-723,210.30"
,CS,AR,32007287,1005,100,,Cash sale,,,,,,03/08/2018,03/08/2018,0.00,,10.93,,"-723,221.23"
,CS,AR,32007300,1005,100,,Cash sale,,,,,,03/08/2018,03/08/2018,0.00,,6.02,,"-723,227.25"
,CS,AR,32007303,1005,100,,Cash sale,,,,,,03/08/2018,03/08/2018,0.00,,7.29,,"-723,234.54"
,CS,AR,32007319,1005,100,,Cash sale,,,,,,03/08/2018,03/08/2018,0.00,,9.32,,"-723,243.86"
,CS,AR,32007322,1005,100,,Cash sale,,,,,,03/08/2018,03/08/2018,0.00,,6.07,,"-723,249.93"
,CS,AR,32007332,1005,100,,Cash sale,,,,,,03/08/2018,03/08/2018,0.00,,18.22,,"-723,268.15"
,CS,AR,32007335,1005,100,,Cash sale,,,,,,03/08/2018,03/08/2018,0.00,,14.58,,"-723,282.73"
,IN,AR,30321438,1005,100,,Invoice,,,,,,03/08/2018,03/08/2018,0.00,,11.86,,"-723,294.59"
,IN,AR,30321439,1005,100,,Invoice,,,,,,03/08/2018,03/08/2018,0.00,,56.36,,"-723,350.95"
,IN,AR,30321441,1005,100,,Invoice,,,,,,03/08/2018,03/08/2018,0.00,,51.02,,"-723,401.97"
,IN,AR,30321445,1005,100,,Invoice,,,,,,03/08/2018,03/08/2018,0.00,,16.78,,"-723,418.75"
,IN,AR,30321459,1005,100,,Invoice,,,,,,03/08/2018,03/08/2018,0.00,,25.51,,"-723,444.26"
,IN,AR,30321470,1005,100,,Invoice,,,,,,03/08/2018,03/08/2018,0.00,,14.49,,"-723,458.75"
,IN,AR,30321481,1005,100,,Invoice,,,,,,03/08/2018,03/08/2018,0.00,,18.37,,"-723,477.12"
,IN,AR,30321483,1005,100,,Invoice,,,,,,03/08/2018,03/08/2018,0.00,,116.44,,"-723,593.56"
,IN,AR,30321489,1005,100,,Invoice,,,,,,03/08/2018,03/08/2018,0.00,,45.08,,"-723,638.64"
,IN,AR,30321498,1005,100,,Invoice,,,,,,03/08/2018,03/08/2018,0.00,,14.58,,"-723,653.22"
,IN,AR,30321507,1005,100,,Invoice,,,,,,03/08/2018,03/08/2018,0.00,,48.00,,"-723,701.22"
,IN,AR,30321521,1005,100,,Invoice,,,,,,03/08/2018,03/08/2018,0.00,,11.68,,"-723,712.90"
,IN,AR,30321526,1005,100,,Invoice,,,,,,03/08/2018,03/08/2018,0.00,,4.75,,"-723,717.65"
,IN,AR,30321528,1005,100,,Invoice,,,,,,03/08/2018,03/08/2018,0.00,,24.00,,"-723,741.65"
,IN,AR,30321544,1005,100,,Invoice,,,,,,03/08/2018,03/08/2018,0.00,,11.64,,"-723,753.29"
,IN,AR,30321545,1005,100,,Invoice,,,,,,03/08/2018,03/08/2018,0.00,,5.82,,"-723,759.11"
,IN,AR,30321547,1005,100,,Invoice,,,,,,03/08/2018,03/08/2018,0.00,,48.00,,"-723,807.11"
,IN,AR,30321553,1005,100,,Invoice,,,,,,03/08/2018,03/08/2018,0.00,,36.44,,"-723,843.55"
,IN,AR,30321554,1005,100,,Invoice,,,,,,03/08/2018,03/08/2018,0.00,,13.98,,"-723,857.53"
,IN,AR,30321555,1005,100,,Invoice,,,,,,03/08/2018,03/08/2018,0.00,,6.02,,"-723,863.55"
,IN,AR,30321563,1005,100,,Invoice,,,,,,03/08/2018,03/08/2018,0.00,,218.64,,"-724,082.19"
,IN,AR,30321565,1005,100,,Invoice,,,,,,03/08/2018,03/08/2018,0.00,,4.78,,"-724,086.97"
,IN,AR,30321571,1005,100,,Invoice,,,,,,03/08/2018,03/08/2018,0.00,,5.17,,"-724,092.14"
,IN,AR,30321576,1005,100,,Invoice,,,,,,03/08/2018,03/08/2018,0.00,,7.19,,"-724,099.33"
,IN,AR,30321580,1005,100,,Invoice,,,,,,03/08/2018,03/08/2018,0.00,,25.51,,"-724,124.84"
,IN,AR,30321599,1005,100,,Invoice,,,,,,03/08/2018,03/08/2018,0.00,,33.60,,"-724,158.44"
,IN,AR,30321601,1005,100,,Invoice,,,,,,03/08/2018,03/08/2018,0.00,,9.56,,"-724,168.00"
,IN,AR,30321609,1005,100,,Invoice,,,,,,03/08/2018,03/08/2018,0.00,,40.63,,"-724,208.63"
,IN,AR,30321617,1005,100,,Invoice,,,,,,03/08/2018,03/08/2018,0.00,,67.68,,"-724,276.31"
,IN,AR,30321627,1005,100,,Invoice,,,,,,03/08/2018,03/08/2018,0.00,,28.68,,"-724,304.99"
,IN,AR,30321640,1005,100,,Invoice,,,,,,03/08/2018,03/08/2018,0.00,,7.29,,"-724,312.28"
,IN,AR,30321676,1005,100,,Invoice,,,,,,03/08/2018,03/08/2018,0.00,,2.39,,"-724,314.67"
,IN,AR,30321681,1005,100,,Invoice,,,,,,03/08/2018,03/08/2018,0.00,,10.17,,"-724,324.84"
,IN,AR,30321682,1005,100,,Invoice,,,,,,03/08/2018,03/08/2018,0.00,,5.08,,"-724,329.92"
,IN,AR,30321687,1005,100,,Invoice,,,,,,03/08/2018,03/08/2018,0.00,,7.63,,"-724,337.55"
,IN,AR,30321689,1005,100,,Invoice,,,,,,03/08/2018,03/08/2018,0.00,,14.62,,"-724,352.17"
,IN,AR,30321729,1005,100,,Invoice,,,,,,03/08/2018,03/08/2018,0.00,,20.34,,"-724,372.51"
,IN,AR,30321731,1005,100,,Invoice,,,,,,03/08/2018,03/08/2018,0.00,,12.71,,"-724,385.22"
,IN,AR,30321732,1005,100,,Invoice,,,,,,03/08/2018,03/08/2018,0.00,,27.54,,"-724,412.76"
,IN,AR,30321735,1005,100,,Invoice,,,,,,03/08/2018,03/08/2018,0.00,,7.29,,"-724,420.05"
,IN,AR,30321753,1005,100,,Invoice,,,,,,03/08/2018,03/08/2018,0.00,,12.71,,"-724,432.76"
,IN,AR,30321761,1005,100,,Invoice,,,,,,03/08/2018,03/08/2018,0.00,,28.05,,"-724,460.81"
,IN,AR,30321771,1005,100,,Invoice,,,,,,03/08/2018,03/08/2018,0.00,,18.22,,"-724,479.03"
,IN,AR,30321782,1005,100,,Invoice,,,,,,03/08/2018,03/08/2018,0.00,,4.24,,"-724,483.27"
,IN,AR,30321801,1005,100,,Invoice,,,,,,03/08/2018,03/08/2018,0.00,,5.17,,"-724,488.44"
,IN,AR,30321820,1005,100,,Invoice,,,,,,03/08/2018,03/08/2018,0.00,,21.86,,"-724,510.30"
,IN,AR,30321835,1005,100,,Invoice,,,,,,03/08/2018,03/08/2018,0.00,,2.42,,"-724,512.72"
,IN,AR,30321836,1005,100,,Invoice,,,,,,03/08/2018,03/08/2018,0.00,,8.01,,"-724,520.73"
,IN,AR,30321838,1005,100,,Invoice,,,,,,03/08/2018,03/08/2018,0.00,,51.02,,"-724,571.75"
,IN,AR,30321851,1005,100,,Invoice,,,,,,03/08/2018,03/08/2018,0.00,,21.86,,"-724,593.61"
,IN,AR,30321872,1005,100,,Invoice,,,,,,03/08/2018,03/08/2018,0.00,,23.85,,"-724,617.46"
,IN,AR,30321880,1005,100,,Invoice,,,,,,03/08/2018,03/08/2018,0.00,,48.26,,"-724,665.72"
,IN,AR,30321887,1005,100,,Invoice,,,,,,03/08/2018,03/08/2018,0.00,,15.71,,"-724,681.43"
,IN,AR,30321892,1005,100,,Invoice,,,,,,03/08/2018,03/08/2018,0.00,,7.29,,"-724,688.72"
,IN,AR,30321894,1005,100,,Invoice,,,,,,03/08/2018,03/08/2018,0.00,,18.04,,"-724,706.76"
,IN,AR,30321899,1005,100,,Invoice,,,,,,03/08/2018,03/08/2018,0.00,,32.80,,"-724,739.56"
,IN,AR,30321903,1005,100,,Invoice,,,,,,03/08/2018,03/08/2018,0.00,,30.36,,"-724,769.92"
,IN,AR,30321907,1005,100,,Invoice,,,,,,03/08/2018,03/08/2018,0.00,,8.64,,"-724,778.56"
,IN,AR,30321909,1005,100,,Invoice,,,,,,03/08/2018,03/08/2018,0.00,,16.95,,"-724,795.51"
,IN,AR,30321912,1005,100,,Invoice,,,,,,03/08/2018,03/08/2018,0.00,,14.58,,"-724,810.09"
,IN,AR,30321915,1005,100,,Invoice,,,,,,03/08/2018,03/08/2018,0.00,,7.29,,"-724,817.38"
,IN,AR,30321916,1005,100,,Invoice,,,,,,03/08/2018,03/08/2018,0.00,,52.54,,"-724,869.92"
,IN,AR,30321923,1005,100,,Invoice,,,,,,03/08/2018,03/08/2018,0.00,,364.41,,"-725,234.33"
,IN,AR,30321925,1005,100,,Invoice,,,,,,03/08/2018,03/08/2018,0.00,,28.69,,"-725,263.02"
,IN,AR,30321930,1005,100,,Invoice,,,,,,03/08/2018,03/08/2018,0.00,,25.42,,"-725,288.44"
,IN,AR,30321931,1005,100,,Invoice,,,,,,03/08/2018,03/08/2018,0.00,,35.59,,"-725,324.03"
,IN,AR,30321939,1005,100,,Invoice,,,,,,03/08/2018,03/08/2018,0.00,,22.01,,"-725,346.04"
,IN,AR,30321941,1005,100,,Invoice,,,,,,03/08/2018,03/08/2018,0.00,,26.01,,"-725,372.05"
,IN,AR,30321951,1005,100,,Invoice,,,,,,03/08/2018,03/08/2018,0.00,,41.06,,"-725,413.11"
,IN,AR,30321956,1005,100,,Invoice,,,,,,03/08/2018,03/08/2018,0.00,,60.97,,"-725,474.08"
,IN,AR,30321967,1005,100,,Invoice,,,,,,03/08/2018,03/08/2018,0.00,,14.58,,"-725,488.66"
,IN,AR,30321976,1005,100,,Invoice,,,,,,03/08/2018,03/08/2018,0.00,,9.19,,"-725,497.85"
,IN,AR,30321977,1005,100,,Invoice,,,,,,03/08/2018,03/08/2018,0.00,,7.29,,"-725,505.14"
,IN,AR,30321984,1005,100,,Invoice,,,,,,03/08/2018,03/08/2018,0.00,,12.14,,"-725,517.28"
,IN,AR,30322000,1005,100,,Invoice,,,,,,03/08/2018,03/08/2018,0.00,,17.03,,"-725,534.31"
,IN,AR,30322001,1005,100,,Invoice,,,,,,03/08/2018,03/08/2018,0.00,,19.32,,"-725,553.63"
,IN,AR,30322011,1005,100,,Invoice,,,,,,03/08/2018,03/08/2018,0.00,,132.88,,"-725,686.51"
,IN,AR,30322055,1005,100,,Invoice,,,,,,03/08/2018,03/08/2018,0.00,,12.00,,"-725,698.51"
,IN,AR,30322071,1005,100,,Invoice,,,,,,03/08/2018,03/08/2018,0.00,,29.15,,"-725,727.66"
,IN,AR,30322077,1005,100,,Invoice,,,,,,03/08/2018,03/08/2018,0.00,,8.75,,"-725,736.41"
,IN,AR,30322079,1005,100,,Invoice,,,,,,03/08/2018,03/08/2018,0.00,,54.66,,"-725,791.07"
,IN,AR,30322080,1005,100,,Invoice,,,,,,03/08/2018,03/08/2018,0.00,,16.42,,"-725,807.49"
,IN,AR,30322083,1005,100,,Invoice,,,,,,03/08/2018,03/08/2018,0.00,,31.78,,"-725,839.27"
,IN,AR,30322086,1005,100,,Invoice,,,,,,03/08/2018,03/08/2018,0.00,,54.66,,"-725,893.93"
,IN,AR,30322091,1005,100,,Invoice,,,,,,03/08/2018,03/08/2018,0.00,,72.88,,"-725,966.81"
,IN,AR,30322095,1005,100,,Invoice,,,,,,03/08/2018,03/08/2018,0.00,,5.93,,"-725,972.74"
,IN,AR,30322100,1005,100,,Invoice,,,,,,03/08/2018,03/08/2018,0.00,,6.13,,"-725,978.87"
,IN,AR,30322109,1005,100,,Invoice,,,,,,03/08/2018,03/08/2018,0.00,,3.98,,"-725,982.85"
,IN,AR,30322123,1005,100,,Invoice,,,,,,03/08/2018,03/08/2018,0.00,,15.18,,"-725,998.03"
,IN,AR,30322126,1005,100,,Invoice,,,,,,03/08/2018,03/08/2018,0.00,,364.41,,"-726,362.44"
,IN,AR,30322128,1005,100,,Invoice,,,,,,03/08/2018,03/08/2018,0.00,,4.00,,"-726,366.44"
,IN,AR,30322129,1005,100,,Invoice,,,,,,03/08/2018,03/08/2018,0.00,,2.00,,"-726,368.44"
,IN,AR,30322139,1005,100,,Invoice,,,,,,03/08/2018,03/08/2018,0.00,,12.46,,"-726,380.90"
,IN,AR,30322155,1005,100,,Invoice,,,,,,03/08/2018,03/08/2018,0.00,,7.29,,"-726,388.19"
,IN,AR,30322156,1005,100,,Invoice,,,,,,03/08/2018,03/08/2018,0.00,,17.20,,"-726,405.39"
,IN,AR,30322157,1005,100,,Invoice,,,,,,03/08/2018,03/08/2018,0.00,,32.57,,"-726,437.96"
,IN,AR,30322159,1005,100,,Invoice,,,,,,03/08/2018,03/08/2018,0.00,,21.86,,"-726,459.82"
,IN,AR,30322162,1005,100,,Invoice,,,,,,03/08/2018,03/08/2018,0.00,,2.03,,"-726,461.85"
,IN,AR,30322171,1005,100,,Invoice,,,,,,03/08/2018,03/08/2018,0.00,,7.29,,"-726,469.14"
,IN,AR,30322175,1005,100,,Invoice,,,,,,03/08/2018,03/08/2018,0.00,,200.00,,"-726,669.14"
,IN,AR,30322176,1005,100,,Invoice,,,,,,03/08/2018,03/08/2018,0.00,,597.50,,"-727,266.64"
,IN,AR,30322186,1005,100,,Invoice,,,,,,03/08/2018,03/08/2018,0.00,,7.29,,"-727,273.93"
,IN,AR,30322187,1005,100,,Invoice,,,,,,03/08/2018,03/08/2018,0.00,,9.10,,"-727,283.03"
,IN,AR,30322193,1005,100,,Invoice,,,,,,03/08/2018,03/08/2018,0.00,,29.15,,"-727,312.18"
,IN,AR,30322200,1005,100,,Invoice,,,,,,03/08/2018,03/08/2018,0.00,,29.15,,"-727,341.33"
,IN,AR,30322202,1005,100,,Invoice,,,,,,03/08/2018,03/08/2018,0.00,,364.41,,"-727,705.74"
,CN,AR,31018543,1005,100,,Credit Note,,,,,,04/08/2018,04/08/2018,54.66,,0.00,,"-727,651.08"
,CS,AR,32007102,1005,100,,Cash sale,,,,,,04/08/2018,04/08/2018,0.00,,14.58,,"-727,665.66"
,CS,AR,32007107,1005,100,,Cash sale,,,,,,04/08/2018,04/08/2018,0.00,,7.29,,"-727,672.95"
,CS,AR,32007109,1005,100,,Cash sale,,,,,,04/08/2018,04/08/2018,0.00,,10.93,,"-727,683.88"
,CS,AR,32007119,1005,100,,Cash sale,,,,,,04/08/2018,04/08/2018,0.00,,7.29,,"-727,691.17"
,CS,AR,32007123,1005,100,,Cash sale,,,,,,04/08/2018,04/08/2018,0.00,,10.93,,"-727,702.10"
,CS,AR,32007128,1005,100,,Cash sale,,,,,,04/08/2018,04/08/2018,0.00,,6.02,,"-727,708.12"
,CS,AR,32007167,1005,100,,Cash sale,,,,,,04/08/2018,04/08/2018,0.00,,7.29,,"-727,715.41"
,CS,AR,32007209,1005,100,,Cash sale,,,,,,04/08/2018,04/08/2018,0.00,,12.17,,"-727,727.58"
,CS,AR,32007216,1005,100,,Cash sale,,,,,,04/08/2018,04/08/2018,0.00,,10.93,,"-727,738.51"
,CS,AR,32007220,1005,100,,Cash sale,,,,,,04/08/2018,04/08/2018,0.00,,7.29,,"-727,745.80"
,CS,AR,32007258,1005,100,,Cash sale,,,,,,04/08/2018,04/08/2018,0.00,,25.51,,"-727,771.31"
,CS,AR,32007292,1005,100,,Cash sale,,,,,,04/08/2018,04/08/2018,0.00,,8.75,,"-727,780.06"
,CS,AR,32007324,1005,100,,Cash sale,,,,,,04/08/2018,04/08/2018,0.00,,7.29,,"-727,787.35"
,IN,AR,30321474,1005,100,,Invoice,,,,,,04/08/2018,04/08/2018,0.00,,364.41,,"-728,151.76"
,IN,AR,30321490,1005,100,,Invoice,,,,,,04/08/2018,04/08/2018,0.00,,85.42,,"-728,237.18"
,IN,AR,30321520,1005,100,,Invoice,,,,,,04/08/2018,04/08/2018,0.00,,"3,644.07",,"-731,881.25"
,IN,AR,30321538,1005,100,,Invoice,,,,,,04/08/2018,04/08/2018,0.00,,"1,093.22",,"-732,974.47"
,IN,AR,30321549,1005,100,,Invoice,,,,,,04/08/2018,04/08/2018,0.00,,3.64,,"-732,978.11"
,IN,AR,30321613,1005,100,,Invoice,,,,,,04/08/2018,04/08/2018,0.00,,609.65,,"-733,587.76"
,IN,AR,30321683,1005,100,,Invoice,,,,,,04/08/2018,04/08/2018,0.00,,15.25,,"-733,603.01"
,IN,AR,30321743,1005,100,,Invoice,,,,,,04/08/2018,04/08/2018,0.00,,364.41,,"-733,967.42"
,IN,AR,30321744,1005,100,,Invoice,,,,,,04/08/2018,04/08/2018,0.00,,364.41,,"-734,331.83"
,IN,AR,30321792,1005,100,,Invoice,,,,,,04/08/2018,04/08/2018,0.00,,546.61,,"-734,878.44"
,IN,AR,30321795,1005,100,,Invoice,,,,,,04/08/2018,04/08/2018,0.00,,364.41,,"-735,242.85"
,IN,AR,30321848,1005,100,,Invoice,,,,,,04/08/2018,04/08/2018,0.00,,546.61,,"-735,789.46"
,IN,AR,30321957,1005,100,,Invoice,,,,,,04/08/2018,04/08/2018,0.00,,6.31,,"-735,795.77"
,IN,AR,30321966,1005,100,,Invoice,,,,,,04/08/2018,04/08/2018,0.00,,"1,093.22",,"-736,888.99"
,IN,AR,30322047,1005,100,,Invoice,,,,,,04/08/2018,04/08/2018,0.00,,18.22,,"-736,907.21"
,IN,AR,30322078,1005,100,,Invoice,,,,,,04/08/2018,04/08/2018,0.00,,8.25,,"-736,915.46"
,IN,AR,30322093,1005,100,,Invoice,,,,,,04/08/2018,04/08/2018,0.00,,10.93,,"-736,926.39"
,IN,AR,30322125,1005,100,,Invoice,,,,,,04/08/2018,04/08/2018,0.00,,10.93,,"-736,937.32"
,IN,AR,30322131,1005,100,,Invoice,,,,,,04/08/2018,04/08/2018,0.00,,54.66,,"-736,991.98"
,IN,AR,30322150,1005,100,,Invoice,,,,,,04/08/2018,04/08/2018,0.00,,54.66,,"-737,046.64"
,IN,AR,30322151,1005,100,,Invoice,,,,,,04/08/2018,04/08/2018,0.00,,182.20,,"-737,228.84"
,IN,AR,30322161,1005,100,,Invoice,,,,,,04/08/2018,04/08/2018,0.00,,10.93,,"-737,239.77"
,IN,AR,30322165,1005,100,,Invoice,,,,,,04/08/2018,04/08/2018,0.00,,7.29,,"-737,247.06"
,IN,AR,30322177,1005,100,,Invoice,,,,,,04/08/2018,04/08/2018,0.00,,590.00,,"-737,837.06"
,IN,AR,30322204,1005,100,,Invoice,,,,,,04/08/2018,04/08/2018,0.00,,10.93,,"-737,847.99"
,IN,AR,30321804,1005,100,,Invoice,,,,,,05/08/2018,05/08/2018,0.00,,29.15,,"-737,877.14"
,CN,AR,31018496,1005,100,,Credit Note,,,,,,06/08/2018,06/08/2018,2.03,,0.00,,"-737,875.11"
,CN,AR,31018497,1005,100,,Credit Note,,,,,,06/08/2018,06/08/2018,11.86,,0.00,,"-737,863.25"
,CN,AR,31018507,1005,100,,Credit Note,,,,,,06/08/2018,06/08/2018,40.08,,0.00,,"-737,823.17"
,CS,AR,32007061,1005,100,,Cash sale,,,,,,06/08/2018,06/08/2018,0.00,,19.64,,"-737,842.81"
,CS,AR,32007065,1005,100,,Cash sale,,,,,,06/08/2018,06/08/2018,0.00,,11.86,,"-737,854.67"
,CS,AR,32007071,1005,100,,Cash sale,,,,,,06/08/2018,06/08/2018,0.00,,7.29,,"-737,861.96"
,CS,AR,32007074,1005,100,,Cash sale,,,,,,06/08/2018,06/08/2018,0.00,,3.64,,"-737,865.60"
,CS,AR,32007076,1005,100,,Cash sale,,,,,,06/08/2018,06/08/2018,0.00,,7.29,,"-737,872.89"
,CS,AR,32007077,1005,100,,Cash sale,,,,,,06/08/2018,06/08/2018,0.00,,14.58,,"-737,887.47"
,CS,AR,32007085,1005,100,,Cash sale,,,,,,06/08/2018,06/08/2018,0.00,,3.64,,"-737,891.11"
,CS,AR,32007096,1005,100,,Cash sale,,,,,,06/08/2018,06/08/2018,0.00,,8.31,,"-737,899.42"
,CS,AR,32007099,1005,100,,Cash sale,,,,,,06/08/2018,06/08/2018,0.00,,14.58,,"-737,914.00"
,CS,AR,32007101,1005,100,,Cash sale,,,,,,06/08/2018,06/08/2018,0.00,,7.29,,"-737,921.29"
,CS,AR,32007103,1005,100,,Cash sale,,,,,,06/08/2018,06/08/2018,0.00,,7.29,,"-737,928.58"
,CS,AR,32007104,1005,100,,Cash sale,,,,,,06/08/2018,06/08/2018,0.00,,14.58,,"-737,943.16"
,CS,AR,32007116,1005,100,,Cash sale,,,,,,06/08/2018,06/08/2018,0.00,,3.64,,"-737,946.80"
,CS,AR,32007120,1005,100,,Cash sale,,,,,,06/08/2018,06/08/2018,0.00,,7.29,,"-737,954.09"
,CS,AR,32007121,1005,100,,Cash sale,,,,,,06/08/2018,06/08/2018,0.00,,10.34,,"-737,964.43"
,CS,AR,32007129,1005,100,,Cash sale,,,,,,06/08/2018,06/08/2018,0.00,,7.29,,"-737,971.72"
,CS,AR,32007134,1005,100,,Cash sale,,,,,,06/08/2018,06/08/2018,0.00,,7.63,,"-737,979.35"
,CS,AR,32007136,1005,100,,Cash sale,,,,,,06/08/2018,06/08/2018,0.00,,30.76,,"-738,010.11"
,CS,AR,32007144,1005,100,,Cash sale,,,,,,06/08/2018,06/08/2018,0.00,,21.98,,"-738,032.09"
,CS,AR,32007147,1005,100,,Cash sale,,,,,,06/08/2018,06/08/2018,0.00,,3.64,,"-738,035.73"
,CS,AR,32007149,1005,100,,Cash sale,,,,,,06/08/2018,06/08/2018,0.00,,10.93,,"-738,046.66"
,CS,AR,32007157,1005,100,,Cash sale,,,,,,06/08/2018,06/08/2018,0.00,,7.63,,"-738,054.29"
,CS,AR,32007158,1005,100,,Cash sale,,,,,,06/08/2018,06/08/2018,0.00,,29.24,,"-738,083.53"
,CS,AR,32007160,1005,100,,Cash sale,,,,,,06/08/2018,06/08/2018,0.00,,7.17,,"-738,090.70"
,CS,AR,32007161,1005,100,,Cash sale,,,,,,06/08/2018,06/08/2018,0.00,,60.17,,"-738,150.87"
,CS,AR,32007162,1005,100,,Cash sale,,,,,,06/08/2018,06/08/2018,0.00,,30.08,,"-738,180.95"
,CS,AR,32007175,1005,100,,Cash sale,,,,,,06/08/2018,06/08/2018,0.00,,7.29,,"-738,188.24"
,CS,AR,32007179,1005,100,,Cash sale,,,,,,06/08/2018,06/08/2018,0.00,,5.08,,"-738,193.32"
,CS,AR,32007188,1005,100,,Cash sale,,,,,,06/08/2018,06/08/2018,0.00,,2.58,,"-738,195.90"
,CS,AR,32007190,1005,100,,Cash sale,,,,,,06/08/2018,06/08/2018,0.00,,3.64,,"-738,199.54"
,CS,AR,32007192,1005,100,,Cash sale,,,,,,06/08/2018,06/08/2018,0.00,,10.93,,"-738,210.47"
,CS,AR,32007206,1005,100,,Cash sale,,,,,,06/08/2018,06/08/2018,0.00,,7.29,,"-738,217.76"
,CS,AR,32007210,1005,100,,Cash sale,,,,,,06/08/2018,06/08/2018,0.00,,3.04,,"-738,220.80"
,CS,AR,32007214,1005,100,,Cash sale,,,,,,06/08/2018,06/08/2018,0.00,,7.29,,"-738,228.09"
,CS,AR,32007222,1005,100,,Cash sale,,,,,,06/08/2018,06/08/2018,0.00,,15.25,,"-738,243.34"
,CS,AR,32007233,1005,100,,Cash sale,,,,,,06/08/2018,06/08/2018,0.00,,29.15,,"-738,272.49"
,CS,AR,32007235,1005,100,,Cash sale,,,,,,06/08/2018,06/08/2018,0.00,,10.93,,"-738,283.42"
,CS,AR,32007237,1005,100,,Cash sale,,,,,,06/08/2018,06/08/2018,0.00,,6.56,,"-738,289.98"
,CS,AR,32007238,1005,100,,Cash sale,,,,,,06/08/2018,06/08/2018,0.00,,3.64,,"-738,293.62"
,CS,AR,32007243,1005,100,,Cash sale,,,,,,06/08/2018,06/08/2018,0.00,,13.73,,"-738,307.35"
,CS,AR,32007244,1005,100,,Cash sale,,,,,,06/08/2018,06/08/2018,0.00,,10.93,,"-738,318.28"
,CS,AR,32007251,1005,100,,Cash sale,,,,,,06/08/2018,06/08/2018,0.00,,5.47,,"-738,323.75"
,CS,AR,32007262,1005,100,,Cash sale,,,,,,06/08/2018,06/08/2018,0.00,,18.21,,"-738,341.96"
,CS,AR,32007268,1005,100,,Cash sale,,,,,,06/08/2018,06/08/2018,0.00,,10.93,,"-738,352.89"
,CS,AR,32007277,1005,100,,Cash sale,,,,,,06/08/2018,06/08/2018,0.00,,10.93,,"-738,363.82"
,CS,AR,32007281,1005,100,,Cash sale,,,,,,06/08/2018,06/08/2018,0.00,,3.64,,"-738,367.46"
,CS,AR,32007282,1005,100,,Cash sale,,,,,,06/08/2018,06/08/2018,0.00,,3.28,,"-738,370.74"
,CS,AR,32007302,1005,100,,Cash sale,,,,,,06/08/2018,06/08/2018,0.00,,7.29,,"-738,378.03"
,CS,AR,32007320,1005,100,,Cash sale,,,,,,06/08/2018,06/08/2018,0.00,,9.32,,"-738,387.35"
,CS,AR,32007323,1005,100,,Cash sale,,,,,,06/08/2018,06/08/2018,0.00,,3.03,,"-738,390.38"
,CS,AR,32007325,1005,100,,Cash sale,,,,,,06/08/2018,06/08/2018,0.00,,7.29,,"-738,397.67"
,CS,AR,32007327,1005,100,,Cash sale,,,,,,06/08/2018,06/08/2018,0.00,,14.58,,"-738,412.25"
,IN,AR,30321433,1005,100,,Invoice,,,,,,06/08/2018,06/08/2018,0.00,,182.20,,"-738,594.45"
,IN,AR,30321440,1005,100,,Invoice,,,,,,06/08/2018,06/08/2018,0.00,,53.39,,"-738,647.84"
,IN,AR,30321443,1005,100,,Invoice,,,,,,06/08/2018,06/08/2018,0.00,,364.41,,"-739,012.25"
,IN,AR,30321444,1005,100,,Invoice,,,,,,06/08/2018,06/08/2018,0.00,,32.80,,"-739,045.05"
,IN,AR,30321450,1005,100,,Invoice,,,,,,06/08/2018,06/08/2018,0.00,,8.10,,"-739,053.15"
,IN,AR,30321451,1005,100,,Invoice,,,,,,06/08/2018,06/08/2018,0.00,,12.15,,"-739,065.30"
,IN,AR,30321452,1005,100,,Invoice,,,,,,06/08/2018,06/08/2018,0.00,,6.08,,"-739,071.38"
,IN,AR,30321453,1005,100,,Invoice,,,,,,06/08/2018,06/08/2018,0.00,,6.08,,"-739,077.46"
,IN,AR,30321454,1005,100,,Invoice,,,,,,06/08/2018,06/08/2018,0.00,,18.23,,"-739,095.69"
,IN,AR,30321455,1005,100,,Invoice,,,,,,06/08/2018,06/08/2018,0.00,,2.03,,"-739,097.72"
,IN,AR,30321456,1005,100,,Invoice,,,,,,06/08/2018,06/08/2018,0.00,,14.18,,"-739,111.90"
,IN,AR,30321461,1005,100,,Invoice,,,,,,06/08/2018,06/08/2018,0.00,,364.41,,"-739,476.31"
,IN,AR,30321467,1005,100,,Invoice,,,,,,06/08/2018,06/08/2018,0.00,,3.64,,"-739,479.95"
,IN,AR,30321475,1005,100,,Invoice,,,,,,06/08/2018,06/08/2018,0.00,,182.20,,"-739,662.15"
,IN,AR,30321476,1005,100,,Invoice,,,,,,06/08/2018,06/08/2018,0.00,,95.11,,"-739,757.26"
,IN,AR,30321491,1005,100,,Invoice,,,,,,06/08/2018,06/08/2018,0.00,,168.47,,"-739,925.73"
,IN,AR,30321494,1005,100,,Invoice,,,,,,06/08/2018,06/08/2018,0.00,,16.53,,"-739,942.26"
,IN,AR,30321496,1005,100,,Invoice,,,,,,06/08/2018,06/08/2018,0.00,,364.41,,"-740,306.67"
,IN,AR,30321500,1005,100,,Invoice,,,,,,06/08/2018,06/08/2018,0.00,,72.00,,"-740,378.67"
,IN,AR,30321501,1005,100,,Invoice,,,,,,06/08/2018,06/08/2018,0.00,,76.35,,"-740,455.02"
,IN,AR,30321505,1005,100,,Invoice,,,,,,06/08/2018,06/08/2018,0.00,,3.64,,"-740,458.66"
,IN,AR,30321508,1005,100,,Invoice,,,,,,06/08/2018,06/08/2018,0.00,,30.00,,"-740,488.66"
,IN,AR,30321509,1005,100,,Invoice,,,,,,06/08/2018,06/08/2018,0.00,,18.00,,"-740,506.66"
,IN,AR,30321510,1005,100,,Invoice,,,,,,06/08/2018,06/08/2018,0.00,,16.61,,"-740,523.27"
,IN,AR,30321512,1005,100,,Invoice,,,,,,06/08/2018,06/08/2018,0.00,,2.75,,"-740,526.02"
,IN,AR,30321513,1005,100,,Invoice,,,,,,06/08/2018,06/08/2018,0.00,,61.02,,"-740,587.04"
,IN,AR,30321514,1005,100,,Invoice,,,,,,06/08/2018,06/08/2018,0.00,,11.02,,"-740,598.06"
,IN,AR,30321519,1005,100,,Invoice,,,,,,06/08/2018,06/08/2018,0.00,,182.20,,"-740,780.26"
,IN,AR,30321522,1005,100,,Invoice,,,,,,06/08/2018,06/08/2018,0.00,,9.73,,"-740,789.99"
,IN,AR,30321524,1005,100,,Invoice,,,,,,06/08/2018,06/08/2018,0.00,,17.54,,"-740,807.53"
,IN,AR,30321529,1005,100,,Invoice,,,,,,06/08/2018,06/08/2018,0.00,,20.00,,"-740,827.53"
,IN,AR,30321530,1005,100,,Invoice,,,,,,06/08/2018,06/08/2018,0.00,,7.29,,"-740,834.82"
,IN,AR,30321531,1005,100,,Invoice,,,,,,06/08/2018,06/08/2018,0.00,,182.20,,"-741,017.02"
,IN,AR,30321532,1005,100,,Invoice,,,,,,06/08/2018,06/08/2018,0.00,,14.58,,"-741,031.60"
,IN,AR,30321548,1005,100,,Invoice,,,,,,06/08/2018,06/08/2018,0.00,,34.00,,"-741,065.60"
,IN,AR,30321550,1005,100,,Invoice,,,,,,06/08/2018,06/08/2018,0.00,,10.93,,"-741,076.53"
,IN,AR,30321557,1005,100,,Invoice,,,,,,06/08/2018,06/08/2018,0.00,,28.39,,"-741,104.92"
,IN,AR,30321559,1005,100,,Invoice,,,,,,06/08/2018,06/08/2018,0.00,,7.29,,"-741,112.21"
,IN,AR,30321560,1005,100,,Invoice,,,,,,06/08/2018,06/08/2018,0.00,,40.08,,"-741,152.29"
,IN,AR,30321564,1005,100,,Invoice,,,,,,06/08/2018,06/08/2018,0.00,,364.41,,"-741,516.70"
,IN,AR,30321567,1005,100,,Invoice,,,,,,06/08/2018,06/08/2018,0.00,,25.85,,"-741,542.55"
,IN,AR,30321572,1005,100,,Invoice,,,,,,06/08/2018,06/08/2018,0.00,,12.92,,"-741,555.47"
,IN,AR,30321573,1005,100,,Invoice,,,,,,06/08/2018,06/08/2018,0.00,,7.29,,"-741,562.76"
,IN,AR,30321577,1005,100,,Invoice,,,,,,06/08/2018,06/08/2018,0.00,,18.37,,"-741,581.13"
,IN,AR,30321590,1005,100,,Invoice,,,,,,06/08/2018,06/08/2018,0.00,,4.24,,"-741,585.37"
,IN,AR,30321597,1005,100,,Invoice,,,,,,06/08/2018,06/08/2018,0.00,,19.07,,"-741,604.44"
,IN,AR,30321600,1005,100,,Invoice,,,,,,06/08/2018,06/08/2018,0.00,,31.02,,"-741,635.46"
,IN,AR,30321603,1005,100,,Invoice,,,,,,06/08/2018,06/08/2018,0.00,,364.41,,"-741,999.87"
,IN,AR,30321604,1005,100,,Invoice,,,,,,06/08/2018,06/08/2018,0.00,,13.35,,"-742,013.22"
,IN,AR,30321608,1005,100,,Invoice,,,,,,06/08/2018,06/08/2018,0.00,,7.29,,"-742,020.51"
,IN,AR,30321618,1005,100,,Invoice,,,,,,06/08/2018,06/08/2018,0.00,,108.69,,"-742,129.20"
,IN,AR,30321622,1005,100,,Invoice,,,,,,06/08/2018,06/08/2018,0.00,,40.68,,"-742,169.88"
,IN,AR,30321628,1005,100,,Invoice,,,,,,06/08/2018,06/08/2018,0.00,,19.12,,"-742,189.00"
,IN,AR,30321630,1005,100,,Invoice,,,,,,06/08/2018,06/08/2018,0.00,,12.88,,"-742,201.88"
,IN,AR,30321631,1005,100,,Invoice,,,,,,06/08/2018,06/08/2018,0.00,,28.98,,"-742,230.86"
,IN,AR,30321633,1005,100,,Invoice,,,,,,06/08/2018,06/08/2018,0.00,,24.07,,"-742,254.93"
,IN,AR,30321641,1005,100,,Invoice,,,,,,06/08/2018,06/08/2018,0.00,,4.24,,"-742,259.17"
,IN,AR,30321642,1005,100,,Invoice,,,,,,06/08/2018,06/08/2018,0.00,,5.51,,"-742,264.68"
,IN,AR,30321643,1005,100,,Invoice,,,,,,06/08/2018,06/08/2018,0.00,,7.29,,"-742,271.97"
,IN,AR,30321655,1005,100,,Invoice,,,,,,06/08/2018,06/08/2018,0.00,,8.64,,"-742,280.61"
,IN,AR,30321684,1005,100,,Invoice,,,,,,06/08/2018,06/08/2018,0.00,,5.08,,"-742,285.69"
,IN,AR,30321688,1005,100,,Invoice,,,,,,06/08/2018,06/08/2018,0.00,,10.34,,"-742,296.03"
,IN,AR,30321690,1005,100,,Invoice,,,,,,06/08/2018,06/08/2018,0.00,,22.37,,"-742,318.40"
,IN,AR,30321730,1005,100,,Invoice,,,,,,06/08/2018,06/08/2018,0.00,,15.25,,"-742,333.65"
,IN,AR,30321739,1005,100,,Invoice,,,,,,06/08/2018,06/08/2018,0.00,,30.51,,"-742,364.16"
,IN,AR,30321742,1005,100,,Invoice,,,,,,06/08/2018,06/08/2018,0.00,,26.44,,"-742,390.60"
,IN,AR,30321748,1005,100,,Invoice,,,,,,06/08/2018,06/08/2018,0.00,,3.64,,"-742,394.24"
,IN,AR,30321750,1005,100,,Invoice,,,,,,06/08/2018,06/08/2018,0.00,,14.58,,"-742,408.82"
,IN,AR,30321751,1005,100,,Invoice,,,,,,06/08/2018,06/08/2018,0.00,,12.71,,"-742,421.53"
,IN,AR,30321757,1005,100,,Invoice,,,,,,06/08/2018,06/08/2018,0.00,,3.64,,"-742,425.17"
,IN,AR,30321759,1005,100,,Invoice,,,,,,06/08/2018,06/08/2018,0.00,,6.08,,"-742,431.25"
,IN,AR,30321762,1005,100,,Invoice,,,,,,06/08/2018,06/08/2018,0.00,,19.64,,"-742,450.89"
,IN,AR,30321764,1005,100,,Invoice,,,,,,06/08/2018,06/08/2018,0.00,,13.14,,"-742,464.03"
,IN,AR,30321780,1005,100,,Invoice,,,,,,06/08/2018,06/08/2018,0.00,,182.20,,"-742,646.23"
,IN,AR,30321785,1005,100,,Invoice,,,,,,06/08/2018,06/08/2018,0.00,,7.29,,"-742,653.52"
,IN,AR,30321787,1005,100,,Invoice,,,,,,06/08/2018,06/08/2018,0.00,,51.25,,"-742,704.77"
,IN,AR,30321790,1005,100,,Invoice,,,,,,06/08/2018,06/08/2018,0.00,,34.00,,"-742,738.77"
,IN,AR,30321802,1005,100,,Invoice,,,,,,06/08/2018,06/08/2018,0.00,,5.17,,"-742,743.94"
,IN,AR,30321807,1005,100,,Invoice,,,,,,06/08/2018,06/08/2018,0.00,,36.12,,"-742,780.06"
,IN,AR,30321808,1005,100,,Invoice,,,,,,06/08/2018,06/08/2018,0.00,,7.29,,"-742,787.35"
,IN,AR,30321810,1005,100,,Invoice,,,,,,06/08/2018,06/08/2018,0.00,,4.49,,"-742,791.84"
,IN,AR,30321829,1005,100,,Invoice,,,,,,06/08/2018,06/08/2018,0.00,,7.05,,"-742,798.89"
,IN,AR,30321832,1005,100,,Invoice,,,,,,06/08/2018,06/08/2018,0.00,,7.29,,"-742,806.18"
,IN,AR,30321840,1005,100,,Invoice,,,,,,06/08/2018,06/08/2018,0.00,,364.41,,"-743,170.59"
,IN,AR,30321849,1005,100,,Invoice,,,,,,06/08/2018,06/08/2018,0.00,,4.29,,"-743,174.88"
,IN,AR,30321864,1005,100,,Invoice,,,,,,06/08/2018,06/08/2018,0.00,,5.17,,"-743,180.05"
,IN,AR,30321870,1005,100,,Invoice,,,,,,06/08/2018,06/08/2018,0.00,,182.20,,"-743,362.25"
,IN,AR,30321884,1005,100,,Invoice,,,,,,06/08/2018,06/08/2018,0.00,,182.20,,"-743,544.45"
,IN,AR,30321888,1005,100,,Invoice,,,,,,06/08/2018,06/08/2018,0.00,,2.14,,"-743,546.59"
,IN,AR,30321895,1005,100,,Invoice,,,,,,06/08/2018,06/08/2018,0.00,,36.08,,"-743,582.67"
,IN,AR,30321900,1005,100,,Invoice,,,,,,06/08/2018,06/08/2018,0.00,,14.58,,"-743,597.25"
,IN,AR,30321904,1005,100,,Invoice,,,,,,06/08/2018,06/08/2018,0.00,,24.29,,"-743,621.54"
,IN,AR,30321914,1005,100,,Invoice,,,,,,06/08/2018,06/08/2018,0.00,,9.84,,"-743,631.38"
,IN,AR,30321917,1005,100,,Invoice,,,,,,06/08/2018,06/08/2018,0.00,,44.66,,"-743,676.04"
,IN,AR,30321918,1005,100,,Invoice,,,,,,06/08/2018,06/08/2018,0.00,,9.15,,"-743,685.19"
,IN,AR,30321919,1005,100,,Invoice,,,,,,06/08/2018,06/08/2018,0.00,,419.07,,"-744,104.26"
,IN,AR,30321926,1005,100,,Invoice,,,,,,06/08/2018,06/08/2018,0.00,,18.22,,"-744,122.48"
,IN,AR,30321935,1005,100,,Invoice,,,,,,06/08/2018,06/08/2018,0.00,,22.01,,"-744,144.49"
,IN,AR,30321942,1005,100,,Invoice,,,,,,06/08/2018,06/08/2018,0.00,,32.01,,"-744,176.50"
,IN,AR,30321947,1005,100,,Invoice,,,,,,06/08/2018,06/08/2018,0.00,,27.15,,"-744,203.65"
,IN,AR,30321948,1005,100,,Invoice,,,,,,06/08/2018,06/08/2018,0.00,,3.02,,"-744,206.67"
,IN,AR,30321958,1005,100,,Invoice,,,,,,06/08/2018,06/08/2018,0.00,,6.31,,"-744,212.98"
,IN,AR,30321960,1005,100,,Invoice,,,,,,06/08/2018,06/08/2018,0.00,,182.20,,"-744,395.18"
,IN,AR,30321964,1005,100,,Invoice,,,,,,06/08/2018,06/08/2018,0.00,,14.58,,"-744,409.76"
,IN,AR,30321969,1005,100,,Invoice,,,,,,06/08/2018,06/08/2018,0.00,,36.24,,"-744,446.00"
,IN,AR,30321970,1005,100,,Invoice,,,,,,06/08/2018,06/08/2018,0.00,,156.14,,"-744,602.14"
,IN,AR,30321971,1005,100,,Invoice,,,,,,06/08/2018,06/08/2018,0.00,,4.66,,"-744,606.80"
,IN,AR,30321974,1005,100,,Invoice,,,,,,06/08/2018,06/08/2018,0.00,,11.22,,"-744,618.02"
,IN,AR,30321979,1005,100,,Invoice,,,,,,06/08/2018,06/08/2018,0.00,,54.66,,"-744,672.68"
,IN,AR,30321981,1005,100,,Invoice,,,,,,06/08/2018,06/08/2018,0.00,,54.66,,"-744,727.34"
,IN,AR,30321983,1005,100,,Invoice,,,,,,06/08/2018,06/08/2018,0.00,,128.00,,"-744,855.34"
,IN,AR,30321994,1005,100,,Invoice,,,,,,06/08/2018,06/08/2018,0.00,,182.20,,"-745,037.54"
,IN,AR,30322002,1005,100,,Invoice,,,,,,06/08/2018,06/08/2018,0.00,,26.69,,"-745,064.23"
,IN,AR,30322008,1005,100,,Invoice,,,,,,06/08/2018,06/08/2018,0.00,,12.75,,"-745,076.98"
,IN,AR,30322009,1005,100,,Invoice,,,,,,06/08/2018,06/08/2018,0.00,,1.59,,"-745,078.57"
,IN,AR,30322013,1005,100,,Invoice,,,,,,06/08/2018,06/08/2018,0.00,,182.20,,"-745,260.77"
,IN,AR,30322056,1005,100,,Invoice,,,,,,06/08/2018,06/08/2018,0.00,,10.00,,"-745,270.77"
,IN,AR,30322062,1005,100,,Invoice,,,,,,06/08/2018,06/08/2018,0.00,,1.88,,"-745,272.65"
,IN,AR,30322081,1005,100,,Invoice,,,,,,06/08/2018,06/08/2018,0.00,,13.69,,"-745,286.34"
,IN,AR,30322094,1005,100,,Invoice,,,,,,06/08/2018,06/08/2018,0.00,,5.24,,"-745,291.58"
,IN,AR,30322101,1005,100,,Invoice,,,,,,06/08/2018,06/08/2018,0.00,,4.08,,"-745,295.66"
,IN,AR,30322113,1005,100,,Invoice,,,,,,06/08/2018,06/08/2018,0.00,,35.08,,"-745,330.74"
,IN,AR,30322130,1005,100,,Invoice,,,,,,06/08/2018,06/08/2018,0.00,,4.00,,"-745,334.74"
,IN,AR,30322140,1005,100,,Invoice,,,,,,06/08/2018,06/08/2018,0.00,,2.08,,"-745,336.82"
,IN,AR,30322141,1005,100,,Invoice,,,,,,06/08/2018,06/08/2018,0.00,,8.31,,"-745,345.13"
,IN,AR,30322142,1005,100,,Invoice,,,,,,06/08/2018,06/08/2018,0.00,,4.15,,"-745,349.28"
,IN,AR,30322143,1005,100,,Invoice,,,,,,06/08/2018,06/08/2018,0.00,,2.08,,"-745,351.36"
,IN,AR,30322149,1005,100,,Invoice,,,,,,06/08/2018,06/08/2018,0.00,,6.56,,"-745,357.92"
,IN,AR,30322160,1005,100,,Invoice,,,,,,06/08/2018,06/08/2018,0.00,,14.58,,"-745,372.50"
,IN,AR,30322167,1005,100,,Invoice,,,,,,06/08/2018,06/08/2018,0.00,,14.58,,"-745,387.08"
,IN,AR,30322169,1005,100,,Invoice,,,,,,06/08/2018,06/08/2018,0.00,,1.75,,"-745,388.83"
,IN,AR,30322178,1005,100,,Invoice,,,,,,06/08/2018,06/08/2018,0.00,,280.00,,"-745,668.83"
,IN,AR,30322184,1005,100,,Invoice,,,,,,06/08/2018,06/08/2018,0.00,,23.13,,"-745,691.96"
,IN,AR,30322194,1005,100,,Invoice,,,,,,06/08/2018,06/08/2018,0.00,,36.44,,"-745,728.40"
,IN,AR,30322201,1005,100,,Invoice,,,,,,06/08/2018,06/08/2018,0.00,,8.00,,"-745,736.40"
,IN,AR,30322205,1005,100,,Invoice,,,,,,06/08/2018,06/08/2018,0.00,,29.15,,"-745,765.55"
,CN,AR,31018545,1005,100,,Credit Note,,,,,,07/08/2018,07/08/2018,3.64,,0.00,,"-745,761.91"
,CS,AR,32007075,1005,100,,Cash sale,,,,,,07/08/2018,07/08/2018,0.00,,3.64,,"-745,765.55"
,CS,AR,32007084,1005,100,,Cash sale,,,,,,07/08/2018,07/08/2018,0.00,,18.22,,"-745,783.77"
,CS,AR,32007088,1005,100,,Cash sale,,,,,,07/08/2018,07/08/2018,0.00,,14.58,,"-745,798.35"
,CS,AR,32007090,1005,100,,Cash sale,,,,,,07/08/2018,07/08/2018,0.00,,6.02,,"-745,804.37"
,CS,AR,32007092,1005,100,,Cash sale,,,,,,07/08/2018,07/08/2018,0.00,,14.58,,"-745,818.95"
,CS,AR,32007106,1005,100,,Cash sale,,,,,,07/08/2018,07/08/2018,0.00,,14.58,,"-745,833.53"
,CS,AR,32007111,1005,100,,Cash sale,,,,,,07/08/2018,07/08/2018,0.00,,7.29,,"-745,840.82"
,CS,AR,32007126,1005,100,,Cash sale,,,,,,07/08/2018,07/08/2018,0.00,,9.03,,"-745,849.85"
,CS,AR,32007137,1005,100,,Cash sale,,,,,,07/08/2018,07/08/2018,0.00,,10.34,,"-745,860.19"
,CS,AR,32007138,1005,100,,Cash sale,,,,,,07/08/2018,07/08/2018,0.00,,5.68,,"-745,865.87"
,CS,AR,32007164,1005,100,,Cash sale,,,,,,07/08/2018,07/08/2018,0.00,,17.29,,"-745,883.16"
,CS,AR,32007169,1005,100,,Cash sale,,,,,,07/08/2018,07/08/2018,0.00,,4.78,,"-745,887.94"
,CS,AR,32007172,1005,100,,Cash sale,,,,,,07/08/2018,07/08/2018,0.00,,2.54,,"-745,890.48"
,CS,AR,32007173,1005,100,,Cash sale,,,,,,07/08/2018,07/08/2018,0.00,,7.75,,"-745,898.23"
,CS,AR,32007174,1005,100,,Cash sale,,,,,,07/08/2018,07/08/2018,0.00,,7.29,,"-745,905.52"
,CS,AR,32007180,1005,100,,Cash sale,,,,,,07/08/2018,07/08/2018,0.00,,12.92,,"-745,918.44"
,CS,AR,32007181,1005,100,,Cash sale,,,,,,07/08/2018,07/08/2018,0.00,,5.85,,"-745,924.29"
,CS,AR,32007182,1005,100,,Cash sale,,,,,,07/08/2018,07/08/2018,0.00,,10.93,,"-745,935.22"
,CS,AR,32007185,1005,100,,Cash sale,,,,,,07/08/2018,07/08/2018,0.00,,7.29,,"-745,942.51"
,CS,AR,32007193,1005,100,,Cash sale,,,,,,07/08/2018,07/08/2018,0.00,,14.58,,"-745,957.09"
,CS,AR,32007195,1005,100,,Cash sale,,,,,,07/08/2018,07/08/2018,0.00,,6.02,,"-745,963.11"
,CS,AR,32007196,1005,100,,Cash sale,,,,,,07/08/2018,07/08/2018,0.00,,10.93,,"-745,974.04"
,CS,AR,32007200,1005,100,,Cash sale,,,,,,07/08/2018,07/08/2018,0.00,,7.29,,"-745,981.33"
,CS,AR,32007218,1005,100,,Cash sale,,,,,,07/08/2018,07/08/2018,0.00,,10.93,,"-745,992.26"
,CS,AR,32007221,1005,100,,Cash sale,,,,,,07/08/2018,07/08/2018,0.00,,32.80,,"-746,025.06"
,CS,AR,32007229,1005,100,,Cash sale,,,,,,07/08/2018,07/08/2018,0.00,,12.71,,"-746,037.77"
,CS,AR,32007231,1005,100,,Cash sale,,,,,,07/08/2018,07/08/2018,0.00,,48.00,,"-746,085.77"
,CS,AR,32007248,1005,100,,Cash sale,,,,,,07/08/2018,07/08/2018,0.00,,11.86,,"-746,097.63"
,CS,AR,32007252,1005,100,,Cash sale,,,,,,07/08/2018,07/08/2018,0.00,,5.50,,"-746,103.13"
,CS,AR,32007257,1005,100,,Cash sale,,,,,,07/08/2018,07/08/2018,0.00,,54.66,,"-746,157.79"
,CS,AR,32007263,1005,100,,Cash sale,,,,,,07/08/2018,07/08/2018,0.00,,18.22,,"-746,176.01"
,CS,AR,32007272,1005,100,,Cash sale,,,,,,07/08/2018,07/08/2018,0.00,,7.29,,"-746,183.30"
,CS,AR,32007274,1005,100,,Cash sale,,,,,,07/08/2018,07/08/2018,0.00,,20.41,,"-746,203.71"
,CS,AR,32007279,1005,100,,Cash sale,,,,,,07/08/2018,07/08/2018,0.00,,3.64,,"-746,207.35"
,CS,AR,32007286,1005,100,,Cash sale,,,,,,07/08/2018,07/08/2018,0.00,,10.93,,"-746,218.28"
,CS,AR,32007291,1005,100,,Cash sale,,,,,,07/08/2018,07/08/2018,0.00,,5.47,,"-746,223.75"
,CS,AR,32007297,1005,100,,Cash sale,,,,,,07/08/2018,07/08/2018,0.00,,16.48,,"-746,240.23"
,CS,AR,32007298,1005,100,,Cash sale,,,,,,07/08/2018,07/08/2018,0.00,,7.29,,"-746,247.52"
,CS,AR,32007299,1005,100,,Cash sale,,,,,,07/08/2018,07/08/2018,0.00,,7.75,,"-746,255.27"
,CS,AR,32007305,1005,100,,Cash sale,,,,,,07/08/2018,07/08/2018,0.00,,10.93,,"-746,266.20"
,CS,AR,32007321,1005,100,,Cash sale,,,,,,07/08/2018,07/08/2018,0.00,,6.19,,"-746,272.39"
,CS,AR,32007328,1005,100,,Cash sale,,,,,,07/08/2018,07/08/2018,0.00,,7.29,,"-746,279.68"
,CS,AR,32007336,1005,100,,Cash sale,,,,,,07/08/2018,07/08/2018,0.00,,3.64,,"-746,283.32"
,CS,AR,32007338,1005,100,,Cash sale,,,,,,07/08/2018,07/08/2018,0.00,,7.29,,"-746,290.61"
,IN,AR,30321449,1005,100,,Invoice,,,,,,07/08/2018,07/08/2018,0.00,,54.95,,"-746,345.56"
,IN,AR,30321458,1005,100,,Invoice,,,,,,07/08/2018,07/08/2018,0.00,,32.54,,"-746,378.10"
,IN,AR,30321462,1005,100,,Invoice,,,,,,07/08/2018,07/08/2018,0.00,,182.20,,"-746,560.30"
,IN,AR,30321464,1005,100,,Invoice,,,,,,07/08/2018,07/08/2018,0.00,,3.64,,"-746,563.94"
,IN,AR,30321472,1005,100,,Invoice,,,,,,07/08/2018,07/08/2018,0.00,,14.58,,"-746,578.52"
,IN,AR,30321473,1005,100,,Invoice,,,,,,07/08/2018,07/08/2018,0.00,,7.00,,"-746,585.52"
,IN,AR,30321477,1005,100,,Invoice,,,,,,07/08/2018,07/08/2018,0.00,,8.39,,"-746,593.91"
,IN,AR,30321486,1005,100,,Invoice,,,,,,07/08/2018,07/08/2018,0.00,,3.98,,"-746,597.89"
,IN,AR,30321493,1005,100,,Invoice,,,,,,07/08/2018,07/08/2018,0.00,,83.05,,"-746,680.94"
,IN,AR,30321533,1005,100,,Invoice,,,,,,07/08/2018,07/08/2018,0.00,,3.64,,"-746,684.58"
,IN,AR,30321534,1005,100,,Invoice,,,,,,07/08/2018,07/08/2018,0.00,,21.86,,"-746,706.44"
,IN,AR,30321537,1005,100,,Invoice,,,,,,07/08/2018,07/08/2018,0.00,,18.22,,"-746,724.66"
,IN,AR,30321540,1005,100,,Invoice,,,,,,07/08/2018,07/08/2018,0.00,,28.39,,"-746,753.05"
,IN,AR,30321543,1005,100,,Invoice,,,,,,07/08/2018,07/08/2018,0.00,,20.34,,"-746,773.39"
,IN,AR,30321546,1005,100,,Invoice,,,,,,07/08/2018,07/08/2018,0.00,,76.47,,"-746,849.86"
,IN,AR,30321551,1005,100,,Invoice,,,,,,07/08/2018,07/08/2018,0.00,,19.24,,"-746,869.10"
,IN,AR,30321552,1005,100,,Invoice,,,,,,07/08/2018,07/08/2018,0.00,,3.64,,"-746,872.74"
,IN,AR,30321558,1005,100,,Invoice,,,,,,07/08/2018,07/08/2018,0.00,,10.93,,"-746,883.67"
,IN,AR,30321574,1005,100,,Invoice,,,,,,07/08/2018,07/08/2018,0.00,,41.19,,"-746,924.86"
,IN,AR,30321575,1005,100,,Invoice,,,,,,07/08/2018,07/08/2018,0.00,,4.64,,"-746,929.50"
,IN,AR,30321579,1005,100,,Invoice,,,,,,07/08/2018,07/08/2018,0.00,,5.08,,"-746,934.58"
,IN,AR,30321581,1005,100,,Invoice,,,,,,07/08/2018,07/08/2018,0.00,,18.22,,"-746,952.80"
,IN,AR,30321587,1005,100,,Invoice,,,,,,07/08/2018,07/08/2018,0.00,,4.32,,"-746,957.12"
,IN,AR,30321588,1005,100,,Invoice,,,,,,07/08/2018,07/08/2018,0.00,,12.71,,"-746,969.83"
,IN,AR,30321591,1005,100,,Invoice,,,,,,07/08/2018,07/08/2018,0.00,,7.29,,"-746,977.12"
,IN,AR,30321605,1005,100,,Invoice,,,,,,07/08/2018,07/08/2018,0.00,,3.90,,"-746,981.02"
,IN,AR,30321606,1005,100,,Invoice,,,,,,07/08/2018,07/08/2018,0.00,,29.15,,"-747,010.17"
,IN,AR,30321610,1005,100,,Invoice,,,,,,07/08/2018,07/08/2018,0.00,,24.07,,"-747,034.24"
,IN,AR,30321614,1005,100,,Invoice,,,,,,07/08/2018,07/08/2018,0.00,,3.90,,"-747,038.14"
,IN,AR,30321619,1005,100,,Invoice,,,,,,07/08/2018,07/08/2018,0.00,,7.29,,"-747,045.43"
,IN,AR,30321623,1005,100,,Invoice,,,,,,07/08/2018,07/08/2018,0.00,,5.17,,"-747,050.60"
,IN,AR,30321629,1005,100,,Invoice,,,,,,07/08/2018,07/08/2018,0.00,,4.78,,"-747,055.38"
,IN,AR,30321648,1005,100,,Invoice,,,,,,07/08/2018,07/08/2018,0.00,,5.17,,"-747,060.55"
,IN,AR,30321686,1005,100,,Invoice,,,,,,07/08/2018,07/08/2018,0.00,,7.29,,"-747,067.84"
,IN,AR,30321692,1005,100,,Invoice,,,,,,07/08/2018,07/08/2018,0.00,,11.23,,"-747,079.07"
,IN,AR,30321697,1005,100,,Invoice,,,,,,07/08/2018,07/08/2018,0.00,,182.20,,"-747,261.27"
,IN,AR,30321698,1005,100,,Invoice,,,,,,07/08/2018,07/08/2018,0.00,,10.93,,"-747,272.20"
,IN,AR,30321733,1005,100,,Invoice,,,,,,07/08/2018,07/08/2018,0.00,,7.29,,"-747,279.49"
,IN,AR,30321734,1005,100,,Invoice,,,,,,07/08/2018,07/08/2018,0.00,,5.85,,"-747,285.34"
,IN,AR,30321737,1005,100,,Invoice,,,,,,07/08/2018,07/08/2018,0.00,,26.69,,"-747,312.03"
,IN,AR,30321740,1005,100,,Invoice,,,,,,07/08/2018,07/08/2018,0.00,,14.63,,"-747,326.66"
,IN,AR,30321745,1005,100,,Invoice,,,,,,07/08/2018,07/08/2018,0.00,,13.22,,"-747,339.88"
,IN,AR,30321746,1005,100,,Invoice,,,,,,07/08/2018,07/08/2018,0.00,,20.34,,"-747,360.22"
,IN,AR,30321747,1005,100,,Invoice,,,,,,07/08/2018,07/08/2018,0.00,,10.53,,"-747,370.75"
,IN,AR,30321749,1005,100,,Invoice,,,,,,07/08/2018,07/08/2018,0.00,,12.03,,"-747,382.78"
,IN,AR,30321752,1005,100,,Invoice,,,,,,07/08/2018,07/08/2018,0.00,,25.42,,"-747,408.20"
,IN,AR,30321755,1005,100,,Invoice,,,,,,07/08/2018,07/08/2018,0.00,,4.24,,"-747,412.44"
,IN,AR,30321758,1005,100,,Invoice,,,,,,07/08/2018,07/08/2018,0.00,,5.08,,"-747,417.52"
,IN,AR,30321763,1005,100,,Invoice,,,,,,07/08/2018,07/08/2018,0.00,,12.71,,"-747,430.23"
,IN,AR,30321766,1005,100,,Invoice,,,,,,07/08/2018,07/08/2018,0.00,,12.71,,"-747,442.94"
,IN,AR,30321769,1005,100,,Invoice,,,,,,07/08/2018,07/08/2018,0.00,,26.69,,"-747,469.63"
,IN,AR,30321791,1005,100,,Invoice,,,,,,07/08/2018,07/08/2018,0.00,,22.81,,"-747,492.44"
,IN,AR,30321800,1005,100,,Invoice,,,,,,07/08/2018,07/08/2018,0.00,,8.26,,"-747,500.70"
,IN,AR,30321803,1005,100,,Invoice,,,,,,07/08/2018,07/08/2018,0.00,,5.86,,"-747,506.56"
,IN,AR,30321805,1005,100,,Invoice,,,,,,07/08/2018,07/08/2018,0.00,,5.68,,"-747,512.24"
,IN,AR,30321821,1005,100,,Invoice,,,,,,07/08/2018,07/08/2018,0.00,,7.29,,"-747,519.53"
,IN,AR,30321823,1005,100,,Invoice,,,,,,07/08/2018,07/08/2018,0.00,,21.44,,"-747,540.97"
,IN,AR,30321826,1005,100,,Invoice,,,,,,07/08/2018,07/08/2018,0.00,,30.02,,"-747,570.99"
,IN,AR,30321830,1005,100,,Invoice,,,,,,07/08/2018,07/08/2018,0.00,,7.05,,"-747,578.04"
,IN,AR,30321839,1005,100,,Invoice,,,,,,07/08/2018,07/08/2018,0.00,,133.47,,"-747,711.51"
,IN,AR,30321850,1005,100,,Invoice,,,,,,07/08/2018,07/08/2018,0.00,,10.93,,"-747,722.44"
,IN,AR,30321873,1005,100,,Invoice,,,,,,07/08/2018,07/08/2018,0.00,,6.36,,"-747,728.80"
,IN,AR,30321874,1005,100,,Invoice,,,,,,07/08/2018,07/08/2018,0.00,,3.18,,"-747,731.98"
,IN,AR,30321875,1005,100,,Invoice,,,,,,07/08/2018,07/08/2018,0.00,,3.18,,"-747,735.16"
,IN,AR,30321876,1005,100,,Invoice,,,,,,07/08/2018,07/08/2018,0.00,,1.59,,"-747,736.75"
,IN,AR,30321877,1005,100,,Invoice,,,,,,07/08/2018,07/08/2018,0.00,,4.77,,"-747,741.52"
,IN,AR,30321878,1005,100,,Invoice,,,,,,07/08/2018,07/08/2018,0.00,,138.33,,"-747,879.85"
,IN,AR,30321881,1005,100,,Invoice,,,,,,07/08/2018,07/08/2018,0.00,,42.58,,"-747,922.43"
,IN,AR,30321882,1005,100,,Invoice,,,,,,07/08/2018,07/08/2018,0.00,,34.00,,"-747,956.43"
,IN,AR,30321885,1005,100,,Invoice,,,,,,07/08/2018,07/08/2018,0.00,,54.66,,"-748,011.09"
,IN,AR,30321908,1005,100,,Invoice,,,,,,07/08/2018,07/08/2018,0.00,,219.37,,"-748,230.46"
,IN,AR,30321913,1005,100,,Invoice,,,,,,07/08/2018,07/08/2018,0.00,,7.29,,"-748,237.75"
,IN,AR,30321928,1005,100,,Invoice,,,,,,07/08/2018,07/08/2018,0.00,,10.93,,"-748,248.68"
,IN,AR,30321932,1005,100,,Invoice,,,,,,07/08/2018,07/08/2018,0.00,,10.17,,"-748,258.85"
,IN,AR,30321933,1005,100,,Invoice,,,,,,07/08/2018,07/08/2018,0.00,,182.20,,"-748,441.05"
,IN,AR,30321937,1005,100,,Invoice,,,,,,07/08/2018,07/08/2018,0.00,,20.01,,"-748,461.06"
,IN,AR,30321959,1005,100,,Invoice,,,,,,07/08/2018,07/08/2018,0.00,,23.13,,"-748,484.19"
,IN,AR,30321962,1005,100,,Invoice,,,,,,07/08/2018,07/08/2018,0.00,,14.58,,"-748,498.77"
,IN,AR,30321972,1005,100,,Invoice,,,,,,07/08/2018,07/08/2018,0.00,,5.47,,"-748,504.24"
,IN,AR,30321985,1005,100,,Invoice,,,,,,07/08/2018,07/08/2018,0.00,,6.07,,"-748,510.31"
,IN,AR,30321991,1005,100,,Invoice,,,,,,07/08/2018,07/08/2018,0.00,,42.71,,"-748,553.02"
,IN,AR,30321992,1005,100,,Invoice,,,,,,07/08/2018,07/08/2018,0.00,,7.29,,"-748,560.31"
,IN,AR,30321998,1005,100,,Invoice,,,,,,07/08/2018,07/08/2018,0.00,,2.54,,"-748,562.85"
,IN,AR,30322012,1005,100,,Invoice,,,,,,07/08/2018,07/08/2018,0.00,,37.97,,"-748,600.82"
,IN,AR,30322048,1005,100,,Invoice,,,,,,07/08/2018,07/08/2018,0.00,,28.47,,"-748,629.29"
,IN,AR,30322053,1005,100,,Invoice,,,,,,07/08/2018,07/08/2018,0.00,,28.47,,"-748,657.76"
,IN,AR,30322064,1005,100,,Invoice,,,,,,07/08/2018,07/08/2018,0.00,,1.75,,"-748,659.51"
,IN,AR,30322065,1005,100,,Invoice,,,,,,07/08/2018,07/08/2018,0.00,,12.00,,"-748,671.51"
,IN,AR,30322066,1005,100,,Invoice,,,,,,07/08/2018,07/08/2018,0.00,,8.90,,"-748,680.41"
,IN,AR,30322069,1005,100,,Invoice,,,,,,07/08/2018,07/08/2018,0.00,,139.17,,"-748,819.58"
,IN,AR,30322070,1005,100,,Invoice,,,,,,07/08/2018,07/08/2018,0.00,,10.93,,"-748,830.51"
,IN,AR,30322076,1005,100,,Invoice,,,,,,07/08/2018,07/08/2018,0.00,,7.02,,"-748,837.53"
,IN,AR,30322098,1005,100,,Invoice,,,,,,07/08/2018,07/08/2018,0.00,,10.47,,"-748,848.00"
,IN,AR,30322108,1005,100,,Invoice,,,,,,07/08/2018,07/08/2018,0.00,,5.51,,"-748,853.51"
,IN,AR,30322110,1005,100,,Invoice,,,,,,07/08/2018,07/08/2018,0.00,,7.97,,"-748,861.48"
,IN,AR,30322121,1005,100,,Invoice,,,,,,07/08/2018,07/08/2018,0.00,,9.66,,"-748,871.14"
,IN,AR,30322124,1005,100,,Invoice,,,,,,07/08/2018,07/08/2018,0.00,,15.18,,"-748,886.32"
,IN,AR,30322144,1005,100,,Invoice,,,,,,07/08/2018,07/08/2018,0.00,,8.31,,"-748,894.63"
,IN,AR,30322145,1005,100,,Invoice,,,,,,07/08/2018,07/08/2018,0.00,,12.46,,"-748,907.09"
,IN,AR,30322146,1005,100,,Invoice,,,,,,07/08/2018,07/08/2018,0.00,,12.46,,"-748,919.55"
,IN,AR,30322147,1005,100,,Invoice,,,,,,07/08/2018,07/08/2018,0.00,,25.42,,"-748,944.97"
,IN,AR,30322152,1005,100,,Invoice,,,,,,07/08/2018,07/08/2018,0.00,,14.49,,"-748,959.46"
,IN,AR,30322163,1005,100,,Invoice,,,,,,07/08/2018,07/08/2018,0.00,,29.15,,"-748,988.61"
,IN,AR,30322164,1005,100,,Invoice,,,,,,07/08/2018,07/08/2018,0.00,,15.25,,"-749,003.86"
,IN,AR,30322179,1005,100,,Invoice,,,,,,07/08/2018,07/08/2018,0.00,,37.50,,"-749,041.36"
,IN,AR,30322197,1005,100,,Invoice,,,,,,07/08/2018,07/08/2018,0.00,,29.15,,"-749,070.51"
,CS,AR,32007339,1005,100,,Cash sale,,,,,,07/08/2018,07/08/2018,0.00,,7.29,,"-749,077.80"
,CS,AR,32007340,1005,100,,Cash sale,,,,,,07/08/2018,07/08/2018,0.00,,29.15,,"-749,106.95"
,CS,AR,32007341,1005,100,,Cash sale,,,,,,07/08/2018,07/08/2018,0.00,,18.25,,"-749,125.20"
,IN,AR,30322209,1005,100,,Invoice,,,,,,07/08/2018,07/08/2018,0.00,,778.92,,"-749,904.12"
,IN,AR,30322210,1005,100,,Invoice,,,,,,07/08/2018,07/08/2018,0.00,,12.20,,"-749,916.32"
,IN,AR,30322211,1005,100,,Invoice,,,,,,07/08/2018,07/08/2018,0.00,,56.95,,"-749,973.27"
,IN,AR,30322213,1005,100,,Invoice,,,,,,07/08/2018,07/08/2018,0.00,,54.66,,"-750,027.93"
,IN,AR,30322215,1005,100,,Invoice,,,,,,07/08/2018,07/08/2018,0.00,,12.14,,"-750,040.07"
,IN,AR,30322217,1005,100,,Invoice,,,,,,07/08/2018,07/08/2018,0.00,,54.66,,"-750,094.73"
,CN,AR,31018583,1005,100,,Credit Note,,,,,,08/08/2018,08/08/2018,31.78,,0.00,,"-750,062.95"
,CN,AR,31018584,1005,100,,Credit Note,,,,,,08/08/2018,08/08/2018,31.78,,0.00,,"-750,031.17"
,CN,AR,31018644,1005,100,,Credit Note,,,,,,08/08/2018,08/08/2018,7.29,,0.00,,"-750,023.88"
,CS,AR,32007343,1005,100,,Cash sale,,,,,,08/08/2018,08/08/2018,0.00,,21.86,,"-750,045.74"
,CS,AR,32007350,1005,100,,Cash sale,,,,,,08/08/2018,08/08/2018,0.00,,16.83,,"-750,062.57"
,CS,AR,32007356,1005,100,,Cash sale,,,,,,08/08/2018,08/08/2018,0.00,,3.64,,"-750,066.21"
,CS,AR,32007358,1005,100,,Cash sale,,,,,,08/08/2018,08/08/2018,0.00,,45.15,,"-750,111.36"
,CS,AR,32007379,1005,100,,Cash sale,,,,,,08/08/2018,08/08/2018,0.00,,3.64,,"-750,115.00"
,CS,AR,32007407,1005,100,,Cash sale,,,,,,08/08/2018,08/08/2018,0.00,,3.64,,"-750,118.64"
,CS,AR,32007421,1005,100,,Cash sale,,,,,,08/08/2018,08/08/2018,0.00,,3.64,,"-750,122.28"
,CS,AR,32007426,1005,100,,Cash sale,,,,,,08/08/2018,08/08/2018,0.00,,7.29,,"-750,129.57"
,CS,AR,32007427,1005,100,,Cash sale,,,,,,08/08/2018,08/08/2018,0.00,,9.03,,"-750,138.60"
,CS,AR,32007437,1005,100,,Cash sale,,,,,,08/08/2018,08/08/2018,0.00,,7.29,,"-750,145.89"
,CS,AR,32007442,1005,100,,Cash sale,,,,,,08/08/2018,08/08/2018,0.00,,7.29,,"-750,153.18"
,CS,AR,32007456,1005,100,,Cash sale,,,,,,08/08/2018,08/08/2018,0.00,,8.78,,"-750,161.96"
,CS,AR,32007466,1005,100,,Cash sale,,,,,,08/08/2018,08/08/2018,0.00,,10.34,,"-750,172.30"
,CS,AR,32007477,1005,100,,Cash sale,,,,,,08/08/2018,08/08/2018,0.00,,3.64,,"-750,175.94"
,CS,AR,32007497,1005,100,,Cash sale,,,,,,08/08/2018,08/08/2018,0.00,,7.75,,"-750,183.69"
,CS,AR,32007500,1005,100,,Cash sale,,,,,,08/08/2018,08/08/2018,0.00,,15.51,,"-750,199.20"
,CS,AR,32007504,1005,100,,Cash sale,,,,,,08/08/2018,08/08/2018,0.00,,7.29,,"-750,206.49"
,CS,AR,32007510,1005,100,,Cash sale,,,,,,08/08/2018,08/08/2018,0.00,,24.07,,"-750,230.56"
,CS,AR,32007513,1005,100,,Cash sale,,,,,,08/08/2018,08/08/2018,0.00,,8.58,,"-750,239.14"
,CS,AR,32007523,1005,100,,Cash sale,,,,,,08/08/2018,08/08/2018,0.00,,10.93,,"-750,250.07"
,CS,AR,32007529,1005,100,,Cash sale,,,,,,08/08/2018,08/08/2018,0.00,,10.93,,"-750,261.00"
,CS,AR,32007537,1005,100,,Cash sale,,,,,,08/08/2018,08/08/2018,0.00,,12.71,,"-750,273.71"
,CS,AR,32007562,1005,100,,Cash sale,,,,,,08/08/2018,08/08/2018,0.00,,25.51,,"-750,299.22"
,CS,AR,32007573,1005,100,,Cash sale,,,,,,08/08/2018,08/08/2018,0.00,,3.64,,"-750,302.86"
,CS,AR,32007600,1005,100,,Cash sale,,,,,,08/08/2018,08/08/2018,0.00,,14.58,,"-750,317.44"
,CS,AR,32007616,1005,100,,Cash sale,,,,,,08/08/2018,08/08/2018,0.00,,10.93,,"-750,328.37"
,CS,AR,32007631,1005,100,,Cash sale,,,,,,08/08/2018,08/08/2018,0.00,,8.14,,"-750,336.51"
,CS,AR,32007635,1005,100,,Cash sale,,,,,,08/08/2018,08/08/2018,0.00,,7.29,,"-750,343.80"
,CS,AR,32007645,1005,100,,Cash sale,,,,,,08/08/2018,08/08/2018,0.00,,7.75,,"-750,351.55"
,CS,AR,32007663,1005,100,,Cash sale,,,,,,08/08/2018,08/08/2018,0.00,,10.68,,"-750,362.23"
,CS,AR,32007672,1005,100,,Cash sale,,,,,,08/08/2018,08/08/2018,0.00,,18.98,,"-750,381.21"
,CS,AR,32007673,1005,100,,Cash sale,,,,,,08/08/2018,08/08/2018,0.00,,11.86,,"-750,393.07"
,CS,AR,32007693,1005,100,,Cash sale,,,,,,08/08/2018,08/08/2018,0.00,,7.29,,"-750,400.36"
,CS,AR,32007695,1005,100,,Cash sale,,,,,,08/08/2018,08/08/2018,0.00,,6.86,,"-750,407.22"
,CS,AR,32007724,1005,100,,Cash sale,,,,,,08/08/2018,08/08/2018,0.00,,7.29,,"-750,414.51"
,CS,AR,32007726,1005,100,,Cash sale,,,,,,08/08/2018,08/08/2018,0.00,,6.86,,"-750,421.37"
,CS,AR,32007732,1005,100,,Cash sale,,,,,,08/08/2018,08/08/2018,0.00,,29.15,,"-750,450.52"
,CS,AR,32007733,1005,100,,Cash sale,,,,,,08/08/2018,08/08/2018,0.00,,5.93,,"-750,456.45"
,CS,AR,32007736,1005,100,,Cash sale,,,,,,08/08/2018,08/08/2018,0.00,,14.58,,"-750,471.03"
,CS,AR,32007739,1005,100,,Cash sale,,,,,,08/08/2018,08/08/2018,0.00,,9.10,,"-750,480.13"
,CS,AR,32007742,1005,100,,Cash sale,,,,,,08/08/2018,08/08/2018,0.00,,10.93,,"-750,491.06"
,CS,AR,32007747,1005,100,,Cash sale,,,,,,08/08/2018,08/08/2018,0.00,,7.29,,"-750,498.35"
,CS,AR,32007753,1005,100,,Cash sale,,,,,,08/08/2018,08/08/2018,0.00,,15.04,,"-750,513.39"
,CS,AR,32007755,1005,100,,Cash sale,,,,,,08/08/2018,08/08/2018,0.00,,10.93,,"-750,524.32"
,CS,AR,32007756,1005,100,,Cash sale,,,,,,08/08/2018,08/08/2018,0.00,,25.51,,"-750,549.83"
,CS,AR,32007769,1005,100,,Cash sale,,,,,,08/08/2018,08/08/2018,0.00,,7.29,,"-750,557.12"
,CS,AR,32007777,1005,100,,Cash sale,,,,,,08/08/2018,08/08/2018,0.00,,17.80,,"-750,574.92"
,CS,AR,32007785,1005,100,,Cash sale,,,,,,08/08/2018,08/08/2018,0.00,,7.29,,"-750,582.21"
,CS,AR,32007789,1005,100,,Cash sale,,,,,,08/08/2018,08/08/2018,0.00,,10.93,,"-750,593.14"
,CS,AR,32007793,1005,100,,Cash sale,,,,,,08/08/2018,08/08/2018,0.00,,9.84,,"-750,602.98"
,IN,AR,30322220,1005,100,,Invoice,,,,,,08/08/2018,08/08/2018,0.00,,253.63,,"-750,856.61"
,IN,AR,30322222,1005,100,,Invoice,,,,,,08/08/2018,08/08/2018,0.00,,23.73,,"-750,880.34"
,IN,AR,30322238,1005,100,,Invoice,,,,,,08/08/2018,08/08/2018,0.00,,313.23,,"-751,193.57"
,IN,AR,30322245,1005,100,,Invoice,,,,,,08/08/2018,08/08/2018,0.00,,18.22,,"-751,211.79"
,IN,AR,30322248,1005,100,,Invoice,,,,,,08/08/2018,08/08/2018,0.00,,53.69,,"-751,265.48"
,IN,AR,30322249,1005,100,,Invoice,,,,,,08/08/2018,08/08/2018,0.00,,29.29,,"-751,294.77"
,IN,AR,30322268,1005,100,,Invoice,,,,,,08/08/2018,08/08/2018,0.00,,16.27,,"-751,311.04"
,IN,AR,30322271,1005,100,,Invoice,,,,,,08/08/2018,08/08/2018,0.00,,21.86,,"-751,332.90"
,IN,AR,30322272,1005,100,,Invoice,,,,,,08/08/2018,08/08/2018,0.00,,19.92,,"-751,352.82"
,IN,AR,30322280,1005,100,,Invoice,,,,,,08/08/2018,08/08/2018,0.00,,23.64,,"-751,376.46"
,IN,AR,30322281,1005,100,,Invoice,,,,,,08/08/2018,08/08/2018,0.00,,78.81,,"-751,455.27"
,IN,AR,30322284,1005,100,,Invoice,,,,,,08/08/2018,08/08/2018,0.00,,18.22,,"-751,473.49"
,IN,AR,30322285,1005,100,,Invoice,,,,,,08/08/2018,08/08/2018,0.00,,21.74,,"-751,495.23"
,IN,AR,30322309,1005,100,,Invoice,,,,,,08/08/2018,08/08/2018,0.00,,11.64,,"-751,506.87"
,IN,AR,30322317,1005,100,,Invoice,,,,,,08/08/2018,08/08/2018,0.00,,47.46,,"-751,554.33"
,IN,AR,30322340,1005,100,,Invoice,,,,,,08/08/2018,08/08/2018,0.00,,18.22,,"-751,572.55"
,IN,AR,30322357,1005,100,,Invoice,,,,,,08/08/2018,08/08/2018,0.00,,7.29,,"-751,579.84"
,IN,AR,30322361,1005,100,,Invoice,,,,,,08/08/2018,08/08/2018,0.00,,3.64,,"-751,583.48"
,IN,AR,30322363,1005,100,,Invoice,,,,,,08/08/2018,08/08/2018,0.00,,48.00,,"-751,631.48"
,IN,AR,30322391,1005,100,,Invoice,,,,,,08/08/2018,08/08/2018,0.00,,30.00,,"-751,661.48"
,IN,AR,30322415,1005,100,,Invoice,,,,,,08/08/2018,08/08/2018,0.00,,7.29,,"-751,668.77"
,IN,AR,30322423,1005,100,,Invoice,,,,,,08/08/2018,08/08/2018,0.00,,281.07,,"-751,949.84"
,IN,AR,30322466,1005,100,,Invoice,,,,,,08/08/2018,08/08/2018,0.00,,34.48,,"-751,984.32"
,IN,AR,30322475,1005,100,,Invoice,,,,,,08/08/2018,08/08/2018,0.00,,17.53,,"-752,001.85"
,IN,AR,30322493,1005,100,,Invoice,,,,,,08/08/2018,08/08/2018,0.00,,182.20,,"-752,184.05"
,IN,AR,30322515,1005,100,,Invoice,,,,,,08/08/2018,08/08/2018,0.00,,25.42,,"-752,209.47"
,IN,AR,30322522,1005,100,,Invoice,,,,,,08/08/2018,08/08/2018,0.00,,4.24,,"-752,213.71"
,IN,AR,30322523,1005,100,,Invoice,,,,,,08/08/2018,08/08/2018,0.00,,4.24,,"-752,217.95"
,IN,AR,30322530,1005,100,,Invoice,,,,,,08/08/2018,08/08/2018,0.00,,4.24,,"-752,222.19"
,IN,AR,30322538,1005,100,,Invoice,,,,,,08/08/2018,08/08/2018,0.00,,5.59,,"-752,227.78"
,IN,AR,30322541,1005,100,,Invoice,,,,,,08/08/2018,08/08/2018,0.00,,19.07,,"-752,246.85"
,IN,AR,30322564,1005,100,,Invoice,,,,,,08/08/2018,08/08/2018,0.00,,22.03,,"-752,268.88"
,IN,AR,30322565,1005,100,,Invoice,,,,,,08/08/2018,08/08/2018,0.00,,3.64,,"-752,272.52"
,IN,AR,30322572,1005,100,,Invoice,,,,,,08/08/2018,08/08/2018,0.00,,9.56,,"-752,282.08"
,IN,AR,30322579,1005,100,,Invoice,,,,,,08/08/2018,08/08/2018,0.00,,61.53,,"-752,343.61"
,IN,AR,30322610,1005,100,,Invoice,,,,,,08/08/2018,08/08/2018,0.00,,7.29,,"-752,350.90"
,IN,AR,30322621,1005,100,,Invoice,,,,,,08/08/2018,08/08/2018,0.00,,7.75,,"-752,358.65"
,IN,AR,30322625,1005,100,,Invoice,,,,,,08/08/2018,08/08/2018,0.00,,32.68,,"-752,391.33"
,IN,AR,30322629,1005,100,,Invoice,,,,,,08/08/2018,08/08/2018,0.00,,296.08,,"-752,687.41"
,IN,AR,30322637,1005,100,,Invoice,,,,,,08/08/2018,08/08/2018,0.00,,5.08,,"-752,692.49"
,IN,AR,30322652,1005,100,,Invoice,,,,,,08/08/2018,08/08/2018,0.00,,18.39,,"-752,710.88"
,IN,AR,30322658,1005,100,,Invoice,,,,,,08/08/2018,08/08/2018,0.00,,27.97,,"-752,738.85"
,IN,AR,30322685,1005,100,,Invoice,,,,,,08/08/2018,08/08/2018,0.00,,7.75,,"-752,746.60"
,IN,AR,30322688,1005,100,,Invoice,,,,,,08/08/2018,08/08/2018,0.00,,15.90,,"-752,762.50"
,IN,AR,30322719,1005,100,,Invoice,,,,,,08/08/2018,08/08/2018,0.00,,12.71,,"-752,775.21"
,IN,AR,30322723,1005,100,,Invoice,,,,,,08/08/2018,08/08/2018,0.00,,21.86,,"-752,797.07"
,IN,AR,30322728,1005,100,,Invoice,,,,,,08/08/2018,08/08/2018,0.00,,10.93,,"-752,808.00"
,IN,AR,30322730,1005,100,,Invoice,,,,,,08/08/2018,08/08/2018,0.00,,10.93,,"-752,818.93"
,IN,AR,30322756,1005,100,,Invoice,,,,,,08/08/2018,08/08/2018,0.00,,17.80,,"-752,836.73"
,IN,AR,30322780,1005,100,,Invoice,,,,,,08/08/2018,08/08/2018,0.00,,18.22,,"-752,854.95"
,IN,AR,30322784,1005,100,,Invoice,,,,,,08/08/2018,08/08/2018,0.00,,31.78,,"-752,886.73"
,IN,AR,30322787,1005,100,,Invoice,,,,,,08/08/2018,08/08/2018,0.00,,30.76,,"-752,917.49"
,IN,AR,30322791,1005,100,,Invoice,,,,,,08/08/2018,08/08/2018,0.00,,10.17,,"-752,927.66"
,IN,AR,30322804,1005,100,,Invoice,,,,,,08/08/2018,08/08/2018,0.00,,54.66,,"-752,982.32"
,IN,AR,30322814,1005,100,,Invoice,,,,,,08/08/2018,08/08/2018,0.00,,54.66,,"-753,036.98"
,IN,AR,30322843,1005,100,,Invoice,,,,,,08/08/2018,08/08/2018,0.00,,27.08,,"-753,064.06"
,IN,AR,30322851,1005,100,,Invoice,,,,,,08/08/2018,08/08/2018,0.00,,29.15,,"-753,093.21"
,IN,AR,30322856,1005,100,,Invoice,,,,,,08/08/2018,08/08/2018,0.00,,182.20,,"-753,275.41"
,IN,AR,30322889,1005,100,,Invoice,,,,,,08/08/2018,08/08/2018,0.00,,1.76,,"-753,277.17"
,IN,AR,30322890,1005,100,,Invoice,,,,,,08/08/2018,08/08/2018,0.00,,17.62,,"-753,294.79"
,IN,AR,30322891,1005,100,,Invoice,,,,,,08/08/2018,08/08/2018,0.00,,5.29,,"-753,300.08"
,IN,AR,30322899,1005,100,,Invoice,,,,,,08/08/2018,08/08/2018,0.00,,27.08,,"-753,327.16"
,IN,AR,30322922,1005,100,,Invoice,,,,,,08/08/2018,08/08/2018,0.00,,10.93,,"-753,338.09"
,IN,AR,30322928,1005,100,,Invoice,,,,,,08/08/2018,08/08/2018,0.00,,26.01,,"-753,364.10"
,IN,AR,30322930,1005,100,,Invoice,,,,,,08/08/2018,08/08/2018,0.00,,47.37,,"-753,411.47"
,IN,AR,30322931,1005,100,,Invoice,,,,,,08/08/2018,08/08/2018,0.00,,51.02,,"-753,462.49"
,IN,AR,30322955,1005,100,,Invoice,,,,,,08/08/2018,08/08/2018,0.00,,12.71,,"-753,475.20"
,IN,AR,30322959,1005,100,,Invoice,,,,,,08/08/2018,08/08/2018,0.00,,7.29,,"-753,482.49"
,IN,AR,30322965,1005,100,,Invoice,,,,,,08/08/2018,08/08/2018,0.00,,10.93,,"-753,493.42"
,IN,AR,30322984,1005,100,,Invoice,,,,,,08/08/2018,08/08/2018,0.00,,6.02,,"-753,499.44"
,IN,AR,30322990,1005,100,,Invoice,,,,,,08/08/2018,08/08/2018,0.00,,26.00,,"-753,525.44"
,IN,AR,30322997,1005,100,,Invoice,,,,,,08/08/2018,08/08/2018,0.00,,54.66,,"-753,580.10"
,IN,AR,30323002,1005,100,,Invoice,,,,,,08/08/2018,08/08/2018,0.00,,160.34,,"-753,740.44"
,IN,AR,30323006,1005,100,,Invoice,,,,,,08/08/2018,08/08/2018,0.00,,34.08,,"-753,774.52"
,IN,AR,30323012,1005,100,,Invoice,,,,,,08/08/2018,08/08/2018,0.00,,14.58,,"-753,789.10"
,IN,AR,30323041,1005,100,,Invoice,,,,,,08/08/2018,08/08/2018,0.00,,3.64,,"-753,792.74"
,IN,AR,30323045,1005,100,,Invoice,,,,,,08/08/2018,08/08/2018,0.00,,10.19,,"-753,802.93"
,IN,AR,30323050,1005,100,,Invoice,,,,,,08/08/2018,08/08/2018,0.00,,25.87,,"-753,828.80"
,IN,AR,30323061,1005,100,,Invoice,,,,,,08/08/2018,08/08/2018,0.00,,18.22,,"-753,847.02"
,IN,AR,30323063,1005,100,,Invoice,,,,,,08/08/2018,08/08/2018,0.00,,10.17,,"-753,857.19"
,IN,AR,30323064,1005,100,,Invoice,,,,,,08/08/2018,08/08/2018,0.00,,10.17,,"-753,867.36"
,IN,AR,30323065,1005,100,,Invoice,,,,,,08/08/2018,08/08/2018,0.00,,10.17,,"-753,877.53"
,IN,AR,30323082,1005,100,,Invoice,,,,,,08/08/2018,08/08/2018,0.00,,18.01,,"-753,895.54"
,IN,AR,30323089,1005,100,,Invoice,,,,,,08/08/2018,08/08/2018,0.00,,83.05,,"-753,978.59"
,IN,AR,30323097,1005,100,,Invoice,,,,,,08/08/2018,08/08/2018,0.00,,54.66,,"-754,033.25"
,IN,AR,30323102,1005,100,,Invoice,,,,,,08/08/2018,08/08/2018,0.00,,9.05,,"-754,042.30"
,IN,AR,30323103,1005,100,,Invoice,,,,,,08/08/2018,08/08/2018,0.00,,24.14,,"-754,066.44"
,IN,AR,30323113,1005,100,,Invoice,,,,,,08/08/2018,08/08/2018,0.00,,29.44,,"-754,095.88"
,IN,AR,30323114,1005,100,,Invoice,,,,,,08/08/2018,08/08/2018,0.00,,8.41,,"-754,104.29"
,IN,AR,30323147,1005,100,,Invoice,,,,,,08/08/2018,08/08/2018,0.00,,11.19,,"-754,115.48"
,IN,AR,30323149,1005,100,,Invoice,,,,,,08/08/2018,08/08/2018,0.00,,16.78,,"-754,132.26"
,IN,AR,30323150,1005,100,,Invoice,,,,,,08/08/2018,08/08/2018,0.00,,9.64,,"-754,141.90"
,IN,AR,30323172,1005,100,,Invoice,,,,,,08/08/2018,08/08/2018,0.00,,29.15,,"-754,171.05"
,IN,AR,30323175,1005,100,,Invoice,,,,,,08/08/2018,08/08/2018,0.00,,10.93,,"-754,181.98"
,IN,AR,30323182,1005,100,,Invoice,,,,,,08/08/2018,08/08/2018,0.00,,2.84,,"-754,184.82"
,IN,AR,30323184,1005,100,,Invoice,,,,,,08/08/2018,08/08/2018,0.00,,9.66,,"-754,194.48"
,IN,AR,30323186,1005,100,,Invoice,,,,,,08/08/2018,08/08/2018,0.00,,20.41,,"-754,214.89"
,IN,AR,30323195,1005,100,,Invoice,,,,,,08/08/2018,08/08/2018,0.00,,6.37,,"-754,221.26"
,IN,AR,30323214,1005,100,,Invoice,,,,,,08/08/2018,08/08/2018,0.00,,154.25,,"-754,375.51"
,IN,AR,30323215,1005,100,,Invoice,,,,,,08/08/2018,08/08/2018,0.00,,28.47,,"-754,403.98"
,IN,AR,30323241,1005,100,,Invoice,,,,,,08/08/2018,08/08/2018,0.00,,5.26,,"-754,409.24"
,IN,AR,30323257,1005,100,,Invoice,,,,,,08/08/2018,08/08/2018,0.00,,29.15,,"-754,438.39"
,IN,AR,30323284,1005,100,,Invoice,,,,,,08/08/2018,08/08/2018,0.00,,7.29,,"-754,445.68"
,IN,AR,30323285,1005,100,,Invoice,,,,,,08/08/2018,08/08/2018,0.00,,11.29,,"-754,456.97"
,IN,AR,30323297,1005,100,,Invoice,,,,,,08/08/2018,08/08/2018,0.00,,245.00,,"-754,701.97"
,IN,AR,30323298,1005,100,,Invoice,,,,,,08/08/2018,08/08/2018,0.00,,125.00,,"-754,826.97"
,IN,AR,30323299,1005,100,,Invoice,,,,,,08/08/2018,08/08/2018,0.00,,182.50,,"-755,009.47"
,IN,AR,30323300,1005,100,,Invoice,,,,,,08/08/2018,08/08/2018,0.00,,240.00,,"-755,249.47"
,IN,AR,30323301,1005,100,,Invoice,,,,,,08/08/2018,08/08/2018,0.00,,295.00,,"-755,544.47"
,IN,AR,30323302,1005,100,,Invoice,,,,,,08/08/2018,08/08/2018,0.00,,205.00,,"-755,749.47"
,IN,AR,30323303,1005,100,,Invoice,,,,,,08/08/2018,08/08/2018,0.00,,77.50,,"-755,826.97"
,IN,AR,30323304,1005,100,,Invoice,,,,,,08/08/2018,08/08/2018,0.00,,285.00,,"-756,111.97"
,IN,AR,30323305,1005,100,,Invoice,,,,,,08/08/2018,08/08/2018,0.00,,130.00,,"-756,241.97"
,IN,AR,30323306,1005,100,,Invoice,,,,,,08/08/2018,08/08/2018,0.00,,212.50,,"-756,454.47"
,IN,AR,30323307,1005,100,,Invoice,,,,,,08/08/2018,08/08/2018,0.00,,257.50,,"-756,711.97"
,IN,AR,30323308,1005,100,,Invoice,,,,,,08/08/2018,08/08/2018,0.00,,167.50,,"-756,879.47"
,IN,AR,30323309,1005,100,,Invoice,,,,,,08/08/2018,08/08/2018,0.00,,192.50,,"-757,071.97"
,IN,AR,30323321,1005,100,,Invoice,,,,,,08/08/2018,08/08/2018,0.00,,33.56,,"-757,105.53"
,IN,AR,30323323,1005,100,,Invoice,,,,,,08/08/2018,08/08/2018,0.00,,57.19,,"-757,162.72"
,IN,AR,30323331,1005,100,,Invoice,,,,,,08/08/2018,08/08/2018,0.00,,10.21,,"-757,172.93"
,IN,AR,30323332,1005,100,,Invoice,,,,,,08/08/2018,08/08/2018,0.00,,7.29,,"-757,180.22"
,IN,AR,30323361,1005,100,,Invoice,,,,,,08/08/2018,08/08/2018,0.00,,11.44,,"-757,191.66"
,IN,AR,30323378,1005,100,,Invoice,,,,,,08/08/2018,08/08/2018,0.00,,58.14,,"-757,249.80"
,IN,AR,30323379,1005,100,,Invoice,,,,,,08/08/2018,08/08/2018,0.00,,8.31,,"-757,258.11"
,IN,AR,30323380,1005,100,,Invoice,,,,,,08/08/2018,08/08/2018,0.00,,16.61,,"-757,274.72"
,IN,AR,30323381,1005,100,,Invoice,,,,,,08/08/2018,08/08/2018,0.00,,8.31,,"-757,283.03"
,IN,AR,30323411,1005,100,,Invoice,,,,,,08/08/2018,08/08/2018,0.00,,2.54,,"-757,285.57"
,IN,AR,30323423,1005,100,,Invoice,,,,,,08/08/2018,08/08/2018,0.00,,24.27,,"-757,309.84"
,IN,AR,30323433,1005,100,,Invoice,,,,,,08/08/2018,08/08/2018,0.00,,7.29,,"-757,317.13"
,IN,AR,30323434,1005,100,,Invoice,,,,,,08/08/2018,08/08/2018,0.00,,16.91,,"-757,334.04"
,IN,AR,30323459,1005,100,,Invoice,,,,,,08/08/2018,08/08/2018,0.00,,43.93,,"-757,377.97"
,IN,AR,30323476,1005,100,,Invoice,,,,,,08/08/2018,08/08/2018,0.00,,7.29,,"-757,385.26"
,IN,AR,30323483,1005,100,,Invoice,,,,,,08/08/2018,08/08/2018,0.00,,7.29,,"-757,392.55"
,IN,AR,30323485,1005,100,,Invoice,,,,,,08/08/2018,08/08/2018,0.00,,3.64,,"-757,396.19"
,IN,AR,30323486,1005,100,,Invoice,,,,,,08/08/2018,08/08/2018,0.00,,3.64,,"-757,399.83"
,IN,AR,30323489,1005,100,,Invoice,,,,,,08/08/2018,08/08/2018,0.00,,27.97,,"-757,427.80"
,IN,AR,30323493,1005,100,,Invoice,,,,,,08/08/2018,08/08/2018,0.00,,364.41,,"-757,792.21"
,IN,AR,30323495,1005,100,,Invoice,,,,,,08/08/2018,08/08/2018,0.00,,19.41,,"-757,811.62"
,IN,AR,30323525,1005,100,,Invoice,,,,,,08/08/2018,08/08/2018,0.00,,31.79,,"-757,843.41"
,CN,AR,31018624,1005,100,,Credit Note,,,,,,09/08/2018,09/08/2018,72.88,,0.00,,"-757,770.53"
,CS,AR,32007345,1005,100,,Cash sale,,,,,,09/08/2018,09/08/2018,0.00,,9.03,,"-757,779.56"
,CS,AR,32007348,1005,100,,Cash sale,,,,,,09/08/2018,09/08/2018,0.00,,29.15,,"-757,808.71"
,CS,AR,32007365,1005,100,,Cash sale,,,,,,09/08/2018,09/08/2018,0.00,,7.29,,"-757,816.00"
,CS,AR,32007371,1005,100,,Cash sale,,,,,,09/08/2018,09/08/2018,0.00,,10.93,,"-757,826.93"
,CS,AR,32007387,1005,100,,Cash sale,,,,,,09/08/2018,09/08/2018,0.00,,10.93,,"-757,837.86"
,CS,AR,32007390,1005,100,,Cash sale,,,,,,09/08/2018,09/08/2018,0.00,,3.64,,"-757,841.50"
,CS,AR,32007397,1005,100,,Cash sale,,,,,,09/08/2018,09/08/2018,0.00,,7.29,,"-757,848.79"
,CS,AR,32007403,1005,100,,Cash sale,,,,,,09/08/2018,09/08/2018,0.00,,3.64,,"-757,852.43"
,CS,AR,32007416,1005,100,,Cash sale,,,,,,09/08/2018,09/08/2018,0.00,,3.64,,"-757,856.07"
,CS,AR,32007425,1005,100,,Cash sale,,,,,,09/08/2018,09/08/2018,0.00,,7.29,,"-757,863.36"
,CS,AR,32007453,1005,100,,Cash sale,,,,,,09/08/2018,09/08/2018,0.00,,7.29,,"-757,870.65"
,CS,AR,32007457,1005,100,,Cash sale,,,,,,09/08/2018,09/08/2018,0.00,,7.29,,"-757,877.94"
,CS,AR,32007459,1005,100,,Cash sale,,,,,,09/08/2018,09/08/2018,0.00,,7.29,,"-757,885.23"
,CS,AR,32007462,1005,100,,Cash sale,,,,,,09/08/2018,09/08/2018,0.00,,7.29,,"-757,892.52"
,CS,AR,32007475,1005,100,,Cash sale,,,,,,09/08/2018,09/08/2018,0.00,,4.78,,"-757,897.30"
,CS,AR,32007507,1005,100,,Cash sale,,,,,,09/08/2018,09/08/2018,0.00,,28.43,,"-757,925.73"
,CS,AR,32007535,1005,100,,Cash sale,,,,,,09/08/2018,09/08/2018,0.00,,7.29,,"-757,933.02"
,CS,AR,32007543,1005,100,,Cash sale,,,,,,09/08/2018,09/08/2018,0.00,,10.93,,"-757,943.95"
,CS,AR,32007558,1005,100,,Cash sale,,,,,,09/08/2018,09/08/2018,0.00,,8.17,,"-757,952.12"
,CS,AR,32007564,1005,100,,Cash sale,,,,,,09/08/2018,09/08/2018,0.00,,10.17,,"-757,962.29"
,CS,AR,32007570,1005,100,,Cash sale,,,,,,09/08/2018,09/08/2018,0.00,,7.29,,"-757,969.58"
,CS,AR,32007578,1005,100,,Cash sale,,,,,,09/08/2018,09/08/2018,0.00,,19.28,,"-757,988.86"
,CS,AR,32007592,1005,100,,Cash sale,,,,,,09/08/2018,09/08/2018,0.00,,7.29,,"-757,996.15"
,CS,AR,32007604,1005,100,,Cash sale,,,,,,09/08/2018,09/08/2018,0.00,,9.66,,"-758,005.81"
,CS,AR,32007606,1005,100,,Cash sale,,,,,,09/08/2018,09/08/2018,0.00,,83.90,,"-758,089.71"
,CS,AR,32007639,1005,100,,Cash sale,,,,,,09/08/2018,09/08/2018,0.00,,10.93,,"-758,100.64"
,CS,AR,32007653,1005,100,,Cash sale,,,,,,09/08/2018,09/08/2018,0.00,,3.64,,"-758,104.28"
,CS,AR,32007664,1005,100,,Cash sale,,,,,,09/08/2018,09/08/2018,0.00,,22.37,,"-758,126.65"
,CS,AR,32007669,1005,100,,Cash sale,,,,,,09/08/2018,09/08/2018,0.00,,7.29,,"-758,133.94"
,CS,AR,32007678,1005,100,,Cash sale,,,,,,09/08/2018,09/08/2018,0.00,,10.93,,"-758,144.87"
,CS,AR,32007679,1005,100,,Cash sale,,,,,,09/08/2018,09/08/2018,0.00,,20.95,,"-758,165.82"
,CS,AR,32007684,1005,100,,Cash sale,,,,,,09/08/2018,09/08/2018,0.00,,3.64,,"-758,169.46"
,CS,AR,32007686,1005,100,,Cash sale,,,,,,09/08/2018,09/08/2018,0.00,,21.86,,"-758,191.32"
,CS,AR,32007689,1005,100,,Cash sale,,,,,,09/08/2018,09/08/2018,0.00,,2.58,,"-758,193.90"
,CS,AR,32007708,1005,100,,Cash sale,,,,,,09/08/2018,09/08/2018,0.00,,8.26,,"-758,202.16"
,CS,AR,32007710,1005,100,,Cash sale,,,,,,09/08/2018,09/08/2018,0.00,,5.93,,"-758,208.09"
,CS,AR,32007712,1005,100,,Cash sale,,,,,,09/08/2018,09/08/2018,0.00,,10.93,,"-758,219.02"
,CS,AR,32007723,1005,100,,Cash sale,,,,,,09/08/2018,09/08/2018,0.00,,7.29,,"-758,226.31"
,CS,AR,32007737,1005,100,,Cash sale,,,,,,09/08/2018,09/08/2018,0.00,,10.93,,"-758,237.24"
,CS,AR,32007748,1005,100,,Cash sale,,,,,,09/08/2018,09/08/2018,0.00,,14.58,,"-758,251.82"
,CS,AR,32007752,1005,100,,Cash sale,,,,,,09/08/2018,09/08/2018,0.00,,60.71,,"-758,312.53"
,CS,AR,32007765,1005,100,,Cash sale,,,,,,09/08/2018,09/08/2018,0.00,,5.47,,"-758,318.00"
,CS,AR,32007797,1005,100,,Cash sale,,,,,,09/08/2018,09/08/2018,0.00,,10.93,,"-758,328.93"
,CS,AR,32007810,1005,100,,Cash sale,,,,,,09/08/2018,09/08/2018,0.00,,14.58,,"-758,343.51"
,CS,AR,32007848,1005,100,,Cash sale,,,,,,09/08/2018,09/08/2018,0.00,,3.64,,"-758,347.15"
,CS,AR,32007866,1005,100,,Cash sale,,,,,,09/08/2018,09/08/2018,0.00,,14.58,,"-758,361.73"
,IN,AR,30322231,1005,100,,Invoice,,,,,,09/08/2018,09/08/2018,0.00,,3.64,,"-758,365.37"
,IN,AR,30322243,1005,100,,Invoice,,,,,,09/08/2018,09/08/2018,0.00,,10.93,,"-758,376.30"
,IN,AR,30322246,1005,100,,Invoice,,,,,,09/08/2018,09/08/2018,0.00,,3.64,,"-758,379.94"
,IN,AR,30322275,1005,100,,Invoice,,,,,,09/08/2018,09/08/2018,0.00,,3.64,,"-758,383.58"
,IN,AR,30322303,1005,100,,Invoice,,,,,,09/08/2018,09/08/2018,0.00,,36.44,,"-758,420.02"
,IN,AR,30322318,1005,100,,Invoice,,,,,,09/08/2018,09/08/2018,0.00,,90.17,,"-758,510.19"
,IN,AR,30322330,1005,100,,Invoice,,,,,,09/08/2018,09/08/2018,0.00,,7.29,,"-758,517.48"
,IN,AR,30322332,1005,100,,Invoice,,,,,,09/08/2018,09/08/2018,0.00,,182.20,,"-758,699.68"
,IN,AR,30322336,1005,100,,Invoice,,,,,,09/08/2018,09/08/2018,0.00,,52.00,,"-758,751.68"
,IN,AR,30322344,1005,100,,Invoice,,,,,,09/08/2018,09/08/2018,0.00,,43.73,,"-758,795.41"
,IN,AR,30322345,1005,100,,Invoice,,,,,,09/08/2018,09/08/2018,0.00,,11.86,,"-758,807.27"
,IN,AR,30322356,1005,100,,Invoice,,,,,,09/08/2018,09/08/2018,0.00,,58.31,,"-758,865.58"
,IN,AR,30322359,1005,100,,Invoice,,,,,,09/08/2018,09/08/2018,0.00,,10.93,,"-758,876.51"
,IN,AR,30322371,1005,100,,Invoice,,,,,,09/08/2018,09/08/2018,0.00,,364.41,,"-759,240.92"
,IN,AR,30322374,1005,100,,Invoice,,,,,,09/08/2018,09/08/2018,0.00,,7.29,,"-759,248.21"
,IN,AR,30322398,1005,100,,Invoice,,,,,,09/08/2018,09/08/2018,0.00,,99.66,,"-759,347.87"
,IN,AR,30322416,1005,100,,Invoice,,,,,,09/08/2018,09/08/2018,0.00,,46.68,,"-759,394.55"
,IN,AR,30322429,1005,100,,Invoice,,,,,,09/08/2018,09/08/2018,0.00,,15.51,,"-759,410.06"
,IN,AR,30322478,1005,100,,Invoice,,,,,,09/08/2018,09/08/2018,0.00,,21.86,,"-759,431.92"
,IN,AR,30322481,1005,100,,Invoice,,,,,,09/08/2018,09/08/2018,0.00,,18.22,,"-759,450.14"
,IN,AR,30322483,1005,100,,Invoice,,,,,,09/08/2018,09/08/2018,0.00,,21.00,,"-759,471.14"
,IN,AR,30322490,1005,100,,Invoice,,,,,,09/08/2018,09/08/2018,0.00,,182.20,,"-759,653.34"
,IN,AR,30322553,1005,100,,Invoice,,,,,,09/08/2018,09/08/2018,0.00,,218.53,,"-759,871.87"
,IN,AR,30322563,1005,100,,Invoice,,,,,,09/08/2018,09/08/2018,0.00,,7.29,,"-759,879.16"
,IN,AR,30322578,1005,100,,Invoice,,,,,,09/08/2018,09/08/2018,0.00,,22.03,,"-759,901.19"
,IN,AR,30322592,1005,100,,Invoice,,,,,,09/08/2018,09/08/2018,0.00,,14.34,,"-759,915.53"
,IN,AR,30322593,1005,100,,Invoice,,,,,,09/08/2018,09/08/2018,0.00,,19.12,,"-759,934.65"
,IN,AR,30322619,1005,100,,Invoice,,,,,,09/08/2018,09/08/2018,0.00,,15.04,,"-759,949.69"
,IN,AR,30322632,1005,100,,Invoice,,,,,,09/08/2018,09/08/2018,0.00,,8.47,,"-759,958.16"
,IN,AR,30322655,1005,100,,Invoice,,,,,,09/08/2018,09/08/2018,0.00,,7.75,,"-759,965.91"
,IN,AR,30322662,1005,100,,Invoice,,,,,,09/08/2018,09/08/2018,0.00,,6.48,,"-759,972.39"
,IN,AR,30322664,1005,100,,Invoice,,,,,,09/08/2018,09/08/2018,0.00,,21.86,,"-759,994.25"
,IN,AR,30322677,1005,100,,Invoice,,,,,,09/08/2018,09/08/2018,0.00,,21.19,,"-760,015.44"
,IN,AR,30322694,1005,100,,Invoice,,,,,,09/08/2018,09/08/2018,0.00,,27.97,,"-760,043.41"
,IN,AR,30322713,1005,100,,Invoice,,,,,,09/08/2018,09/08/2018,0.00,,27.47,,"-760,070.88"
,IN,AR,30322721,1005,100,,Invoice,,,,,,09/08/2018,09/08/2018,0.00,,8.47,,"-760,079.35"
,IN,AR,30322738,1005,100,,Invoice,,,,,,09/08/2018,09/08/2018,0.00,,54.66,,"-760,134.01"
,IN,AR,30322741,1005,100,,Invoice,,,,,,09/08/2018,09/08/2018,0.00,,10.98,,"-760,144.99"
,IN,AR,30322760,1005,100,,Invoice,,,,,,09/08/2018,09/08/2018,0.00,,14.58,,"-760,159.57"
,IN,AR,30322761,1005,100,,Invoice,,,,,,09/08/2018,09/08/2018,0.00,,14.00,,"-760,173.57"
,IN,AR,30322764,1005,100,,Invoice,,,,,,09/08/2018,09/08/2018,0.00,,182.20,,"-760,355.77"
,IN,AR,30322769,1005,100,,Invoice,,,,,,09/08/2018,09/08/2018,0.00,,7.29,,"-760,363.06"
,IN,AR,30322770,1005,100,,Invoice,,,,,,09/08/2018,09/08/2018,0.00,,182.20,,"-760,545.26"
,IN,AR,30322806,1005,100,,Invoice,,,,,,09/08/2018,09/08/2018,0.00,,6.97,,"-760,552.23"
,IN,AR,30322812,1005,100,,Invoice,,,,,,09/08/2018,09/08/2018,0.00,,11.69,,"-760,563.92"
,IN,AR,30322817,1005,100,,Invoice,,,,,,09/08/2018,09/08/2018,0.00,,7.29,,"-760,571.21"
,IN,AR,30322819,1005,100,,Invoice,,,,,,09/08/2018,09/08/2018,0.00,,30.30,,"-760,601.51"
,IN,AR,30322831,1005,100,,Invoice,,,,,,09/08/2018,09/08/2018,0.00,,2.84,,"-760,604.35"
,IN,AR,30322847,1005,100,,Invoice,,,,,,09/08/2018,09/08/2018,0.00,,24.07,,"-760,628.42"
,IN,AR,30322852,1005,100,,Invoice,,,,,,09/08/2018,09/08/2018,0.00,,30.22,,"-760,658.64"
,IN,AR,30322858,1005,100,,Invoice,,,,,,09/08/2018,09/08/2018,0.00,,11.64,,"-760,670.28"
,IN,AR,30322860,1005,100,,Invoice,,,,,,09/08/2018,09/08/2018,0.00,,7.63,,"-760,677.91"
,IN,AR,30322861,1005,100,,Invoice,,,,,,09/08/2018,09/08/2018,0.00,,54.66,,"-760,732.57"
,IN,AR,30322869,1005,100,,Invoice,,,,,,09/08/2018,09/08/2018,0.00,,18.05,,"-760,750.62"
,IN,AR,30322870,1005,100,,Invoice,,,,,,09/08/2018,09/08/2018,0.00,,12.00,,"-760,762.62"
,IN,AR,30322876,1005,100,,Invoice,,,,,,09/08/2018,09/08/2018,0.00,,107.20,,"-760,869.82"
,IN,AR,30322892,1005,100,,Invoice,,,,,,09/08/2018,09/08/2018,0.00,,5.29,,"-760,875.11"
,IN,AR,30322903,1005,100,,Invoice,,,,,,09/08/2018,09/08/2018,0.00,,10.93,,"-760,886.04"
,IN,AR,30322905,1005,100,,Invoice,,,,,,09/08/2018,09/08/2018,0.00,,27.25,,"-760,913.29"
,IN,AR,30322942,1005,100,,Invoice,,,,,,09/08/2018,09/08/2018,0.00,,18.22,,"-760,931.51"
,IN,AR,30322945,1005,100,,Invoice,,,,,,09/08/2018,09/08/2018,0.00,,182.20,,"-761,113.71"
,IN,AR,30322953,1005,100,,Invoice,,,,,,09/08/2018,09/08/2018,0.00,,14.58,,"-761,128.29"
,IN,AR,30322966,1005,100,,Invoice,,,,,,09/08/2018,09/08/2018,0.00,,9.96,,"-761,138.25"
,IN,AR,30322967,1005,100,,Invoice,,,,,,09/08/2018,09/08/2018,0.00,,9.96,,"-761,148.21"
,IN,AR,30322968,1005,100,,Invoice,,,,,,09/08/2018,09/08/2018,0.00,,5.97,,"-761,154.18"
,IN,AR,30322969,1005,100,,Invoice,,,,,,09/08/2018,09/08/2018,0.00,,19.92,,"-761,174.10"
,IN,AR,30322974,1005,100,,Invoice,,,,,,09/08/2018,09/08/2018,0.00,,25.44,,"-761,199.54"
,IN,AR,30323000,1005,100,,Invoice,,,,,,09/08/2018,09/08/2018,0.00,,260.42,,"-761,459.96"
,IN,AR,30323014,1005,100,,Invoice,,,,,,09/08/2018,09/08/2018,0.00,,13.35,,"-761,473.31"
,IN,AR,30323055,1005,100,,Invoice,,,,,,09/08/2018,09/08/2018,0.00,,10.93,,"-761,484.24"
,IN,AR,30323058,1005,100,,Invoice,,,,,,09/08/2018,09/08/2018,0.00,,364.41,,"-761,848.65"
,IN,AR,30323070,1005,100,,Invoice,,,,,,09/08/2018,09/08/2018,0.00,,26.01,,"-761,874.66"
,IN,AR,30323076,1005,100,,Invoice,,,,,,09/08/2018,09/08/2018,0.00,,10.00,,"-761,884.66"
,IN,AR,30323079,1005,100,,Invoice,,,,,,09/08/2018,09/08/2018,0.00,,22.01,,"-761,906.67"
,IN,AR,30323091,1005,100,,Invoice,,,,,,09/08/2018,09/08/2018,0.00,,29.15,,"-761,935.82"
,IN,AR,30323092,1005,100,,Invoice,,,,,,09/08/2018,09/08/2018,0.00,,11.66,,"-761,947.48"
,IN,AR,30323110,1005,100,,Invoice,,,,,,09/08/2018,09/08/2018,0.00,,3.64,,"-761,951.12"
,IN,AR,30323128,1005,100,,Invoice,,,,,,09/08/2018,09/08/2018,0.00,,29.15,,"-761,980.27"
,IN,AR,30323137,1005,100,,Invoice,,,,,,09/08/2018,09/08/2018,0.00,,11.22,,"-761,991.49"
,IN,AR,30323144,1005,100,,Invoice,,,,,,09/08/2018,09/08/2018,0.00,,20.59,,"-762,012.08"
,IN,AR,30323154,1005,100,,Invoice,,,,,,09/08/2018,09/08/2018,0.00,,9.08,,"-762,021.16"
,IN,AR,30323157,1005,100,,Invoice,,,,,,09/08/2018,09/08/2018,0.00,,10.93,,"-762,032.09"
,IN,AR,30323193,1005,100,,Invoice,,,,,,09/08/2018,09/08/2018,0.00,,121.73,,"-762,153.82"
,IN,AR,30323196,1005,100,,Invoice,,,,,,09/08/2018,09/08/2018,0.00,,19.12,,"-762,172.94"
,IN,AR,30323197,1005,100,,Invoice,,,,,,09/08/2018,09/08/2018,0.00,,149.76,,"-762,322.70"
,IN,AR,30323198,1005,100,,Invoice,,,,,,09/08/2018,09/08/2018,0.00,,25.49,,"-762,348.19"
,IN,AR,30323219,1005,100,,Invoice,,,,,,09/08/2018,09/08/2018,0.00,,24.41,,"-762,372.60"
,IN,AR,30323276,1005,100,,Invoice,,,,,,09/08/2018,09/08/2018,0.00,,364.41,,"-762,737.01"
,IN,AR,30323289,1005,100,,Invoice,,,,,,09/08/2018,09/08/2018,0.00,,15.17,,"-762,752.18"
,IN,AR,30323296,1005,100,,Invoice,,,,,,09/08/2018,09/08/2018,0.00,,8.78,,"-762,760.96"
,IN,AR,30323310,1005,100,,Invoice,,,,,,09/08/2018,09/08/2018,0.00,,130.00,,"-762,890.96"
,IN,AR,30323311,1005,100,,Invoice,,,,,,09/08/2018,09/08/2018,0.00,,257.50,,"-763,148.46"
,IN,AR,30323312,1005,100,,Invoice,,,,,,09/08/2018,09/08/2018,0.00,,362.50,,"-763,510.96"
,IN,AR,30323329,1005,100,,Invoice,,,,,,09/08/2018,09/08/2018,0.00,,6.13,,"-763,517.09"
,IN,AR,30323333,1005,100,,Invoice,,,,,,09/08/2018,09/08/2018,0.00,,14.58,,"-763,531.67"
,IN,AR,30323349,1005,100,,Invoice,,,,,,09/08/2018,09/08/2018,0.00,,54.66,,"-763,586.33"
,IN,AR,30323350,1005,100,,Invoice,,,,,,09/08/2018,09/08/2018,0.00,,54.66,,"-763,640.99"
,IN,AR,30323382,1005,100,,Invoice,,,,,,09/08/2018,09/08/2018,0.00,,4.15,,"-763,645.14"
,IN,AR,30323383,1005,100,,Invoice,,,,,,09/08/2018,09/08/2018,0.00,,20.76,,"-763,665.90"
,IN,AR,30323384,1005,100,,Invoice,,,,,,09/08/2018,09/08/2018,0.00,,4.15,,"-763,670.05"
,IN,AR,30323385,1005,100,,Invoice,,,,,,09/08/2018,09/08/2018,0.00,,2.08,,"-763,672.13"
,IN,AR,30323416,1005,100,,Invoice,,,,,,09/08/2018,09/08/2018,0.00,,5.94,,"-763,678.07"
,IN,AR,30323417,1005,100,,Invoice,,,,,,09/08/2018,09/08/2018,0.00,,41.06,,"-763,719.13"
,IN,AR,30323426,1005,100,,Invoice,,,,,,09/08/2018,09/08/2018,0.00,,29.15,,"-763,748.28"
,IN,AR,30323457,1005,100,,Invoice,,,,,,09/08/2018,09/08/2018,0.00,,29.15,,"-763,777.43"
,IN,AR,30323460,1005,100,,Invoice,,,,,,09/08/2018,09/08/2018,0.00,,13.73,,"-763,791.16"
,IN,AR,30323468,1005,100,,Invoice,,,,,,09/08/2018,09/08/2018,0.00,,31.54,,"-763,822.70"
,IN,AR,30323492,1005,100,,Invoice,,,,,,09/08/2018,09/08/2018,0.00,,51.02,,"-763,873.72"
,IN,AR,30323498,1005,100,,Invoice,,,,,,09/08/2018,09/08/2018,0.00,,29.15,,"-763,902.87"
,CN,AR,31018557,1005,100,,Credit Note,,,,,,10/08/2018,10/08/2018,8.00,,0.00,,"-763,894.87"
,CN,AR,31018565,1005,100,,Credit Note,,,,,,10/08/2018,10/08/2018,25.17,,0.00,,"-763,869.70"
,CN,AR,31018573,1005,100,,Credit Note,,,,,,10/08/2018,10/08/2018,364.41,,0.00,,"-763,505.29"
,CS,AR,32007351,1005,100,,Cash sale,,,,,,10/08/2018,10/08/2018,0.00,,11.22,,"-763,516.51"
,CS,AR,32007360,1005,100,,Cash sale,,,,,,10/08/2018,10/08/2018,0.00,,9.49,,"-763,526.00"
,CS,AR,32007370,1005,100,,Cash sale,,,,,,10/08/2018,10/08/2018,0.00,,10.93,,"-763,536.93"
,CS,AR,32007377,1005,100,,Cash sale,,,,,,10/08/2018,10/08/2018,0.00,,14.58,,"-763,551.51"
,CS,AR,32007380,1005,100,,Cash sale,,,,,,10/08/2018,10/08/2018,0.00,,3.64,,"-763,555.15"
,CS,AR,32007382,1005,100,,Cash sale,,,,,,10/08/2018,10/08/2018,0.00,,14.58,,"-763,569.73"
,CS,AR,32007391,1005,100,,Cash sale,,,,,,10/08/2018,10/08/2018,0.00,,87.25,,"-763,656.98"
,CS,AR,32007392,1005,100,,Cash sale,,,,,,10/08/2018,10/08/2018,0.00,,10.93,,"-763,667.91"
,CS,AR,32007394,1005,100,,Cash sale,,,,,,10/08/2018,10/08/2018,0.00,,18.22,,"-763,686.13"
,CS,AR,32007396,1005,100,,Cash sale,,,,,,10/08/2018,10/08/2018,0.00,,7.29,,"-763,693.42"
,CS,AR,32007398,1005,100,,Cash sale,,,,,,10/08/2018,10/08/2018,0.00,,14.49,,"-763,707.91"
,CS,AR,32007409,1005,100,,Cash sale,,,,,,10/08/2018,10/08/2018,0.00,,18.22,,"-763,726.13"
,CS,AR,32007411,1005,100,,Cash sale,,,,,,10/08/2018,10/08/2018,0.00,,16.61,,"-763,742.74"
,CS,AR,32007430,1005,100,,Cash sale,,,,,,10/08/2018,10/08/2018,0.00,,10.93,,"-763,753.67"
,CS,AR,32007434,1005,100,,Cash sale,,,,,,10/08/2018,10/08/2018,0.00,,3.64,,"-763,757.31"
,CS,AR,32007445,1005,100,,Cash sale,,,,,,10/08/2018,10/08/2018,0.00,,8.39,,"-763,765.70"
,CS,AR,32007449,1005,100,,Cash sale,,,,,,10/08/2018,10/08/2018,0.00,,23.29,,"-763,788.99"
,CS,AR,32007451,1005,100,,Cash sale,,,,,,10/08/2018,10/08/2018,0.00,,6.02,,"-763,795.01"
,CS,AR,32007455,1005,100,,Cash sale,,,,,,10/08/2018,10/08/2018,0.00,,10.93,,"-763,805.94"
,CS,AR,32007479,1005,100,,Cash sale,,,,,,10/08/2018,10/08/2018,0.00,,10.81,,"-763,816.75"
,CS,AR,32007485,1005,100,,Cash sale,,,,,,10/08/2018,10/08/2018,0.00,,21.86,,"-763,838.61"
,CS,AR,32007487,1005,100,,Cash sale,,,,,,10/08/2018,10/08/2018,0.00,,2.58,,"-763,841.19"
,CS,AR,32007490,1005,100,,Cash sale,,,,,,10/08/2018,10/08/2018,0.00,,5.08,,"-763,846.27"
,CS,AR,32007502,1005,100,,Cash sale,,,,,,10/08/2018,10/08/2018,0.00,,63.19,,"-763,909.46"
,CS,AR,32007517,1005,100,,Cash sale,,,,,,10/08/2018,10/08/2018,0.00,,14.58,,"-763,924.04"
,CS,AR,32007520,1005,100,,Cash sale,,,,,,10/08/2018,10/08/2018,0.00,,21.06,,"-763,945.10"
,CS,AR,32007522,1005,100,,Cash sale,,,,,,10/08/2018,10/08/2018,0.00,,14.58,,"-763,959.68"
,CS,AR,32007538,1005,100,,Cash sale,,,,,,10/08/2018,10/08/2018,0.00,,12.71,,"-763,972.39"
,CS,AR,32007545,1005,100,,Cash sale,,,,,,10/08/2018,10/08/2018,0.00,,14.62,,"-763,987.01"
,CS,AR,32007550,1005,100,,Cash sale,,,,,,10/08/2018,10/08/2018,0.00,,6.02,,"-763,993.03"
,CS,AR,32007554,1005,100,,Cash sale,,,,,,10/08/2018,10/08/2018,0.00,,18.05,,"-764,011.08"
,CS,AR,32007580,1005,100,,Cash sale,,,,,,10/08/2018,10/08/2018,0.00,,3.64,,"-764,014.72"
,CS,AR,32007582,1005,100,,Cash sale,,,,,,10/08/2018,10/08/2018,0.00,,10.93,,"-764,025.65"
,CS,AR,32007584,1005,100,,Cash sale,,,,,,10/08/2018,10/08/2018,0.00,,10.93,,"-764,036.58"
,CS,AR,32007591,1005,100,,Cash sale,,,,,,10/08/2018,10/08/2018,0.00,,60.17,,"-764,096.75"
,CS,AR,32007620,1005,100,,Cash sale,,,,,,10/08/2018,10/08/2018,0.00,,29.15,,"-764,125.90"
,CS,AR,32007624,1005,100,,Cash sale,,,,,,10/08/2018,10/08/2018,0.00,,3.64,,"-764,129.54"
,CS,AR,32007627,1005,100,,Cash sale,,,,,,10/08/2018,10/08/2018,0.00,,7.29,,"-764,136.83"
,CS,AR,32007628,1005,100,,Cash sale,,,,,,10/08/2018,10/08/2018,0.00,,10.93,,"-764,147.76"
,CS,AR,32007629,1005,100,,Cash sale,,,,,,10/08/2018,10/08/2018,0.00,,7.29,,"-764,155.05"
,CS,AR,32007637,1005,100,,Cash sale,,,,,,10/08/2018,10/08/2018,0.00,,5.17,,"-764,160.22"
,CS,AR,32007641,1005,100,,Cash sale,,,,,,10/08/2018,10/08/2018,0.00,,27.77,,"-764,187.99"
,CS,AR,32007642,1005,100,,Cash sale,,,,,,10/08/2018,10/08/2018,0.00,,6.02,,"-764,194.01"
,CS,AR,32007656,1005,100,,Cash sale,,,,,,10/08/2018,10/08/2018,0.00,,11.12,,"-764,205.13"
,CS,AR,32007666,1005,100,,Cash sale,,,,,,10/08/2018,10/08/2018,0.00,,7.29,,"-764,212.42"
,CS,AR,32007671,1005,100,,Cash sale,,,,,,10/08/2018,10/08/2018,0.00,,10.93,,"-764,223.35"
,CS,AR,32007674,1005,100,,Cash sale,,,,,,10/08/2018,10/08/2018,0.00,,21.90,,"-764,245.25"
,CS,AR,32007688,1005,100,,Cash sale,,,,,,10/08/2018,10/08/2018,0.00,,6.12,,"-764,251.37"
,CS,AR,32007701,1005,100,,Cash sale,,,,,,10/08/2018,10/08/2018,0.00,,26.00,,"-764,277.37"
,CS,AR,32007706,1005,100,,Cash sale,,,,,,10/08/2018,10/08/2018,0.00,,12.71,,"-764,290.08"
,CS,AR,32007709,1005,100,,Cash sale,,,,,,10/08/2018,10/08/2018,0.00,,12.03,,"-764,302.11"
,CS,AR,32007716,1005,100,,Cash sale,,,,,,10/08/2018,10/08/2018,0.00,,14.58,,"-764,316.69"
,CS,AR,32007718,1005,100,,Cash sale,,,,,,10/08/2018,10/08/2018,0.00,,5.08,,"-764,321.77"
,CS,AR,32007721,1005,100,,Cash sale,,,,,,10/08/2018,10/08/2018,0.00,,5.18,,"-764,326.95"
,CS,AR,32007727,1005,100,,Cash sale,,,,,,10/08/2018,10/08/2018,0.00,,9.15,,"-764,336.10"
,CS,AR,32007758,1005,100,,Cash sale,,,,,,10/08/2018,10/08/2018,0.00,,7.29,,"-764,343.39"
,CS,AR,32007759,1005,100,,Cash sale,,,,,,10/08/2018,10/08/2018,0.00,,24.29,,"-764,367.68"
,CS,AR,32007763,1005,100,,Cash sale,,,,,,10/08/2018,10/08/2018,0.00,,10.93,,"-764,378.61"
,CS,AR,32007770,1005,100,,Cash sale,,,,,,10/08/2018,10/08/2018,0.00,,7.29,,"-764,385.90"
,CS,AR,32007774,1005,100,,Cash sale,,,,,,10/08/2018,10/08/2018,0.00,,5.08,,"-764,390.98"
,CS,AR,32007776,1005,100,,Cash sale,,,,,,10/08/2018,10/08/2018,0.00,,3.64,,"-764,394.62"
,CS,AR,32007779,1005,100,,Cash sale,,,,,,10/08/2018,10/08/2018,0.00,,10.93,,"-764,405.55"
,CS,AR,32007780,1005,100,,Cash sale,,,,,,10/08/2018,10/08/2018,0.00,,8.31,,"-764,413.86"
,CS,AR,32007782,1005,100,,Cash sale,,,,,,10/08/2018,10/08/2018,0.00,,7.29,,"-764,421.15"
,CS,AR,32007783,1005,100,,Cash sale,,,,,,10/08/2018,10/08/2018,0.00,,5.83,,"-764,426.98"
,CS,AR,32007791,1005,100,,Cash sale,,,,,,10/08/2018,10/08/2018,0.00,,10.93,,"-764,437.91"
,CS,AR,32007809,1005,100,,Cash sale,,,,,,10/08/2018,10/08/2018,0.00,,3.01,,"-764,440.92"
,CS,AR,32007837,1005,100,,Cash sale,,,,,,10/08/2018,10/08/2018,0.00,,9.32,,"-764,450.24"
,CS,AR,32007839,1005,100,,Cash sale,,,,,,10/08/2018,10/08/2018,0.00,,6.07,,"-764,456.31"
,CS,AR,32007844,1005,100,,Cash sale,,,,,,10/08/2018,10/08/2018,0.00,,14.58,,"-764,470.89"
,CS,AR,32007856,1005,100,,Cash sale,,,,,,10/08/2018,10/08/2018,0.00,,14.58,,"-764,485.47"
,CS,AR,32007861,1005,100,,Cash sale,,,,,,10/08/2018,10/08/2018,0.00,,10.93,,"-764,496.40"
,CS,AR,32007869,1005,100,,Cash sale,,,,,,10/08/2018,10/08/2018,0.00,,3.64,,"-764,500.04"
,IN,AR,30322223,1005,100,,Invoice,,,,,,10/08/2018,10/08/2018,0.00,,44.49,,"-764,544.53"
,IN,AR,30322224,1005,100,,Invoice,,,,,,10/08/2018,10/08/2018,0.00,,59.32,,"-764,603.85"
,IN,AR,30322230,1005,100,,Invoice,,,,,,10/08/2018,10/08/2018,0.00,,36.44,,"-764,640.29"
,IN,AR,30322239,1005,100,,Invoice,,,,,,10/08/2018,10/08/2018,0.00,,364.41,,"-765,004.70"
,IN,AR,30322241,1005,100,,Invoice,,,,,,10/08/2018,10/08/2018,0.00,,19.58,,"-765,024.28"
,IN,AR,30322269,1005,100,,Invoice,,,,,,10/08/2018,10/08/2018,0.00,,14.58,,"-765,038.86"
,IN,AR,30322278,1005,100,,Invoice,,,,,,10/08/2018,10/08/2018,0.00,,9.13,,"-765,047.99"
,IN,AR,30322286,1005,100,,Invoice,,,,,,10/08/2018,10/08/2018,0.00,,14.49,,"-765,062.48"
,IN,AR,30322287,1005,100,,Invoice,,,,,,10/08/2018,10/08/2018,0.00,,54.66,,"-765,117.14"
,IN,AR,30322288,1005,100,,Invoice,,,,,,10/08/2018,10/08/2018,0.00,,182.20,,"-765,299.34"
,IN,AR,30322295,1005,100,,Invoice,,,,,,10/08/2018,10/08/2018,0.00,,97.22,,"-765,396.56"
,IN,AR,30322306,1005,100,,Invoice,,,,,,10/08/2018,10/08/2018,0.00,,9.19,,"-765,405.75"
,IN,AR,30322310,1005,100,,Invoice,,,,,,10/08/2018,10/08/2018,0.00,,98.97,,"-765,504.72"
,IN,AR,30322319,1005,100,,Invoice,,,,,,10/08/2018,10/08/2018,0.00,,42.71,,"-765,547.43"
,IN,AR,30322335,1005,100,,Invoice,,,,,,10/08/2018,10/08/2018,0.00,,10.93,,"-765,558.36"
,IN,AR,30322341,1005,100,,Invoice,,,,,,10/08/2018,10/08/2018,0.00,,364.41,,"-765,922.77"
,IN,AR,30322352,1005,100,,Invoice,,,,,,10/08/2018,10/08/2018,0.00,,182.20,,"-766,104.97"
,IN,AR,30322364,1005,100,,Invoice,,,,,,10/08/2018,10/08/2018,0.00,,50.00,,"-766,154.97"
,IN,AR,30322372,1005,100,,Invoice,,,,,,10/08/2018,10/08/2018,0.00,,54.66,,"-766,209.63"
,IN,AR,30322387,1005,100,,Invoice,,,,,,10/08/2018,10/08/2018,0.00,,7.78,,"-766,217.41"
,IN,AR,30322399,1005,100,,Invoice,,,,,,10/08/2018,10/08/2018,0.00,,7.12,,"-766,224.53"
,IN,AR,30322402,1005,100,,Invoice,,,,,,10/08/2018,10/08/2018,0.00,,8.00,,"-766,232.53"
,IN,AR,30322403,1005,100,,Invoice,,,,,,10/08/2018,10/08/2018,0.00,,18.00,,"-766,250.53"
,IN,AR,30322409,1005,100,,Invoice,,,,,,10/08/2018,10/08/2018,0.00,,54.66,,"-766,305.19"
,IN,AR,30322413,1005,100,,Invoice,,,,,,10/08/2018,10/08/2018,0.00,,54.66,,"-766,359.85"
,IN,AR,30322420,1005,100,,Invoice,,,,,,10/08/2018,10/08/2018,0.00,,54.66,,"-766,414.51"
,IN,AR,30322421,1005,100,,Invoice,,,,,,10/08/2018,10/08/2018,0.00,,364.41,,"-766,778.92"
,IN,AR,30322431,1005,100,,Invoice,,,,,,10/08/2018,10/08/2018,0.00,,364.41,,"-767,143.33"
,IN,AR,30322432,1005,100,,Invoice,,,,,,10/08/2018,10/08/2018,0.00,,13.58,,"-767,156.91"
,IN,AR,30322433,1005,100,,Invoice,,,,,,10/08/2018,10/08/2018,0.00,,11.64,,"-767,168.55"
,IN,AR,30322440,1005,100,,Invoice,,,,,,10/08/2018,10/08/2018,0.00,,48.00,,"-767,216.55"
,IN,AR,30322444,1005,100,,Invoice,,,,,,10/08/2018,10/08/2018,0.00,,3.64,,"-767,220.19"
,IN,AR,30322453,1005,100,,Invoice,,,,,,10/08/2018,10/08/2018,0.00,,25.51,,"-767,245.70"
,IN,AR,30322455,1005,100,,Invoice,,,,,,10/08/2018,10/08/2018,0.00,,182.20,,"-767,427.90"
,IN,AR,30322456,1005,100,,Invoice,,,,,,10/08/2018,10/08/2018,0.00,,10.93,,"-767,438.83"
,IN,AR,30322457,1005,100,,Invoice,,,,,,10/08/2018,10/08/2018,0.00,,364.41,,"-767,803.24"
,IN,AR,30322458,1005,100,,Invoice,,,,,,10/08/2018,10/08/2018,0.00,,25.17,,"-767,828.41"
,IN,AR,30322459,1005,100,,Invoice,,,,,,10/08/2018,10/08/2018,0.00,,11.19,,"-767,839.60"
,IN,AR,30322461,1005,100,,Invoice,,,,,,10/08/2018,10/08/2018,0.00,,33.81,,"-767,873.41"
,IN,AR,30322486,1005,100,,Invoice,,,,,,10/08/2018,10/08/2018,0.00,,5.17,,"-767,878.58"
,IN,AR,30322491,1005,100,,Invoice,,,,,,10/08/2018,10/08/2018,0.00,,29.15,,"-767,907.73"
,IN,AR,30322497,1005,100,,Invoice,,,,,,10/08/2018,10/08/2018,0.00,,14.58,,"-767,922.31"
,IN,AR,30322499,1005,100,,Invoice,,,,,,10/08/2018,10/08/2018,0.00,,29.15,,"-767,951.46"
,IN,AR,30322502,1005,100,,Invoice,,,,,,10/08/2018,10/08/2018,0.00,,7.19,,"-767,958.65"
,IN,AR,30322508,1005,100,,Invoice,,,,,,10/08/2018,10/08/2018,0.00,,54.66,,"-768,013.31"
,IN,AR,30322509,1005,100,,Invoice,,,,,,10/08/2018,10/08/2018,0.00,,54.66,,"-768,067.97"
,IN,AR,30322512,1005,100,,Invoice,,,,,,10/08/2018,10/08/2018,0.00,,7.29,,"-768,075.26"
,IN,AR,30322519,1005,100,,Invoice,,,,,,10/08/2018,10/08/2018,0.00,,12.03,,"-768,087.29"
,IN,AR,30322529,1005,100,,Invoice,,,,,,10/08/2018,10/08/2018,0.00,,91.10,,"-768,178.39"
,IN,AR,30322533,1005,100,,Invoice,,,,,,10/08/2018,10/08/2018,0.00,,182.20,,"-768,360.59"
,IN,AR,30322536,1005,100,,Invoice,,,,,,10/08/2018,10/08/2018,0.00,,54.66,,"-768,415.25"
,IN,AR,30322537,1005,100,,Invoice,,,,,,10/08/2018,10/08/2018,0.00,,54.66,,"-768,469.91"
,IN,AR,30322544,1005,100,,Invoice,,,,,,10/08/2018,10/08/2018,0.00,,33.60,,"-768,503.51"
,IN,AR,30322548,1005,100,,Invoice,,,,,,10/08/2018,10/08/2018,0.00,,7.17,,"-768,510.68"
,IN,AR,30322552,1005,100,,Invoice,,,,,,10/08/2018,10/08/2018,0.00,,10.93,,"-768,521.61"
,IN,AR,30322556,1005,100,,Invoice,,,,,,10/08/2018,10/08/2018,0.00,,"1,093.22",,"-769,614.83"
,IN,AR,30322559,1005,100,,Invoice,,,,,,10/08/2018,10/08/2018,0.00,,5.18,,"-769,620.01"
,IN,AR,30322568,1005,100,,Invoice,,,,,,10/08/2018,10/08/2018,0.00,,3.01,,"-769,623.02"
,IN,AR,30322571,1005,100,,Invoice,,,,,,10/08/2018,10/08/2018,0.00,,54.66,,"-769,677.68"
,IN,AR,30322580,1005,100,,Invoice,,,,,,10/08/2018,10/08/2018,0.00,,59.47,,"-769,737.15"
,IN,AR,30322584,1005,100,,Invoice,,,,,,10/08/2018,10/08/2018,0.00,,106.78,,"-769,843.93"
,IN,AR,30322585,1005,100,,Invoice,,,,,,10/08/2018,10/08/2018,0.00,,7.63,,"-769,851.56"
,IN,AR,30322590,1005,100,,Invoice,,,,,,10/08/2018,10/08/2018,0.00,,182.20,,"-770,033.76"
,IN,AR,30322594,1005,100,,Invoice,,,,,,10/08/2018,10/08/2018,0.00,,14.34,,"-770,048.10"
,IN,AR,30322595,1005,100,,Invoice,,,,,,10/08/2018,10/08/2018,0.00,,11.95,,"-770,060.05"
,IN,AR,30322608,1005,100,,Invoice,,,,,,10/08/2018,10/08/2018,0.00,,6.02,,"-770,066.07"
,IN,AR,30322617,1005,100,,Invoice,,,,,,10/08/2018,10/08/2018,0.00,,364.41,,"-770,430.48"
,IN,AR,30322620,1005,100,,Invoice,,,,,,10/08/2018,10/08/2018,0.00,,11.65,,"-770,442.13"
,IN,AR,30322627,1005,100,,Invoice,,,,,,10/08/2018,10/08/2018,0.00,,4.24,,"-770,446.37"
,IN,AR,30322633,1005,100,,Invoice,,,,,,10/08/2018,10/08/2018,0.00,,4.78,,"-770,451.15"
,IN,AR,30322638,1005,100,,Invoice,,,,,,10/08/2018,10/08/2018,0.00,,10.17,,"-770,461.32"
,IN,AR,30322639,1005,100,,Invoice,,,,,,10/08/2018,10/08/2018,0.00,,5.08,,"-770,466.40"
,IN,AR,30322649,1005,100,,Invoice,,,,,,10/08/2018,10/08/2018,0.00,,2.54,,"-770,468.94"
,IN,AR,30322650,1005,100,,Invoice,,,,,,10/08/2018,10/08/2018,0.00,,54.66,,"-770,523.60"
,IN,AR,30322661,1005,100,,Invoice,,,,,,10/08/2018,10/08/2018,0.00,,182.20,,"-770,705.80"
,IN,AR,30322670,1005,100,,Invoice,,,,,,10/08/2018,10/08/2018,0.00,,20.34,,"-770,726.14"
,IN,AR,30322674,1005,100,,Invoice,,,,,,10/08/2018,10/08/2018,0.00,,8.47,,"-770,734.61"
,IN,AR,30322680,1005,100,,Invoice,,,,,,10/08/2018,10/08/2018,0.00,,"1,093.22",,"-771,827.83"
,IN,AR,30322686,1005,100,,Invoice,,,,,,10/08/2018,10/08/2018,0.00,,364.41,,"-772,192.24"
,IN,AR,30322687,1005,100,,Invoice,,,,,,10/08/2018,10/08/2018,0.00,,14.58,,"-772,206.82"
,IN,AR,30322698,1005,100,,Invoice,,,,,,10/08/2018,10/08/2018,0.00,,29.15,,"-772,235.97"
,IN,AR,30322699,1005,100,,Invoice,,,,,,10/08/2018,10/08/2018,0.00,,22.50,,"-772,258.47"
,IN,AR,30322745,1005,100,,Invoice,,,,,,10/08/2018,10/08/2018,0.00,,22.44,,"-772,280.91"
,IN,AR,30322765,1005,100,,Invoice,,,,,,10/08/2018,10/08/2018,0.00,,364.41,,"-772,645.32"
,IN,AR,30322767,1005,100,,Invoice,,,,,,10/08/2018,10/08/2018,0.00,,182.20,,"-772,827.52"
,IN,AR,30322768,1005,100,,Invoice,,,,,,10/08/2018,10/08/2018,0.00,,364.41,,"-773,191.93"
,IN,AR,30322773,1005,100,,Invoice,,,,,,10/08/2018,10/08/2018,0.00,,14.58,,"-773,206.51"
,IN,AR,30322774,1005,100,,Invoice,,,,,,10/08/2018,10/08/2018,0.00,,182.20,,"-773,388.71"
,IN,AR,30322777,1005,100,,Invoice,,,,,,10/08/2018,10/08/2018,0.00,,54.66,,"-773,443.37"
,IN,AR,30322778,1005,100,,Invoice,,,,,,10/08/2018,10/08/2018,0.00,,4.24,,"-773,447.61"
,IN,AR,30322799,1005,100,,Invoice,,,,,,10/08/2018,10/08/2018,0.00,,364.41,,"-773,812.02"
,IN,AR,30322803,1005,100,,Invoice,,,,,,10/08/2018,10/08/2018,0.00,,3.22,,"-773,815.24"
,IN,AR,30322810,1005,100,,Invoice,,,,,,10/08/2018,10/08/2018,0.00,,17.56,,"-773,832.80"
,IN,AR,30322816,1005,100,,Invoice,,,,,,10/08/2018,10/08/2018,0.00,,54.66,,"-773,887.46"
,IN,AR,30322824,1005,100,,Invoice,,,,,,10/08/2018,10/08/2018,0.00,,5.17,,"-773,892.63"
,IN,AR,30322830,1005,100,,Invoice,,,,,,10/08/2018,10/08/2018,0.00,,182.20,,"-774,074.83"
,IN,AR,30322845,1005,100,,Invoice,,,,,,10/08/2018,10/08/2018,0.00,,182.20,,"-774,257.03"
,IN,AR,30322846,1005,100,,Invoice,,,,,,10/08/2018,10/08/2018,0.00,,54.66,,"-774,311.69"
,IN,AR,30322854,1005,100,,Invoice,,,,,,10/08/2018,10/08/2018,0.00,,54.66,,"-774,366.35"
,IN,AR,30322855,1005,100,,Invoice,,,,,,10/08/2018,10/08/2018,0.00,,54.66,,"-774,421.01"
,IN,AR,30322862,1005,100,,Invoice,,,,,,10/08/2018,10/08/2018,0.00,,6.53,,"-774,427.54"
,IN,AR,30322863,1005,100,,Invoice,,,,,,10/08/2018,10/08/2018,0.00,,364.41,,"-774,791.95"
,IN,AR,30322865,1005,100,,Invoice,,,,,,10/08/2018,10/08/2018,0.00,,19.87,,"-774,811.82"
,IN,AR,30322877,1005,100,,Invoice,,,,,,10/08/2018,10/08/2018,0.00,,64.32,,"-774,876.14"
,IN,AR,30322893,1005,100,,Invoice,,,,,,10/08/2018,10/08/2018,0.00,,8.81,,"-774,884.95"
,IN,AR,30322904,1005,100,,Invoice,,,,,,10/08/2018,10/08/2018,0.00,,4.85,,"-774,889.80"
,IN,AR,30322912,1005,100,,Invoice,,,,,,10/08/2018,10/08/2018,0.00,,54.66,,"-774,944.46"
,IN,AR,30322913,1005,100,,Invoice,,,,,,10/08/2018,10/08/2018,0.00,,91.10,,"-775,035.56"
,IN,AR,30322915,1005,100,,Invoice,,,,,,10/08/2018,10/08/2018,0.00,,54.66,,"-775,090.22"
,IN,AR,30322916,1005,100,,Invoice,,,,,,10/08/2018,10/08/2018,0.00,,29.15,,"-775,119.37"
,IN,AR,30322920,1005,100,,Invoice,,,,,,10/08/2018,10/08/2018,0.00,,54.66,,"-775,174.03"
,IN,AR,30322923,1005,100,,Invoice,,,,,,10/08/2018,10/08/2018,0.00,,14.58,,"-775,188.61"
,IN,AR,30322963,1005,100,,Invoice,,,,,,10/08/2018,10/08/2018,0.00,,54.66,,"-775,243.27"
,IN,AR,30322964,1005,100,,Invoice,,,,,,10/08/2018,10/08/2018,0.00,,54.66,,"-775,297.93"
,IN,AR,30322975,1005,100,,Invoice,,,,,,10/08/2018,10/08/2018,0.00,,17.49,,"-775,315.42"
,IN,AR,30322986,1005,100,,Invoice,,,,,,10/08/2018,10/08/2018,0.00,,53.94,,"-775,369.36"
,IN,AR,30322991,1005,100,,Invoice,,,,,,10/08/2018,10/08/2018,0.00,,20.00,,"-775,389.36"
,IN,AR,30322993,1005,100,,Invoice,,,,,,10/08/2018,10/08/2018,0.00,,49.75,,"-775,439.11"
,IN,AR,30322998,1005,100,,Invoice,,,,,,10/08/2018,10/08/2018,0.00,,5.93,,"-775,445.04"
,IN,AR,30323007,1005,100,,Invoice,,,,,,10/08/2018,10/08/2018,0.00,,34.08,,"-775,479.12"
,IN,AR,30323017,1005,100,,Invoice,,,,,,10/08/2018,10/08/2018,0.00,,27.32,,"-775,506.44"
,IN,AR,30323022,1005,100,,Invoice,,,,,,10/08/2018,10/08/2018,0.00,,47.54,,"-775,553.98"
,IN,AR,30323031,1005,100,,Invoice,,,,,,10/08/2018,10/08/2018,0.00,,14.01,,"-775,567.99"
,IN,AR,30323033,1005,100,,Invoice,,,,,,10/08/2018,10/08/2018,0.00,,28.90,,"-775,596.89"
,IN,AR,30323040,1005,100,,Invoice,,,,,,10/08/2018,10/08/2018,0.00,,14.58,,"-775,611.47"
,IN,AR,30323051,1005,100,,Invoice,,,,,,10/08/2018,10/08/2018,0.00,,23.91,,"-775,635.38"
,IN,AR,30323057,1005,100,,Invoice,,,,,,10/08/2018,10/08/2018,0.00,,182.20,,"-775,817.58"
,IN,AR,30323072,1005,100,,Invoice,,,,,,10/08/2018,10/08/2018,0.00,,14.00,,"-775,831.58"
,IN,AR,30323083,1005,100,,Invoice,,,,,,10/08/2018,10/08/2018,0.00,,22.01,,"-775,853.59"
,IN,AR,30323088,1005,100,,Invoice,,,,,,10/08/2018,10/08/2018,0.00,,54.66,,"-775,908.25"
,IN,AR,30323096,1005,100,,Invoice,,,,,,10/08/2018,10/08/2018,0.00,,18.22,,"-775,926.47"
,IN,AR,30323101,1005,100,,Invoice,,,,,,10/08/2018,10/08/2018,0.00,,79.49,,"-776,005.96"
,IN,AR,30323111,1005,100,,Invoice,,,,,,10/08/2018,10/08/2018,0.00,,32.85,,"-776,038.81"
,IN,AR,30323115,1005,100,,Invoice,,,,,,10/08/2018,10/08/2018,0.00,,46.25,,"-776,085.06"
,IN,AR,30323116,1005,100,,Invoice,,,,,,10/08/2018,10/08/2018,0.00,,18.92,,"-776,103.98"
,IN,AR,30323152,1005,100,,Invoice,,,,,,10/08/2018,10/08/2018,0.00,,70.00,,"-776,173.98"
,IN,AR,30323158,1005,100,,Invoice,,,,,,10/08/2018,10/08/2018,0.00,,29.15,,"-776,203.13"
,IN,AR,30323174,1005,100,,Invoice,,,,,,10/08/2018,10/08/2018,0.00,,54.66,,"-776,257.79"
,IN,AR,30323178,1005,100,,Invoice,,,,,,10/08/2018,10/08/2018,0.00,,29.15,,"-776,286.94"
,IN,AR,30323179,1005,100,,Invoice,,,,,,10/08/2018,10/08/2018,0.00,,29.15,,"-776,316.09"
,IN,AR,30323190,1005,100,,Invoice,,,,,,10/08/2018,10/08/2018,0.00,,1.61,,"-776,317.70"
,IN,AR,30323212,1005,100,,Invoice,,,,,,10/08/2018,10/08/2018,0.00,,29.49,,"-776,347.19"
,IN,AR,30323233,1005,100,,Invoice,,,,,,10/08/2018,10/08/2018,0.00,,54.66,,"-776,401.85"
,IN,AR,30323275,1005,100,,Invoice,,,,,,10/08/2018,10/08/2018,0.00,,364.41,,"-776,766.26"
,IN,AR,30323277,1005,100,,Invoice,,,,,,10/08/2018,10/08/2018,0.00,,10.95,,"-776,777.21"
,IN,AR,30323282,1005,100,,Invoice,,,,,,10/08/2018,10/08/2018,0.00,,25.42,,"-776,802.63"
,IN,AR,30323313,1005,100,,Invoice,,,,,,10/08/2018,10/08/2018,0.00,,7.29,,"-776,809.92"
,IN,AR,30323316,1005,100,,Invoice,,,,,,10/08/2018,10/08/2018,0.00,,182.20,,"-776,992.12"
,IN,AR,30323324,1005,100,,Invoice,,,,,,10/08/2018,10/08/2018,0.00,,8.17,,"-777,000.29"
,IN,AR,30323335,1005,100,,Invoice,,,,,,10/08/2018,10/08/2018,0.00,,43.73,,"-777,044.02"
,IN,AR,30323351,1005,100,,Invoice,,,,,,10/08/2018,10/08/2018,0.00,,7.97,,"-777,051.99"
,IN,AR,30323356,1005,100,,Invoice,,,,,,10/08/2018,10/08/2018,0.00,,29.15,,"-777,081.14"
,IN,AR,30323358,1005,100,,Invoice,,,,,,10/08/2018,10/08/2018,0.00,,54.66,,"-777,135.80"
,IN,AR,30323366,1005,100,,Invoice,,,,,,10/08/2018,10/08/2018,0.00,,6.07,,"-777,141.87"
,IN,AR,30323372,1005,100,,Invoice,,,,,,10/08/2018,10/08/2018,0.00,,4.00,,"-777,145.87"
,IN,AR,30323414,1005,100,,Invoice,,,,,,10/08/2018,10/08/2018,0.00,,2.54,,"-777,148.41"
,IN,AR,30323421,1005,100,,Invoice,,,,,,10/08/2018,10/08/2018,0.00,,54.66,,"-777,203.07"
,IN,AR,30323429,1005,100,,Invoice,,,,,,10/08/2018,10/08/2018,0.00,,6.20,,"-777,209.27"
,IN,AR,30323437,1005,100,,Invoice,,,,,,10/08/2018,10/08/2018,0.00,,10.93,,"-777,220.20"
,IN,AR,30323450,1005,100,,Invoice,,,,,,10/08/2018,10/08/2018,0.00,,29.15,,"-777,249.35"
,IN,AR,30323461,1005,100,,Invoice,,,,,,10/08/2018,10/08/2018,0.00,,21.97,,"-777,271.32"
,IN,AR,30323480,1005,100,,Invoice,,,,,,10/08/2018,10/08/2018,0.00,,9.10,,"-777,280.42"
,IN,AR,30323484,1005,100,,Invoice,,,,,,10/08/2018,10/08/2018,0.00,,3.64,,"-777,284.06"
,IN,AR,30323500,1005,100,,Invoice,,,,,,10/08/2018,10/08/2018,0.00,,29.15,,"-777,313.21"
,IN,AR,30323502,1005,100,,Invoice,,,,,,10/08/2018,10/08/2018,0.00,,182.20,,"-777,495.41"
,CN,AR,31018564,1005,100,,Credit Note,,,,,,11/08/2018,11/08/2018,10.93,,0.00,,"-777,484.48"
,CN,AR,31018568,1005,100,,Credit Note,,,,,,11/08/2018,11/08/2018,14.58,,0.00,,"-777,469.90"
,CN,AR,31018596,1005,100,,Credit Note,,,,,,11/08/2018,11/08/2018,14.58,,0.00,,"-777,455.32"
,CN,AR,31018608,1005,100,,Credit Note,,,,,,11/08/2018,11/08/2018,18.22,,0.00,,"-777,437.10"
,CN,AR,31018613,1005,100,,Credit Note,,,,,,11/08/2018,11/08/2018,10.93,,0.00,,"-777,426.17"
,CN,AR,31018625,1005,100,,Credit Note,,,,,,11/08/2018,11/08/2018,"2,332.20",,0.00,,"-775,093.97"
,CN,AR,31018633,1005,100,,Credit Note,,,,,,11/08/2018,11/08/2018,14.58,,0.00,,"-775,079.39"
,CN,AR,31018638,1005,100,,Credit Note,,,,,,11/08/2018,11/08/2018,112.50,,0.00,,"-774,966.89"
,CN,AR,31018642,1005,100,,Credit Note,,,,,,11/08/2018,11/08/2018,10.93,,0.00,,"-774,955.96"
,CS,AR,32007368,1005,100,,Cash sale,,,,,,11/08/2018,11/08/2018,0.00,,9.03,,"-774,964.99"
,CS,AR,32007402,1005,100,,Cash sale,,,,,,11/08/2018,11/08/2018,0.00,,10.93,,"-774,975.92"
,CS,AR,32007440,1005,100,,Cash sale,,,,,,11/08/2018,11/08/2018,0.00,,3.64,,"-774,979.56"
,CS,AR,32007528,1005,100,,Cash sale,,,,,,11/08/2018,11/08/2018,0.00,,10.93,,"-774,990.49"
,CS,AR,32007542,1005,100,,Cash sale,,,,,,11/08/2018,11/08/2018,0.00,,7.00,,"-774,997.49"
,CS,AR,32007568,1005,100,,Cash sale,,,,,,11/08/2018,11/08/2018,0.00,,7.29,,"-775,004.78"
,CS,AR,32007845,1005,100,,Cash sale,,,,,,11/08/2018,11/08/2018,0.00,,3.64,,"-775,008.42"
,IN,AR,30322320,1005,100,,Invoice,,,,,,11/08/2018,11/08/2018,0.00,,90.17,,"-775,098.59"
,IN,AR,30322384,1005,100,,Invoice,,,,,,11/08/2018,11/08/2018,0.00,,18.22,,"-775,116.81"
,IN,AR,30322793,1005,100,,Invoice,,,,,,11/08/2018,11/08/2018,0.00,,2.16,,"-775,118.97"
,IN,AR,30322878,1005,100,,Invoice,,,,,,11/08/2018,11/08/2018,0.00,,107.20,,"-775,226.17"
,IN,AR,30322887,1005,100,,Invoice,,,,,,11/08/2018,11/08/2018,0.00,,13.14,,"-775,239.31"
,IN,AR,30323099,1005,100,,Invoice,,,,,,11/08/2018,11/08/2018,0.00,,29.15,,"-775,268.46"
,IN,AR,30323249,1005,100,,Invoice,,,,,,11/08/2018,11/08/2018,0.00,,10.93,,"-775,279.39"
,IN,AR,30323336,1005,100,,Invoice,,,,,,11/08/2018,11/08/2018,0.00,,"2,332.20",,"-777,611.59"
,IN,AR,30323462,1005,100,,Invoice,,,,,,11/08/2018,11/08/2018,0.00,,27.46,,"-777,639.05"
,CN,AR,31018560,1005,100,,Credit Note,,,,,,12/08/2018,12/08/2018,16.27,,0.00,,"-777,622.78"
,CN,AR,31018561,1005,100,,Credit Note,,,,,,12/08/2018,12/08/2018,97.62,,0.00,,"-777,525.16"
,CS,AR,32007849,1005,100,,Cash sale,,,,,,12/08/2018,12/08/2018,0.00,,10.93,,"-777,536.09"
,IN,AR,30322426,1005,100,,Invoice,,,,,,12/08/2018,12/08/2018,0.00,,780.96,,"-778,317.05"
,IN,AR,30322439,1005,100,,Invoice,,,,,,12/08/2018,12/08/2018,0.00,,10.93,,"-778,327.98"
,CN,AR,31018546,1005,100,,Credit Note,,,,,,13/08/2018,13/08/2018,2.97,,0.00,,"-778,325.01"
,CS,AR,32007352,1005,100,,Cash sale,,,,,,13/08/2018,13/08/2018,0.00,,22.44,,"-778,347.45"
,CS,AR,32007375,1005,100,,Cash sale,,,,,,13/08/2018,13/08/2018,0.00,,3.64,,"-778,351.09"
,CS,AR,32007389,1005,100,,Cash sale,,,,,,13/08/2018,13/08/2018,0.00,,7.29,,"-778,358.38"
,CS,AR,32007405,1005,100,,Cash sale,,,,,,13/08/2018,13/08/2018,0.00,,7.29,,"-778,365.67"
,CS,AR,32007412,1005,100,,Cash sale,,,,,,13/08/2018,13/08/2018,0.00,,10.38,,"-778,376.05"
,CS,AR,32007417,1005,100,,Cash sale,,,,,,13/08/2018,13/08/2018,0.00,,14.58,,"-778,390.63"
,CS,AR,32007436,1005,100,,Cash sale,,,,,,13/08/2018,13/08/2018,0.00,,7.29,,"-778,397.92"
,CS,AR,32007463,1005,100,,Cash sale,,,,,,13/08/2018,13/08/2018,0.00,,7.75,,"-778,405.67"
,CS,AR,32007482,1005,100,,Cash sale,,,,,,13/08/2018,13/08/2018,0.00,,10.93,,"-778,416.60"
,CS,AR,32007483,1005,100,,Cash sale,,,,,,13/08/2018,13/08/2018,0.00,,7.29,,"-778,423.89"
,CS,AR,32007491,1005,100,,Cash sale,,,,,,13/08/2018,13/08/2018,0.00,,20.34,,"-778,444.23"
,CS,AR,32007508,1005,100,,Cash sale,,,,,,13/08/2018,13/08/2018,0.00,,19.24,,"-778,463.47"
,CS,AR,32007519,1005,100,,Cash sale,,,,,,13/08/2018,13/08/2018,0.00,,27.08,,"-778,490.55"
,CS,AR,32007525,1005,100,,Cash sale,,,,,,13/08/2018,13/08/2018,0.00,,7.29,,"-778,497.84"
,CS,AR,32007539,1005,100,,Cash sale,,,,,,13/08/2018,13/08/2018,0.00,,10.17,,"-778,508.01"
,CS,AR,32007546,1005,100,,Cash sale,,,,,,13/08/2018,13/08/2018,0.00,,20.47,,"-778,528.48"
,CS,AR,32007553,1005,100,,Cash sale,,,,,,13/08/2018,13/08/2018,0.00,,20.68,,"-778,549.16"
,CS,AR,32007593,1005,100,,Cash sale,,,,,,13/08/2018,13/08/2018,0.00,,5.08,,"-778,554.24"
,CS,AR,32007611,1005,100,,Cash sale,,,,,,13/08/2018,13/08/2018,0.00,,7.75,,"-778,561.99"
,CS,AR,32007614,1005,100,,Cash sale,,,,,,13/08/2018,13/08/2018,0.00,,3.64,,"-778,565.63"
,CS,AR,32007623,1005,100,,Cash sale,,,,,,13/08/2018,13/08/2018,0.00,,10.93,,"-778,576.56"
,CS,AR,32007643,1005,100,,Cash sale,,,,,,13/08/2018,13/08/2018,0.00,,3.64,,"-778,580.20"
,CS,AR,32007649,1005,100,,Cash sale,,,,,,13/08/2018,13/08/2018,0.00,,7.29,,"-778,587.49"
,CS,AR,32007650,1005,100,,Cash sale,,,,,,13/08/2018,13/08/2018,0.00,,3.64,,"-778,591.13"
,CS,AR,32007667,1005,100,,Cash sale,,,,,,13/08/2018,13/08/2018,0.00,,10.93,,"-778,602.06"
,CS,AR,32007685,1005,100,,Cash sale,,,,,,13/08/2018,13/08/2018,0.00,,6.53,,"-778,608.59"
,CS,AR,32007705,1005,100,,Cash sale,,,,,,13/08/2018,13/08/2018,0.00,,18.20,,"-778,626.79"
,CS,AR,32007725,1005,100,,Cash sale,,,,,,13/08/2018,13/08/2018,0.00,,7.29,,"-778,634.08"
,CS,AR,32007728,1005,100,,Cash sale,,,,,,13/08/2018,13/08/2018,0.00,,11.44,,"-778,645.52"
,CS,AR,32007760,1005,100,,Cash sale,,,,,,13/08/2018,13/08/2018,0.00,,18.21,,"-778,663.73"
,CS,AR,32007771,1005,100,,Cash sale,,,,,,13/08/2018,13/08/2018,0.00,,7.29,,"-778,671.02"
,CS,AR,32007786,1005,100,,Cash sale,,,,,,13/08/2018,13/08/2018,0.00,,3.64,,"-778,674.66"
,CS,AR,32007787,1005,100,,Cash sale,,,,,,13/08/2018,13/08/2018,0.00,,14.58,,"-778,689.24"
,CS,AR,32007812,1005,100,,Cash sale,,,,,,13/08/2018,13/08/2018,0.00,,3.64,,"-778,692.88"
,CS,AR,32007838,1005,100,,Cash sale,,,,,,13/08/2018,13/08/2018,0.00,,6.99,,"-778,699.87"
,CS,AR,32007840,1005,100,,Cash sale,,,,,,13/08/2018,13/08/2018,0.00,,6.07,,"-778,705.94"
,CS,AR,32007846,1005,100,,Cash sale,,,,,,13/08/2018,13/08/2018,0.00,,7.29,,"-778,713.23"
,IN,AR,30322221,1005,100,,Invoice,,,,,,13/08/2018,13/08/2018,0.00,,54.66,,"-778,767.89"
,IN,AR,30322225,1005,100,,Invoice,,,,,,13/08/2018,13/08/2018,0.00,,29.66,,"-778,797.55"
,IN,AR,30322232,1005,100,,Invoice,,,,,,13/08/2018,13/08/2018,0.00,,182.20,,"-778,979.75"
,IN,AR,30322234,1005,100,,Invoice,,,,,,13/08/2018,13/08/2018,0.00,,21.86,,"-779,001.61"
,IN,AR,30322237,1005,100,,Invoice,,,,,,13/08/2018,13/08/2018,0.00,,"1,093.22",,"-780,094.83"
,IN,AR,30322250,1005,100,,Invoice,,,,,,13/08/2018,13/08/2018,0.00,,"1,093.22",,"-781,188.05"
,IN,AR,30322252,1005,100,,Invoice,,,,,,13/08/2018,13/08/2018,0.00,,4.05,,"-781,192.10"
,IN,AR,30322253,1005,100,,Invoice,,,,,,13/08/2018,13/08/2018,0.00,,10.13,,"-781,202.23"
,IN,AR,30322254,1005,100,,Invoice,,,,,,13/08/2018,13/08/2018,0.00,,10.13,,"-781,212.36"
,IN,AR,30322255,1005,100,,Invoice,,,,,,13/08/2018,13/08/2018,0.00,,14.18,,"-781,226.54"
,IN,AR,30322256,1005,100,,Invoice,,,,,,13/08/2018,13/08/2018,0.00,,18.23,,"-781,244.77"
,IN,AR,30322257,1005,100,,Invoice,,,,,,13/08/2018,13/08/2018,0.00,,4.05,,"-781,248.82"
,IN,AR,30322258,1005,100,,Invoice,,,,,,13/08/2018,13/08/2018,0.00,,2.03,,"-781,250.85"
,IN,AR,30322259,1005,100,,Invoice,,,,,,13/08/2018,13/08/2018,0.00,,6.08,,"-781,256.93"
,IN,AR,30322267,1005,100,,Invoice,,,,,,13/08/2018,13/08/2018,0.00,,7.12,,"-781,264.05"
,IN,AR,30322296,1005,100,,Invoice,,,,,,13/08/2018,13/08/2018,0.00,,23.25,,"-781,287.30"
,IN,AR,30322301,1005,100,,Invoice,,,,,,13/08/2018,13/08/2018,0.00,,18.22,,"-781,305.52"
,IN,AR,30322312,1005,100,,Invoice,,,,,,13/08/2018,13/08/2018,0.00,,3.64,,"-781,309.16"
,IN,AR,30322321,1005,100,,Invoice,,,,,,13/08/2018,13/08/2018,0.00,,142.37,,"-781,451.53"
,IN,AR,30322328,1005,100,,Invoice,,,,,,13/08/2018,13/08/2018,0.00,,16.53,,"-781,468.06"
,IN,AR,30322337,1005,100,,Invoice,,,,,,13/08/2018,13/08/2018,0.00,,76.00,,"-781,544.06"
,IN,AR,30322350,1005,100,,Invoice,,,,,,13/08/2018,13/08/2018,0.00,,53.03,,"-781,597.09"
,IN,AR,30322362,1005,100,,Invoice,,,,,,13/08/2018,13/08/2018,0.00,,3.64,,"-781,600.73"
,IN,AR,30322365,1005,100,,Invoice,,,,,,13/08/2018,13/08/2018,0.00,,30.00,,"-781,630.73"
,IN,AR,30322366,1005,100,,Invoice,,,,,,13/08/2018,13/08/2018,0.00,,38.00,,"-781,668.73"
,IN,AR,30322373,1005,100,,Invoice,,,,,,13/08/2018,13/08/2018,0.00,,54.66,,"-781,723.39"
,IN,AR,30322375,1005,100,,Invoice,,,,,,13/08/2018,13/08/2018,0.00,,5.51,,"-781,728.90"
,IN,AR,30322376,1005,100,,Invoice,,,,,,13/08/2018,13/08/2018,0.00,,13.77,,"-781,742.67"
,IN,AR,30322377,1005,100,,Invoice,,,,,,13/08/2018,13/08/2018,0.00,,58.47,,"-781,801.14"
,IN,AR,30322386,1005,100,,Invoice,,,,,,13/08/2018,13/08/2018,0.00,,3.64,,"-781,804.78"
,IN,AR,30322388,1005,100,,Invoice,,,,,,13/08/2018,13/08/2018,0.00,,13.62,,"-781,818.40"
,IN,AR,30322394,1005,100,,Invoice,,,,,,13/08/2018,13/08/2018,0.00,,11.69,,"-781,830.09"
,IN,AR,30322404,1005,100,,Invoice,,,,,,13/08/2018,13/08/2018,0.00,,26.00,,"-781,856.09"
,IN,AR,30322441,1005,100,,Invoice,,,,,,13/08/2018,13/08/2018,0.00,,34.00,,"-781,890.09"
,IN,AR,30322462,1005,100,,Invoice,,,,,,13/08/2018,13/08/2018,0.00,,4.83,,"-781,894.92"
,IN,AR,30322468,1005,100,,Invoice,,,,,,13/08/2018,13/08/2018,0.00,,36.44,,"-781,931.36"
,IN,AR,30322472,1005,100,,Invoice,,,,,,13/08/2018,13/08/2018,0.00,,94.75,,"-782,026.11"
,IN,AR,30322476,1005,100,,Invoice,,,,,,13/08/2018,13/08/2018,0.00,,9.56,,"-782,035.67"
,IN,AR,30322479,1005,100,,Invoice,,,,,,13/08/2018,13/08/2018,0.00,,20.68,,"-782,056.35"
,IN,AR,30322488,1005,100,,Invoice,,,,,,13/08/2018,13/08/2018,0.00,,10.34,,"-782,066.69"
,IN,AR,30322492,1005,100,,Invoice,,,,,,13/08/2018,13/08/2018,0.00,,29.15,,"-782,095.84"
,IN,AR,30322500,1005,100,,Invoice,,,,,,13/08/2018,13/08/2018,0.00,,54.66,,"-782,150.50"
,IN,AR,30322506,1005,100,,Invoice,,,,,,13/08/2018,13/08/2018,0.00,,18.37,,"-782,168.87"
,IN,AR,30322526,1005,100,,Invoice,,,,,,13/08/2018,13/08/2018,0.00,,61.02,,"-782,229.89"
,IN,AR,30322534,1005,100,,Invoice,,,,,,13/08/2018,13/08/2018,0.00,,29.15,,"-782,259.04"
,IN,AR,30322545,1005,100,,Invoice,,,,,,13/08/2018,13/08/2018,0.00,,36.19,,"-782,295.23"
,IN,AR,30322550,1005,100,,Invoice,,,,,,13/08/2018,13/08/2018,0.00,,54.66,,"-782,349.89"
,IN,AR,30322557,1005,100,,Invoice,,,,,,13/08/2018,13/08/2018,0.00,,8.90,,"-782,358.79"
,IN,AR,30322566,1005,100,,Invoice,,,,,,13/08/2018,13/08/2018,0.00,,3.64,,"-782,362.43"
,IN,AR,30322581,1005,100,,Invoice,,,,,,13/08/2018,13/08/2018,0.00,,92.29,,"-782,454.72"
,IN,AR,30322586,1005,100,,Invoice,,,,,,13/08/2018,13/08/2018,0.00,,58.47,,"-782,513.19"
,IN,AR,30322596,1005,100,,Invoice,,,,,,13/08/2018,13/08/2018,0.00,,9.56,,"-782,522.75"
,IN,AR,30322597,1005,100,,Invoice,,,,,,13/08/2018,13/08/2018,0.00,,23.90,,"-782,546.65"
,IN,AR,30322601,1005,100,,Invoice,,,,,,13/08/2018,13/08/2018,0.00,,28.98,,"-782,575.63"
,IN,AR,30322612,1005,100,,Invoice,,,,,,13/08/2018,13/08/2018,0.00,,2.12,,"-782,577.75"
,IN,AR,30322614,1005,100,,Invoice,,,,,,13/08/2018,13/08/2018,0.00,,7.29,,"-782,585.04"
,IN,AR,30322623,1005,100,,Invoice,,,,,,13/08/2018,13/08/2018,0.00,,6.36,,"-782,591.40"
,IN,AR,30322628,1005,100,,Invoice,,,,,,13/08/2018,13/08/2018,0.00,,6.02,,"-782,597.42"
,IN,AR,30322635,1005,100,,Invoice,,,,,,13/08/2018,13/08/2018,0.00,,364.41,,"-782,961.83"
,IN,AR,30322640,1005,100,,Invoice,,,,,,13/08/2018,13/08/2018,0.00,,5.08,,"-782,966.91"
,IN,AR,30322667,1005,100,,Invoice,,,,,,13/08/2018,13/08/2018,0.00,,39.11,,"-783,006.02"
,IN,AR,30322668,1005,100,,Invoice,,,,,,13/08/2018,13/08/2018,0.00,,30.08,,"-783,036.10"
,IN,AR,30322681,1005,100,,Invoice,,,,,,13/08/2018,13/08/2018,0.00,,7.17,,"-783,043.27"
,IN,AR,30322695,1005,100,,Invoice,,,,,,13/08/2018,13/08/2018,0.00,,27.97,,"-783,071.24"
,IN,AR,30322703,1005,100,,Invoice,,,,,,13/08/2018,13/08/2018,0.00,,14.24,,"-783,085.48"
,IN,AR,30322712,1005,100,,Invoice,,,,,,13/08/2018,13/08/2018,0.00,,14.58,,"-783,100.06"
,IN,AR,30322714,1005,100,,Invoice,,,,,,13/08/2018,13/08/2018,0.00,,7.29,,"-783,107.35"
,IN,AR,30322715,1005,100,,Invoice,,,,,,13/08/2018,13/08/2018,0.00,,14.58,,"-783,121.93"
,IN,AR,30322733,1005,100,,Invoice,,,,,,13/08/2018,13/08/2018,0.00,,11.02,,"-783,132.95"
,IN,AR,30322735,1005,100,,Invoice,,,,,,13/08/2018,13/08/2018,0.00,,3.64,,"-783,136.59"
,IN,AR,30322743,1005,100,,Invoice,,,,,,13/08/2018,13/08/2018,0.00,,20.67,,"-783,157.26"
,IN,AR,30322750,1005,100,,Invoice,,,,,,13/08/2018,13/08/2018,0.00,,15.76,,"-783,173.02"
,IN,AR,30322771,1005,100,,Invoice,,,,,,13/08/2018,13/08/2018,0.00,,54.66,,"-783,227.68"
,IN,AR,30322772,1005,100,,Invoice,,,,,,13/08/2018,13/08/2018,0.00,,29.15,,"-783,256.83"
,IN,AR,30322775,1005,100,,Invoice,,,,,,13/08/2018,13/08/2018,0.00,,14.58,,"-783,271.41"
,IN,AR,30322776,1005,100,,Invoice,,,,,,13/08/2018,13/08/2018,0.00,,5.85,,"-783,277.26"
,IN,AR,30322782,1005,100,,Invoice,,,,,,13/08/2018,13/08/2018,0.00,,10.59,,"-783,287.85"
,IN,AR,30322785,1005,100,,Invoice,,,,,,13/08/2018,13/08/2018,0.00,,14.83,,"-783,302.68"
,IN,AR,30322795,1005,100,,Invoice,,,,,,13/08/2018,13/08/2018,0.00,,32.00,,"-783,334.68"
,IN,AR,30322835,1005,100,,Invoice,,,,,,13/08/2018,13/08/2018,0.00,,42.69,,"-783,377.37"
,IN,AR,30322841,1005,100,,Invoice,,,,,,13/08/2018,13/08/2018,0.00,,2.25,,"-783,379.62"
,IN,AR,30322857,1005,100,,Invoice,,,,,,13/08/2018,13/08/2018,0.00,,31.14,,"-783,410.76"
,IN,AR,30322872,1005,100,,Invoice,,,,,,13/08/2018,13/08/2018,0.00,,9.85,,"-783,420.61"
,IN,AR,30322879,1005,100,,Invoice,,,,,,13/08/2018,13/08/2018,0.00,,150.08,,"-783,570.69"
,IN,AR,30322901,1005,100,,Invoice,,,,,,13/08/2018,13/08/2018,0.00,,7.29,,"-783,577.98"
,IN,AR,30322919,1005,100,,Invoice,,,,,,13/08/2018,13/08/2018,0.00,,10.99,,"-783,588.97"
,IN,AR,30322933,1005,100,,Invoice,,,,,,13/08/2018,13/08/2018,0.00,,54.66,,"-783,643.63"
,IN,AR,30322936,1005,100,,Invoice,,,,,,13/08/2018,13/08/2018,0.00,,54.66,,"-783,698.29"
,IN,AR,30322938,1005,100,,Invoice,,,,,,13/08/2018,13/08/2018,0.00,,54.66,,"-783,752.95"
,IN,AR,30322939,1005,100,,Invoice,,,,,,13/08/2018,13/08/2018,0.00,,4.29,,"-783,757.24"
,IN,AR,30322946,1005,100,,Invoice,,,,,,13/08/2018,13/08/2018,0.00,,10.93,,"-783,768.17"
,IN,AR,30322957,1005,100,,Invoice,,,,,,13/08/2018,13/08/2018,0.00,,17.54,,"-783,785.71"
,IN,AR,30322995,1005,100,,Invoice,,,,,,13/08/2018,13/08/2018,0.00,,4.29,,"-783,790.00"
,IN,AR,30323008,1005,100,,Invoice,,,,,,13/08/2018,13/08/2018,0.00,,42.09,,"-783,832.09"
,IN,AR,30323018,1005,100,,Invoice,,,,,,13/08/2018,13/08/2018,0.00,,21.25,,"-783,853.34"
,IN,AR,30323028,1005,100,,Invoice,,,,,,13/08/2018,13/08/2018,0.00,,10.93,,"-783,864.27"
,IN,AR,30323034,1005,100,,Invoice,,,,,,13/08/2018,13/08/2018,0.00,,44.66,,"-783,908.93"
,IN,AR,30323038,1005,100,,Invoice,,,,,,13/08/2018,13/08/2018,0.00,,4.58,,"-783,913.51"
,IN,AR,30323044,1005,100,,Invoice,,,,,,13/08/2018,13/08/2018,0.00,,54.66,,"-783,968.17"
,IN,AR,30323073,1005,100,,Invoice,,,,,,13/08/2018,13/08/2018,0.00,,14.00,,"-783,982.17"
,IN,AR,30323084,1005,100,,Invoice,,,,,,13/08/2018,13/08/2018,0.00,,22.01,,"-784,004.18"
,IN,AR,30323090,1005,100,,Invoice,,,,,,13/08/2018,13/08/2018,0.00,,"1,093.22",,"-785,097.40"
,IN,AR,30323104,1005,100,,Invoice,,,,,,13/08/2018,13/08/2018,0.00,,69.39,,"-785,166.79"
,IN,AR,30323109,1005,100,,Invoice,,,,,,13/08/2018,13/08/2018,0.00,,25.51,,"-785,192.30"
,IN,AR,30323117,1005,100,,Invoice,,,,,,13/08/2018,13/08/2018,0.00,,4.20,,"-785,196.50"
,IN,AR,30323132,1005,100,,Invoice,,,,,,13/08/2018,13/08/2018,0.00,,24.16,,"-785,220.66"
,IN,AR,30323133,1005,100,,Invoice,,,,,,13/08/2018,13/08/2018,0.00,,195.76,,"-785,416.42"
,IN,AR,30323138,1005,100,,Invoice,,,,,,13/08/2018,13/08/2018,0.00,,14.03,,"-785,430.45"
,IN,AR,30323141,1005,100,,Invoice,,,,,,13/08/2018,13/08/2018,0.00,,29.15,,"-785,459.60"
,IN,AR,30323146,1005,100,,Invoice,,,,,,13/08/2018,13/08/2018,0.00,,54.66,,"-785,514.26"
,IN,AR,30323176,1005,100,,Invoice,,,,,,13/08/2018,13/08/2018,0.00,,21.86,,"-785,536.12"
,IN,AR,30323185,1005,100,,Invoice,,,,,,13/08/2018,13/08/2018,0.00,,29.15,,"-785,565.27"
,IN,AR,30323187,1005,100,,Invoice,,,,,,13/08/2018,13/08/2018,0.00,,364.41,,"-785,929.68"
,IN,AR,30323191,1005,100,,Invoice,,,,,,13/08/2018,13/08/2018,0.00,,42.71,,"-785,972.39"
,IN,AR,30323199,1005,100,,Invoice,,,,,,13/08/2018,13/08/2018,0.00,,22.31,,"-785,994.70"
,IN,AR,30323200,1005,100,,Invoice,,,,,,13/08/2018,13/08/2018,0.00,,17.53,,"-786,012.23"
,IN,AR,30323234,1005,100,,Invoice,,,,,,13/08/2018,13/08/2018,0.00,,18.00,,"-786,030.23"
,IN,AR,30323237,1005,100,,Invoice,,,,,,13/08/2018,13/08/2018,0.00,,3.76,,"-786,033.99"
,IN,AR,30323238,1005,100,,Invoice,,,,,,13/08/2018,13/08/2018,0.00,,7.53,,"-786,041.52"
,IN,AR,30323252,1005,100,,Invoice,,,,,,13/08/2018,13/08/2018,0.00,,15.90,,"-786,057.42"
,IN,AR,30323272,1005,100,,Invoice,,,,,,13/08/2018,13/08/2018,0.00,,29.15,,"-786,086.57"
,IN,AR,30323278,1005,100,,Invoice,,,,,,13/08/2018,13/08/2018,0.00,,10.95,,"-786,097.52"
,IN,AR,30323287,1005,100,,Invoice,,,,,,13/08/2018,13/08/2018,0.00,,54.66,,"-786,152.18"
,IN,AR,30323288,1005,100,,Invoice,,,,,,13/08/2018,13/08/2018,0.00,,54.66,,"-786,206.84"
,IN,AR,30323295,1005,100,,Invoice,,,,,,13/08/2018,13/08/2018,0.00,,73.02,,"-786,279.86"
,IN,AR,30323315,1005,100,,Invoice,,,,,,13/08/2018,13/08/2018,0.00,,29.15,,"-786,309.01"
,IN,AR,30323318,1005,100,,Invoice,,,,,,13/08/2018,13/08/2018,0.00,,7.02,,"-786,316.03"
,IN,AR,30323325,1005,100,,Invoice,,,,,,13/08/2018,13/08/2018,0.00,,6.13,,"-786,322.16"
,IN,AR,30323344,1005,100,,Invoice,,,,,,13/08/2018,13/08/2018,0.00,,8.25,,"-786,330.41"
,IN,AR,30323359,1005,100,,Invoice,,,,,,13/08/2018,13/08/2018,0.00,,35.08,,"-786,365.49"
,IN,AR,30323370,1005,100,,Invoice,,,,,,13/08/2018,13/08/2018,0.00,,29.15,,"-786,394.64"
,IN,AR,30323373,1005,100,,Invoice,,,,,,13/08/2018,13/08/2018,0.00,,4.00,,"-786,398.64"
,IN,AR,30323374,1005,100,,Invoice,,,,,,13/08/2018,13/08/2018,0.00,,2.00,,"-786,400.64"
,IN,AR,30323386,1005,100,,Invoice,,,,,,13/08/2018,13/08/2018,0.00,,6.23,,"-786,406.87"
,IN,AR,30323387,1005,100,,Invoice,,,,,,13/08/2018,13/08/2018,0.00,,8.31,,"-786,415.18"
,IN,AR,30323388,1005,100,,Invoice,,,,,,13/08/2018,13/08/2018,0.00,,10.38,,"-786,425.56"
,IN,AR,30323389,1005,100,,Invoice,,,,,,13/08/2018,13/08/2018,0.00,,4.15,,"-786,429.71"
,IN,AR,30323390,1005,100,,Invoice,,,,,,13/08/2018,13/08/2018,0.00,,2.08,,"-786,431.79"
,IN,AR,30323391,1005,100,,Invoice,,,,,,13/08/2018,13/08/2018,0.00,,16.61,,"-786,448.40"
,IN,AR,30323392,1005,100,,Invoice,,,,,,13/08/2018,13/08/2018,0.00,,56.06,,"-786,504.46"
,IN,AR,30323438,1005,100,,Invoice,,,,,,13/08/2018,13/08/2018,0.00,,14.58,,"-786,519.04"
,IN,AR,30323469,1005,100,,Invoice,,,,,,13/08/2018,13/08/2018,0.00,,50.47,,"-786,569.51"
,CN,AR,31018552,1005,100,,Credit Note,,,,,,14/08/2018,14/08/2018,7.29,,0.00,,"-786,562.22"
,CN,AR,31018643,1005,100,,Credit Note,,,,,,14/08/2018,14/08/2018,5.17,,0.00,,"-786,557.05"
,CN,AR,31018645,1005,100,,Credit Note,,,,,,14/08/2018,14/08/2018,10.93,,0.00,,"-786,546.12"
,CS,AR,32007367,1005,100,,Cash sale,,,,,,14/08/2018,14/08/2018,0.00,,10.93,,"-786,557.05"
,CS,AR,32007378,1005,100,,Cash sale,,,,,,14/08/2018,14/08/2018,0.00,,7.29,,"-786,564.34"
,CS,AR,32007388,1005,100,,Cash sale,,,,,,14/08/2018,14/08/2018,0.00,,10.93,,"-786,575.27"
,CS,AR,32007393,1005,100,,Cash sale,,,,,,14/08/2018,14/08/2018,0.00,,7.29,,"-786,582.56"
,CS,AR,32007400,1005,100,,Cash sale,,,,,,14/08/2018,14/08/2018,0.00,,6.02,,"-786,588.58"
,CS,AR,32007408,1005,100,,Cash sale,,,,,,14/08/2018,14/08/2018,0.00,,7.29,,"-786,595.87"
,CS,AR,32007415,1005,100,,Cash sale,,,,,,14/08/2018,14/08/2018,0.00,,10.93,,"-786,606.80"
,CS,AR,32007423,1005,100,,Cash sale,,,,,,14/08/2018,14/08/2018,0.00,,10.93,,"-786,617.73"
,CS,AR,32007424,1005,100,,Cash sale,,,,,,14/08/2018,14/08/2018,0.00,,3.64,,"-786,621.37"
,CS,AR,32007428,1005,100,,Cash sale,,,,,,14/08/2018,14/08/2018,0.00,,6.02,,"-786,627.39"
,CS,AR,32007448,1005,100,,Cash sale,,,,,,14/08/2018,14/08/2018,0.00,,7.29,,"-786,634.68"
,CS,AR,32007486,1005,100,,Cash sale,,,,,,14/08/2018,14/08/2018,0.00,,18.22,,"-786,652.90"
,CS,AR,32007494,1005,100,,Cash sale,,,,,,14/08/2018,14/08/2018,0.00,,19.58,,"-786,672.48"
,CS,AR,32007495,1005,100,,Cash sale,,,,,,14/08/2018,14/08/2018,0.00,,10.34,,"-786,682.82"
,CS,AR,32007496,1005,100,,Cash sale,,,,,,14/08/2018,14/08/2018,0.00,,5.68,,"-786,688.50"
,CS,AR,32007505,1005,100,,Cash sale,,,,,,14/08/2018,14/08/2018,0.00,,7.29,,"-786,695.79"
,CS,AR,32007506,1005,100,,Cash sale,,,,,,14/08/2018,14/08/2018,0.00,,7.29,,"-786,703.08"
,CS,AR,32007511,1005,100,,Cash sale,,,,,,14/08/2018,14/08/2018,0.00,,15.04,,"-786,718.12"
,CS,AR,32007527,1005,100,,Cash sale,,,,,,14/08/2018,14/08/2018,0.00,,8.58,,"-786,726.70"
,CS,AR,32007531,1005,100,,Cash sale,,,,,,14/08/2018,14/08/2018,0.00,,3.64,,"-786,730.34"
,CS,AR,32007536,1005,100,,Cash sale,,,,,,14/08/2018,14/08/2018,0.00,,7.63,,"-786,737.97"
,CS,AR,32007544,1005,100,,Cash sale,,,,,,14/08/2018,14/08/2018,0.00,,6.74,,"-786,744.71"
,CS,AR,32007561,1005,100,,Cash sale,,,,,,14/08/2018,14/08/2018,0.00,,14.58,,"-786,759.29"
,CS,AR,32007574,1005,100,,Cash sale,,,,,,14/08/2018,14/08/2018,0.00,,3.64,,"-786,762.93"
,CS,AR,32007575,1005,100,,Cash sale,,,,,,14/08/2018,14/08/2018,0.00,,7.80,,"-786,770.73"
,CS,AR,32007577,1005,100,,Cash sale,,,,,,14/08/2018,14/08/2018,0.00,,7.29,,"-786,778.02"
,CS,AR,32007583,1005,100,,Cash sale,,,,,,14/08/2018,14/08/2018,0.00,,5.08,,"-786,783.10"
,CS,AR,32007587,1005,100,,Cash sale,,,,,,14/08/2018,14/08/2018,0.00,,15.51,,"-786,798.61"
,CS,AR,32007595,1005,100,,Cash sale,,,,,,14/08/2018,14/08/2018,0.00,,12.92,,"-786,811.53"
,CS,AR,32007599,1005,100,,Cash sale,,,,,,14/08/2018,14/08/2018,0.00,,3.90,,"-786,815.43"
,CS,AR,32007601,1005,100,,Cash sale,,,,,,14/08/2018,14/08/2018,0.00,,14.58,,"-786,830.01"
,CS,AR,32007608,1005,100,,Cash sale,,,,,,14/08/2018,14/08/2018,0.00,,3.64,,"-786,833.65"
,CS,AR,32007617,1005,100,,Cash sale,,,,,,14/08/2018,14/08/2018,0.00,,7.29,,"-786,840.94"
,CS,AR,32007619,1005,100,,Cash sale,,,,,,14/08/2018,14/08/2018,0.00,,7.29,,"-786,848.23"
,CS,AR,32007632,1005,100,,Cash sale,,,,,,14/08/2018,14/08/2018,0.00,,3.64,,"-786,851.87"
,CS,AR,32007640,1005,100,,Cash sale,,,,,,14/08/2018,14/08/2018,0.00,,5.17,,"-786,857.04"
,CS,AR,32007646,1005,100,,Cash sale,,,,,,14/08/2018,14/08/2018,0.00,,10.93,,"-786,867.97"
,CS,AR,32007657,1005,100,,Cash sale,,,,,,14/08/2018,14/08/2018,0.00,,10.93,,"-786,878.90"
,CS,AR,32007662,1005,100,,Cash sale,,,,,,14/08/2018,14/08/2018,0.00,,7.29,,"-786,886.19"
,CS,AR,32007675,1005,100,,Cash sale,,,,,,14/08/2018,14/08/2018,0.00,,7.29,,"-786,893.48"
,CS,AR,32007680,1005,100,,Cash sale,,,,,,14/08/2018,14/08/2018,0.00,,22.88,,"-786,916.36"
,CS,AR,32007683,1005,100,,Cash sale,,,,,,14/08/2018,14/08/2018,0.00,,15.04,,"-786,931.40"
,CS,AR,32007690,1005,100,,Cash sale,,,,,,14/08/2018,14/08/2018,0.00,,5.17,,"-786,936.57"
,CS,AR,32007696,1005,100,,Cash sale,,,,,,14/08/2018,14/08/2018,0.00,,6.86,,"-786,943.43"
,CS,AR,32007697,1005,100,,Cash sale,,,,,,14/08/2018,14/08/2018,0.00,,7.63,,"-786,951.06"
,CS,AR,32007699,1005,100,,Cash sale,,,,,,14/08/2018,14/08/2018,0.00,,32.00,,"-786,983.06"
,CS,AR,32007702,1005,100,,Cash sale,,,,,,14/08/2018,14/08/2018,0.00,,60.00,,"-787,043.06"
,CS,AR,32007707,1005,100,,Cash sale,,,,,,14/08/2018,14/08/2018,0.00,,3.64,,"-787,046.70"
,CS,AR,32007720,1005,100,,Cash sale,,,,,,14/08/2018,14/08/2018,0.00,,8.20,,"-787,054.90"
,CS,AR,32007734,1005,100,,Cash sale,,,,,,14/08/2018,14/08/2018,0.00,,2.97,,"-787,057.87"
,CS,AR,32007740,1005,100,,Cash sale,,,,,,14/08/2018,14/08/2018,0.00,,14.83,,"-787,072.70"
,CS,AR,32007750,1005,100,,Cash sale,,,,,,14/08/2018,14/08/2018,0.00,,14.58,,"-787,087.28"
,CS,AR,32007852,1005,100,,Cash sale,,,,,,14/08/2018,14/08/2018,0.00,,7.29,,"-787,094.57"
,CS,AR,32007858,1005,100,,Cash sale,,,,,,14/08/2018,14/08/2018,0.00,,7.75,,"-787,102.32"
,IN,AR,30322219,1005,100,,Invoice,,,,,,14/08/2018,14/08/2018,0.00,,9.03,,"-787,111.35"
,IN,AR,30322226,1005,100,,Invoice,,,,,,14/08/2018,14/08/2018,0.00,,68.22,,"-787,179.57"
,IN,AR,30322277,1005,100,,Invoice,,,,,,14/08/2018,14/08/2018,0.00,,3.64,,"-787,183.21"
,IN,AR,30322289,1005,100,,Invoice,,,,,,14/08/2018,14/08/2018,0.00,,3.64,,"-787,186.85"
,IN,AR,30322291,1005,100,,Invoice,,,,,,14/08/2018,14/08/2018,0.00,,7.00,,"-787,193.85"
,IN,AR,30322304,1005,100,,Invoice,,,,,,14/08/2018,14/08/2018,0.00,,65.59,,"-787,259.44"
,IN,AR,30322308,1005,100,,Invoice,,,,,,14/08/2018,14/08/2018,0.00,,14.58,,"-787,274.02"
,IN,AR,30322313,1005,100,,Invoice,,,,,,14/08/2018,14/08/2018,0.00,,7.97,,"-787,281.99"
,IN,AR,30322322,1005,100,,Invoice,,,,,,14/08/2018,14/08/2018,0.00,,9.49,,"-787,291.48"
,IN,AR,30322346,1005,100,,Invoice,,,,,,14/08/2018,14/08/2018,0.00,,18.22,,"-787,309.70"
,IN,AR,30322349,1005,100,,Invoice,,,,,,14/08/2018,14/08/2018,0.00,,7.29,,"-787,316.99"
,IN,AR,30322355,1005,100,,Invoice,,,,,,14/08/2018,14/08/2018,0.00,,3.64,,"-787,320.63"
,IN,AR,30322358,1005,100,,Invoice,,,,,,14/08/2018,14/08/2018,0.00,,10.93,,"-787,331.56"
,IN,AR,30322383,1005,100,,Invoice,,,,,,14/08/2018,14/08/2018,0.00,,10.93,,"-787,342.49"
,IN,AR,30322392,1005,100,,Invoice,,,,,,14/08/2018,14/08/2018,0.00,,62.00,,"-787,404.49"
,IN,AR,30322410,1005,100,,Invoice,,,,,,14/08/2018,14/08/2018,0.00,,54.66,,"-787,459.15"
,IN,AR,30322418,1005,100,,Invoice,,,,,,14/08/2018,14/08/2018,0.00,,54.66,,"-787,513.81"
,IN,AR,30322425,1005,100,,Invoice,,,,,,14/08/2018,14/08/2018,0.00,,14.58,,"-787,528.39"
,IN,AR,30322450,1005,100,,Invoice,,,,,,14/08/2018,14/08/2018,0.00,,7.29,,"-787,535.68"
,IN,AR,30322451,1005,100,,Invoice,,,,,,14/08/2018,14/08/2018,0.00,,12.03,,"-787,547.71"
,IN,AR,30322467,1005,100,,Invoice,,,,,,14/08/2018,14/08/2018,0.00,,7.96,,"-787,555.67"
,IN,AR,30322503,1005,100,,Invoice,,,,,,14/08/2018,14/08/2018,0.00,,11.99,,"-787,567.66"
,IN,AR,30322511,1005,100,,Invoice,,,,,,14/08/2018,14/08/2018,0.00,,2.54,,"-787,570.20"
,IN,AR,30322516,1005,100,,Invoice,,,,,,14/08/2018,14/08/2018,0.00,,27.97,,"-787,598.17"
,IN,AR,30322520,1005,100,,Invoice,,,,,,14/08/2018,14/08/2018,0.00,,8.47,,"-787,606.64"
,IN,AR,30322524,1005,100,,Invoice,,,,,,14/08/2018,14/08/2018,0.00,,2.12,,"-787,608.76"
,IN,AR,30322527,1005,100,,Invoice,,,,,,14/08/2018,14/08/2018,0.00,,18.31,,"-787,627.07"
,IN,AR,30322531,1005,100,,Invoice,,,,,,14/08/2018,14/08/2018,0.00,,2.12,,"-787,629.19"
,IN,AR,30322535,1005,100,,Invoice,,,,,,14/08/2018,14/08/2018,0.00,,8.47,,"-787,637.66"
,IN,AR,30322554,1005,100,,Invoice,,,,,,14/08/2018,14/08/2018,0.00,,167.47,,"-787,805.13"
,IN,AR,30322569,1005,100,,Invoice,,,,,,14/08/2018,14/08/2018,0.00,,15.04,,"-787,820.17"
,IN,AR,30322575,1005,100,,Invoice,,,,,,14/08/2018,14/08/2018,0.00,,182.20,,"-788,002.37"
,IN,AR,30322576,1005,100,,Invoice,,,,,,14/08/2018,14/08/2018,0.00,,5.85,,"-788,008.22"
,IN,AR,30322602,1005,100,,Invoice,,,,,,14/08/2018,14/08/2018,0.00,,6.44,,"-788,014.66"
,IN,AR,30322609,1005,100,,Invoice,,,,,,14/08/2018,14/08/2018,0.00,,9.03,,"-788,023.69"
,IN,AR,30322622,1005,100,,Invoice,,,,,,14/08/2018,14/08/2018,0.00,,7.75,,"-788,031.44"
,IN,AR,30322630,1005,100,,Invoice,,,,,,14/08/2018,14/08/2018,0.00,,216.07,,"-788,247.51"
,IN,AR,30322636,1005,100,,Invoice,,,,,,14/08/2018,14/08/2018,0.00,,3.90,,"-788,251.41"
,IN,AR,30322641,1005,100,,Invoice,,,,,,14/08/2018,14/08/2018,0.00,,10.17,,"-788,261.58"
,IN,AR,30322642,1005,100,,Invoice,,,,,,14/08/2018,14/08/2018,0.00,,5.08,,"-788,266.66"
,IN,AR,30322654,1005,100,,Invoice,,,,,,14/08/2018,14/08/2018,0.00,,54.66,,"-788,321.32"
,IN,AR,30322659,1005,100,,Invoice,,,,,,14/08/2018,14/08/2018,0.00,,12.71,,"-788,334.03"
,IN,AR,30322669,1005,100,,Invoice,,,,,,14/08/2018,14/08/2018,0.00,,6.13,,"-788,340.16"
,IN,AR,30322672,1005,100,,Invoice,,,,,,14/08/2018,14/08/2018,0.00,,7.29,,"-788,347.45"
,IN,AR,30322678,1005,100,,Invoice,,,,,,14/08/2018,14/08/2018,0.00,,7.29,,"-788,354.74"
,IN,AR,30322682,1005,100,,Invoice,,,,,,14/08/2018,14/08/2018,0.00,,7.80,,"-788,362.54"
,IN,AR,30322690,1005,100,,Invoice,,,,,,14/08/2018,14/08/2018,0.00,,28.47,,"-788,391.01"
,IN,AR,30322701,1005,100,,Invoice,,,,,,14/08/2018,14/08/2018,0.00,,3.01,,"-788,394.02"
,IN,AR,30322705,1005,100,,Invoice,,,,,,14/08/2018,14/08/2018,0.00,,9.92,,"-788,403.94"
,IN,AR,30322710,1005,100,,Invoice,,,,,,14/08/2018,14/08/2018,0.00,,10.53,,"-788,414.47"
,IN,AR,30322717,1005,100,,Invoice,,,,,,14/08/2018,14/08/2018,0.00,,21.19,,"-788,435.66"
,IN,AR,30322725,1005,100,,Invoice,,,,,,14/08/2018,14/08/2018,0.00,,4.24,,"-788,439.90"
,IN,AR,30322729,1005,100,,Invoice,,,,,,14/08/2018,14/08/2018,0.00,,14.83,,"-788,454.73"
,IN,AR,30322746,1005,100,,Invoice,,,,,,14/08/2018,14/08/2018,0.00,,16.83,,"-788,471.56"
,IN,AR,30322754,1005,100,,Invoice,,,,,,14/08/2018,14/08/2018,0.00,,12.71,,"-788,484.27"
,IN,AR,30322766,1005,100,,Invoice,,,,,,14/08/2018,14/08/2018,0.00,,11.19,,"-788,495.46"
,IN,AR,30322797,1005,100,,Invoice,,,,,,14/08/2018,14/08/2018,0.00,,24.56,,"-788,520.02"
,IN,AR,30322822,1005,100,,Invoice,,,,,,14/08/2018,14/08/2018,0.00,,11.19,,"-788,531.21"
,IN,AR,30322823,1005,100,,Invoice,,,,,,14/08/2018,14/08/2018,0.00,,54.66,,"-788,585.87"
,IN,AR,30322826,1005,100,,Invoice,,,,,,14/08/2018,14/08/2018,0.00,,5.86,,"-788,591.73"
,IN,AR,30322832,1005,100,,Invoice,,,,,,14/08/2018,14/08/2018,0.00,,2.84,,"-788,594.57"
,IN,AR,30322834,1005,100,,Invoice,,,,,,14/08/2018,14/08/2018,0.00,,50.11,,"-788,644.68"
,IN,AR,30322840,1005,100,,Invoice,,,,,,14/08/2018,14/08/2018,0.00,,14.58,,"-788,659.26"
,IN,AR,30322844,1005,100,,Invoice,,,,,,14/08/2018,14/08/2018,0.00,,18.05,,"-788,677.31"
,IN,AR,30322850,1005,100,,Invoice,,,,,,14/08/2018,14/08/2018,0.00,,9.10,,"-788,686.41"
,IN,AR,30322864,1005,100,,Invoice,,,,,,14/08/2018,14/08/2018,0.00,,14.58,,"-788,700.99"
,IN,AR,30322866,1005,100,,Invoice,,,,,,14/08/2018,14/08/2018,0.00,,17.15,,"-788,718.14"
,IN,AR,30322880,1005,100,,Invoice,,,,,,14/08/2018,14/08/2018,0.00,,30.02,,"-788,748.16"
,IN,AR,30322881,1005,100,,Invoice,,,,,,14/08/2018,14/08/2018,0.00,,57.89,,"-788,806.05"
,IN,AR,30322894,1005,100,,Invoice,,,,,,14/08/2018,14/08/2018,0.00,,5.29,,"-788,811.34"
,IN,AR,30322895,1005,100,,Invoice,,,,,,14/08/2018,14/08/2018,0.00,,7.05,,"-788,818.39"
,IN,AR,30322908,1005,100,,Invoice,,,,,,14/08/2018,14/08/2018,0.00,,10.34,,"-788,828.73"
,IN,AR,30322909,1005,100,,Invoice,,,,,,14/08/2018,14/08/2018,0.00,,169.49,,"-788,998.22"
,IN,AR,30322914,1005,100,,Invoice,,,,,,14/08/2018,14/08/2018,0.00,,54.66,,"-789,052.88"
,IN,AR,30322921,1005,100,,Invoice,,,,,,14/08/2018,14/08/2018,0.00,,32.80,,"-789,085.68"
,IN,AR,30322961,1005,100,,Invoice,,,,,,14/08/2018,14/08/2018,0.00,,21.86,,"-789,107.54"
,IN,AR,30322976,1005,100,,Invoice,,,,,,14/08/2018,14/08/2018,0.00,,3.18,,"-789,110.72"
,IN,AR,30322977,1005,100,,Invoice,,,,,,14/08/2018,14/08/2018,0.00,,3.18,,"-789,113.90"
,IN,AR,30322987,1005,100,,Invoice,,,,,,14/08/2018,14/08/2018,0.00,,48.26,,"-789,162.16"
,IN,AR,30323013,1005,100,,Invoice,,,,,,14/08/2018,14/08/2018,0.00,,10.93,,"-789,173.09"
,IN,AR,30323015,1005,100,,Invoice,,,,,,14/08/2018,14/08/2018,0.00,,66.74,,"-789,239.83"
,IN,AR,30323024,1005,100,,Invoice,,,,,,14/08/2018,14/08/2018,0.00,,204.07,,"-789,443.90"
,IN,AR,30323026,1005,100,,Invoice,,,,,,14/08/2018,14/08/2018,0.00,,19.07,,"-789,462.97"
,IN,AR,30323029,1005,100,,Invoice,,,,,,14/08/2018,14/08/2018,0.00,,14.58,,"-789,477.55"
,IN,AR,30323043,1005,100,,Invoice,,,,,,14/08/2018,14/08/2018,0.00,,6.56,,"-789,484.11"
,IN,AR,30323046,1005,100,,Invoice,,,,,,14/08/2018,14/08/2018,0.00,,10.19,,"-789,494.30"
,IN,AR,30323066,1005,100,,Invoice,,,,,,14/08/2018,14/08/2018,0.00,,22.88,,"-789,517.18"
,IN,AR,30323077,1005,100,,Invoice,,,,,,14/08/2018,14/08/2018,0.00,,22.01,,"-789,539.19"
,IN,AR,30323106,1005,100,,Invoice,,,,,,14/08/2018,14/08/2018,0.00,,8.25,,"-789,547.44"
,IN,AR,30323108,1005,100,,Invoice,,,,,,14/08/2018,14/08/2018,0.00,,8.75,,"-789,556.19"
,IN,AR,30323125,1005,100,,Invoice,,,,,,14/08/2018,14/08/2018,0.00,,14.95,,"-789,571.14"
,IN,AR,30323135,1005,100,,Invoice,,,,,,14/08/2018,14/08/2018,0.00,,8.21,,"-789,579.35"
,IN,AR,30323151,1005,100,,Invoice,,,,,,14/08/2018,14/08/2018,0.00,,12.85,,"-789,592.20"
,IN,AR,30323153,1005,100,,Invoice,,,,,,14/08/2018,14/08/2018,0.00,,108.00,,"-789,700.20"
,IN,AR,30323160,1005,100,,Invoice,,,,,,14/08/2018,14/08/2018,0.00,,40.34,,"-789,740.54"
,IN,AR,30323167,1005,100,,Invoice,,,,,,14/08/2018,14/08/2018,0.00,,7.29,,"-789,747.83"
,IN,AR,30323208,1005,100,,Invoice,,,,,,14/08/2018,14/08/2018,0.00,,86.78,,"-789,834.61"
,IN,AR,30323216,1005,100,,Invoice,,,,,,14/08/2018,14/08/2018,0.00,,26.10,,"-789,860.71"
,IN,AR,30323217,1005,100,,Invoice,,,,,,14/08/2018,14/08/2018,0.00,,113.91,,"-789,974.62"
,IN,AR,30323221,1005,100,,Invoice,,,,,,14/08/2018,14/08/2018,0.00,,26.44,,"-790,001.06"
,IN,AR,30323239,1005,100,,Invoice,,,,,,14/08/2018,14/08/2018,0.00,,3.76,,"-790,004.82"
,IN,AR,30323243,1005,100,,Invoice,,,,,,14/08/2018,14/08/2018,0.00,,5.26,,"-790,010.08"
,IN,AR,30323247,1005,100,,Invoice,,,,,,14/08/2018,14/08/2018,0.00,,12.00,,"-790,022.08"
,IN,AR,30323258,1005,100,,Invoice,,,,,,14/08/2018,14/08/2018,0.00,,29.12,,"-790,051.20"
,IN,AR,30323260,1005,100,,Invoice,,,,,,14/08/2018,14/08/2018,0.00,,147.24,,"-790,198.44"
,IN,AR,30323267,1005,100,,Invoice,,,,,,14/08/2018,14/08/2018,0.00,,10.93,,"-790,209.37"
,IN,AR,30323270,1005,100,,Invoice,,,,,,14/08/2018,14/08/2018,0.00,,7.02,,"-790,216.39"
,IN,AR,30323281,1005,100,,Invoice,,,,,,14/08/2018,14/08/2018,0.00,,14.58,,"-790,230.97"
,IN,AR,30323291,1005,100,,Invoice,,,,,,14/08/2018,14/08/2018,0.00,,54.66,,"-790,285.63"
,IN,AR,30323292,1005,100,,Invoice,,,,,,14/08/2018,14/08/2018,0.00,,83.81,,"-790,369.44"
,IN,AR,30323345,1005,100,,Invoice,,,,,,14/08/2018,14/08/2018,0.00,,18.11,,"-790,387.55"
,IN,AR,30323352,1005,100,,Invoice,,,,,,14/08/2018,14/08/2018,0.00,,9.96,,"-790,397.51"
,IN,AR,30323367,1005,100,,Invoice,,,,,,14/08/2018,14/08/2018,0.00,,9.11,,"-790,406.62"
,IN,AR,30323393,1005,100,,Invoice,,,,,,14/08/2018,14/08/2018,0.00,,2.08,,"-790,408.70"
,IN,AR,30323394,1005,100,,Invoice,,,,,,14/08/2018,14/08/2018,0.00,,29.07,,"-790,437.77"
,IN,AR,30323395,1005,100,,Invoice,,,,,,14/08/2018,14/08/2018,0.00,,16.61,,"-790,454.38"
,IN,AR,30323396,1005,100,,Invoice,,,,,,14/08/2018,14/08/2018,0.00,,37.37,,"-790,491.75"
,IN,AR,30323397,1005,100,,Invoice,,,,,,14/08/2018,14/08/2018,0.00,,8.31,,"-790,500.06"
,IN,AR,30323398,1005,100,,Invoice,,,,,,14/08/2018,14/08/2018,0.00,,6.23,,"-790,506.29"
,IN,AR,30323409,1005,100,,Invoice,,,,,,14/08/2018,14/08/2018,0.00,,25.42,,"-790,531.71"
,IN,AR,30323419,1005,100,,Invoice,,,,,,14/08/2018,14/08/2018,0.00,,14.58,,"-790,546.29"
,IN,AR,30323424,1005,100,,Invoice,,,,,,14/08/2018,14/08/2018,0.00,,21.24,,"-790,567.53"
,IN,AR,30323445,1005,100,,Invoice,,,,,,14/08/2018,14/08/2018,0.00,,12.71,,"-790,580.24"
,IN,AR,30323446,1005,100,,Invoice,,,,,,14/08/2018,14/08/2018,0.00,,15.25,,"-790,595.49"
,IN,AR,30323448,1005,100,,Invoice,,,,,,14/08/2018,14/08/2018,0.00,,21.86,,"-790,617.35"
,IN,AR,30323456,1005,100,,Invoice,,,,,,14/08/2018,14/08/2018,0.00,,18.22,,"-790,635.57"
,IN,AR,30323463,1005,100,,Invoice,,,,,,14/08/2018,14/08/2018,0.00,,60.41,,"-790,695.98"
,IN,AR,30323464,1005,100,,Invoice,,,,,,14/08/2018,14/08/2018,0.00,,21.97,,"-790,717.95"
,IN,AR,30323465,1005,100,,Invoice,,,,,,14/08/2018,14/08/2018,0.00,,16.47,,"-790,734.42"
,IN,AR,30323477,1005,100,,Invoice,,,,,,14/08/2018,14/08/2018,0.00,,7.29,,"-790,741.71"
,IN,AR,30323482,1005,100,,Invoice,,,,,,14/08/2018,14/08/2018,0.00,,5.17,,"-790,746.88"
,IN,AR,30323488,1005,100,,Invoice,,,,,,14/08/2018,14/08/2018,0.00,,29.15,,"-790,776.03"
,IN,AR,30323496,1005,100,,Invoice,,,,,,14/08/2018,14/08/2018,0.00,,7.29,,"-790,783.32"
,IN,AR,30323497,1005,100,,Invoice,,,,,,14/08/2018,14/08/2018,0.00,,6.56,,"-790,789.88"
,IN,AR,30323504,1005,100,,Invoice,,,,,,14/08/2018,14/08/2018,0.00,,3.64,,"-790,793.52"
,IN,AR,30323506,1005,100,,Invoice,,,,,,14/08/2018,14/08/2018,0.00,,29.15,,"-790,822.67"
,IN,AR,30323508,1005,100,,Invoice,,,,,,14/08/2018,14/08/2018,0.00,,29.15,,"-790,851.82"
,IN,AR,30322888,1005,100,,Invoice,,,,,,15/08/2018,15/08/2018,0.00,,29.15,,"-790,880.97"
,IN,AR,30323472,1005,100,,Invoice,,,,,,15/08/2018,15/08/2018,0.00,,10.93,,"-790,891.90"
,CN,AR,31018579,1005,100,,Credit Note,,,,,,16/08/2018,16/08/2018,7.29,,0.00,,"-790,884.61"
,CN,AR,31018595,1005,100,,Credit Note,,,,,,16/08/2018,16/08/2018,7.29,,0.00,,"-790,877.32"
,CN,AR,31018621,1005,100,,Credit Note,,,,,,16/08/2018,16/08/2018,83.81,,0.00,,"-790,793.51"
,CS,AR,32007346,1005,100,,Cash sale,,,,,,16/08/2018,16/08/2018,0.00,,9.03,,"-790,802.54"
,CS,AR,32007349,1005,100,,Cash sale,,,,,,16/08/2018,16/08/2018,0.00,,21.86,,"-790,824.40"
,CS,AR,32007355,1005,100,,Cash sale,,,,,,16/08/2018,16/08/2018,0.00,,40.34,,"-790,864.74"
,CS,AR,32007363,1005,100,,Cash sale,,,,,,16/08/2018,16/08/2018,0.00,,3.64,,"-790,868.38"
,CS,AR,32007383,1005,100,,Cash sale,,,,,,16/08/2018,16/08/2018,0.00,,25.51,,"-790,893.89"
,CS,AR,32007384,1005,100,,Cash sale,,,,,,16/08/2018,16/08/2018,0.00,,40.08,,"-790,933.97"
,CS,AR,32007404,1005,100,,Cash sale,,,,,,16/08/2018,16/08/2018,0.00,,3.64,,"-790,937.61"
,CS,AR,32007420,1005,100,,Cash sale,,,,,,16/08/2018,16/08/2018,0.00,,7.29,,"-790,944.90"
,CS,AR,32007429,1005,100,,Cash sale,,,,,,16/08/2018,16/08/2018,0.00,,3.64,,"-790,948.54"
,CS,AR,32007458,1005,100,,Cash sale,,,,,,16/08/2018,16/08/2018,0.00,,10.93,,"-790,959.47"
,CS,AR,32007467,1005,100,,Cash sale,,,,,,16/08/2018,16/08/2018,0.00,,10.34,,"-790,969.81"
,CS,AR,32007470,1005,100,,Cash sale,,,,,,16/08/2018,16/08/2018,0.00,,7.29,,"-790,977.10"
,CS,AR,32007472,1005,100,,Cash sale,,,,,,16/08/2018,16/08/2018,0.00,,7.29,,"-790,984.39"
,CS,AR,32007481,1005,100,,Cash sale,,,,,,16/08/2018,16/08/2018,0.00,,7.29,,"-790,991.68"
,CS,AR,32007498,1005,100,,Cash sale,,,,,,16/08/2018,16/08/2018,0.00,,7.75,,"-790,999.43"
,CS,AR,32007514,1005,100,,Cash sale,,,,,,16/08/2018,16/08/2018,0.00,,10.72,,"-791,010.15"
,CS,AR,32007524,1005,100,,Cash sale,,,,,,16/08/2018,16/08/2018,0.00,,14.58,,"-791,024.73"
,CS,AR,32007563,1005,100,,Cash sale,,,,,,16/08/2018,16/08/2018,0.00,,7.29,,"-791,032.02"
,CS,AR,32007590,1005,100,,Cash sale,,,,,,16/08/2018,16/08/2018,0.00,,7.29,,"-791,039.31"
,CS,AR,32007607,1005,100,,Cash sale,,,,,,16/08/2018,16/08/2018,0.00,,19.58,,"-791,058.89"
,CS,AR,32007609,1005,100,,Cash sale,,,,,,16/08/2018,16/08/2018,0.00,,31.02,,"-791,089.91"
,CS,AR,32007610,1005,100,,Cash sale,,,,,,16/08/2018,16/08/2018,0.00,,10.93,,"-791,100.84"
,CS,AR,32007618,1005,100,,Cash sale,,,,,,16/08/2018,16/08/2018,0.00,,14.58,,"-791,115.42"
,CS,AR,32007630,1005,100,,Cash sale,,,,,,16/08/2018,16/08/2018,0.00,,6.44,,"-791,121.86"
,CS,AR,32007661,1005,100,,Cash sale,,,,,,16/08/2018,16/08/2018,0.00,,7.75,,"-791,129.61"
,CS,AR,32007665,1005,100,,Cash sale,,,,,,16/08/2018,16/08/2018,0.00,,25.17,,"-791,154.78"
,CS,AR,32007711,1005,100,,Cash sale,,,,,,16/08/2018,16/08/2018,0.00,,8.90,,"-791,163.68"
,CS,AR,32007713,1005,100,,Cash sale,,,,,,16/08/2018,16/08/2018,0.00,,12.14,,"-791,175.82"
,CS,AR,32007722,1005,100,,Cash sale,,,,,,16/08/2018,16/08/2018,0.00,,6.56,,"-791,182.38"
,CS,AR,32007729,1005,100,,Cash sale,,,,,,16/08/2018,16/08/2018,0.00,,11.44,,"-791,193.82"
,CS,AR,32007738,1005,100,,Cash sale,,,,,,16/08/2018,16/08/2018,0.00,,18.22,,"-791,212.04"
,CS,AR,32007749,1005,100,,Cash sale,,,,,,16/08/2018,16/08/2018,0.00,,10.93,,"-791,222.97"
,CS,AR,32007754,1005,100,,Cash sale,,,,,,16/08/2018,16/08/2018,0.00,,18.05,,"-791,241.02"
,CS,AR,32007766,1005,100,,Cash sale,,,,,,16/08/2018,16/08/2018,0.00,,5.47,,"-791,246.49"
,CS,AR,32007768,1005,100,,Cash sale,,,,,,16/08/2018,16/08/2018,0.00,,3.64,,"-791,250.13"
,CS,AR,32007796,1005,100,,Cash sale,,,,,,16/08/2018,16/08/2018,0.00,,7.29,,"-791,257.42"
,CS,AR,32007805,1005,100,,Cash sale,,,,,,16/08/2018,16/08/2018,0.00,,6.56,,"-791,263.98"
,CS,AR,32007811,1005,100,,Cash sale,,,,,,16/08/2018,16/08/2018,0.00,,14.58,,"-791,278.56"
,CS,AR,32007859,1005,100,,Cash sale,,,,,,16/08/2018,16/08/2018,0.00,,7.29,,"-791,285.85"
,CS,AR,32007868,1005,100,,Cash sale,,,,,,16/08/2018,16/08/2018,0.00,,7.29,,"-791,293.14"
,IN,AR,30322247,1005,100,,Invoice,,,,,,16/08/2018,16/08/2018,0.00,,3.64,,"-791,296.78"
,IN,AR,30322276,1005,100,,Invoice,,,,,,16/08/2018,16/08/2018,0.00,,3.64,,"-791,300.42"
,IN,AR,30322305,1005,100,,Invoice,,,,,,16/08/2018,16/08/2018,0.00,,142.12,,"-791,442.54"
,IN,AR,30322323,1005,100,,Invoice,,,,,,16/08/2018,16/08/2018,0.00,,149.49,,"-791,592.03"
,IN,AR,30322338,1005,100,,Invoice,,,,,,16/08/2018,16/08/2018,0.00,,74.00,,"-791,666.03"
,IN,AR,30322379,1005,100,,Invoice,,,,,,16/08/2018,16/08/2018,0.00,,13.77,,"-791,679.80"
,IN,AR,30322400,1005,100,,Invoice,,,,,,16/08/2018,16/08/2018,0.00,,54.58,,"-791,734.38"
,IN,AR,30322405,1005,100,,Invoice,,,,,,16/08/2018,16/08/2018,0.00,,20.00,,"-791,754.38"
,IN,AR,30322417,1005,100,,Invoice,,,,,,16/08/2018,16/08/2018,0.00,,24.71,,"-791,779.09"
,IN,AR,30322447,1005,100,,Invoice,,,,,,16/08/2018,16/08/2018,0.00,,"1,093.22",,"-792,872.31"
,IN,AR,30322482,1005,100,,Invoice,,,,,,16/08/2018,16/08/2018,0.00,,10.93,,"-792,883.24"
,IN,AR,30322484,1005,100,,Invoice,,,,,,16/08/2018,16/08/2018,0.00,,31.50,,"-792,914.74"
,IN,AR,30322485,1005,100,,Invoice,,,,,,16/08/2018,16/08/2018,0.00,,21.86,,"-792,936.60"
,IN,AR,30322517,1005,100,,Invoice,,,,,,16/08/2018,16/08/2018,0.00,,54.66,,"-792,991.26"
,IN,AR,30322555,1005,100,,Invoice,,,,,,16/08/2018,16/08/2018,0.00,,73.53,,"-793,064.79"
,IN,AR,30322573,1005,100,,Invoice,,,,,,16/08/2018,16/08/2018,0.00,,19.12,,"-793,083.91"
,IN,AR,30322582,1005,100,,Invoice,,,,,,16/08/2018,16/08/2018,0.00,,127.15,,"-793,211.06"
,IN,AR,30322598,1005,100,,Invoice,,,,,,16/08/2018,16/08/2018,0.00,,11.95,,"-793,223.01"
,IN,AR,30322604,1005,100,,Invoice,,,,,,16/08/2018,16/08/2018,0.00,,22.54,,"-793,245.55"
,IN,AR,30322653,1005,100,,Invoice,,,,,,16/08/2018,16/08/2018,0.00,,22.07,,"-793,267.62"
,IN,AR,30322656,1005,100,,Invoice,,,,,,16/08/2018,16/08/2018,0.00,,5.17,,"-793,272.79"
,IN,AR,30322657,1005,100,,Invoice,,,,,,16/08/2018,16/08/2018,0.00,,6.36,,"-793,279.15"
,IN,AR,30322665,1005,100,,Invoice,,,,,,16/08/2018,16/08/2018,0.00,,21.86,,"-793,301.01"
,IN,AR,30322689,1005,100,,Invoice,,,,,,16/08/2018,16/08/2018,0.00,,13.63,,"-793,314.64"
,IN,AR,30322696,1005,100,,Invoice,,,,,,16/08/2018,16/08/2018,0.00,,30.51,,"-793,345.15"
,IN,AR,30322722,1005,100,,Invoice,,,,,,16/08/2018,16/08/2018,0.00,,10.59,,"-793,355.74"
,IN,AR,30322724,1005,100,,Invoice,,,,,,16/08/2018,16/08/2018,0.00,,21.86,,"-793,377.60"
,IN,AR,30322731,1005,100,,Invoice,,,,,,16/08/2018,16/08/2018,0.00,,3.64,,"-793,381.24"
,IN,AR,30322742,1005,100,,Invoice,,,,,,16/08/2018,16/08/2018,0.00,,16.47,,"-793,397.71"
,IN,AR,30322747,1005,100,,Invoice,,,,,,16/08/2018,16/08/2018,0.00,,16.83,,"-793,414.54"
,IN,AR,30322753,1005,100,,Invoice,,,,,,16/08/2018,16/08/2018,0.00,,21.19,,"-793,435.73"
,IN,AR,30322758,1005,100,,Invoice,,,,,,16/08/2018,16/08/2018,0.00,,4.58,,"-793,440.31"
,IN,AR,30322762,1005,100,,Invoice,,,,,,16/08/2018,16/08/2018,0.00,,10.50,,"-793,450.81"
,IN,AR,30322779,1005,100,,Invoice,,,,,,16/08/2018,16/08/2018,0.00,,10.93,,"-793,461.74"
,IN,AR,30322783,1005,100,,Invoice,,,,,,16/08/2018,16/08/2018,0.00,,21.19,,"-793,482.93"
,IN,AR,30322788,1005,100,,Invoice,,,,,,16/08/2018,16/08/2018,0.00,,33.56,,"-793,516.49"
,IN,AR,30322789,1005,100,,Invoice,,,,,,16/08/2018,16/08/2018,0.00,,73.22,,"-793,589.71"
,IN,AR,30322792,1005,100,,Invoice,,,,,,16/08/2018,16/08/2018,0.00,,12.71,,"-793,602.42"
,IN,AR,30322794,1005,100,,Invoice,,,,,,16/08/2018,16/08/2018,0.00,,54.66,,"-793,657.08"
,IN,AR,30322807,1005,100,,Invoice,,,,,,16/08/2018,16/08/2018,0.00,,9.29,,"-793,666.37"
,IN,AR,30322813,1005,100,,Invoice,,,,,,16/08/2018,16/08/2018,0.00,,8.77,,"-793,675.14"
,IN,AR,30322815,1005,100,,Invoice,,,,,,16/08/2018,16/08/2018,0.00,,18.22,,"-793,693.36"
,IN,AR,30322818,1005,100,,Invoice,,,,,,16/08/2018,16/08/2018,0.00,,21.86,,"-793,715.22"
,IN,AR,30322820,1005,100,,Invoice,,,,,,16/08/2018,16/08/2018,0.00,,11.02,,"-793,726.24"
,IN,AR,30322848,1005,100,,Invoice,,,,,,16/08/2018,16/08/2018,0.00,,18.05,,"-793,744.29"
,IN,AR,30322859,1005,100,,Invoice,,,,,,16/08/2018,16/08/2018,0.00,,11.64,,"-793,755.93"
,IN,AR,30322871,1005,100,,Invoice,,,,,,16/08/2018,16/08/2018,0.00,,6.00,,"-793,761.93"
,IN,AR,30322896,1005,100,,Invoice,,,,,,16/08/2018,16/08/2018,0.00,,1.76,,"-793,763.69"
,IN,AR,30322900,1005,100,,Invoice,,,,,,16/08/2018,16/08/2018,0.00,,18.05,,"-793,781.74"
,IN,AR,30322907,1005,100,,Invoice,,,,,,16/08/2018,16/08/2018,0.00,,8.24,,"-793,789.98"
,IN,AR,30322917,1005,100,,Invoice,,,,,,16/08/2018,16/08/2018,0.00,,29.15,,"-793,819.13"
,IN,AR,30322918,1005,100,,Invoice,,,,,,16/08/2018,16/08/2018,0.00,,5.17,,"-793,824.30"
,IN,AR,30322926,1005,100,,Invoice,,,,,,16/08/2018,16/08/2018,0.00,,15.71,,"-793,840.01"
,IN,AR,30322929,1005,100,,Invoice,,,,,,16/08/2018,16/08/2018,0.00,,32.01,,"-793,872.02"
,IN,AR,30322950,1005,100,,Invoice,,,,,,16/08/2018,16/08/2018,0.00,,54.66,,"-793,926.68"
,IN,AR,30322951,1005,100,,Invoice,,,,,,16/08/2018,16/08/2018,0.00,,7.29,,"-793,933.97"
,IN,AR,30322952,1005,100,,Invoice,,,,,,16/08/2018,16/08/2018,0.00,,18.22,,"-793,952.19"
,IN,AR,30322954,1005,100,,Invoice,,,,,,16/08/2018,16/08/2018,0.00,,14.58,,"-793,966.77"
,IN,AR,30322956,1005,100,,Invoice,,,,,,16/08/2018,16/08/2018,0.00,,12.71,,"-793,979.48"
,IN,AR,30322960,1005,100,,Invoice,,,,,,16/08/2018,16/08/2018,0.00,,7.29,,"-793,986.77"
,IN,AR,30322970,1005,100,,Invoice,,,,,,16/08/2018,16/08/2018,0.00,,11.95,,"-793,998.72"
,IN,AR,30322971,1005,100,,Invoice,,,,,,16/08/2018,16/08/2018,0.00,,15.93,,"-794,014.65"
,IN,AR,30322972,1005,100,,Invoice,,,,,,16/08/2018,16/08/2018,0.00,,41.82,,"-794,056.47"
,IN,AR,30322978,1005,100,,Invoice,,,,,,16/08/2018,16/08/2018,0.00,,15.90,,"-794,072.37"
,IN,AR,30322985,1005,100,,Invoice,,,,,,16/08/2018,16/08/2018,0.00,,2.01,,"-794,074.38"
,IN,AR,30323001,1005,100,,Invoice,,,,,,16/08/2018,16/08/2018,0.00,,330.08,,"-794,404.46"
,IN,AR,30323003,1005,100,,Invoice,,,,,,16/08/2018,16/08/2018,0.00,,116.25,,"-794,520.71"
,IN,AR,30323023,1005,100,,Invoice,,,,,,16/08/2018,16/08/2018,0.00,,47.54,,"-794,568.25"
,IN,AR,30323049,1005,100,,Invoice,,,,,,16/08/2018,16/08/2018,0.00,,3.64,,"-794,571.89"
,IN,AR,30323067,1005,100,,Invoice,,,,,,16/08/2018,16/08/2018,0.00,,5.08,,"-794,576.97"
,IN,AR,30323068,1005,100,,Invoice,,,,,,16/08/2018,16/08/2018,0.00,,7.63,,"-794,584.60"
,IN,AR,30323071,1005,100,,Invoice,,,,,,16/08/2018,16/08/2018,0.00,,24.01,,"-794,608.61"
,IN,AR,30323080,1005,100,,Invoice,,,,,,16/08/2018,16/08/2018,0.00,,40.01,,"-794,648.62"
,IN,AR,30323093,1005,100,,Invoice,,,,,,16/08/2018,16/08/2018,0.00,,11.66,,"-794,660.28"
,IN,AR,30323094,1005,100,,Invoice,,,,,,16/08/2018,16/08/2018,0.00,,11.66,,"-794,671.94"
,IN,AR,30323118,1005,100,,Invoice,,,,,,16/08/2018,16/08/2018,0.00,,27.33,,"-794,699.27"
,IN,AR,30323119,1005,100,,Invoice,,,,,,16/08/2018,16/08/2018,0.00,,21.03,,"-794,720.30"
,IN,AR,30323126,1005,100,,Invoice,,,,,,16/08/2018,16/08/2018,0.00,,32.39,,"-794,752.69"
,IN,AR,30323129,1005,100,,Invoice,,,,,,16/08/2018,16/08/2018,0.00,,21.86,,"-794,774.55"
,IN,AR,30323139,1005,100,,Invoice,,,,,,16/08/2018,16/08/2018,0.00,,5.61,,"-794,780.16"
,IN,AR,30323142,1005,100,,Invoice,,,,,,16/08/2018,16/08/2018,0.00,,17.80,,"-794,797.96"
,IN,AR,30323145,1005,100,,Invoice,,,,,,16/08/2018,16/08/2018,0.00,,27.46,,"-794,825.42"
,IN,AR,30323155,1005,100,,Invoice,,,,,,16/08/2018,16/08/2018,0.00,,7.29,,"-794,832.71"
,IN,AR,30323201,1005,100,,Invoice,,,,,,16/08/2018,16/08/2018,0.00,,7.97,,"-794,840.68"
,IN,AR,30323202,1005,100,,Invoice,,,,,,16/08/2018,16/08/2018,0.00,,19.12,,"-794,859.80"
,IN,AR,30323203,1005,100,,Invoice,,,,,,16/08/2018,16/08/2018,0.00,,3.19,,"-794,862.99"
,IN,AR,30323204,1005,100,,Invoice,,,,,,16/08/2018,16/08/2018,0.00,,100.37,,"-794,963.36"
,IN,AR,30323205,1005,100,,Invoice,,,,,,16/08/2018,16/08/2018,0.00,,22.31,,"-794,985.67"
,IN,AR,30323224,1005,100,,Invoice,,,,,,16/08/2018,16/08/2018,0.00,,22.37,,"-795,008.04"
,IN,AR,30323242,1005,100,,Invoice,,,,,,16/08/2018,16/08/2018,0.00,,5.26,,"-795,013.30"
,IN,AR,30323254,1005,100,,Invoice,,,,,,16/08/2018,16/08/2018,0.00,,16.95,,"-795,030.25"
,IN,AR,30323264,1005,100,,Invoice,,,,,,16/08/2018,16/08/2018,0.00,,29.15,,"-795,059.40"
,IN,AR,30323274,1005,100,,Invoice,,,,,,16/08/2018,16/08/2018,0.00,,8.75,,"-795,068.15"
,IN,AR,30323286,1005,100,,Invoice,,,,,,16/08/2018,16/08/2018,0.00,,9.41,,"-795,077.56"
,IN,AR,30323319,1005,100,,Invoice,,,,,,16/08/2018,16/08/2018,0.00,,14.83,,"-795,092.39"
,IN,AR,30323330,1005,100,,Invoice,,,,,,16/08/2018,16/08/2018,0.00,,4.08,,"-795,096.47"
,IN,AR,30323347,1005,100,,Invoice,,,,,,16/08/2018,16/08/2018,0.00,,54.66,,"-795,151.13"
,IN,AR,30323362,1005,100,,Invoice,,,,,,16/08/2018,16/08/2018,0.00,,9.15,,"-795,160.28"
,IN,AR,30323399,1005,100,,Invoice,,,,,,16/08/2018,16/08/2018,0.00,,4.15,,"-795,164.43"
,IN,AR,30323400,1005,100,,Invoice,,,,,,16/08/2018,16/08/2018,0.00,,6.23,,"-795,170.66"
,IN,AR,30323401,1005,100,,Invoice,,,,,,16/08/2018,16/08/2018,0.00,,4.15,,"-795,174.81"
,IN,AR,30323402,1005,100,,Invoice,,,,,,16/08/2018,16/08/2018,0.00,,20.76,,"-795,195.57"
,IN,AR,30323412,1005,100,,Invoice,,,,,,16/08/2018,16/08/2018,0.00,,5.08,,"-795,200.65"
,IN,AR,30323441,1005,100,,Invoice,,,,,,16/08/2018,16/08/2018,0.00,,2.03,,"-795,202.68"
,IN,AR,30323447,1005,100,,Invoice,,,,,,16/08/2018,16/08/2018,0.00,,4.78,,"-795,207.46"
,IN,AR,30323466,1005,100,,Invoice,,,,,,16/08/2018,16/08/2018,0.00,,13.73,,"-795,221.19"
,IN,AR,30323470,1005,100,,Invoice,,,,,,16/08/2018,16/08/2018,0.00,,23.13,,"-795,244.32"
,IN,AR,30323490,1005,100,,Invoice,,,,,,16/08/2018,16/08/2018,0.00,,27.97,,"-795,272.29"
,IN,AR,30323511,1005,100,,Invoice,,,,,,16/08/2018,16/08/2018,0.00,,419.07,,"-795,691.36"
,IN,AR,30323513,1005,100,,Invoice,,,,,,16/08/2018,16/08/2018,0.00,,419.07,,"-796,110.43"
,IN,AR,30323516,1005,100,,Invoice,,,,,,16/08/2018,16/08/2018,0.00,,29.15,,"-796,139.58"
,CN,AR,31018647,1005,100,,Credit Note,,,,,,17/08/2018,17/08/2018,419.07,,0.00,,"-795,720.51"
,CS,AR,32007344,1005,100,,Cash sale,,,,,,17/08/2018,17/08/2018,0.00,,7.29,,"-795,727.80"
,CS,AR,32007353,1005,100,,Cash sale,,,,,,17/08/2018,17/08/2018,0.00,,22.44,,"-795,750.24"
,CS,AR,32007357,1005,100,,Cash sale,,,,,,17/08/2018,17/08/2018,0.00,,7.29,,"-795,757.53"
,CS,AR,32007359,1005,100,,Cash sale,,,,,,17/08/2018,17/08/2018,0.00,,60.20,,"-795,817.73"
,CS,AR,32007361,1005,100,,Cash sale,,,,,,17/08/2018,17/08/2018,0.00,,11.86,,"-795,829.59"
,CS,AR,32007364,1005,100,,Cash sale,,,,,,17/08/2018,17/08/2018,0.00,,19.87,,"-795,849.46"
,CS,AR,32007373,1005,100,,Cash sale,,,,,,17/08/2018,17/08/2018,0.00,,3.64,,"-795,853.10"
,CS,AR,32007381,1005,100,,Cash sale,,,,,,17/08/2018,17/08/2018,0.00,,3.64,,"-795,856.74"
,CS,AR,32007385,1005,100,,Cash sale,,,,,,17/08/2018,17/08/2018,0.00,,3.64,,"-795,860.38"
,CS,AR,32007395,1005,100,,Cash sale,,,,,,17/08/2018,17/08/2018,0.00,,7.29,,"-795,867.67"
,CS,AR,32007399,1005,100,,Cash sale,,,,,,17/08/2018,17/08/2018,0.00,,7.25,,"-795,874.92"
,CS,AR,32007406,1005,100,,Cash sale,,,,,,17/08/2018,17/08/2018,0.00,,10.93,,"-795,885.85"
,CS,AR,32007410,1005,100,,Cash sale,,,,,,17/08/2018,17/08/2018,0.00,,18.22,,"-795,904.07"
,CS,AR,32007413,1005,100,,Cash sale,,,,,,17/08/2018,17/08/2018,0.00,,12.46,,"-795,916.53"
,CS,AR,32007419,1005,100,,Cash sale,,,,,,17/08/2018,17/08/2018,0.00,,10.93,,"-795,927.46"
,CS,AR,32007422,1005,100,,Cash sale,,,,,,17/08/2018,17/08/2018,0.00,,7.29,,"-795,934.75"
,CS,AR,32007431,1005,100,,Cash sale,,,,,,17/08/2018,17/08/2018,0.00,,7.29,,"-795,942.04"
,CS,AR,32007433,1005,100,,Cash sale,,,,,,17/08/2018,17/08/2018,0.00,,3.64,,"-795,945.68"
,CS,AR,32007435,1005,100,,Cash sale,,,,,,17/08/2018,17/08/2018,0.00,,3.64,,"-795,949.32"
,CS,AR,32007447,1005,100,,Cash sale,,,,,,17/08/2018,17/08/2018,0.00,,7.29,,"-795,956.61"
,CS,AR,32007450,1005,100,,Cash sale,,,,,,17/08/2018,17/08/2018,0.00,,23.29,,"-795,979.90"
,CS,AR,32007454,1005,100,,Cash sale,,,,,,17/08/2018,17/08/2018,0.00,,3.64,,"-795,983.54"
,CS,AR,32007460,1005,100,,Cash sale,,,,,,17/08/2018,17/08/2018,0.00,,7.29,,"-795,990.83"
,CS,AR,32007461,1005,100,,Cash sale,,,,,,17/08/2018,17/08/2018,0.00,,7.29,,"-795,998.12"
,CS,AR,32007473,1005,100,,Cash sale,,,,,,17/08/2018,17/08/2018,0.00,,12.92,,"-796,011.04"
,CS,AR,32007478,1005,100,,Cash sale,,,,,,17/08/2018,17/08/2018,0.00,,3.64,,"-796,014.68"
,CS,AR,32007492,1005,100,,Cash sale,,,,,,17/08/2018,17/08/2018,0.00,,2.54,,"-796,017.22"
,CS,AR,32007503,1005,100,,Cash sale,,,,,,17/08/2018,17/08/2018,0.00,,71.44,,"-796,088.66"
,CS,AR,32007518,1005,100,,Cash sale,,,,,,17/08/2018,17/08/2018,0.00,,7.29,,"-796,095.95"
,CS,AR,32007530,1005,100,,Cash sale,,,,,,17/08/2018,17/08/2018,0.00,,11.65,,"-796,107.60"
,CS,AR,32007534,1005,100,,Cash sale,,,,,,17/08/2018,17/08/2018,0.00,,6.02,,"-796,113.62"
,CS,AR,32007540,1005,100,,Cash sale,,,,,,17/08/2018,17/08/2018,0.00,,12.71,,"-796,126.33"
,CS,AR,32007547,1005,100,,Cash sale,,,,,,17/08/2018,17/08/2018,0.00,,26.31,,"-796,152.64"
,CS,AR,32007549,1005,100,,Cash sale,,,,,,17/08/2018,17/08/2018,0.00,,6.74,,"-796,159.38"
,CS,AR,32007555,1005,100,,Cash sale,,,,,,17/08/2018,17/08/2018,0.00,,33.09,,"-796,192.47"
,CS,AR,32007565,1005,100,,Cash sale,,,,,,17/08/2018,17/08/2018,0.00,,17.80,,"-796,210.27"
,CS,AR,32007581,1005,100,,Cash sale,,,,,,17/08/2018,17/08/2018,0.00,,3.64,,"-796,213.91"
,CS,AR,32007586,1005,100,,Cash sale,,,,,,17/08/2018,17/08/2018,0.00,,10.93,,"-796,224.84"
,CS,AR,32007603,1005,100,,Cash sale,,,,,,17/08/2018,17/08/2018,0.00,,10.93,,"-796,235.77"
,CS,AR,32007613,1005,100,,Cash sale,,,,,,17/08/2018,17/08/2018,0.00,,3.64,,"-796,239.41"
,CS,AR,32007621,1005,100,,Cash sale,,,,,,17/08/2018,17/08/2018,0.00,,25.51,,"-796,264.92"
,CS,AR,32007638,1005,100,,Cash sale,,,,,,17/08/2018,17/08/2018,0.00,,2.58,,"-796,267.50"
,CS,AR,32007652,1005,100,,Cash sale,,,,,,17/08/2018,17/08/2018,0.00,,10.34,,"-796,277.84"
,CS,AR,32007670,1005,100,,Cash sale,,,,,,17/08/2018,17/08/2018,0.00,,10.93,,"-796,288.77"
,CS,AR,32007681,1005,100,,Cash sale,,,,,,17/08/2018,17/08/2018,0.00,,15.25,,"-796,304.02"
,CS,AR,32007692,1005,100,,Cash sale,,,,,,17/08/2018,17/08/2018,0.00,,3.64,,"-796,307.66"
,CS,AR,32007694,1005,100,,Cash sale,,,,,,17/08/2018,17/08/2018,0.00,,7.29,,"-796,314.95"
,CS,AR,32007703,1005,100,,Cash sale,,,,,,17/08/2018,17/08/2018,0.00,,34.00,,"-796,348.95"
,CS,AR,32007719,1005,100,,Cash sale,,,,,,17/08/2018,17/08/2018,0.00,,10.17,,"-796,359.12"
,CS,AR,32007730,1005,100,,Cash sale,,,,,,17/08/2018,17/08/2018,0.00,,6.86,,"-796,365.98"
,CS,AR,32007757,1005,100,,Cash sale,,,,,,17/08/2018,17/08/2018,0.00,,18.22,,"-796,384.20"
,CS,AR,32007761,1005,100,,Cash sale,,,,,,17/08/2018,17/08/2018,0.00,,21.25,,"-796,405.45"
,CS,AR,32007772,1005,100,,Cash sale,,,,,,17/08/2018,17/08/2018,0.00,,3.64,,"-796,409.09"
,CS,AR,32007784,1005,100,,Cash sale,,,,,,17/08/2018,17/08/2018,0.00,,14.58,,"-796,423.67"
,CS,AR,32007790,1005,100,,Cash sale,,,,,,17/08/2018,17/08/2018,0.00,,7.29,,"-796,430.96"
,CS,AR,32007792,1005,100,,Cash sale,,,,,,17/08/2018,17/08/2018,0.00,,18.22,,"-796,449.18"
,CS,AR,32007799,1005,100,,Cash sale,,,,,,17/08/2018,17/08/2018,0.00,,3.64,,"-796,452.82"
,CS,AR,32007806,1005,100,,Cash sale,,,,,,17/08/2018,17/08/2018,0.00,,7.29,,"-796,460.11"
,CS,AR,32007813,1005,100,,Cash sale,,,,,,17/08/2018,17/08/2018,0.00,,7.29,,"-796,467.40"
,CS,AR,32007862,1005,100,,Cash sale,,,,,,17/08/2018,17/08/2018,0.00,,18.22,,"-796,485.62"
,CS,AR,32007875,1005,100,,Cash sale,,,,,,17/08/2018,17/08/2018,0.00,,29.15,,"-796,514.77"
,CS,AR,32007876,1005,100,,Cash sale,,,,,,17/08/2018,17/08/2018,0.00,,3.64,,"-796,518.41"
,IN,AR,30322227,1005,100,,Invoice,,,,,,17/08/2018,17/08/2018,0.00,,8.90,,"-796,527.31"
,IN,AR,30322228,1005,100,,Invoice,,,,,,17/08/2018,17/08/2018,0.00,,56.36,,"-796,583.67"
,IN,AR,30322242,1005,100,,Invoice,,,,,,17/08/2018,17/08/2018,0.00,,22.37,,"-796,606.04"
,IN,AR,30322270,1005,100,,Invoice,,,,,,17/08/2018,17/08/2018,0.00,,21.86,,"-796,627.90"
,IN,AR,30322273,1005,100,,Invoice,,,,,,17/08/2018,17/08/2018,0.00,,21.91,,"-796,649.81"
,IN,AR,30322279,1005,100,,Invoice,,,,,,17/08/2018,17/08/2018,0.00,,9.13,,"-796,658.94"
,IN,AR,30322282,1005,100,,Invoice,,,,,,17/08/2018,17/08/2018,0.00,,91.95,,"-796,750.89"
,IN,AR,30322290,1005,100,,Invoice,,,,,,17/08/2018,17/08/2018,0.00,,54.66,,"-796,805.55"
,IN,AR,30322297,1005,100,,Invoice,,,,,,17/08/2018,17/08/2018,0.00,,52.84,,"-796,858.39"
,IN,AR,30322299,1005,100,,Invoice,,,,,,17/08/2018,17/08/2018,0.00,,182.20,,"-797,040.59"
,IN,AR,30322300,1005,100,,Invoice,,,,,,17/08/2018,17/08/2018,0.00,,364.41,,"-797,405.00"
,IN,AR,30322307,1005,100,,Invoice,,,,,,17/08/2018,17/08/2018,0.00,,27.56,,"-797,432.56"
,IN,AR,30322311,1005,100,,Invoice,,,,,,17/08/2018,17/08/2018,0.00,,87.33,,"-797,519.89"
,IN,AR,30322314,1005,100,,Invoice,,,,,,17/08/2018,17/08/2018,0.00,,17.92,,"-797,537.81"
,IN,AR,30322324,1005,100,,Invoice,,,,,,17/08/2018,17/08/2018,0.00,,66.44,,"-797,604.25"
,IN,AR,30322331,1005,100,,Invoice,,,,,,17/08/2018,17/08/2018,0.00,,18.22,,"-797,622.47"
,IN,AR,30322334,1005,100,,Invoice,,,,,,17/08/2018,17/08/2018,0.00,,7.29,,"-797,629.76"
,IN,AR,30322342,1005,100,,Invoice,,,,,,17/08/2018,17/08/2018,0.00,,7.29,,"-797,637.05"
,IN,AR,30322348,1005,100,,Invoice,,,,,,17/08/2018,17/08/2018,0.00,,54.66,,"-797,691.71"
,IN,AR,30322367,1005,100,,Invoice,,,,,,17/08/2018,17/08/2018,0.00,,72.00,,"-797,763.71"
,IN,AR,30322389,1005,100,,Invoice,,,,,,17/08/2018,17/08/2018,0.00,,11.68,,"-797,775.39"
,IN,AR,30322393,1005,100,,Invoice,,,,,,17/08/2018,17/08/2018,0.00,,10.00,,"-797,785.39"
,IN,AR,30322395,1005,100,,Invoice,,,,,,17/08/2018,17/08/2018,0.00,,5.85,,"-797,791.24"
,IN,AR,30322397,1005,100,,Invoice,,,,,,17/08/2018,17/08/2018,0.00,,7.29,,"-797,798.53"
,IN,AR,30322401,1005,100,,Invoice,,,,,,17/08/2018,17/08/2018,0.00,,4.75,,"-797,803.28"
,IN,AR,30322406,1005,100,,Invoice,,,,,,17/08/2018,17/08/2018,0.00,,10.00,,"-797,813.28"
,IN,AR,30322407,1005,100,,Invoice,,,,,,17/08/2018,17/08/2018,0.00,,4.00,,"-797,817.28"
,IN,AR,30322424,1005,100,,Invoice,,,,,,17/08/2018,17/08/2018,0.00,,229.22,,"-798,046.50"
,IN,AR,30322434,1005,100,,Invoice,,,,,,17/08/2018,17/08/2018,0.00,,11.64,,"-798,058.14"
,IN,AR,30322435,1005,100,,Invoice,,,,,,17/08/2018,17/08/2018,0.00,,9.70,,"-798,067.84"
,IN,AR,30322442,1005,100,,Invoice,,,,,,17/08/2018,17/08/2018,0.00,,44.00,,"-798,111.84"
,IN,AR,30322445,1005,100,,Invoice,,,,,,17/08/2018,17/08/2018,0.00,,7.29,,"-798,119.13"
,IN,AR,30322454,1005,100,,Invoice,,,,,,17/08/2018,17/08/2018,0.00,,25.51,,"-798,144.64"
,IN,AR,30322460,1005,100,,Invoice,,,,,,17/08/2018,17/08/2018,0.00,,8.39,,"-798,153.03"
,IN,AR,30322463,1005,100,,Invoice,,,,,,17/08/2018,17/08/2018,0.00,,12.88,,"-798,165.91"
,IN,AR,30322477,1005,100,,Invoice,,,,,,17/08/2018,17/08/2018,0.00,,9.56,,"-798,175.47"
,IN,AR,30322487,1005,100,,Invoice,,,,,,17/08/2018,17/08/2018,0.00,,7.75,,"-798,183.22"
,IN,AR,30322495,1005,100,,Invoice,,,,,,17/08/2018,17/08/2018,0.00,,4.64,,"-798,187.86"
,IN,AR,30322513,1005,100,,Invoice,,,,,,17/08/2018,17/08/2018,0.00,,7.29,,"-798,195.15"
,IN,AR,30322539,1005,100,,Invoice,,,,,,17/08/2018,17/08/2018,0.00,,13.98,,"-798,209.13"
,IN,AR,30322543,1005,100,,Invoice,,,,,,17/08/2018,17/08/2018,0.00,,14.58,,"-798,223.71"
,IN,AR,30322546,1005,100,,Invoice,,,,,,17/08/2018,17/08/2018,0.00,,36.19,,"-798,259.90"
,IN,AR,30322549,1005,100,,Invoice,,,,,,17/08/2018,17/08/2018,0.00,,4.78,,"-798,264.68"
,IN,AR,30322551,1005,100,,Invoice,,,,,,17/08/2018,17/08/2018,0.00,,364.41,,"-798,629.09"
,IN,AR,30322560,1005,100,,Invoice,,,,,,17/08/2018,17/08/2018,0.00,,5.18,,"-798,634.27"
,IN,AR,30322587,1005,100,,Invoice,,,,,,17/08/2018,17/08/2018,0.00,,94.07,,"-798,728.34"
,IN,AR,30322588,1005,100,,Invoice,,,,,,17/08/2018,17/08/2018,0.00,,27.97,,"-798,756.31"
,IN,AR,30322605,1005,100,,Invoice,,,,,,17/08/2018,17/08/2018,0.00,,54.66,,"-798,810.97"
,IN,AR,30322606,1005,100,,Invoice,,,,,,17/08/2018,17/08/2018,0.00,,9.03,,"-798,820.00"
,IN,AR,30322615,1005,100,,Invoice,,,,,,17/08/2018,17/08/2018,0.00,,6.02,,"-798,826.02"
,IN,AR,30322634,1005,100,,Invoice,,,,,,17/08/2018,17/08/2018,0.00,,4.78,,"-798,830.80"
,IN,AR,30322643,1005,100,,Invoice,,,,,,17/08/2018,17/08/2018,0.00,,2.54,,"-798,833.34"
,IN,AR,30322644,1005,100,,Invoice,,,,,,17/08/2018,17/08/2018,0.00,,12.71,,"-798,846.05"
,IN,AR,30322645,1005,100,,Invoice,,,,,,17/08/2018,17/08/2018,0.00,,10.17,,"-798,856.22"
,IN,AR,30322646,1005,100,,Invoice,,,,,,17/08/2018,17/08/2018,0.00,,2.54,,"-798,858.76"
,IN,AR,30322671,1005,100,,Invoice,,,,,,17/08/2018,17/08/2018,0.00,,17.80,,"-798,876.56"
,IN,AR,30322675,1005,100,,Invoice,,,,,,17/08/2018,17/08/2018,0.00,,6.36,,"-798,882.92"
,IN,AR,30322676,1005,100,,Invoice,,,,,,17/08/2018,17/08/2018,0.00,,23.31,,"-798,906.23"
,IN,AR,30322683,1005,100,,Invoice,,,,,,17/08/2018,17/08/2018,0.00,,10.93,,"-798,917.16"
,IN,AR,30322700,1005,100,,Invoice,,,,,,17/08/2018,17/08/2018,0.00,,15.00,,"-798,932.16"
,IN,AR,30322740,1005,100,,Invoice,,,,,,17/08/2018,17/08/2018,0.00,,8.17,,"-798,940.33"
,IN,AR,30322763,1005,100,,Invoice,,,,,,17/08/2018,17/08/2018,0.00,,54.66,,"-798,994.99"
,IN,AR,30322781,1005,100,,Invoice,,,,,,17/08/2018,17/08/2018,0.00,,18.22,,"-799,013.21"
,IN,AR,30322801,1005,100,,Invoice,,,,,,17/08/2018,17/08/2018,0.00,,29.12,,"-799,042.33"
,IN,AR,30322805,1005,100,,Invoice,,,,,,17/08/2018,17/08/2018,0.00,,54.66,,"-799,096.99"
,IN,AR,30322808,1005,100,,Invoice,,,,,,17/08/2018,17/08/2018,0.00,,364.41,,"-799,461.40"
,IN,AR,30322811,1005,100,,Invoice,,,,,,17/08/2018,17/08/2018,0.00,,26.34,,"-799,487.74"
,IN,AR,30322853,1005,100,,Invoice,,,,,,17/08/2018,17/08/2018,0.00,,364.41,,"-799,852.15"
,IN,AR,30322867,1005,100,,Invoice,,,,,,17/08/2018,17/08/2018,0.00,,17.15,,"-799,869.30"
,IN,AR,30322882,1005,100,,Invoice,,,,,,17/08/2018,17/08/2018,0.00,,150.08,,"-800,019.38"
,IN,AR,30322885,1005,100,,Invoice,,,,,,17/08/2018,17/08/2018,0.00,,14.58,,"-800,033.96"
,IN,AR,30322897,1005,100,,Invoice,,,,,,17/08/2018,17/08/2018,0.00,,8.81,,"-800,042.77"
,IN,AR,30322937,1005,100,,Invoice,,,,,,17/08/2018,17/08/2018,0.00,,18.22,,"-800,060.99"
,IN,AR,30322941,1005,100,,Invoice,,,,,,17/08/2018,17/08/2018,0.00,,364.41,,"-800,425.40"
,IN,AR,30322944,1005,100,,Invoice,,,,,,17/08/2018,17/08/2018,0.00,,21.86,,"-800,447.26"
,IN,AR,30322973,1005,100,,Invoice,,,,,,17/08/2018,17/08/2018,0.00,,5.97,,"-800,453.23"
,IN,AR,30322979,1005,100,,Invoice,,,,,,17/08/2018,17/08/2018,0.00,,27.03,,"-800,480.26"
,IN,AR,30322988,1005,100,,Invoice,,,,,,17/08/2018,17/08/2018,0.00,,34.07,,"-800,514.33"
,IN,AR,30322992,1005,100,,Invoice,,,,,,17/08/2018,17/08/2018,0.00,,38.00,,"-800,552.33"
,IN,AR,30322994,1005,100,,Invoice,,,,,,17/08/2018,17/08/2018,0.00,,54.99,,"-800,607.32"
,IN,AR,30322999,1005,100,,Invoice,,,,,,17/08/2018,17/08/2018,0.00,,2.97,,"-800,610.29"
,IN,AR,30323009,1005,100,,Invoice,,,,,,17/08/2018,17/08/2018,0.00,,56.12,,"-800,666.41"
,IN,AR,30323019,1005,100,,Invoice,,,,,,17/08/2018,17/08/2018,0.00,,30.36,,"-800,696.77"
,IN,AR,30323021,1005,100,,Invoice,,,,,,17/08/2018,17/08/2018,0.00,,10.93,,"-800,707.70"
,IN,AR,30323027,1005,100,,Invoice,,,,,,17/08/2018,17/08/2018,0.00,,7.29,,"-800,714.99"
,IN,AR,30323032,1005,100,,Invoice,,,,,,17/08/2018,17/08/2018,0.00,,10.93,,"-800,725.92"
,IN,AR,30323035,1005,100,,Invoice,,,,,,17/08/2018,17/08/2018,0.00,,42.03,,"-800,767.95"
,IN,AR,30323037,1005,100,,Invoice,,,,,,17/08/2018,17/08/2018,0.00,,54.66,,"-800,822.61"
,IN,AR,30323047,1005,100,,Invoice,,,,,,17/08/2018,17/08/2018,0.00,,14.58,,"-800,837.19"
,IN,AR,30323052,1005,100,,Invoice,,,,,,17/08/2018,17/08/2018,0.00,,23.91,,"-800,861.10"
,IN,AR,30323056,1005,100,,Invoice,,,,,,17/08/2018,17/08/2018,0.00,,29.15,,"-800,890.25"
,IN,AR,30323074,1005,100,,Invoice,,,,,,17/08/2018,17/08/2018,0.00,,8.00,,"-800,898.25"
,IN,AR,30323078,1005,100,,Invoice,,,,,,17/08/2018,17/08/2018,0.00,,14.00,,"-800,912.25"
,IN,AR,30323081,1005,100,,Invoice,,,,,,17/08/2018,17/08/2018,0.00,,22.01,,"-800,934.26"
,IN,AR,30323085,1005,100,,Invoice,,,,,,17/08/2018,17/08/2018,0.00,,32.01,,"-800,966.27"
,IN,AR,30323095,1005,100,,Invoice,,,,,,17/08/2018,17/08/2018,0.00,,20.41,,"-800,986.68"
,IN,AR,30323112,1005,100,,Invoice,,,,,,17/08/2018,17/08/2018,0.00,,38.32,,"-801,025.00"
,IN,AR,30323120,1005,100,,Invoice,,,,,,17/08/2018,17/08/2018,0.00,,23.13,,"-801,048.13"
,IN,AR,30323121,1005,100,,Invoice,,,,,,17/08/2018,17/08/2018,0.00,,25.23,,"-801,073.36"
,IN,AR,30323127,1005,100,,Invoice,,,,,,17/08/2018,17/08/2018,0.00,,182.20,,"-801,255.56"
,IN,AR,30323143,1005,100,,Invoice,,,,,,17/08/2018,17/08/2018,0.00,,6.89,,"-801,262.45"
,IN,AR,30323148,1005,100,,Invoice,,,,,,17/08/2018,17/08/2018,0.00,,5.59,,"-801,268.04"
,IN,AR,30323169,1005,100,,Invoice,,,,,,17/08/2018,17/08/2018,0.00,,182.20,,"-801,450.24"
,IN,AR,30323170,1005,100,,Invoice,,,,,,17/08/2018,17/08/2018,0.00,,29.15,,"-801,479.39"
,IN,AR,30323183,1005,100,,Invoice,,,,,,17/08/2018,17/08/2018,0.00,,19.87,,"-801,499.26"
,IN,AR,30323194,1005,100,,Invoice,,,,,,17/08/2018,17/08/2018,0.00,,121.73,,"-801,620.99"
,IN,AR,30323206,1005,100,,Invoice,,,,,,17/08/2018,17/08/2018,0.00,,7.97,,"-801,628.96"
,IN,AR,30323211,1005,100,,Invoice,,,,,,17/08/2018,17/08/2018,0.00,,54.66,,"-801,683.62"
,IN,AR,30323235,1005,100,,Invoice,,,,,,17/08/2018,17/08/2018,0.00,,16.00,,"-801,699.62"
,IN,AR,30323245,1005,100,,Invoice,,,,,,17/08/2018,17/08/2018,0.00,,8.26,,"-801,707.88"
,IN,AR,30323259,1005,100,,Invoice,,,,,,17/08/2018,17/08/2018,0.00,,14.19,,"-801,722.07"
,IN,AR,30323261,1005,100,,Invoice,,,,,,17/08/2018,17/08/2018,0.00,,116.98,,"-801,839.05"
,IN,AR,30323273,1005,100,,Invoice,,,,,,17/08/2018,17/08/2018,0.00,,11.66,,"-801,850.71"
,IN,AR,30323279,1005,100,,Invoice,,,,,,17/08/2018,17/08/2018,0.00,,16.42,,"-801,867.13"
,IN,AR,30323283,1005,100,,Invoice,,,,,,17/08/2018,17/08/2018,0.00,,21.19,,"-801,888.32"
,IN,AR,30323322,1005,100,,Invoice,,,,,,17/08/2018,17/08/2018,0.00,,25.17,,"-801,913.49"
,IN,AR,30323326,1005,100,,Invoice,,,,,,17/08/2018,17/08/2018,0.00,,8.17,,"-801,921.66"
,IN,AR,30323327,1005,100,,Invoice,,,,,,17/08/2018,17/08/2018,0.00,,112.33,,"-802,033.99"
,IN,AR,30323348,1005,100,,Invoice,,,,,,17/08/2018,17/08/2018,0.00,,7.29,,"-802,041.28"
,IN,AR,30323353,1005,100,,Invoice,,,,,,17/08/2018,17/08/2018,0.00,,3.98,,"-802,045.26"
,IN,AR,30323368,1005,100,,Invoice,,,,,,17/08/2018,17/08/2018,0.00,,9.11,,"-802,054.37"
,IN,AR,30323375,1005,100,,Invoice,,,,,,17/08/2018,17/08/2018,0.00,,4.00,,"-802,058.37"
,IN,AR,30323415,1005,100,,Invoice,,,,,,17/08/2018,17/08/2018,0.00,,7.63,,"-802,066.00"
,IN,AR,30323425,1005,100,,Invoice,,,,,,17/08/2018,17/08/2018,0.00,,7.29,,"-802,073.29"
,IN,AR,30323427,1005,100,,Invoice,,,,,,17/08/2018,17/08/2018,0.00,,6.99,,"-802,080.28"
,IN,AR,30323430,1005,100,,Invoice,,,,,,17/08/2018,17/08/2018,0.00,,12.41,,"-802,092.69"
,IN,AR,30323439,1005,100,,Invoice,,,,,,17/08/2018,17/08/2018,0.00,,14.58,,"-802,107.27"
,IN,AR,30323442,1005,100,,Invoice,,,,,,17/08/2018,17/08/2018,0.00,,2.03,,"-802,109.30"
,IN,AR,30323443,1005,100,,Invoice,,,,,,17/08/2018,17/08/2018,0.00,,29.12,,"-802,138.42"
,IN,AR,30323454,1005,100,,Invoice,,,,,,17/08/2018,17/08/2018,0.00,,10.93,,"-802,149.35"
,IN,AR,30323458,1005,100,,Invoice,,,,,,17/08/2018,17/08/2018,0.00,,54.66,,"-802,204.01"
,IN,AR,30323481,1005,100,,Invoice,,,,,,17/08/2018,17/08/2018,0.00,,3.03,,"-802,207.04"
,IN,AR,30323491,1005,100,,Invoice,,,,,,17/08/2018,17/08/2018,0.00,,7.29,,"-802,214.33"
,IN,AR,30323505,1005,100,,Invoice,,,,,,17/08/2018,17/08/2018,0.00,,7.29,,"-802,221.62"
,IN,AR,30323514,1005,100,,Invoice,,,,,,17/08/2018,17/08/2018,0.00,,182.20,,"-802,403.82"
,IN,AR,30324231,1005,100,,Invoice,,,,,,17/08/2018,17/08/2018,0.00,,5.08,,"-802,408.90"
,CS,AR,32007347,1005,100,,Cash sale,,,,,,18/08/2018,18/08/2018,0.00,,15.04,,"-802,423.94"
,CS,AR,32007418,1005,100,,Cash sale,,,,,,18/08/2018,18/08/2018,0.00,,7.29,,"-802,431.23"
,CS,AR,32007444,1005,100,,Cash sale,,,,,,18/08/2018,18/08/2018,0.00,,3.64,,"-802,434.87"
,CS,AR,32007533,1005,100,,Cash sale,,,,,,18/08/2018,18/08/2018,0.00,,5.17,,"-802,440.04"
,CS,AR,32007569,1005,100,,Cash sale,,,,,,18/08/2018,18/08/2018,0.00,,7.29,,"-802,447.33"
,CS,AR,32007605,1005,100,,Cash sale,,,,,,18/08/2018,18/08/2018,0.00,,9.66,,"-802,456.99"
,CS,AR,32007626,1005,100,,Cash sale,,,,,,18/08/2018,18/08/2018,0.00,,18.22,,"-802,475.21"
,CS,AR,32007658,1005,100,,Cash sale,,,,,,18/08/2018,18/08/2018,0.00,,10.93,,"-802,486.14"
,CS,AR,32007677,1005,100,,Cash sale,,,,,,18/08/2018,18/08/2018,0.00,,14.58,,"-802,500.72"
,CS,AR,32007735,1005,100,,Cash sale,,,,,,18/08/2018,18/08/2018,0.00,,14.58,,"-802,515.30"
,CS,AR,32007778,1005,100,,Cash sale,,,,,,18/08/2018,18/08/2018,0.00,,9.15,,"-802,524.45"
,CS,AR,32007788,1005,100,,Cash sale,,,,,,18/08/2018,18/08/2018,0.00,,7.29,,"-802,531.74"
,CS,AR,32007801,1005,100,,Cash sale,,,,,,18/08/2018,18/08/2018,0.00,,8.75,,"-802,540.49"
,CS,AR,32007803,1005,100,,Cash sale,,,,,,18/08/2018,18/08/2018,0.00,,11.70,,"-802,552.19"
,CS,AR,32007807,1005,100,,Cash sale,,,,,,18/08/2018,18/08/2018,0.00,,5.85,,"-802,558.04"
,CS,AR,32007851,1005,100,,Cash sale,,,,,,18/08/2018,18/08/2018,0.00,,7.29,,"-802,565.33"
,IN,AR,30322325,1005,100,,Invoice,,,,,,18/08/2018,18/08/2018,0.00,,33.22,,"-802,598.55"
,IN,AR,30322333,1005,100,,Invoice,,,,,,18/08/2018,18/08/2018,0.00,,45.13,,"-802,643.68"
,IN,AR,30322437,1005,100,,Invoice,,,,,,18/08/2018,18/08/2018,0.00,,86.03,,"-802,729.71"
,IN,AR,30322574,1005,100,,Invoice,,,,,,18/08/2018,18/08/2018,0.00,,612.20,,"-803,341.91"
,IN,AR,30322868,1005,100,,Invoice,,,,,,18/08/2018,18/08/2018,0.00,,8.02,,"-803,349.93"
,IN,AR,30322886,1005,100,,Invoice,,,,,,18/08/2018,18/08/2018,0.00,,9.29,,"-803,359.22"
,IN,AR,30322927,1005,100,,Invoice,,,,,,18/08/2018,18/08/2018,0.00,,14.58,,"-803,373.80"
,IN,AR,30323054,1005,100,,Invoice,,,,,,18/08/2018,18/08/2018,0.00,,18.22,,"-803,392.02"
,IN,AR,30323156,1005,100,,Invoice,,,,,,18/08/2018,18/08/2018,0.00,,18.22,,"-803,410.24"
,IN,AR,30323290,1005,100,,Invoice,,,,,,18/08/2018,18/08/2018,0.00,,12.14,,"-803,422.38"
,IN,AR,30323314,1005,100,,Invoice,,,,,,18/08/2018,18/08/2018,0.00,,10.93,,"-803,433.31"
,IN,AR,30323479,1005,100,,Invoice,,,,,,18/08/2018,18/08/2018,0.00,,54.66,,"-803,487.97"
,IN,AR,30323510,1005,100,,Invoice,,,,,,18/08/2018,18/08/2018,0.00,,3.64,,"-803,491.61"
,IN,AR,30322427,1005,100,,Invoice,,,,,,19/08/2018,19/08/2018,0.00,,585.72,,"-804,077.33"
,CS,AR,32007354,1005,100,,Cash sale,,,,,,20/08/2018,20/08/2018,0.00,,22.44,,"-804,099.77"
,CS,AR,32007362,1005,100,,Cash sale,,,,,,20/08/2018,20/08/2018,0.00,,7.12,,"-804,106.89"
,CS,AR,32007369,1005,100,,Cash sale,,,,,,20/08/2018,20/08/2018,0.00,,3.64,,"-804,110.53"
,CS,AR,32007372,1005,100,,Cash sale,,,,,,20/08/2018,20/08/2018,0.00,,7.29,,"-804,117.82"
,CS,AR,32007414,1005,100,,Cash sale,,,,,,20/08/2018,20/08/2018,0.00,,12.46,,"-804,130.28"
,CS,AR,32007432,1005,100,,Cash sale,,,,,,20/08/2018,20/08/2018,0.00,,7.29,,"-804,137.57"
,CS,AR,32007439,1005,100,,Cash sale,,,,,,20/08/2018,20/08/2018,0.00,,10.93,,"-804,148.50"
,CS,AR,32007446,1005,100,,Cash sale,,,,,,20/08/2018,20/08/2018,0.00,,3.64,,"-804,152.14"
,CS,AR,32007464,1005,100,,Cash sale,,,,,,20/08/2018,20/08/2018,0.00,,10.34,,"-804,162.48"
,CS,AR,32007484,1005,100,,Cash sale,,,,,,20/08/2018,20/08/2018,0.00,,10.93,,"-804,173.41"
,CS,AR,32007493,1005,100,,Cash sale,,,,,,20/08/2018,20/08/2018,0.00,,20.34,,"-804,193.75"
,CS,AR,32007501,1005,100,,Cash sale,,,,,,20/08/2018,20/08/2018,0.00,,25.85,,"-804,219.60"
,CS,AR,32007509,1005,100,,Cash sale,,,,,,20/08/2018,20/08/2018,0.00,,16.48,,"-804,236.08"
,CS,AR,32007512,1005,100,,Cash sale,,,,,,20/08/2018,20/08/2018,0.00,,7.29,,"-804,243.37"
,CS,AR,32007515,1005,100,,Cash sale,,,,,,20/08/2018,20/08/2018,0.00,,7.29,,"-804,250.66"
,CS,AR,32007516,1005,100,,Cash sale,,,,,,20/08/2018,20/08/2018,0.00,,7.29,,"-804,257.95"
,CS,AR,32007526,1005,100,,Cash sale,,,,,,20/08/2018,20/08/2018,0.00,,7.29,,"-804,265.24"
,CS,AR,32007541,1005,100,,Cash sale,,,,,,20/08/2018,20/08/2018,0.00,,7.63,,"-804,272.87"
,CS,AR,32007548,1005,100,,Cash sale,,,,,,20/08/2018,20/08/2018,0.00,,17.54,,"-804,290.41"
,CS,AR,32007556,1005,100,,Cash sale,,,,,,20/08/2018,20/08/2018,0.00,,18.05,,"-804,308.46"
,CS,AR,32007557,1005,100,,Cash sale,,,,,,20/08/2018,20/08/2018,0.00,,21.06,,"-804,329.52"
,CS,AR,32007566,1005,100,,Cash sale,,,,,,20/08/2018,20/08/2018,0.00,,6.48,,"-804,336.00"
,CS,AR,32007571,1005,100,,Cash sale,,,,,,20/08/2018,20/08/2018,0.00,,3.64,,"-804,339.64"
,CS,AR,32007572,1005,100,,Cash sale,,,,,,20/08/2018,20/08/2018,0.00,,3.64,,"-804,343.28"
,CS,AR,32007576,1005,100,,Cash sale,,,,,,20/08/2018,20/08/2018,0.00,,14.58,,"-804,357.86"
,CS,AR,32007579,1005,100,,Cash sale,,,,,,20/08/2018,20/08/2018,0.00,,7.29,,"-804,365.15"
,CS,AR,32007585,1005,100,,Cash sale,,,,,,20/08/2018,20/08/2018,0.00,,7.29,,"-804,372.44"
,CS,AR,32007589,1005,100,,Cash sale,,,,,,20/08/2018,20/08/2018,0.00,,3.64,,"-804,376.08"
,CS,AR,32007594,1005,100,,Cash sale,,,,,,20/08/2018,20/08/2018,0.00,,5.08,,"-804,381.16"
,CS,AR,32007612,1005,100,,Cash sale,,,,,,20/08/2018,20/08/2018,0.00,,10.34,,"-804,391.50"
,CS,AR,32007615,1005,100,,Cash sale,,,,,,20/08/2018,20/08/2018,0.00,,3.64,,"-804,395.14"
,CS,AR,32007622,1005,100,,Cash sale,,,,,,20/08/2018,20/08/2018,0.00,,10.93,,"-804,406.07"
,CS,AR,32007625,1005,100,,Cash sale,,,,,,20/08/2018,20/08/2018,0.00,,7.29,,"-804,413.36"
,CS,AR,32007636,1005,100,,Cash sale,,,,,,20/08/2018,20/08/2018,0.00,,7.29,,"-804,420.65"
,CS,AR,32007648,1005,100,,Cash sale,,,,,,20/08/2018,20/08/2018,0.00,,5.17,,"-804,425.82"
,CS,AR,32007651,1005,100,,Cash sale,,,,,,20/08/2018,20/08/2018,0.00,,6.42,,"-804,432.24"
,CS,AR,32007668,1005,100,,Cash sale,,,,,,20/08/2018,20/08/2018,0.00,,7.29,,"-804,439.53"
,CS,AR,32007682,1005,100,,Cash sale,,,,,,20/08/2018,20/08/2018,0.00,,15.25,,"-804,454.78"
,CS,AR,32007687,1005,100,,Cash sale,,,,,,20/08/2018,20/08/2018,0.00,,7.29,,"-804,462.07"
,CS,AR,32007691,1005,100,,Cash sale,,,,,,20/08/2018,20/08/2018,0.00,,2.58,,"-804,464.65"
,CS,AR,32007714,1005,100,,Cash sale,,,,,,20/08/2018,20/08/2018,0.00,,9.84,,"-804,474.49"
,CS,AR,32007715,1005,100,,Cash sale,,,,,,20/08/2018,20/08/2018,0.00,,6.56,,"-804,481.05"
,CS,AR,32007717,1005,100,,Cash sale,,,,,,20/08/2018,20/08/2018,0.00,,7.29,,"-804,488.34"
,CS,AR,32007731,1005,100,,Cash sale,,,,,,20/08/2018,20/08/2018,0.00,,11.44,,"-804,499.78"
,CS,AR,32007745,1005,100,,Cash sale,,,,,,20/08/2018,20/08/2018,0.00,,5.47,,"-804,505.25"
,CS,AR,32007762,1005,100,,Cash sale,,,,,,20/08/2018,20/08/2018,0.00,,15.18,,"-804,520.43"
,CS,AR,32007773,1005,100,,Cash sale,,,,,,20/08/2018,20/08/2018,0.00,,7.29,,"-804,527.72"
,CS,AR,32007775,1005,100,,Cash sale,,,,,,20/08/2018,20/08/2018,0.00,,10.93,,"-804,538.65"
,CS,AR,32007795,1005,100,,Cash sale,,,,,,20/08/2018,20/08/2018,0.00,,6.56,,"-804,545.21"
,CS,AR,32007841,1005,100,,Cash sale,,,,,,20/08/2018,20/08/2018,0.00,,3.03,,"-804,548.24"
,CS,AR,32007842,1005,100,,Cash sale,,,,,,20/08/2018,20/08/2018,0.00,,7.29,,"-804,555.53"
,CS,AR,32007847,1005,100,,Cash sale,,,,,,20/08/2018,20/08/2018,0.00,,7.29,,"-804,562.82"
,CS,AR,32007854,1005,100,,Cash sale,,,,,,20/08/2018,20/08/2018,0.00,,54.66,,"-804,617.48"
,CS,AR,32007863,1005,100,,Cash sale,,,,,,20/08/2018,20/08/2018,0.00,,3.64,,"-804,621.12"
,CS,AR,32007870,1005,100,,Cash sale,,,,,,20/08/2018,20/08/2018,0.00,,10.93,,"-804,632.05"
,IN,AR,30322229,1005,100,,Invoice,,,,,,20/08/2018,20/08/2018,0.00,,62.29,,"-804,694.34"
,IN,AR,30322235,1005,100,,Invoice,,,,,,20/08/2018,20/08/2018,0.00,,14.58,,"-804,708.92"
,IN,AR,30322260,1005,100,,Invoice,,,,,,20/08/2018,20/08/2018,0.00,,4.05,,"-804,712.97"
,IN,AR,30322261,1005,100,,Invoice,,,,,,20/08/2018,20/08/2018,0.00,,2.03,,"-804,715.00"
,IN,AR,30322262,1005,100,,Invoice,,,,,,20/08/2018,20/08/2018,0.00,,6.08,,"-804,721.08"
,IN,AR,30322263,1005,100,,Invoice,,,,,,20/08/2018,20/08/2018,0.00,,2.03,,"-804,723.11"
,IN,AR,30322264,1005,100,,Invoice,,,,,,20/08/2018,20/08/2018,0.00,,20.25,,"-804,743.36"
,IN,AR,30322265,1005,100,,Invoice,,,,,,20/08/2018,20/08/2018,0.00,,10.13,,"-804,753.49"
,IN,AR,30322266,1005,100,,Invoice,,,,,,20/08/2018,20/08/2018,0.00,,2.03,,"-804,755.52"
,IN,AR,30322298,1005,100,,Invoice,,,,,,20/08/2018,20/08/2018,0.00,,69.75,,"-804,825.27"
,IN,AR,30322326,1005,100,,Invoice,,,,,,20/08/2018,20/08/2018,0.00,,173.22,,"-804,998.49"
,IN,AR,30322329,1005,100,,Invoice,,,,,,20/08/2018,20/08/2018,0.00,,11.02,,"-805,009.51"
,IN,AR,30322339,1005,100,,Invoice,,,,,,20/08/2018,20/08/2018,0.00,,54.00,,"-805,063.51"
,IN,AR,30322351,1005,100,,Invoice,,,,,,20/08/2018,20/08/2018,0.00,,38.18,,"-805,101.69"
,IN,AR,30322368,1005,100,,Invoice,,,,,,20/08/2018,20/08/2018,0.00,,52.00,,"-805,153.69"
,IN,AR,30322369,1005,100,,Invoice,,,,,,20/08/2018,20/08/2018,0.00,,28.00,,"-805,181.69"
,IN,AR,30322378,1005,100,,Invoice,,,,,,20/08/2018,20/08/2018,0.00,,50.85,,"-805,232.54"
,IN,AR,30322380,1005,100,,Invoice,,,,,,20/08/2018,20/08/2018,0.00,,2.75,,"-805,235.29"
,IN,AR,30322390,1005,100,,Invoice,,,,,,20/08/2018,20/08/2018,0.00,,7.78,,"-805,243.07"
,IN,AR,30322396,1005,100,,Invoice,,,,,,20/08/2018,20/08/2018,0.00,,8.77,,"-805,251.84"
,IN,AR,30322408,1005,100,,Invoice,,,,,,20/08/2018,20/08/2018,0.00,,14.00,,"-805,265.84"
,IN,AR,30322411,1005,100,,Invoice,,,,,,20/08/2018,20/08/2018,0.00,,10.93,,"-805,276.77"
,IN,AR,30322414,1005,100,,Invoice,,,,,,20/08/2018,20/08/2018,0.00,,54.66,,"-805,331.43"
,IN,AR,30322419,1005,100,,Invoice,,,,,,20/08/2018,20/08/2018,0.00,,21.86,,"-805,353.29"
,IN,AR,30322422,1005,100,,Invoice,,,,,,20/08/2018,20/08/2018,0.00,,28.39,,"-805,381.68"
,IN,AR,30322443,1005,100,,Invoice,,,,,,20/08/2018,20/08/2018,0.00,,24.00,,"-805,405.68"
,IN,AR,30322452,1005,100,,Invoice,,,,,,20/08/2018,20/08/2018,0.00,,6.02,,"-805,411.70"
,IN,AR,30322464,1005,100,,Invoice,,,,,,20/08/2018,20/08/2018,0.00,,11.27,,"-805,422.97"
,IN,AR,30322469,1005,100,,Invoice,,,,,,20/08/2018,20/08/2018,0.00,,29.15,,"-805,452.12"
,IN,AR,30322470,1005,100,,Invoice,,,,,,20/08/2018,20/08/2018,0.00,,10.93,,"-805,463.05"
,IN,AR,30322471,1005,100,,Invoice,,,,,,20/08/2018,20/08/2018,0.00,,10.93,,"-805,473.98"
,IN,AR,30322473,1005,100,,Invoice,,,,,,20/08/2018,20/08/2018,0.00,,87.46,,"-805,561.44"
,IN,AR,30322480,1005,100,,Invoice,,,,,,20/08/2018,20/08/2018,0.00,,33.60,,"-805,595.04"
,IN,AR,30322489,1005,100,,Invoice,,,,,,20/08/2018,20/08/2018,0.00,,12.92,,"-805,607.96"
,IN,AR,30322501,1005,100,,Invoice,,,,,,20/08/2018,20/08/2018,0.00,,54.66,,"-805,662.62"
,IN,AR,30322504,1005,100,,Invoice,,,,,,20/08/2018,20/08/2018,0.00,,4.80,,"-805,667.42"
,IN,AR,30322507,1005,100,,Invoice,,,,,,20/08/2018,20/08/2018,0.00,,11.48,,"-805,678.90"
,IN,AR,30322514,1005,100,,Invoice,,,,,,20/08/2018,20/08/2018,0.00,,10.51,,"-805,689.41"
,IN,AR,30322525,1005,100,,Invoice,,,,,,20/08/2018,20/08/2018,0.00,,4.24,,"-805,693.65"
,IN,AR,30322540,1005,100,,Invoice,,,,,,20/08/2018,20/08/2018,0.00,,25.42,,"-805,719.07"
,IN,AR,30322542,1005,100,,Invoice,,,,,,20/08/2018,20/08/2018,0.00,,21.19,,"-805,740.26"
,IN,AR,30322547,1005,100,,Invoice,,,,,,20/08/2018,20/08/2018,0.00,,33.60,,"-805,773.86"
,IN,AR,30322558,1005,100,,Invoice,,,,,,20/08/2018,20/08/2018,0.00,,5.93,,"-805,779.79"
,IN,AR,30322561,1005,100,,Invoice,,,,,,20/08/2018,20/08/2018,0.00,,54.33,,"-805,834.12"
,IN,AR,30322562,1005,100,,Invoice,,,,,,20/08/2018,20/08/2018,0.00,,7.76,,"-805,841.88"
,IN,AR,30322567,1005,100,,Invoice,,,,,,20/08/2018,20/08/2018,0.00,,3.64,,"-805,845.52"
,IN,AR,30322583,1005,100,,Invoice,,,,,,20/08/2018,20/08/2018,0.00,,104.59,,"-805,950.11"
,IN,AR,30322589,1005,100,,Invoice,,,,,,20/08/2018,20/08/2018,0.00,,22.88,,"-805,972.99"
,IN,AR,30322599,1005,100,,Invoice,,,,,,20/08/2018,20/08/2018,0.00,,23.90,,"-805,996.89"
,IN,AR,30322603,1005,100,,Invoice,,,,,,20/08/2018,20/08/2018,0.00,,19.32,,"-806,016.21"
,IN,AR,30322607,1005,100,,Invoice,,,,,,20/08/2018,20/08/2018,0.00,,12.03,,"-806,028.24"
,IN,AR,30322611,1005,100,,Invoice,,,,,,20/08/2018,20/08/2018,0.00,,16.95,,"-806,045.19"
,IN,AR,30322613,1005,100,,Invoice,,,,,,20/08/2018,20/08/2018,0.00,,4.24,,"-806,049.43"
,IN,AR,30322616,1005,100,,Invoice,,,,,,20/08/2018,20/08/2018,0.00,,5.51,,"-806,054.94"
,IN,AR,30322618,1005,100,,Invoice,,,,,,20/08/2018,20/08/2018,0.00,,182.20,,"-806,237.14"
,IN,AR,30322624,1005,100,,Invoice,,,,,,20/08/2018,20/08/2018,0.00,,2.12,,"-806,239.26"
,IN,AR,30322626,1005,100,,Invoice,,,,,,20/08/2018,20/08/2018,0.00,,30.08,,"-806,269.34"
,IN,AR,30322647,1005,100,,Invoice,,,,,,20/08/2018,20/08/2018,0.00,,10.17,,"-806,279.51"
,IN,AR,30322666,1005,100,,Invoice,,,,,,20/08/2018,20/08/2018,0.00,,7.29,,"-806,286.80"
,IN,AR,30322693,1005,100,,Invoice,,,,,,20/08/2018,20/08/2018,0.00,,364.41,,"-806,651.21"
,IN,AR,30322697,1005,100,,Invoice,,,,,,20/08/2018,20/08/2018,0.00,,25.42,,"-806,676.63"
,IN,AR,30322704,1005,100,,Invoice,,,,,,20/08/2018,20/08/2018,0.00,,18.31,,"-806,694.94"
,IN,AR,30322708,1005,100,,Invoice,,,,,,20/08/2018,20/08/2018,0.00,,10.93,,"-806,705.87"
,IN,AR,30322716,1005,100,,Invoice,,,,,,20/08/2018,20/08/2018,0.00,,7.29,,"-806,713.16"
,IN,AR,30322727,1005,100,,Invoice,,,,,,20/08/2018,20/08/2018,0.00,,27.54,,"-806,740.70"
,IN,AR,30322734,1005,100,,Invoice,,,,,,20/08/2018,20/08/2018,0.00,,5.51,,"-806,746.21"
,IN,AR,30322736,1005,100,,Invoice,,,,,,20/08/2018,20/08/2018,0.00,,7.29,,"-806,753.50"
,IN,AR,30322744,1005,100,,Invoice,,,,,,20/08/2018,20/08/2018,0.00,,9.19,,"-806,762.69"
,IN,AR,30322748,1005,100,,Invoice,,,,,,20/08/2018,20/08/2018,0.00,,19.64,,"-806,782.33"
,IN,AR,30322751,1005,100,,Invoice,,,,,,20/08/2018,20/08/2018,0.00,,13.14,,"-806,795.47"
,IN,AR,30322752,1005,100,,Invoice,,,,,,20/08/2018,20/08/2018,0.00,,7.29,,"-806,802.76"
,IN,AR,30322790,1005,100,,Invoice,,,,,,20/08/2018,20/08/2018,0.00,,7.29,,"-806,810.05"
,IN,AR,30322796,1005,100,,Invoice,,,,,,20/08/2018,20/08/2018,0.00,,18.00,,"-806,828.05"
,IN,AR,30322821,1005,100,,Invoice,,,,,,20/08/2018,20/08/2018,0.00,,18.22,,"-806,846.27"
,IN,AR,30322825,1005,100,,Invoice,,,,,,20/08/2018,20/08/2018,0.00,,7.75,,"-806,854.02"
,IN,AR,30322836,1005,100,,Invoice,,,,,,20/08/2018,20/08/2018,0.00,,26.26,,"-806,880.28"
,IN,AR,30322837,1005,100,,Invoice,,,,,,20/08/2018,20/08/2018,0.00,,13.88,,"-806,894.16"
,IN,AR,30322842,1005,100,,Invoice,,,,,,20/08/2018,20/08/2018,0.00,,2.25,,"-806,896.41"
,IN,AR,30322849,1005,100,,Invoice,,,,,,20/08/2018,20/08/2018,0.00,,"1,093.22",,"-807,989.63"
,IN,AR,30322883,1005,100,,Invoice,,,,,,20/08/2018,20/08/2018,0.00,,171.53,,"-808,161.16"
,IN,AR,30322902,1005,100,,Invoice,,,,,,20/08/2018,20/08/2018,0.00,,3.64,,"-808,164.80"
,IN,AR,30322924,1005,100,,Invoice,,,,,,20/08/2018,20/08/2018,0.00,,10.93,,"-808,175.73"
,IN,AR,30322940,1005,100,,Invoice,,,,,,20/08/2018,20/08/2018,0.00,,4.29,,"-808,180.02"
,IN,AR,30322943,1005,100,,Invoice,,,,,,20/08/2018,20/08/2018,0.00,,8.52,,"-808,188.54"
,IN,AR,30322947,1005,100,,Invoice,,,,,,20/08/2018,20/08/2018,0.00,,54.66,,"-808,243.20"
,IN,AR,30322948,1005,100,,Invoice,,,,,,20/08/2018,20/08/2018,0.00,,54.66,,"-808,297.86"
,IN,AR,30322996,1005,100,,Invoice,,,,,,20/08/2018,20/08/2018,0.00,,2.14,,"-808,300.00"
,IN,AR,30323005,1005,100,,Invoice,,,,,,20/08/2018,20/08/2018,0.00,,11.36,,"-808,311.36"
,IN,AR,30323010,1005,100,,Invoice,,,,,,20/08/2018,20/08/2018,0.00,,32.07,,"-808,343.43"
,IN,AR,30323011,1005,100,,Invoice,,,,,,20/08/2018,20/08/2018,0.00,,7.29,,"-808,350.72"
,IN,AR,30323016,1005,100,,Invoice,,,,,,20/08/2018,20/08/2018,0.00,,8.21,,"-808,358.93"
,IN,AR,30323020,1005,100,,Invoice,,,,,,20/08/2018,20/08/2018,0.00,,21.25,,"-808,380.18"
,IN,AR,30323036,1005,100,,Invoice,,,,,,20/08/2018,20/08/2018,0.00,,47.29,,"-808,427.47"
,IN,AR,30323059,1005,100,,Invoice,,,,,,20/08/2018,20/08/2018,0.00,,29.15,,"-808,456.62"
,IN,AR,30323075,1005,100,,Invoice,,,,,,20/08/2018,20/08/2018,0.00,,14.00,,"-808,470.62"
,IN,AR,30323086,1005,100,,Invoice,,,,,,20/08/2018,20/08/2018,0.00,,22.01,,"-808,492.63"
,IN,AR,30323122,1005,100,,Invoice,,,,,,20/08/2018,20/08/2018,0.00,,18.92,,"-808,511.55"
,IN,AR,30323131,1005,100,,Invoice,,,,,,20/08/2018,20/08/2018,0.00,,25.51,,"-808,537.06"
,IN,AR,30323140,1005,100,,Invoice,,,,,,20/08/2018,20/08/2018,0.00,,14.03,,"-808,551.09"
,IN,AR,30323177,1005,100,,Invoice,,,,,,20/08/2018,20/08/2018,0.00,,10.93,,"-808,562.02"
,IN,AR,30323181,1005,100,,Invoice,,,,,,20/08/2018,20/08/2018,0.00,,29.15,,"-808,591.17"
,IN,AR,30323192,1005,100,,Invoice,,,,,,20/08/2018,20/08/2018,0.00,,24.03,,"-808,615.20"
,IN,AR,30323207,1005,100,,Invoice,,,,,,20/08/2018,20/08/2018,0.00,,30.27,,"-808,645.47"
,IN,AR,30323213,1005,100,,Invoice,,,,,,20/08/2018,20/08/2018,0.00,,44.24,,"-808,689.71"
,IN,AR,30323236,1005,100,,Invoice,,,,,,20/08/2018,20/08/2018,0.00,,12.00,,"-808,701.71"
,IN,AR,30323240,1005,100,,Invoice,,,,,,20/08/2018,20/08/2018,0.00,,1.88,,"-808,703.59"
,IN,AR,30323253,1005,100,,Invoice,,,,,,20/08/2018,20/08/2018,0.00,,9.08,,"-808,712.67"
,IN,AR,30323255,1005,100,,Invoice,,,,,,20/08/2018,20/08/2018,0.00,,29.15,,"-808,741.82"
,IN,AR,30323280,1005,100,,Invoice,,,,,,20/08/2018,20/08/2018,0.00,,10.95,,"-808,752.77"
,IN,AR,30323293,1005,100,,Invoice,,,,,,20/08/2018,20/08/2018,0.00,,21.86,,"-808,774.63"
,IN,AR,30323317,1005,100,,Invoice,,,,,,20/08/2018,20/08/2018,0.00,,13.09,,"-808,787.72"
,IN,AR,30323328,1005,100,,Invoice,,,,,,20/08/2018,20/08/2018,0.00,,4.08,,"-808,791.80"
,IN,AR,30323355,1005,100,,Invoice,,,,,,20/08/2018,20/08/2018,0.00,,54.66,,"-808,846.46"
,IN,AR,30323360,1005,100,,Invoice,,,,,,20/08/2018,20/08/2018,0.00,,52.63,,"-808,899.09"
,IN,AR,30323363,1005,100,,Invoice,,,,,,20/08/2018,20/08/2018,0.00,,18.20,,"-808,917.29"
,IN,AR,30323376,1005,100,,Invoice,,,,,,20/08/2018,20/08/2018,0.00,,4.00,,"-808,921.29"
,IN,AR,30323377,1005,100,,Invoice,,,,,,20/08/2018,20/08/2018,0.00,,2.00,,"-808,923.29"
,IN,AR,30323403,1005,100,,Invoice,,,,,,20/08/2018,20/08/2018,0.00,,2.08,,"-808,925.37"
,IN,AR,30323404,1005,100,,Invoice,,,,,,20/08/2018,20/08/2018,0.00,,6.23,,"-808,931.60"
,IN,AR,30323405,1005,100,,Invoice,,,,,,20/08/2018,20/08/2018,0.00,,6.23,,"-808,937.83"
,IN,AR,30323406,1005,100,,Invoice,,,,,,20/08/2018,20/08/2018,0.00,,4.15,,"-808,941.98"
,IN,AR,30323413,1005,100,,Invoice,,,,,,20/08/2018,20/08/2018,0.00,,5.08,,"-808,947.06"
,IN,AR,30323420,1005,100,,Invoice,,,,,,20/08/2018,20/08/2018,0.00,,21.25,,"-808,968.31"
,IN,AR,30323428,1005,100,,Invoice,,,,,,20/08/2018,20/08/2018,0.00,,9.32,,"-808,977.63"
,IN,AR,30323431,1005,100,,Invoice,,,,,,20/08/2018,20/08/2018,0.00,,7.29,,"-808,984.92"
,IN,AR,30323440,1005,100,,Invoice,,,,,,20/08/2018,20/08/2018,0.00,,14.58,,"-808,999.50"
,IN,AR,30323444,1005,100,,Invoice,,,,,,20/08/2018,20/08/2018,0.00,,21.86,,"-809,021.36"
,IN,AR,30323471,1005,100,,Invoice,,,,,,20/08/2018,20/08/2018,0.00,,42.05,,"-809,063.41"
,IN,AR,30323478,1005,100,,Invoice,,,,,,20/08/2018,20/08/2018,0.00,,7.29,,"-809,070.70"
,IN,AR,30323509,1005,100,,Invoice,,,,,,20/08/2018,20/08/2018,0.00,,117.37,,"-809,188.07"
,IN,AR,30323517,1005,100,,Invoice,,,,,,20/08/2018,20/08/2018,0.00,,29.15,,"-809,217.22"
,IN,AR,30323518,1005,100,,Invoice,,,,,,20/08/2018,20/08/2018,0.00,,3.64,,"-809,220.86"
,IN,AR,30323519,1005,100,,Invoice,,,,,,20/08/2018,20/08/2018,0.00,,3.64,,"-809,224.50"
,IN,AR,30323520,1005,100,,Invoice,,,,,,20/08/2018,20/08/2018,0.00,,10.93,,"-809,235.43"
,IN,AR,30323521,1005,100,,Invoice,,,,,,20/08/2018,20/08/2018,0.00,,7.29,,"-809,242.72"
,CS,AR,32007374,1005,100,,Cash sale,,,,,,21/08/2018,21/08/2018,0.00,,7.29,,"-809,250.01"
,CS,AR,32007376,1005,100,,Cash sale,,,,,,21/08/2018,21/08/2018,0.00,,7.29,,"-809,257.30"
,CS,AR,32007401,1005,100,,Cash sale,,,,,,21/08/2018,21/08/2018,0.00,,3.01,,"-809,260.31"
,CS,AR,32007438,1005,100,,Cash sale,,,,,,21/08/2018,21/08/2018,0.00,,21.86,,"-809,282.17"
,CS,AR,32007441,1005,100,,Cash sale,,,,,,21/08/2018,21/08/2018,0.00,,7.29,,"-809,289.46"
,CS,AR,32007443,1005,100,,Cash sale,,,,,,21/08/2018,21/08/2018,0.00,,7.29,,"-809,296.75"
,CS,AR,32007452,1005,100,,Cash sale,,,,,,21/08/2018,21/08/2018,0.00,,3.64,,"-809,300.39"
,CS,AR,32007465,1005,100,,Cash sale,,,,,,21/08/2018,21/08/2018,0.00,,29.15,,"-809,329.54"
,CS,AR,32007469,1005,100,,Cash sale,,,,,,21/08/2018,21/08/2018,0.00,,15.25,,"-809,344.79"
,CS,AR,32007471,1005,100,,Cash sale,,,,,,21/08/2018,21/08/2018,0.00,,14.58,,"-809,359.37"
,CS,AR,32007474,1005,100,,Cash sale,,,,,,21/08/2018,21/08/2018,0.00,,7.29,,"-809,366.66"
,CS,AR,32007480,1005,100,,Cash sale,,,,,,21/08/2018,21/08/2018,0.00,,6.48,,"-809,373.14"
,CS,AR,32007489,1005,100,,Cash sale,,,,,,21/08/2018,21/08/2018,0.00,,10.93,,"-809,384.07"
,CS,AR,32007499,1005,100,,Cash sale,,,,,,21/08/2018,21/08/2018,0.00,,18.22,,"-809,402.29"
,CS,AR,32007521,1005,100,,Cash sale,,,,,,21/08/2018,21/08/2018,0.00,,7.29,,"-809,409.58"
,CS,AR,32007532,1005,100,,Cash sale,,,,,,21/08/2018,21/08/2018,0.00,,3.64,,"-809,413.22"
,CS,AR,32007551,1005,100,,Cash sale,,,,,,21/08/2018,21/08/2018,0.00,,3.90,,"-809,417.12"
,CS,AR,32007552,1005,100,,Cash sale,,,,,,21/08/2018,21/08/2018,0.00,,7.29,,"-809,424.41"
,CS,AR,32007559,1005,100,,Cash sale,,,,,,21/08/2018,21/08/2018,0.00,,6.13,,"-809,430.54"
,CS,AR,32007567,1005,100,,Cash sale,,,,,,21/08/2018,21/08/2018,0.00,,5.85,,"-809,436.39"
,CS,AR,32007588,1005,100,,Cash sale,,,,,,21/08/2018,21/08/2018,0.00,,5.17,,"-809,441.56"
,CS,AR,32007596,1005,100,,Cash sale,,,,,,21/08/2018,21/08/2018,0.00,,5.17,,"-809,446.73"
,CS,AR,32007597,1005,100,,Cash sale,,,,,,21/08/2018,21/08/2018,0.00,,18.05,,"-809,464.78"
,CS,AR,32007598,1005,100,,Cash sale,,,,,,21/08/2018,21/08/2018,0.00,,18.22,,"-809,483.00"
,CS,AR,32007602,1005,100,,Cash sale,,,,,,21/08/2018,21/08/2018,0.00,,10.93,,"-809,493.93"
,CS,AR,32007634,1005,100,,Cash sale,,,,,,21/08/2018,21/08/2018,0.00,,7.29,,"-809,501.22"
,CS,AR,32007647,1005,100,,Cash sale,,,,,,21/08/2018,21/08/2018,0.00,,3.64,,"-809,504.86"
,CS,AR,32007659,1005,100,,Cash sale,,,,,,21/08/2018,21/08/2018,0.00,,19.30,,"-809,524.16"
,CS,AR,32007660,1005,100,,Cash sale,,,,,,21/08/2018,21/08/2018,0.00,,1.88,,"-809,526.04"
,CS,AR,32007676,1005,100,,Cash sale,,,,,,21/08/2018,21/08/2018,0.00,,10.93,,"-809,536.97"
,CS,AR,32007698,1005,100,,Cash sale,,,,,,21/08/2018,21/08/2018,0.00,,7.63,,"-809,544.60"
,CS,AR,32007700,1005,100,,Cash sale,,,,,,21/08/2018,21/08/2018,0.00,,30.00,,"-809,574.60"
,CS,AR,32007704,1005,100,,Cash sale,,,,,,21/08/2018,21/08/2018,0.00,,56.00,,"-809,630.60"
,CS,AR,32007741,1005,100,,Cash sale,,,,,,21/08/2018,21/08/2018,0.00,,32.63,,"-809,663.23"
,CS,AR,32007751,1005,100,,Cash sale,,,,,,21/08/2018,21/08/2018,0.00,,18.22,,"-809,681.45"
,CS,AR,32007767,1005,100,,Cash sale,,,,,,21/08/2018,21/08/2018,0.00,,5.47,,"-809,686.92"
,CS,AR,32007781,1005,100,,Cash sale,,,,,,21/08/2018,21/08/2018,0.00,,6.56,,"-809,693.48"
,CS,AR,32007794,1005,100,,Cash sale,,,,,,21/08/2018,21/08/2018,0.00,,14.58,,"-809,708.06"
,CS,AR,32007798,1005,100,,Cash sale,,,,,,21/08/2018,21/08/2018,0.00,,10.93,,"-809,718.99"
,CS,AR,32007800,1005,100,,Cash sale,,,,,,21/08/2018,21/08/2018,0.00,,8.21,,"-809,727.20"
,CS,AR,32007802,1005,100,,Cash sale,,,,,,21/08/2018,21/08/2018,0.00,,10.93,,"-809,738.13"
,CS,AR,32007808,1005,100,,Cash sale,,,,,,21/08/2018,21/08/2018,0.00,,7.75,,"-809,745.88"
,CS,AR,32007843,1005,100,,Cash sale,,,,,,21/08/2018,21/08/2018,0.00,,3.64,,"-809,749.52"
,CS,AR,32007853,1005,100,,Cash sale,,,,,,21/08/2018,21/08/2018,0.00,,7.29,,"-809,756.81"
,CS,AR,32007877,1005,100,,Cash sale,,,,,,21/08/2018,21/08/2018,0.00,,10.93,,"-809,767.74"
,IN,AR,30322251,1005,100,,Invoice,,,,,,21/08/2018,21/08/2018,0.00,,27.47,,"-809,795.21"
,IN,AR,30322274,1005,100,,Invoice,,,,,,21/08/2018,21/08/2018,0.00,,54.66,,"-809,849.87"
,IN,AR,30322283,1005,100,,Invoice,,,,,,21/08/2018,21/08/2018,0.00,,10.51,,"-809,860.38"
,IN,AR,30322292,1005,100,,Invoice,,,,,,21/08/2018,21/08/2018,0.00,,7.00,,"-809,867.38"
,IN,AR,30322315,1005,100,,Invoice,,,,,,21/08/2018,21/08/2018,0.00,,3.98,,"-809,871.36"
,IN,AR,30322327,1005,100,,Invoice,,,,,,21/08/2018,21/08/2018,0.00,,25.51,,"-809,896.87"
,IN,AR,30322347,1005,100,,Invoice,,,,,,21/08/2018,21/08/2018,0.00,,18.22,,"-809,915.09"
,IN,AR,30322412,1005,100,,Invoice,,,,,,21/08/2018,21/08/2018,0.00,,3.64,,"-809,918.73"
,IN,AR,30322436,1005,100,,Invoice,,,,,,21/08/2018,21/08/2018,0.00,,9.70,,"-809,928.43"
,IN,AR,30322438,1005,100,,Invoice,,,,,,21/08/2018,21/08/2018,0.00,,39.62,,"-809,968.05"
,IN,AR,30322449,1005,100,,Invoice,,,,,,21/08/2018,21/08/2018,0.00,,24.73,,"-809,992.78"
,IN,AR,30322494,1005,100,,Invoice,,,,,,21/08/2018,21/08/2018,0.00,,16.47,,"-810,009.25"
,IN,AR,30322505,1005,100,,Invoice,,,,,,21/08/2018,21/08/2018,0.00,,4.80,,"-810,014.05"
,IN,AR,30322518,1005,100,,Invoice,,,,,,21/08/2018,21/08/2018,0.00,,4.32,,"-810,018.37"
,IN,AR,30322521,1005,100,,Invoice,,,,,,21/08/2018,21/08/2018,0.00,,8.47,,"-810,026.84"
,IN,AR,30322528,1005,100,,Invoice,,,,,,21/08/2018,21/08/2018,0.00,,61.02,,"-810,087.86"
,IN,AR,30322532,1005,100,,Invoice,,,,,,21/08/2018,21/08/2018,0.00,,10.59,,"-810,098.45"
,IN,AR,30322570,1005,100,,Invoice,,,,,,21/08/2018,21/08/2018,0.00,,18.05,,"-810,116.50"
,IN,AR,30322577,1005,100,,Invoice,,,,,,21/08/2018,21/08/2018,0.00,,5.85,,"-810,122.35"
,IN,AR,30322591,1005,100,,Invoice,,,,,,21/08/2018,21/08/2018,0.00,,5.17,,"-810,127.52"
,IN,AR,30322600,1005,100,,Invoice,,,,,,21/08/2018,21/08/2018,0.00,,4.78,,"-810,132.30"
,IN,AR,30322648,1005,100,,Invoice,,,,,,21/08/2018,21/08/2018,0.00,,7.29,,"-810,139.59"
,IN,AR,30322673,1005,100,,Invoice,,,,,,21/08/2018,21/08/2018,0.00,,7.29,,"-810,146.88"
,IN,AR,30322679,1005,100,,Invoice,,,,,,21/08/2018,21/08/2018,0.00,,7.29,,"-810,154.17"
,IN,AR,30322691,1005,100,,Invoice,,,,,,21/08/2018,21/08/2018,0.00,,26.69,,"-810,180.86"
,IN,AR,30322702,1005,100,,Invoice,,,,,,21/08/2018,21/08/2018,0.00,,3.01,,"-810,183.87"
,IN,AR,30322706,1005,100,,Invoice,,,,,,21/08/2018,21/08/2018,0.00,,6.61,,"-810,190.48"
,IN,AR,30322707,1005,100,,Invoice,,,,,,21/08/2018,21/08/2018,0.00,,4.78,,"-810,195.26"
,IN,AR,30322709,1005,100,,Invoice,,,,,,21/08/2018,21/08/2018,0.00,,25.42,,"-810,220.68"
,IN,AR,30322711,1005,100,,Invoice,,,,,,21/08/2018,21/08/2018,0.00,,10.53,,"-810,231.21"
,IN,AR,30322718,1005,100,,Invoice,,,,,,21/08/2018,21/08/2018,0.00,,14.83,,"-810,246.04"
,IN,AR,30322720,1005,100,,Invoice,,,,,,21/08/2018,21/08/2018,0.00,,16.95,,"-810,262.99"
,IN,AR,30322726,1005,100,,Invoice,,,,,,21/08/2018,21/08/2018,0.00,,4.24,,"-810,267.23"
,IN,AR,30322732,1005,100,,Invoice,,,,,,21/08/2018,21/08/2018,0.00,,6.43,,"-810,273.66"
,IN,AR,30322737,1005,100,,Invoice,,,,,,21/08/2018,21/08/2018,0.00,,5.08,,"-810,278.74"
,IN,AR,30322749,1005,100,,Invoice,,,,,,21/08/2018,21/08/2018,0.00,,8.47,,"-810,287.21"
,IN,AR,30322755,1005,100,,Invoice,,,,,,21/08/2018,21/08/2018,0.00,,10.59,,"-810,297.80"
,IN,AR,30322757,1005,100,,Invoice,,,,,,21/08/2018,21/08/2018,0.00,,41.53,,"-810,339.33"
,IN,AR,30322798,1005,100,,Invoice,,,,,,21/08/2018,21/08/2018,0.00,,17.54,,"-810,356.87"
,IN,AR,30322802,1005,100,,Invoice,,,,,,21/08/2018,21/08/2018,0.00,,29.15,,"-810,386.02"
,IN,AR,30322827,1005,100,,Invoice,,,,,,21/08/2018,21/08/2018,0.00,,5.86,,"-810,391.88"
,IN,AR,30322833,1005,100,,Invoice,,,,,,21/08/2018,21/08/2018,0.00,,5.68,,"-810,397.56"
,IN,AR,30322838,1005,100,,Invoice,,,,,,21/08/2018,21/08/2018,0.00,,12.88,,"-810,410.44"
,IN,AR,30322873,1005,100,,Invoice,,,,,,21/08/2018,21/08/2018,0.00,,29.15,,"-810,439.59"
,IN,AR,30322874,1005,100,,Invoice,,,,,,21/08/2018,21/08/2018,0.00,,7.29,,"-810,446.88"
,IN,AR,30322884,1005,100,,Invoice,,,,,,21/08/2018,21/08/2018,0.00,,23.58,,"-810,470.46"
,IN,AR,30322898,1005,100,,Invoice,,,,,,21/08/2018,21/08/2018,0.00,,5.29,,"-810,475.75"
,IN,AR,30322910,1005,100,,Invoice,,,,,,21/08/2018,21/08/2018,0.00,,114.41,,"-810,590.16"
,IN,AR,30322911,1005,100,,Invoice,,,,,,21/08/2018,21/08/2018,0.00,,29.15,,"-810,619.31"
,IN,AR,30322932,1005,100,,Invoice,,,,,,21/08/2018,21/08/2018,0.00,,54.66,,"-810,673.97"
,IN,AR,30322980,1005,100,,Invoice,,,,,,21/08/2018,21/08/2018,0.00,,20.67,,"-810,694.64"
,IN,AR,30322981,1005,100,,Invoice,,,,,,21/08/2018,21/08/2018,0.00,,1.59,,"-810,696.23"
,IN,AR,30322982,1005,100,,Invoice,,,,,,21/08/2018,21/08/2018,0.00,,6.36,,"-810,702.59"
,IN,AR,30322983,1005,100,,Invoice,,,,,,21/08/2018,21/08/2018,0.00,,232.14,,"-810,934.73"
,IN,AR,30322989,1005,100,,Invoice,,,,,,21/08/2018,21/08/2018,0.00,,53.94,,"-810,988.67"
,IN,AR,30323004,1005,100,,Invoice,,,,,,21/08/2018,21/08/2018,0.00,,72.15,,"-811,060.82"
,IN,AR,30323025,1005,100,,Invoice,,,,,,21/08/2018,21/08/2018,0.00,,209.17,,"-811,269.99"
,IN,AR,30323030,1005,100,,Invoice,,,,,,21/08/2018,21/08/2018,0.00,,7.29,,"-811,277.28"
,IN,AR,30323039,1005,100,,Invoice,,,,,,21/08/2018,21/08/2018,0.00,,2.29,,"-811,279.57"
,IN,AR,30323048,1005,100,,Invoice,,,,,,21/08/2018,21/08/2018,0.00,,10.93,,"-811,290.50"
,IN,AR,30323062,1005,100,,Invoice,,,,,,21/08/2018,21/08/2018,0.00,,29.15,,"-811,319.65"
,IN,AR,30323069,1005,100,,Invoice,,,,,,21/08/2018,21/08/2018,0.00,,15.25,,"-811,334.90"
,IN,AR,30323105,1005,100,,Invoice,,,,,,21/08/2018,21/08/2018,0.00,,39.22,,"-811,374.12"
,IN,AR,30323123,1005,100,,Invoice,,,,,,21/08/2018,21/08/2018,0.00,,21.03,,"-811,395.15"
,IN,AR,30323134,1005,100,,Invoice,,,,,,21/08/2018,21/08/2018,0.00,,139.83,,"-811,534.98"
,IN,AR,30323136,1005,100,,Invoice,,,,,,21/08/2018,21/08/2018,0.00,,5.47,,"-811,540.45"
,IN,AR,30323166,1005,100,,Invoice,,,,,,21/08/2018,21/08/2018,0.00,,23.73,,"-811,564.18"
,IN,AR,30323168,1005,100,,Invoice,,,,,,21/08/2018,21/08/2018,0.00,,3.64,,"-811,567.82"
,IN,AR,30323173,1005,100,,Invoice,,,,,,21/08/2018,21/08/2018,0.00,,5.83,,"-811,573.65"
,IN,AR,30323180,1005,100,,Invoice,,,,,,21/08/2018,21/08/2018,0.00,,7.29,,"-811,580.94"
,IN,AR,30323209,1005,100,,Invoice,,,,,,21/08/2018,21/08/2018,0.00,,70.51,,"-811,651.45"
,IN,AR,30323218,1005,100,,Invoice,,,,,,21/08/2018,21/08/2018,0.00,,23.73,,"-811,675.18"
,IN,AR,30323229,1005,100,,Invoice,,,,,,21/08/2018,21/08/2018,0.00,,22.37,,"-811,697.55"
,IN,AR,30323230,1005,100,,Invoice,,,,,,21/08/2018,21/08/2018,0.00,,3.64,,"-811,701.19"
,IN,AR,30323232,1005,100,,Invoice,,,,,,21/08/2018,21/08/2018,0.00,,54.66,,"-811,755.85"
,IN,AR,30323244,1005,100,,Invoice,,,,,,21/08/2018,21/08/2018,0.00,,3.51,,"-811,759.36"
,IN,AR,30323248,1005,100,,Invoice,,,,,,21/08/2018,21/08/2018,0.00,,6.00,,"-811,765.36"
,IN,AR,30323250,1005,100,,Invoice,,,,,,21/08/2018,21/08/2018,0.00,,54.66,,"-811,820.02"
,IN,AR,30323251,1005,100,,Invoice,,,,,,21/08/2018,21/08/2018,0.00,,5.93,,"-811,825.95"
,IN,AR,30323271,1005,100,,Invoice,,,,,,21/08/2018,21/08/2018,0.00,,8.77,,"-811,834.72"
,IN,AR,30323320,1005,100,,Invoice,,,,,,21/08/2018,21/08/2018,0.00,,13.09,,"-811,847.81"
,IN,AR,30323354,1005,100,,Invoice,,,,,,21/08/2018,21/08/2018,0.00,,9.96,,"-811,857.77"
,IN,AR,30323364,1005,100,,Invoice,,,,,,21/08/2018,21/08/2018,0.00,,7.29,,"-811,865.06"
,IN,AR,30323365,1005,100,,Invoice,,,,,,21/08/2018,21/08/2018,0.00,,7.25,,"-811,872.31"
,IN,AR,30323371,1005,100,,Invoice,,,,,,21/08/2018,21/08/2018,0.00,,29.15,,"-811,901.46"
,IN,AR,30323407,1005,100,,Invoice,,,,,,21/08/2018,21/08/2018,0.00,,12.46,,"-811,913.92"
,IN,AR,30323408,1005,100,,Invoice,,,,,,21/08/2018,21/08/2018,0.00,,12.46,,"-811,926.38"
,IN,AR,30323410,1005,100,,Invoice,,,,,,21/08/2018,21/08/2018,0.00,,38.14,,"-811,964.52"
,IN,AR,30323418,1005,100,,Invoice,,,,,,21/08/2018,21/08/2018,0.00,,24.15,,"-811,988.67"
,IN,AR,30323432,1005,100,,Invoice,,,,,,21/08/2018,21/08/2018,0.00,,6.19,,"-811,994.86"
,IN,AR,30323453,1005,100,,Invoice,,,,,,21/08/2018,21/08/2018,0.00,,7.02,,"-812,001.88"
,IN,AR,30323522,1005,100,,Invoice,,,,,,21/08/2018,21/08/2018,0.00,,29.15,,"-812,031.03"
,IN,AR,30323523,1005,100,,Invoice,,,,,,21/08/2018,21/08/2018,0.00,,29.15,,"-812,060.18"
,IN,AR,30323524,1005,100,,Invoice,,,,,,21/08/2018,21/08/2018,0.00,,17.80,,"-812,077.98"
,CS,AR,32008137,1005,100,,Cash sale,,,,,,21/08/2018,21/08/2018,0.00,,21.86,,"-812,099.84"
,CS,AR,32008160,1005,100,,Cash sale,,,,,,21/08/2018,21/08/2018,0.00,,12.92,,"-812,112.76"
,CS,AR,32008329,1005,100,,Cash sale,,,,,,21/08/2018,21/08/2018,0.00,,3.64,,"-812,116.40"
,CS,AR,32008396,1005,100,,Cash sale,,,,,,21/08/2018,21/08/2018,0.00,,7.29,,"-812,123.69"
,CS,AR,32008530,1005,100,,Cash sale,,,,,,21/08/2018,21/08/2018,0.00,,30.51,,"-812,154.20"
,CS,AR,32008687,1005,100,,Cash sale,,,,,,21/08/2018,21/08/2018,0.00,,8.00,,"-812,162.20"
,IN,AR,30323761,1005,100,,Invoice,,,,,,21/08/2018,21/08/2018,0.00,,7.29,,"-812,169.49"
,IN,AR,30324585,1005,100,,Invoice,,,,,,21/08/2018,21/08/2018,0.00,,12.03,,"-812,181.52"
,IN,AR,30324824,1005,100,,Invoice,,,,,,21/08/2018,21/08/2018,0.00,,29.15,,"-812,210.67"
,IN,AR,30324908,1005,100,,Invoice,,,,,,21/08/2018,21/08/2018,0.00,,36.10,,"-812,246.77"
,IN,AR,30325282,1005,100,,Invoice,,,,,,21/08/2018,21/08/2018,0.00,,22.88,,"-812,269.65"
,IN,AR,30325329,1005,100,,Invoice,,,,,,21/08/2018,21/08/2018,0.00,,182.20,,"-812,451.85"
,IN,AR,30325331,1005,100,,Invoice,,,,,,21/08/2018,21/08/2018,0.00,,116.27,,"-812,568.12"
,IN,AR,30325372,1005,100,,Invoice,,,,,,21/08/2018,21/08/2018,0.00,,25.23,,"-812,593.35"
,IN,AR,30325403,1005,100,,Invoice,,,,,,21/08/2018,21/08/2018,0.00,,9.32,,"-812,602.67"
,IN,AR,30325464,1005,100,,Invoice,,,,,,21/08/2018,21/08/2018,0.00,,98.00,,"-812,700.67"
,IN,AR,30325617,1005,100,,Invoice,,,,,,21/08/2018,21/08/2018,0.00,,116.28,,"-812,816.95"
,IN,AR,30325618,1005,100,,Invoice,,,,,,21/08/2018,21/08/2018,0.00,,64.07,,"-812,881.02"
,IN,AR,30325619,1005,100,,Invoice,,,,,,21/08/2018,21/08/2018,0.00,,9.49,,"-812,890.51"
,IN,AR,30325745,1005,100,,Invoice,,,,,,21/08/2018,21/08/2018,0.00,,10.99,,"-812,901.50"
,IN,AR,30325798,1005,100,,Invoice,,,,,,21/08/2018,21/08/2018,0.00,,145.76,,"-813,047.26"
,IN,AR,30326029,1005,100,,Invoice,,,,,,21/08/2018,21/08/2018,0.00,,13.56,,"-813,060.82"
,IN,AR,30326038,1005,100,,Invoice,,,,,,21/08/2018,21/08/2018,0.00,,29.15,,"-813,089.97"
,IN,AR,30326135,1005,100,,Invoice,,,,,,21/08/2018,21/08/2018,0.00,,24.27,,"-813,114.24"
,CN,AR,31018807,1005,100,,Credit Note,,,,,,22/08/2018,22/08/2018,20.68,,0.00,,"-813,093.56"
,CN,AR,31018808,1005,100,,Credit Note,,,,,,22/08/2018,22/08/2018,38.77,,0.00,,"-813,054.79"
,CN,AR,31018809,1005,100,,Credit Note,,,,,,22/08/2018,22/08/2018,23.26,,0.00,,"-813,031.53"
,CN,AR,31018832,1005,100,,Credit Note,,,,,,22/08/2018,22/08/2018,98.30,,0.00,,"-812,933.23"
,CS,AR,32007886,1005,100,,Cash sale,,,,,,22/08/2018,22/08/2018,0.00,,16.83,,"-812,950.06"
,CS,AR,32007899,1005,100,,Cash sale,,,,,,22/08/2018,22/08/2018,0.00,,20.07,,"-812,970.13"
,CS,AR,32007938,1005,100,,Cash sale,,,,,,22/08/2018,22/08/2018,0.00,,7.29,,"-812,977.42"
,CS,AR,32007946,1005,100,,Cash sale,,,,,,22/08/2018,22/08/2018,0.00,,7.29,,"-812,984.71"
,CS,AR,32007956,1005,100,,Cash sale,,,,,,22/08/2018,22/08/2018,0.00,,10.93,,"-812,995.64"
,CS,AR,32007964,1005,100,,Cash sale,,,,,,22/08/2018,22/08/2018,0.00,,14.58,,"-813,010.22"
,CS,AR,32007994,1005,100,,Cash sale,,,,,,22/08/2018,22/08/2018,0.00,,3.64,,"-813,013.86"
,CS,AR,32008034,1005,100,,Cash sale,,,,,,22/08/2018,22/08/2018,0.00,,9.03,,"-813,022.89"
,CS,AR,32008060,1005,100,,Cash sale,,,,,,22/08/2018,22/08/2018,0.00,,7.29,,"-813,030.18"
,CS,AR,32008064,1005,100,,Cash sale,,,,,,22/08/2018,22/08/2018,0.00,,3.64,,"-813,033.82"
,CS,AR,32008090,1005,100,,Cash sale,,,,,,22/08/2018,22/08/2018,0.00,,8.78,,"-813,042.60"
,CS,AR,32008109,1005,100,,Cash sale,,,,,,22/08/2018,22/08/2018,0.00,,7.75,,"-813,050.35"
,CS,AR,32008179,1005,100,,Cash sale,,,,,,22/08/2018,22/08/2018,0.00,,7.29,,"-813,057.64"
,CS,AR,32008192,1005,100,,Cash sale,,,,,,22/08/2018,22/08/2018,0.00,,21.06,,"-813,078.70"
,CS,AR,32008196,1005,100,,Cash sale,,,,,,22/08/2018,22/08/2018,0.00,,8.58,,"-813,087.28"
,CS,AR,32008220,1005,100,,Cash sale,,,,,,22/08/2018,22/08/2018,0.00,,10.93,,"-813,098.21"
,CS,AR,32008234,1005,100,,Cash sale,,,,,,22/08/2018,22/08/2018,0.00,,5.08,,"-813,103.29"
,CS,AR,32008261,1005,100,,Cash sale,,,,,,22/08/2018,22/08/2018,0.00,,9.49,,"-813,112.78"
,CS,AR,32008279,1005,100,,Cash sale,,,,,,22/08/2018,22/08/2018,0.00,,7.29,,"-813,120.07"
,CS,AR,32008289,1005,100,,Cash sale,,,,,,22/08/2018,22/08/2018,0.00,,7.75,,"-813,127.82"
,CS,AR,32008303,1005,100,,Cash sale,,,,,,22/08/2018,22/08/2018,0.00,,3.64,,"-813,131.46"
,CS,AR,32008328,1005,100,,Cash sale,,,,,,22/08/2018,22/08/2018,0.00,,7.29,,"-813,138.75"
,CS,AR,32008338,1005,100,,Cash sale,,,,,,22/08/2018,22/08/2018,0.00,,18.22,,"-813,156.97"
,CS,AR,32008353,1005,100,,Cash sale,,,,,,22/08/2018,22/08/2018,0.00,,7.63,,"-813,164.60"
,CS,AR,32008373,1005,100,,Cash sale,,,,,,22/08/2018,22/08/2018,0.00,,3.64,,"-813,168.24"
,CS,AR,32008378,1005,100,,Cash sale,,,,,,22/08/2018,22/08/2018,0.00,,10.93,,"-813,179.17"
,CS,AR,32008422,1005,100,,Cash sale,,,,,,22/08/2018,22/08/2018,0.00,,7.29,,"-813,186.46"
,CS,AR,32008464,1005,100,,Cash sale,,,,,,22/08/2018,22/08/2018,0.00,,7.29,,"-813,193.75"
,CS,AR,32008481,1005,100,,Cash sale,,,,,,22/08/2018,22/08/2018,0.00,,16.61,,"-813,210.36"
,CS,AR,32008484,1005,100,,Cash sale,,,,,,22/08/2018,22/08/2018,0.00,,11.86,,"-813,222.22"
,CS,AR,32008490,1005,100,,Cash sale,,,,,,22/08/2018,22/08/2018,0.00,,10.93,,"-813,233.15"
,CS,AR,32008495,1005,100,,Cash sale,,,,,,22/08/2018,22/08/2018,0.00,,14.58,,"-813,247.73"
,CS,AR,32008498,1005,100,,Cash sale,,,,,,22/08/2018,22/08/2018,0.00,,18.22,,"-813,265.95"
,CS,AR,32008502,1005,100,,Cash sale,,,,,,22/08/2018,22/08/2018,0.00,,7.29,,"-813,273.24"
,CS,AR,32008534,1005,100,,Cash sale,,,,,,22/08/2018,22/08/2018,0.00,,7.29,,"-813,280.53"
,CS,AR,32008538,1005,100,,Cash sale,,,,,,22/08/2018,22/08/2018,0.00,,6.86,,"-813,287.39"
,CS,AR,32008553,1005,100,,Cash sale,,,,,,22/08/2018,22/08/2018,0.00,,5.51,,"-813,292.90"
,CS,AR,32008555,1005,100,,Cash sale,,,,,,22/08/2018,22/08/2018,0.00,,6.02,,"-813,298.92"
,CS,AR,32008581,1005,100,,Cash sale,,,,,,22/08/2018,22/08/2018,0.00,,7.29,,"-813,306.21"
,CS,AR,32008583,1005,100,,Cash sale,,,,,,22/08/2018,22/08/2018,0.00,,9.15,,"-813,315.36"
,CS,AR,32008606,1005,100,,Cash sale,,,,,,22/08/2018,22/08/2018,0.00,,12.14,,"-813,327.50"
,CS,AR,32008622,1005,100,,Cash sale,,,,,,22/08/2018,22/08/2018,0.00,,7.29,,"-813,334.79"
,CS,AR,32008624,1005,100,,Cash sale,,,,,,22/08/2018,22/08/2018,0.00,,14.58,,"-813,349.37"
,CS,AR,32008660,1005,100,,Cash sale,,,,,,22/08/2018,22/08/2018,0.00,,14.58,,"-813,363.95"
,CS,AR,32008675,1005,100,,Cash sale,,,,,,22/08/2018,22/08/2018,0.00,,2.54,,"-813,366.49"
,CS,AR,32008691,1005,100,,Cash sale,,,,,,22/08/2018,22/08/2018,0.00,,7.75,,"-813,374.24"
,CS,AR,32008699,1005,100,,Cash sale,,,,,,22/08/2018,22/08/2018,0.00,,18.22,,"-813,392.46"
,CS,AR,32008700,1005,100,,Cash sale,,,,,,22/08/2018,22/08/2018,0.00,,10.93,,"-813,403.39"
,CS,AR,32008746,1005,100,,Cash sale,,,,,,22/08/2018,22/08/2018,0.00,,16.48,,"-813,419.87"
,CS,AR,32008750,1005,100,,Cash sale,,,,,,22/08/2018,22/08/2018,0.00,,7.29,,"-813,427.16"
,CS,AR,32008837,1005,100,,Cash sale,,,,,,22/08/2018,22/08/2018,0.00,,7.29,,"-813,434.45"
,CS,AR,32008845,1005,100,,Cash sale,,,,,,22/08/2018,22/08/2018,0.00,,7.29,,"-813,441.74"
,IN,AR,30323535,1005,100,,Invoice,,,,,,22/08/2018,22/08/2018,0.00,,169.08,,"-813,610.82"
,IN,AR,30323541,1005,100,,Invoice,,,,,,22/08/2018,22/08/2018,0.00,,44.49,,"-813,655.31"
,IN,AR,30323589,1005,100,,Invoice,,,,,,22/08/2018,22/08/2018,0.00,,25.51,,"-813,680.82"
,IN,AR,30323596,1005,100,,Invoice,,,,,,22/08/2018,22/08/2018,0.00,,95.19,,"-813,776.01"
,IN,AR,30323597,1005,100,,Invoice,,,,,,22/08/2018,22/08/2018,0.00,,51.25,,"-813,827.26"
,IN,AR,30323629,1005,100,,Invoice,,,,,,22/08/2018,22/08/2018,0.00,,13.56,,"-813,840.82"
,IN,AR,30323640,1005,100,,Invoice,,,,,,22/08/2018,22/08/2018,0.00,,8.52,,"-813,849.34"
,IN,AR,30323643,1005,100,,Invoice,,,,,,22/08/2018,22/08/2018,0.00,,10.93,,"-813,860.27"
,IN,AR,30323655,1005,100,,Invoice,,,,,,22/08/2018,22/08/2018,0.00,,39.41,,"-813,899.68"
,IN,AR,30323656,1005,100,,Invoice,,,,,,22/08/2018,22/08/2018,0.00,,44.66,,"-813,944.34"
,IN,AR,30323666,1005,100,,Invoice,,,,,,22/08/2018,22/08/2018,0.00,,29.15,,"-813,973.49"
,IN,AR,30323670,1005,100,,Invoice,,,,,,22/08/2018,22/08/2018,0.00,,26.57,,"-814,000.06"
,IN,AR,30323713,1005,100,,Invoice,,,,,,22/08/2018,22/08/2018,0.00,,3.88,,"-814,003.94"
,IN,AR,30323714,1005,100,,Invoice,,,,,,22/08/2018,22/08/2018,0.00,,5.82,,"-814,009.76"
,IN,AR,30323731,1005,100,,Invoice,,,,,,22/08/2018,22/08/2018,0.00,,123.39,,"-814,133.15"
,IN,AR,30323779,1005,100,,Invoice,,,,,,22/08/2018,22/08/2018,0.00,,3.64,,"-814,136.79"
,IN,AR,30323813,1005,100,,Invoice,,,,,,22/08/2018,22/08/2018,0.00,,28.00,,"-814,164.79"
,IN,AR,30323845,1005,100,,Invoice,,,,,,22/08/2018,22/08/2018,0.00,,7.29,,"-814,172.08"
,IN,AR,30323855,1005,100,,Invoice,,,,,,22/08/2018,22/08/2018,0.00,,12.00,,"-814,184.08"
,IN,AR,30323868,1005,100,,Invoice,,,,,,22/08/2018,22/08/2018,0.00,,3.64,,"-814,187.72"
,IN,AR,30323904,1005,100,,Invoice,,,,,,22/08/2018,22/08/2018,0.00,,18.22,,"-814,205.94"
,IN,AR,30323908,1005,100,,Invoice,,,,,,22/08/2018,22/08/2018,0.00,,291.98,,"-814,497.92"
,IN,AR,30323978,1005,100,,Invoice,,,,,,22/08/2018,22/08/2018,0.00,,13.26,,"-814,511.18"
,IN,AR,30323991,1005,100,,Invoice,,,,,,22/08/2018,22/08/2018,0.00,,7.29,,"-814,518.47"
,IN,AR,30324062,1005,100,,Invoice,,,,,,22/08/2018,22/08/2018,0.00,,25.42,,"-814,543.89"
,IN,AR,30324090,1005,100,,Invoice,,,,,,22/08/2018,22/08/2018,0.00,,4.24,,"-814,548.13"
,IN,AR,30324103,1005,100,,Invoice,,,,,,22/08/2018,22/08/2018,0.00,,111.86,,"-814,659.99"
,IN,AR,30324114,1005,100,,Invoice,,,,,,22/08/2018,22/08/2018,0.00,,2.12,,"-814,662.11"
,IN,AR,30324132,1005,100,,Invoice,,,,,,22/08/2018,22/08/2018,0.00,,2.80,,"-814,664.91"
,IN,AR,30324184,1005,100,,Invoice,,,,,,22/08/2018,22/08/2018,0.00,,18.22,,"-814,683.13"
,IN,AR,30324199,1005,100,,Invoice,,,,,,22/08/2018,22/08/2018,0.00,,9.56,,"-814,692.69"
,IN,AR,30324205,1005,100,,Invoice,,,,,,22/08/2018,22/08/2018,0.00,,29.15,,"-814,721.84"
,IN,AR,30324218,1005,100,,Invoice,,,,,,22/08/2018,22/08/2018,0.00,,55.37,,"-814,777.21"
,IN,AR,30324246,1005,100,,Invoice,,,,,,22/08/2018,22/08/2018,0.00,,11.95,,"-814,789.16"
,IN,AR,30324282,1005,100,,Invoice,,,,,,22/08/2018,22/08/2018,0.00,,21.06,,"-814,810.22"
,IN,AR,30324293,1005,100,,Invoice,,,,,,22/08/2018,22/08/2018,0.00,,26.10,,"-814,836.32"
,IN,AR,30324307,1005,100,,Invoice,,,,,,22/08/2018,22/08/2018,0.00,,12.92,,"-814,849.24"
,IN,AR,30324378,1005,100,,Invoice,,,,,,22/08/2018,22/08/2018,0.00,,2.54,,"-814,851.78"
,IN,AR,30324379,1005,100,,Invoice,,,,,,22/08/2018,22/08/2018,0.00,,2.54,,"-814,854.32"
,IN,AR,30324408,1005,100,,Invoice,,,,,,22/08/2018,22/08/2018,0.00,,1.59,,"-814,855.91"
,IN,AR,30324411,1005,100,,Invoice,,,,,,22/08/2018,22/08/2018,0.00,,16.55,,"-814,872.46"
,IN,AR,30324424,1005,100,,Invoice,,,,,,22/08/2018,22/08/2018,0.00,,20.34,,"-814,892.80"
,IN,AR,30324482,1005,100,,Invoice,,,,,,22/08/2018,22/08/2018,0.00,,27.54,,"-814,920.34"
,IN,AR,30324508,1005,100,,Invoice,,,,,,22/08/2018,22/08/2018,0.00,,7.75,,"-814,928.09"
,IN,AR,30324511,1005,100,,Invoice,,,,,,22/08/2018,22/08/2018,0.00,,18.17,,"-814,946.26"
,IN,AR,30324561,1005,100,,Invoice,,,,,,22/08/2018,22/08/2018,0.00,,14.58,,"-814,960.84"
,IN,AR,30324612,1005,100,,Invoice,,,,,,22/08/2018,22/08/2018,0.00,,14.58,,"-814,975.42"
,IN,AR,30324682,1005,100,,Invoice,,,,,,22/08/2018,22/08/2018,0.00,,59.32,,"-815,034.74"
,IN,AR,30324737,1005,100,,Invoice,,,,,,22/08/2018,22/08/2018,0.00,,16.95,,"-815,051.69"
,IN,AR,30324738,1005,100,,Invoice,,,,,,22/08/2018,22/08/2018,0.00,,31.78,,"-815,083.47"
,IN,AR,30324739,1005,100,,Invoice,,,,,,22/08/2018,22/08/2018,0.00,,19.07,,"-815,102.54"
,IN,AR,30324750,1005,100,,Invoice,,,,,,22/08/2018,22/08/2018,0.00,,33.56,,"-815,136.10"
,IN,AR,30324762,1005,100,,Invoice,,,,,,22/08/2018,22/08/2018,0.00,,5.08,,"-815,141.18"
,IN,AR,30324782,1005,100,,Invoice,,,,,,22/08/2018,22/08/2018,0.00,,13.56,,"-815,154.74"
,IN,AR,30324833,1005,100,,Invoice,,,,,,22/08/2018,22/08/2018,0.00,,53.82,,"-815,208.56"
,IN,AR,30324857,1005,100,,Invoice,,,,,,22/08/2018,22/08/2018,0.00,,30.08,,"-815,238.64"
,IN,AR,30324891,1005,100,,Invoice,,,,,,22/08/2018,22/08/2018,0.00,,12.71,,"-815,251.35"
,IN,AR,30324899,1005,100,,Invoice,,,,,,22/08/2018,22/08/2018,0.00,,29.15,,"-815,280.50"
,IN,AR,30324918,1005,100,,Invoice,,,,,,22/08/2018,22/08/2018,0.00,,150.08,,"-815,430.58"
,IN,AR,30324935,1005,100,,Invoice,,,,,,22/08/2018,22/08/2018,0.00,,1.76,,"-815,432.34"
,IN,AR,30324955,1005,100,,Invoice,,,,,,22/08/2018,22/08/2018,0.00,,12.03,,"-815,444.37"
,IN,AR,30324994,1005,100,,Invoice,,,,,,22/08/2018,22/08/2018,0.00,,10.34,,"-815,454.71"
,IN,AR,30325016,1005,100,,Invoice,,,,,,22/08/2018,22/08/2018,0.00,,32.01,,"-815,486.72"
,IN,AR,30325021,1005,100,,Invoice,,,,,,22/08/2018,22/08/2018,0.00,,58.31,,"-815,545.03"
,IN,AR,30325022,1005,100,,Invoice,,,,,,22/08/2018,22/08/2018,0.00,,32.80,,"-815,577.83"
,IN,AR,30325059,1005,100,,Invoice,,,,,,22/08/2018,22/08/2018,0.00,,7.29,,"-815,585.12"
,IN,AR,30325068,1005,100,,Invoice,,,,,,22/08/2018,22/08/2018,0.00,,7.63,,"-815,592.75"
,IN,AR,30325110,1005,100,,Invoice,,,,,,22/08/2018,22/08/2018,0.00,,4.01,,"-815,596.76"
,IN,AR,30325125,1005,100,,Invoice,,,,,,22/08/2018,22/08/2018,0.00,,30.00,,"-815,626.76"
,IN,AR,30325152,1005,100,,Invoice,,,,,,22/08/2018,22/08/2018,0.00,,18.04,,"-815,644.80"
,IN,AR,30325157,1005,100,,Invoice,,,,,,22/08/2018,22/08/2018,0.00,,44.09,,"-815,688.89"
,IN,AR,30325170,1005,100,,Invoice,,,,,,22/08/2018,22/08/2018,0.00,,18.22,,"-815,707.11"
,IN,AR,30325179,1005,100,,Invoice,,,,,,22/08/2018,22/08/2018,0.00,,3.64,,"-815,710.75"
,IN,AR,30325198,1005,100,,Invoice,,,,,,22/08/2018,22/08/2018,0.00,,38.90,,"-815,749.65"
,IN,AR,30325210,1005,100,,Invoice,,,,,,22/08/2018,22/08/2018,0.00,,6.07,,"-815,755.72"
,IN,AR,30325237,1005,100,,Invoice,,,,,,22/08/2018,22/08/2018,0.00,,19.68,,"-815,775.40"
,IN,AR,30325242,1005,100,,Invoice,,,,,,22/08/2018,22/08/2018,0.00,,10.19,,"-815,785.59"
,IN,AR,30325247,1005,100,,Invoice,,,,,,22/08/2018,22/08/2018,0.00,,6.56,,"-815,792.15"
,IN,AR,30325257,1005,100,,Invoice,,,,,,22/08/2018,22/08/2018,0.00,,98.30,,"-815,890.45"
,IN,AR,30325258,1005,100,,Invoice,,,,,,22/08/2018,22/08/2018,0.00,,31.04,,"-815,921.49"
,IN,AR,30325280,1005,100,,Invoice,,,,,,22/08/2018,22/08/2018,0.00,,10.93,,"-815,932.42"
,IN,AR,30325283,1005,100,,Invoice,,,,,,22/08/2018,22/08/2018,0.00,,5.08,,"-815,937.50"
,IN,AR,30325306,1005,100,,Invoice,,,,,,22/08/2018,22/08/2018,0.00,,18.01,,"-815,955.51"
,IN,AR,30325316,1005,100,,Invoice,,,,,,22/08/2018,22/08/2018,0.00,,8.00,,"-815,963.51"
,IN,AR,30325344,1005,100,,Invoice,,,,,,22/08/2018,22/08/2018,0.00,,68.14,,"-816,031.65"
,IN,AR,30325365,1005,100,,Invoice,,,,,,22/08/2018,22/08/2018,0.00,,9.11,,"-816,040.76"
,IN,AR,30325373,1005,100,,Invoice,,,,,,22/08/2018,22/08/2018,0.00,,21.03,,"-816,061.79"
,IN,AR,30325374,1005,100,,Invoice,,,,,,22/08/2018,22/08/2018,0.00,,25.23,,"-816,087.02"
,IN,AR,30325396,1005,100,,Invoice,,,,,,22/08/2018,22/08/2018,0.00,,12.03,,"-816,099.05"
,IN,AR,30325459,1005,100,,Invoice,,,,,,22/08/2018,22/08/2018,0.00,,13.98,,"-816,113.03"
,IN,AR,30325460,1005,100,,Invoice,,,,,,22/08/2018,22/08/2018,0.00,,6.42,,"-816,119.45"
,IN,AR,30325465,1005,100,,Invoice,,,,,,22/08/2018,22/08/2018,0.00,,58.00,,"-816,177.45"
,IN,AR,30325509,1005,100,,Invoice,,,,,,22/08/2018,22/08/2018,0.00,,7.29,,"-816,184.74"
,IN,AR,30325517,1005,100,,Invoice,,,,,,22/08/2018,22/08/2018,0.00,,5.08,,"-816,189.82"
,IN,AR,30325544,1005,100,,Invoice,,,,,,22/08/2018,22/08/2018,0.00,,6.37,,"-816,196.19"
,IN,AR,30325675,1005,100,,Invoice,,,,,,22/08/2018,22/08/2018,0.00,,54.66,,"-816,250.85"
,IN,AR,30325690,1005,100,,Invoice,,,,,,22/08/2018,22/08/2018,0.00,,3.51,,"-816,254.36"
,IN,AR,30325712,1005,100,,Invoice,,,,,,22/08/2018,22/08/2018,0.00,,29.15,,"-816,283.51"
,IN,AR,30325714,1005,100,,Invoice,,,,,,22/08/2018,22/08/2018,0.00,,96.81,,"-816,380.32"
,IN,AR,30325773,1005,100,,Invoice,,,,,,22/08/2018,22/08/2018,0.00,,9.41,,"-816,389.73"
,IN,AR,30325803,1005,100,,Invoice,,,,,,22/08/2018,22/08/2018,0.00,,29.15,,"-816,418.88"
,IN,AR,30325815,1005,100,,Invoice,,,,,,22/08/2018,22/08/2018,0.00,,11.19,,"-816,430.07"
,IN,AR,30325819,1005,100,,Invoice,,,,,,22/08/2018,22/08/2018,0.00,,24.51,,"-816,454.58"
,IN,AR,30325820,1005,100,,Invoice,,,,,,22/08/2018,22/08/2018,0.00,,20.42,,"-816,475.00"
,IN,AR,30325873,1005,100,,Invoice,,,,,,22/08/2018,22/08/2018,0.00,,9.15,,"-816,484.15"
,IN,AR,30325881,1005,100,,Invoice,,,,,,22/08/2018,22/08/2018,0.00,,6.07,,"-816,490.22"
,IN,AR,30325897,1005,100,,Invoice,,,,,,22/08/2018,22/08/2018,0.00,,49.83,,"-816,540.05"
,IN,AR,30325898,1005,100,,Invoice,,,,,,22/08/2018,22/08/2018,0.00,,4.15,,"-816,544.20"
,IN,AR,30325899,1005,100,,Invoice,,,,,,22/08/2018,22/08/2018,0.00,,18.69,,"-816,562.89"
,IN,AR,30325900,1005,100,,Invoice,,,,,,22/08/2018,22/08/2018,0.00,,4.15,,"-816,567.04"
,IN,AR,30325963,1005,100,,Invoice,,,,,,22/08/2018,22/08/2018,0.00,,2.54,,"-816,569.58"
,IN,AR,30325979,1005,100,,Invoice,,,,,,22/08/2018,22/08/2018,0.00,,24.27,,"-816,593.85"
,IN,AR,30326002,1005,100,,Invoice,,,,,,22/08/2018,22/08/2018,0.00,,12.08,,"-816,605.93"
,IN,AR,30326022,1005,100,,Invoice,,,,,,22/08/2018,22/08/2018,0.00,,29.15,,"-816,635.08"
,IN,AR,30326040,1005,100,,Invoice,,,,,,22/08/2018,22/08/2018,0.00,,29.15,,"-816,664.23"
,IN,AR,30326081,1005,100,,Invoice,,,,,,22/08/2018,22/08/2018,0.00,,27.46,,"-816,691.69"
,IN,AR,30326112,1005,100,,Invoice,,,,,,22/08/2018,22/08/2018,0.00,,33.56,,"-816,725.25"
,IN,AR,30326127,1005,100,,Invoice,,,,,,22/08/2018,22/08/2018,0.00,,6.00,,"-816,731.25"
,IN,AR,30326173,1005,100,,Invoice,,,,,,22/08/2018,22/08/2018,0.00,,54.66,,"-816,785.91"
,IN,AR,30326177,1005,100,,Invoice,,,,,,22/08/2018,22/08/2018,0.00,,5.93,,"-816,791.84"
,IN,AR,30326181,1005,100,,Invoice,,,,,,22/08/2018,22/08/2018,0.00,,47.81,,"-816,839.65"
,CN,AR,31018749,1005,100,,Credit Note,,,,,,23/08/2018,23/08/2018,14.71,,0.00,,"-816,824.94"
,CS,AR,32007880,1005,100,,Cash sale,,,,,,23/08/2018,23/08/2018,0.00,,12.03,,"-816,836.97"
,CS,AR,32007884,1005,100,,Cash sale,,,,,,23/08/2018,23/08/2018,0.00,,21.86,,"-816,858.83"
,CS,AR,32007912,1005,100,,Cash sale,,,,,,23/08/2018,23/08/2018,0.00,,11.36,,"-816,870.19"
,CS,AR,32007933,1005,100,,Cash sale,,,,,,23/08/2018,23/08/2018,0.00,,11.22,,"-816,881.41"
,CS,AR,32007988,1005,100,,Cash sale,,,,,,23/08/2018,23/08/2018,0.00,,7.29,,"-816,888.70"
,CS,AR,32008021,1005,100,,Cash sale,,,,,,23/08/2018,23/08/2018,0.00,,7.29,,"-816,895.99"
,CS,AR,32008067,1005,100,,Cash sale,,,,,,23/08/2018,23/08/2018,0.00,,18.22,,"-816,914.21"
,CS,AR,32008083,1005,100,,Cash sale,,,,,,23/08/2018,23/08/2018,0.00,,7.29,,"-816,921.50"
,CS,AR,32008094,1005,100,,Cash sale,,,,,,23/08/2018,23/08/2018,0.00,,7.29,,"-816,928.79"
,CS,AR,32008294,1005,100,,Cash sale,,,,,,23/08/2018,23/08/2018,0.00,,7.29,,"-816,936.08"
,CS,AR,32008316,1005,100,,Cash sale,,,,,,23/08/2018,23/08/2018,0.00,,3.64,,"-816,939.72"
,CS,AR,32008360,1005,100,,Cash sale,,,,,,23/08/2018,23/08/2018,0.00,,33.56,,"-816,973.28"
,CS,AR,32008404,1005,100,,Cash sale,,,,,,23/08/2018,23/08/2018,0.00,,6.02,,"-816,979.30"
,CS,AR,32008409,1005,100,,Cash sale,,,,,,23/08/2018,23/08/2018,0.00,,6.44,,"-816,985.74"
,CS,AR,32008416,1005,100,,Cash sale,,,,,,23/08/2018,23/08/2018,0.00,,10.93,,"-816,996.67"
,CS,AR,32008466,1005,100,,Cash sale,,,,,,23/08/2018,23/08/2018,0.00,,19.58,,"-817,016.25"
,CS,AR,32008476,1005,100,,Cash sale,,,,,,23/08/2018,23/08/2018,0.00,,3.64,,"-817,019.89"
,CS,AR,32008580,1005,100,,Cash sale,,,,,,23/08/2018,23/08/2018,0.00,,10.93,,"-817,030.82"
,CS,AR,32008598,1005,100,,Cash sale,,,,,,23/08/2018,23/08/2018,0.00,,2.97,,"-817,033.79"
,CS,AR,32008604,1005,100,,Cash sale,,,,,,23/08/2018,23/08/2018,0.00,,10.93,,"-817,044.72"
,CS,AR,32008612,1005,100,,Cash sale,,,,,,23/08/2018,23/08/2018,0.00,,14.58,,"-817,059.30"
,CS,AR,32008771,1005,100,,Cash sale,,,,,,23/08/2018,23/08/2018,0.00,,10.93,,"-817,070.23"
,CS,AR,32008839,1005,100,,Cash sale,,,,,,23/08/2018,23/08/2018,0.00,,10.93,,"-817,081.16"
,IN,AR,30323561,1005,100,,Invoice,,,,,,23/08/2018,23/08/2018,0.00,,3.64,,"-817,084.80"
,IN,AR,30323634,1005,100,,Invoice,,,,,,23/08/2018,23/08/2018,0.00,,3.64,,"-817,088.44"
,IN,AR,30323699,1005,100,,Invoice,,,,,,23/08/2018,23/08/2018,0.00,,29.15,,"-817,117.59"
,IN,AR,30323705,1005,100,,Invoice,,,,,,23/08/2018,23/08/2018,0.00,,54.66,,"-817,172.25"
,IN,AR,30323721,1005,100,,Invoice,,,,,,23/08/2018,23/08/2018,0.00,,3.98,,"-817,176.23"
,IN,AR,30323732,1005,100,,Invoice,,,,,,23/08/2018,23/08/2018,0.00,,35.59,,"-817,211.82"
,IN,AR,30323766,1005,100,,Invoice,,,,,,23/08/2018,23/08/2018,0.00,,42.12,,"-817,253.94"
,IN,AR,30323771,1005,100,,Invoice,,,,,,23/08/2018,23/08/2018,0.00,,56.00,,"-817,309.94"
,IN,AR,30323800,1005,100,,Invoice,,,,,,23/08/2018,23/08/2018,0.00,,29.15,,"-817,339.09"
,IN,AR,30323805,1005,100,,Invoice,,,,,,23/08/2018,23/08/2018,0.00,,7.29,,"-817,346.38"
,IN,AR,30323870,1005,100,,Invoice,,,,,,23/08/2018,23/08/2018,0.00,,56.95,,"-817,403.33"
,IN,AR,30323893,1005,100,,Invoice,,,,,,23/08/2018,23/08/2018,0.00,,32.95,,"-817,436.28"
,IN,AR,30323953,1005,100,,Invoice,,,,,,23/08/2018,23/08/2018,0.00,,18.22,,"-817,454.50"
,IN,AR,30323994,1005,100,,Invoice,,,,,,23/08/2018,23/08/2018,0.00,,54.66,,"-817,509.16"
,IN,AR,30324008,1005,100,,Invoice,,,,,,23/08/2018,23/08/2018,0.00,,10.93,,"-817,520.09"
,IN,AR,30324013,1005,100,,Invoice,,,,,,23/08/2018,23/08/2018,0.00,,28.00,,"-817,548.09"
,IN,AR,30324033,1005,100,,Invoice,,,,,,23/08/2018,23/08/2018,0.00,,6.97,,"-817,555.06"
,IN,AR,30324041,1005,100,,Invoice,,,,,,23/08/2018,23/08/2018,0.00,,12.03,,"-817,567.09"
,IN,AR,30324104,1005,100,,Invoice,,,,,,23/08/2018,23/08/2018,0.00,,24.41,,"-817,591.50"
,IN,AR,30324164,1005,100,,Invoice,,,,,,23/08/2018,23/08/2018,0.00,,222.62,,"-817,814.12"
,IN,AR,30324181,1005,100,,Invoice,,,,,,23/08/2018,23/08/2018,0.00,,8.39,,"-817,822.51"
,IN,AR,30324190,1005,100,,Invoice,,,,,,23/08/2018,23/08/2018,0.00,,43.02,,"-817,865.53"
,IN,AR,30324214,1005,100,,Invoice,,,,,,23/08/2018,23/08/2018,0.00,,28.81,,"-817,894.34"
,IN,AR,30324232,1005,100,,Invoice,,,,,,23/08/2018,23/08/2018,0.00,,5.08,,"-817,899.42"
,IN,AR,30324233,1005,100,,Invoice,,,,,,23/08/2018,23/08/2018,0.00,,30.51,,"-817,929.93"
,IN,AR,30324247,1005,100,,Invoice,,,,,,23/08/2018,23/08/2018,0.00,,16.73,,"-817,946.66"
,IN,AR,30324262,1005,100,,Invoice,,,,,,23/08/2018,23/08/2018,0.00,,6.44,,"-817,953.10"
,IN,AR,30324268,1005,100,,Invoice,,,,,,23/08/2018,23/08/2018,0.00,,12.88,,"-817,965.98"
,IN,AR,30324320,1005,100,,Invoice,,,,,,23/08/2018,23/08/2018,0.00,,27.08,,"-817,993.06"
,IN,AR,30324337,1005,100,,Invoice,,,,,,23/08/2018,23/08/2018,0.00,,14.58,,"-818,007.64"
,IN,AR,30324364,1005,100,,Invoice,,,,,,23/08/2018,23/08/2018,0.00,,6.36,,"-818,014.00"
,IN,AR,30324417,1005,100,,Invoice,,,,,,23/08/2018,23/08/2018,0.00,,5.17,,"-818,019.17"
,IN,AR,30324487,1005,100,,Invoice,,,,,,23/08/2018,23/08/2018,0.00,,21.19,,"-818,040.36"
,IN,AR,30324524,1005,100,,Invoice,,,,,,23/08/2018,23/08/2018,0.00,,35.59,,"-818,075.95"
,IN,AR,30324535,1005,100,,Invoice,,,,,,23/08/2018,23/08/2018,0.00,,20.00,,"-818,095.95"
,IN,AR,30324551,1005,100,,Invoice,,,,,,23/08/2018,23/08/2018,0.00,,7.29,,"-818,103.24"
,IN,AR,30324652,1005,100,,Invoice,,,,,,23/08/2018,23/08/2018,0.00,,10.98,,"-818,114.22"
,IN,AR,30324691,1005,100,,Invoice,,,,,,23/08/2018,23/08/2018,0.00,,10.93,,"-818,125.15"
,IN,AR,30324692,1005,100,,Invoice,,,,,,23/08/2018,23/08/2018,0.00,,7.00,,"-818,132.15"
,IN,AR,30324709,1005,100,,Invoice,,,,,,23/08/2018,23/08/2018,0.00,,14.58,,"-818,146.73"
,IN,AR,30324744,1005,100,,Invoice,,,,,,23/08/2018,23/08/2018,0.00,,16.95,,"-818,163.68"
,IN,AR,30324757,1005,100,,Invoice,,,,,,23/08/2018,23/08/2018,0.00,,78.10,,"-818,241.78"
,IN,AR,30324785,1005,100,,Invoice,,,,,,23/08/2018,23/08/2018,0.00,,9.29,,"-818,251.07"
,IN,AR,30324795,1005,100,,Invoice,,,,,,23/08/2018,23/08/2018,0.00,,5.85,,"-818,256.92"
,IN,AR,30324806,1005,100,,Invoice,,,,,,23/08/2018,23/08/2018,0.00,,19.28,,"-818,276.20"
,IN,AR,30324863,1005,100,,Invoice,,,,,,23/08/2018,23/08/2018,0.00,,18.05,,"-818,294.25"
,IN,AR,30324886,1005,100,,Invoice,,,,,,23/08/2018,23/08/2018,0.00,,15.53,,"-818,309.78"
,IN,AR,30324895,1005,100,,Invoice,,,,,,23/08/2018,23/08/2018,0.00,,6.53,,"-818,316.31"
,IN,AR,30324903,1005,100,,Invoice,,,,,,23/08/2018,23/08/2018,0.00,,28.39,,"-818,344.70"
,IN,AR,30324912,1005,100,,Invoice,,,,,,23/08/2018,23/08/2018,0.00,,6.00,,"-818,350.70"
,IN,AR,30324926,1005,100,,Invoice,,,,,,23/08/2018,23/08/2018,0.00,,16.02,,"-818,366.72"
,IN,AR,30324936,1005,100,,Invoice,,,,,,23/08/2018,23/08/2018,0.00,,3.53,,"-818,370.25"
,IN,AR,30324964,1005,100,,Invoice,,,,,,23/08/2018,23/08/2018,0.00,,10.93,,"-818,381.18"
,IN,AR,30324972,1005,100,,Invoice,,,,,,23/08/2018,23/08/2018,0.00,,20.44,,"-818,401.62"
,IN,AR,30324977,1005,100,,Invoice,,,,,,23/08/2018,23/08/2018,0.00,,22.51,,"-818,424.13"
,IN,AR,30325014,1005,100,,Invoice,,,,,,23/08/2018,23/08/2018,0.00,,11.70,,"-818,435.83"
,IN,AR,30325047,1005,100,,Invoice,,,,,,23/08/2018,23/08/2018,0.00,,10.93,,"-818,446.76"
,IN,AR,30325076,1005,100,,Invoice,,,,,,23/08/2018,23/08/2018,0.00,,3.98,,"-818,450.74"
,IN,AR,30325077,1005,100,,Invoice,,,,,,23/08/2018,23/08/2018,0.00,,9.96,,"-818,460.70"
,IN,AR,30325078,1005,100,,Invoice,,,,,,23/08/2018,23/08/2018,0.00,,15.93,,"-818,476.63"
,IN,AR,30325091,1005,100,,Invoice,,,,,,23/08/2018,23/08/2018,0.00,,12.72,,"-818,489.35"
,IN,AR,30325148,1005,100,,Invoice,,,,,,23/08/2018,23/08/2018,0.00,,236.20,,"-818,725.55"
,IN,AR,30325182,1005,100,,Invoice,,,,,,23/08/2018,23/08/2018,0.00,,7.29,,"-818,732.84"
,IN,AR,30325195,1005,100,,Invoice,,,,,,23/08/2018,23/08/2018,0.00,,3.64,,"-818,736.48"
,IN,AR,30325238,1005,100,,Invoice,,,,,,23/08/2018,23/08/2018,0.00,,6.56,,"-818,743.04"
,IN,AR,30325249,1005,100,,Invoice,,,,,,23/08/2018,23/08/2018,0.00,,7.29,,"-818,750.33"
,IN,AR,30325277,1005,100,,Invoice,,,,,,23/08/2018,23/08/2018,0.00,,8.90,,"-818,759.23"
,IN,AR,30325297,1005,100,,Invoice,,,,,,23/08/2018,23/08/2018,0.00,,26.01,,"-818,785.24"
,IN,AR,30325310,1005,100,,Invoice,,,,,,23/08/2018,23/08/2018,0.00,,28.01,,"-818,813.25"
,IN,AR,30325333,1005,100,,Invoice,,,,,,23/08/2018,23/08/2018,0.00,,14.58,,"-818,827.83"
,IN,AR,30325334,1005,100,,Invoice,,,,,,23/08/2018,23/08/2018,0.00,,11.66,,"-818,839.49"
,IN,AR,30325348,1005,100,,Invoice,,,,,,23/08/2018,23/08/2018,0.00,,9.05,,"-818,848.54"
,IN,AR,30325409,1005,100,,Invoice,,,,,,23/08/2018,23/08/2018,0.00,,29.15,,"-818,877.69"
,IN,AR,30325419,1005,100,,Invoice,,,,,,23/08/2018,23/08/2018,0.00,,36.24,,"-818,913.93"
,IN,AR,30325432,1005,100,,Invoice,,,,,,23/08/2018,23/08/2018,0.00,,8.42,,"-818,922.35"
,IN,AR,30325452,1005,100,,Invoice,,,,,,23/08/2018,23/08/2018,0.00,,8.52,,"-818,930.87"
,IN,AR,30325477,1005,100,,Invoice,,,,,,23/08/2018,23/08/2018,0.00,,29.15,,"-818,960.02"
,IN,AR,30325507,1005,100,,Invoice,,,,,,23/08/2018,23/08/2018,0.00,,54.66,,"-819,014.68"
,IN,AR,30325538,1005,100,,Invoice,,,,,,23/08/2018,23/08/2018,0.00,,81.15,,"-819,095.83"
,IN,AR,30325545,1005,100,,Invoice,,,,,,23/08/2018,23/08/2018,0.00,,6.37,,"-819,102.20"
,IN,AR,30325546,1005,100,,Invoice,,,,,,23/08/2018,23/08/2018,0.00,,4.78,,"-819,106.98"
,IN,AR,30325547,1005,100,,Invoice,,,,,,23/08/2018,23/08/2018,0.00,,4.78,,"-819,111.76"
,IN,AR,30325548,1005,100,,Invoice,,,,,,23/08/2018,23/08/2018,0.00,,117.90,,"-819,229.66"
,IN,AR,30325549,1005,100,,Invoice,,,,,,23/08/2018,23/08/2018,0.00,,7.97,,"-819,237.63"
,IN,AR,30325550,1005,100,,Invoice,,,,,,23/08/2018,23/08/2018,0.00,,7.97,,"-819,245.60"
,IN,AR,30325631,1005,100,,Invoice,,,,,,23/08/2018,23/08/2018,0.00,,22.37,,"-819,267.97"
,IN,AR,30325792,1005,100,,Invoice,,,,,,23/08/2018,23/08/2018,0.00,,5.86,,"-819,273.83"
,IN,AR,30325832,1005,100,,Invoice,,,,,,23/08/2018,23/08/2018,0.00,,6.13,,"-819,279.96"
,IN,AR,30325845,1005,100,,Invoice,,,,,,23/08/2018,23/08/2018,0.00,,36.44,,"-819,316.40"
,IN,AR,30325901,1005,100,,Invoice,,,,,,23/08/2018,23/08/2018,0.00,,2.08,,"-819,318.48"
,IN,AR,30325902,1005,100,,Invoice,,,,,,23/08/2018,23/08/2018,0.00,,2.08,,"-819,320.56"
,IN,AR,30325903,1005,100,,Invoice,,,,,,23/08/2018,23/08/2018,0.00,,24.92,,"-819,345.48"
,IN,AR,30325904,1005,100,,Invoice,,,,,,23/08/2018,23/08/2018,0.00,,2.08,,"-819,347.56"
,IN,AR,30326084,1005,100,,Invoice,,,,,,23/08/2018,23/08/2018,0.00,,39.95,,"-819,387.51"
,IN,AR,30326097,1005,100,,Invoice,,,,,,23/08/2018,23/08/2018,0.00,,7.29,,"-819,394.80"
,IN,AR,30326158,1005,100,,Invoice,,,,,,23/08/2018,23/08/2018,0.00,,3.64,,"-819,398.44"
,IN,AR,30326161,1005,100,,Invoice,,,,,,23/08/2018,23/08/2018,0.00,,3.64,,"-819,402.08"
,IN,AR,30326165,1005,100,,Invoice,,,,,,23/08/2018,23/08/2018,0.00,,3.64,,"-819,405.72"
,IN,AR,30326179,1005,100,,Invoice,,,,,,23/08/2018,23/08/2018,0.00,,7.29,,"-819,413.01"
,IN,AR,30326189,1005,100,,Invoice,,,,,,23/08/2018,23/08/2018,0.00,,419.07,,"-819,832.08"
,CN,AR,31018872,1005,100,,Credit Note,,,,,,24/08/2018,24/08/2018,3.64,,0.00,,"-819,828.44"
,CR,AR,33000260,1005,100,,Cash Return,,,,,,24/08/2018,24/08/2018,10.93,,0.00,,"-819,817.51"
,CR,AR,33000261,1005,100,,Cash Return,,,,,,24/08/2018,24/08/2018,10.93,,0.00,,"-819,806.58"
,CS,AR,32007887,1005,100,,Cash sale,,,,,,24/08/2018,24/08/2018,0.00,,11.22,,"-819,817.80"
,CS,AR,32007903,1005,100,,Cash sale,,,,,,24/08/2018,24/08/2018,0.00,,9.49,,"-819,827.29"
,CS,AR,32007929,1005,100,,Cash sale,,,,,,24/08/2018,24/08/2018,0.00,,3.64,,"-819,830.93"
,CS,AR,32007936,1005,100,,Cash sale,,,,,,24/08/2018,24/08/2018,0.00,,14.58,,"-819,845.51"
,CS,AR,32007976,1005,100,,Cash sale,,,,,,24/08/2018,24/08/2018,0.00,,14.58,,"-819,860.09"
,CS,AR,32007982,1005,100,,Cash sale,,,,,,24/08/2018,24/08/2018,0.00,,12.08,,"-819,872.17"
,CS,AR,32008007,1005,100,,Cash sale,,,,,,24/08/2018,24/08/2018,0.00,,14.58,,"-819,886.75"
,CS,AR,32008011,1005,100,,Cash sale,,,,,,24/08/2018,24/08/2018,0.00,,14.53,,"-819,901.28"
,CS,AR,32008038,1005,100,,Cash sale,,,,,,24/08/2018,24/08/2018,0.00,,7.29,,"-819,908.57"
,CS,AR,32008050,1005,100,,Cash sale,,,,,,24/08/2018,24/08/2018,0.00,,3.64,,"-819,912.21"
,CS,AR,32008078,1005,100,,Cash sale,,,,,,24/08/2018,24/08/2018,0.00,,25.87,,"-819,938.08"
,CS,AR,32008141,1005,100,,Cash sale,,,,,,24/08/2018,24/08/2018,0.00,,2.58,,"-819,940.66"
,CS,AR,32008148,1005,100,,Cash sale,,,,,,24/08/2018,24/08/2018,0.00,,10.17,,"-819,950.83"
,CS,AR,32008156,1005,100,,Cash sale,,,,,,24/08/2018,24/08/2018,0.00,,16.78,,"-819,967.61"
,CS,AR,32008170,1005,100,,Cash sale,,,,,,24/08/2018,24/08/2018,0.00,,3.64,,"-819,971.25"
,CS,AR,32008175,1005,100,,Cash sale,,,,,,24/08/2018,24/08/2018,0.00,,52.20,,"-820,023.45"
,CS,AR,32008217,1005,100,,Cash sale,,,,,,24/08/2018,24/08/2018,0.00,,10.93,,"-820,034.38"
,CS,AR,32008235,1005,100,,Cash sale,,,,,,24/08/2018,24/08/2018,0.00,,7.63,,"-820,042.01"
,CS,AR,32008244,1005,100,,Cash sale,,,,,,24/08/2018,24/08/2018,0.00,,18.09,,"-820,060.10"
,CS,AR,32008249,1005,100,,Cash sale,,,,,,24/08/2018,24/08/2018,0.00,,17.54,,"-820,077.64"
,CS,AR,32008266,1005,100,,Cash sale,,,,,,24/08/2018,24/08/2018,0.00,,42.12,,"-820,119.76"
,CS,AR,32008282,1005,100,,Cash sale,,,,,,24/08/2018,24/08/2018,0.00,,12.71,,"-820,132.47"
,CS,AR,32008312,1005,100,,Cash sale,,,,,,24/08/2018,24/08/2018,0.00,,3.64,,"-820,136.11"
,CS,AR,32008322,1005,100,,Cash sale,,,,,,24/08/2018,24/08/2018,0.00,,7.29,,"-820,143.40"
,CS,AR,32008384,1005,100,,Cash sale,,,,,,24/08/2018,24/08/2018,0.00,,21.86,,"-820,165.26"
,CS,AR,32008398,1005,100,,Cash sale,,,,,,24/08/2018,24/08/2018,0.00,,7.29,,"-820,172.55"
,CS,AR,32008401,1005,100,,Cash sale,,,,,,24/08/2018,24/08/2018,0.00,,7.29,,"-820,179.84"
,CS,AR,32008407,1005,100,,Cash sale,,,,,,24/08/2018,24/08/2018,0.00,,7.29,,"-820,187.13"
,CS,AR,32008414,1005,100,,Cash sale,,,,,,24/08/2018,24/08/2018,0.00,,14.63,,"-820,201.76"
,CS,AR,32008424,1005,100,,Cash sale,,,,,,24/08/2018,24/08/2018,0.00,,10.93,,"-820,212.69"
,CS,AR,32008426,1005,100,,Cash sale,,,,,,24/08/2018,24/08/2018,0.00,,5.17,,"-820,217.86"
,CS,AR,32008442,1005,100,,Cash sale,,,,,,24/08/2018,24/08/2018,0.00,,5.17,,"-820,223.03"
,CS,AR,32008449,1005,100,,Cash sale,,,,,,24/08/2018,24/08/2018,0.00,,7.29,,"-820,230.32"
,CS,AR,32008453,1005,100,,Cash sale,,,,,,24/08/2018,24/08/2018,0.00,,5.56,,"-820,235.88"
,CS,AR,32008468,1005,100,,Cash sale,,,,,,24/08/2018,24/08/2018,0.00,,7.29,,"-820,243.17"
,CS,AR,32008516,1005,100,,Cash sale,,,,,,24/08/2018,24/08/2018,0.00,,14.58,,"-820,257.75"
,CS,AR,32008521,1005,100,,Cash sale,,,,,,24/08/2018,24/08/2018,0.00,,6.12,,"-820,263.87"
,CS,AR,32008526,1005,100,,Cash sale,,,,,,24/08/2018,24/08/2018,0.00,,7.29,,"-820,271.16"
,CS,AR,32008531,1005,100,,Cash sale,,,,,,24/08/2018,24/08/2018,0.00,,25.42,,"-820,296.58"
,CS,AR,32008544,1005,100,,Cash sale,,,,,,24/08/2018,24/08/2018,0.00,,3.64,,"-820,300.22"
,CS,AR,32008551,1005,100,,Cash sale,,,,,,24/08/2018,24/08/2018,0.00,,5.08,,"-820,305.30"
,CS,AR,32008556,1005,100,,Cash sale,,,,,,24/08/2018,24/08/2018,0.00,,9.03,,"-820,314.33"
,CS,AR,32008559,1005,100,,Cash sale,,,,,,24/08/2018,24/08/2018,0.00,,14.58,,"-820,328.91"
,CS,AR,32008569,1005,100,,Cash sale,,,,,,24/08/2018,24/08/2018,0.00,,2.54,,"-820,331.45"
,CS,AR,32008579,1005,100,,Cash sale,,,,,,24/08/2018,24/08/2018,0.00,,10.93,,"-820,342.38"
,CS,AR,32008584,1005,100,,Cash sale,,,,,,24/08/2018,24/08/2018,0.00,,4.58,,"-820,346.96"
,CS,AR,32008618,1005,100,,Cash sale,,,,,,24/08/2018,24/08/2018,0.00,,17.80,,"-820,364.76"
,CS,AR,32008631,1005,100,,Cash sale,,,,,,24/08/2018,24/08/2018,0.00,,60.71,,"-820,425.47"
,CS,AR,32008640,1005,100,,Cash sale,,,,,,24/08/2018,24/08/2018,0.00,,18.21,,"-820,443.68"
,CS,AR,32008671,1005,100,,Cash sale,,,,,,24/08/2018,24/08/2018,0.00,,3.64,,"-820,447.32"
,CS,AR,32008683,1005,100,,Cash sale,,,,,,24/08/2018,24/08/2018,0.00,,4.15,,"-820,451.47"
,CS,AR,32008688,1005,100,,Cash sale,,,,,,24/08/2018,24/08/2018,0.00,,7.29,,"-820,458.76"
,CS,AR,32008690,1005,100,,Cash sale,,,,,,24/08/2018,24/08/2018,0.00,,21.86,,"-820,480.62"
,CS,AR,32008693,1005,100,,Cash sale,,,,,,24/08/2018,24/08/2018,0.00,,15.17,,"-820,495.79"
,CS,AR,32008702,1005,100,,Cash sale,,,,,,24/08/2018,24/08/2018,0.00,,21.86,,"-820,517.65"
,CS,AR,32008718,1005,100,,Cash sale,,,,,,24/08/2018,24/08/2018,0.00,,3.64,,"-820,521.29"
,CS,AR,32008724,1005,100,,Cash sale,,,,,,24/08/2018,24/08/2018,0.00,,10.93,,"-820,532.22"
,CS,AR,32008731,1005,100,,Cash sale,,,,,,24/08/2018,24/08/2018,0.00,,10.93,,"-820,543.15"
,CS,AR,32008768,1005,100,,Cash sale,,,,,,24/08/2018,24/08/2018,0.00,,5.94,,"-820,549.09"
,CS,AR,32008827,1005,100,,Cash sale,,,,,,24/08/2018,24/08/2018,0.00,,3.03,,"-820,552.12"
,CS,AR,32008846,1005,100,,Cash sale,,,,,,24/08/2018,24/08/2018,0.00,,7.29,,"-820,559.41"
,CS,AR,32008855,1005,100,,Cash sale,,,,,,24/08/2018,24/08/2018,0.00,,7.29,,"-820,566.70"
,CS,AR,32008863,1005,100,,Cash sale,,,,,,24/08/2018,24/08/2018,0.00,,10.93,,"-820,577.63"
,IN,AR,30323536,1005,100,,Invoice,,,,,,24/08/2018,24/08/2018,0.00,,10.93,,"-820,588.56"
,IN,AR,30323542,1005,100,,Invoice,,,,,,24/08/2018,24/08/2018,0.00,,44.49,,"-820,633.05"
,IN,AR,30323557,1005,100,,Invoice,,,,,,24/08/2018,24/08/2018,0.00,,40.08,,"-820,673.13"
,IN,AR,30323580,1005,100,,Invoice,,,,,,24/08/2018,24/08/2018,0.00,,19.58,,"-820,692.71"
,IN,AR,30323584,1005,100,,Invoice,,,,,,24/08/2018,24/08/2018,0.00,,14.58,,"-820,707.29"
,IN,AR,30323585,1005,100,,Invoice,,,,,,24/08/2018,24/08/2018,0.00,,14.58,,"-820,721.87"
,IN,AR,30323635,1005,100,,Invoice,,,,,,24/08/2018,24/08/2018,0.00,,7.29,,"-820,729.16"
,IN,AR,30323671,1005,100,,Invoice,,,,,,24/08/2018,24/08/2018,0.00,,12.08,,"-820,741.24"
,IN,AR,30323681,1005,100,,Invoice,,,,,,24/08/2018,24/08/2018,0.00,,7.29,,"-820,748.53"
,IN,AR,30323690,1005,100,,Invoice,,,,,,24/08/2018,24/08/2018,0.00,,105.68,,"-820,854.21"
,IN,AR,30323701,1005,100,,Invoice,,,,,,24/08/2018,24/08/2018,0.00,,54.66,,"-820,908.87"
,IN,AR,30323709,1005,100,,Invoice,,,,,,24/08/2018,24/08/2018,0.00,,9.19,,"-820,918.06"
,IN,AR,30323715,1005,100,,Invoice,,,,,,24/08/2018,24/08/2018,0.00,,95.09,,"-821,013.15"
,IN,AR,30323733,1005,100,,Invoice,,,,,,24/08/2018,24/08/2018,0.00,,71.19,,"-821,084.34"
,IN,AR,30323787,1005,100,,Invoice,,,,,,24/08/2018,24/08/2018,0.00,,7.29,,"-821,091.63"
,IN,AR,30323814,1005,100,,Invoice,,,,,,24/08/2018,24/08/2018,0.00,,38.00,,"-821,129.63"
,IN,AR,30323830,1005,100,,Invoice,,,,,,24/08/2018,24/08/2018,0.00,,455.51,,"-821,585.14"
,IN,AR,30323853,1005,100,,Invoice,,,,,,24/08/2018,24/08/2018,0.00,,11.68,,"-821,596.82"
,IN,AR,30323862,1005,100,,Invoice,,,,,,24/08/2018,24/08/2018,0.00,,8.77,,"-821,605.59"
,IN,AR,30323867,1005,100,,Invoice,,,,,,24/08/2018,24/08/2018,0.00,,3.64,,"-821,609.23"
,IN,AR,30323871,1005,100,,Invoice,,,,,,24/08/2018,24/08/2018,0.00,,7.12,,"-821,616.35"
,IN,AR,30323879,1005,100,,Invoice,,,,,,24/08/2018,24/08/2018,0.00,,22.00,,"-821,638.35"
,IN,AR,30323923,1005,100,,Invoice,,,,,,24/08/2018,24/08/2018,0.00,,9.70,,"-821,648.05"
,IN,AR,30323924,1005,100,,Invoice,,,,,,24/08/2018,24/08/2018,0.00,,17.47,,"-821,665.52"
,IN,AR,30323942,1005,100,,Invoice,,,,,,24/08/2018,24/08/2018,0.00,,52.00,,"-821,717.52"
,IN,AR,30323949,1005,100,,Invoice,,,,,,24/08/2018,24/08/2018,0.00,,3.64,,"-821,721.16"
,IN,AR,30323962,1005,100,,Invoice,,,,,,24/08/2018,24/08/2018,0.00,,32.80,,"-821,753.96"
,IN,AR,30323976,1005,100,,Invoice,,,,,,24/08/2018,24/08/2018,0.00,,6.02,,"-821,759.98"
,IN,AR,30324002,1005,100,,Invoice,,,,,,24/08/2018,24/08/2018,0.00,,25.51,,"-821,785.49"
,IN,AR,30324020,1005,100,,Invoice,,,,,,24/08/2018,24/08/2018,0.00,,5.17,,"-821,790.66"
,IN,AR,30324056,1005,100,,Invoice,,,,,,24/08/2018,24/08/2018,0.00,,10.93,,"-821,801.59"
,IN,AR,30324149,1005,100,,Invoice,,,,,,24/08/2018,24/08/2018,0.00,,36.19,,"-821,837.78"
,IN,AR,30324157,1005,100,,Invoice,,,,,,24/08/2018,24/08/2018,0.00,,4.78,,"-821,842.56"
,IN,AR,30324194,1005,100,,Invoice,,,,,,24/08/2018,24/08/2018,0.00,,3.01,,"-821,845.57"
,IN,AR,30324219,1005,100,,Invoice,,,,,,24/08/2018,24/08/2018,0.00,,61.53,,"-821,907.10"
,IN,AR,30324249,1005,100,,Invoice,,,,,,24/08/2018,24/08/2018,0.00,,16.73,,"-821,923.83"
,IN,AR,30324299,1005,100,,Invoice,,,,,,24/08/2018,24/08/2018,0.00,,54.66,,"-821,978.49"
,IN,AR,30324304,1005,100,,Invoice,,,,,,24/08/2018,24/08/2018,0.00,,9.32,,"-821,987.81"
,IN,AR,30324308,1005,100,,Invoice,,,,,,24/08/2018,24/08/2018,0.00,,12.92,,"-822,000.73"
,IN,AR,30324371,1005,100,,Invoice,,,,,,24/08/2018,24/08/2018,0.00,,51.02,,"-822,051.75"
,IN,AR,30324372,1005,100,,Invoice,,,,,,24/08/2018,24/08/2018,0.00,,2.39,,"-822,054.14"
,IN,AR,30324380,1005,100,,Invoice,,,,,,24/08/2018,24/08/2018,0.00,,5.08,,"-822,059.22"
,IN,AR,30324381,1005,100,,Invoice,,,,,,24/08/2018,24/08/2018,0.00,,5.08,,"-822,064.30"
,IN,AR,30324382,1005,100,,Invoice,,,,,,24/08/2018,24/08/2018,0.00,,10.17,,"-822,074.47"
,IN,AR,30324403,1005,100,,Invoice,,,,,,24/08/2018,24/08/2018,0.00,,7.63,,"-822,082.10"
,IN,AR,30324416,1005,100,,Invoice,,,,,,24/08/2018,24/08/2018,0.00,,6.02,,"-822,088.12"
,IN,AR,30324470,1005,100,,Invoice,,,,,,24/08/2018,24/08/2018,0.00,,27.97,,"-822,116.09"
,IN,AR,30324476,1005,100,,Invoice,,,,,,24/08/2018,24/08/2018,0.00,,10.59,,"-822,126.68"
,IN,AR,30324503,1005,100,,Invoice,,,,,,24/08/2018,24/08/2018,0.00,,7.29,,"-822,133.97"
,IN,AR,30324519,1005,100,,Invoice,,,,,,24/08/2018,24/08/2018,0.00,,7.29,,"-822,141.26"
,IN,AR,30324572,1005,100,,Invoice,,,,,,24/08/2018,24/08/2018,0.00,,10.93,,"-822,152.19"
,IN,AR,30324606,1005,100,,Invoice,,,,,,24/08/2018,24/08/2018,0.00,,10.59,,"-822,162.78"
,IN,AR,30324639,1005,100,,Invoice,,,,,,24/08/2018,24/08/2018,0.00,,14.58,,"-822,177.36"
,IN,AR,30324660,1005,100,,Invoice,,,,,,24/08/2018,24/08/2018,0.00,,19.64,,"-822,197.00"
,IN,AR,30324681,1005,100,,Invoice,,,,,,24/08/2018,24/08/2018,0.00,,7.29,,"-822,204.29"
,IN,AR,30324718,1005,100,,Invoice,,,,,,24/08/2018,24/08/2018,0.00,,6.36,,"-822,210.65"
,IN,AR,30324780,1005,100,,Invoice,,,,,,24/08/2018,24/08/2018,0.00,,29.15,,"-822,239.80"
,IN,AR,30324815,1005,100,,Invoice,,,,,,24/08/2018,24/08/2018,0.00,,5.17,,"-822,244.97"
,IN,AR,30324823,1005,100,,Invoice,,,,,,24/08/2018,24/08/2018,0.00,,7.29,,"-822,252.26"
,IN,AR,30324873,1005,100,,Invoice,,,,,,24/08/2018,24/08/2018,0.00,,10.99,,"-822,263.25"
,IN,AR,30324919,1005,100,,Invoice,,,,,,24/08/2018,24/08/2018,0.00,,107.20,,"-822,370.45"
,IN,AR,30324937,1005,100,,Invoice,,,,,,24/08/2018,24/08/2018,0.00,,7.05,,"-822,377.50"
,IN,AR,30324938,1005,100,,Invoice,,,,,,24/08/2018,24/08/2018,0.00,,7.05,,"-822,384.55"
,IN,AR,30325008,1005,100,,Invoice,,,,,,24/08/2018,24/08/2018,0.00,,18.33,,"-822,402.88"
,IN,AR,30325062,1005,100,,Invoice,,,,,,24/08/2018,24/08/2018,0.00,,14.07,,"-822,416.95"
,IN,AR,30325092,1005,100,,Invoice,,,,,,24/08/2018,24/08/2018,0.00,,23.85,,"-822,440.80"
,IN,AR,30325115,1005,100,,Invoice,,,,,,24/08/2018,24/08/2018,0.00,,42.58,,"-822,483.38"
,IN,AR,30325129,1005,100,,Invoice,,,,,,24/08/2018,24/08/2018,0.00,,24.00,,"-822,507.38"
,IN,AR,30325137,1005,100,,Invoice,,,,,,24/08/2018,24/08/2018,0.00,,47.14,,"-822,554.52"
,IN,AR,30325144,1005,100,,Invoice,,,,,,24/08/2018,24/08/2018,0.00,,2.97,,"-822,557.49"
,IN,AR,30325158,1005,100,,Invoice,,,,,,24/08/2018,24/08/2018,0.00,,26.06,,"-822,583.55"
,IN,AR,30325171,1005,100,,Invoice,,,,,,24/08/2018,24/08/2018,0.00,,69.24,,"-822,652.79"
,IN,AR,30325186,1005,100,,Invoice,,,,,,24/08/2018,24/08/2018,0.00,,21.25,,"-822,674.04"
,IN,AR,30325212,1005,100,,Invoice,,,,,,24/08/2018,24/08/2018,0.00,,3.64,,"-822,677.68"
,IN,AR,30325217,1005,100,,Invoice,,,,,,24/08/2018,24/08/2018,0.00,,10.93,,"-822,688.61"
,IN,AR,30325222,1005,100,,Invoice,,,,,,24/08/2018,24/08/2018,0.00,,52.54,,"-822,741.15"
,IN,AR,30325262,1005,100,,Invoice,,,,,,24/08/2018,24/08/2018,0.00,,28.69,,"-822,769.84"
,IN,AR,30325284,1005,100,,Invoice,,,,,,24/08/2018,24/08/2018,0.00,,27.97,,"-822,797.81"
,IN,AR,30325317,1005,100,,Invoice,,,,,,24/08/2018,24/08/2018,0.00,,20.01,,"-822,817.82"
,IN,AR,30325368,1005,100,,Invoice,,,,,,24/08/2018,24/08/2018,0.00,,38.32,,"-822,856.14"
,IN,AR,30325375,1005,100,,Invoice,,,,,,24/08/2018,24/08/2018,0.00,,6.31,,"-822,862.45"
,IN,AR,30325376,1005,100,,Invoice,,,,,,24/08/2018,24/08/2018,0.00,,86.21,,"-822,948.66"
,IN,AR,30325441,1005,100,,Invoice,,,,,,24/08/2018,24/08/2018,0.00,,11.48,,"-822,960.14"
,IN,AR,30325446,1005,100,,Invoice,,,,,,24/08/2018,24/08/2018,0.00,,7.29,,"-822,967.43"
,IN,AR,30325447,1005,100,,Invoice,,,,,,24/08/2018,24/08/2018,0.00,,32.03,,"-822,999.46"
,IN,AR,30325456,1005,100,,Invoice,,,,,,24/08/2018,24/08/2018,0.00,,5.08,,"-823,004.54"
,IN,AR,30325515,1005,100,,Invoice,,,,,,24/08/2018,24/08/2018,0.00,,29.15,,"-823,033.69"
,IN,AR,30325522,1005,100,,Invoice,,,,,,24/08/2018,24/08/2018,0.00,,2.84,,"-823,036.53"
,IN,AR,30325525,1005,100,,Invoice,,,,,,24/08/2018,24/08/2018,0.00,,19.32,,"-823,055.85"
,IN,AR,30325529,1005,100,,Invoice,,,,,,24/08/2018,24/08/2018,0.00,,23.32,,"-823,079.17"
,IN,AR,30325580,1005,100,,Invoice,,,,,,24/08/2018,24/08/2018,0.00,,18.25,,"-823,097.42"
,IN,AR,30325677,1005,100,,Invoice,,,,,,24/08/2018,24/08/2018,0.00,,14.00,,"-823,111.42"
,IN,AR,30325737,1005,100,,Invoice,,,,,,24/08/2018,24/08/2018,0.00,,5.83,,"-823,117.25"
,IN,AR,30325750,1005,100,,Invoice,,,,,,24/08/2018,24/08/2018,0.00,,13.69,,"-823,130.94"
,IN,AR,30325767,1005,100,,Invoice,,,,,,24/08/2018,24/08/2018,0.00,,48.73,,"-823,179.67"
,IN,AR,30325781,1005,100,,Invoice,,,,,,24/08/2018,24/08/2018,0.00,,10.93,,"-823,190.60"
,IN,AR,30325782,1005,100,,Invoice,,,,,,24/08/2018,24/08/2018,0.00,,10.93,,"-823,201.53"
,IN,AR,30325800,1005,100,,Invoice,,,,,,24/08/2018,24/08/2018,0.00,,10.93,,"-823,212.46"
,IN,AR,30325807,1005,100,,Invoice,,,,,,24/08/2018,24/08/2018,0.00,,21.86,,"-823,234.32"
,IN,AR,30325821,1005,100,,Invoice,,,,,,24/08/2018,24/08/2018,0.00,,8.17,,"-823,242.49"
,IN,AR,30325849,1005,100,,Invoice,,,,,,24/08/2018,24/08/2018,0.00,,5.51,,"-823,248.00"
,IN,AR,30325856,1005,100,,Invoice,,,,,,24/08/2018,24/08/2018,0.00,,5.97,,"-823,253.97"
,IN,AR,30325886,1005,100,,Invoice,,,,,,24/08/2018,24/08/2018,0.00,,4.00,,"-823,257.97"
,IN,AR,30325905,1005,100,,Invoice,,,,,,24/08/2018,24/08/2018,0.00,,18.69,,"-823,276.66"
,IN,AR,30325984,1005,100,,Invoice,,,,,,24/08/2018,24/08/2018,0.00,,12.29,,"-823,288.95"
,IN,AR,30325990,1005,100,,Invoice,,,,,,24/08/2018,24/08/2018,0.00,,13.98,,"-823,302.93"
,IN,AR,30325994,1005,100,,Invoice,,,,,,24/08/2018,24/08/2018,0.00,,9.31,,"-823,312.24"
,IN,AR,30326012,1005,100,,Invoice,,,,,,24/08/2018,24/08/2018,0.00,,21.86,,"-823,334.10"
,IN,AR,30326024,1005,100,,Invoice,,,,,,24/08/2018,24/08/2018,0.00,,2.03,,"-823,336.13"
,IN,AR,30326044,1005,100,,Invoice,,,,,,24/08/2018,24/08/2018,0.00,,14.58,,"-823,350.71"
,IN,AR,30326061,1005,100,,Invoice,,,,,,24/08/2018,24/08/2018,0.00,,3.64,,"-823,354.35"
,IN,AR,30326129,1005,100,,Invoice,,,,,,24/08/2018,24/08/2018,0.00,,3.28,,"-823,357.63"
,IN,AR,30326136,1005,100,,Invoice,,,,,,24/08/2018,24/08/2018,0.00,,182.03,,"-823,539.66"
,IN,AR,30326149,1005,100,,Invoice,,,,,,24/08/2018,24/08/2018,0.00,,93.90,,"-823,633.56"
,IN,AR,30326186,1005,100,,Invoice,,,,,,24/08/2018,24/08/2018,0.00,,29.15,,"-823,662.71"
,IN,AR,30326191,1005,100,,Invoice,,,,,,24/08/2018,24/08/2018,0.00,,364.41,,"-824,027.12"
,IN,AR,30326194,1005,100,,Invoice,,,,,,24/08/2018,24/08/2018,0.00,,455.51,,"-824,482.63"
,IN,AR,30326195,1005,100,,Invoice,,,,,,24/08/2018,24/08/2018,0.00,,419.07,,"-824,901.70"
,IN,AR,30326197,1005,100,,Invoice,,,,,,24/08/2018,24/08/2018,0.00,,29.15,,"-824,930.85"
,CS,AR,32008018,1005,100,,Cash sale,,,,,,25/08/2018,25/08/2018,0.00,,10.93,,"-824,941.78"
,CS,AR,32008113,1005,100,,Cash sale,,,,,,25/08/2018,25/08/2018,0.00,,7.29,,"-824,949.07"
,CS,AR,32008274,1005,100,,Cash sale,,,,,,25/08/2018,25/08/2018,0.00,,6.86,,"-824,955.93"
,CS,AR,32008679,1005,100,,Cash sale,,,,,,25/08/2018,25/08/2018,0.00,,6.10,,"-824,962.03"
,CS,AR,32008765,1005,100,,Cash sale,,,,,,25/08/2018,25/08/2018,0.00,,29.15,,"-824,991.18"
,IN,AR,30323734,1005,100,,Invoice,,,,,,25/08/2018,25/08/2018,0.00,,49.83,,"-825,041.01"
,IN,AR,30323847,1005,100,,Invoice,,,,,,25/08/2018,25/08/2018,0.00,,25.51,,"-825,066.52"
,IN,AR,30323914,1005,100,,Invoice,,,,,,25/08/2018,25/08/2018,0.00,,780.96,,"-825,847.48"
,IN,AR,30323936,1005,100,,Invoice,,,,,,25/08/2018,25/08/2018,0.00,,10.93,,"-825,858.41"
,IN,AR,30324505,1005,100,,Invoice,,,,,,25/08/2018,25/08/2018,0.00,,3.64,,"-825,862.05"
,IN,AR,30324967,1005,100,,Invoice,,,,,,25/08/2018,25/08/2018,0.00,,9.69,,"-825,871.74"
,IN,AR,30325473,1005,100,,Invoice,,,,,,25/08/2018,25/08/2018,0.00,,27.31,,"-825,899.05"
,IN,AR,30326019,1005,100,,Invoice,,,,,,25/08/2018,25/08/2018,0.00,,7.29,,"-825,906.34"
,IN,AR,30326020,1005,100,,Invoice,,,,,,25/08/2018,25/08/2018,0.00,,3.28,,"-825,909.62"
,CS,AR,32008777,1005,100,,Cash sale,,,,,,26/08/2018,26/08/2018,0.00,,29.15,,"-825,938.77"
,CN,AR,31018782,1005,100,,Credit Note,,,,,,27/08/2018,27/08/2018,29.76,,0.00,,"-825,909.01"
,CN,AR,31018783,1005,100,,Credit Note,,,,,,27/08/2018,27/08/2018,59.53,,0.00,,"-825,849.48"
,CN,AR,31018826,1005,100,,Credit Note,,,,,,27/08/2018,27/08/2018,8.33,,0.00,,"-825,841.15"
,CN,AR,31018925,1005,100,,Credit Note,,,,,,27/08/2018,27/08/2018,21.86,,0.00,,"-825,819.29"
,CS,AR,32007888,1005,100,,Cash sale,,,,,,27/08/2018,27/08/2018,0.00,,11.22,,"-825,830.51"
,CS,AR,32007904,1005,100,,Cash sale,,,,,,27/08/2018,27/08/2018,0.00,,9.49,,"-825,840.00"
,CS,AR,32007931,1005,100,,Cash sale,,,,,,27/08/2018,27/08/2018,0.00,,18.22,,"-825,858.22"
,CS,AR,32007935,1005,100,,Cash sale,,,,,,27/08/2018,27/08/2018,0.00,,10.93,,"-825,869.15"
,CS,AR,32007969,1005,100,,Cash sale,,,,,,27/08/2018,27/08/2018,0.00,,7.29,,"-825,876.44"
,CS,AR,32008012,1005,100,,Cash sale,,,,,,27/08/2018,27/08/2018,0.00,,10.38,,"-825,886.82"
,CS,AR,32008031,1005,100,,Cash sale,,,,,,27/08/2018,27/08/2018,0.00,,7.29,,"-825,894.11"
,CS,AR,32008039,1005,100,,Cash sale,,,,,,27/08/2018,27/08/2018,0.00,,3.64,,"-825,897.75"
,CS,AR,32008057,1005,100,,Cash sale,,,,,,27/08/2018,27/08/2018,0.00,,7.29,,"-825,905.04"
,CS,AR,32008063,1005,100,,Cash sale,,,,,,27/08/2018,27/08/2018,0.00,,5.17,,"-825,910.21"
,CS,AR,32008075,1005,100,,Cash sale,,,,,,27/08/2018,27/08/2018,0.00,,3.64,,"-825,913.85"
,CS,AR,32008106,1005,100,,Cash sale,,,,,,27/08/2018,27/08/2018,0.00,,7.75,,"-825,921.60"
,CS,AR,32008133,1005,100,,Cash sale,,,,,,27/08/2018,27/08/2018,0.00,,14.58,,"-825,936.18"
,CS,AR,32008149,1005,100,,Cash sale,,,,,,27/08/2018,27/08/2018,0.00,,7.63,,"-825,943.81"
,CS,AR,32008164,1005,100,,Cash sale,,,,,,27/08/2018,27/08/2018,0.00,,10.93,,"-825,954.74"
,CS,AR,32008189,1005,100,,Cash sale,,,,,,27/08/2018,27/08/2018,0.00,,19.24,,"-825,973.98"
,CS,AR,32008206,1005,100,,Cash sale,,,,,,27/08/2018,27/08/2018,0.00,,24.07,,"-825,998.05"
,CS,AR,32008224,1005,100,,Cash sale,,,,,,27/08/2018,27/08/2018,0.00,,7.29,,"-826,005.34"
,CS,AR,32008236,1005,100,,Cash sale,,,,,,27/08/2018,27/08/2018,0.00,,5.08,,"-826,010.42"
,CS,AR,32008250,1005,100,,Cash sale,,,,,,27/08/2018,27/08/2018,0.00,,17.54,,"-826,027.96"
,CS,AR,32008262,1005,100,,Cash sale,,,,,,27/08/2018,27/08/2018,0.00,,20.68,,"-826,048.64"
,CS,AR,32008267,1005,100,,Cash sale,,,,,,27/08/2018,27/08/2018,0.00,,18.05,,"-826,066.69"
,CS,AR,32008286,1005,100,,Cash sale,,,,,,27/08/2018,27/08/2018,0.00,,7.29,,"-826,073.98"
,CS,AR,32008305,1005,100,,Cash sale,,,,,,27/08/2018,27/08/2018,0.00,,3.64,,"-826,077.62"
,CS,AR,32008341,1005,100,,Cash sale,,,,,,27/08/2018,27/08/2018,0.00,,2.54,,"-826,080.16"
,CS,AR,32008368,1005,100,,Cash sale,,,,,,27/08/2018,27/08/2018,0.00,,10.93,,"-826,091.09"
,CS,AR,32008370,1005,100,,Cash sale,,,,,,27/08/2018,27/08/2018,0.00,,7.75,,"-826,098.84"
,CS,AR,32008376,1005,100,,Cash sale,,,,,,27/08/2018,27/08/2018,0.00,,5.85,,"-826,104.69"
,CS,AR,32008391,1005,100,,Cash sale,,,,,,27/08/2018,27/08/2018,0.00,,10.93,,"-826,115.62"
,CS,AR,32008445,1005,100,,Cash sale,,,,,,27/08/2018,27/08/2018,0.00,,9.13,,"-826,124.75"
,CS,AR,32008473,1005,100,,Cash sale,,,,,,27/08/2018,27/08/2018,0.00,,7.29,,"-826,132.04"
,CS,AR,32008524,1005,100,,Cash sale,,,,,,27/08/2018,27/08/2018,0.00,,5.17,,"-826,137.21"
,CS,AR,32008563,1005,100,,Cash sale,,,,,,27/08/2018,27/08/2018,0.00,,10.93,,"-826,148.14"
,CS,AR,32008585,1005,100,,Cash sale,,,,,,27/08/2018,27/08/2018,0.00,,13.73,,"-826,161.87"
,CS,AR,32008596,1005,100,,Cash sale,,,,,,27/08/2018,27/08/2018,0.00,,7.29,,"-826,169.16"
,CS,AR,32008641,1005,100,,Cash sale,,,,,,27/08/2018,27/08/2018,0.00,,15.18,,"-826,184.34"
,CS,AR,32008661,1005,100,,Cash sale,,,,,,27/08/2018,27/08/2018,0.00,,10.93,,"-826,195.27"
,CS,AR,32008673,1005,100,,Cash sale,,,,,,27/08/2018,27/08/2018,0.00,,44.75,,"-826,240.02"
,CS,AR,32008695,1005,100,,Cash sale,,,,,,27/08/2018,27/08/2018,0.00,,10.93,,"-826,250.95"
,CS,AR,32008716,1005,100,,Cash sale,,,,,,27/08/2018,27/08/2018,0.00,,54.66,,"-826,305.61"
,CS,AR,32008761,1005,100,,Cash sale,,,,,,27/08/2018,27/08/2018,0.00,,3.64,,"-826,309.25"
,CS,AR,32008828,1005,100,,Cash sale,,,,,,27/08/2018,27/08/2018,0.00,,3.03,,"-826,312.28"
,CS,AR,32008832,1005,100,,Cash sale,,,,,,27/08/2018,27/08/2018,0.00,,7.29,,"-826,319.57"
,CS,AR,32008841,1005,100,,Cash sale,,,,,,27/08/2018,27/08/2018,0.00,,7.29,,"-826,326.86"
,IN,AR,30323543,1005,100,,Invoice,,,,,,27/08/2018,27/08/2018,0.00,,65.25,,"-826,392.11"
,IN,AR,30323566,1005,100,,Invoice,,,,,,27/08/2018,27/08/2018,0.00,,43.73,,"-826,435.84"
,IN,AR,30323576,1005,100,,Invoice,,,,,,27/08/2018,27/08/2018,0.00,,364.41,,"-826,800.25"
,IN,AR,30323607,1005,100,,Invoice,,,,,,27/08/2018,27/08/2018,0.00,,8.10,,"-826,808.35"
,IN,AR,30323608,1005,100,,Invoice,,,,,,27/08/2018,27/08/2018,0.00,,2.03,,"-826,810.38"
,IN,AR,30323609,1005,100,,Invoice,,,,,,27/08/2018,27/08/2018,0.00,,8.10,,"-826,818.48"
,IN,AR,30323610,1005,100,,Invoice,,,,,,27/08/2018,27/08/2018,0.00,,16.20,,"-826,834.68"
,IN,AR,30323611,1005,100,,Invoice,,,,,,27/08/2018,27/08/2018,0.00,,14.18,,"-826,848.86"
,IN,AR,30323612,1005,100,,Invoice,,,,,,27/08/2018,27/08/2018,0.00,,10.13,,"-826,858.99"
,IN,AR,30323691,1005,100,,Invoice,,,,,,27/08/2018,27/08/2018,0.00,,4.23,,"-826,863.22"
,IN,AR,30323720,1005,100,,Invoice,,,,,,27/08/2018,27/08/2018,0.00,,3.64,,"-826,866.86"
,IN,AR,30323735,1005,100,,Invoice,,,,,,27/08/2018,27/08/2018,0.00,,144.75,,"-827,011.61"
,IN,AR,30323753,1005,100,,Invoice,,,,,,27/08/2018,27/08/2018,0.00,,19.28,,"-827,030.89"
,IN,AR,30323760,1005,100,,Invoice,,,,,,27/08/2018,27/08/2018,0.00,,54.66,,"-827,085.55"
,IN,AR,30323770,1005,100,,Invoice,,,,,,27/08/2018,27/08/2018,0.00,,54.66,,"-827,140.21"
,IN,AR,30323772,1005,100,,Invoice,,,,,,27/08/2018,27/08/2018,0.00,,64.00,,"-827,204.21"
,IN,AR,30323783,1005,100,,Invoice,,,,,,27/08/2018,27/08/2018,0.00,,23.73,,"-827,227.94"
,IN,AR,30323791,1005,100,,Invoice,,,,,,27/08/2018,27/08/2018,0.00,,65.75,,"-827,293.69"
,IN,AR,30323809,1005,100,,Invoice,,,,,,27/08/2018,27/08/2018,0.00,,3.64,,"-827,297.33"
,IN,AR,30323815,1005,100,,Invoice,,,,,,27/08/2018,27/08/2018,0.00,,30.00,,"-827,327.33"
,IN,AR,30323816,1005,100,,Invoice,,,,,,27/08/2018,27/08/2018,0.00,,32.00,,"-827,359.33"
,IN,AR,30323832,1005,100,,Invoice,,,,,,27/08/2018,27/08/2018,0.00,,5.51,,"-827,364.84"
,IN,AR,30323836,1005,100,,Invoice,,,,,,27/08/2018,27/08/2018,0.00,,43.22,,"-827,408.06"
,IN,AR,30323839,1005,100,,Invoice,,,,,,27/08/2018,27/08/2018,0.00,,5.51,,"-827,413.57"
,IN,AR,30323854,1005,100,,Invoice,,,,,,27/08/2018,27/08/2018,0.00,,5.84,,"-827,419.41"
,IN,AR,30323863,1005,100,,Invoice,,,,,,27/08/2018,27/08/2018,0.00,,5.85,,"-827,425.26"
,IN,AR,30323880,1005,100,,Invoice,,,,,,27/08/2018,27/08/2018,0.00,,26.00,,"-827,451.26"
,IN,AR,30323892,1005,100,,Invoice,,,,,,27/08/2018,27/08/2018,0.00,,29.15,,"-827,480.41"
,IN,AR,30323905,1005,100,,Invoice,,,,,,27/08/2018,27/08/2018,0.00,,14.19,,"-827,494.60"
,IN,AR,30323915,1005,100,,Invoice,,,,,,27/08/2018,27/08/2018,0.00,,30.51,,"-827,525.11"
,IN,AR,30323935,1005,100,,Invoice,,,,,,27/08/2018,27/08/2018,0.00,,14.58,,"-827,539.69"
,IN,AR,30323941,1005,100,,Invoice,,,,,,27/08/2018,27/08/2018,0.00,,182.20,,"-827,721.89"
,IN,AR,30323943,1005,100,,Invoice,,,,,,27/08/2018,27/08/2018,0.00,,24.00,,"-827,745.89"
,IN,AR,30323972,1005,100,,Invoice,,,,,,27/08/2018,27/08/2018,0.00,,19.32,,"-827,765.21"
,IN,AR,30323984,1005,100,,Invoice,,,,,,27/08/2018,27/08/2018,0.00,,25.51,,"-827,790.72"
,IN,AR,30323997,1005,100,,Invoice,,,,,,27/08/2018,27/08/2018,0.00,,7.97,,"-827,798.69"
,IN,AR,30324005,1005,100,,Invoice,,,,,,27/08/2018,27/08/2018,0.00,,23.26,,"-827,821.95"
,IN,AR,30324023,1005,100,,Invoice,,,,,,27/08/2018,27/08/2018,0.00,,12.92,,"-827,834.87"
,IN,AR,30324026,1005,100,,Invoice,,,,,,27/08/2018,27/08/2018,0.00,,7.29,,"-827,842.16"
,IN,AR,30324028,1005,100,,Invoice,,,,,,27/08/2018,27/08/2018,0.00,,29.15,,"-827,871.31"
,IN,AR,30324042,1005,100,,Invoice,,,,,,27/08/2018,27/08/2018,0.00,,364.41,,"-828,235.72"
,IN,AR,30324045,1005,100,,Invoice,,,,,,27/08/2018,27/08/2018,0.00,,7.19,,"-828,242.91"
,IN,AR,30324051,1005,100,,Invoice,,,,,,27/08/2018,27/08/2018,0.00,,13.78,,"-828,256.69"
,IN,AR,30324096,1005,100,,Invoice,,,,,,27/08/2018,27/08/2018,0.00,,4.24,,"-828,260.93"
,IN,AR,30324131,1005,100,,Invoice,,,,,,27/08/2018,27/08/2018,0.00,,182.20,,"-828,443.13"
,IN,AR,30324136,1005,100,,Invoice,,,,,,27/08/2018,27/08/2018,0.00,,10.59,,"-828,453.72"
,IN,AR,30324141,1005,100,,Invoice,,,,,,27/08/2018,27/08/2018,0.00,,19.07,,"-828,472.79"
,IN,AR,30324170,1005,100,,Invoice,,,,,,27/08/2018,27/08/2018,0.00,,10.38,,"-828,483.17"
,IN,AR,30324179,1005,100,,Invoice,,,,,,27/08/2018,27/08/2018,0.00,,"1,093.22",,"-829,576.39"
,IN,AR,30324220,1005,100,,Invoice,,,,,,27/08/2018,27/08/2018,0.00,,88.19,,"-829,664.58"
,IN,AR,30324234,1005,100,,Invoice,,,,,,27/08/2018,27/08/2018,0.00,,55.93,,"-829,720.51"
,IN,AR,30324250,1005,100,,Invoice,,,,,,27/08/2018,27/08/2018,0.00,,14.34,,"-829,734.85"
,IN,AR,30324251,1005,100,,Invoice,,,,,,27/08/2018,27/08/2018,0.00,,14.34,,"-829,749.19"
,IN,AR,30324263,1005,100,,Invoice,,,,,,27/08/2018,27/08/2018,0.00,,9.66,,"-829,758.85"
,IN,AR,30324264,1005,100,,Invoice,,,,,,27/08/2018,27/08/2018,0.00,,32.20,,"-829,791.05"
,IN,AR,30324283,1005,100,,Invoice,,,,,,27/08/2018,27/08/2018,0.00,,12.03,,"-829,803.08"
,IN,AR,30324296,1005,100,,Invoice,,,,,,27/08/2018,27/08/2018,0.00,,2.75,,"-829,805.83"
,IN,AR,30324314,1005,100,,Invoice,,,,,,27/08/2018,27/08/2018,0.00,,2.12,,"-829,807.95"
,IN,AR,30324331,1005,100,,Invoice,,,,,,27/08/2018,27/08/2018,0.00,,6.02,,"-829,813.97"
,IN,AR,30324383,1005,100,,Invoice,,,,,,27/08/2018,27/08/2018,0.00,,5.08,,"-829,819.05"
,IN,AR,30324436,1005,100,,Invoice,,,,,,27/08/2018,27/08/2018,0.00,,24.07,,"-829,843.12"
,IN,AR,30324525,1005,100,,Invoice,,,,,,27/08/2018,27/08/2018,0.00,,27.97,,"-829,871.09"
,IN,AR,30324542,1005,100,,Invoice,,,,,,27/08/2018,27/08/2018,0.00,,26.44,,"-829,897.53"
,IN,AR,30324588,1005,100,,Invoice,,,,,,27/08/2018,27/08/2018,0.00,,14.58,,"-829,912.11"
,IN,AR,30324629,1005,100,,Invoice,,,,,,27/08/2018,27/08/2018,0.00,,5.51,,"-829,917.62"
,IN,AR,30324632,1005,100,,Invoice,,,,,,27/08/2018,27/08/2018,0.00,,3.64,,"-829,921.26"
,IN,AR,30324646,1005,100,,Invoice,,,,,,27/08/2018,27/08/2018,0.00,,15.21,,"-829,936.47"
,IN,AR,30324657,1005,100,,Invoice,,,,,,27/08/2018,27/08/2018,0.00,,11.48,,"-829,947.95"
,IN,AR,30324670,1005,100,,Invoice,,,,,,27/08/2018,27/08/2018,0.00,,10.51,,"-829,958.46"
,IN,AR,30324697,1005,100,,Invoice,,,,,,27/08/2018,27/08/2018,0.00,,14.58,,"-829,973.04"
,IN,AR,30324716,1005,100,,Invoice,,,,,,27/08/2018,27/08/2018,0.00,,54.66,,"-830,027.70"
,IN,AR,30324732,1005,100,,Invoice,,,,,,27/08/2018,27/08/2018,0.00,,14.83,,"-830,042.53"
,IN,AR,30324758,1005,100,,Invoice,,,,,,27/08/2018,27/08/2018,0.00,,68.34,,"-830,110.87"
,IN,AR,30324769,1005,100,,Invoice,,,,,,27/08/2018,27/08/2018,0.00,,14.58,,"-830,125.45"
,IN,AR,30324772,1005,100,,Invoice,,,,,,27/08/2018,27/08/2018,0.00,,40.00,,"-830,165.45"
,IN,AR,30324816,1005,100,,Invoice,,,,,,27/08/2018,27/08/2018,0.00,,7.75,,"-830,173.20"
,IN,AR,30324836,1005,100,,Invoice,,,,,,27/08/2018,27/08/2018,0.00,,42.69,,"-830,215.89"
,IN,AR,30324839,1005,100,,Invoice,,,,,,27/08/2018,27/08/2018,0.00,,8.33,,"-830,224.22"
,IN,AR,30324853,1005,100,,Invoice,,,,,,27/08/2018,27/08/2018,0.00,,7.29,,"-830,231.51"
,IN,AR,30324854,1005,100,,Invoice,,,,,,27/08/2018,27/08/2018,0.00,,11.23,,"-830,242.74"
,IN,AR,30324880,1005,100,,Invoice,,,,,,27/08/2018,27/08/2018,0.00,,"1,275.42",,"-831,518.16"
,IN,AR,30324939,1005,100,,Invoice,,,,,,27/08/2018,27/08/2018,0.00,,7.05,,"-831,525.21"
,IN,AR,30324960,1005,100,,Invoice,,,,,,27/08/2018,27/08/2018,0.00,,7.29,,"-831,532.50"
,IN,AR,30325000,1005,100,,Invoice,,,,,,27/08/2018,27/08/2018,0.00,,29.15,,"-831,561.65"
,IN,AR,30325029,1005,100,,Invoice,,,,,,27/08/2018,27/08/2018,0.00,,54.66,,"-831,616.31"
,IN,AR,30325030,1005,100,,Invoice,,,,,,27/08/2018,27/08/2018,0.00,,54.66,,"-831,670.97"
,IN,AR,30325040,1005,100,,Invoice,,,,,,27/08/2018,27/08/2018,0.00,,6.43,,"-831,677.40"
,IN,AR,30325043,1005,100,,Invoice,,,,,,27/08/2018,27/08/2018,0.00,,218.64,,"-831,896.04"
,IN,AR,30325093,1005,100,,Invoice,,,,,,27/08/2018,27/08/2018,0.00,,1.59,,"-831,897.63"
,IN,AR,30325141,1005,100,,Invoice,,,,,,27/08/2018,27/08/2018,0.00,,4.29,,"-831,901.92"
,IN,AR,30325159,1005,100,,Invoice,,,,,,27/08/2018,27/08/2018,0.00,,34.08,,"-831,936.00"
,IN,AR,30325187,1005,100,,Invoice,,,,,,27/08/2018,27/08/2018,0.00,,15.18,,"-831,951.18"
,IN,AR,30325199,1005,100,,Invoice,,,,,,27/08/2018,27/08/2018,0.00,,38.90,,"-831,990.08"
,IN,AR,30325230,1005,100,,Invoice,,,,,,27/08/2018,27/08/2018,0.00,,4.58,,"-831,994.66"
,IN,AR,30325271,1005,100,,Invoice,,,,,,27/08/2018,27/08/2018,0.00,,14.58,,"-832,009.24"
,IN,AR,30325301,1005,100,,Invoice,,,,,,27/08/2018,27/08/2018,0.00,,22.01,,"-832,031.25"
,IN,AR,30325318,1005,100,,Invoice,,,,,,27/08/2018,27/08/2018,0.00,,16.01,,"-832,047.26"
,IN,AR,30325342,1005,100,,Invoice,,,,,,27/08/2018,27/08/2018,0.00,,18.20,,"-832,065.46"
,IN,AR,30325349,1005,100,,Invoice,,,,,,27/08/2018,27/08/2018,0.00,,39.22,,"-832,104.68"
,IN,AR,30325377,1005,100,,Invoice,,,,,,27/08/2018,27/08/2018,0.00,,12.62,,"-832,117.30"
,IN,AR,30325405,1005,100,,Invoice,,,,,,27/08/2018,27/08/2018,0.00,,4.66,,"-832,121.96"
,IN,AR,30325422,1005,100,,Invoice,,,,,,27/08/2018,27/08/2018,0.00,,130.51,,"-832,252.47"
,IN,AR,30325433,1005,100,,Invoice,,,,,,27/08/2018,27/08/2018,0.00,,14.03,,"-832,266.50"
,IN,AR,30325445,1005,100,,Invoice,,,,,,27/08/2018,27/08/2018,0.00,,218.64,,"-832,485.14"
,IN,AR,30325453,1005,100,,Invoice,,,,,,27/08/2018,27/08/2018,0.00,,19.58,,"-832,504.72"
,IN,AR,30325533,1005,100,,Invoice,,,,,,27/08/2018,27/08/2018,0.00,,29.36,,"-832,534.08"
,IN,AR,30325543,1005,100,,Invoice,,,,,,27/08/2018,27/08/2018,0.00,,21.86,,"-832,555.94"
,IN,AR,30325551,1005,100,,Invoice,,,,,,27/08/2018,27/08/2018,0.00,,31.86,,"-832,587.80"
,IN,AR,30325552,1005,100,,Invoice,,,,,,27/08/2018,27/08/2018,0.00,,9.56,,"-832,597.36"
,IN,AR,30325678,1005,100,,Invoice,,,,,,27/08/2018,27/08/2018,0.00,,12.00,,"-832,609.36"
,IN,AR,30325686,1005,100,,Invoice,,,,,,27/08/2018,27/08/2018,0.00,,3.76,,"-832,613.12"
,IN,AR,30325706,1005,100,,Invoice,,,,,,27/08/2018,27/08/2018,0.00,,11.36,,"-832,624.48"
,IN,AR,30325741,1005,100,,Invoice,,,,,,27/08/2018,27/08/2018,0.00,,29.15,,"-832,653.63"
,IN,AR,30325751,1005,100,,Invoice,,,,,,27/08/2018,27/08/2018,0.00,,10.95,,"-832,664.58"
,IN,AR,30325764,1005,100,,Invoice,,,,,,27/08/2018,27/08/2018,0.00,,182.20,,"-832,846.78"
,IN,AR,30325804,1005,100,,Invoice,,,,,,27/08/2018,27/08/2018,0.00,,5.24,,"-832,852.02"
,IN,AR,30325808,1005,100,,Invoice,,,,,,27/08/2018,27/08/2018,0.00,,10.53,,"-832,862.55"
,IN,AR,30325822,1005,100,,Invoice,,,,,,27/08/2018,27/08/2018,0.00,,4.08,,"-832,866.63"
,IN,AR,30325842,1005,100,,Invoice,,,,,,27/08/2018,27/08/2018,0.00,,182.20,,"-833,048.83"
,IN,AR,30325843,1005,100,,Invoice,,,,,,27/08/2018,27/08/2018,0.00,,51.02,,"-833,099.85"
,IN,AR,30325865,1005,100,,Invoice,,,,,,27/08/2018,27/08/2018,0.00,,38.01,,"-833,137.86"
,IN,AR,30325887,1005,100,,Invoice,,,,,,27/08/2018,27/08/2018,0.00,,4.00,,"-833,141.86"
,IN,AR,30325906,1005,100,,Invoice,,,,,,27/08/2018,27/08/2018,0.00,,4.15,,"-833,146.01"
,IN,AR,30325907,1005,100,,Invoice,,,,,,27/08/2018,27/08/2018,0.00,,10.38,,"-833,156.39"
,IN,AR,30325908,1005,100,,Invoice,,,,,,27/08/2018,27/08/2018,0.00,,2.08,,"-833,158.47"
,IN,AR,30325909,1005,100,,Invoice,,,,,,27/08/2018,27/08/2018,0.00,,4.15,,"-833,162.62"
,IN,AR,30325910,1005,100,,Invoice,,,,,,27/08/2018,27/08/2018,0.00,,6.23,,"-833,168.85"
,IN,AR,30325911,1005,100,,Invoice,,,,,,27/08/2018,27/08/2018,0.00,,12.46,,"-833,181.31"
,IN,AR,30325966,1005,100,,Invoice,,,,,,27/08/2018,27/08/2018,0.00,,13.12,,"-833,194.43"
,IN,AR,30325991,1005,100,,Invoice,,,,,,27/08/2018,27/08/2018,0.00,,9.32,,"-833,203.75"
,IN,AR,30326013,1005,100,,Invoice,,,,,,27/08/2018,27/08/2018,0.00,,10.93,,"-833,214.68"
,IN,AR,30326055,1005,100,,Invoice,,,,,,27/08/2018,27/08/2018,0.00,,1.75,,"-833,216.43"
,IN,AR,30326069,1005,100,,Invoice,,,,,,27/08/2018,27/08/2018,0.00,,29.15,,"-833,245.58"
,IN,AR,30326070,1005,100,,Invoice,,,,,,27/08/2018,27/08/2018,0.00,,29.15,,"-833,274.73"
,IN,AR,30326071,1005,100,,Invoice,,,,,,27/08/2018,27/08/2018,0.00,,182.20,,"-833,456.93"
,IN,AR,30326085,1005,100,,Invoice,,,,,,27/08/2018,27/08/2018,0.00,,31.54,,"-833,488.47"
,IN,AR,30326086,1005,100,,Invoice,,,,,,27/08/2018,27/08/2018,0.00,,10.52,,"-833,498.99"
,IN,AR,30326108,1005,100,,Invoice,,,,,,27/08/2018,27/08/2018,0.00,,54.66,,"-833,553.65"
,IN,AR,30326125,1005,100,,Invoice,,,,,,27/08/2018,27/08/2018,0.00,,15.53,,"-833,569.18"
,IN,AR,30326132,1005,100,,Invoice,,,,,,27/08/2018,27/08/2018,0.00,,10.93,,"-833,580.11"
,IN,AR,30326199,1005,100,,Invoice,,,,,,27/08/2018,27/08/2018,0.00,,10.93,,"-833,591.04"
,IN,AR,30326202,1005,100,,Invoice,,,,,,27/08/2018,27/08/2018,0.00,,29.15,,"-833,620.19"
,IN,AR,30326204,1005,100,,Invoice,,,,,,27/08/2018,27/08/2018,0.00,,29.15,,"-833,649.34"
,CN,AR,31018938,1005,100,,Credit Note,,,,,,28/08/2018,28/08/2018,172.33,,0.00,,"-833,477.01"
,CS,AR,32007916,1005,100,,Cash sale,,,,,,28/08/2018,28/08/2018,0.00,,7.29,,"-833,484.30"
,CS,AR,32007934,1005,100,,Cash sale,,,,,,28/08/2018,28/08/2018,0.00,,3.64,,"-833,487.94"
,CS,AR,32007939,1005,100,,Cash sale,,,,,,28/08/2018,28/08/2018,0.00,,3.64,,"-833,491.58"
,CS,AR,32007940,1005,100,,Cash sale,,,,,,28/08/2018,28/08/2018,0.00,,7.29,,"-833,498.87"
,CS,AR,32007957,1005,100,,Cash sale,,,,,,28/08/2018,28/08/2018,0.00,,14.58,,"-833,513.45"
,CS,AR,32007965,1005,100,,Cash sale,,,,,,28/08/2018,28/08/2018,0.00,,14.58,,"-833,528.03"
,CS,AR,32007967,1005,100,,Cash sale,,,,,,28/08/2018,28/08/2018,0.00,,7.29,,"-833,535.32"
,CS,AR,32007986,1005,100,,Cash sale,,,,,,28/08/2018,28/08/2018,0.00,,12.03,,"-833,547.35"
,CS,AR,32007991,1005,100,,Cash sale,,,,,,28/08/2018,28/08/2018,0.00,,25.51,,"-833,572.86"
,CS,AR,32008001,1005,100,,Cash sale,,,,,,28/08/2018,28/08/2018,0.00,,18.22,,"-833,591.08"
,CS,AR,32008069,1005,100,,Cash sale,,,,,,28/08/2018,28/08/2018,0.00,,10.93,,"-833,602.01"
,CS,AR,32008080,1005,100,,Cash sale,,,,,,28/08/2018,28/08/2018,0.00,,10.93,,"-833,612.94"
,CS,AR,32008085,1005,100,,Cash sale,,,,,,28/08/2018,28/08/2018,0.00,,7.29,,"-833,620.23"
,CS,AR,32008117,1005,100,,Cash sale,,,,,,28/08/2018,28/08/2018,0.00,,7.29,,"-833,627.52"
,CS,AR,32008126,1005,100,,Cash sale,,,,,,28/08/2018,28/08/2018,0.00,,4.32,,"-833,631.84"
,CS,AR,32008161,1005,100,,Cash sale,,,,,,28/08/2018,28/08/2018,0.00,,10.34,,"-833,642.18"
,CS,AR,32008166,1005,100,,Cash sale,,,,,,28/08/2018,28/08/2018,0.00,,2.84,,"-833,645.02"
,CS,AR,32008172,1005,100,,Cash sale,,,,,,28/08/2018,28/08/2018,0.00,,7.29,,"-833,652.31"
,CS,AR,32008183,1005,100,,Cash sale,,,,,,28/08/2018,28/08/2018,0.00,,10.93,,"-833,663.24"
,CS,AR,32008185,1005,100,,Cash sale,,,,,,28/08/2018,28/08/2018,0.00,,10.93,,"-833,674.17"
,CS,AR,32008213,1005,100,,Cash sale,,,,,,28/08/2018,28/08/2018,0.00,,7.29,,"-833,681.46"
,CS,AR,32008214,1005,100,,Cash sale,,,,,,28/08/2018,28/08/2018,0.00,,7.29,,"-833,688.75"
,CS,AR,32008229,1005,100,,Cash sale,,,,,,28/08/2018,28/08/2018,0.00,,3.64,,"-833,692.39"
,CS,AR,32008246,1005,100,,Cash sale,,,,,,28/08/2018,28/08/2018,0.00,,12.03,,"-833,704.42"
,CS,AR,32008290,1005,100,,Cash sale,,,,,,28/08/2018,28/08/2018,0.00,,7.75,,"-833,712.17"
,CS,AR,32008308,1005,100,,Cash sale,,,,,,28/08/2018,28/08/2018,0.00,,3.64,,"-833,715.81"
,CS,AR,32008325,1005,100,,Cash sale,,,,,,28/08/2018,28/08/2018,0.00,,12.92,,"-833,728.73"
,CS,AR,32008335,1005,100,,Cash sale,,,,,,28/08/2018,28/08/2018,0.00,,90.25,,"-833,818.98"
,CS,AR,32008344,1005,100,,Cash sale,,,,,,28/08/2018,28/08/2018,0.00,,12.92,,"-833,831.90"
,CS,AR,32008349,1005,100,,Cash sale,,,,,,28/08/2018,28/08/2018,0.00,,3.90,,"-833,835.80"
,CS,AR,32008351,1005,100,,Cash sale,,,,,,28/08/2018,28/08/2018,0.00,,10.93,,"-833,846.73"
,CS,AR,32008365,1005,100,,Cash sale,,,,,,28/08/2018,28/08/2018,0.00,,3.64,,"-833,850.37"
,CS,AR,32008382,1005,100,,Cash sale,,,,,,28/08/2018,28/08/2018,0.00,,7.29,,"-833,857.66"
,CS,AR,32008419,1005,100,,Cash sale,,,,,,28/08/2018,28/08/2018,0.00,,11.19,,"-833,868.85"
,CS,AR,32008434,1005,100,,Cash sale,,,,,,28/08/2018,28/08/2018,0.00,,3.64,,"-833,872.49"
,CS,AR,32008491,1005,100,,Cash sale,,,,,,28/08/2018,28/08/2018,0.00,,18.22,,"-833,890.71"
,CS,AR,32008497,1005,100,,Cash sale,,,,,,28/08/2018,28/08/2018,0.00,,10.93,,"-833,901.64"
,CS,AR,32008508,1005,100,,Cash sale,,,,,,28/08/2018,28/08/2018,0.00,,20.34,,"-833,921.98"
,CS,AR,32008527,1005,100,,Cash sale,,,,,,28/08/2018,28/08/2018,0.00,,18.22,,"-833,940.20"
,CS,AR,32008541,1005,100,,Cash sale,,,,,,28/08/2018,28/08/2018,0.00,,5.08,,"-833,945.28"
,CS,AR,32008574,1005,100,,Cash sale,,,,,,28/08/2018,28/08/2018,0.00,,8.20,,"-833,953.48"
,CS,AR,32008608,1005,100,,Cash sale,,,,,,28/08/2018,28/08/2018,0.00,,11.86,,"-833,965.34"
,CS,AR,32008625,1005,100,,Cash sale,,,,,,28/08/2018,28/08/2018,0.00,,8.25,,"-833,973.59"
,CS,AR,32008649,1005,100,,Cash sale,,,,,,28/08/2018,28/08/2018,0.00,,7.29,,"-833,980.88"
,CS,AR,32008657,1005,100,,Cash sale,,,,,,28/08/2018,28/08/2018,0.00,,5.47,,"-833,986.35"
,CS,AR,32008714,1005,100,,Cash sale,,,,,,28/08/2018,28/08/2018,0.00,,3.64,,"-833,989.99"
,CS,AR,32008717,1005,100,,Cash sale,,,,,,28/08/2018,28/08/2018,0.00,,10.93,,"-834,000.92"
,CS,AR,32008729,1005,100,,Cash sale,,,,,,28/08/2018,28/08/2018,0.00,,10.93,,"-834,011.85"
,CS,AR,32008745,1005,100,,Cash sale,,,,,,28/08/2018,28/08/2018,0.00,,10.93,,"-834,022.78"
,CS,AR,32008859,1005,100,,Cash sale,,,,,,28/08/2018,28/08/2018,0.00,,7.29,,"-834,030.07"
,CS,AR,32008882,1005,100,,Cash sale,,,,,,28/08/2018,28/08/2018,0.00,,7.29,,"-834,037.36"
,IN,AR,30323565,1005,100,,Invoice,,,,,,28/08/2018,28/08/2018,0.00,,54.66,,"-834,092.02"
,IN,AR,30323569,1005,100,,Invoice,,,,,,28/08/2018,28/08/2018,0.00,,364.41,,"-834,456.43"
,IN,AR,30323573,1005,100,,Invoice,,,,,,28/08/2018,28/08/2018,0.00,,182.20,,"-834,638.63"
,IN,AR,30323586,1005,100,,Invoice,,,,,,28/08/2018,28/08/2018,0.00,,21.86,,"-834,660.49"
,IN,AR,30323604,1005,100,,Invoice,,,,,,28/08/2018,28/08/2018,0.00,,364.41,,"-835,024.90"
,IN,AR,30323685,1005,100,,Invoice,,,,,,28/08/2018,28/08/2018,0.00,,7.00,,"-835,031.90"
,IN,AR,30323688,1005,100,,Invoice,,,,,,28/08/2018,28/08/2018,0.00,,364.41,,"-835,396.31"
,IN,AR,30323729,1005,100,,Invoice,,,,,,28/08/2018,28/08/2018,0.00,,364.41,,"-835,760.72"
,IN,AR,30323730,1005,100,,Invoice,,,,,,28/08/2018,28/08/2018,0.00,,364.41,,"-836,125.13"
,IN,AR,30323736,1005,100,,Invoice,,,,,,28/08/2018,28/08/2018,0.00,,23.73,,"-836,148.86"
,IN,AR,30323764,1005,100,,Invoice,,,,,,28/08/2018,28/08/2018,0.00,,364.41,,"-836,513.27"
,IN,AR,30323784,1005,100,,Invoice,,,,,,28/08/2018,28/08/2018,0.00,,18.22,,"-836,531.49"
,IN,AR,30323788,1005,100,,Invoice,,,,,,28/08/2018,28/08/2018,0.00,,"1,093.22",,"-837,624.71"
,IN,AR,30323790,1005,100,,Invoice,,,,,,28/08/2018,28/08/2018,0.00,,54.66,,"-837,679.37"
,IN,AR,30323802,1005,100,,Invoice,,,,,,28/08/2018,28/08/2018,0.00,,14.58,,"-837,693.95"
,IN,AR,30323811,1005,100,,Invoice,,,,,,28/08/2018,28/08/2018,0.00,,54.66,,"-837,748.61"
,IN,AR,30323812,1005,100,,Invoice,,,,,,28/08/2018,28/08/2018,0.00,,54.66,,"-837,803.27"
,IN,AR,30323828,1005,100,,Invoice,,,,,,28/08/2018,28/08/2018,0.00,,54.66,,"-837,857.93"
,IN,AR,30323887,1005,100,,Invoice,,,,,,28/08/2018,28/08/2018,0.00,,7.29,,"-837,865.22"
,IN,AR,30323897,1005,100,,Invoice,,,,,,28/08/2018,28/08/2018,0.00,,364.41,,"-838,229.63"
,IN,AR,30323954,1005,100,,Invoice,,,,,,28/08/2018,28/08/2018,0.00,,10.99,,"-838,240.62"
,IN,AR,30323957,1005,100,,Invoice,,,,,,28/08/2018,28/08/2018,0.00,,10.93,,"-838,251.55"
,IN,AR,30323988,1005,100,,Invoice,,,,,,28/08/2018,28/08/2018,0.00,,182.20,,"-838,433.75"
,IN,AR,30324012,1005,100,,Invoice,,,,,,28/08/2018,28/08/2018,0.00,,10.93,,"-838,444.68"
,IN,AR,30324018,1005,100,,Invoice,,,,,,28/08/2018,28/08/2018,0.00,,14.58,,"-838,459.26"
,IN,AR,30324034,1005,100,,Invoice,,,,,,28/08/2018,28/08/2018,0.00,,9.29,,"-838,468.55"
,IN,AR,30324074,1005,100,,Invoice,,,,,,28/08/2018,28/08/2018,0.00,,728.81,,"-839,197.36"
,IN,AR,30324080,1005,100,,Invoice,,,,,,28/08/2018,28/08/2018,0.00,,8.47,,"-839,205.83"
,IN,AR,30324119,1005,100,,Invoice,,,,,,28/08/2018,28/08/2018,0.00,,4.24,,"-839,210.07"
,IN,AR,30324127,1005,100,,Invoice,,,,,,28/08/2018,28/08/2018,0.00,,6.36,,"-839,216.43"
,IN,AR,30324150,1005,100,,Invoice,,,,,,28/08/2018,28/08/2018,0.00,,31.02,,"-839,247.45"
,IN,AR,30324163,1005,100,,Invoice,,,,,,28/08/2018,28/08/2018,0.00,,5.17,,"-839,252.62"
,IN,AR,30324176,1005,100,,Invoice,,,,,,28/08/2018,28/08/2018,0.00,,28.68,,"-839,281.30"
,IN,AR,30324195,1005,100,,Invoice,,,,,,28/08/2018,28/08/2018,0.00,,15.04,,"-839,296.34"
,IN,AR,30324211,1005,100,,Invoice,,,,,,28/08/2018,28/08/2018,0.00,,5.85,,"-839,302.19"
,IN,AR,30324242,1005,100,,Invoice,,,,,,28/08/2018,28/08/2018,0.00,,12.58,,"-839,314.77"
,IN,AR,30324273,1005,100,,Invoice,,,,,,28/08/2018,28/08/2018,0.00,,14.58,,"-839,329.35"
,IN,AR,30324300,1005,100,,Invoice,,,,,,28/08/2018,28/08/2018,0.00,,2.14,,"-839,331.49"
,IN,AR,30324309,1005,100,,Invoice,,,,,,28/08/2018,28/08/2018,0.00,,10.34,,"-839,341.83"
,IN,AR,30324318,1005,100,,Invoice,,,,,,28/08/2018,28/08/2018,0.00,,30.64,,"-839,372.47"
,IN,AR,30324321,1005,100,,Invoice,,,,,,28/08/2018,28/08/2018,0.00,,45.13,,"-839,417.60"
,IN,AR,30324496,1005,100,,Invoice,,,,,,28/08/2018,28/08/2018,0.00,,7.29,,"-839,424.89"
,IN,AR,30324500,1005,100,,Invoice,,,,,,28/08/2018,28/08/2018,0.00,,5.85,,"-839,430.74"
,IN,AR,30324506,1005,100,,Invoice,,,,,,28/08/2018,28/08/2018,0.00,,8.39,,"-839,439.13"
,IN,AR,30324507,1005,100,,Invoice,,,,,,28/08/2018,28/08/2018,0.00,,2.80,,"-839,441.93"
,IN,AR,30324515,1005,100,,Invoice,,,,,,28/08/2018,28/08/2018,0.00,,23.14,,"-839,465.07"
,IN,AR,30324532,1005,100,,Invoice,,,,,,28/08/2018,28/08/2018,0.00,,14.63,,"-839,479.70"
,IN,AR,30324546,1005,100,,Invoice,,,,,,28/08/2018,28/08/2018,0.00,,4.08,,"-839,483.78"
,IN,AR,30324554,1005,100,,Invoice,,,,,,28/08/2018,28/08/2018,0.00,,13.22,,"-839,497.00"
,IN,AR,30324560,1005,100,,Invoice,,,,,,28/08/2018,28/08/2018,0.00,,2.39,,"-839,499.39"
,IN,AR,30324565,1005,100,,Invoice,,,,,,28/08/2018,28/08/2018,0.00,,12.71,,"-839,512.10"
,IN,AR,30324574,1005,100,,Invoice,,,,,,28/08/2018,28/08/2018,0.00,,1.95,,"-839,514.05"
,IN,AR,30324576,1005,100,,Invoice,,,,,,28/08/2018,28/08/2018,0.00,,10.53,,"-839,524.58"
,IN,AR,30324582,1005,100,,Invoice,,,,,,28/08/2018,28/08/2018,0.00,,10.93,,"-839,535.51"
,IN,AR,30324594,1005,100,,Invoice,,,,,,28/08/2018,28/08/2018,0.00,,14.83,,"-839,550.34"
,IN,AR,30324616,1005,100,,Invoice,,,,,,28/08/2018,28/08/2018,0.00,,6.36,,"-839,556.70"
,IN,AR,30324624,1005,100,,Invoice,,,,,,28/08/2018,28/08/2018,0.00,,12.71,,"-839,569.41"
,IN,AR,30324635,1005,100,,Invoice,,,,,,28/08/2018,28/08/2018,0.00,,5.08,,"-839,574.49"
,IN,AR,30324636,1005,100,,Invoice,,,,,,28/08/2018,28/08/2018,0.00,,7.29,,"-839,581.78"
,IN,AR,30324648,1005,100,,Invoice,,,,,,28/08/2018,28/08/2018,0.00,,29.15,,"-839,610.93"
,IN,AR,30324656,1005,100,,Invoice,,,,,,28/08/2018,28/08/2018,0.00,,182.20,,"-839,793.13"
,IN,AR,30324676,1005,100,,Invoice,,,,,,28/08/2018,28/08/2018,0.00,,12.71,,"-839,805.84"
,IN,AR,30324683,1005,100,,Invoice,,,,,,28/08/2018,28/08/2018,0.00,,59.32,,"-839,865.16"
,IN,AR,30324745,1005,100,,Invoice,,,,,,28/08/2018,28/08/2018,0.00,,6.36,,"-839,871.52"
,IN,AR,30324777,1005,100,,Invoice,,,,,,28/08/2018,28/08/2018,0.00,,26.31,,"-839,897.83"
,IN,AR,30324807,1005,100,,Invoice,,,,,,28/08/2018,28/08/2018,0.00,,8.26,,"-839,906.09"
,IN,AR,30324831,1005,100,,Invoice,,,,,,28/08/2018,28/08/2018,0.00,,5.68,,"-839,911.77"
,IN,AR,30324841,1005,100,,Invoice,,,,,,28/08/2018,28/08/2018,0.00,,29.15,,"-839,940.92"
,IN,AR,30324897,1005,100,,Invoice,,,,,,28/08/2018,28/08/2018,0.00,,364.41,,"-840,305.33"
,IN,AR,30324900,1005,100,,Invoice,,,,,,28/08/2018,28/08/2018,0.00,,7.29,,"-840,312.62"
,IN,AR,30324905,1005,100,,Invoice,,,,,,28/08/2018,28/08/2018,0.00,,17.15,,"-840,329.77"
,IN,AR,30324920,1005,100,,Invoice,,,,,,28/08/2018,28/08/2018,0.00,,23.58,,"-840,353.35"
,IN,AR,30324930,1005,100,,Invoice,,,,,,28/08/2018,28/08/2018,0.00,,10.93,,"-840,364.28"
,IN,AR,30324940,1005,100,,Invoice,,,,,,28/08/2018,28/08/2018,0.00,,5.29,,"-840,369.57"
,IN,AR,30324984,1005,100,,Invoice,,,,,,28/08/2018,28/08/2018,0.00,,120.76,,"-840,490.33"
,IN,AR,30324987,1005,100,,Invoice,,,,,,28/08/2018,28/08/2018,0.00,,16.42,,"-840,506.75"
,IN,AR,30325042,1005,100,,Invoice,,,,,,28/08/2018,28/08/2018,0.00,,5.17,,"-840,511.92"
,IN,AR,30325067,1005,100,,Invoice,,,,,,28/08/2018,28/08/2018,0.00,,29.15,,"-840,541.07"
,IN,AR,30325094,1005,100,,Invoice,,,,,,28/08/2018,28/08/2018,0.00,,3.18,,"-840,544.25"
,IN,AR,30325116,1005,100,,Invoice,,,,,,28/08/2018,28/08/2018,0.00,,39.75,,"-840,584.00"
,IN,AR,30325122,1005,100,,Invoice,,,,,,28/08/2018,28/08/2018,0.00,,28.00,,"-840,612.00"
,IN,AR,30325130,1005,100,,Invoice,,,,,,28/08/2018,28/08/2018,0.00,,52.00,,"-840,664.00"
,IN,AR,30325205,1005,100,,Invoice,,,,,,28/08/2018,28/08/2018,0.00,,211.72,,"-840,875.72"
,IN,AR,30325223,1005,100,,Invoice,,,,,,28/08/2018,28/08/2018,0.00,,39.41,,"-840,915.13"
,IN,AR,30325250,1005,100,,Invoice,,,,,,28/08/2018,28/08/2018,0.00,,182.20,,"-841,097.33"
,IN,AR,30325279,1005,100,,Invoice,,,,,,28/08/2018,28/08/2018,0.00,,7.29,,"-841,104.62"
,IN,AR,30325285,1005,100,,Invoice,,,,,,28/08/2018,28/08/2018,0.00,,20.34,,"-841,124.96"
,IN,AR,30325307,1005,100,,Invoice,,,,,,28/08/2018,28/08/2018,0.00,,32.01,,"-841,156.97"
,IN,AR,30325400,1005,100,,Invoice,,,,,,28/08/2018,28/08/2018,0.00,,14.58,,"-841,171.55"
,IN,AR,30325428,1005,100,,Invoice,,,,,,28/08/2018,28/08/2018,0.00,,273.31,,"-841,444.86"
,IN,AR,30325429,1005,100,,Invoice,,,,,,28/08/2018,28/08/2018,0.00,,5.47,,"-841,450.33"
,IN,AR,30325461,1005,100,,Invoice,,,,,,28/08/2018,28/08/2018,0.00,,6.42,,"-841,456.75"
,IN,AR,30325474,1005,100,,Invoice,,,,,,28/08/2018,28/08/2018,0.00,,9.10,,"-841,465.85"
,IN,AR,30325489,1005,100,,Invoice,,,,,,28/08/2018,28/08/2018,0.00,,49.83,,"-841,515.68"
,IN,AR,30325577,1005,100,,Invoice,,,,,,28/08/2018,28/08/2018,0.00,,92.20,,"-841,607.88"
,IN,AR,30325620,1005,100,,Invoice,,,,,,28/08/2018,28/08/2018,0.00,,30.85,,"-841,638.73"
,IN,AR,30325621,1005,100,,Invoice,,,,,,28/08/2018,28/08/2018,0.00,,154.25,,"-841,792.98"
,IN,AR,30325635,1005,100,,Invoice,,,,,,28/08/2018,28/08/2018,0.00,,22.37,,"-841,815.35"
,IN,AR,30325672,1005,100,,Invoice,,,,,,28/08/2018,28/08/2018,0.00,,7.29,,"-841,822.64"
,IN,AR,30325694,1005,100,,Invoice,,,,,,28/08/2018,28/08/2018,0.00,,1.75,,"-841,824.39"
,IN,AR,30325697,1005,100,,Invoice,,,,,,28/08/2018,28/08/2018,0.00,,2.75,,"-841,827.14"
,IN,AR,30325700,1005,100,,Invoice,,,,,,28/08/2018,28/08/2018,0.00,,12.00,,"-841,839.14"
,IN,AR,30325704,1005,100,,Invoice,,,,,,28/08/2018,28/08/2018,0.00,,5.93,,"-841,845.07"
,IN,AR,30325715,1005,100,,Invoice,,,,,,28/08/2018,28/08/2018,0.00,,121.02,,"-841,966.09"
,IN,AR,30325720,1005,100,,Invoice,,,,,,28/08/2018,28/08/2018,0.00,,10.93,,"-841,977.02"
,IN,AR,30325734,1005,100,,Invoice,,,,,,28/08/2018,28/08/2018,0.00,,5.26,,"-841,982.28"
,IN,AR,30325760,1005,100,,Invoice,,,,,,28/08/2018,28/08/2018,0.00,,8.21,,"-841,990.49"
,IN,AR,30325851,1005,100,,Invoice,,,,,,28/08/2018,28/08/2018,0.00,,16.78,,"-842,007.27"
,IN,AR,30325857,1005,100,,Invoice,,,,,,28/08/2018,28/08/2018,0.00,,11.95,,"-842,019.22"
,IN,AR,30325882,1005,100,,Invoice,,,,,,28/08/2018,28/08/2018,0.00,,15.18,,"-842,034.40"
,IN,AR,30325912,1005,100,,Invoice,,,,,,28/08/2018,28/08/2018,0.00,,172.33,,"-842,206.73"
,IN,AR,30325913,1005,100,,Invoice,,,,,,28/08/2018,28/08/2018,0.00,,6.23,,"-842,212.96"
,IN,AR,30325960,1005,100,,Invoice,,,,,,28/08/2018,28/08/2018,0.00,,15.25,,"-842,228.21"
,IN,AR,30325969,1005,100,,Invoice,,,,,,28/08/2018,28/08/2018,0.00,,19.32,,"-842,247.53"
,IN,AR,30326028,1005,100,,Invoice,,,,,,28/08/2018,28/08/2018,0.00,,10.17,,"-842,257.70"
,IN,AR,30326030,1005,100,,Invoice,,,,,,28/08/2018,28/08/2018,0.00,,11.86,,"-842,269.56"
,IN,AR,30326079,1005,100,,Invoice,,,,,,28/08/2018,28/08/2018,0.00,,7.29,,"-842,276.85"
,IN,AR,30326096,1005,100,,Invoice,,,,,,28/08/2018,28/08/2018,0.00,,29.15,,"-842,306.00"
,IN,AR,30326101,1005,100,,Invoice,,,,,,28/08/2018,28/08/2018,0.00,,21.24,,"-842,327.24"
,IN,AR,30326167,1005,100,,Invoice,,,,,,28/08/2018,28/08/2018,0.00,,7.29,,"-842,334.53"
,IN,AR,30326168,1005,100,,Invoice,,,,,,28/08/2018,28/08/2018,0.00,,29.15,,"-842,363.68"
,IN,AR,30326212,1005,100,,Invoice,,,,,,28/08/2018,28/08/2018,0.00,,29.15,,"-842,392.83"
,IN,AR,30326214,1005,100,,Invoice,,,,,,28/08/2018,28/08/2018,0.00,,273.31,,"-842,666.14"
,IN,AR,30326215,1005,100,,Invoice,,,,,,28/08/2018,28/08/2018,0.00,,29.15,,"-842,695.29"
,CN,AR,31018674,1005,100,,Credit Note,,,,,,29/08/2018,29/08/2018,138.47,,0.00,,"-842,556.82"
,CN,AR,31018687,1005,100,,Credit Note,,,,,,29/08/2018,29/08/2018,364.41,,0.00,,"-842,192.41"
,CN,AR,31018697,1005,100,,Credit Note,,,,,,29/08/2018,29/08/2018,29.67,,0.00,,"-842,162.74"
,CN,AR,31018699,1005,100,,Credit Note,,,,,,29/08/2018,29/08/2018,4.24,,0.00,,"-842,158.50"
,CN,AR,31018701,1005,100,,Credit Note,,,,,,29/08/2018,29/08/2018,10.60,,0.00,,"-842,147.90"
,CN,AR,31018703,1005,100,,Credit Note,,,,,,29/08/2018,29/08/2018,8.48,,0.00,,"-842,139.42"
,CN,AR,31018708,1005,100,,Credit Note,,,,,,29/08/2018,29/08/2018,8.48,,0.00,,"-842,130.94"
,CN,AR,31018711,1005,100,,Credit Note,,,,,,29/08/2018,29/08/2018,10.60,,0.00,,"-842,120.34"
,CN,AR,31018715,1005,100,,Credit Note,,,,,,29/08/2018,29/08/2018,8.48,,0.00,,"-842,111.86"
,CN,AR,31018718,1005,100,,Credit Note,,,,,,29/08/2018,29/08/2018,36.02,,0.00,,"-842,075.84"
,CN,AR,31018720,1005,100,,Credit Note,,,,,,29/08/2018,29/08/2018,59.33,,0.00,,"-842,016.51"
,CN,AR,31018731,1005,100,,Credit Note,,,,,,29/08/2018,29/08/2018,16.95,,0.00,,"-841,999.56"
,CN,AR,31018735,1005,100,,Credit Note,,,,,,29/08/2018,29/08/2018,10.60,,0.00,,"-841,988.96"
,CN,AR,31018737,1005,100,,Credit Note,,,,,,29/08/2018,29/08/2018,4.24,,0.00,,"-841,984.72"
,CN,AR,31018745,1005,100,,Credit Note,,,,,,29/08/2018,29/08/2018,14.83,,0.00,,"-841,969.89"
,CN,AR,31018750,1005,100,,Credit Note,,,,,,29/08/2018,29/08/2018,6.36,,0.00,,"-841,963.53"
,CN,AR,31018754,1005,100,,Credit Note,,,,,,29/08/2018,29/08/2018,25.43,,0.00,,"-841,938.10"
,CN,AR,31018756,1005,100,,Credit Note,,,,,,29/08/2018,29/08/2018,27.55,,0.00,,"-841,910.55"
,CN,AR,31018758,1005,100,,Credit Note,,,,,,29/08/2018,29/08/2018,21.19,,0.00,,"-841,889.36"
,CN,AR,31018760,1005,100,,Credit Note,,,,,,29/08/2018,29/08/2018,23.31,,0.00,,"-841,866.05"
,CN,AR,31018762,1005,100,,Credit Note,,,,,,29/08/2018,29/08/2018,21.19,,0.00,,"-841,844.86"
,CN,AR,31018772,1005,100,,Credit Note,,,,,,29/08/2018,29/08/2018,10.93,,0.00,,"-841,833.93"
,CN,AR,31018774,1005,100,,Credit Note,,,,,,29/08/2018,29/08/2018,61.45,,0.00,,"-841,772.48"
,CN,AR,31018776,1005,100,,Credit Note,,,,,,29/08/2018,29/08/2018,12.71,,0.00,,"-841,759.77"
,CN,AR,31018778,1005,100,,Credit Note,,,,,,29/08/2018,29/08/2018,16.95,,0.00,,"-841,742.82"
,CN,AR,31018781,1005,100,,Credit Note,,,,,,29/08/2018,29/08/2018,29.67,,0.00,,"-841,713.15"
,CN,AR,31018784,1005,100,,Credit Note,,,,,,29/08/2018,29/08/2018,12.71,,0.00,,"-841,700.44"
,CN,AR,31018785,1005,100,,Credit Note,,,,,,29/08/2018,29/08/2018,27.55,,0.00,,"-841,672.89"
,CN,AR,31018787,1005,100,,Credit Note,,,,,,29/08/2018,29/08/2018,14.83,,0.00,,"-841,658.06"
,CN,AR,31018793,1005,100,,Credit Note,,,,,,29/08/2018,29/08/2018,21.19,,0.00,,"-841,636.87"
,CN,AR,31018795,1005,100,,Credit Note,,,,,,29/08/2018,29/08/2018,21.19,,0.00,,"-841,615.68"
,CN,AR,31018797,1005,100,,Credit Note,,,,,,29/08/2018,29/08/2018,36.02,,0.00,,"-841,579.66"
,CN,AR,31018801,1005,100,,Credit Note,,,,,,29/08/2018,29/08/2018,10.60,,0.00,,"-841,569.06"
,CN,AR,31018803,1005,100,,Credit Note,,,,,,29/08/2018,29/08/2018,10.60,,0.00,,"-841,558.46"
,CN,AR,31018805,1005,100,,Credit Note,,,,,,29/08/2018,29/08/2018,36.02,,0.00,,"-841,522.44"
,CN,AR,31018810,1005,100,,Credit Note,,,,,,29/08/2018,29/08/2018,67.81,,0.00,,"-841,454.63"
,CN,AR,31018813,1005,100,,Credit Note,,,,,,29/08/2018,29/08/2018,31.79,,0.00,,"-841,422.84"
,CN,AR,31018865,1005,100,,Credit Note,,,,,,29/08/2018,29/08/2018,1.59,,0.00,,"-841,421.25"
,CS,AR,32007889,1005,100,,Cash sale,,,,,,29/08/2018,29/08/2018,0.00,,8.42,,"-841,429.67"
,CS,AR,32007897,1005,100,,Cash sale,,,,,,29/08/2018,29/08/2018,0.00,,7.29,,"-841,436.96"
,CS,AR,32007900,1005,100,,Cash sale,,,,,,29/08/2018,29/08/2018,0.00,,40.14,,"-841,477.10"
,CS,AR,32007922,1005,100,,Cash sale,,,,,,29/08/2018,29/08/2018,0.00,,7.29,,"-841,484.39"
,CS,AR,32007947,1005,100,,Cash sale,,,,,,29/08/2018,29/08/2018,0.00,,3.64,,"-841,488.03"
,CS,AR,32007950,1005,100,,Cash sale,,,,,,29/08/2018,29/08/2018,0.00,,7.29,,"-841,495.32"
,CS,AR,32007960,1005,100,,Cash sale,,,,,,29/08/2018,29/08/2018,0.00,,3.64,,"-841,498.96"
,CS,AR,32007996,1005,100,,Cash sale,,,,,,29/08/2018,29/08/2018,0.00,,7.29,,"-841,506.25"
,CS,AR,32007999,1005,100,,Cash sale,,,,,,29/08/2018,29/08/2018,0.00,,10.93,,"-841,517.18"
,CS,AR,32008005,1005,100,,Cash sale,,,,,,29/08/2018,29/08/2018,0.00,,3.64,,"-841,520.82"
,CS,AR,32008035,1005,100,,Cash sale,,,,,,29/08/2018,29/08/2018,0.00,,6.02,,"-841,526.84"
,CS,AR,32008091,1005,100,,Cash sale,,,,,,29/08/2018,29/08/2018,0.00,,5.86,,"-841,532.70"
,CS,AR,32008110,1005,100,,Cash sale,,,,,,29/08/2018,29/08/2018,0.00,,12.92,,"-841,545.62"
,CS,AR,32008121,1005,100,,Cash sale,,,,,,29/08/2018,29/08/2018,0.00,,12.03,,"-841,557.65"
,CS,AR,32008122,1005,100,,Cash sale,,,,,,29/08/2018,29/08/2018,0.00,,3.64,,"-841,561.29"
,CS,AR,32008180,1005,100,,Cash sale,,,,,,29/08/2018,29/08/2018,0.00,,7.29,,"-841,568.58"
,CS,AR,32008193,1005,100,,Cash sale,,,,,,29/08/2018,29/08/2018,0.00,,27.08,,"-841,595.66"
,CS,AR,32008197,1005,100,,Cash sale,,,,,,29/08/2018,29/08/2018,0.00,,10.72,,"-841,606.38"
,CS,AR,32008221,1005,100,,Cash sale,,,,,,29/08/2018,29/08/2018,0.00,,18.22,,"-841,624.60"
,CS,AR,32008232,1005,100,,Cash sale,,,,,,29/08/2018,29/08/2018,0.00,,7.63,,"-841,632.23"
,CS,AR,32008297,1005,100,,Cash sale,,,,,,29/08/2018,29/08/2018,0.00,,14.58,,"-841,646.81"
,CS,AR,32008340,1005,100,,Cash sale,,,,,,29/08/2018,29/08/2018,0.00,,14.58,,"-841,661.39"
,CS,AR,32008355,1005,100,,Cash sale,,,,,,29/08/2018,29/08/2018,0.00,,10.93,,"-841,672.32"
,CS,AR,32008379,1005,100,,Cash sale,,,,,,29/08/2018,29/08/2018,0.00,,10.93,,"-841,683.25"
,CS,AR,32008418,1005,100,,Cash sale,,,,,,29/08/2018,29/08/2018,0.00,,7.29,,"-841,690.54"
,CS,AR,32008428,1005,100,,Cash sale,,,,,,29/08/2018,29/08/2018,0.00,,18.22,,"-841,708.76"
,CS,AR,32008482,1005,100,,Cash sale,,,,,,29/08/2018,29/08/2018,0.00,,18.98,,"-841,727.74"
,CS,AR,32008485,1005,100,,Cash sale,,,,,,29/08/2018,29/08/2018,0.00,,2.97,,"-841,730.71"
,CS,AR,32008499,1005,100,,Cash sale,,,,,,29/08/2018,29/08/2018,0.00,,7.29,,"-841,738.00"
,CS,AR,32008517,1005,100,,Cash sale,,,,,,29/08/2018,29/08/2018,0.00,,6.53,,"-841,744.53"
,CS,AR,32008535,1005,100,,Cash sale,,,,,,29/08/2018,29/08/2018,0.00,,10.93,,"-841,755.46"
,CS,AR,32008550,1005,100,,Cash sale,,,,,,29/08/2018,29/08/2018,0.00,,3.64,,"-841,759.10"
,CS,AR,32008557,1005,100,,Cash sale,,,,,,29/08/2018,29/08/2018,0.00,,6.02,,"-841,765.12"
,CS,AR,32008570,1005,100,,Cash sale,,,,,,29/08/2018,29/08/2018,0.00,,27.97,,"-841,793.09"
,CS,AR,32008586,1005,100,,Cash sale,,,,,,29/08/2018,29/08/2018,0.00,,11.44,,"-841,804.53"
,CS,AR,32008599,1005,100,,Cash sale,,,,,,29/08/2018,29/08/2018,0.00,,5.93,,"-841,810.46"
,CS,AR,32008602,1005,100,,Cash sale,,,,,,29/08/2018,29/08/2018,0.00,,14.58,,"-841,825.04"
,CS,AR,32008627,1005,100,,Cash sale,,,,,,29/08/2018,29/08/2018,0.00,,14.58,,"-841,839.62"
,CS,AR,32008635,1005,100,,Cash sale,,,,,,29/08/2018,29/08/2018,0.00,,18.05,,"-841,857.67"
,CS,AR,32008637,1005,100,,Cash sale,,,,,,29/08/2018,29/08/2018,0.00,,29.15,,"-841,886.82"
,CS,AR,32008736,1005,100,,Cash sale,,,,,,29/08/2018,29/08/2018,0.00,,18.22,,"-841,905.04"
,CS,AR,32008747,1005,100,,Cash sale,,,,,,29/08/2018,29/08/2018,0.00,,10.99,,"-841,916.03"
,CS,AR,32008751,1005,100,,Cash sale,,,,,,29/08/2018,29/08/2018,0.00,,7.29,,"-841,923.32"
,CS,AR,32008865,1005,100,,Cash sale,,,,,,29/08/2018,29/08/2018,0.00,,10.93,,"-841,934.25"
,IN,AR,30323538,1005,100,,Invoice,,,,,,29/08/2018,29/08/2018,0.00,,182.20,,"-842,116.45"
,IN,AR,30323539,1005,100,,Invoice,,,,,,29/08/2018,29/08/2018,0.00,,182.20,,"-842,298.65"
,IN,AR,30323544,1005,100,,Invoice,,,,,,29/08/2018,29/08/2018,0.00,,41.53,,"-842,340.18"
,IN,AR,30323575,1005,100,,Invoice,,,,,,29/08/2018,29/08/2018,0.00,,364.41,,"-842,704.59"
,IN,AR,30323583,1005,100,,Invoice,,,,,,29/08/2018,29/08/2018,0.00,,182.20,,"-842,886.79"
,IN,AR,30323598,1005,100,,Invoice,,,,,,29/08/2018,29/08/2018,0.00,,24.41,,"-842,911.20"
,IN,AR,30323599,1005,100,,Invoice,,,,,,29/08/2018,29/08/2018,0.00,,58.58,,"-842,969.78"
,IN,AR,30323613,1005,100,,Invoice,,,,,,29/08/2018,29/08/2018,0.00,,6.08,,"-842,975.86"
,IN,AR,30323641,1005,100,,Invoice,,,,,,29/08/2018,29/08/2018,0.00,,5.68,,"-842,981.54"
,IN,AR,30323657,1005,100,,Invoice,,,,,,29/08/2018,29/08/2018,0.00,,84.07,,"-843,065.61"
,IN,AR,30323658,1005,100,,Invoice,,,,,,29/08/2018,29/08/2018,0.00,,28.90,,"-843,094.51"
,IN,AR,30323664,1005,100,,Invoice,,,,,,29/08/2018,29/08/2018,0.00,,364.41,,"-843,458.92"
,IN,AR,30323667,1005,100,,Invoice,,,,,,29/08/2018,29/08/2018,0.00,,18.22,,"-843,477.14"
,IN,AR,30323672,1005,100,,Invoice,,,,,,29/08/2018,29/08/2018,0.00,,19.32,,"-843,496.46"
,IN,AR,30323677,1005,100,,Invoice,,,,,,29/08/2018,29/08/2018,0.00,,54.66,,"-843,551.12"
,IN,AR,30323689,1005,100,,Invoice,,,,,,29/08/2018,29/08/2018,0.00,,182.20,,"-843,733.32"
,IN,AR,30323700,1005,100,,Invoice,,,,,,29/08/2018,29/08/2018,0.00,,182.20,,"-843,915.52"
,IN,AR,30323722,1005,100,,Invoice,,,,,,29/08/2018,29/08/2018,0.00,,7.97,,"-843,923.49"
,IN,AR,30323737,1005,100,,Invoice,,,,,,29/08/2018,29/08/2018,0.00,,71.19,,"-843,994.68"
,IN,AR,30323763,1005,100,,Invoice,,,,,,29/08/2018,29/08/2018,0.00,,364.41,,"-844,359.09"
,IN,AR,30323765,1005,100,,Invoice,,,,,,29/08/2018,29/08/2018,0.00,,364.41,,"-844,723.50"
,IN,AR,30323767,1005,100,,Invoice,,,,,,29/08/2018,29/08/2018,0.00,,182.20,,"-844,905.70"
,IN,AR,30323781,1005,100,,Invoice,,,,,,29/08/2018,29/08/2018,0.00,,364.41,,"-845,270.11"
,IN,AR,30323798,1005,100,,Invoice,,,,,,29/08/2018,29/08/2018,0.00,,54.66,,"-845,324.77"
,IN,AR,30323807,1005,100,,Invoice,,,,,,29/08/2018,29/08/2018,0.00,,182.20,,"-845,506.97"
,IN,AR,30323808,1005,100,,Invoice,,,,,,29/08/2018,29/08/2018,0.00,,32.80,,"-845,539.77"
,IN,AR,30323817,1005,100,,Invoice,,,,,,29/08/2018,29/08/2018,0.00,,32.00,,"-845,571.77"
,IN,AR,30323843,1005,100,,Invoice,,,,,,29/08/2018,29/08/2018,0.00,,54.66,,"-845,626.43"
,IN,AR,30323856,1005,100,,Invoice,,,,,,29/08/2018,29/08/2018,0.00,,18.00,,"-845,644.43"
,IN,AR,30323861,1005,100,,Invoice,,,,,,29/08/2018,29/08/2018,0.00,,29.15,,"-845,673.58"
,IN,AR,30323889,1005,100,,Invoice,,,,,,29/08/2018,29/08/2018,0.00,,54.66,,"-845,728.24"
,IN,AR,30323891,1005,100,,Invoice,,,,,,29/08/2018,29/08/2018,0.00,,60.53,,"-845,788.77"
,IN,AR,30323909,1005,100,,Invoice,,,,,,29/08/2018,29/08/2018,0.00,,229.22,,"-846,017.99"
,IN,AR,30323916,1005,100,,Invoice,,,,,,29/08/2018,29/08/2018,0.00,,780.96,,"-846,798.95"
,IN,AR,30323959,1005,100,,Invoice,,,,,,29/08/2018,29/08/2018,0.00,,9.03,,"-846,807.98"
,IN,AR,30323967,1005,100,,Invoice,,,,,,29/08/2018,29/08/2018,0.00,,131.18,,"-846,939.16"
,IN,AR,30323977,1005,100,,Invoice,,,,,,29/08/2018,29/08/2018,0.00,,54.66,,"-846,993.82"
,IN,AR,30323982,1005,100,,Invoice,,,,,,29/08/2018,29/08/2018,0.00,,182.20,,"-847,176.02"
,IN,AR,30323992,1005,100,,Invoice,,,,,,29/08/2018,29/08/2018,0.00,,10.93,,"-847,186.95"
,IN,AR,30324019,1005,100,,Invoice,,,,,,29/08/2018,29/08/2018,0.00,,182.20,,"-847,369.15"
,IN,AR,30324029,1005,100,,Invoice,,,,,,29/08/2018,29/08/2018,0.00,,29.15,,"-847,398.30"
,IN,AR,30324032,1005,100,,Invoice,,,,,,29/08/2018,29/08/2018,0.00,,29.15,,"-847,427.45"
,IN,AR,30324060,1005,100,,Invoice,,,,,,29/08/2018,29/08/2018,0.00,,182.20,,"-847,609.65"
,IN,AR,30324063,1005,100,,Invoice,,,,,,29/08/2018,29/08/2018,0.00,,40.68,,"-847,650.33"
,IN,AR,30324086,1005,100,,Invoice,,,,,,29/08/2018,29/08/2018,0.00,,4.24,,"-847,654.57"
,IN,AR,30324091,1005,100,,Invoice,,,,,,29/08/2018,29/08/2018,0.00,,2.12,,"-847,656.69"
,IN,AR,30324112,1005,100,,Invoice,,,,,,29/08/2018,29/08/2018,0.00,,18.05,,"-847,674.74"
,IN,AR,30324115,1005,100,,Invoice,,,,,,29/08/2018,29/08/2018,0.00,,4.24,,"-847,678.98"
,IN,AR,30324133,1005,100,,Invoice,,,,,,29/08/2018,29/08/2018,0.00,,8.39,,"-847,687.37"
,IN,AR,30324146,1005,100,,Invoice,,,,,,29/08/2018,29/08/2018,0.00,,182.20,,"-847,869.57"
,IN,AR,30324148,1005,100,,Invoice,,,,,,29/08/2018,29/08/2018,0.00,,91.10,,"-847,960.67"
,IN,AR,30324183,1005,100,,Invoice,,,,,,29/08/2018,29/08/2018,0.00,,44.37,,"-848,005.04"
,IN,AR,30324185,1005,100,,Invoice,,,,,,29/08/2018,29/08/2018,0.00,,10.93,,"-848,015.97"
,IN,AR,30324189,1005,100,,Invoice,,,,,,29/08/2018,29/08/2018,0.00,,29.15,,"-848,045.12"
,IN,AR,30324192,1005,100,,Invoice,,,,,,29/08/2018,29/08/2018,0.00,,54.66,,"-848,099.78"
,IN,AR,30324193,1005,100,,Invoice,,,,,,29/08/2018,29/08/2018,0.00,,7.75,,"-848,107.53"
,IN,AR,30324200,1005,100,,Invoice,,,,,,29/08/2018,29/08/2018,0.00,,4.78,,"-848,112.31"
,IN,AR,30324203,1005,100,,Invoice,,,,,,29/08/2018,29/08/2018,0.00,,364.41,,"-848,476.72"
,IN,AR,30324206,1005,100,,Invoice,,,,,,29/08/2018,29/08/2018,0.00,,408.14,,"-848,884.86"
,IN,AR,30324210,1005,100,,Invoice,,,,,,29/08/2018,29/08/2018,0.00,,54.66,,"-848,939.52"
,IN,AR,30324221,1005,100,,Invoice,,,,,,29/08/2018,29/08/2018,0.00,,67.68,,"-849,007.20"
,IN,AR,30324301,1005,100,,Invoice,,,,,,29/08/2018,29/08/2018,0.00,,364.41,,"-849,371.61"
,IN,AR,30324334,1005,100,,Invoice,,,,,,29/08/2018,29/08/2018,0.00,,114.03,,"-849,485.64"
,IN,AR,30324362,1005,100,,Invoice,,,,,,29/08/2018,29/08/2018,0.00,,29.15,,"-849,514.79"
,IN,AR,30324384,1005,100,,Invoice,,,,,,29/08/2018,29/08/2018,0.00,,5.08,,"-849,519.87"
,IN,AR,30324412,1005,100,,Invoice,,,,,,29/08/2018,29/08/2018,0.00,,18.39,,"-849,538.26"
,IN,AR,30324421,1005,100,,Invoice,,,,,,29/08/2018,29/08/2018,0.00,,8.47,,"-849,546.73"
,IN,AR,30324425,1005,100,,Invoice,,,,,,29/08/2018,29/08/2018,0.00,,17.80,,"-849,564.53"
,IN,AR,30324512,1005,100,,Invoice,,,,,,29/08/2018,29/08/2018,0.00,,27.25,,"-849,591.78"
,IN,AR,30324518,1005,100,,Invoice,,,,,,29/08/2018,29/08/2018,0.00,,54.66,,"-849,646.44"
,IN,AR,30324533,1005,100,,Invoice,,,,,,29/08/2018,29/08/2018,0.00,,29.15,,"-849,675.59"
,IN,AR,30324549,1005,100,,Invoice,,,,,,29/08/2018,29/08/2018,0.00,,54.66,,"-849,730.25"
,IN,AR,30324566,1005,100,,Invoice,,,,,,29/08/2018,29/08/2018,0.00,,5.08,,"-849,735.33"
,IN,AR,30324583,1005,100,,Invoice,,,,,,29/08/2018,29/08/2018,0.00,,7.29,,"-849,742.62"
,IN,AR,30324599,1005,100,,Invoice,,,,,,29/08/2018,29/08/2018,0.00,,12.71,,"-849,755.33"
,IN,AR,30324607,1005,100,,Invoice,,,,,,29/08/2018,29/08/2018,0.00,,29.67,,"-849,785.00"
,IN,AR,30324613,1005,100,,Invoice,,,,,,29/08/2018,29/08/2018,0.00,,18.22,,"-849,803.22"
,IN,AR,30324628,1005,100,,Invoice,,,,,,29/08/2018,29/08/2018,0.00,,7.29,,"-849,810.51"
,IN,AR,30324641,1005,100,,Invoice,,,,,,29/08/2018,29/08/2018,0.00,,54.66,,"-849,865.17"
,IN,AR,30324661,1005,100,,Invoice,,,,,,29/08/2018,29/08/2018,0.00,,25.25,,"-849,890.42"
,IN,AR,30324669,1005,100,,Invoice,,,,,,29/08/2018,29/08/2018,0.00,,7.29,,"-849,897.71"
,IN,AR,30324684,1005,100,,Invoice,,,,,,29/08/2018,29/08/2018,0.00,,23.73,,"-849,921.44"
,IN,AR,30324698,1005,100,,Invoice,,,,,,29/08/2018,29/08/2018,0.00,,5.59,,"-849,927.03"
,IN,AR,30324711,1005,100,,Invoice,,,,,,29/08/2018,29/08/2018,0.00,,182.20,,"-850,109.23"
,IN,AR,30324715,1005,100,,Invoice,,,,,,29/08/2018,29/08/2018,0.00,,54.66,,"-850,163.89"
,IN,AR,30324724,1005,100,,Invoice,,,,,,29/08/2018,29/08/2018,0.00,,21.86,,"-850,185.75"
,IN,AR,30324751,1005,100,,Invoice,,,,,,29/08/2018,29/08/2018,0.00,,33.56,,"-850,219.31"
,IN,AR,30324755,1005,100,,Invoice,,,,,,29/08/2018,29/08/2018,0.00,,29.15,,"-850,248.46"
,IN,AR,30324768,1005,100,,Invoice,,,,,,29/08/2018,29/08/2018,0.00,,182.20,,"-850,430.66"
,IN,AR,30324789,1005,100,,Invoice,,,,,,29/08/2018,29/08/2018,0.00,,182.20,,"-850,612.86"
,IN,AR,30324814,1005,100,,Invoice,,,,,,29/08/2018,29/08/2018,0.00,,54.66,,"-850,667.52"
,IN,AR,30324829,1005,100,,Invoice,,,,,,29/08/2018,29/08/2018,0.00,,29.15,,"-850,696.67"
,IN,AR,30324835,1005,100,,Invoice,,,,,,29/08/2018,29/08/2018,0.00,,29.15,,"-850,725.82"
,IN,AR,30324845,1005,100,,Invoice,,,,,,29/08/2018,29/08/2018,0.00,,7.75,,"-850,733.57"
,IN,AR,30324847,1005,100,,Invoice,,,,,,29/08/2018,29/08/2018,0.00,,364.41,,"-851,097.98"
,IN,AR,30324850,1005,100,,Invoice,,,,,,29/08/2018,29/08/2018,0.00,,3.64,,"-851,101.62"
,IN,AR,30324861,1005,100,,Invoice,,,,,,29/08/2018,29/08/2018,0.00,,54.66,,"-851,156.28"
,IN,AR,30324872,1005,100,,Invoice,,,,,,29/08/2018,29/08/2018,0.00,,54.66,,"-851,210.94"
,IN,AR,30324875,1005,100,,Invoice,,,,,,29/08/2018,29/08/2018,0.00,,364.41,,"-851,575.35"
,IN,AR,30324877,1005,100,,Invoice,,,,,,29/08/2018,29/08/2018,0.00,,54.66,,"-851,630.01"
,IN,AR,30324879,1005,100,,Invoice,,,,,,29/08/2018,29/08/2018,0.00,,364.41,,"-851,994.42"
,IN,AR,30324924,1005,100,,Invoice,,,,,,29/08/2018,29/08/2018,0.00,,364.41,,"-852,358.83"
,IN,AR,30324925,1005,100,,Invoice,,,,,,29/08/2018,29/08/2018,0.00,,29.15,,"-852,387.98"
,IN,AR,30324929,1005,100,,Invoice,,,,,,29/08/2018,29/08/2018,0.00,,29.15,,"-852,417.13"
,IN,AR,30324931,1005,100,,Invoice,,,,,,29/08/2018,29/08/2018,0.00,,54.66,,"-852,471.79"
,IN,AR,30324932,1005,100,,Invoice,,,,,,29/08/2018,29/08/2018,0.00,,29.15,,"-852,500.94"
,IN,AR,30324941,1005,100,,Invoice,,,,,,29/08/2018,29/08/2018,0.00,,1.76,,"-852,502.70"
,IN,AR,30324942,1005,100,,Invoice,,,,,,29/08/2018,29/08/2018,0.00,,17.62,,"-852,520.32"
,IN,AR,30324956,1005,100,,Invoice,,,,,,29/08/2018,29/08/2018,0.00,,18.05,,"-852,538.37"
,IN,AR,30324982,1005,100,,Invoice,,,,,,29/08/2018,29/08/2018,0.00,,182.20,,"-852,720.57"
,IN,AR,30324983,1005,100,,Invoice,,,,,,29/08/2018,29/08/2018,0.00,,29.15,,"-852,749.72"
,IN,AR,30324991,1005,100,,Invoice,,,,,,29/08/2018,29/08/2018,0.00,,29.15,,"-852,778.87"
,IN,AR,30324992,1005,100,,Invoice,,,,,,29/08/2018,29/08/2018,0.00,,29.15,,"-852,808.02"
,IN,AR,30324993,1005,100,,Invoice,,,,,,29/08/2018,29/08/2018,0.00,,364.41,,"-853,172.43"
,IN,AR,30324995,1005,100,,Invoice,,,,,,29/08/2018,29/08/2018,0.00,,20.68,,"-853,193.11"
,IN,AR,30325012,1005,100,,Invoice,,,,,,29/08/2018,29/08/2018,0.00,,54.66,,"-853,247.77"
,IN,AR,30325017,1005,100,,Invoice,,,,,,29/08/2018,29/08/2018,0.00,,28.01,,"-853,275.78"
,IN,AR,30325020,1005,100,,Invoice,,,,,,29/08/2018,29/08/2018,0.00,,54.66,,"-853,330.44"
,IN,AR,30325023,1005,100,,Invoice,,,,,,29/08/2018,29/08/2018,0.00,,65.59,,"-853,396.03"
,IN,AR,30325024,1005,100,,Invoice,,,,,,29/08/2018,29/08/2018,0.00,,32.80,,"-853,428.83"
,IN,AR,30325035,1005,100,,Invoice,,,,,,29/08/2018,29/08/2018,0.00,,546.61,,"-853,975.44"
,IN,AR,30325039,1005,100,,Invoice,,,,,,29/08/2018,29/08/2018,0.00,,54.66,,"-854,030.10"
,IN,AR,30325046,1005,100,,Invoice,,,,,,29/08/2018,29/08/2018,0.00,,364.41,,"-854,394.51"
,IN,AR,30325073,1005,100,,Invoice,,,,,,29/08/2018,29/08/2018,0.00,,10.93,,"-854,405.44"
,IN,AR,30325096,1005,100,,Invoice,,,,,,29/08/2018,29/08/2018,0.00,,7.95,,"-854,413.39"
,IN,AR,30325111,1005,100,,Invoice,,,,,,29/08/2018,29/08/2018,0.00,,4.01,,"-854,417.40"
,IN,AR,30325126,1005,100,,Invoice,,,,,,29/08/2018,29/08/2018,0.00,,32.00,,"-854,449.40"
,IN,AR,30325143,1005,100,,Invoice,,,,,,29/08/2018,29/08/2018,0.00,,54.66,,"-854,504.06"
,IN,AR,30325153,1005,100,,Invoice,,,,,,29/08/2018,29/08/2018,0.00,,72.15,,"-854,576.21"
,IN,AR,30325160,1005,100,,Invoice,,,,,,29/08/2018,29/08/2018,0.00,,24.05,,"-854,600.26"
,IN,AR,30325172,1005,100,,Invoice,,,,,,29/08/2018,29/08/2018,0.00,,14.58,,"-854,614.84"
,IN,AR,30325200,1005,100,,Invoice,,,,,,29/08/2018,29/08/2018,0.00,,6.48,,"-854,621.32"
,IN,AR,30325213,1005,100,,Invoice,,,,,,29/08/2018,29/08/2018,0.00,,54.66,,"-854,675.98"
,IN,AR,30325221,1005,100,,Invoice,,,,,,29/08/2018,29/08/2018,0.00,,29.15,,"-854,705.13"
,IN,AR,30325243,1005,100,,Invoice,,,,,,29/08/2018,29/08/2018,0.00,,10.19,,"-854,715.32"
,IN,AR,30325255,1005,100,,Invoice,,,,,,29/08/2018,29/08/2018,0.00,,29.15,,"-854,744.47"
,IN,AR,30325256,1005,100,,Invoice,,,,,,29/08/2018,29/08/2018,0.00,,29.15,,"-854,773.62"
,IN,AR,30325259,1005,100,,Invoice,,,,,,29/08/2018,29/08/2018,0.00,,38.81,,"-854,812.43"
,IN,AR,30325275,1005,100,,Invoice,,,,,,29/08/2018,29/08/2018,0.00,,29.15,,"-854,841.58"
,IN,AR,30325286,1005,100,,Invoice,,,,,,29/08/2018,29/08/2018,0.00,,5.08,,"-854,846.66"
,IN,AR,30325328,1005,100,,Invoice,,,,,,29/08/2018,29/08/2018,0.00,,54.66,,"-854,901.32"
,IN,AR,30325330,1005,100,,Invoice,,,,,,29/08/2018,29/08/2018,0.00,,182.20,,"-855,083.52"
,IN,AR,30325345,1005,100,,Invoice,,,,,,29/08/2018,29/08/2018,0.00,,34.07,,"-855,117.59"
,IN,AR,30325350,1005,100,,Invoice,,,,,,29/08/2018,29/08/2018,0.00,,3.02,,"-855,120.61"
,IN,AR,30325357,1005,100,,Invoice,,,,,,29/08/2018,29/08/2018,0.00,,5.83,,"-855,126.44"
,IN,AR,30325378,1005,100,,Invoice,,,,,,29/08/2018,29/08/2018,0.00,,27.33,,"-855,153.77"
,IN,AR,30325379,1005,100,,Invoice,,,,,,29/08/2018,29/08/2018,0.00,,12.62,,"-855,166.39"
,IN,AR,30325398,1005,100,,Invoice,,,,,,29/08/2018,29/08/2018,0.00,,19.93,,"-855,186.32"
,IN,AR,30325402,1005,100,,Invoice,,,,,,29/08/2018,29/08/2018,0.00,,29.15,,"-855,215.47"
,IN,AR,30325466,1005,100,,Invoice,,,,,,29/08/2018,29/08/2018,0.00,,126.00,,"-855,341.47"
,IN,AR,30325480,1005,100,,Invoice,,,,,,29/08/2018,29/08/2018,0.00,,364.41,,"-855,705.88"
,IN,AR,30325506,1005,100,,Invoice,,,,,,29/08/2018,29/08/2018,0.00,,54.66,,"-855,760.54"
,IN,AR,30325510,1005,100,,Invoice,,,,,,29/08/2018,29/08/2018,0.00,,7.29,,"-855,767.83"
,IN,AR,30325512,1005,100,,Invoice,,,,,,29/08/2018,29/08/2018,0.00,,29.15,,"-855,796.98"
,IN,AR,30325518,1005,100,,Invoice,,,,,,29/08/2018,29/08/2018,0.00,,5.08,,"-855,802.06"
,IN,AR,30325531,1005,100,,Invoice,,,,,,29/08/2018,29/08/2018,0.00,,54.66,,"-855,856.72"
,IN,AR,30325553,1005,100,,Invoice,,,,,,29/08/2018,29/08/2018,0.00,,6.37,,"-855,863.09"
,IN,AR,30325554,1005,100,,Invoice,,,,,,29/08/2018,29/08/2018,0.00,,19.12,,"-855,882.21"
,IN,AR,30325614,1005,100,,Invoice,,,,,,29/08/2018,29/08/2018,0.00,,54.66,,"-855,936.87"
,IN,AR,30325674,1005,100,,Invoice,,,,,,29/08/2018,29/08/2018,0.00,,54.66,,"-855,991.53"
,IN,AR,30325691,1005,100,,Invoice,,,,,,29/08/2018,29/08/2018,0.00,,7.02,,"-855,998.55"
,IN,AR,30325710,1005,100,,Invoice,,,,,,29/08/2018,29/08/2018,0.00,,29.15,,"-856,027.70"
,IN,AR,30325711,1005,100,,Invoice,,,,,,29/08/2018,29/08/2018,0.00,,11.36,,"-856,039.06"
,IN,AR,30325721,1005,100,,Invoice,,,,,,29/08/2018,29/08/2018,0.00,,29.15,,"-856,068.21"
,IN,AR,30325723,1005,100,,Invoice,,,,,,29/08/2018,29/08/2018,0.00,,29.15,,"-856,097.36"
,IN,AR,30325747,1005,100,,Invoice,,,,,,29/08/2018,29/08/2018,0.00,,54.66,,"-856,152.02"
,IN,AR,30325774,1005,100,,Invoice,,,,,,29/08/2018,29/08/2018,0.00,,9.41,,"-856,161.43"
,IN,AR,30325812,1005,100,,Invoice,,,,,,29/08/2018,29/08/2018,0.00,,18.33,,"-856,179.76"
,IN,AR,30325814,1005,100,,Invoice,,,,,,29/08/2018,29/08/2018,0.00,,29.15,,"-856,208.91"
,IN,AR,30325816,1005,100,,Invoice,,,,,,29/08/2018,29/08/2018,0.00,,16.78,,"-856,225.69"
,IN,AR,30325836,1005,100,,Invoice,,,,,,29/08/2018,29/08/2018,0.00,,29.15,,"-856,254.84"
,IN,AR,30325837,1005,100,,Invoice,,,,,,29/08/2018,29/08/2018,0.00,,54.66,,"-856,309.50"
,IN,AR,30325852,1005,100,,Invoice,,,,,,29/08/2018,29/08/2018,0.00,,182.20,,"-856,491.70"
,IN,AR,30325853,1005,100,,Invoice,,,,,,29/08/2018,29/08/2018,0.00,,182.20,,"-856,673.90"
,IN,AR,30325855,1005,100,,Invoice,,,,,,29/08/2018,29/08/2018,0.00,,54.66,,"-856,728.56"
,IN,AR,30325864,1005,100,,Invoice,,,,,,29/08/2018,29/08/2018,0.00,,29.15,,"-856,757.71"
,IN,AR,30325874,1005,100,,Invoice,,,,,,29/08/2018,29/08/2018,0.00,,9.15,,"-856,766.86"
,IN,AR,30325914,1005,100,,Invoice,,,,,,29/08/2018,29/08/2018,0.00,,53.98,,"-856,820.84"
,IN,AR,30325915,1005,100,,Invoice,,,,,,29/08/2018,29/08/2018,0.00,,12.46,,"-856,833.30"
,IN,AR,30325916,1005,100,,Invoice,,,,,,29/08/2018,29/08/2018,0.00,,4.15,,"-856,837.45"
,IN,AR,30325917,1005,100,,Invoice,,,,,,29/08/2018,29/08/2018,0.00,,14.53,,"-856,851.98"
,IN,AR,30325956,1005,100,,Invoice,,,,,,29/08/2018,29/08/2018,0.00,,29.15,,"-856,881.13"
,IN,AR,30325968,1005,100,,Invoice,,,,,,29/08/2018,29/08/2018,0.00,,29.15,,"-856,910.28"
,IN,AR,30325980,1005,100,,Invoice,,,,,,29/08/2018,29/08/2018,0.00,,24.27,,"-856,934.55"
,IN,AR,30325983,1005,100,,Invoice,,,,,,29/08/2018,29/08/2018,0.00,,29.15,,"-856,963.70"
,IN,AR,30326001,1005,100,,Invoice,,,,,,29/08/2018,29/08/2018,0.00,,14.58,,"-856,978.28"
,IN,AR,30326003,1005,100,,Invoice,,,,,,29/08/2018,29/08/2018,0.00,,14.49,,"-856,992.77"
,IN,AR,30326023,1005,100,,Invoice,,,,,,29/08/2018,29/08/2018,0.00,,29.15,,"-857,021.92"
,IN,AR,30326027,1005,100,,Invoice,,,,,,29/08/2018,29/08/2018,0.00,,29.15,,"-857,051.07"
,IN,AR,30326041,1005,100,,Invoice,,,,,,29/08/2018,29/08/2018,0.00,,29.15,,"-857,080.22"
,IN,AR,30326051,1005,100,,Invoice,,,,,,29/08/2018,29/08/2018,0.00,,29.15,,"-857,109.37"
,IN,AR,30326098,1005,100,,Invoice,,,,,,29/08/2018,29/08/2018,0.00,,10.93,,"-857,120.30"
,IN,AR,30326113,1005,100,,Invoice,,,,,,29/08/2018,29/08/2018,0.00,,33.56,,"-857,153.86"
,IN,AR,30326119,1005,100,,Invoice,,,,,,29/08/2018,29/08/2018,0.00,,29.15,,"-857,183.01"
,IN,AR,30326147,1005,100,,Invoice,,,,,,29/08/2018,29/08/2018,0.00,,7.29,,"-857,190.30"
,IN,AR,30326172,1005,100,,Invoice,,,,,,29/08/2018,29/08/2018,0.00,,29.15,,"-857,219.45"
,IN,AR,30326175,1005,100,,Invoice,,,,,,29/08/2018,29/08/2018,0.00,,54.66,,"-857,274.11"
,IN,AR,30326208,1005,100,,Invoice,,,,,,29/08/2018,29/08/2018,0.00,,3.64,,"-857,277.75"
,CN,AR,31018658,1005,100,,Credit Note,,,,,,30/08/2018,30/08/2018,364.41,,0.00,,"-856,913.34"
,CN,AR,31018673,1005,100,,Credit Note,,,,,,30/08/2018,30/08/2018,3.64,,0.00,,"-856,909.70"
,CN,AR,31018712,1005,100,,Credit Note,,,,,,30/08/2018,30/08/2018,10.60,,0.00,,"-856,899.10"
,CN,AR,31018739,1005,100,,Credit Note,,,,,,30/08/2018,30/08/2018,6.36,,0.00,,"-856,892.74"
,CN,AR,31018844,1005,100,,Credit Note,,,,,,30/08/2018,30/08/2018,364.41,,0.00,,"-856,528.33"
,CN,AR,31018967,1005,100,,Credit Note,,,,,,30/08/2018,30/08/2018,10.98,,0.00,,"-856,517.35"
,CN,AR,31018978,1005,100,,Credit Note,,,,,,30/08/2018,30/08/2018,49.30,,0.00,,"-856,468.05"
,CN,AR,31018982,1005,100,,Credit Note,,,,,,30/08/2018,30/08/2018,3.64,,0.00,,"-856,464.41"
,CR,AR,33000270,1005,100,,Cash Return,,,,,,30/08/2018,30/08/2018,10.93,,0.00,,"-856,453.48"
,CS,AR,32007881,1005,100,,Cash sale,,,,,,30/08/2018,30/08/2018,0.00,,12.03,,"-856,465.51"
,CS,AR,32007989,1005,100,,Cash sale,,,,,,30/08/2018,30/08/2018,0.00,,3.64,,"-856,469.15"
,CS,AR,32008019,1005,100,,Cash sale,,,,,,30/08/2018,30/08/2018,0.00,,7.29,,"-856,476.44"
,CS,AR,32008025,1005,100,,Cash sale,,,,,,30/08/2018,30/08/2018,0.00,,7.29,,"-856,483.73"
,CS,AR,32008026,1005,100,,Cash sale,,,,,,30/08/2018,30/08/2018,0.00,,10.93,,"-856,494.66"
,CS,AR,32008076,1005,100,,Cash sale,,,,,,30/08/2018,30/08/2018,0.00,,10.93,,"-856,505.59"
,CS,AR,32008095,1005,100,,Cash sale,,,,,,30/08/2018,30/08/2018,0.00,,7.29,,"-856,512.88"
,CS,AR,32008116,1005,100,,Cash sale,,,,,,30/08/2018,30/08/2018,0.00,,3.64,,"-856,516.52"
,CS,AR,32008129,1005,100,,Cash sale,,,,,,30/08/2018,30/08/2018,0.00,,7.29,,"-856,523.81"
,CS,AR,32008309,1005,100,,Cash sale,,,,,,30/08/2018,30/08/2018,0.00,,19.28,,"-856,543.09"
,CS,AR,32008332,1005,100,,Cash sale,,,,,,30/08/2018,30/08/2018,0.00,,7.29,,"-856,550.38"
,CS,AR,32008337,1005,100,,Cash sale,,,,,,30/08/2018,30/08/2018,0.00,,3.64,,"-856,554.02"
,CS,AR,32008357,1005,100,,Cash sale,,,,,,30/08/2018,30/08/2018,0.00,,9.66,,"-856,563.68"
,CS,AR,32008361,1005,100,,Cash sale,,,,,,30/08/2018,30/08/2018,0.00,,36.36,,"-856,600.04"
,CS,AR,32008364,1005,100,,Cash sale,,,,,,30/08/2018,30/08/2018,0.00,,3.64,,"-856,603.68"
,CS,AR,32008366,1005,100,,Cash sale,,,,,,30/08/2018,30/08/2018,0.00,,23.26,,"-856,626.94"
,CS,AR,32008410,1005,100,,Cash sale,,,,,,30/08/2018,30/08/2018,0.00,,3.22,,"-856,630.16"
,CS,AR,32008448,1005,100,,Cash sale,,,,,,30/08/2018,30/08/2018,0.00,,7.29,,"-856,637.45"
,CS,AR,32008461,1005,100,,Cash sale,,,,,,30/08/2018,30/08/2018,0.00,,14.58,,"-856,652.03"
,CS,AR,32008467,1005,100,,Cash sale,,,,,,30/08/2018,30/08/2018,0.00,,22.37,,"-856,674.40"
,CS,AR,32008505,1005,100,,Cash sale,,,,,,30/08/2018,30/08/2018,0.00,,10.93,,"-856,685.33"
,CS,AR,32008549,1005,100,,Cash sale,,,,,,30/08/2018,30/08/2018,0.00,,14.58,,"-856,699.91"
,CS,AR,32008560,1005,100,,Cash sale,,,,,,30/08/2018,30/08/2018,0.00,,11.86,,"-856,711.77"
,CS,AR,32008565,1005,100,,Cash sale,,,,,,30/08/2018,30/08/2018,0.00,,6.07,,"-856,717.84"
,CS,AR,32008577,1005,100,,Cash sale,,,,,,30/08/2018,30/08/2018,0.00,,6.56,,"-856,724.40"
,CS,AR,32008605,1005,100,,Cash sale,,,,,,30/08/2018,30/08/2018,0.00,,7.29,,"-856,731.69"
,CS,AR,32008630,1005,100,,Cash sale,,,,,,30/08/2018,30/08/2018,0.00,,14.58,,"-856,746.27"
,CS,AR,32008662,1005,100,,Cash sale,,,,,,30/08/2018,30/08/2018,0.00,,14.58,,"-856,760.85"
,CS,AR,32008713,1005,100,,Cash sale,,,,,,30/08/2018,30/08/2018,0.00,,7.29,,"-856,768.14"
,CS,AR,32008744,1005,100,,Cash sale,,,,,,30/08/2018,30/08/2018,0.00,,7.29,,"-856,775.43"
,CS,AR,32008760,1005,100,,Cash sale,,,,,,30/08/2018,30/08/2018,0.00,,14.58,,"-856,790.01"
,CS,AR,32008769,1005,100,,Cash sale,,,,,,30/08/2018,30/08/2018,0.00,,5.94,,"-856,795.95"
,CS,AR,32008774,1005,100,,Cash sale,,,,,,30/08/2018,30/08/2018,0.00,,25.51,,"-856,821.46"
,CS,AR,32008849,1005,100,,Cash sale,,,,,,30/08/2018,30/08/2018,0.00,,10.93,,"-856,832.39"
,IN,AR,30323562,1005,100,,Invoice,,,,,,30/08/2018,30/08/2018,0.00,,3.64,,"-856,836.03"
,IN,AR,30323587,1005,100,,Invoice,,,,,,30/08/2018,30/08/2018,0.00,,10.93,,"-856,846.96"
,IN,AR,30323593,1005,100,,Invoice,,,,,,30/08/2018,30/08/2018,0.00,,29.15,,"-856,876.11"
,IN,AR,30323594,1005,100,,Invoice,,,,,,30/08/2018,30/08/2018,0.00,,7.29,,"-856,883.40"
,IN,AR,30323648,1005,100,,Invoice,,,,,,30/08/2018,30/08/2018,0.00,,29.15,,"-856,912.55"
,IN,AR,30323665,1005,100,,Invoice,,,,,,30/08/2018,30/08/2018,0.00,,54.66,,"-856,967.21"
,IN,AR,30323678,1005,100,,Invoice,,,,,,30/08/2018,30/08/2018,0.00,,14.58,,"-856,981.79"
,IN,AR,30323706,1005,100,,Invoice,,,,,,30/08/2018,30/08/2018,0.00,,54.66,,"-857,036.45"
,IN,AR,30323723,1005,100,,Invoice,,,,,,30/08/2018,30/08/2018,0.00,,5.97,,"-857,042.42"
,IN,AR,30323738,1005,100,,Invoice,,,,,,30/08/2018,30/08/2018,0.00,,106.78,,"-857,149.20"
,IN,AR,30323773,1005,100,,Invoice,,,,,,30/08/2018,30/08/2018,0.00,,68.00,,"-857,217.20"
,IN,AR,30323797,1005,100,,Invoice,,,,,,30/08/2018,30/08/2018,0.00,,10.93,,"-857,228.13"
,IN,AR,30323844,1005,100,,Invoice,,,,,,30/08/2018,30/08/2018,0.00,,364.41,,"-857,592.54"
,IN,AR,30323846,1005,100,,Invoice,,,,,,30/08/2018,30/08/2018,0.00,,14.58,,"-857,607.12"
,IN,AR,30323849,1005,100,,Invoice,,,,,,30/08/2018,30/08/2018,0.00,,29.15,,"-857,636.27"
,IN,AR,30323859,1005,100,,Invoice,,,,,,30/08/2018,30/08/2018,0.00,,546.61,,"-858,182.88"
,IN,AR,30323872,1005,100,,Invoice,,,,,,30/08/2018,30/08/2018,0.00,,92.54,,"-858,275.42"
,IN,AR,30323881,1005,100,,Invoice,,,,,,30/08/2018,30/08/2018,0.00,,28.00,,"-858,303.42"
,IN,AR,30323894,1005,100,,Invoice,,,,,,30/08/2018,30/08/2018,0.00,,65.90,,"-858,369.32"
,IN,AR,30323903,1005,100,,Invoice,,,,,,30/08/2018,30/08/2018,0.00,,455.51,,"-858,824.83"
,IN,AR,30323998,1005,100,,Invoice,,,,,,30/08/2018,30/08/2018,0.00,,9.56,,"-858,834.39"
,IN,AR,30323999,1005,100,,Invoice,,,,,,30/08/2018,30/08/2018,0.00,,15.93,,"-858,850.32"
,IN,AR,30324009,1005,100,,Invoice,,,,,,30/08/2018,30/08/2018,0.00,,10.93,,"-858,861.25"
,IN,AR,30324014,1005,100,,Invoice,,,,,,30/08/2018,30/08/2018,0.00,,35.00,,"-858,896.25"
,IN,AR,30324037,1005,100,,Invoice,,,,,,30/08/2018,30/08/2018,0.00,,3.64,,"-858,899.89"
,IN,AR,30324044,1005,100,,Invoice,,,,,,30/08/2018,30/08/2018,0.00,,7.29,,"-858,907.18"
,IN,AR,30324073,1005,100,,Invoice,,,,,,30/08/2018,30/08/2018,0.00,,91.10,,"-858,998.28"
,IN,AR,30324082,1005,100,,Invoice,,,,,,30/08/2018,30/08/2018,0.00,,29.67,,"-859,027.95"
,IN,AR,30324088,1005,100,,Invoice,,,,,,30/08/2018,30/08/2018,0.00,,4.24,,"-859,032.19"
,IN,AR,30324093,1005,100,,Invoice,,,,,,30/08/2018,30/08/2018,0.00,,10.60,,"-859,042.79"
,IN,AR,30324098,1005,100,,Invoice,,,,,,30/08/2018,30/08/2018,0.00,,8.48,,"-859,051.27"
,IN,AR,30324105,1005,100,,Invoice,,,,,,30/08/2018,30/08/2018,0.00,,61.02,,"-859,112.29"
,IN,AR,30324106,1005,100,,Invoice,,,,,,30/08/2018,30/08/2018,0.00,,61.02,,"-859,173.31"
,IN,AR,30324117,1005,100,,Invoice,,,,,,30/08/2018,30/08/2018,0.00,,8.48,,"-859,181.79"
,IN,AR,30324122,1005,100,,Invoice,,,,,,30/08/2018,30/08/2018,0.00,,10.60,,"-859,192.39"
,IN,AR,30324123,1005,100,,Invoice,,,,,,30/08/2018,30/08/2018,0.00,,10.60,,"-859,202.99"
,IN,AR,30324126,1005,100,,Invoice,,,,,,30/08/2018,30/08/2018,0.00,,29.15,,"-859,232.14"
,IN,AR,30324129,1005,100,,Invoice,,,,,,30/08/2018,30/08/2018,0.00,,8.48,,"-859,240.62"
,IN,AR,30324138,1005,100,,Invoice,,,,,,30/08/2018,30/08/2018,0.00,,36.02,,"-859,276.64"
,IN,AR,30324143,1005,100,,Invoice,,,,,,30/08/2018,30/08/2018,0.00,,59.33,,"-859,335.97"
,IN,AR,30324156,1005,100,,Invoice,,,,,,30/08/2018,30/08/2018,0.00,,11.66,,"-859,347.63"
,IN,AR,30324161,1005,100,,Invoice,,,,,,30/08/2018,30/08/2018,0.00,,7.29,,"-859,354.92"
,IN,AR,30324165,1005,100,,Invoice,,,,,,30/08/2018,30/08/2018,0.00,,181.77,,"-859,536.69"
,IN,AR,30324215,1005,100,,Invoice,,,,,,30/08/2018,30/08/2018,0.00,,18.64,,"-859,555.33"
,IN,AR,30324235,1005,100,,Invoice,,,,,,30/08/2018,30/08/2018,0.00,,2.54,,"-859,557.87"
,IN,AR,30324236,1005,100,,Invoice,,,,,,30/08/2018,30/08/2018,0.00,,119.49,,"-859,677.36"
,IN,AR,30324252,1005,100,,Invoice,,,,,,30/08/2018,30/08/2018,0.00,,21.51,,"-859,698.87"
,IN,AR,30324269,1005,100,,Invoice,,,,,,30/08/2018,30/08/2018,0.00,,19.32,,"-859,718.19"
,IN,AR,30324290,1005,100,,Invoice,,,,,,30/08/2018,30/08/2018,0.00,,16.95,,"-859,735.14"
,IN,AR,30324312,1005,100,,Invoice,,,,,,30/08/2018,30/08/2018,0.00,,75.00,,"-859,810.14"
,IN,AR,30324316,1005,100,,Invoice,,,,,,30/08/2018,30/08/2018,0.00,,10.60,,"-859,820.74"
,IN,AR,30324327,1005,100,,Invoice,,,,,,30/08/2018,30/08/2018,0.00,,6.36,,"-859,827.10"
,IN,AR,30324329,1005,100,,Invoice,,,,,,30/08/2018,30/08/2018,0.00,,4.24,,"-859,831.34"
,IN,AR,30324366,1005,100,,Invoice,,,,,,30/08/2018,30/08/2018,0.00,,14.83,,"-859,846.17"
,IN,AR,30324418,1005,100,,Invoice,,,,,,30/08/2018,30/08/2018,0.00,,7.75,,"-859,853.92"
,IN,AR,30324423,1005,100,,Invoice,,,,,,30/08/2018,30/08/2018,0.00,,6.36,,"-859,860.28"
,IN,AR,30324429,1005,100,,Invoice,,,,,,30/08/2018,30/08/2018,0.00,,6.48,,"-859,866.76"
,IN,AR,30324475,1005,100,,Invoice,,,,,,30/08/2018,30/08/2018,0.00,,10.59,,"-859,877.35"
,IN,AR,30324478,1005,100,,Invoice,,,,,,30/08/2018,30/08/2018,0.00,,25.43,,"-859,902.78"
,IN,AR,30324484,1005,100,,Invoice,,,,,,30/08/2018,30/08/2018,0.00,,27.55,,"-859,930.33"
,IN,AR,30324489,1005,100,,Invoice,,,,,,30/08/2018,30/08/2018,0.00,,21.19,,"-859,951.52"
,IN,AR,30324492,1005,100,,Invoice,,,,,,30/08/2018,30/08/2018,0.00,,23.31,,"-859,974.83"
,IN,AR,30324494,1005,100,,Invoice,,,,,,30/08/2018,30/08/2018,0.00,,21.19,,"-859,996.02"
,IN,AR,30324495,1005,100,,Invoice,,,,,,30/08/2018,30/08/2018,0.00,,21.19,,"-860,017.21"
,IN,AR,30324526,1005,100,,Invoice,,,,,,30/08/2018,30/08/2018,0.00,,17.80,,"-860,035.01"
,IN,AR,30324531,1005,100,,Invoice,,,,,,30/08/2018,30/08/2018,0.00,,29.15,,"-860,064.16"
,IN,AR,30324536,1005,100,,Invoice,,,,,,30/08/2018,30/08/2018,0.00,,22.50,,"-860,086.66"
,IN,AR,30324552,1005,100,,Invoice,,,,,,30/08/2018,30/08/2018,0.00,,3.64,,"-860,090.30"
,IN,AR,30324596,1005,100,,Invoice,,,,,,30/08/2018,30/08/2018,0.00,,61.45,,"-860,151.75"
,IN,AR,30324601,1005,100,,Invoice,,,,,,30/08/2018,30/08/2018,0.00,,12.71,,"-860,164.46"
,IN,AR,30324604,1005,100,,Invoice,,,,,,30/08/2018,30/08/2018,0.00,,16.95,,"-860,181.41"
,IN,AR,30324621,1005,100,,Invoice,,,,,,30/08/2018,30/08/2018,0.00,,27.55,,"-860,208.96"
,IN,AR,30324626,1005,100,,Invoice,,,,,,30/08/2018,30/08/2018,0.00,,14.83,,"-860,223.79"
,IN,AR,30324653,1005,100,,Invoice,,,,,,30/08/2018,30/08/2018,0.00,,19.22,,"-860,243.01"
,IN,AR,30324667,1005,100,,Invoice,,,,,,30/08/2018,30/08/2018,0.00,,21.19,,"-860,264.20"
,IN,AR,30324673,1005,100,,Invoice,,,,,,30/08/2018,30/08/2018,0.00,,19.07,,"-860,283.27"
,IN,AR,30324674,1005,100,,Invoice,,,,,,30/08/2018,30/08/2018,0.00,,21.19,,"-860,304.46"
,IN,AR,30324678,1005,100,,Invoice,,,,,,30/08/2018,30/08/2018,0.00,,36.02,,"-860,340.48"
,IN,AR,30324689,1005,100,,Invoice,,,,,,30/08/2018,30/08/2018,0.00,,4.58,,"-860,345.06"
,IN,AR,30324700,1005,100,,Invoice,,,,,,30/08/2018,30/08/2018,0.00,,14.58,,"-860,359.64"
,IN,AR,30324720,1005,100,,Invoice,,,,,,30/08/2018,30/08/2018,0.00,,10.60,,"-860,370.24"
,IN,AR,30324729,1005,100,,Invoice,,,,,,30/08/2018,30/08/2018,0.00,,10.59,,"-860,380.83"
,IN,AR,30324730,1005,100,,Invoice,,,,,,30/08/2018,30/08/2018,0.00,,10.60,,"-860,391.43"
,IN,AR,30324734,1005,100,,Invoice,,,,,,30/08/2018,30/08/2018,0.00,,36.02,,"-860,427.45"
,IN,AR,30324741,1005,100,,Invoice,,,,,,30/08/2018,30/08/2018,0.00,,67.81,,"-860,495.26"
,IN,AR,30324747,1005,100,,Invoice,,,,,,30/08/2018,30/08/2018,0.00,,31.79,,"-860,527.05"
,IN,AR,30324786,1005,100,,Invoice,,,,,,30/08/2018,30/08/2018,0.00,,4.64,,"-860,531.69"
,IN,AR,30324796,1005,100,,Invoice,,,,,,30/08/2018,30/08/2018,0.00,,11.69,,"-860,543.38"
,IN,AR,30324801,1005,100,,Invoice,,,,,,30/08/2018,30/08/2018,0.00,,14.58,,"-860,557.96"
,IN,AR,30324822,1005,100,,Invoice,,,,,,30/08/2018,30/08/2018,0.00,,21.86,,"-860,579.82"
,IN,AR,30324846,1005,100,,Invoice,,,,,,30/08/2018,30/08/2018,0.00,,16.53,,"-860,596.35"
,IN,AR,30324851,1005,100,,Invoice,,,,,,30/08/2018,30/08/2018,0.00,,54.66,,"-860,651.01"
,IN,AR,30324852,1005,100,,Invoice,,,,,,30/08/2018,30/08/2018,0.00,,29.15,,"-860,680.16"
,IN,AR,30324858,1005,100,,Invoice,,,,,,30/08/2018,30/08/2018,0.00,,36.10,,"-860,716.26"
,IN,AR,30324870,1005,100,,Invoice,,,,,,30/08/2018,30/08/2018,0.00,,12.14,,"-860,728.40"
,IN,AR,30324883,1005,100,,Invoice,,,,,,30/08/2018,30/08/2018,0.00,,41.53,,"-860,769.93"
,IN,AR,30324887,1005,100,,Invoice,,,,,,30/08/2018,30/08/2018,0.00,,17.47,,"-860,787.40"
,IN,AR,30324892,1005,100,,Invoice,,,,,,30/08/2018,30/08/2018,0.00,,7.63,,"-860,795.03"
,IN,AR,30324898,1005,100,,Invoice,,,,,,30/08/2018,30/08/2018,0.00,,153.05,,"-860,948.08"
,IN,AR,30324909,1005,100,,Invoice,,,,,,30/08/2018,30/08/2018,0.00,,24.07,,"-860,972.15"
,IN,AR,30324913,1005,100,,Invoice,,,,,,30/08/2018,30/08/2018,0.00,,8.00,,"-860,980.15"
,IN,AR,30324965,1005,100,,Invoice,,,,,,30/08/2018,30/08/2018,0.00,,3.64,,"-860,983.79"
,IN,AR,30324973,1005,100,,Invoice,,,,,,30/08/2018,30/08/2018,0.00,,9.08,,"-860,992.87"
,IN,AR,30324975,1005,100,,Invoice,,,,,,30/08/2018,30/08/2018,0.00,,54.66,,"-861,047.53"
,IN,AR,30324978,1005,100,,Invoice,,,,,,30/08/2018,30/08/2018,0.00,,5.49,,"-861,053.02"
,IN,AR,30324999,1005,100,,Invoice,,,,,,30/08/2018,30/08/2018,0.00,,29.15,,"-861,082.17"
,IN,AR,30325001,1005,100,,Invoice,,,,,,30/08/2018,30/08/2018,0.00,,54.66,,"-861,136.83"
,IN,AR,30325009,1005,100,,Invoice,,,,,,30/08/2018,30/08/2018,0.00,,15.71,,"-861,152.54"
,IN,AR,30325036,1005,100,,Invoice,,,,,,30/08/2018,30/08/2018,0.00,,29.15,,"-861,181.69"
,IN,AR,30325061,1005,100,,Invoice,,,,,,30/08/2018,30/08/2018,0.00,,2.58,,"-861,184.27"
,IN,AR,30325065,1005,100,,Invoice,,,,,,30/08/2018,30/08/2018,0.00,,7.29,,"-861,191.56"
,IN,AR,30325071,1005,100,,Invoice,,,,,,30/08/2018,30/08/2018,0.00,,18.22,,"-861,209.78"
,IN,AR,30325079,1005,100,,Invoice,,,,,,30/08/2018,30/08/2018,0.00,,5.97,,"-861,215.75"
,IN,AR,30325080,1005,100,,Invoice,,,,,,30/08/2018,30/08/2018,0.00,,39.83,,"-861,255.58"
,IN,AR,30325097,1005,100,,Invoice,,,,,,30/08/2018,30/08/2018,0.00,,11.13,,"-861,266.71"
,IN,AR,30325149,1005,100,,Invoice,,,,,,30/08/2018,30/08/2018,0.00,,157.47,,"-861,424.18"
,IN,AR,30325183,1005,100,,Invoice,,,,,,30/08/2018,30/08/2018,0.00,,7.29,,"-861,431.47"
,IN,AR,30325252,1005,100,,Invoice,,,,,,30/08/2018,30/08/2018,0.00,,7.29,,"-861,438.76"
,IN,AR,30325298,1005,100,,Invoice,,,,,,30/08/2018,30/08/2018,0.00,,22.01,,"-861,460.77"
,IN,AR,30325311,1005,100,,Invoice,,,,,,30/08/2018,30/08/2018,0.00,,20.01,,"-861,480.78"
,IN,AR,30325327,1005,100,,Invoice,,,,,,30/08/2018,30/08/2018,0.00,,54.66,,"-861,535.44"
,IN,AR,30325335,1005,100,,Invoice,,,,,,30/08/2018,30/08/2018,0.00,,14.58,,"-861,550.02"
,IN,AR,30325336,1005,100,,Invoice,,,,,,30/08/2018,30/08/2018,0.00,,11.66,,"-861,561.68"
,IN,AR,30325364,1005,100,,Invoice,,,,,,30/08/2018,30/08/2018,0.00,,7.29,,"-861,568.97"
,IN,AR,30325410,1005,100,,Invoice,,,,,,30/08/2018,30/08/2018,0.00,,26.24,,"-861,595.21"
,IN,AR,30325414,1005,100,,Invoice,,,,,,30/08/2018,30/08/2018,0.00,,25.51,,"-861,620.72"
,IN,AR,30325416,1005,100,,Invoice,,,,,,30/08/2018,30/08/2018,0.00,,10.93,,"-861,631.65"
,IN,AR,30325434,1005,100,,Invoice,,,,,,30/08/2018,30/08/2018,0.00,,8.42,,"-861,640.07"
,IN,AR,30325448,1005,100,,Invoice,,,,,,30/08/2018,30/08/2018,0.00,,22.88,,"-861,662.95"
,IN,AR,30325458,1005,100,,Invoice,,,,,,30/08/2018,30/08/2018,0.00,,29.15,,"-861,692.10"
,IN,AR,30325537,1005,100,,Invoice,,,,,,30/08/2018,30/08/2018,0.00,,29.15,,"-861,721.25"
,IN,AR,30325539,1005,100,,Invoice,,,,,,30/08/2018,30/08/2018,0.00,,81.15,,"-861,802.40"
,IN,AR,30325555,1005,100,,Invoice,,,,,,30/08/2018,30/08/2018,0.00,,7.97,,"-861,810.37"
,IN,AR,30325556,1005,100,,Invoice,,,,,,30/08/2018,30/08/2018,0.00,,6.37,,"-861,816.74"
,IN,AR,30325557,1005,100,,Invoice,,,,,,30/08/2018,30/08/2018,0.00,,119.49,,"-861,936.23"
,IN,AR,30325558,1005,100,,Invoice,,,,,,30/08/2018,30/08/2018,0.00,,9.56,,"-861,945.79"
,IN,AR,30325640,1005,100,,Invoice,,,,,,30/08/2018,30/08/2018,0.00,,26.44,,"-861,972.23"
,IN,AR,30325698,1005,100,,Invoice,,,,,,30/08/2018,30/08/2018,0.00,,29.15,,"-862,001.38"
,IN,AR,30325722,1005,100,,Invoice,,,,,,30/08/2018,30/08/2018,0.00,,29.15,,"-862,030.53"
,IN,AR,30325762,1005,100,,Invoice,,,,,,30/08/2018,30/08/2018,0.00,,29.15,,"-862,059.68"
,IN,AR,30325763,1005,100,,Invoice,,,,,,30/08/2018,30/08/2018,0.00,,29.15,,"-862,088.83"
,IN,AR,30325778,1005,100,,Invoice,,,,,,30/08/2018,30/08/2018,0.00,,15.17,,"-862,104.00"
,IN,AR,30325790,1005,100,,Invoice,,,,,,30/08/2018,30/08/2018,0.00,,182.20,,"-862,286.20"
,IN,AR,30325793,1005,100,,Invoice,,,,,,30/08/2018,30/08/2018,0.00,,2.92,,"-862,289.12"
,IN,AR,30325833,1005,100,,Invoice,,,,,,30/08/2018,30/08/2018,0.00,,6.13,,"-862,295.25"
,IN,AR,30325840,1005,100,,Invoice,,,,,,30/08/2018,30/08/2018,0.00,,9.84,,"-862,305.09"
,IN,AR,30325885,1005,100,,Invoice,,,,,,30/08/2018,30/08/2018,0.00,,3.64,,"-862,308.73"
,IN,AR,30325918,1005,100,,Invoice,,,,,,30/08/2018,30/08/2018,0.00,,12.46,,"-862,321.19"
,IN,AR,30325919,1005,100,,Invoice,,,,,,30/08/2018,30/08/2018,0.00,,4.15,,"-862,325.34"
,IN,AR,30325920,1005,100,,Invoice,,,,,,30/08/2018,30/08/2018,0.00,,6.23,,"-862,331.57"
,IN,AR,30325921,1005,100,,Invoice,,,,,,30/08/2018,30/08/2018,0.00,,35.30,,"-862,366.87"
,IN,AR,30325976,1005,100,,Invoice,,,,,,30/08/2018,30/08/2018,0.00,,364.41,,"-862,731.28"
,IN,AR,30326054,1005,100,,Invoice,,,,,,30/08/2018,30/08/2018,0.00,,29.15,,"-862,760.43"
,IN,AR,30326087,1005,100,,Invoice,,,,,,30/08/2018,30/08/2018,0.00,,31.54,,"-862,791.97"
,IN,AR,30326105,1005,100,,Invoice,,,,,,30/08/2018,30/08/2018,0.00,,29.15,,"-862,821.12"
,IN,AR,30326133,1005,100,,Invoice,,,,,,30/08/2018,30/08/2018,0.00,,10.93,,"-862,832.05"
,IN,AR,30326159,1005,100,,Invoice,,,,,,30/08/2018,30/08/2018,0.00,,3.64,,"-862,835.69"
,IN,AR,30326162,1005,100,,Invoice,,,,,,30/08/2018,30/08/2018,0.00,,3.64,,"-862,839.33"
,IN,AR,30326218,1005,100,,Invoice,,,,,,30/08/2018,30/08/2018,0.00,,7.29,,"-862,846.62"
,IN,AR,30326222,1005,100,,Invoice,,,,,,30/08/2018,30/08/2018,0.00,,54.66,,"-862,901.28"
,CN,AR,31018655,1005,100,,Credit Note,,,,,,31/08/2018,31/08/2018,6.08,,0.00,,"-862,895.20"
,CN,AR,31018742,1005,100,,Credit Note,,,,,,31/08/2018,31/08/2018,216.36,,0.00,,"-862,678.84"
,CN,AR,31018926,1005,100,,Credit Note,,,,,,31/08/2018,31/08/2018,18.22,,0.00,,"-862,660.62"
,CN,AR,31018927,1005,100,,Credit Note,,,,,,31/08/2018,31/08/2018,10.93,,0.00,,"-862,649.69"
,CN,AR,31018959,1005,100,,Credit Note,,,,,,31/08/2018,31/08/2018,14.58,,0.00,,"-862,635.11"
,CS,AR,32007878,1005,100,,Cash sale,,,,,,31/08/2018,31/08/2018,0.00,,7.29,,"-862,642.40"
,CS,AR,32007890,1005,100,,Cash sale,,,,,,31/08/2018,31/08/2018,0.00,,11.22,,"-862,653.62"
,CS,AR,32007905,1005,100,,Cash sale,,,,,,31/08/2018,31/08/2018,0.00,,9.49,,"-862,663.11"
,CS,AR,32007918,1005,100,,Cash sale,,,,,,31/08/2018,31/08/2018,0.00,,6.08,,"-862,669.19"
,CS,AR,32007919,1005,100,,Cash sale,,,,,,31/08/2018,31/08/2018,0.00,,6.08,,"-862,675.27"
,CS,AR,32007930,1005,100,,Cash sale,,,,,,31/08/2018,31/08/2018,0.00,,3.64,,"-862,678.91"
,CS,AR,32007945,1005,100,,Cash sale,,,,,,31/08/2018,31/08/2018,0.00,,21.86,,"-862,700.77"
,CS,AR,32007951,1005,100,,Cash sale,,,,,,31/08/2018,31/08/2018,0.00,,10.93,,"-862,711.70"
,CS,AR,32007959,1005,100,,Cash sale,,,,,,31/08/2018,31/08/2018,0.00,,4.32,,"-862,716.02"
,CS,AR,32008013,1005,100,,Cash sale,,,,,,31/08/2018,31/08/2018,0.00,,10.38,,"-862,726.40"
,CS,AR,32008027,1005,100,,Cash sale,,,,,,31/08/2018,31/08/2018,0.00,,3.64,,"-862,730.04"
,CS,AR,32008040,1005,100,,Cash sale,,,,,,31/08/2018,31/08/2018,0.00,,7.29,,"-862,737.33"
,CS,AR,32008045,1005,100,,Cash sale,,,,,,31/08/2018,31/08/2018,0.00,,7.78,,"-862,745.11"
,CS,AR,32008051,1005,100,,Cash sale,,,,,,31/08/2018,31/08/2018,0.00,,3.64,,"-862,748.75"
,CS,AR,32008054,1005,100,,Cash sale,,,,,,31/08/2018,31/08/2018,0.00,,3.64,,"-862,752.39"
,CS,AR,32008081,1005,100,,Cash sale,,,,,,31/08/2018,31/08/2018,0.00,,14.58,,"-862,766.97"
,CS,AR,32008086,1005,100,,Cash sale,,,,,,31/08/2018,31/08/2018,0.00,,10.93,,"-862,777.90"
,CS,AR,32008103,1005,100,,Cash sale,,,,,,31/08/2018,31/08/2018,0.00,,7.29,,"-862,785.19"
,CS,AR,32008138,1005,100,,Cash sale,,,,,,31/08/2018,31/08/2018,0.00,,29.15,,"-862,814.34"
,CS,AR,32008142,1005,100,,Cash sale,,,,,,31/08/2018,31/08/2018,0.00,,2.58,,"-862,816.92"
,CS,AR,32008150,1005,100,,Cash sale,,,,,,31/08/2018,31/08/2018,0.00,,12.71,,"-862,829.63"
,CS,AR,32008157,1005,100,,Cash sale,,,,,,31/08/2018,31/08/2018,0.00,,13.98,,"-862,843.61"
,CS,AR,32008174,1005,100,,Cash sale,,,,,,31/08/2018,31/08/2018,0.00,,28.43,,"-862,872.04"
,CS,AR,32008176,1005,100,,Cash sale,,,,,,31/08/2018,31/08/2018,0.00,,38.47,,"-862,910.51"
,CS,AR,32008203,1005,100,,Cash sale,,,,,,31/08/2018,31/08/2018,0.00,,7.29,,"-862,917.80"
,CS,AR,32008209,1005,100,,Cash sale,,,,,,31/08/2018,31/08/2018,0.00,,6.02,,"-862,923.82"
,CS,AR,32008237,1005,100,,Cash sale,,,,,,31/08/2018,31/08/2018,0.00,,15.25,,"-862,939.07"
,CS,AR,32008251,1005,100,,Cash sale,,,,,,31/08/2018,31/08/2018,0.00,,26.31,,"-862,965.38"
,CS,AR,32008263,1005,100,,Cash sale,,,,,,31/08/2018,31/08/2018,0.00,,5.17,,"-862,970.55"
,CS,AR,32008283,1005,100,,Cash sale,,,,,,31/08/2018,31/08/2018,0.00,,10.17,,"-862,980.72"
,CS,AR,32008324,1005,100,,Cash sale,,,,,,31/08/2018,31/08/2018,0.00,,21.86,,"-863,002.58"
,CS,AR,32008350,1005,100,,Cash sale,,,,,,31/08/2018,31/08/2018,0.00,,14.58,,"-863,017.16"
,CS,AR,32008385,1005,100,,Cash sale,,,,,,31/08/2018,31/08/2018,0.00,,21.86,,"-863,039.02"
,CS,AR,32008388,1005,100,,Cash sale,,,,,,31/08/2018,31/08/2018,0.00,,5.17,,"-863,044.19"
,CS,AR,32008399,1005,100,,Cash sale,,,,,,31/08/2018,31/08/2018,0.00,,14.58,,"-863,058.77"
,CS,AR,32008402,1005,100,,Cash sale,,,,,,31/08/2018,31/08/2018,0.00,,10.93,,"-863,069.70"
,CS,AR,32008415,1005,100,,Cash sale,,,,,,31/08/2018,31/08/2018,0.00,,17.56,,"-863,087.26"
,CS,AR,32008443,1005,100,,Cash sale,,,,,,31/08/2018,31/08/2018,0.00,,5.17,,"-863,092.43"
,CS,AR,32008469,1005,100,,Cash sale,,,,,,31/08/2018,31/08/2018,0.00,,7.29,,"-863,099.72"
,CS,AR,32008509,1005,100,,Cash sale,,,,,,31/08/2018,31/08/2018,0.00,,12.71,,"-863,112.43"
,CS,AR,32008513,1005,100,,Cash sale,,,,,,31/08/2018,31/08/2018,0.00,,9.03,,"-863,121.46"
,CS,AR,32008545,1005,100,,Cash sale,,,,,,31/08/2018,31/08/2018,0.00,,3.64,,"-863,125.10"
,CS,AR,32008587,1005,100,,Cash sale,,,,,,31/08/2018,31/08/2018,0.00,,6.86,,"-863,131.96"
,CS,AR,32008594,1005,100,,Cash sale,,,,,,31/08/2018,31/08/2018,0.00,,25.51,,"-863,157.47"
,CS,AR,32008619,1005,100,,Cash sale,,,,,,31/08/2018,31/08/2018,0.00,,10.17,,"-863,167.64"
,CS,AR,32008642,1005,100,,Cash sale,,,,,,31/08/2018,31/08/2018,0.00,,15.18,,"-863,182.82"
,CS,AR,32008663,1005,100,,Cash sale,,,,,,31/08/2018,31/08/2018,0.00,,3.64,,"-863,186.46"
,CS,AR,32008678,1005,100,,Cash sale,,,,,,31/08/2018,31/08/2018,0.00,,21.24,,"-863,207.70"
,CS,AR,32008684,1005,100,,Cash sale,,,,,,31/08/2018,31/08/2018,0.00,,4.15,,"-863,211.85"
,CS,AR,32008701,1005,100,,Cash sale,,,,,,31/08/2018,31/08/2018,0.00,,9.13,,"-863,220.98"
,CS,AR,32008706,1005,100,,Cash sale,,,,,,31/08/2018,31/08/2018,0.00,,21.86,,"-863,242.84"
,CS,AR,32008737,1005,100,,Cash sale,,,,,,31/08/2018,31/08/2018,0.00,,18.22,,"-863,261.06"
,CS,AR,32008739,1005,100,,Cash sale,,,,,,31/08/2018,31/08/2018,0.00,,3.64,,"-863,264.70"
,CS,AR,32008757,1005,100,,Cash sale,,,,,,31/08/2018,31/08/2018,0.00,,3.01,,"-863,267.71"
,CS,AR,32008766,1005,100,,Cash sale,,,,,,31/08/2018,31/08/2018,0.00,,7.29,,"-863,275.00"
,CS,AR,32008866,1005,100,,Cash sale,,,,,,31/08/2018,31/08/2018,0.00,,7.29,,"-863,282.29"
,IN,AR,30323534,1005,100,,Invoice,,,,,,31/08/2018,31/08/2018,0.00,,11.65,,"-863,293.94"
,IN,AR,30323545,1005,100,,Invoice,,,,,,31/08/2018,31/08/2018,0.00,,5.93,,"-863,299.87"
,IN,AR,30323546,1005,100,,Invoice,,,,,,31/08/2018,31/08/2018,0.00,,29.66,,"-863,329.53"
,IN,AR,30323558,1005,100,,Invoice,,,,,,31/08/2018,31/08/2018,0.00,,36.44,,"-863,365.97"
,IN,AR,30323581,1005,100,,Invoice,,,,,,31/08/2018,31/08/2018,0.00,,19.58,,"-863,385.55"
,IN,AR,30323605,1005,100,,Invoice,,,,,,31/08/2018,31/08/2018,0.00,,7.29,,"-863,392.84"
,IN,AR,30323630,1005,100,,Invoice,,,,,,31/08/2018,31/08/2018,0.00,,21.69,,"-863,414.53"
,IN,AR,30323636,1005,100,,Invoice,,,,,,31/08/2018,31/08/2018,0.00,,43.73,,"-863,458.26"
,IN,AR,30323646,1005,100,,Invoice,,,,,,31/08/2018,31/08/2018,0.00,,"1,896.70",,"-865,354.96"
,IN,AR,30323673,1005,100,,Invoice,,,,,,31/08/2018,31/08/2018,0.00,,12.08,,"-865,367.04"
,IN,AR,30323692,1005,100,,Invoice,,,,,,31/08/2018,31/08/2018,0.00,,84.54,,"-865,451.58"
,IN,AR,30323739,1005,100,,Invoice,,,,,,31/08/2018,31/08/2018,0.00,,35.59,,"-865,487.17"
,IN,AR,30323762,1005,100,,Invoice,,,,,,31/08/2018,31/08/2018,0.00,,"1,808.47",,"-867,295.64"
,IN,AR,30323768,1005,100,,Invoice,,,,,,31/08/2018,31/08/2018,0.00,,14.58,,"-867,310.22"
,IN,AR,30323818,1005,100,,Invoice,,,,,,31/08/2018,31/08/2018,0.00,,32.00,,"-867,342.22"
,IN,AR,30323864,1005,100,,Invoice,,,,,,31/08/2018,31/08/2018,0.00,,5.85,,"-867,348.07"
,IN,AR,30323873,1005,100,,Invoice,,,,,,31/08/2018,31/08/2018,0.00,,4.75,,"-867,352.82"
,IN,AR,30323878,1005,100,,Invoice,,,,,,31/08/2018,31/08/2018,0.00,,74.58,,"-867,427.40"
,IN,AR,30323900,1005,100,,Invoice,,,,,,31/08/2018,31/08/2018,0.00,,338.90,,"-867,766.30"
,IN,AR,30323925,1005,100,,Invoice,,,,,,31/08/2018,31/08/2018,0.00,,5.82,,"-867,772.12"
,IN,AR,30323926,1005,100,,Invoice,,,,,,31/08/2018,31/08/2018,0.00,,15.53,,"-867,787.65"
,IN,AR,30323932,1005,100,,Invoice,,,,,,31/08/2018,31/08/2018,0.00,,86.03,,"-867,873.68"
,IN,AR,30323940,1005,100,,Invoice,,,,,,31/08/2018,31/08/2018,0.00,,364.41,,"-868,238.09"
,IN,AR,30323944,1005,100,,Invoice,,,,,,31/08/2018,31/08/2018,0.00,,46.00,,"-868,284.09"
,IN,AR,30323950,1005,100,,Invoice,,,,,,31/08/2018,31/08/2018,0.00,,3.64,,"-868,287.73"
,IN,AR,30323963,1005,100,,Invoice,,,,,,31/08/2018,31/08/2018,0.00,,32.80,,"-868,320.53"
,IN,AR,30323969,1005,100,,Invoice,,,,,,31/08/2018,31/08/2018,0.00,,11.19,,"-868,331.72"
,IN,AR,30323980,1005,100,,Invoice,,,,,,31/08/2018,31/08/2018,0.00,,102.29,,"-868,434.01"
,IN,AR,30324000,1005,100,,Invoice,,,,,,31/08/2018,31/08/2018,0.00,,7.97,,"-868,441.98"
,IN,AR,30324030,1005,100,,Invoice,,,,,,31/08/2018,31/08/2018,0.00,,7.29,,"-868,449.27"
,IN,AR,30324068,1005,100,,Invoice,,,,,,31/08/2018,31/08/2018,0.00,,"1,422.69",,"-869,871.96"
,IN,AR,30324069,1005,100,,Invoice,,,,,,31/08/2018,31/08/2018,0.00,,80.69,,"-869,952.65"
,IN,AR,30324070,1005,100,,Invoice,,,,,,31/08/2018,31/08/2018,0.00,,7.02,,"-869,959.67"
,IN,AR,30324071,1005,100,,Invoice,,,,,,31/08/2018,31/08/2018,0.00,,15.79,,"-869,975.46"
,IN,AR,30324072,1005,100,,Invoice,,,,,,31/08/2018,31/08/2018,0.00,,98.24,,"-870,073.70"
,IN,AR,30324083,1005,100,,Invoice,,,,,,31/08/2018,31/08/2018,0.00,,21.19,,"-870,094.89"
,IN,AR,30324107,1005,100,,Invoice,,,,,,31/08/2018,31/08/2018,0.00,,18.31,,"-870,113.20"
,IN,AR,30324113,1005,100,,Invoice,,,,,,31/08/2018,31/08/2018,0.00,,311.44,,"-870,424.64"
,IN,AR,30324151,1005,100,,Invoice,,,,,,31/08/2018,31/08/2018,0.00,,28.43,,"-870,453.07"
,IN,AR,30324158,1005,100,,Invoice,,,,,,31/08/2018,31/08/2018,0.00,,4.78,,"-870,457.85"
,IN,AR,30324196,1005,100,,Invoice,,,,,,31/08/2018,31/08/2018,0.00,,6.02,,"-870,463.87"
,IN,AR,30324204,1005,100,,Invoice,,,,,,31/08/2018,31/08/2018,0.00,,"2,058.00",,"-872,521.87"
,IN,AR,30324222,1005,100,,Invoice,,,,,,31/08/2018,31/08/2018,0.00,,65.63,,"-872,587.50"
,IN,AR,30324229,1005,100,,Invoice,,,,,,31/08/2018,31/08/2018,0.00,,28.05,,"-872,615.55"
,IN,AR,30324253,1005,100,,Invoice,,,,,,31/08/2018,31/08/2018,0.00,,9.56,,"-872,625.11"
,IN,AR,30324265,1005,100,,Invoice,,,,,,31/08/2018,31/08/2018,0.00,,19.32,,"-872,644.43"
,IN,AR,30324270,1005,100,,Invoice,,,,,,31/08/2018,31/08/2018,0.00,,77.29,,"-872,721.72"
,IN,AR,30324275,1005,100,,Invoice,,,,,,31/08/2018,31/08/2018,0.00,,85.58,,"-872,807.30"
,IN,AR,30324276,1005,100,,Invoice,,,,,,31/08/2018,31/08/2018,0.00,,8.39,,"-872,815.69"
,IN,AR,30324277,1005,100,,Invoice,,,,,,31/08/2018,31/08/2018,0.00,,10.07,,"-872,825.76"
,IN,AR,30324278,1005,100,,Invoice,,,,,,31/08/2018,31/08/2018,0.00,,11.75,,"-872,837.51"
,IN,AR,30324279,1005,100,,Invoice,,,,,,31/08/2018,31/08/2018,0.00,,13.42,,"-872,850.93"
,IN,AR,30324280,1005,100,,Invoice,,,,,,31/08/2018,31/08/2018,0.00,,8.39,,"-872,859.32"
,IN,AR,30324281,1005,100,,Invoice,,,,,,31/08/2018,31/08/2018,0.00,,3.36,,"-872,862.68"
,IN,AR,30324284,1005,100,,Invoice,,,,,,31/08/2018,31/08/2018,0.00,,9.03,,"-872,871.71"
,IN,AR,30324305,1005,100,,Invoice,,,,,,31/08/2018,31/08/2018,0.00,,9.32,,"-872,881.03"
,IN,AR,30324313,1005,100,,Invoice,,,,,,31/08/2018,31/08/2018,0.00,,7.75,,"-872,888.78"
,IN,AR,30324319,1005,100,,Invoice,,,,,,31/08/2018,31/08/2018,0.00,,9.03,,"-872,897.81"
,IN,AR,30324330,1005,100,,Invoice,,,,,,31/08/2018,31/08/2018,0.00,,157.88,,"-873,055.69"
,IN,AR,30324333,1005,100,,Invoice,,,,,,31/08/2018,31/08/2018,0.00,,236.82,,"-873,292.51"
,IN,AR,30324339,1005,100,,Invoice,,,,,,31/08/2018,31/08/2018,0.00,,48.92,,"-873,341.43"
,IN,AR,30324340,1005,100,,Invoice,,,,,,31/08/2018,31/08/2018,0.00,,64.91,,"-873,406.34"
,IN,AR,30324341,1005,100,,Invoice,,,,,,31/08/2018,31/08/2018,0.00,,233.31,,"-873,639.65"
,IN,AR,30324343,1005,100,,Invoice,,,,,,31/08/2018,31/08/2018,0.00,,63.15,,"-873,702.80"
,IN,AR,30324344,1005,100,,Invoice,,,,,,31/08/2018,31/08/2018,0.00,,216.36,,"-873,919.16"
,IN,AR,30324345,1005,100,,Invoice,,,,,,31/08/2018,31/08/2018,0.00,,13.17,,"-873,932.33"
,IN,AR,30324346,1005,100,,Invoice,,,,,,31/08/2018,31/08/2018,0.00,,33.86,,"-873,966.19"
,IN,AR,30324347,1005,100,,Invoice,,,,,,31/08/2018,31/08/2018,0.00,,31.98,,"-873,998.17"
,IN,AR,30324348,1005,100,,Invoice,,,,,,31/08/2018,31/08/2018,0.00,,20.69,,"-874,018.86"
,IN,AR,30324349,1005,100,,Invoice,,,,,,31/08/2018,31/08/2018,0.00,,22.58,,"-874,041.44"
,IN,AR,30324350,1005,100,,Invoice,,,,,,31/08/2018,31/08/2018,0.00,,54.56,,"-874,096.00"
,IN,AR,30324351,1005,100,,Invoice,,,,,,31/08/2018,31/08/2018,0.00,,7.53,,"-874,103.53"
,IN,AR,30324352,1005,100,,Invoice,,,,,,31/08/2018,31/08/2018,0.00,,7.53,,"-874,111.06"
,IN,AR,30324353,1005,100,,Invoice,,,,,,31/08/2018,31/08/2018,0.00,,9.41,,"-874,120.47"
,IN,AR,30324354,1005,100,,Invoice,,,,,,31/08/2018,31/08/2018,0.00,,15.05,,"-874,135.52"
,IN,AR,30324355,1005,100,,Invoice,,,,,,31/08/2018,31/08/2018,0.00,,392.95,,"-874,528.47"
,IN,AR,30324356,1005,100,,Invoice,,,,,,31/08/2018,31/08/2018,0.00,,78.94,,"-874,607.41"
,IN,AR,30324357,1005,100,,Invoice,,,,,,31/08/2018,31/08/2018,0.00,,38.59,,"-874,646.00"
,IN,AR,30324360,1005,100,,Invoice,,,,,,31/08/2018,31/08/2018,0.00,,16.93,,"-874,662.93"
,IN,AR,30324361,1005,100,,Invoice,,,,,,31/08/2018,31/08/2018,0.00,,56.14,,"-874,719.07"
,IN,AR,30324363,1005,100,,Invoice,,,,,,31/08/2018,31/08/2018,0.00,,47.36,,"-874,766.43"
,IN,AR,30324368,1005,100,,Invoice,,,,,,31/08/2018,31/08/2018,0.00,,17.54,,"-874,783.97"
,IN,AR,30324369,1005,100,,Invoice,,,,,,31/08/2018,31/08/2018,0.00,,24.56,,"-874,808.53"
,IN,AR,30324370,1005,100,,Invoice,,,,,,31/08/2018,31/08/2018,0.00,,28.07,,"-874,836.60"
,IN,AR,30324373,1005,100,,Invoice,,,,,,31/08/2018,31/08/2018,0.00,,2.39,,"-874,838.99"
,IN,AR,30324376,1005,100,,Invoice,,,,,,31/08/2018,31/08/2018,0.00,,8.77,,"-874,847.76"
,IN,AR,30324385,1005,100,,Invoice,,,,,,31/08/2018,31/08/2018,0.00,,5.08,,"-874,852.84"
,IN,AR,30324386,1005,100,,Invoice,,,,,,31/08/2018,31/08/2018,0.00,,10.17,,"-874,863.01"
,IN,AR,30324402,1005,100,,Invoice,,,,,,31/08/2018,31/08/2018,0.00,,35.08,,"-874,898.09"
,IN,AR,30324404,1005,100,,Invoice,,,,,,31/08/2018,31/08/2018,0.00,,7.63,,"-874,905.72"
,IN,AR,30324409,1005,100,,Invoice,,,,,,31/08/2018,31/08/2018,0.00,,14.34,,"-874,920.06"
,IN,AR,30324415,1005,100,,Invoice,,,,,,31/08/2018,31/08/2018,0.00,,405.23,,"-875,325.29"
,IN,AR,30324437,1005,100,,Invoice,,,,,,31/08/2018,31/08/2018,0.00,,143.05,,"-875,468.34"
,IN,AR,30324438,1005,100,,Invoice,,,,,,31/08/2018,31/08/2018,0.00,,23.25,,"-875,491.59"
,IN,AR,30324439,1005,100,,Invoice,,,,,,31/08/2018,31/08/2018,0.00,,84.04,,"-875,575.63"
,IN,AR,30324440,1005,100,,Invoice,,,,,,31/08/2018,31/08/2018,0.00,,51.86,,"-875,627.49"
,IN,AR,30324441,1005,100,,Invoice,,,,,,31/08/2018,31/08/2018,0.00,,53.64,,"-875,681.13"
,IN,AR,30324442,1005,100,,Invoice,,,,,,31/08/2018,31/08/2018,0.00,,35.76,,"-875,716.89"
,IN,AR,30324443,1005,100,,Invoice,,,,,,31/08/2018,31/08/2018,0.00,,44.70,,"-875,761.59"
,IN,AR,30324444,1005,100,,Invoice,,,,,,31/08/2018,31/08/2018,0.00,,73.31,,"-875,834.90"
,IN,AR,30324445,1005,100,,Invoice,,,,,,31/08/2018,31/08/2018,0.00,,311.14,,"-876,146.04"
,IN,AR,30324446,1005,100,,Invoice,,,,,,31/08/2018,31/08/2018,0.00,,10.73,,"-876,156.77"
,IN,AR,30324447,1005,100,,Invoice,,,,,,31/08/2018,31/08/2018,0.00,,19.67,,"-876,176.44"
,IN,AR,30324448,1005,100,,Invoice,,,,,,31/08/2018,31/08/2018,0.00,,23.25,,"-876,199.69"
,IN,AR,30324450,1005,100,,Invoice,,,,,,31/08/2018,31/08/2018,0.00,,53.64,,"-876,253.33"
,IN,AR,30324451,1005,100,,Invoice,,,,,,31/08/2018,31/08/2018,0.00,,103.71,,"-876,357.04"
,IN,AR,30324452,1005,100,,Invoice,,,,,,31/08/2018,31/08/2018,0.00,,42.92,,"-876,399.96"
,IN,AR,30324453,1005,100,,Invoice,,,,,,31/08/2018,31/08/2018,0.00,,14.31,,"-876,414.27"
,IN,AR,30324454,1005,100,,Invoice,,,,,,31/08/2018,31/08/2018,0.00,,10.73,,"-876,425.00"
,IN,AR,30324455,1005,100,,Invoice,,,,,,31/08/2018,31/08/2018,0.00,,28.61,,"-876,453.61"
,IN,AR,30324456,1005,100,,Invoice,,,,,,31/08/2018,31/08/2018,0.00,,25.03,,"-876,478.64"
,IN,AR,30324457,1005,100,,Invoice,,,,,,31/08/2018,31/08/2018,0.00,,7.15,,"-876,485.79"
,IN,AR,30324458,1005,100,,Invoice,,,,,,31/08/2018,31/08/2018,0.00,,44.70,,"-876,530.49"
,IN,AR,30324461,1005,100,,Invoice,,,,,,31/08/2018,31/08/2018,0.00,,163.14,,"-876,693.63"
,IN,AR,30324462,1005,100,,Invoice,,,,,,31/08/2018,31/08/2018,0.00,,236.92,,"-876,930.55"
,IN,AR,30324463,1005,100,,Invoice,,,,,,31/08/2018,31/08/2018,0.00,,71.48,,"-877,002.03"
,IN,AR,30324464,1005,100,,Invoice,,,,,,31/08/2018,31/08/2018,0.00,,10.21,,"-877,012.24"
,IN,AR,30324465,1005,100,,Invoice,,,,,,31/08/2018,31/08/2018,0.00,,16.34,,"-877,028.58"
,IN,AR,30324466,1005,100,,Invoice,,,,,,31/08/2018,31/08/2018,0.00,,220.58,,"-877,249.16"
,IN,AR,30324467,1005,100,,Invoice,,,,,,31/08/2018,31/08/2018,0.00,,67.40,,"-877,316.56"
,IN,AR,30324468,1005,100,,Invoice,,,,,,31/08/2018,31/08/2018,0.00,,412.56,,"-877,729.12"
,IN,AR,30324469,1005,100,,Invoice,,,,,,31/08/2018,31/08/2018,0.00,,6.13,,"-877,735.25"
,IN,AR,30324471,1005,100,,Invoice,,,,,,31/08/2018,31/08/2018,0.00,,20.34,,"-877,755.59"
,IN,AR,30324479,1005,100,,Invoice,,,,,,31/08/2018,31/08/2018,0.00,,8.47,,"-877,764.06"
,IN,AR,30324485,1005,100,,Invoice,,,,,,31/08/2018,31/08/2018,0.00,,12.71,,"-877,776.77"
,IN,AR,30324592,1005,100,,Invoice,,,,,,31/08/2018,31/08/2018,0.00,,10.59,,"-877,787.36"
,IN,AR,30324609,1005,100,,Invoice,,,,,,31/08/2018,31/08/2018,0.00,,12.71,,"-877,800.07"
,IN,AR,30324623,1005,100,,Invoice,,,,,,31/08/2018,31/08/2018,0.00,,24.79,,"-877,824.86"
,IN,AR,30324645,1005,100,,Invoice,,,,,,31/08/2018,31/08/2018,0.00,,6.13,,"-877,830.99"
,IN,AR,30324703,1005,100,,Invoice,,,,,,31/08/2018,31/08/2018,0.00,,"1,229.15",,"-879,060.14"
,IN,AR,30324704,1005,100,,Invoice,,,,,,31/08/2018,31/08/2018,0.00,,931.50,,"-879,991.64"
,IN,AR,30324706,1005,100,,Invoice,,,,,,31/08/2018,31/08/2018,0.00,,407.75,,"-880,399.39"
,IN,AR,30324707,1005,100,,Invoice,,,,,,31/08/2018,31/08/2018,0.00,,95.64,,"-880,495.03"
,IN,AR,30324708,1005,100,,Invoice,,,,,,31/08/2018,31/08/2018,0.00,,42.10,,"-880,537.13"
,IN,AR,30324743,1005,100,,Invoice,,,,,,31/08/2018,31/08/2018,0.00,,6.36,,"-880,543.49"
,IN,AR,30324763,1005,100,,Invoice,,,,,,31/08/2018,31/08/2018,0.00,,10.17,,"-880,553.66"
,IN,AR,30324808,1005,100,,Invoice,,,,,,31/08/2018,31/08/2018,0.00,,30.30,,"-880,583.96"
,IN,AR,30324817,1005,100,,Invoice,,,,,,31/08/2018,31/08/2018,0.00,,7.75,,"-880,591.71"
,IN,AR,30324848,1005,100,,Invoice,,,,,,31/08/2018,31/08/2018,0.00,,7.29,,"-880,599.00"
,IN,AR,30324856,1005,100,,Invoice,,,,,,31/08/2018,31/08/2018,0.00,,85.36,,"-880,684.36"
,IN,AR,30324906,1005,100,,Invoice,,,,,,31/08/2018,31/08/2018,0.00,,149.49,,"-880,833.85"
,IN,AR,30324968,1005,100,,Invoice,,,,,,31/08/2018,31/08/2018,0.00,,4.85,,"-880,838.70"
,IN,AR,30324971,1005,100,,Invoice,,,,,,31/08/2018,31/08/2018,0.00,,10.68,,"-880,849.38"
,IN,AR,30325032,1005,100,,Invoice,,,,,,31/08/2018,31/08/2018,0.00,,911.53,,"-881,760.91"
,IN,AR,30325033,1005,100,,Invoice,,,,,,31/08/2018,31/08/2018,0.00,,365.48,,"-882,126.39"
,IN,AR,30325049,1005,100,,Invoice,,,,,,31/08/2018,31/08/2018,0.00,,83.90,,"-882,210.29"
,IN,AR,30325050,1005,100,,Invoice,,,,,,31/08/2018,31/08/2018,0.00,,23.31,,"-882,233.60"
,IN,AR,30325051,1005,100,,Invoice,,,,,,31/08/2018,31/08/2018,0.00,,46.61,,"-882,280.21"
,IN,AR,30325052,1005,100,,Invoice,,,,,,31/08/2018,31/08/2018,0.00,,13.98,,"-882,294.19"
,IN,AR,30325053,1005,100,,Invoice,,,,,,31/08/2018,31/08/2018,0.00,,55.93,,"-882,350.12"
,IN,AR,30325054,1005,100,,Invoice,,,,,,31/08/2018,31/08/2018,0.00,,41.95,,"-882,392.07"
,IN,AR,30325055,1005,100,,Invoice,,,,,,31/08/2018,31/08/2018,0.00,,55.93,,"-882,448.00"
,IN,AR,30325056,1005,100,,Invoice,,,,,,31/08/2018,31/08/2018,0.00,,11.65,,"-882,459.65"
,IN,AR,30325057,1005,100,,Invoice,,,,,,31/08/2018,31/08/2018,0.00,,46.61,,"-882,506.26"
,IN,AR,30325058,1005,100,,Invoice,,,,,,31/08/2018,31/08/2018,0.00,,30.30,,"-882,536.56"
,IN,AR,30325060,1005,100,,Invoice,,,,,,31/08/2018,31/08/2018,0.00,,751.22,,"-883,287.78"
,IN,AR,30325081,1005,100,,Invoice,,,,,,31/08/2018,31/08/2018,0.00,,9.96,,"-883,297.74"
,IN,AR,30325082,1005,100,,Invoice,,,,,,31/08/2018,31/08/2018,0.00,,15.93,,"-883,313.67"
,IN,AR,30325083,1005,100,,Invoice,,,,,,31/08/2018,31/08/2018,0.00,,11.95,,"-883,325.62"
,IN,AR,30325098,1005,100,,Invoice,,,,,,31/08/2018,31/08/2018,0.00,,36.57,,"-883,362.19"
,IN,AR,30325099,1005,100,,Invoice,,,,,,31/08/2018,31/08/2018,0.00,,23.85,,"-883,386.04"
,IN,AR,30325117,1005,100,,Invoice,,,,,,31/08/2018,31/08/2018,0.00,,34.07,,"-883,420.11"
,IN,AR,30325131,1005,100,,Invoice,,,,,,31/08/2018,31/08/2018,0.00,,16.00,,"-883,436.11"
,IN,AR,30325138,1005,100,,Invoice,,,,,,31/08/2018,31/08/2018,0.00,,44.52,,"-883,480.63"
,IN,AR,30325145,1005,100,,Invoice,,,,,,31/08/2018,31/08/2018,0.00,,5.93,,"-883,486.56"
,IN,AR,30325161,1005,100,,Invoice,,,,,,31/08/2018,31/08/2018,0.00,,20.04,,"-883,506.60"
,IN,AR,30325169,1005,100,,Invoice,,,,,,31/08/2018,31/08/2018,0.00,,456.76,,"-883,963.36"
,IN,AR,30325173,1005,100,,Invoice,,,,,,31/08/2018,31/08/2018,0.00,,14.58,,"-883,977.94"
,IN,AR,30325177,1005,100,,Invoice,,,,,,31/08/2018,31/08/2018,0.00,,8.26,,"-883,986.20"
,IN,AR,30325185,1005,100,,Invoice,,,,,,31/08/2018,31/08/2018,0.00,,189.38,,"-884,175.58"
,IN,AR,30325188,1005,100,,Invoice,,,,,,31/08/2018,31/08/2018,0.00,,24.29,,"-884,199.87"
,IN,AR,30325193,1005,100,,Invoice,,,,,,31/08/2018,31/08/2018,0.00,,3.01,,"-884,202.88"
,IN,AR,30325201,1005,100,,Invoice,,,,,,31/08/2018,31/08/2018,0.00,,23.77,,"-884,226.65"
,IN,AR,30325216,1005,100,,Invoice,,,,,,31/08/2018,31/08/2018,0.00,,28.03,,"-884,254.68"
,IN,AR,30325218,1005,100,,Invoice,,,,,,31/08/2018,31/08/2018,0.00,,10.93,,"-884,265.61"
,IN,AR,30325224,1005,100,,Invoice,,,,,,31/08/2018,31/08/2018,0.00,,42.03,,"-884,307.64"
,IN,AR,30325241,1005,100,,Invoice,,,,,,31/08/2018,31/08/2018,0.00,,266.15,,"-884,573.79"
,IN,AR,30325263,1005,100,,Invoice,,,,,,31/08/2018,31/08/2018,0.00,,21.52,,"-884,595.31"
,IN,AR,30325287,1005,100,,Invoice,,,,,,31/08/2018,31/08/2018,0.00,,22.88,,"-884,618.19"
,IN,AR,30325302,1005,100,,Invoice,,,,,,31/08/2018,31/08/2018,0.00,,6.00,,"-884,624.19"
,IN,AR,30325314,1005,100,,Invoice,,,,,,31/08/2018,31/08/2018,0.00,,16.01,,"-884,640.20"
,IN,AR,30325351,1005,100,,Invoice,,,,,,31/08/2018,31/08/2018,0.00,,42.24,,"-884,682.44"
,IN,AR,30325361,1005,100,,Invoice,,,,,,31/08/2018,31/08/2018,0.00,,182.20,,"-884,864.64"
,IN,AR,30325367,1005,100,,Invoice,,,,,,31/08/2018,31/08/2018,0.00,,90.36,,"-884,955.00"
,IN,AR,30325369,1005,100,,Invoice,,,,,,31/08/2018,31/08/2018,0.00,,32.85,,"-884,987.85"
,IN,AR,30325380,1005,100,,Invoice,,,,,,31/08/2018,31/08/2018,0.00,,33.64,,"-885,021.49"
,IN,AR,30325381,1005,100,,Invoice,,,,,,31/08/2018,31/08/2018,0.00,,8.41,,"-885,029.90"
,IN,AR,30325423,1005,100,,Invoice,,,,,,31/08/2018,31/08/2018,0.00,,37.29,,"-885,067.19"
,IN,AR,30325457,1005,100,,Invoice,,,,,,31/08/2018,31/08/2018,0.00,,5.08,,"-885,072.27"
,IN,AR,30325516,1005,100,,Invoice,,,,,,31/08/2018,31/08/2018,0.00,,10.93,,"-885,083.20"
,IN,AR,30325523,1005,100,,Invoice,,,,,,31/08/2018,31/08/2018,0.00,,14.19,,"-885,097.39"
,IN,AR,30325526,1005,100,,Invoice,,,,,,31/08/2018,31/08/2018,0.00,,9.66,,"-885,107.05"
,IN,AR,30325559,1005,100,,Invoice,,,,,,31/08/2018,31/08/2018,0.00,,28.68,,"-885,135.73"
,IN,AR,30325582,1005,100,,Invoice,,,,,,31/08/2018,31/08/2018,0.00,,762.12,,"-885,897.85"
,IN,AR,30325583,1005,100,,Invoice,,,,,,31/08/2018,31/08/2018,0.00,,11.69,,"-885,909.54"
,IN,AR,30325584,1005,100,,Invoice,,,,,,31/08/2018,31/08/2018,0.00,,11.69,,"-885,921.23"
,IN,AR,30325585,1005,100,,Invoice,,,,,,31/08/2018,31/08/2018,0.00,,27.29,,"-885,948.52"
,IN,AR,30325586,1005,100,,Invoice,,,,,,31/08/2018,31/08/2018,0.00,,38.98,,"-885,987.50"
,IN,AR,30325587,1005,100,,Invoice,,,,,,31/08/2018,31/08/2018,0.00,,13.64,,"-886,001.14"
,IN,AR,30325588,1005,100,,Invoice,,,,,,31/08/2018,31/08/2018,0.00,,21.44,,"-886,022.58"
,IN,AR,30325589,1005,100,,Invoice,,,,,,31/08/2018,31/08/2018,0.00,,15.59,,"-886,038.17"
,IN,AR,30325590,1005,100,,Invoice,,,,,,31/08/2018,31/08/2018,0.00,,15.59,,"-886,053.76"
,IN,AR,30325591,1005,100,,Invoice,,,,,,31/08/2018,31/08/2018,0.00,,13.64,,"-886,067.40"
,IN,AR,30325592,1005,100,,Invoice,,,,,,31/08/2018,31/08/2018,0.00,,25.34,,"-886,092.74"
,IN,AR,30325593,1005,100,,Invoice,,,,,,31/08/2018,31/08/2018,0.00,,17.54,,"-886,110.28"
,IN,AR,30325594,1005,100,,Invoice,,,,,,31/08/2018,31/08/2018,0.00,,15.59,,"-886,125.87"
,IN,AR,30325595,1005,100,,Invoice,,,,,,31/08/2018,31/08/2018,0.00,,89.66,,"-886,215.53"
,IN,AR,30325596,1005,100,,Invoice,,,,,,31/08/2018,31/08/2018,0.00,,15.59,,"-886,231.12"
,IN,AR,30325597,1005,100,,Invoice,,,,,,31/08/2018,31/08/2018,0.00,,13.64,,"-886,244.76"
,IN,AR,30325598,1005,100,,Invoice,,,,,,31/08/2018,31/08/2018,0.00,,25.34,,"-886,270.10"
,IN,AR,30325599,1005,100,,Invoice,,,,,,31/08/2018,31/08/2018,0.00,,7.80,,"-886,277.90"
,IN,AR,30325600,1005,100,,Invoice,,,,,,31/08/2018,31/08/2018,0.00,,11.69,,"-886,289.59"
,IN,AR,30325601,1005,100,,Invoice,,,,,,31/08/2018,31/08/2018,0.00,,9.75,,"-886,299.34"
,IN,AR,30325602,1005,100,,Invoice,,,,,,31/08/2018,31/08/2018,0.00,,3.90,,"-886,303.24"
,IN,AR,30325603,1005,100,,Invoice,,,,,,31/08/2018,31/08/2018,0.00,,727.03,,"-887,030.27"
,IN,AR,30325604,1005,100,,Invoice,,,,,,31/08/2018,31/08/2018,0.00,,50.68,,"-887,080.95"
,IN,AR,30325605,1005,100,,Invoice,,,,,,31/08/2018,31/08/2018,0.00,,56.53,,"-887,137.48"
,IN,AR,30325606,1005,100,,Invoice,,,,,,31/08/2018,31/08/2018,0.00,,762.12,,"-887,899.60"
,IN,AR,30325607,1005,100,,Invoice,,,,,,31/08/2018,31/08/2018,0.00,,15.59,,"-887,915.19"
,IN,AR,30325608,1005,100,,Invoice,,,,,,31/08/2018,31/08/2018,0.00,,13.64,,"-887,928.83"
,IN,AR,30325609,1005,100,,Invoice,,,,,,31/08/2018,31/08/2018,0.00,,5.85,,"-887,934.68"
,IN,AR,30325610,1005,100,,Invoice,,,,,,31/08/2018,31/08/2018,0.00,,38.98,,"-887,973.66"
,IN,AR,30325611,1005,100,,Invoice,,,,,,31/08/2018,31/08/2018,0.00,,85.76,,"-888,059.42"
,IN,AR,30325612,1005,100,,Invoice,,,,,,31/08/2018,31/08/2018,0.00,,17.54,,"-888,076.96"
,IN,AR,30325613,1005,100,,Invoice,,,,,,31/08/2018,31/08/2018,0.00,,19.49,,"-888,096.45"
,IN,AR,30325676,1005,100,,Invoice,,,,,,31/08/2018,31/08/2018,0.00,,9.51,,"-888,105.96"
,IN,AR,30325679,1005,100,,Invoice,,,,,,31/08/2018,31/08/2018,0.00,,8.00,,"-888,113.96"
,IN,AR,30325682,1005,100,,Invoice,,,,,,31/08/2018,31/08/2018,0.00,,13.17,,"-888,127.13"
,IN,AR,30325683,1005,100,,Invoice,,,,,,31/08/2018,31/08/2018,0.00,,18.81,,"-888,145.94"
,IN,AR,30325684,1005,100,,Invoice,,,,,,31/08/2018,31/08/2018,0.00,,9.41,,"-888,155.35"
,IN,AR,30325685,1005,100,,Invoice,,,,,,31/08/2018,31/08/2018,0.00,,11.29,,"-888,166.64"
,IN,AR,30325699,1005,100,,Invoice,,,,,,31/08/2018,31/08/2018,0.00,,29.15,,"-888,195.79"
,IN,AR,30325725,1005,100,,Invoice,,,,,,31/08/2018,31/08/2018,0.00,,813.97,,"-889,009.76"
,IN,AR,30325738,1005,100,,Invoice,,,,,,31/08/2018,31/08/2018,0.00,,8.75,,"-889,018.51"
,IN,AR,30325752,1005,100,,Invoice,,,,,,31/08/2018,31/08/2018,0.00,,13.69,,"-889,032.20"
,IN,AR,30325768,1005,100,,Invoice,,,,,,31/08/2018,31/08/2018,0.00,,38.14,,"-889,070.34"
,IN,AR,30325787,1005,100,,Invoice,,,,,,31/08/2018,31/08/2018,0.00,,306.15,,"-889,376.49"
,IN,AR,30325788,1005,100,,Invoice,,,,,,31/08/2018,31/08/2018,0.00,,295.95,,"-889,672.44"
,IN,AR,30325795,1005,100,,Invoice,,,,,,31/08/2018,31/08/2018,0.00,,265.00,,"-889,937.44"
,IN,AR,30325796,1005,100,,Invoice,,,,,,31/08/2018,31/08/2018,0.00,,197.50,,"-890,134.94"
,IN,AR,30325797,1005,100,,Invoice,,,,,,31/08/2018,31/08/2018,0.00,,457.50,,"-890,592.44"
,IN,AR,30325801,1005,100,,Invoice,,,,,,31/08/2018,31/08/2018,0.00,,10.93,,"-890,603.37"
,IN,AR,30325810,1005,100,,Invoice,,,,,,31/08/2018,31/08/2018,0.00,,29.15,,"-890,632.52"
,IN,AR,30325823,1005,100,,Invoice,,,,,,31/08/2018,31/08/2018,0.00,,8.17,,"-890,640.69"
,IN,AR,30325835,1005,100,,Invoice,,,,,,31/08/2018,31/08/2018,0.00,,10.21,,"-890,650.90"
,IN,AR,30325846,1005,100,,Invoice,,,,,,31/08/2018,31/08/2018,0.00,,36.44,,"-890,687.34"
,IN,AR,30325858,1005,100,,Invoice,,,,,,31/08/2018,31/08/2018,0.00,,5.97,,"-890,693.31"
,IN,AR,30325868,1005,100,,Invoice,,,,,,31/08/2018,31/08/2018,0.00,,68.43,,"-890,761.74"
,IN,AR,30325869,1005,100,,Invoice,,,,,,31/08/2018,31/08/2018,0.00,,24.64,,"-890,786.38"
,IN,AR,30325870,1005,100,,Invoice,,,,,,31/08/2018,31/08/2018,0.00,,19.16,,"-890,805.54"
,IN,AR,30325871,1005,100,,Invoice,,,,,,31/08/2018,31/08/2018,0.00,,10.95,,"-890,816.49"
,IN,AR,30325872,1005,100,,Invoice,,,,,,31/08/2018,31/08/2018,0.00,,13.69,,"-890,830.18"
,IN,AR,30325888,1005,100,,Invoice,,,,,,31/08/2018,31/08/2018,0.00,,2.00,,"-890,832.18"
,IN,AR,30325889,1005,100,,Invoice,,,,,,31/08/2018,31/08/2018,0.00,,2.00,,"-890,834.18"
,IN,AR,30325922,1005,100,,Invoice,,,,,,31/08/2018,31/08/2018,0.00,,20.76,,"-890,854.94"
,IN,AR,30325923,1005,100,,Invoice,,,,,,31/08/2018,31/08/2018,0.00,,126.65,,"-890,981.59"
,IN,AR,30325992,1005,100,,Invoice,,,,,,31/08/2018,31/08/2018,0.00,,9.32,,"-890,990.91"
,IN,AR,30325995,1005,100,,Invoice,,,,,,31/08/2018,31/08/2018,0.00,,15.51,,"-891,006.42"
,IN,AR,30326006,1005,100,,Invoice,,,,,,31/08/2018,31/08/2018,0.00,,3.03,,"-891,009.45"
,IN,AR,30326014,1005,100,,Invoice,,,,,,31/08/2018,31/08/2018,0.00,,14.58,,"-891,024.03"
,IN,AR,30326059,1005,100,,Invoice,,,,,,31/08/2018,31/08/2018,0.00,,187.58,,"-891,211.61"
,IN,AR,30326065,1005,100,,Invoice,,,,,,31/08/2018,31/08/2018,0.00,,7.29,,"-891,218.90"
,IN,AR,30326130,1005,100,,Invoice,,,,,,31/08/2018,31/08/2018,0.00,,3.28,,"-891,222.18"
,IN,AR,30326185,1005,100,,Invoice,,,,,,31/08/2018,31/08/2018,0.00,,7.29,,"-891,229.47"
,IN,AR,30326217,1005,100,,Invoice,,,,,,31/08/2018,31/08/2018,0.00,,36.44,,"-891,265.91"
,IN,AR,30326227,1005,100,,Invoice,,,,,,31/08/2018,31/08/2018,0.00,,29.15,,"-891,295.06"
,CS,AR,32008165,1005,100,,Cash sale,,,,,,01/09/2018,01/09/2018,0.00,,14.58,,"-891,309.64"
,CS,AR,32008245,1005,100,,Cash sale,,,,,,01/09/2018,01/09/2018,0.00,,7.00,,"-891,316.64"
,CS,AR,32008313,1005,100,,Cash sale,,,,,,01/09/2018,01/09/2018,0.00,,3.64,,"-891,320.28"
,CS,AR,32008389,1005,100,,Cash sale,,,,,,01/09/2018,01/09/2018,0.00,,10.93,,"-891,331.21"
,CS,AR,32008441,1005,100,,Cash sale,,,,,,01/09/2018,01/09/2018,0.00,,7.29,,"-891,338.50"
,CS,AR,32008471,1005,100,,Cash sale,,,,,,01/09/2018,01/09/2018,0.00,,7.29,,"-891,345.79"
,CS,AR,32008503,1005,100,,Cash sale,,,,,,01/09/2018,01/09/2018,0.00,,14.58,,"-891,360.37"
,CS,AR,32008595,1005,100,,Cash sale,,,,,,01/09/2018,01/09/2018,0.00,,10.93,,"-891,371.30"
,CS,AR,32008685,1005,100,,Cash sale,,,,,,01/09/2018,01/09/2018,0.00,,7.29,,"-891,378.59"
,CS,AR,32008754,1005,100,,Cash sale,,,,,,01/09/2018,01/09/2018,0.00,,5.85,,"-891,384.44"
,CS,AR,32008778,1005,100,,Cash sale,,,,,,01/09/2018,01/09/2018,0.00,,7.29,,"-891,391.73"
,CS,AR,32008804,1005,100,,Cash sale,,,,,,01/09/2018,01/09/2018,0.00,,3.64,,"-891,395.37"
,CS,AR,32008847,1005,100,,Cash sale,,,,,,01/09/2018,01/09/2018,0.00,,10.93,,"-891,406.30"
,IN,AR,30323740,1005,100,,Invoice,,,,,,01/09/2018,01/09/2018,0.00,,73.56,,"-891,479.86"
,IN,AR,30323937,1005,100,,Invoice,,,,,,01/09/2018,01/09/2018,0.00,,7.29,,"-891,487.15"
,IN,AR,30324520,1005,100,,Invoice,,,,,,01/09/2018,01/09/2018,0.00,,7.29,,"-891,494.44"
,IN,AR,30325003,1005,100,,Invoice,,,,,,01/09/2018,01/09/2018,0.00,,29.15,,"-891,523.59"
,IN,AR,30326036,1005,100,,Invoice,,,,,,01/09/2018,01/09/2018,0.00,,7.29,,"-891,530.88"
,IN,AR,30326094,1005,100,,Invoice,,,,,,01/09/2018,01/09/2018,0.00,,10.93,,"-891,541.81"
,IN,AR,30326166,1005,100,,Invoice,,,,,,01/09/2018,01/09/2018,0.00,,3.64,,"-891,545.45"
,IN,AR,30326220,1005,100,,Invoice,,,,,,01/09/2018,01/09/2018,0.00,,8.90,,"-891,554.35"
,CS,AR,32008764,1005,100,,Cash sale,,,,,,02/09/2018,02/09/2018,0.00,,29.15,,"-891,583.50"
,IN,AR,30325478,1005,100,,Invoice,,,,,,02/09/2018,02/09/2018,0.00,,9.15,,"-891,592.65"
,IN,AR,30326093,1005,100,,Invoice,,,,,,02/09/2018,02/09/2018,0.00,,54.66,,"-891,647.31"
,IN,AR,30326239,1005,100,,Invoice,,,,,,02/09/2018,02/09/2018,0.00,,10.93,,"-891,658.24"
,CN,AR,31018940,1005,100,,Credit Note,,,,,,03/09/2018,03/09/2018,29.15,,0.00,,"-891,629.09"
,CN,AR,31018941,1005,100,,Credit Note,,,,,,03/09/2018,03/09/2018,10.44,,0.00,,"-891,618.65"
,CN,AR,31018948,1005,100,,Credit Note,,,,,,03/09/2018,03/09/2018,29.15,,0.00,,"-891,589.50"
,CS,AR,32007891,1005,100,,Cash sale,,,,,,03/09/2018,03/09/2018,0.00,,14.03,,"-891,603.53"
,CS,AR,32007906,1005,100,,Cash sale,,,,,,03/09/2018,03/09/2018,0.00,,7.12,,"-891,610.65"
,CS,AR,32007910,1005,100,,Cash sale,,,,,,03/09/2018,03/09/2018,0.00,,6.02,,"-891,616.67"
,CS,AR,32007927,1005,100,,Cash sale,,,,,,03/09/2018,03/09/2018,0.00,,7.29,,"-891,623.96"
,CS,AR,32007937,1005,100,,Cash sale,,,,,,03/09/2018,03/09/2018,0.00,,3.64,,"-891,627.60"
,CS,AR,32007943,1005,100,,Cash sale,,,,,,03/09/2018,03/09/2018,0.00,,3.64,,"-891,631.24"
,CS,AR,32007972,1005,100,,Cash sale,,,,,,03/09/2018,03/09/2018,0.00,,75.21,,"-891,706.45"
,CS,AR,32007983,1005,100,,Cash sale,,,,,,03/09/2018,03/09/2018,0.00,,16.91,,"-891,723.36"
,CS,AR,32008008,1005,100,,Cash sale,,,,,,03/09/2018,03/09/2018,0.00,,18.22,,"-891,741.58"
,CS,AR,32008014,1005,100,,Cash sale,,,,,,03/09/2018,03/09/2018,0.00,,14.53,,"-891,756.11"
,CS,AR,32008041,1005,100,,Cash sale,,,,,,03/09/2018,03/09/2018,0.00,,3.64,,"-891,759.75"
,CS,AR,32008046,1005,100,,Cash sale,,,,,,03/09/2018,03/09/2018,0.00,,5.84,,"-891,765.59"
,CS,AR,32008058,1005,100,,Cash sale,,,,,,03/09/2018,03/09/2018,0.00,,7.29,,"-891,772.88"
,CS,AR,32008061,1005,100,,Cash sale,,,,,,03/09/2018,03/09/2018,0.00,,7.29,,"-891,780.17"
,CS,AR,32008074,1005,100,,Cash sale,,,,,,03/09/2018,03/09/2018,0.00,,3.64,,"-891,783.81"
,CS,AR,32008098,1005,100,,Cash sale,,,,,,03/09/2018,03/09/2018,0.00,,3.64,,"-891,787.45"
,CS,AR,32008107,1005,100,,Cash sale,,,,,,03/09/2018,03/09/2018,0.00,,10.34,,"-891,797.79"
,CS,AR,32008132,1005,100,,Cash sale,,,,,,03/09/2018,03/09/2018,0.00,,10.93,,"-891,808.72"
,CS,AR,32008135,1005,100,,Cash sale,,,,,,03/09/2018,03/09/2018,0.00,,10.93,,"-891,819.65"
,CS,AR,32008151,1005,100,,Cash sale,,,,,,03/09/2018,03/09/2018,0.00,,7.63,,"-891,827.28"
,CS,AR,32008190,1005,100,,Cash sale,,,,,,03/09/2018,03/09/2018,0.00,,13.74,,"-891,841.02"
,CS,AR,32008201,1005,100,,Cash sale,,,,,,03/09/2018,03/09/2018,0.00,,10.93,,"-891,851.95"
,CS,AR,32008207,1005,100,,Cash sale,,,,,,03/09/2018,03/09/2018,0.00,,18.05,,"-891,870.00"
,CS,AR,32008208,1005,100,,Cash sale,,,,,,03/09/2018,03/09/2018,0.00,,10.93,,"-891,880.93"
,CS,AR,32008212,1005,100,,Cash sale,,,,,,03/09/2018,03/09/2018,0.00,,4.24,,"-891,885.17"
,CS,AR,32008225,1005,100,,Cash sale,,,,,,03/09/2018,03/09/2018,0.00,,7.29,,"-891,892.46"
,CS,AR,32008238,1005,100,,Cash sale,,,,,,03/09/2018,03/09/2018,0.00,,2.54,,"-891,895.00"
,CS,AR,32008252,1005,100,,Cash sale,,,,,,03/09/2018,03/09/2018,0.00,,20.47,,"-891,915.47"
,CS,AR,32008258,1005,100,,Cash sale,,,,,,03/09/2018,03/09/2018,0.00,,10.88,,"-891,926.35"
,CS,AR,32008268,1005,100,,Cash sale,,,,,,03/09/2018,03/09/2018,0.00,,51.14,,"-891,977.49"
,CS,AR,32008269,1005,100,,Cash sale,,,,,,03/09/2018,03/09/2018,0.00,,18.05,,"-891,995.54"
,CS,AR,32008292,1005,100,,Cash sale,,,,,,03/09/2018,03/09/2018,0.00,,10.93,,"-892,006.47"
,CS,AR,32008306,1005,100,,Cash sale,,,,,,03/09/2018,03/09/2018,0.00,,10.93,,"-892,017.40"
,CS,AR,32008330,1005,100,,Cash sale,,,,,,03/09/2018,03/09/2018,0.00,,3.64,,"-892,021.04"
,CS,AR,32008339,1005,100,,Cash sale,,,,,,03/09/2018,03/09/2018,0.00,,18.39,,"-892,039.43"
,CS,AR,32008342,1005,100,,Cash sale,,,,,,03/09/2018,03/09/2018,0.00,,5.08,,"-892,044.51"
,CS,AR,32008346,1005,100,,Cash sale,,,,,,03/09/2018,03/09/2018,0.00,,6.02,,"-892,050.53"
,CS,AR,32008371,1005,100,,Cash sale,,,,,,03/09/2018,03/09/2018,0.00,,10.34,,"-892,060.87"
,CS,AR,32008397,1005,100,,Cash sale,,,,,,03/09/2018,03/09/2018,0.00,,2.16,,"-892,063.03"
,CS,AR,32008432,1005,100,,Cash sale,,,,,,03/09/2018,03/09/2018,0.00,,3.64,,"-892,066.67"
,CS,AR,32008440,1005,100,,Cash sale,,,,,,03/09/2018,03/09/2018,0.00,,3.20,,"-892,069.87"
,CS,AR,32008446,1005,100,,Cash sale,,,,,,03/09/2018,03/09/2018,0.00,,6.08,,"-892,075.95"
,CS,AR,32008458,1005,100,,Cash sale,,,,,,03/09/2018,03/09/2018,0.00,,15.04,,"-892,090.99"
,CS,AR,32008474,1005,100,,Cash sale,,,,,,03/09/2018,03/09/2018,0.00,,3.64,,"-892,094.63"
,CS,AR,32008510,1005,100,,Cash sale,,,,,,03/09/2018,03/09/2018,0.00,,15.25,,"-892,109.88"
,CS,AR,32008520,1005,100,,Cash sale,,,,,,03/09/2018,03/09/2018,0.00,,14.58,,"-892,124.46"
,CS,AR,32008528,1005,100,,Cash sale,,,,,,03/09/2018,03/09/2018,0.00,,7.29,,"-892,131.75"
,CS,AR,32008567,1005,100,,Cash sale,,,,,,03/09/2018,03/09/2018,0.00,,9.84,,"-892,141.59"
,CS,AR,32008588,1005,100,,Cash sale,,,,,,03/09/2018,03/09/2018,0.00,,11.44,,"-892,153.03"
,CS,AR,32008603,1005,100,,Cash sale,,,,,,03/09/2018,03/09/2018,0.00,,18.22,,"-892,171.25"
,CS,AR,32008658,1005,100,,Cash sale,,,,,,03/09/2018,03/09/2018,0.00,,5.47,,"-892,176.72"
,CS,AR,32008664,1005,100,,Cash sale,,,,,,03/09/2018,03/09/2018,0.00,,10.93,,"-892,187.65"
,CS,AR,32008696,1005,100,,Cash sale,,,,,,03/09/2018,03/09/2018,0.00,,7.29,,"-892,194.94"
,CS,AR,32008703,1005,100,,Cash sale,,,,,,03/09/2018,03/09/2018,0.00,,10.93,,"-892,205.87"
,CS,AR,32008709,1005,100,,Cash sale,,,,,,03/09/2018,03/09/2018,0.00,,3.64,,"-892,209.51"
,CS,AR,32008711,1005,100,,Cash sale,,,,,,03/09/2018,03/09/2018,0.00,,3.28,,"-892,212.79"
,CS,AR,32008756,1005,100,,Cash sale,,,,,,03/09/2018,03/09/2018,0.00,,15.18,,"-892,227.97"
,CS,AR,32008762,1005,100,,Cash sale,,,,,,03/09/2018,03/09/2018,0.00,,3.64,,"-892,231.61"
,CS,AR,32008829,1005,100,,Cash sale,,,,,,03/09/2018,03/09/2018,0.00,,3.03,,"-892,234.64"
,CS,AR,32008856,1005,100,,Cash sale,,,,,,03/09/2018,03/09/2018,0.00,,21.86,,"-892,256.50"
,CS,AR,32008885,1005,100,,Cash sale,,,,,,03/09/2018,03/09/2018,0.00,,36.44,,"-892,292.94"
,IN,AR,30323547,1005,100,,Invoice,,,,,,03/09/2018,03/09/2018,0.00,,59.32,,"-892,352.26"
,IN,AR,30323567,1005,100,,Invoice,,,,,,03/09/2018,03/09/2018,0.00,,21.86,,"-892,374.12"
,IN,AR,30323693,1005,100,,Invoice,,,,,,03/09/2018,03/09/2018,0.00,,27.47,,"-892,401.59"
,IN,AR,30323704,1005,100,,Invoice,,,,,,03/09/2018,03/09/2018,0.00,,14.58,,"-892,416.17"
,IN,AR,30323710,1005,100,,Invoice,,,,,,03/09/2018,03/09/2018,0.00,,18.37,,"-892,434.54"
,IN,AR,30323716,1005,100,,Invoice,,,,,,03/09/2018,03/09/2018,0.00,,52.40,,"-892,486.94"
,IN,AR,30323774,1005,100,,Invoice,,,,,,03/09/2018,03/09/2018,0.00,,40.00,,"-892,526.94"
,IN,AR,30323792,1005,100,,Invoice,,,,,,03/09/2018,03/09/2018,0.00,,59.38,,"-892,586.32"
,IN,AR,30323810,1005,100,,Invoice,,,,,,03/09/2018,03/09/2018,0.00,,3.64,,"-892,589.96"
,IN,AR,30323819,1005,100,,Invoice,,,,,,03/09/2018,03/09/2018,0.00,,50.00,,"-892,639.96"
,IN,AR,30323820,1005,100,,Invoice,,,,,,03/09/2018,03/09/2018,0.00,,28.00,,"-892,667.96"
,IN,AR,30323833,1005,100,,Invoice,,,,,,03/09/2018,03/09/2018,0.00,,8.26,,"-892,676.22"
,IN,AR,30323837,1005,100,,Invoice,,,,,,03/09/2018,03/09/2018,0.00,,48.31,,"-892,724.53"
,IN,AR,30323865,1005,100,,Invoice,,,,,,03/09/2018,03/09/2018,0.00,,8.77,,"-892,733.30"
,IN,AR,30323882,1005,100,,Invoice,,,,,,03/09/2018,03/09/2018,0.00,,10.00,,"-892,743.30"
,IN,AR,30323906,1005,100,,Invoice,,,,,,03/09/2018,03/09/2018,0.00,,11.36,,"-892,754.66"
,IN,AR,30323945,1005,100,,Invoice,,,,,,03/09/2018,03/09/2018,0.00,,26.00,,"-892,780.66"
,IN,AR,30323973,1005,100,,Invoice,,,,,,03/09/2018,03/09/2018,0.00,,22.54,,"-892,803.20"
,IN,AR,30323985,1005,100,,Invoice,,,,,,03/09/2018,03/09/2018,0.00,,36.44,,"-892,839.64"
,IN,AR,30324003,1005,100,,Invoice,,,,,,03/09/2018,03/09/2018,0.00,,25.51,,"-892,865.15"
,IN,AR,30324006,1005,100,,Invoice,,,,,,03/09/2018,03/09/2018,0.00,,31.02,,"-892,896.17"
,IN,AR,30324024,1005,100,,Invoice,,,,,,03/09/2018,03/09/2018,0.00,,7.75,,"-892,903.92"
,IN,AR,30324027,1005,100,,Invoice,,,,,,03/09/2018,03/09/2018,0.00,,3.64,,"-892,907.56"
,IN,AR,30324046,1005,100,,Invoice,,,,,,03/09/2018,03/09/2018,0.00,,7.19,,"-892,914.75"
,IN,AR,30324052,1005,100,,Invoice,,,,,,03/09/2018,03/09/2018,0.00,,16.08,,"-892,930.83"
,IN,AR,30324099,1005,100,,Invoice,,,,,,03/09/2018,03/09/2018,0.00,,4.24,,"-892,935.07"
,IN,AR,30324101,1005,100,,Invoice,,,,,,03/09/2018,03/09/2018,0.00,,54.66,,"-892,989.73"
,IN,AR,30324139,1005,100,,Invoice,,,,,,03/09/2018,03/09/2018,0.00,,10.59,,"-893,000.32"
,IN,AR,30324144,1005,100,,Invoice,,,,,,03/09/2018,03/09/2018,0.00,,16.95,,"-893,017.27"
,IN,AR,30324152,1005,100,,Invoice,,,,,,03/09/2018,03/09/2018,0.00,,31.02,,"-893,048.29"
,IN,AR,30324171,1005,100,,Invoice,,,,,,03/09/2018,03/09/2018,0.00,,11.86,,"-893,060.15"
,IN,AR,30324188,1005,100,,Invoice,,,,,,03/09/2018,03/09/2018,0.00,,3.64,,"-893,063.79"
,IN,AR,30324223,1005,100,,Invoice,,,,,,03/09/2018,03/09/2018,0.00,,84.08,,"-893,147.87"
,IN,AR,30324237,1005,100,,Invoice,,,,,,03/09/2018,03/09/2018,0.00,,48.31,,"-893,196.18"
,IN,AR,30324254,1005,100,,Invoice,,,,,,03/09/2018,03/09/2018,0.00,,23.90,,"-893,220.08"
,IN,AR,30324266,1005,100,,Invoice,,,,,,03/09/2018,03/09/2018,0.00,,28.98,,"-893,249.06"
,IN,AR,30324342,1005,100,,Invoice,,,,,,03/09/2018,03/09/2018,0.00,,5.76,,"-893,254.82"
,IN,AR,30324387,1005,100,,Invoice,,,,,,03/09/2018,03/09/2018,0.00,,7.63,,"-893,262.45"
,IN,AR,30324388,1005,100,,Invoice,,,,,,03/09/2018,03/09/2018,0.00,,15.25,,"-893,277.70"
,IN,AR,30324499,1005,100,,Invoice,,,,,,03/09/2018,03/09/2018,0.00,,7.17,,"-893,284.87"
,IN,AR,30324527,1005,100,,Invoice,,,,,,03/09/2018,03/09/2018,0.00,,33.05,,"-893,317.92"
,IN,AR,30324543,1005,100,,Invoice,,,,,,03/09/2018,03/09/2018,0.00,,14.24,,"-893,332.16"
,IN,AR,30324589,1005,100,,Invoice,,,,,,03/09/2018,03/09/2018,0.00,,10.93,,"-893,343.09"
,IN,AR,30324591,1005,100,,Invoice,,,,,,03/09/2018,03/09/2018,0.00,,77.54,,"-893,420.63"
,IN,AR,30324633,1005,100,,Invoice,,,,,,03/09/2018,03/09/2018,0.00,,7.29,,"-893,427.92"
,IN,AR,30324644,1005,100,,Invoice,,,,,,03/09/2018,03/09/2018,0.00,,54.66,,"-893,482.58"
,IN,AR,30324662,1005,100,,Invoice,,,,,,03/09/2018,03/09/2018,0.00,,11.22,,"-893,493.80"
,IN,AR,30324714,1005,100,,Invoice,,,,,,03/09/2018,03/09/2018,0.00,,7.29,,"-893,501.09"
,IN,AR,30324735,1005,100,,Invoice,,,,,,03/09/2018,03/09/2018,0.00,,8.47,,"-893,509.56"
,IN,AR,30324749,1005,100,,Invoice,,,,,,03/09/2018,03/09/2018,0.00,,182.20,,"-893,691.76"
,IN,AR,30324759,1005,100,,Invoice,,,,,,03/09/2018,03/09/2018,0.00,,75.66,,"-893,767.42"
,IN,AR,30324773,1005,100,,Invoice,,,,,,03/09/2018,03/09/2018,0.00,,18.00,,"-893,785.42"
,IN,AR,30324818,1005,100,,Invoice,,,,,,03/09/2018,03/09/2018,0.00,,7.75,,"-893,793.17"
,IN,AR,30324837,1005,100,,Invoice,,,,,,03/09/2018,03/09/2018,0.00,,42.69,,"-893,835.86"
,IN,AR,30324843,1005,100,,Invoice,,,,,,03/09/2018,03/09/2018,0.00,,21.86,,"-893,857.72"
,IN,AR,30324862,1005,100,,Invoice,,,,,,03/09/2018,03/09/2018,0.00,,14.58,,"-893,872.30"
,IN,AR,30324884,1005,100,,Invoice,,,,,,03/09/2018,03/09/2018,0.00,,51.91,,"-893,924.21"
,IN,AR,30324928,1005,100,,Invoice,,,,,,03/09/2018,03/09/2018,0.00,,728.81,,"-894,653.02"
,IN,AR,30324943,1005,100,,Invoice,,,,,,03/09/2018,03/09/2018,0.00,,3.53,,"-894,656.55"
,IN,AR,30324944,1005,100,,Invoice,,,,,,03/09/2018,03/09/2018,0.00,,1.76,,"-894,658.31"
,IN,AR,30324961,1005,100,,Invoice,,,,,,03/09/2018,03/09/2018,0.00,,3.64,,"-894,661.95"
,IN,AR,30325006,1005,100,,Invoice,,,,,,03/09/2018,03/09/2018,0.00,,10.93,,"-894,672.88"
,IN,AR,30325041,1005,100,,Invoice,,,,,,03/09/2018,03/09/2018,0.00,,4.29,,"-894,677.17"
,IN,AR,30325118,1005,100,,Invoice,,,,,,03/09/2018,03/09/2018,0.00,,42.58,,"-894,719.75"
,IN,AR,30325142,1005,100,,Invoice,,,,,,03/09/2018,03/09/2018,0.00,,2.14,,"-894,721.89"
,IN,AR,30325162,1005,100,,Invoice,,,,,,03/09/2018,03/09/2018,0.00,,26.06,,"-894,747.95"
,IN,AR,30325168,1005,100,,Invoice,,,,,,03/09/2018,03/09/2018,0.00,,7.29,,"-894,755.24"
,IN,AR,30325178,1005,100,,Invoice,,,,,,03/09/2018,03/09/2018,0.00,,42.71,,"-894,797.95"
,IN,AR,30325189,1005,100,,Invoice,,,,,,03/09/2018,03/09/2018,0.00,,18.21,,"-894,816.16"
,IN,AR,30325211,1005,100,,Invoice,,,,,,03/09/2018,03/09/2018,0.00,,9.84,,"-894,826.00"
,IN,AR,30325225,1005,100,,Invoice,,,,,,03/09/2018,03/09/2018,0.00,,26.27,,"-894,852.27"
,IN,AR,30325231,1005,100,,Invoice,,,,,,03/09/2018,03/09/2018,0.00,,4.58,,"-894,856.85"
,IN,AR,30325233,1005,100,,Invoice,,,,,,03/09/2018,03/09/2018,0.00,,29.15,,"-894,886.00"
,IN,AR,30325268,1005,100,,Invoice,,,,,,03/09/2018,03/09/2018,0.00,,29.15,,"-894,915.15"
,IN,AR,30325272,1005,100,,Invoice,,,,,,03/09/2018,03/09/2018,0.00,,21.86,,"-894,937.01"
,IN,AR,30325303,1005,100,,Invoice,,,,,,03/09/2018,03/09/2018,0.00,,12.00,,"-894,949.01"
,IN,AR,30325319,1005,100,,Invoice,,,,,,03/09/2018,03/09/2018,0.00,,16.01,,"-894,965.02"
,IN,AR,30325352,1005,100,,Invoice,,,,,,03/09/2018,03/09/2018,0.00,,33.19,,"-894,998.21"
,IN,AR,30325420,1005,100,,Invoice,,,,,,03/09/2018,03/09/2018,0.00,,50.74,,"-895,048.95"
,IN,AR,30325424,1005,100,,Invoice,,,,,,03/09/2018,03/09/2018,0.00,,186.44,,"-895,235.39"
,IN,AR,30325435,1005,100,,Invoice,,,,,,03/09/2018,03/09/2018,0.00,,14.03,,"-895,249.42"
,IN,AR,30325442,1005,100,,Invoice,,,,,,03/09/2018,03/09/2018,0.00,,16.08,,"-895,265.50"
,IN,AR,30325470,1005,100,,Invoice,,,,,,03/09/2018,03/09/2018,0.00,,20.44,,"-895,285.94"
,IN,AR,30325534,1005,100,,Invoice,,,,,,03/09/2018,03/09/2018,0.00,,34.70,,"-895,320.64"
,IN,AR,30325560,1005,100,,Invoice,,,,,,03/09/2018,03/09/2018,0.00,,9.56,,"-895,330.20"
,IN,AR,30325687,1005,100,,Invoice,,,,,,03/09/2018,03/09/2018,0.00,,1.88,,"-895,332.08"
,IN,AR,30325688,1005,100,,Invoice,,,,,,03/09/2018,03/09/2018,0.00,,7.53,,"-895,339.61"
,IN,AR,30325707,1005,100,,Invoice,,,,,,03/09/2018,03/09/2018,0.00,,13.63,,"-895,353.24"
,IN,AR,30325753,1005,100,,Invoice,,,,,,03/09/2018,03/09/2018,0.00,,8.21,,"-895,361.45"
,IN,AR,30325805,1005,100,,Invoice,,,,,,03/09/2018,03/09/2018,0.00,,2.62,,"-895,364.07"
,IN,AR,30325824,1005,100,,Invoice,,,,,,03/09/2018,03/09/2018,0.00,,4.08,,"-895,368.15"
,IN,AR,30325866,1005,100,,Invoice,,,,,,03/09/2018,03/09/2018,0.00,,35.08,,"-895,403.23"
,IN,AR,30325890,1005,100,,Invoice,,,,,,03/09/2018,03/09/2018,0.00,,2.00,,"-895,405.23"
,IN,AR,30325891,1005,100,,Invoice,,,,,,03/09/2018,03/09/2018,0.00,,4.00,,"-895,409.23"
,IN,AR,30325924,1005,100,,Invoice,,,,,,03/09/2018,03/09/2018,0.00,,4.15,,"-895,413.38"
,IN,AR,30325925,1005,100,,Invoice,,,,,,03/09/2018,03/09/2018,0.00,,8.31,,"-895,421.69"
,IN,AR,30325926,1005,100,,Invoice,,,,,,03/09/2018,03/09/2018,0.00,,4.15,,"-895,425.84"
,IN,AR,30325927,1005,100,,Invoice,,,,,,03/09/2018,03/09/2018,0.00,,4.15,,"-895,429.99"
,IN,AR,30325957,1005,100,,Invoice,,,,,,03/09/2018,03/09/2018,0.00,,29.15,,"-895,459.14"
,IN,AR,30326010,1005,100,,Invoice,,,,,,03/09/2018,03/09/2018,0.00,,61.95,,"-895,521.09"
,IN,AR,30326015,1005,100,,Invoice,,,,,,03/09/2018,03/09/2018,0.00,,7.29,,"-895,528.38"
,IN,AR,30326035,1005,100,,Invoice,,,,,,03/09/2018,03/09/2018,0.00,,5.17,,"-895,533.55"
,IN,AR,30326046,1005,100,,Invoice,,,,,,03/09/2018,03/09/2018,0.00,,10.93,,"-895,544.48"
,IN,AR,30326056,1005,100,,Invoice,,,,,,03/09/2018,03/09/2018,0.00,,1.75,,"-895,546.23"
,IN,AR,30326073,1005,100,,Invoice,,,,,,03/09/2018,03/09/2018,0.00,,29.15,,"-895,575.38"
,IN,AR,30326078,1005,100,,Invoice,,,,,,03/09/2018,03/09/2018,0.00,,18.22,,"-895,593.60"
,IN,AR,30326088,1005,100,,Invoice,,,,,,03/09/2018,03/09/2018,0.00,,44.15,,"-895,637.75"
,IN,AR,30326106,1005,100,,Invoice,,,,,,03/09/2018,03/09/2018,0.00,,29.15,,"-895,666.90"
,IN,AR,30326182,1005,100,,Invoice,,,,,,03/09/2018,03/09/2018,0.00,,27.89,,"-895,694.79"
,IN,AR,30326206,1005,100,,Invoice,,,,,,03/09/2018,03/09/2018,0.00,,7.29,,"-895,702.08"
,IN,AR,30326210,1005,100,,Invoice,,,,,,03/09/2018,03/09/2018,0.00,,182.20,,"-895,884.28"
,CN,AR,31018889,1005,100,,Credit Note,,,,,,04/09/2018,04/09/2018,3.64,,0.00,,"-895,880.64"
,CN,AR,31018937,1005,100,,Credit Note,,,,,,04/09/2018,04/09/2018,29.15,,0.00,,"-895,851.49"
,CN,AR,31018952,1005,100,,Credit Note,,,,,,04/09/2018,04/09/2018,32.80,,0.00,,"-895,818.69"
,CN,AR,31018983,1005,100,,Credit Note,,,,,,04/09/2018,04/09/2018,36.44,,0.00,,"-895,782.25"
,CS,AR,32007917,1005,100,,Cash sale,,,,,,04/09/2018,04/09/2018,0.00,,3.64,,"-895,785.89"
,CS,AR,32007925,1005,100,,Cash sale,,,,,,04/09/2018,04/09/2018,0.00,,14.58,,"-895,800.47"
,CS,AR,32007942,1005,100,,Cash sale,,,,,,04/09/2018,04/09/2018,0.00,,10.93,,"-895,811.40"
,CS,AR,32007954,1005,100,,Cash sale,,,,,,04/09/2018,04/09/2018,0.00,,14.58,,"-895,825.98"
,CS,AR,32007966,1005,100,,Cash sale,,,,,,04/09/2018,04/09/2018,0.00,,18.22,,"-895,844.20"
,CS,AR,32007968,1005,100,,Cash sale,,,,,,04/09/2018,04/09/2018,0.00,,3.64,,"-895,847.84"
,CS,AR,32007977,1005,100,,Cash sale,,,,,,04/09/2018,04/09/2018,0.00,,7.29,,"-895,855.13"
,CS,AR,32007987,1005,100,,Cash sale,,,,,,04/09/2018,04/09/2018,0.00,,6.02,,"-895,861.15"
,CS,AR,32007992,1005,100,,Cash sale,,,,,,04/09/2018,04/09/2018,0.00,,7.29,,"-895,868.44"
,CS,AR,32007997,1005,100,,Cash sale,,,,,,04/09/2018,04/09/2018,0.00,,3.64,,"-895,872.08"
,CS,AR,32008006,1005,100,,Cash sale,,,,,,04/09/2018,04/09/2018,0.00,,7.29,,"-895,879.37"
,CS,AR,32008071,1005,100,,Cash sale,,,,,,04/09/2018,04/09/2018,0.00,,11.19,,"-895,890.56"
,CS,AR,32008115,1005,100,,Cash sale,,,,,,04/09/2018,04/09/2018,0.00,,14.58,,"-895,905.14"
,CS,AR,32008127,1005,100,,Cash sale,,,,,,04/09/2018,04/09/2018,0.00,,4.32,,"-895,909.46"
,CS,AR,32008147,1005,100,,Cash sale,,,,,,04/09/2018,04/09/2018,0.00,,2.58,,"-895,912.04"
,CS,AR,32008154,1005,100,,Cash sale,,,,,,04/09/2018,04/09/2018,0.00,,12.14,,"-895,924.18"
,CS,AR,32008155,1005,100,,Cash sale,,,,,,04/09/2018,04/09/2018,0.00,,7.80,,"-895,931.98"
,CS,AR,32008162,1005,100,,Cash sale,,,,,,04/09/2018,04/09/2018,0.00,,5.17,,"-895,937.15"
,CS,AR,32008167,1005,100,,Cash sale,,,,,,04/09/2018,04/09/2018,0.00,,5.68,,"-895,942.83"
,CS,AR,32008173,1005,100,,Cash sale,,,,,,04/09/2018,04/09/2018,0.00,,10.93,,"-895,953.76"
,CS,AR,32008187,1005,100,,Cash sale,,,,,,04/09/2018,04/09/2018,0.00,,2.58,,"-895,956.34"
,CS,AR,32008215,1005,100,,Cash sale,,,,,,04/09/2018,04/09/2018,0.00,,10.93,,"-895,967.27"
,CS,AR,32008248,1005,100,,Cash sale,,,,,,04/09/2018,04/09/2018,0.00,,6.74,,"-895,974.01"
,CS,AR,32008278,1005,100,,Cash sale,,,,,,04/09/2018,04/09/2018,0.00,,18.22,,"-895,992.23"
,CS,AR,32008280,1005,100,,Cash sale,,,,,,04/09/2018,04/09/2018,0.00,,18.22,,"-896,010.45"
,CS,AR,32008300,1005,100,,Cash sale,,,,,,04/09/2018,04/09/2018,0.00,,10.00,,"-896,020.45"
,CS,AR,32008301,1005,100,,Cash sale,,,,,,04/09/2018,04/09/2018,0.00,,10.93,,"-896,031.38"
,CS,AR,32008302,1005,100,,Cash sale,,,,,,04/09/2018,04/09/2018,0.00,,2.39,,"-896,033.77"
,CS,AR,32008311,1005,100,,Cash sale,,,,,,04/09/2018,04/09/2018,0.00,,14.58,,"-896,048.35"
,CS,AR,32008319,1005,100,,Cash sale,,,,,,04/09/2018,04/09/2018,0.00,,5.08,,"-896,053.43"
,CS,AR,32008321,1005,100,,Cash sale,,,,,,04/09/2018,04/09/2018,0.00,,25.42,,"-896,078.85"
,CS,AR,32008326,1005,100,,Cash sale,,,,,,04/09/2018,04/09/2018,0.00,,15.51,,"-896,094.36"
,CS,AR,32008333,1005,100,,Cash sale,,,,,,04/09/2018,04/09/2018,0.00,,3.64,,"-896,098.00"
,CS,AR,32008392,1005,100,,Cash sale,,,,,,04/09/2018,04/09/2018,0.00,,10.93,,"-896,108.93"
,CS,AR,32008406,1005,100,,Cash sale,,,,,,04/09/2018,04/09/2018,0.00,,7.29,,"-896,116.22"
,CS,AR,32008420,1005,100,,Cash sale,,,,,,04/09/2018,04/09/2018,0.00,,7.29,,"-896,123.51"
,CS,AR,32008430,1005,100,,Cash sale,,,,,,04/09/2018,04/09/2018,0.00,,5.17,,"-896,128.68"
,CS,AR,32008435,1005,100,,Cash sale,,,,,,04/09/2018,04/09/2018,0.00,,7.29,,"-896,135.97"
,CS,AR,32008454,1005,100,,Cash sale,,,,,,04/09/2018,04/09/2018,0.00,,8.34,,"-896,144.31"
,CS,AR,32008456,1005,100,,Cash sale,,,,,,04/09/2018,04/09/2018,0.00,,21.44,,"-896,165.75"
,CS,AR,32008462,1005,100,,Cash sale,,,,,,04/09/2018,04/09/2018,0.00,,5.64,,"-896,171.39"
,CS,AR,32008492,1005,100,,Cash sale,,,,,,04/09/2018,04/09/2018,0.00,,7.29,,"-896,178.68"
,CS,AR,32008493,1005,100,,Cash sale,,,,,,04/09/2018,04/09/2018,0.00,,7.29,,"-896,185.97"
,CS,AR,32008500,1005,100,,Cash sale,,,,,,04/09/2018,04/09/2018,0.00,,7.29,,"-896,193.26"
,CS,AR,32008506,1005,100,,Cash sale,,,,,,04/09/2018,04/09/2018,0.00,,29.15,,"-896,222.41"
,CS,AR,32008522,1005,100,,Cash sale,,,,,,04/09/2018,04/09/2018,0.00,,6.12,,"-896,228.53"
,CS,AR,32008523,1005,100,,Cash sale,,,,,,04/09/2018,04/09/2018,0.00,,29.15,,"-896,257.68"
,CS,AR,32008542,1005,100,,Cash sale,,,,,,04/09/2018,04/09/2018,0.00,,10.17,,"-896,267.85"
,CS,AR,32008600,1005,100,,Cash sale,,,,,,04/09/2018,04/09/2018,0.00,,5.93,,"-896,273.78"
,CS,AR,32008609,1005,100,,Cash sale,,,,,,04/09/2018,04/09/2018,0.00,,17.80,,"-896,291.58"
,CS,AR,32008648,1005,100,,Cash sale,,,,,,04/09/2018,04/09/2018,0.00,,18.22,,"-896,309.80"
,CS,AR,32008650,1005,100,,Cash sale,,,,,,04/09/2018,04/09/2018,0.00,,7.29,,"-896,317.09"
,CS,AR,32008681,1005,100,,Cash sale,,,,,,04/09/2018,04/09/2018,0.00,,10.93,,"-896,328.02"
,CS,AR,32008704,1005,100,,Cash sale,,,,,,04/09/2018,04/09/2018,0.00,,7.29,,"-896,335.31"
,CS,AR,32008721,1005,100,,Cash sale,,,,,,04/09/2018,04/09/2018,0.00,,19.16,,"-896,354.47"
,CS,AR,32008728,1005,100,,Cash sale,,,,,,04/09/2018,04/09/2018,0.00,,8.75,,"-896,363.22"
,CS,AR,32008735,1005,100,,Cash sale,,,,,,04/09/2018,04/09/2018,0.00,,10.93,,"-896,374.15"
,CS,AR,32008752,1005,100,,Cash sale,,,,,,04/09/2018,04/09/2018,0.00,,3.64,,"-896,377.79"
,CS,AR,32008755,1005,100,,Cash sale,,,,,,04/09/2018,04/09/2018,0.00,,10.34,,"-896,388.13"
,CS,AR,32008826,1005,100,,Cash sale,,,,,,04/09/2018,04/09/2018,0.00,,6.19,,"-896,394.32"
,CS,AR,32008833,1005,100,,Cash sale,,,,,,04/09/2018,04/09/2018,0.00,,7.29,,"-896,401.61"
,CS,AR,32008844,1005,100,,Cash sale,,,,,,04/09/2018,04/09/2018,0.00,,7.29,,"-896,408.90"
,CS,AR,32008888,1005,100,,Cash sale,,,,,,04/09/2018,04/09/2018,0.00,,7.29,,"-896,416.19"
,IN,AR,30323606,1005,100,,Invoice,,,,,,04/09/2018,04/09/2018,0.00,,38.47,,"-896,454.66"
,IN,AR,30323614,1005,100,,Invoice,,,,,,04/09/2018,04/09/2018,0.00,,12.15,,"-896,466.81"
,IN,AR,30323615,1005,100,,Invoice,,,,,,04/09/2018,04/09/2018,0.00,,4.05,,"-896,470.86"
,IN,AR,30323616,1005,100,,Invoice,,,,,,04/09/2018,04/09/2018,0.00,,16.20,,"-896,487.06"
,IN,AR,30323617,1005,100,,Invoice,,,,,,04/09/2018,04/09/2018,0.00,,22.28,,"-896,509.34"
,IN,AR,30323618,1005,100,,Invoice,,,,,,04/09/2018,04/09/2018,0.00,,6.08,,"-896,515.42"
,IN,AR,30323619,1005,100,,Invoice,,,,,,04/09/2018,04/09/2018,0.00,,20.25,,"-896,535.67"
,IN,AR,30323620,1005,100,,Invoice,,,,,,04/09/2018,04/09/2018,0.00,,2.03,,"-896,537.70"
,IN,AR,30323686,1005,100,,Invoice,,,,,,04/09/2018,04/09/2018,0.00,,7.00,,"-896,544.70"
,IN,AR,30323724,1005,100,,Invoice,,,,,,04/09/2018,04/09/2018,0.00,,5.97,,"-896,550.67"
,IN,AR,30323741,1005,100,,Invoice,,,,,,04/09/2018,04/09/2018,0.00,,140.00,,"-896,690.67"
,IN,AR,30323752,1005,100,,Invoice,,,,,,04/09/2018,04/09/2018,0.00,,18.22,,"-896,708.89"
,IN,AR,30323754,1005,100,,Invoice,,,,,,04/09/2018,04/09/2018,0.00,,5.51,,"-896,714.40"
,IN,AR,30323755,1005,100,,Invoice,,,,,,04/09/2018,04/09/2018,0.00,,27.54,,"-896,741.94"
,IN,AR,30323785,1005,100,,Invoice,,,,,,04/09/2018,04/09/2018,0.00,,14.58,,"-896,756.52"
,IN,AR,30323831,1005,100,,Invoice,,,,,,04/09/2018,04/09/2018,0.00,,11.86,,"-896,768.38"
,IN,AR,30323840,1005,100,,Invoice,,,,,,04/09/2018,04/09/2018,0.00,,2.75,,"-896,771.13"
,IN,AR,30323898,1005,100,,Invoice,,,,,,04/09/2018,04/09/2018,0.00,,25.51,,"-896,796.64"
,IN,AR,30323912,1005,100,,Invoice,,,,,,04/09/2018,04/09/2018,0.00,,10.93,,"-896,807.57"
,IN,AR,30323917,1005,100,,Invoice,,,,,,04/09/2018,04/09/2018,0.00,,4.07,,"-896,811.64"
,IN,AR,30323921,1005,100,,Invoice,,,,,,04/09/2018,04/09/2018,0.00,,15.51,,"-896,827.15"
,IN,AR,30323955,1005,100,,Invoice,,,,,,04/09/2018,04/09/2018,0.00,,24.73,,"-896,851.88"
,IN,AR,30323958,1005,100,,Invoice,,,,,,04/09/2018,04/09/2018,0.00,,7.29,,"-896,859.17"
,IN,AR,30323966,1005,100,,Invoice,,,,,,04/09/2018,04/09/2018,0.00,,7.29,,"-896,866.46"
,IN,AR,30323981,1005,100,,Invoice,,,,,,04/09/2018,04/09/2018,0.00,,364.41,,"-897,230.87"
,IN,AR,30323987,1005,100,,Invoice,,,,,,04/09/2018,04/09/2018,0.00,,7.29,,"-897,238.16"
,IN,AR,30324031,1005,100,,Invoice,,,,,,04/09/2018,04/09/2018,0.00,,38.44,,"-897,276.60"
,IN,AR,30324035,1005,100,,Invoice,,,,,,04/09/2018,04/09/2018,0.00,,2.32,,"-897,278.92"
,IN,AR,30324047,1005,100,,Invoice,,,,,,04/09/2018,04/09/2018,0.00,,16.79,,"-897,295.71"
,IN,AR,30324048,1005,100,,Invoice,,,,,,04/09/2018,04/09/2018,0.00,,2.40,,"-897,298.11"
,IN,AR,30324054,1005,100,,Invoice,,,,,,04/09/2018,04/09/2018,0.00,,15.25,,"-897,313.36"
,IN,AR,30324075,1005,100,,Invoice,,,,,,04/09/2018,04/09/2018,0.00,,4.32,,"-897,317.68"
,IN,AR,30324084,1005,100,,Invoice,,,,,,04/09/2018,04/09/2018,0.00,,12.71,,"-897,330.39"
,IN,AR,30324124,1005,100,,Invoice,,,,,,04/09/2018,04/09/2018,0.00,,2.12,,"-897,332.51"
,IN,AR,30324212,1005,100,,Invoice,,,,,,04/09/2018,04/09/2018,0.00,,3.90,,"-897,336.41"
,IN,AR,30324255,1005,100,,Invoice,,,,,,04/09/2018,04/09/2018,0.00,,4.78,,"-897,341.19"
,IN,AR,30324297,1005,100,,Invoice,,,,,,04/09/2018,04/09/2018,0.00,,2.75,,"-897,343.94"
,IN,AR,30324306,1005,100,,Invoice,,,,,,04/09/2018,04/09/2018,0.00,,44.28,,"-897,388.22"
,IN,AR,30324322,1005,100,,Invoice,,,,,,04/09/2018,04/09/2018,0.00,,45.13,,"-897,433.35"
,IN,AR,30324389,1005,100,,Invoice,,,,,,04/09/2018,04/09/2018,0.00,,5.08,,"-897,438.43"
,IN,AR,30324426,1005,100,,Invoice,,,,,,04/09/2018,04/09/2018,0.00,,10.17,,"-897,448.60"
,IN,AR,30324433,1005,100,,Invoice,,,,,,04/09/2018,04/09/2018,0.00,,10.93,,"-897,459.53"
,IN,AR,30324434,1005,100,,Invoice,,,,,,04/09/2018,04/09/2018,0.00,,7.29,,"-897,466.82"
,IN,AR,30324474,1005,100,,Invoice,,,,,,04/09/2018,04/09/2018,0.00,,3.64,,"-897,470.46"
,IN,AR,30324497,1005,100,,Invoice,,,,,,04/09/2018,04/09/2018,0.00,,7.29,,"-897,477.75"
,IN,AR,30324501,1005,100,,Invoice,,,,,,04/09/2018,04/09/2018,0.00,,7.80,,"-897,485.55"
,IN,AR,30324510,1005,100,,Invoice,,,,,,04/09/2018,04/09/2018,0.00,,25.85,,"-897,511.40"
,IN,AR,30324516,1005,100,,Invoice,,,,,,04/09/2018,04/09/2018,0.00,,23.14,,"-897,534.54"
,IN,AR,30324539,1005,100,,Invoice,,,,,,04/09/2018,04/09/2018,0.00,,3.01,,"-897,537.55"
,IN,AR,30324555,1005,100,,Invoice,,,,,,04/09/2018,04/09/2018,0.00,,4.96,,"-897,542.51"
,IN,AR,30324567,1005,100,,Invoice,,,,,,04/09/2018,04/09/2018,0.00,,15.25,,"-897,557.76"
,IN,AR,30324577,1005,100,,Invoice,,,,,,04/09/2018,04/09/2018,0.00,,10.53,,"-897,568.29"
,IN,AR,30324580,1005,100,,Invoice,,,,,,04/09/2018,04/09/2018,0.00,,21.98,,"-897,590.27"
,IN,AR,30324581,1005,100,,Invoice,,,,,,04/09/2018,04/09/2018,0.00,,14.58,,"-897,604.85"
,IN,AR,30324586,1005,100,,Invoice,,,,,,04/09/2018,04/09/2018,0.00,,6.02,,"-897,610.87"
,IN,AR,30324597,1005,100,,Invoice,,,,,,04/09/2018,04/09/2018,0.00,,16.95,,"-897,627.82"
,IN,AR,30324602,1005,100,,Invoice,,,,,,04/09/2018,04/09/2018,0.00,,6.36,,"-897,634.18"
,IN,AR,30324605,1005,100,,Invoice,,,,,,04/09/2018,04/09/2018,0.00,,8.47,,"-897,642.65"
,IN,AR,30324618,1005,100,,Invoice,,,,,,04/09/2018,04/09/2018,0.00,,4.24,,"-897,646.89"
,IN,AR,30324630,1005,100,,Invoice,,,,,,04/09/2018,04/09/2018,0.00,,5.51,,"-897,652.40"
,IN,AR,30324658,1005,100,,Invoice,,,,,,04/09/2018,04/09/2018,0.00,,13.78,,"-897,666.18"
,IN,AR,30324679,1005,100,,Invoice,,,,,,04/09/2018,04/09/2018,0.00,,12.71,,"-897,678.89"
,IN,AR,30324705,1005,100,,Invoice,,,,,,04/09/2018,04/09/2018,0.00,,10.93,,"-897,689.82"
,IN,AR,30324756,1005,100,,Invoice,,,,,,04/09/2018,04/09/2018,0.00,,182.20,,"-897,872.02"
,IN,AR,30324767,1005,100,,Invoice,,,,,,04/09/2018,04/09/2018,0.00,,10.93,,"-897,882.95"
,IN,AR,30324778,1005,100,,Invoice,,,,,,04/09/2018,04/09/2018,0.00,,17.54,,"-897,900.49"
,IN,AR,30324812,1005,100,,Invoice,,,,,,04/09/2018,04/09/2018,0.00,,5.59,,"-897,906.08"
,IN,AR,30324866,1005,100,,Invoice,,,,,,04/09/2018,04/09/2018,0.00,,364.41,,"-898,270.49"
,IN,AR,30324901,1005,100,,Invoice,,,,,,04/09/2018,04/09/2018,0.00,,7.29,,"-898,277.78"
,IN,AR,30324921,1005,100,,Invoice,,,,,,04/09/2018,04/09/2018,0.00,,27.87,,"-898,305.65"
,IN,AR,30324945,1005,100,,Invoice,,,,,,04/09/2018,04/09/2018,0.00,,5.29,,"-898,310.94"
,IN,AR,30324966,1005,100,,Invoice,,,,,,04/09/2018,04/09/2018,0.00,,14.58,,"-898,325.52"
,IN,AR,30324980,1005,100,,Invoice,,,,,,04/09/2018,04/09/2018,0.00,,32.80,,"-898,358.32"
,IN,AR,30324981,1005,100,,Invoice,,,,,,04/09/2018,04/09/2018,0.00,,5.17,,"-898,363.49"
,IN,AR,30324985,1005,100,,Invoice,,,,,,04/09/2018,04/09/2018,0.00,,86.86,,"-898,450.35"
,IN,AR,30324988,1005,100,,Invoice,,,,,,04/09/2018,04/09/2018,0.00,,8.21,,"-898,458.56"
,IN,AR,30324998,1005,100,,Invoice,,,,,,04/09/2018,04/09/2018,0.00,,3.64,,"-898,462.20"
,IN,AR,30325100,1005,100,,Invoice,,,,,,04/09/2018,04/09/2018,0.00,,6.36,,"-898,468.56"
,IN,AR,30325101,1005,100,,Invoice,,,,,,04/09/2018,04/09/2018,0.00,,3.18,,"-898,471.74"
,IN,AR,30325123,1005,100,,Invoice,,,,,,04/09/2018,04/09/2018,0.00,,28.00,,"-898,499.74"
,IN,AR,30325132,1005,100,,Invoice,,,,,,04/09/2018,04/09/2018,0.00,,54.00,,"-898,553.74"
,IN,AR,30325206,1005,100,,Invoice,,,,,,04/09/2018,04/09/2018,0.00,,198.97,,"-898,752.71"
,IN,AR,30325266,1005,100,,Invoice,,,,,,04/09/2018,04/09/2018,0.00,,13.67,,"-898,766.38"
,IN,AR,30325278,1005,100,,Invoice,,,,,,04/09/2018,04/09/2018,0.00,,7.29,,"-898,773.67"
,IN,AR,30325288,1005,100,,Invoice,,,,,,04/09/2018,04/09/2018,0.00,,7.63,,"-898,781.30"
,IN,AR,30325308,1005,100,,Invoice,,,,,,04/09/2018,04/09/2018,0.00,,28.01,,"-898,809.31"
,IN,AR,30325363,1005,100,,Invoice,,,,,,04/09/2018,04/09/2018,0.00,,364.41,,"-899,173.72"
,IN,AR,30325366,1005,100,,Invoice,,,,,,04/09/2018,04/09/2018,0.00,,14.58,,"-899,188.30"
,IN,AR,30325382,1005,100,,Invoice,,,,,,04/09/2018,04/09/2018,0.00,,14.72,,"-899,203.02"
,IN,AR,30325406,1005,100,,Invoice,,,,,,04/09/2018,04/09/2018,0.00,,2.33,,"-899,205.35"
,IN,AR,30325430,1005,100,,Invoice,,,,,,04/09/2018,04/09/2018,0.00,,5.47,,"-899,210.82"
,IN,AR,30325440,1005,100,,Invoice,,,,,,04/09/2018,04/09/2018,0.00,,29.15,,"-899,239.97"
,IN,AR,30325479,1005,100,,Invoice,,,,,,04/09/2018,04/09/2018,0.00,,29.15,,"-899,269.12"
,IN,AR,30325490,1005,100,,Invoice,,,,,,04/09/2018,04/09/2018,0.00,,37.97,,"-899,307.09"
,IN,AR,30325508,1005,100,,Invoice,,,,,,04/09/2018,04/09/2018,0.00,,54.66,,"-899,361.75"
,IN,AR,30325578,1005,100,,Invoice,,,,,,04/09/2018,04/09/2018,0.00,,84.07,,"-899,445.82"
,IN,AR,30325616,1005,100,,Invoice,,,,,,04/09/2018,04/09/2018,0.00,,54.07,,"-899,499.89"
,IN,AR,30325622,1005,100,,Invoice,,,,,,04/09/2018,04/09/2018,0.00,,26.10,,"-899,525.99"
,IN,AR,30325623,1005,100,,Invoice,,,,,,04/09/2018,04/09/2018,0.00,,161.36,,"-899,687.35"
,IN,AR,30325624,1005,100,,Invoice,,,,,,04/09/2018,04/09/2018,0.00,,18.98,,"-899,706.33"
,IN,AR,30325647,1005,100,,Invoice,,,,,,04/09/2018,04/09/2018,0.00,,20.34,,"-899,726.67"
,IN,AR,30325695,1005,100,,Invoice,,,,,,04/09/2018,04/09/2018,0.00,,5.26,,"-899,731.93"
,IN,AR,30325701,1005,100,,Invoice,,,,,,04/09/2018,04/09/2018,0.00,,10.00,,"-899,741.93"
,IN,AR,30325716,1005,100,,Invoice,,,,,,04/09/2018,04/09/2018,0.00,,135.14,,"-899,877.07"
,IN,AR,30325735,1005,100,,Invoice,,,,,,04/09/2018,04/09/2018,0.00,,7.02,,"-899,884.09"
,IN,AR,30325749,1005,100,,Invoice,,,,,,04/09/2018,04/09/2018,0.00,,29.15,,"-899,913.24"
,IN,AR,30325766,1005,100,,Invoice,,,,,,04/09/2018,04/09/2018,0.00,,10.93,,"-899,924.17"
,IN,AR,30325799,1005,100,,Invoice,,,,,,04/09/2018,04/09/2018,0.00,,145.76,,"-900,069.93"
,IN,AR,30325825,1005,100,,Invoice,,,,,,04/09/2018,04/09/2018,0.00,,40.85,,"-900,110.78"
,IN,AR,30325826,1005,100,,Invoice,,,,,,04/09/2018,04/09/2018,0.00,,49.02,,"-900,159.80"
,IN,AR,30325859,1005,100,,Invoice,,,,,,04/09/2018,04/09/2018,0.00,,7.97,,"-900,167.77"
,IN,AR,30325896,1005,100,,Invoice,,,,,,04/09/2018,04/09/2018,0.00,,54.66,,"-900,222.43"
,IN,AR,30325928,1005,100,,Invoice,,,,,,04/09/2018,04/09/2018,0.00,,8.31,,"-900,230.74"
,IN,AR,30325929,1005,100,,Invoice,,,,,,04/09/2018,04/09/2018,0.00,,12.46,,"-900,243.20"
,IN,AR,30325930,1005,100,,Invoice,,,,,,04/09/2018,04/09/2018,0.00,,4.15,,"-900,247.35"
,IN,AR,30325961,1005,100,,Invoice,,,,,,04/09/2018,04/09/2018,0.00,,35.59,,"-900,282.94"
,IN,AR,30325970,1005,100,,Invoice,,,,,,04/09/2018,04/09/2018,0.00,,19.32,,"-900,302.26"
,IN,AR,30326008,1005,100,,Invoice,,,,,,04/09/2018,04/09/2018,0.00,,3.64,,"-900,305.90"
,IN,AR,30326031,1005,100,,Invoice,,,,,,04/09/2018,04/09/2018,0.00,,10.17,,"-900,316.07"
,IN,AR,30326058,1005,100,,Invoice,,,,,,04/09/2018,04/09/2018,0.00,,29.15,,"-900,345.22"
,IN,AR,30326062,1005,100,,Invoice,,,,,,04/09/2018,04/09/2018,0.00,,7.29,,"-900,352.51"
,IN,AR,30326099,1005,100,,Invoice,,,,,,04/09/2018,04/09/2018,0.00,,10.93,,"-900,363.44"
,IN,AR,30326121,1005,100,,Invoice,,,,,,04/09/2018,04/09/2018,0.00,,10.93,,"-900,374.37"
,IN,AR,30326137,1005,100,,Invoice,,,,,,04/09/2018,04/09/2018,0.00,,194.17,,"-900,568.54"
,IN,AR,30326155,1005,100,,Invoice,,,,,,04/09/2018,04/09/2018,0.00,,54.66,,"-900,623.20"
,IN,AR,30326207,1005,100,,Invoice,,,,,,04/09/2018,04/09/2018,0.00,,10.93,,"-900,634.13"
,IN,AR,30326241,1005,100,,Invoice,,,,,,04/09/2018,04/09/2018,0.00,,54.66,,"-900,688.79"
,CS,AR,32007901,1005,100,,Cash sale,,,,,,05/09/2018,05/09/2018,0.00,,20.07,,"-900,708.86"
,CS,AR,32007913,1005,100,,Cash sale,,,,,,05/09/2018,05/09/2018,0.00,,22.71,,"-900,731.57"
,CS,AR,32007948,1005,100,,Cash sale,,,,,,05/09/2018,05/09/2018,0.00,,3.64,,"-900,735.21"
,CS,AR,32007979,1005,100,,Cash sale,,,,,,05/09/2018,05/09/2018,0.00,,3.64,,"-900,738.85"
,CS,AR,32007995,1005,100,,Cash sale,,,,,,05/09/2018,05/09/2018,0.00,,3.64,,"-900,742.49"
,CS,AR,32008023,1005,100,,Cash sale,,,,,,05/09/2018,05/09/2018,0.00,,14.58,,"-900,757.07"
,CS,AR,32008036,1005,100,,Cash sale,,,,,,05/09/2018,05/09/2018,0.00,,9.03,,"-900,766.10"
,CS,AR,32008065,1005,100,,Cash sale,,,,,,05/09/2018,05/09/2018,0.00,,3.64,,"-900,769.74"
,CS,AR,32008077,1005,100,,Cash sale,,,,,,05/09/2018,05/09/2018,0.00,,7.29,,"-900,777.03"
,CS,AR,32008087,1005,100,,Cash sale,,,,,,05/09/2018,05/09/2018,0.00,,10.34,,"-900,787.37"
,CS,AR,32008092,1005,100,,Cash sale,,,,,,05/09/2018,05/09/2018,0.00,,5.86,,"-900,793.23"
,CS,AR,32008101,1005,100,,Cash sale,,,,,,05/09/2018,05/09/2018,0.00,,14.58,,"-900,807.81"
,CS,AR,32008111,1005,100,,Cash sale,,,,,,05/09/2018,05/09/2018,0.00,,7.75,,"-900,815.56"
,CS,AR,32008114,1005,100,,Cash sale,,,,,,05/09/2018,05/09/2018,0.00,,7.29,,"-900,822.85"
,CS,AR,32008123,1005,100,,Cash sale,,,,,,05/09/2018,05/09/2018,0.00,,3.64,,"-900,826.49"
,CS,AR,32008158,1005,100,,Cash sale,,,,,,05/09/2018,05/09/2018,0.00,,13.98,,"-900,840.47"
,CS,AR,32008168,1005,100,,Cash sale,,,,,,05/09/2018,05/09/2018,0.00,,12.92,,"-900,853.39"
,CS,AR,32008181,1005,100,,Cash sale,,,,,,05/09/2018,05/09/2018,0.00,,7.29,,"-900,860.68"
,CS,AR,32008194,1005,100,,Cash sale,,,,,,05/09/2018,05/09/2018,0.00,,18.05,,"-900,878.73"
,CS,AR,32008198,1005,100,,Cash sale,,,,,,05/09/2018,05/09/2018,0.00,,8.58,,"-900,887.31"
,CS,AR,32008202,1005,100,,Cash sale,,,,,,05/09/2018,05/09/2018,0.00,,10.93,,"-900,898.24"
,CS,AR,32008210,1005,100,,Cash sale,,,,,,05/09/2018,05/09/2018,0.00,,6.02,,"-900,904.26"
,CS,AR,32008222,1005,100,,Cash sale,,,,,,05/09/2018,05/09/2018,0.00,,10.93,,"-900,915.19"
,CS,AR,32008380,1005,100,,Cash sale,,,,,,05/09/2018,05/09/2018,0.00,,7.29,,"-900,922.48"
,CS,AR,32008413,1005,100,,Cash sale,,,,,,05/09/2018,05/09/2018,0.00,,3.64,,"-900,926.12"
,CS,AR,32008423,1005,100,,Cash sale,,,,,,05/09/2018,05/09/2018,0.00,,7.29,,"-900,933.41"
,CS,AR,32008429,1005,100,,Cash sale,,,,,,05/09/2018,05/09/2018,0.00,,10.93,,"-900,944.34"
,CS,AR,32008455,1005,100,,Cash sale,,,,,,05/09/2018,05/09/2018,0.00,,10.93,,"-900,955.27"
,CS,AR,32008486,1005,100,,Cash sale,,,,,,05/09/2018,05/09/2018,0.00,,5.93,,"-900,961.20"
,CS,AR,32008536,1005,100,,Cash sale,,,,,,05/09/2018,05/09/2018,0.00,,10.93,,"-900,972.13"
,CS,AR,32008539,1005,100,,Cash sale,,,,,,05/09/2018,05/09/2018,0.00,,6.86,,"-900,978.99"
,CS,AR,32008573,1005,100,,Cash sale,,,,,,05/09/2018,05/09/2018,0.00,,6.07,,"-900,985.06"
,CS,AR,32008589,1005,100,,Cash sale,,,,,,05/09/2018,05/09/2018,0.00,,9.15,,"-900,994.21"
,CS,AR,32008665,1005,100,,Cash sale,,,,,,05/09/2018,05/09/2018,0.00,,7.29,,"-901,001.50"
,CS,AR,32008676,1005,100,,Cash sale,,,,,,05/09/2018,05/09/2018,0.00,,5.08,,"-901,006.58"
,CS,AR,32008748,1005,100,,Cash sale,,,,,,05/09/2018,05/09/2018,0.00,,19.24,,"-901,025.82"
,CS,AR,32008890,1005,100,,Cash sale,,,,,,05/09/2018,05/09/2018,0.00,,7.29,,"-901,033.11"
,IN,AR,30323548,1005,100,,Invoice,,,,,,05/09/2018,05/09/2018,0.00,,26.69,,"-901,059.80"
,IN,AR,30323570,1005,100,,Invoice,,,,,,05/09/2018,05/09/2018,0.00,,19.64,,"-901,079.44"
,IN,AR,30323591,1005,100,,Invoice,,,,,,05/09/2018,05/09/2018,0.00,,32.80,,"-901,112.24"
,IN,AR,30323600,1005,100,,Invoice,,,,,,05/09/2018,05/09/2018,0.00,,19.53,,"-901,131.77"
,IN,AR,30323601,1005,100,,Invoice,,,,,,05/09/2018,05/09/2018,0.00,,75.66,,"-901,207.43"
,IN,AR,30323631,1005,100,,Invoice,,,,,,05/09/2018,05/09/2018,0.00,,16.27,,"-901,223.70"
,IN,AR,30323644,1005,100,,Invoice,,,,,,05/09/2018,05/09/2018,0.00,,18.22,,"-901,241.92"
,IN,AR,30323654,1005,100,,Invoice,,,,,,05/09/2018,05/09/2018,0.00,,21.86,,"-901,263.78"
,IN,AR,30323659,1005,100,,Invoice,,,,,,05/09/2018,05/09/2018,0.00,,26.27,,"-901,290.05"
,IN,AR,30323660,1005,100,,Invoice,,,,,,05/09/2018,05/09/2018,0.00,,86.69,,"-901,376.74"
,IN,AR,30323674,1005,100,,Invoice,,,,,,05/09/2018,05/09/2018,0.00,,19.32,,"-901,396.06"
,IN,AR,30323742,1005,100,,Invoice,,,,,,05/09/2018,05/09/2018,0.00,,66.44,,"-901,462.50"
,IN,AR,30323821,1005,100,,Invoice,,,,,,05/09/2018,05/09/2018,0.00,,24.00,,"-901,486.50"
,IN,AR,30323857,1005,100,,Invoice,,,,,,05/09/2018,05/09/2018,0.00,,38.00,,"-901,524.50"
,IN,AR,30323883,1005,100,,Invoice,,,,,,05/09/2018,05/09/2018,0.00,,16.00,,"-901,540.50"
,IN,AR,30323910,1005,100,,Invoice,,,,,,05/09/2018,05/09/2018,0.00,,289.25,,"-901,829.75"
,IN,AR,30323918,1005,100,,Invoice,,,,,,05/09/2018,05/09/2018,0.00,,667.07,,"-902,496.82"
,IN,AR,30323960,1005,100,,Invoice,,,,,,05/09/2018,05/09/2018,0.00,,3.01,,"-902,499.83"
,IN,AR,30323979,1005,100,,Invoice,,,,,,05/09/2018,05/09/2018,0.00,,31.83,,"-902,531.66"
,IN,AR,30323990,1005,100,,Invoice,,,,,,05/09/2018,05/09/2018,0.00,,3.64,,"-902,535.30"
,IN,AR,30324064,1005,100,,Invoice,,,,,,05/09/2018,05/09/2018,0.00,,25.42,,"-902,560.72"
,IN,AR,30324094,1005,100,,Invoice,,,,,,05/09/2018,05/09/2018,0.00,,4.24,,"-902,564.96"
,IN,AR,30324118,1005,100,,Invoice,,,,,,05/09/2018,05/09/2018,0.00,,2.12,,"-902,567.08"
,IN,AR,30324134,1005,100,,Invoice,,,,,,05/09/2018,05/09/2018,0.00,,5.59,,"-902,572.67"
,IN,AR,30324186,1005,100,,Invoice,,,,,,05/09/2018,05/09/2018,0.00,,14.58,,"-902,587.25"
,IN,AR,30324224,1005,100,,Invoice,,,,,,05/09/2018,05/09/2018,0.00,,65.63,,"-902,652.88"
,IN,AR,30324243,1005,100,,Invoice,,,,,,05/09/2018,05/09/2018,0.00,,29.15,,"-902,682.03"
,IN,AR,30324291,1005,100,,Invoice,,,,,,05/09/2018,05/09/2018,0.00,,19.07,,"-902,701.10"
,IN,AR,30324294,1005,100,,Invoice,,,,,,05/09/2018,05/09/2018,0.00,,6.02,,"-902,707.12"
,IN,AR,30324310,1005,100,,Invoice,,,,,,05/09/2018,05/09/2018,0.00,,12.92,,"-902,720.04"
,IN,AR,30324335,1005,100,,Invoice,,,,,,05/09/2018,05/09/2018,0.00,,256.08,,"-902,976.12"
,IN,AR,30324390,1005,100,,Invoice,,,,,,05/09/2018,05/09/2018,0.00,,5.08,,"-902,981.20"
,IN,AR,30324513,1005,100,,Invoice,,,,,,05/09/2018,05/09/2018,0.00,,13.63,,"-902,994.83"
,IN,AR,30324556,1005,100,,Invoice,,,,,,05/09/2018,05/09/2018,0.00,,6.61,,"-903,001.44"
,IN,AR,30324568,1005,100,,Invoice,,,,,,05/09/2018,05/09/2018,0.00,,2.54,,"-903,003.98"
,IN,AR,30324614,1005,100,,Invoice,,,,,,05/09/2018,05/09/2018,0.00,,18.22,,"-903,022.20"
,IN,AR,30324663,1005,100,,Invoice,,,,,,05/09/2018,05/09/2018,0.00,,22.44,,"-903,044.64"
,IN,AR,30324685,1005,100,,Invoice,,,,,,05/09/2018,05/09/2018,0.00,,29.66,,"-903,074.30"
,IN,AR,30324725,1005,100,,Invoice,,,,,,05/09/2018,05/09/2018,0.00,,7.29,,"-903,081.59"
,IN,AR,30324752,1005,100,,Invoice,,,,,,05/09/2018,05/09/2018,0.00,,27.97,,"-903,109.56"
,IN,AR,30324764,1005,100,,Invoice,,,,,,05/09/2018,05/09/2018,0.00,,15.25,,"-903,124.81"
,IN,AR,30324774,1005,100,,Invoice,,,,,,05/09/2018,05/09/2018,0.00,,36.00,,"-903,160.81"
,IN,AR,30324783,1005,100,,Invoice,,,,,,05/09/2018,05/09/2018,0.00,,10.85,,"-903,171.66"
,IN,AR,30324844,1005,100,,Invoice,,,,,,05/09/2018,05/09/2018,0.00,,21.19,,"-903,192.85"
,IN,AR,30324885,1005,100,,Invoice,,,,,,05/09/2018,05/09/2018,0.00,,10.38,,"-903,203.23"
,IN,AR,30324946,1005,100,,Invoice,,,,,,05/09/2018,05/09/2018,0.00,,3.53,,"-903,206.76"
,IN,AR,30324947,1005,100,,Invoice,,,,,,05/09/2018,05/09/2018,0.00,,7.05,,"-903,213.81"
,IN,AR,30324948,1005,100,,Invoice,,,,,,05/09/2018,05/09/2018,0.00,,7.05,,"-903,220.86"
,IN,AR,30324957,1005,100,,Invoice,,,,,,05/09/2018,05/09/2018,0.00,,18.05,,"-903,238.91"
,IN,AR,30324963,1005,100,,Invoice,,,,,,05/09/2018,05/09/2018,0.00,,14.58,,"-903,253.49"
,IN,AR,30324996,1005,100,,Invoice,,,,,,05/09/2018,05/09/2018,0.00,,5.17,,"-903,258.66"
,IN,AR,30325018,1005,100,,Invoice,,,,,,05/09/2018,05/09/2018,0.00,,22.01,,"-903,280.67"
,IN,AR,30325025,1005,100,,Invoice,,,,,,05/09/2018,05/09/2018,0.00,,51.02,,"-903,331.69"
,IN,AR,30325026,1005,100,,Invoice,,,,,,05/09/2018,05/09/2018,0.00,,32.80,,"-903,364.49"
,IN,AR,30325069,1005,100,,Invoice,,,,,,05/09/2018,05/09/2018,0.00,,25.42,,"-903,389.91"
,IN,AR,30325102,1005,100,,Invoice,,,,,,05/09/2018,05/09/2018,0.00,,1.59,,"-903,391.50"
,IN,AR,30325103,1005,100,,Invoice,,,,,,05/09/2018,05/09/2018,0.00,,7.95,,"-903,399.45"
,IN,AR,30325104,1005,100,,Invoice,,,,,,05/09/2018,05/09/2018,0.00,,260.76,,"-903,660.21"
,IN,AR,30325112,1005,100,,Invoice,,,,,,05/09/2018,05/09/2018,0.00,,2.01,,"-903,662.22"
,IN,AR,30325127,1005,100,,Invoice,,,,,,05/09/2018,05/09/2018,0.00,,30.00,,"-903,692.22"
,IN,AR,30325154,1005,100,,Invoice,,,,,,05/09/2018,05/09/2018,0.00,,84.18,,"-903,776.40"
,IN,AR,30325163,1005,100,,Invoice,,,,,,05/09/2018,05/09/2018,0.00,,38.08,,"-903,814.48"
,IN,AR,30325174,1005,100,,Invoice,,,,,,05/09/2018,05/09/2018,0.00,,14.58,,"-903,829.06"
,IN,AR,30325196,1005,100,,Invoice,,,,,,05/09/2018,05/09/2018,0.00,,3.64,,"-903,832.70"
,IN,AR,30325208,1005,100,,Invoice,,,,,,05/09/2018,05/09/2018,0.00,,14.58,,"-903,847.28"
,IN,AR,30325244,1005,100,,Invoice,,,,,,05/09/2018,05/09/2018,0.00,,12.73,,"-903,860.01"
,IN,AR,30325260,1005,100,,Invoice,,,,,,05/09/2018,05/09/2018,0.00,,38.81,,"-903,898.82"
,IN,AR,30325281,1005,100,,Invoice,,,,,,05/09/2018,05/09/2018,0.00,,7.29,,"-903,906.11"
,IN,AR,30325289,1005,100,,Invoice,,,,,,05/09/2018,05/09/2018,0.00,,5.08,,"-903,911.19"
,IN,AR,30325290,1005,100,,Invoice,,,,,,05/09/2018,05/09/2018,0.00,,10.17,,"-903,921.36"
,IN,AR,30325332,1005,100,,Invoice,,,,,,05/09/2018,05/09/2018,0.00,,101.74,,"-904,023.10"
,IN,AR,30325343,1005,100,,Invoice,,,,,,05/09/2018,05/09/2018,0.00,,14.58,,"-904,037.68"
,IN,AR,30325346,1005,100,,Invoice,,,,,,05/09/2018,05/09/2018,0.00,,39.75,,"-904,077.43"
,IN,AR,30325358,1005,100,,Invoice,,,,,,05/09/2018,05/09/2018,0.00,,2.92,,"-904,080.35"
,IN,AR,30325383,1005,100,,Invoice,,,,,,05/09/2018,05/09/2018,0.00,,37.85,,"-904,118.20"
,IN,AR,30325384,1005,100,,Invoice,,,,,,05/09/2018,05/09/2018,0.00,,8.41,,"-904,126.61"
,IN,AR,30325385,1005,100,,Invoice,,,,,,05/09/2018,05/09/2018,0.00,,14.72,,"-904,141.33"
,IN,AR,30325397,1005,100,,Invoice,,,,,,05/09/2018,05/09/2018,0.00,,15.04,,"-904,156.37"
,IN,AR,30325454,1005,100,,Invoice,,,,,,05/09/2018,05/09/2018,0.00,,11.19,,"-904,167.56"
,IN,AR,30325467,1005,100,,Invoice,,,,,,05/09/2018,05/09/2018,0.00,,148.00,,"-904,315.56"
,IN,AR,30325513,1005,100,,Invoice,,,,,,05/09/2018,05/09/2018,0.00,,25.51,,"-904,341.07"
,IN,AR,30325520,1005,100,,Invoice,,,,,,05/09/2018,05/09/2018,0.00,,364.41,,"-904,705.48"
,IN,AR,30325561,1005,100,,Invoice,,,,,,05/09/2018,05/09/2018,0.00,,17.53,,"-904,723.01"
,IN,AR,30325562,1005,100,,Invoice,,,,,,05/09/2018,05/09/2018,0.00,,4.78,,"-904,727.79"
,IN,AR,30325692,1005,100,,Invoice,,,,,,05/09/2018,05/09/2018,0.00,,7.02,,"-904,734.81"
,IN,AR,30325775,1005,100,,Invoice,,,,,,05/09/2018,05/09/2018,0.00,,15.05,,"-904,749.86"
,IN,AR,30325817,1005,100,,Invoice,,,,,,05/09/2018,05/09/2018,0.00,,16.78,,"-904,766.64"
,IN,AR,30325875,1005,100,,Invoice,,,,,,05/09/2018,05/09/2018,0.00,,11.44,,"-904,778.08"
,IN,AR,30325878,1005,100,,Invoice,,,,,,05/09/2018,05/09/2018,0.00,,16.91,,"-904,794.99"
,IN,AR,30325883,1005,100,,Invoice,,,,,,05/09/2018,05/09/2018,0.00,,15.18,,"-904,810.17"
,IN,AR,30325931,1005,100,,Invoice,,,,,,05/09/2018,05/09/2018,0.00,,58.14,,"-904,868.31"
,IN,AR,30325932,1005,100,,Invoice,,,,,,05/09/2018,05/09/2018,0.00,,14.53,,"-904,882.84"
,IN,AR,30325933,1005,100,,Invoice,,,,,,05/09/2018,05/09/2018,0.00,,8.31,,"-904,891.15"
,IN,AR,30325934,1005,100,,Invoice,,,,,,05/09/2018,05/09/2018,0.00,,14.53,,"-904,905.68"
,IN,AR,30325981,1005,100,,Invoice,,,,,,05/09/2018,05/09/2018,0.00,,24.27,,"-904,929.95"
,IN,AR,30326004,1005,100,,Invoice,,,,,,05/09/2018,05/09/2018,0.00,,21.74,,"-904,951.69"
,IN,AR,30326042,1005,100,,Invoice,,,,,,05/09/2018,05/09/2018,0.00,,29.15,,"-904,980.84"
,IN,AR,30326089,1005,100,,Invoice,,,,,,05/09/2018,05/09/2018,0.00,,63.08,,"-905,043.92"
,IN,AR,30326110,1005,100,,Invoice,,,,,,05/09/2018,05/09/2018,0.00,,3.64,,"-905,047.56"
,IN,AR,30326114,1005,100,,Invoice,,,,,,05/09/2018,05/09/2018,0.00,,55.93,,"-905,103.49"
,IN,AR,30326223,1005,100,,Invoice,,,,,,05/09/2018,05/09/2018,0.00,,12.14,,"-905,115.63"
,IN,AR,30326226,1005,100,,Invoice,,,,,,05/09/2018,05/09/2018,0.00,,80.00,,"-905,195.63"
,IN,AR,30326248,1005,100,,Invoice,,,,,,05/09/2018,05/09/2018,0.00,,29.15,,"-905,224.78"
,IN,AR,30326250,1005,100,,Invoice,,,,,,05/09/2018,05/09/2018,0.00,,29.15,,"-905,253.93"
,CN,AR,31018884,1005,100,,Credit Note,,,,,,06/09/2018,06/09/2018,14.19,,0.00,,"-905,239.74"
,CS,AR,32007882,1005,100,,Cash sale,,,,,,06/09/2018,06/09/2018,0.00,,3.01,,"-905,242.75"
,CS,AR,32007885,1005,100,,Cash sale,,,,,,06/09/2018,06/09/2018,0.00,,14.58,,"-905,257.33"
,CS,AR,32007911,1005,100,,Cash sale,,,,,,06/09/2018,06/09/2018,0.00,,3.64,,"-905,260.97"
,CS,AR,32007914,1005,100,,Cash sale,,,,,,06/09/2018,06/09/2018,0.00,,7.29,,"-905,268.26"
,CS,AR,32007952,1005,100,,Cash sale,,,,,,06/09/2018,06/09/2018,0.00,,7.29,,"-905,275.55"
,CS,AR,32007970,1005,100,,Cash sale,,,,,,06/09/2018,06/09/2018,0.00,,7.29,,"-905,282.84"
,CS,AR,32007971,1005,100,,Cash sale,,,,,,06/09/2018,06/09/2018,0.00,,3.64,,"-905,286.48"
,CS,AR,32007990,1005,100,,Cash sale,,,,,,06/09/2018,06/09/2018,0.00,,7.29,,"-905,293.77"
,CS,AR,32008020,1005,100,,Cash sale,,,,,,06/09/2018,06/09/2018,0.00,,7.29,,"-905,301.06"
,CS,AR,32008022,1005,100,,Cash sale,,,,,,06/09/2018,06/09/2018,0.00,,3.64,,"-905,304.70"
,CS,AR,32008043,1005,100,,Cash sale,,,,,,06/09/2018,06/09/2018,0.00,,3.64,,"-905,308.34"
,CS,AR,32008068,1005,100,,Cash sale,,,,,,06/09/2018,06/09/2018,0.00,,18.22,,"-905,326.56"
,CS,AR,32008073,1005,100,,Cash sale,,,,,,06/09/2018,06/09/2018,0.00,,14.58,,"-905,341.14"
,CS,AR,32008088,1005,100,,Cash sale,,,,,,06/09/2018,06/09/2018,0.00,,3.01,,"-905,344.15"
,CS,AR,32008096,1005,100,,Cash sale,,,,,,06/09/2018,06/09/2018,0.00,,10.93,,"-905,355.08"
,CS,AR,32008239,1005,100,,Cash sale,,,,,,06/09/2018,06/09/2018,0.00,,10.17,,"-905,365.25"
,CS,AR,32008277,1005,100,,Cash sale,,,,,,06/09/2018,06/09/2018,0.00,,10.21,,"-905,375.46"
,CS,AR,32008317,1005,100,,Cash sale,,,,,,06/09/2018,06/09/2018,0.00,,7.29,,"-905,382.75"
,CS,AR,32008362,1005,100,,Cash sale,,,,,,06/09/2018,06/09/2018,0.00,,39.15,,"-905,421.90"
,CS,AR,32008374,1005,100,,Cash sale,,,,,,06/09/2018,06/09/2018,0.00,,3.64,,"-905,425.54"
,CS,AR,32008411,1005,100,,Cash sale,,,,,,06/09/2018,06/09/2018,0.00,,6.44,,"-905,431.98"
,CS,AR,32008417,1005,100,,Cash sale,,,,,,06/09/2018,06/09/2018,0.00,,21.86,,"-905,453.84"
,CS,AR,32008436,1005,100,,Cash sale,,,,,,06/09/2018,06/09/2018,0.00,,5.17,,"-905,459.01"
,CS,AR,32008437,1005,100,,Cash sale,,,,,,06/09/2018,06/09/2018,0.00,,10.93,,"-905,469.94"
,CS,AR,32008477,1005,100,,Cash sale,,,,,,06/09/2018,06/09/2018,0.00,,7.29,,"-905,477.23"
,CS,AR,32008525,1005,100,,Cash sale,,,,,,06/09/2018,06/09/2018,0.00,,5.17,,"-905,482.40"
,CS,AR,32008561,1005,100,,Cash sale,,,,,,06/09/2018,06/09/2018,0.00,,5.93,,"-905,488.33"
,CS,AR,32008632,1005,100,,Cash sale,,,,,,06/09/2018,06/09/2018,0.00,,57.68,,"-905,546.01"
,CS,AR,32008710,1005,100,,Cash sale,,,,,,06/09/2018,06/09/2018,0.00,,14.58,,"-905,560.59"
,CS,AR,32008742,1005,100,,Cash sale,,,,,,06/09/2018,06/09/2018,0.00,,7.29,,"-905,567.88"
,CS,AR,32008772,1005,100,,Cash sale,,,,,,06/09/2018,06/09/2018,0.00,,7.29,,"-905,575.17"
,CS,AR,32008834,1005,100,,Cash sale,,,,,,06/09/2018,06/09/2018,0.00,,7.29,,"-905,582.46"
,CS,AR,32008864,1005,100,,Cash sale,,,,,,06/09/2018,06/09/2018,0.00,,14.58,,"-905,597.04"
,CS,AR,32008875,1005,100,,Cash sale,,,,,,06/09/2018,06/09/2018,0.00,,7.29,,"-905,604.33"
,CS,AR,32008876,1005,100,,Cash sale,,,,,,06/09/2018,06/09/2018,0.00,,3.64,,"-905,607.97"
,IN,AR,30323528,1005,100,,Invoice,,,,,,06/09/2018,06/09/2018,0.00,,12.03,,"-905,620.00"
,IN,AR,30323563,1005,100,,Invoice,,,,,,06/09/2018,06/09/2018,0.00,,3.64,,"-905,623.64"
,IN,AR,30323679,1005,100,,Invoice,,,,,,06/09/2018,06/09/2018,0.00,,14.58,,"-905,638.22"
,IN,AR,30323707,1005,100,,Invoice,,,,,,06/09/2018,06/09/2018,0.00,,65.59,,"-905,703.81"
,IN,AR,30323725,1005,100,,Invoice,,,,,,06/09/2018,06/09/2018,0.00,,3.98,,"-905,707.79"
,IN,AR,30323743,1005,100,,Invoice,,,,,,06/09/2018,06/09/2018,0.00,,71.19,,"-905,778.98"
,IN,AR,30323758,1005,100,,Invoice,,,,,,06/09/2018,06/09/2018,0.00,,7.29,,"-905,786.27"
,IN,AR,30323782,1005,100,,Invoice,,,,,,06/09/2018,06/09/2018,0.00,,14.58,,"-905,800.85"
,IN,AR,30323803,1005,100,,Invoice,,,,,,06/09/2018,06/09/2018,0.00,,10.93,,"-905,811.78"
,IN,AR,30323806,1005,100,,Invoice,,,,,,06/09/2018,06/09/2018,0.00,,3.64,,"-905,815.42"
,IN,AR,30323829,1005,100,,Invoice,,,,,,06/09/2018,06/09/2018,0.00,,10.93,,"-905,826.35"
,IN,AR,30323834,1005,100,,Invoice,,,,,,06/09/2018,06/09/2018,0.00,,5.51,,"-905,831.86"
,IN,AR,30323895,1005,100,,Invoice,,,,,,06/09/2018,06/09/2018,0.00,,38.44,,"-905,870.30"
,IN,AR,30323975,1005,100,,Invoice,,,,,,06/09/2018,06/09/2018,0.00,,7.29,,"-905,877.59"
,IN,AR,30324010,1005,100,,Invoice,,,,,,06/09/2018,06/09/2018,0.00,,7.29,,"-905,884.88"
,IN,AR,30324016,1005,100,,Invoice,,,,,,06/09/2018,06/09/2018,0.00,,28.00,,"-905,912.88"
,IN,AR,30324067,1005,100,,Invoice,,,,,,06/09/2018,06/09/2018,0.00,,10.93,,"-905,923.81"
,IN,AR,30324079,1005,100,,Invoice,,,,,,06/09/2018,06/09/2018,0.00,,12.03,,"-905,935.84"
,IN,AR,30324166,1005,100,,Invoice,,,,,,06/09/2018,06/09/2018,0.00,,177.69,,"-906,113.53"
,IN,AR,30324191,1005,100,,Invoice,,,,,,06/09/2018,06/09/2018,0.00,,35.85,,"-906,149.38"
,IN,AR,30324201,1005,100,,Invoice,,,,,,06/09/2018,06/09/2018,0.00,,19.12,,"-906,168.50"
,IN,AR,30324216,1005,100,,Invoice,,,,,,06/09/2018,06/09/2018,0.00,,16.95,,"-906,185.45"
,IN,AR,30324256,1005,100,,Invoice,,,,,,06/09/2018,06/09/2018,0.00,,21.51,,"-906,206.96"
,IN,AR,30324261,1005,100,,Invoice,,,,,,06/09/2018,06/09/2018,0.00,,2.58,,"-906,209.54"
,IN,AR,30324271,1005,100,,Invoice,,,,,,06/09/2018,06/09/2018,0.00,,12.88,,"-906,222.42"
,IN,AR,30324288,1005,100,,Invoice,,,,,,06/09/2018,06/09/2018,0.00,,10.93,,"-906,233.35"
,IN,AR,30324367,1005,100,,Invoice,,,,,,06/09/2018,06/09/2018,0.00,,8.47,,"-906,241.82"
,IN,AR,30324391,1005,100,,Invoice,,,,,,06/09/2018,06/09/2018,0.00,,5.08,,"-906,246.90"
,IN,AR,30324413,1005,100,,Invoice,,,,,,06/09/2018,06/09/2018,0.00,,27.58,,"-906,274.48"
,IN,AR,30324419,1005,100,,Invoice,,,,,,06/09/2018,06/09/2018,0.00,,5.17,,"-906,279.65"
,IN,AR,30324435,1005,100,,Invoice,,,,,,06/09/2018,06/09/2018,0.00,,21.86,,"-906,301.51"
,IN,AR,30324459,1005,100,,Invoice,,,,,,06/09/2018,06/09/2018,0.00,,3.43,,"-906,304.94"
,IN,AR,30324528,1005,100,,Invoice,,,,,,06/09/2018,06/09/2018,0.00,,30.51,,"-906,335.45"
,IN,AR,30324537,1005,100,,Invoice,,,,,,06/09/2018,06/09/2018,0.00,,25.00,,"-906,360.45"
,IN,AR,30324654,1005,100,,Invoice,,,,,,06/09/2018,06/09/2018,0.00,,21.97,,"-906,382.42"
,IN,AR,30324668,1005,100,,Invoice,,,,,,06/09/2018,06/09/2018,0.00,,14.83,,"-906,397.25"
,IN,AR,30324686,1005,100,,Invoice,,,,,,06/09/2018,06/09/2018,0.00,,50.42,,"-906,447.67"
,IN,AR,30324693,1005,100,,Invoice,,,,,,06/09/2018,06/09/2018,0.00,,21.00,,"-906,468.67"
,IN,AR,30324695,1005,100,,Invoice,,,,,,06/09/2018,06/09/2018,0.00,,364.41,,"-906,833.08"
,IN,AR,30324699,1005,100,,Invoice,,,,,,06/09/2018,06/09/2018,0.00,,182.20,,"-907,015.28"
,IN,AR,30324710,1005,100,,Invoice,,,,,,06/09/2018,06/09/2018,0.00,,14.58,,"-907,029.86"
,IN,AR,30324787,1005,100,,Invoice,,,,,,06/09/2018,06/09/2018,0.00,,6.97,,"-907,036.83"
,IN,AR,30324797,1005,100,,Invoice,,,,,,06/09/2018,06/09/2018,0.00,,8.77,,"-907,045.60"
,IN,AR,30324809,1005,100,,Invoice,,,,,,06/09/2018,06/09/2018,0.00,,22.03,,"-907,067.63"
,IN,AR,30324832,1005,100,,Invoice,,,,,,06/09/2018,06/09/2018,0.00,,8.52,,"-907,076.15"
,IN,AR,30324849,1005,100,,Invoice,,,,,,06/09/2018,06/09/2018,0.00,,32.80,,"-907,108.95"
,IN,AR,30324860,1005,100,,Invoice,,,,,,06/09/2018,06/09/2018,0.00,,182.20,,"-907,291.15"
,IN,AR,30324874,1005,100,,Invoice,,,,,,06/09/2018,06/09/2018,0.00,,21.98,,"-907,313.13"
,IN,AR,30324888,1005,100,,Invoice,,,,,,06/09/2018,06/09/2018,0.00,,15.53,,"-907,328.66"
,IN,AR,30324893,1005,100,,Invoice,,,,,,06/09/2018,06/09/2018,0.00,,10.17,,"-907,338.83"
,IN,AR,30324907,1005,100,,Invoice,,,,,,06/09/2018,06/09/2018,0.00,,54.66,,"-907,393.49"
,IN,AR,30324910,1005,100,,Invoice,,,,,,06/09/2018,06/09/2018,0.00,,36.10,,"-907,429.59"
,IN,AR,30324914,1005,100,,Invoice,,,,,,06/09/2018,06/09/2018,0.00,,10.00,,"-907,439.59"
,IN,AR,30324933,1005,100,,Invoice,,,,,,06/09/2018,06/09/2018,0.00,,22.37,,"-907,461.96"
,IN,AR,30324974,1005,100,,Invoice,,,,,,06/09/2018,06/09/2018,0.00,,9.08,,"-907,471.04"
,IN,AR,30324989,1005,100,,Invoice,,,,,,06/09/2018,06/09/2018,0.00,,3.64,,"-907,474.68"
,IN,AR,30325010,1005,100,,Invoice,,,,,,06/09/2018,06/09/2018,0.00,,13.09,,"-907,487.77"
,IN,AR,30325015,1005,100,,Invoice,,,,,,06/09/2018,06/09/2018,0.00,,11.70,,"-907,499.47"
,IN,AR,30325044,1005,100,,Invoice,,,,,,06/09/2018,06/09/2018,0.00,,8.52,,"-907,507.99"
,IN,AR,30325074,1005,100,,Invoice,,,,,,06/09/2018,06/09/2018,0.00,,9.84,,"-907,517.83"
,IN,AR,30325084,1005,100,,Invoice,,,,,,06/09/2018,06/09/2018,0.00,,3.98,,"-907,521.81"
,IN,AR,30325085,1005,100,,Invoice,,,,,,06/09/2018,06/09/2018,0.00,,9.96,,"-907,531.77"
,IN,AR,30325086,1005,100,,Invoice,,,,,,06/09/2018,06/09/2018,0.00,,5.97,,"-907,537.74"
,IN,AR,30325105,1005,100,,Invoice,,,,,,06/09/2018,06/09/2018,0.00,,14.31,,"-907,552.05"
,IN,AR,30325136,1005,100,,Invoice,,,,,,06/09/2018,06/09/2018,0.00,,182.20,,"-907,734.25"
,IN,AR,30325150,1005,100,,Invoice,,,,,,06/09/2018,06/09/2018,0.00,,142.33,,"-907,876.58"
,IN,AR,30325156,1005,100,,Invoice,,,,,,06/09/2018,06/09/2018,0.00,,11.36,,"-907,887.94"
,IN,AR,30325194,1005,100,,Invoice,,,,,,06/09/2018,06/09/2018,0.00,,6.02,,"-907,893.96"
,IN,AR,30325215,1005,100,,Invoice,,,,,,06/09/2018,06/09/2018,0.00,,13.12,,"-907,907.08"
,IN,AR,30325239,1005,100,,Invoice,,,,,,06/09/2018,06/09/2018,0.00,,9.84,,"-907,916.92"
,IN,AR,30325248,1005,100,,Invoice,,,,,,06/09/2018,06/09/2018,0.00,,9.84,,"-907,926.76"
,IN,AR,30325274,1005,100,,Invoice,,,,,,06/09/2018,06/09/2018,0.00,,10.93,,"-907,937.69"
,IN,AR,30325291,1005,100,,Invoice,,,,,,06/09/2018,06/09/2018,0.00,,43.22,,"-907,980.91"
,IN,AR,30325299,1005,100,,Invoice,,,,,,06/09/2018,06/09/2018,0.00,,20.01,,"-908,000.92"
,IN,AR,30325312,1005,100,,Invoice,,,,,,06/09/2018,06/09/2018,0.00,,36.01,,"-908,036.93"
,IN,AR,30325337,1005,100,,Invoice,,,,,,06/09/2018,06/09/2018,0.00,,17.49,,"-908,054.42"
,IN,AR,30325338,1005,100,,Invoice,,,,,,06/09/2018,06/09/2018,0.00,,11.66,,"-908,066.08"
,IN,AR,30325353,1005,100,,Invoice,,,,,,06/09/2018,06/09/2018,0.00,,6.03,,"-908,072.11"
,IN,AR,30325399,1005,100,,Invoice,,,,,,06/09/2018,06/09/2018,0.00,,22.42,,"-908,094.53"
,IN,AR,30325436,1005,100,,Invoice,,,,,,06/09/2018,06/09/2018,0.00,,8.42,,"-908,102.95"
,IN,AR,30325449,1005,100,,Invoice,,,,,,06/09/2018,06/09/2018,0.00,,25.17,,"-908,128.12"
,IN,AR,30325451,1005,100,,Invoice,,,,,,06/09/2018,06/09/2018,0.00,,10.93,,"-908,139.05"
,IN,AR,30325462,1005,100,,Invoice,,,,,,06/09/2018,06/09/2018,0.00,,12.85,,"-908,151.90"
,IN,AR,30325475,1005,100,,Invoice,,,,,,06/09/2018,06/09/2018,0.00,,18.20,,"-908,170.10"
,IN,AR,30325540,1005,100,,Invoice,,,,,,06/09/2018,06/09/2018,0.00,,81.15,,"-908,251.25"
,IN,AR,30325542,1005,100,,Invoice,,,,,,06/09/2018,06/09/2018,0.00,,7.29,,"-908,258.54"
,IN,AR,30325563,1005,100,,Invoice,,,,,,06/09/2018,06/09/2018,0.00,,6.37,,"-908,264.91"
,IN,AR,30325564,1005,100,,Invoice,,,,,,06/09/2018,06/09/2018,0.00,,6.37,,"-908,271.28"
,IN,AR,30325565,1005,100,,Invoice,,,,,,06/09/2018,06/09/2018,0.00,,103.56,,"-908,374.84"
,IN,AR,30325566,1005,100,,Invoice,,,,,,06/09/2018,06/09/2018,0.00,,3.19,,"-908,378.03"
,IN,AR,30325567,1005,100,,Invoice,,,,,,06/09/2018,06/09/2018,0.00,,11.15,,"-908,389.18"
,IN,AR,30325568,1005,100,,Invoice,,,,,,06/09/2018,06/09/2018,0.00,,22.31,,"-908,411.49"
,IN,AR,30325653,1005,100,,Invoice,,,,,,06/09/2018,06/09/2018,0.00,,26.44,,"-908,437.93"
,IN,AR,30325702,1005,100,,Invoice,,,,,,06/09/2018,06/09/2018,0.00,,4.00,,"-908,441.93"
,IN,AR,30325759,1005,100,,Invoice,,,,,,06/09/2018,06/09/2018,0.00,,29.15,,"-908,471.08"
,IN,AR,30325811,1005,100,,Invoice,,,,,,06/09/2018,06/09/2018,0.00,,14.83,,"-908,485.91"
,IN,AR,30325844,1005,100,,Invoice,,,,,,06/09/2018,06/09/2018,0.00,,7.29,,"-908,493.20"
,IN,AR,30325935,1005,100,,Invoice,,,,,,06/09/2018,06/09/2018,0.00,,2.08,,"-908,495.28"
,IN,AR,30325936,1005,100,,Invoice,,,,,,06/09/2018,06/09/2018,0.00,,4.15,,"-908,499.43"
,IN,AR,30325937,1005,100,,Invoice,,,,,,06/09/2018,06/09/2018,0.00,,18.69,,"-908,518.12"
,IN,AR,30325938,1005,100,,Invoice,,,,,,06/09/2018,06/09/2018,0.00,,22.84,,"-908,540.96"
,IN,AR,30326025,1005,100,,Invoice,,,,,,06/09/2018,06/09/2018,0.00,,4.07,,"-908,545.03"
,IN,AR,30326052,1005,100,,Invoice,,,,,,06/09/2018,06/09/2018,0.00,,7.29,,"-908,552.32"
,IN,AR,30326067,1005,100,,Invoice,,,,,,06/09/2018,06/09/2018,0.00,,54.66,,"-908,606.98"
,IN,AR,30326090,1005,100,,Invoice,,,,,,06/09/2018,06/09/2018,0.00,,23.13,,"-908,630.11"
,IN,AR,30326107,1005,100,,Invoice,,,,,,06/09/2018,06/09/2018,0.00,,29.15,,"-908,659.26"
,IN,AR,30326134,1005,100,,Invoice,,,,,,06/09/2018,06/09/2018,0.00,,29.15,,"-908,688.41"
,IN,AR,30326138,1005,100,,Invoice,,,,,,06/09/2018,06/09/2018,0.00,,63.71,,"-908,752.12"
,IN,AR,30326160,1005,100,,Invoice,,,,,,06/09/2018,06/09/2018,0.00,,3.64,,"-908,755.76"
,IN,AR,30326163,1005,100,,Invoice,,,,,,06/09/2018,06/09/2018,0.00,,3.64,,"-908,759.40"
,IN,AR,30326183,1005,100,,Invoice,,,,,,06/09/2018,06/09/2018,0.00,,79.68,,"-908,839.08"
,IN,AR,30326237,1005,100,,Invoice,,,,,,06/09/2018,06/09/2018,0.00,,10.93,,"-908,850.01"
,CN,AR,31018664,1005,100,,Credit Note,,,,,,07/09/2018,07/09/2018,102.03,,0.00,,"-908,747.98"
,CN,AR,31018791,1005,100,,Credit Note,,,,,,07/09/2018,07/09/2018,7.29,,0.00,,"-908,740.69"
,CN,AR,31018863,1005,100,,Credit Note,,,,,,07/09/2018,07/09/2018,9.84,,0.00,,"-908,730.85"
,CS,AR,32007892,1005,100,,Cash sale,,,,,,07/09/2018,07/09/2018,0.00,,8.42,,"-908,739.27"
,CS,AR,32007907,1005,100,,Cash sale,,,,,,07/09/2018,07/09/2018,0.00,,11.86,,"-908,751.13"
,CS,AR,32007920,1005,100,,Cash sale,,,,,,07/09/2018,07/09/2018,0.00,,9.13,,"-908,760.26"
,CS,AR,32007944,1005,100,,Cash sale,,,,,,07/09/2018,07/09/2018,0.00,,7.29,,"-908,767.55"
,CS,AR,32007978,1005,100,,Cash sale,,,,,,07/09/2018,07/09/2018,0.00,,14.58,,"-908,782.13"
,CS,AR,32007984,1005,100,,Cash sale,,,,,,07/09/2018,07/09/2018,0.00,,7.25,,"-908,789.38"
,CS,AR,32008009,1005,100,,Cash sale,,,,,,07/09/2018,07/09/2018,0.00,,10.93,,"-908,800.31"
,CS,AR,32008015,1005,100,,Cash sale,,,,,,07/09/2018,07/09/2018,0.00,,16.61,,"-908,816.92"
,CS,AR,32008028,1005,100,,Cash sale,,,,,,07/09/2018,07/09/2018,0.00,,3.64,,"-908,820.56"
,CS,AR,32008042,1005,100,,Cash sale,,,,,,07/09/2018,07/09/2018,0.00,,10.93,,"-908,831.49"
,CS,AR,32008047,1005,100,,Cash sale,,,,,,07/09/2018,07/09/2018,0.00,,5.84,,"-908,837.33"
,CS,AR,32008052,1005,100,,Cash sale,,,,,,07/09/2018,07/09/2018,0.00,,3.64,,"-908,840.97"
,CS,AR,32008082,1005,100,,Cash sale,,,,,,07/09/2018,07/09/2018,0.00,,7.29,,"-908,848.26"
,CS,AR,32008089,1005,100,,Cash sale,,,,,,07/09/2018,07/09/2018,0.00,,10.93,,"-908,859.19"
,CS,AR,32008104,1005,100,,Cash sale,,,,,,07/09/2018,07/09/2018,0.00,,7.29,,"-908,866.48"
,CS,AR,32008139,1005,100,,Cash sale,,,,,,07/09/2018,07/09/2018,0.00,,29.15,,"-908,895.63"
,CS,AR,32008143,1005,100,,Cash sale,,,,,,07/09/2018,07/09/2018,0.00,,5.17,,"-908,900.80"
,CS,AR,32008152,1005,100,,Cash sale,,,,,,07/09/2018,07/09/2018,0.00,,7.63,,"-908,908.43"
,CS,AR,32008177,1005,100,,Cash sale,,,,,,07/09/2018,07/09/2018,0.00,,71.44,,"-908,979.87"
,CS,AR,32008204,1005,100,,Cash sale,,,,,,07/09/2018,07/09/2018,0.00,,10.93,,"-908,990.80"
,CS,AR,32008218,1005,100,,Cash sale,,,,,,07/09/2018,07/09/2018,0.00,,14.58,,"-909,005.38"
,CS,AR,32008240,1005,100,,Cash sale,,,,,,07/09/2018,07/09/2018,0.00,,7.63,,"-909,013.01"
,CS,AR,32008253,1005,100,,Cash sale,,,,,,07/09/2018,07/09/2018,0.00,,14.62,,"-909,027.63"
,CS,AR,32008259,1005,100,,Cash sale,,,,,,07/09/2018,07/09/2018,0.00,,6.02,,"-909,033.65"
,CS,AR,32008264,1005,100,,Cash sale,,,,,,07/09/2018,07/09/2018,0.00,,7.75,,"-909,041.40"
,CS,AR,32008265,1005,100,,Cash sale,,,,,,07/09/2018,07/09/2018,0.00,,7.17,,"-909,048.57"
,CS,AR,32008270,1005,100,,Cash sale,,,,,,07/09/2018,07/09/2018,0.00,,30.08,,"-909,078.65"
,CS,AR,32008284,1005,100,,Cash sale,,,,,,07/09/2018,07/09/2018,0.00,,15.25,,"-909,093.90"
,CS,AR,32008298,1005,100,,Cash sale,,,,,,07/09/2018,07/09/2018,0.00,,7.29,,"-909,101.19"
,CS,AR,32008314,1005,100,,Cash sale,,,,,,07/09/2018,07/09/2018,0.00,,3.64,,"-909,104.83"
,CS,AR,32008386,1005,100,,Cash sale,,,,,,07/09/2018,07/09/2018,0.00,,25.51,,"-909,130.34"
,CS,AR,32008403,1005,100,,Cash sale,,,,,,07/09/2018,07/09/2018,0.00,,10.93,,"-909,141.27"
,CS,AR,32008427,1005,100,,Cash sale,,,,,,07/09/2018,07/09/2018,0.00,,7.75,,"-909,149.02"
,CS,AR,32008444,1005,100,,Cash sale,,,,,,07/09/2018,07/09/2018,0.00,,7.75,,"-909,156.77"
,CS,AR,32008451,1005,100,,Cash sale,,,,,,07/09/2018,07/09/2018,0.00,,3.64,,"-909,160.41"
,CS,AR,32008470,1005,100,,Cash sale,,,,,,07/09/2018,07/09/2018,0.00,,7.29,,"-909,167.70"
,CS,AR,32008480,1005,100,,Cash sale,,,,,,07/09/2018,07/09/2018,0.00,,10.93,,"-909,178.63"
,CS,AR,32008514,1005,100,,Cash sale,,,,,,07/09/2018,07/09/2018,0.00,,3.01,,"-909,181.64"
,CS,AR,32008519,1005,100,,Cash sale,,,,,,07/09/2018,07/09/2018,0.00,,10.93,,"-909,192.57"
,CS,AR,32008546,1005,100,,Cash sale,,,,,,07/09/2018,07/09/2018,0.00,,7.29,,"-909,199.86"
,CS,AR,32008552,1005,100,,Cash sale,,,,,,07/09/2018,07/09/2018,0.00,,10.17,,"-909,210.03"
,CS,AR,32008566,1005,100,,Cash sale,,,,,,07/09/2018,07/09/2018,0.00,,6.07,,"-909,216.10"
,CS,AR,32008571,1005,100,,Cash sale,,,,,,07/09/2018,07/09/2018,0.00,,2.54,,"-909,218.64"
,CS,AR,32008576,1005,100,,Cash sale,,,,,,07/09/2018,07/09/2018,0.00,,5.18,,"-909,223.82"
,CS,AR,32008582,1005,100,,Cash sale,,,,,,07/09/2018,07/09/2018,0.00,,7.29,,"-909,231.11"
,CS,AR,32008590,1005,100,,Cash sale,,,,,,07/09/2018,07/09/2018,0.00,,6.86,,"-909,237.97"
,CS,AR,32008607,1005,100,,Cash sale,,,,,,07/09/2018,07/09/2018,0.00,,9.10,,"-909,247.07"
,CS,AR,32008617,1005,100,,Cash sale,,,,,,07/09/2018,07/09/2018,0.00,,11.86,,"-909,258.93"
,CS,AR,32008620,1005,100,,Cash sale,,,,,,07/09/2018,07/09/2018,0.00,,7.63,,"-909,266.56"
,CS,AR,32008628,1005,100,,Cash sale,,,,,,07/09/2018,07/09/2018,0.00,,7.29,,"-909,273.85"
,CS,AR,32008633,1005,100,,Cash sale,,,,,,07/09/2018,07/09/2018,0.00,,21.86,,"-909,295.71"
,CS,AR,32008638,1005,100,,Cash sale,,,,,,07/09/2018,07/09/2018,0.00,,18.22,,"-909,313.93"
,CS,AR,32008643,1005,100,,Cash sale,,,,,,07/09/2018,07/09/2018,0.00,,21.25,,"-909,335.18"
,CS,AR,32008646,1005,100,,Cash sale,,,,,,07/09/2018,07/09/2018,0.00,,54.66,,"-909,389.84"
,CS,AR,32008653,1005,100,,Cash sale,,,,,,07/09/2018,07/09/2018,0.00,,3.64,,"-909,393.48"
,CS,AR,32008666,1005,100,,Cash sale,,,,,,07/09/2018,07/09/2018,0.00,,10.93,,"-909,404.41"
,CS,AR,32008672,1005,100,,Cash sale,,,,,,07/09/2018,07/09/2018,0.00,,3.64,,"-909,408.05"
,CS,AR,32008674,1005,100,,Cash sale,,,,,,07/09/2018,07/09/2018,0.00,,14.58,,"-909,422.63"
,CS,AR,32008689,1005,100,,Cash sale,,,,,,07/09/2018,07/09/2018,0.00,,7.29,,"-909,429.92"
,CS,AR,32008694,1005,100,,Cash sale,,,,,,07/09/2018,07/09/2018,0.00,,9.10,,"-909,439.02"
,CS,AR,32008707,1005,100,,Cash sale,,,,,,07/09/2018,07/09/2018,0.00,,14.58,,"-909,453.60"
,CS,AR,32008725,1005,100,,Cash sale,,,,,,07/09/2018,07/09/2018,0.00,,7.29,,"-909,460.89"
,CS,AR,32008730,1005,100,,Cash sale,,,,,,07/09/2018,07/09/2018,0.00,,14.58,,"-909,475.47"
,CS,AR,32008740,1005,100,,Cash sale,,,,,,07/09/2018,07/09/2018,0.00,,3.64,,"-909,479.11"
,CS,AR,32008830,1005,100,,Cash sale,,,,,,07/09/2018,07/09/2018,0.00,,3.03,,"-909,482.14"
,CS,AR,32008878,1005,100,,Cash sale,,,,,,07/09/2018,07/09/2018,0.00,,7.29,,"-909,489.43"
,IN,AR,30323537,1005,100,,Invoice,,,,,,07/09/2018,07/09/2018,0.00,,7.29,,"-909,496.72"
,IN,AR,30323549,1005,100,,Invoice,,,,,,07/09/2018,07/09/2018,0.00,,5.93,,"-909,502.65"
,IN,AR,30323550,1005,100,,Invoice,,,,,,07/09/2018,07/09/2018,0.00,,41.53,,"-909,544.18"
,IN,AR,30323559,1005,100,,Invoice,,,,,,07/09/2018,07/09/2018,0.00,,36.44,,"-909,580.62"
,IN,AR,30323572,1005,100,,Invoice,,,,,,07/09/2018,07/09/2018,0.00,,23.73,,"-909,604.35"
,IN,AR,30323582,1005,100,,Invoice,,,,,,07/09/2018,07/09/2018,0.00,,19.58,,"-909,623.93"
,IN,AR,30323637,1005,100,,Invoice,,,,,,07/09/2018,07/09/2018,0.00,,25.51,,"-909,649.44"
,IN,AR,30323649,1005,100,,Invoice,,,,,,07/09/2018,07/09/2018,0.00,,3.64,,"-909,653.08"
,IN,AR,30323668,1005,100,,Invoice,,,,,,07/09/2018,07/09/2018,0.00,,7.29,,"-909,660.37"
,IN,AR,30323675,1005,100,,Invoice,,,,,,07/09/2018,07/09/2018,0.00,,12.08,,"-909,672.45"
,IN,AR,30323694,1005,100,,Invoice,,,,,,07/09/2018,07/09/2018,0.00,,31.70,,"-909,704.15"
,IN,AR,30323711,1005,100,,Invoice,,,,,,07/09/2018,07/09/2018,0.00,,13.78,,"-909,717.93"
,IN,AR,30323717,1005,100,,Invoice,,,,,,07/09/2018,07/09/2018,0.00,,126.14,,"-909,844.07"
,IN,AR,30323744,1005,100,,Invoice,,,,,,07/09/2018,07/09/2018,0.00,,102.03,,"-909,946.10"
,IN,AR,30323745,1005,100,,Invoice,,,,,,07/09/2018,07/09/2018,0.00,,83.05,,"-910,029.15"
,IN,AR,30323775,1005,100,,Invoice,,,,,,07/09/2018,07/09/2018,0.00,,104.00,,"-910,133.15"
,IN,AR,30323801,1005,100,,Invoice,,,,,,07/09/2018,07/09/2018,0.00,,61.95,,"-910,195.10"
,IN,AR,30323822,1005,100,,Invoice,,,,,,07/09/2018,07/09/2018,0.00,,46.00,,"-910,241.10"
,IN,AR,30323874,1005,100,,Invoice,,,,,,07/09/2018,07/09/2018,0.00,,80.68,,"-910,321.78"
,IN,AR,30323875,1005,100,,Invoice,,,,,,07/09/2018,07/09/2018,0.00,,7.12,,"-910,328.90"
,IN,AR,30323884,1005,100,,Invoice,,,,,,07/09/2018,07/09/2018,0.00,,6.00,,"-910,334.90"
,IN,AR,30323927,1005,100,,Invoice,,,,,,07/09/2018,07/09/2018,0.00,,11.64,,"-910,346.54"
,IN,AR,30323928,1005,100,,Invoice,,,,,,07/09/2018,07/09/2018,0.00,,5.82,,"-910,352.36"
,IN,AR,30323946,1005,100,,Invoice,,,,,,07/09/2018,07/09/2018,0.00,,52.00,,"-910,404.36"
,IN,AR,30323951,1005,100,,Invoice,,,,,,07/09/2018,07/09/2018,0.00,,7.29,,"-910,411.65"
,IN,AR,30323964,1005,100,,Invoice,,,,,,07/09/2018,07/09/2018,0.00,,25.51,,"-910,437.16"
,IN,AR,30323970,1005,100,,Invoice,,,,,,07/09/2018,07/09/2018,0.00,,11.19,,"-910,448.35"
,IN,AR,30324021,1005,100,,Invoice,,,,,,07/09/2018,07/09/2018,0.00,,10.34,,"-910,458.69"
,IN,AR,30324057,1005,100,,Invoice,,,,,,07/09/2018,07/09/2018,0.00,,14.58,,"-910,473.27"
,IN,AR,30324153,1005,100,,Invoice,,,,,,07/09/2018,07/09/2018,0.00,,36.19,,"-910,509.46"
,IN,AR,30324159,1005,100,,Invoice,,,,,,07/09/2018,07/09/2018,0.00,,7.17,,"-910,516.63"
,IN,AR,30324197,1005,100,,Invoice,,,,,,07/09/2018,07/09/2018,0.00,,15.04,,"-910,531.67"
,IN,AR,30324225,1005,100,,Invoice,,,,,,07/09/2018,07/09/2018,0.00,,67.68,,"-910,599.35"
,IN,AR,30324230,1005,100,,Invoice,,,,,,07/09/2018,07/09/2018,0.00,,28.05,,"-910,627.40"
,IN,AR,30324257,1005,100,,Invoice,,,,,,07/09/2018,07/09/2018,0.00,,16.73,,"-910,644.13"
,IN,AR,30324285,1005,100,,Invoice,,,,,,07/09/2018,07/09/2018,0.00,,21.06,,"-910,665.19"
,IN,AR,30324287,1005,100,,Invoice,,,,,,07/09/2018,07/09/2018,0.00,,10.93,,"-910,676.12"
,IN,AR,30324374,1005,100,,Invoice,,,,,,07/09/2018,07/09/2018,0.00,,2.39,,"-910,678.51"
,IN,AR,30324392,1005,100,,Invoice,,,,,,07/09/2018,07/09/2018,0.00,,2.54,,"-910,681.05"
,IN,AR,30324393,1005,100,,Invoice,,,,,,07/09/2018,07/09/2018,0.00,,2.54,,"-910,683.59"
,IN,AR,30324394,1005,100,,Invoice,,,,,,07/09/2018,07/09/2018,0.00,,2.54,,"-910,686.13"
,IN,AR,30324395,1005,100,,Invoice,,,,,,07/09/2018,07/09/2018,0.00,,12.71,,"-910,698.84"
,IN,AR,30324405,1005,100,,Invoice,,,,,,07/09/2018,07/09/2018,0.00,,7.63,,"-910,706.47"
,IN,AR,30324472,1005,100,,Invoice,,,,,,07/09/2018,07/09/2018,0.00,,22.88,,"-910,729.35"
,IN,AR,30324480,1005,100,,Invoice,,,,,,07/09/2018,07/09/2018,0.00,,12.71,,"-910,742.06"
,IN,AR,30324486,1005,100,,Invoice,,,,,,07/09/2018,07/09/2018,0.00,,16.95,,"-910,759.01"
,IN,AR,30324504,1005,100,,Invoice,,,,,,07/09/2018,07/09/2018,0.00,,10.93,,"-910,769.94"
,IN,AR,30324610,1005,100,,Invoice,,,,,,07/09/2018,07/09/2018,0.00,,8.47,,"-910,778.41"
,IN,AR,30324638,1005,100,,Invoice,,,,,,07/09/2018,07/09/2018,0.00,,21.86,,"-910,800.27"
,IN,AR,30324721,1005,100,,Invoice,,,,,,07/09/2018,07/09/2018,0.00,,6.36,,"-910,806.63"
,IN,AR,30324748,1005,100,,Invoice,,,,,,07/09/2018,07/09/2018,0.00,,10.59,,"-910,817.22"
,IN,AR,30324793,1005,100,,Invoice,,,,,,07/09/2018,07/09/2018,0.00,,17.56,,"-910,834.78"
,IN,AR,30324805,1005,100,,Invoice,,,,,,07/09/2018,07/09/2018,0.00,,25.51,,"-910,860.29"
,IN,AR,30324819,1005,100,,Invoice,,,,,,07/09/2018,07/09/2018,0.00,,2.58,,"-910,862.87"
,IN,AR,30324859,1005,100,,Invoice,,,,,,07/09/2018,07/09/2018,0.00,,21.06,,"-910,883.93"
,IN,AR,30324864,1005,100,,Invoice,,,,,,07/09/2018,07/09/2018,0.00,,6.02,,"-910,889.95"
,IN,AR,30324949,1005,100,,Invoice,,,,,,07/09/2018,07/09/2018,0.00,,3.53,,"-910,893.48"
,IN,AR,30324950,1005,100,,Invoice,,,,,,07/09/2018,07/09/2018,0.00,,10.57,,"-910,904.05"
,IN,AR,30324969,1005,100,,Invoice,,,,,,07/09/2018,07/09/2018,0.00,,2.42,,"-910,906.47"
,IN,AR,30325004,1005,100,,Invoice,,,,,,07/09/2018,07/09/2018,0.00,,14.58,,"-910,921.05"
,IN,AR,30325045,1005,100,,Invoice,,,,,,07/09/2018,07/09/2018,0.00,,18.22,,"-910,939.27"
,IN,AR,30325075,1005,100,,Invoice,,,,,,07/09/2018,07/09/2018,0.00,,9.84,,"-910,949.11"
,IN,AR,30325106,1005,100,,Invoice,,,,,,07/09/2018,07/09/2018,0.00,,30.21,,"-910,979.32"
,IN,AR,30325119,1005,100,,Invoice,,,,,,07/09/2018,07/09/2018,0.00,,34.07,,"-911,013.39"
,IN,AR,30325133,1005,100,,Invoice,,,,,,07/09/2018,07/09/2018,0.00,,32.00,,"-911,045.39"
,IN,AR,30325139,1005,100,,Invoice,,,,,,07/09/2018,07/09/2018,0.00,,47.14,,"-911,092.53"
,IN,AR,30325146,1005,100,,Invoice,,,,,,07/09/2018,07/09/2018,0.00,,2.97,,"-911,095.50"
,IN,AR,30325164,1005,100,,Invoice,,,,,,07/09/2018,07/09/2018,0.00,,26.06,,"-911,121.56"
,IN,AR,30325181,1005,100,,Invoice,,,,,,07/09/2018,07/09/2018,0.00,,8.21,,"-911,129.77"
,IN,AR,30325190,1005,100,,Invoice,,,,,,07/09/2018,07/09/2018,0.00,,24.29,,"-911,154.06"
,IN,AR,30325202,1005,100,,Invoice,,,,,,07/09/2018,07/09/2018,0.00,,41.06,,"-911,195.12"
,IN,AR,30325219,1005,100,,Invoice,,,,,,07/09/2018,07/09/2018,0.00,,14.58,,"-911,209.70"
,IN,AR,30325226,1005,100,,Invoice,,,,,,07/09/2018,07/09/2018,0.00,,49.92,,"-911,259.62"
,IN,AR,30325253,1005,100,,Invoice,,,,,,07/09/2018,07/09/2018,0.00,,7.29,,"-911,266.91"
,IN,AR,30325264,1005,100,,Invoice,,,,,,07/09/2018,07/09/2018,0.00,,31.08,,"-911,297.99"
,IN,AR,30325267,1005,100,,Invoice,,,,,,07/09/2018,07/09/2018,0.00,,14.58,,"-911,312.57"
,IN,AR,30325270,1005,100,,Invoice,,,,,,07/09/2018,07/09/2018,0.00,,14.58,,"-911,327.15"
,IN,AR,30325292,1005,100,,Invoice,,,,,,07/09/2018,07/09/2018,0.00,,12.71,,"-911,339.86"
,IN,AR,30325320,1005,100,,Invoice,,,,,,07/09/2018,07/09/2018,0.00,,24.01,,"-911,363.87"
,IN,AR,30325370,1005,100,,Invoice,,,,,,07/09/2018,07/09/2018,0.00,,35.58,,"-911,399.45"
,IN,AR,30325386,1005,100,,Invoice,,,,,,07/09/2018,07/09/2018,0.00,,8.41,,"-911,407.86"
,IN,AR,30325387,1005,100,,Invoice,,,,,,07/09/2018,07/09/2018,0.00,,54.67,,"-911,462.53"
,IN,AR,30325443,1005,100,,Invoice,,,,,,07/09/2018,07/09/2018,0.00,,11.48,,"-911,474.01"
,IN,AR,30325521,1005,100,,Invoice,,,,,,07/09/2018,07/09/2018,0.00,,3.64,,"-911,477.65"
,IN,AR,30325524,1005,100,,Invoice,,,,,,07/09/2018,07/09/2018,0.00,,14.19,,"-911,491.84"
,IN,AR,30325527,1005,100,,Invoice,,,,,,07/09/2018,07/09/2018,0.00,,19.32,,"-911,511.16"
,IN,AR,30325717,1005,100,,Invoice,,,,,,07/09/2018,07/09/2018,0.00,,68.58,,"-911,579.74"
,IN,AR,30325739,1005,100,,Invoice,,,,,,07/09/2018,07/09/2018,0.00,,5.83,,"-911,585.57"
,IN,AR,30325744,1005,100,,Invoice,,,,,,07/09/2018,07/09/2018,0.00,,9.84,,"-911,595.41"
,IN,AR,30325754,1005,100,,Invoice,,,,,,07/09/2018,07/09/2018,0.00,,24.64,,"-911,620.05"
,IN,AR,30325769,1005,100,,Invoice,,,,,,07/09/2018,07/09/2018,0.00,,46.61,,"-911,666.66"
,IN,AR,30325786,1005,100,,Invoice,,,,,,07/09/2018,07/09/2018,0.00,,10.93,,"-911,677.59"
,IN,AR,30325794,1005,100,,Invoice,,,,,,07/09/2018,07/09/2018,0.00,,11.70,,"-911,689.29"
,IN,AR,30325827,1005,100,,Invoice,,,,,,07/09/2018,07/09/2018,0.00,,8.17,,"-911,697.46"
,IN,AR,30325850,1005,100,,Invoice,,,,,,07/09/2018,07/09/2018,0.00,,15.53,,"-911,712.99"
,IN,AR,30325860,1005,100,,Invoice,,,,,,07/09/2018,07/09/2018,0.00,,5.97,,"-911,718.96"
,IN,AR,30325892,1005,100,,Invoice,,,,,,07/09/2018,07/09/2018,0.00,,2.00,,"-911,720.96"
,IN,AR,30325893,1005,100,,Invoice,,,,,,07/09/2018,07/09/2018,0.00,,2.00,,"-911,722.96"
,IN,AR,30325939,1005,100,,Invoice,,,,,,07/09/2018,07/09/2018,0.00,,16.61,,"-911,739.57"
,IN,AR,30325965,1005,100,,Invoice,,,,,,07/09/2018,07/09/2018,0.00,,5.08,,"-911,744.65"
,IN,AR,30325985,1005,100,,Invoice,,,,,,07/09/2018,07/09/2018,0.00,,56.53,,"-911,801.18"
,IN,AR,30325996,1005,100,,Invoice,,,,,,07/09/2018,07/09/2018,0.00,,7.75,,"-911,808.93"
,IN,AR,30325998,1005,100,,Invoice,,,,,,07/09/2018,07/09/2018,0.00,,18.20,,"-911,827.13"
,IN,AR,30325999,1005,100,,Invoice,,,,,,07/09/2018,07/09/2018,0.00,,3.64,,"-911,830.77"
,IN,AR,30326016,1005,100,,Invoice,,,,,,07/09/2018,07/09/2018,0.00,,21.86,,"-911,852.63"
,IN,AR,30326026,1005,100,,Invoice,,,,,,07/09/2018,07/09/2018,0.00,,6.10,,"-911,858.73"
,IN,AR,30326063,1005,100,,Invoice,,,,,,07/09/2018,07/09/2018,0.00,,7.29,,"-911,866.02"
,IN,AR,30326102,1005,100,,Invoice,,,,,,07/09/2018,07/09/2018,0.00,,18.20,,"-911,884.22"
,IN,AR,30326109,1005,100,,Invoice,,,,,,07/09/2018,07/09/2018,0.00,,10.93,,"-911,895.15"
,CS,AR,32008654,1005,100,,Cash sale,,,,,,08/09/2018,08/09/2018,0.00,,10.93,,"-911,906.08"
,IN,AR,30324208,1005,100,,Invoice,,,,,,08/09/2018,08/09/2018,0.00,,612.20,,"-912,518.28"
,IN,AR,30324238,1005,100,,Invoice,,,,,,08/09/2018,08/09/2018,0.00,,99.15,,"-912,617.43"
,IN,AR,30325323,1005,100,,Invoice,,,,,,09/09/2018,09/09/2018,0.00,,29.15,,"-912,646.58"
,CN,AR,31019215,1005,100,,Credit Note,,,,,,09/09/2018,09/09/2018,54.07,,0.00,,"-912,592.51"
,CS,AR,32007908,1005,100,,Cash sale,,,,,,10/09/2018,10/09/2018,0.00,,11.86,,"-912,604.37"
,CS,AR,32007928,1005,100,,Cash sale,,,,,,10/09/2018,10/09/2018,0.00,,3.64,,"-912,608.01"
,CS,AR,32007932,1005,100,,Cash sale,,,,,,10/09/2018,10/09/2018,0.00,,14.58,,"-912,622.59"
,CS,AR,32007998,1005,100,,Cash sale,,,,,,10/09/2018,10/09/2018,0.00,,7.29,,"-912,629.88"
,CS,AR,32008016,1005,100,,Cash sale,,,,,,10/09/2018,10/09/2018,0.00,,8.31,,"-912,638.19"
,CS,AR,32008032,1005,100,,Cash sale,,,,,,10/09/2018,10/09/2018,0.00,,7.29,,"-912,645.48"
,CS,AR,32008033,1005,100,,Cash sale,,,,,,10/09/2018,10/09/2018,0.00,,7.29,,"-912,652.77"
,CS,AR,32008048,1005,100,,Cash sale,,,,,,10/09/2018,10/09/2018,0.00,,5.84,,"-912,658.61"
,CS,AR,32008059,1005,100,,Cash sale,,,,,,10/09/2018,10/09/2018,0.00,,7.29,,"-912,665.90"
,CS,AR,32008072,1005,100,,Cash sale,,,,,,10/09/2018,10/09/2018,0.00,,3.64,,"-912,669.54"
,CS,AR,32008102,1005,100,,Cash sale,,,,,,10/09/2018,10/09/2018,0.00,,3.64,,"-912,673.18"
,CS,AR,32008131,1005,100,,Cash sale,,,,,,10/09/2018,10/09/2018,0.00,,7.29,,"-912,680.47"
,CS,AR,32008136,1005,100,,Cash sale,,,,,,10/09/2018,10/09/2018,0.00,,7.29,,"-912,687.76"
,CS,AR,32008191,1005,100,,Cash sale,,,,,,10/09/2018,10/09/2018,0.00,,10.99,,"-912,698.75"
,CS,AR,32008200,1005,100,,Cash sale,,,,,,10/09/2018,10/09/2018,0.00,,7.29,,"-912,706.04"
,CS,AR,32008226,1005,100,,Cash sale,,,,,,10/09/2018,10/09/2018,0.00,,7.29,,"-912,713.33"
,CS,AR,32008227,1005,100,,Cash sale,,,,,,10/09/2018,10/09/2018,0.00,,32.80,,"-912,746.13"
,CS,AR,32008241,1005,100,,Cash sale,,,,,,10/09/2018,10/09/2018,0.00,,7.63,,"-912,753.76"
,CS,AR,32008254,1005,100,,Cash sale,,,,,,10/09/2018,10/09/2018,0.00,,17.54,,"-912,771.30"
,CS,AR,32008271,1005,100,,Cash sale,,,,,,10/09/2018,10/09/2018,0.00,,15.04,,"-912,786.34"
,CS,AR,32008272,1005,100,,Cash sale,,,,,,10/09/2018,10/09/2018,0.00,,18.05,,"-912,804.39"
,CS,AR,32008304,1005,100,,Cash sale,,,,,,10/09/2018,10/09/2018,0.00,,14.58,,"-912,818.97"
,CS,AR,32008307,1005,100,,Cash sale,,,,,,10/09/2018,10/09/2018,0.00,,7.29,,"-912,826.26"
,CS,AR,32008331,1005,100,,Cash sale,,,,,,10/09/2018,10/09/2018,0.00,,3.64,,"-912,829.90"
,CS,AR,32008336,1005,100,,Cash sale,,,,,,10/09/2018,10/09/2018,0.00,,45.13,,"-912,875.03"
,CS,AR,32008343,1005,100,,Cash sale,,,,,,10/09/2018,10/09/2018,0.00,,7.63,,"-912,882.66"
,CS,AR,32008347,1005,100,,Cash sale,,,,,,10/09/2018,10/09/2018,0.00,,7.29,,"-912,889.95"
,CS,AR,32008354,1005,100,,Cash sale,,,,,,10/09/2018,10/09/2018,0.00,,10.17,,"-912,900.12"
,CS,AR,32008369,1005,100,,Cash sale,,,,,,10/09/2018,10/09/2018,0.00,,10.93,,"-912,911.05"
,CS,AR,32008375,1005,100,,Cash sale,,,,,,10/09/2018,10/09/2018,0.00,,3.64,,"-912,914.69"
,CS,AR,32008377,1005,100,,Cash sale,,,,,,10/09/2018,10/09/2018,0.00,,9.03,,"-912,923.72"
,CS,AR,32008390,1005,100,,Cash sale,,,,,,10/09/2018,10/09/2018,0.00,,7.29,,"-912,931.01"
,CS,AR,32008393,1005,100,,Cash sale,,,,,,10/09/2018,10/09/2018,0.00,,7.29,,"-912,938.30"
,CS,AR,32008394,1005,100,,Cash sale,,,,,,10/09/2018,10/09/2018,0.00,,7.29,,"-912,945.59"
,CS,AR,32008400,1005,100,,Cash sale,,,,,,10/09/2018,10/09/2018,0.00,,10.93,,"-912,956.52"
,CS,AR,32008438,1005,100,,Cash sale,,,,,,10/09/2018,10/09/2018,0.00,,3.64,,"-912,960.16"
,CS,AR,32008447,1005,100,,Cash sale,,,,,,10/09/2018,10/09/2018,0.00,,9.13,,"-912,969.29"
,CS,AR,32008475,1005,100,,Cash sale,,,,,,10/09/2018,10/09/2018,0.00,,10.93,,"-912,980.22"
,CS,AR,32008511,1005,100,,Cash sale,,,,,,10/09/2018,10/09/2018,0.00,,12.71,,"-912,992.93"
,CS,AR,32008564,1005,100,,Cash sale,,,,,,10/09/2018,10/09/2018,0.00,,10.93,,"-913,003.86"
,CS,AR,32008568,1005,100,,Cash sale,,,,,,10/09/2018,10/09/2018,0.00,,3.64,,"-913,007.50"
,CS,AR,32008591,1005,100,,Cash sale,,,,,,10/09/2018,10/09/2018,0.00,,11.44,,"-913,018.94"
,CS,AR,32008597,1005,100,,Cash sale,,,,,,10/09/2018,10/09/2018,0.00,,10.93,,"-913,029.87"
,CS,AR,32008611,1005,100,,Cash sale,,,,,,10/09/2018,10/09/2018,0.00,,29.15,,"-913,059.02"
,CS,AR,32008659,1005,100,,Cash sale,,,,,,10/09/2018,10/09/2018,0.00,,5.47,,"-913,064.49"
,CS,AR,32008667,1005,100,,Cash sale,,,,,,10/09/2018,10/09/2018,0.00,,10.93,,"-913,075.42"
,CS,AR,32008697,1005,100,,Cash sale,,,,,,10/09/2018,10/09/2018,0.00,,10.93,,"-913,086.35"
,CS,AR,32008727,1005,100,,Cash sale,,,,,,10/09/2018,10/09/2018,0.00,,29.15,,"-913,115.50"
,CS,AR,32008753,1005,100,,Cash sale,,,,,,10/09/2018,10/09/2018,0.00,,7.29,,"-913,122.79"
,CS,AR,32008892,1005,100,,Cash sale,,,,,,10/09/2018,10/09/2018,0.00,,3.64,,"-913,126.43"
,IN,AR,30323540,1005,100,,Invoice,,,,,,10/09/2018,10/09/2018,0.00,,182.20,,"-913,308.63"
,IN,AR,30323551,1005,100,,Invoice,,,,,,10/09/2018,10/09/2018,0.00,,88.98,,"-913,397.61"
,IN,AR,30323568,1005,100,,Invoice,,,,,,10/09/2018,10/09/2018,0.00,,25.51,,"-913,423.12"
,IN,AR,30323574,1005,100,,Invoice,,,,,,10/09/2018,10/09/2018,0.00,,329.71,,"-913,752.83"
,IN,AR,30323621,1005,100,,Invoice,,,,,,10/09/2018,10/09/2018,0.00,,4.05,,"-913,756.88"
,IN,AR,30323622,1005,100,,Invoice,,,,,,10/09/2018,10/09/2018,0.00,,2.03,,"-913,758.91"
,IN,AR,30323623,1005,100,,Invoice,,,,,,10/09/2018,10/09/2018,0.00,,8.10,,"-913,767.01"
,IN,AR,30323624,1005,100,,Invoice,,,,,,10/09/2018,10/09/2018,0.00,,2.03,,"-913,769.04"
,IN,AR,30323625,1005,100,,Invoice,,,,,,10/09/2018,10/09/2018,0.00,,10.13,,"-913,779.17"
,IN,AR,30323626,1005,100,,Invoice,,,,,,10/09/2018,10/09/2018,0.00,,14.18,,"-913,793.35"
,IN,AR,30323627,1005,100,,Invoice,,,,,,10/09/2018,10/09/2018,0.00,,6.08,,"-913,799.43"
,IN,AR,30323695,1005,100,,Invoice,,,,,,10/09/2018,10/09/2018,0.00,,71.86,,"-913,871.29"
,IN,AR,30323747,1005,100,,Invoice,,,,,,10/09/2018,10/09/2018,0.00,,187.46,,"-914,058.75"
,IN,AR,30323756,1005,100,,Invoice,,,,,,10/09/2018,10/09/2018,0.00,,8.26,,"-914,067.01"
,IN,AR,30323776,1005,100,,Invoice,,,,,,10/09/2018,10/09/2018,0.00,,28.00,,"-914,095.01"
,IN,AR,30323793,1005,100,,Invoice,,,,,,10/09/2018,10/09/2018,0.00,,65.75,,"-914,160.76"
,IN,AR,30323823,1005,100,,Invoice,,,,,,10/09/2018,10/09/2018,0.00,,36.00,,"-914,196.76"
,IN,AR,30323824,1005,100,,Invoice,,,,,,10/09/2018,10/09/2018,0.00,,28.00,,"-914,224.76"
,IN,AR,30323835,1005,100,,Invoice,,,,,,10/09/2018,10/09/2018,0.00,,2.75,,"-914,227.51"
,IN,AR,30323838,1005,100,,Invoice,,,,,,10/09/2018,10/09/2018,0.00,,50.85,,"-914,278.36"
,IN,AR,30323841,1005,100,,Invoice,,,,,,10/09/2018,10/09/2018,0.00,,5.51,,"-914,283.87"
,IN,AR,30323848,1005,100,,Invoice,,,,,,10/09/2018,10/09/2018,0.00,,3.64,,"-914,287.51"
,IN,AR,30323866,1005,100,,Invoice,,,,,,10/09/2018,10/09/2018,0.00,,11.69,,"-914,299.20"
,IN,AR,30323885,1005,100,,Invoice,,,,,,10/09/2018,10/09/2018,0.00,,40.00,,"-914,339.20"
,IN,AR,30323888,1005,100,,Invoice,,,,,,10/09/2018,10/09/2018,0.00,,18.22,,"-914,357.42"
,IN,AR,30323938,1005,100,,Invoice,,,,,,10/09/2018,10/09/2018,0.00,,7.29,,"-914,364.71"
,IN,AR,30323947,1005,100,,Invoice,,,,,,10/09/2018,10/09/2018,0.00,,28.00,,"-914,392.71"
,IN,AR,30323974,1005,100,,Invoice,,,,,,10/09/2018,10/09/2018,0.00,,25.76,,"-914,418.47"
,IN,AR,30323986,1005,100,,Invoice,,,,,,10/09/2018,10/09/2018,0.00,,32.80,,"-914,451.27"
,IN,AR,30323989,1005,100,,Invoice,,,,,,10/09/2018,10/09/2018,0.00,,7.29,,"-914,458.56"
,IN,AR,30323996,1005,100,,Invoice,,,,,,10/09/2018,10/09/2018,0.00,,182.20,,"-914,640.76"
,IN,AR,30324001,1005,100,,Invoice,,,,,,10/09/2018,10/09/2018,0.00,,9.56,,"-914,650.32"
,IN,AR,30324007,1005,100,,Invoice,,,,,,10/09/2018,10/09/2018,0.00,,31.02,,"-914,681.34"
,IN,AR,30324040,1005,100,,Invoice,,,,,,10/09/2018,10/09/2018,0.00,,7.29,,"-914,688.63"
,IN,AR,30324043,1005,100,,Invoice,,,,,,10/09/2018,10/09/2018,0.00,,10.34,,"-914,698.97"
,IN,AR,30324049,1005,100,,Invoice,,,,,,10/09/2018,10/09/2018,0.00,,7.19,,"-914,706.16"
,IN,AR,30324053,1005,100,,Invoice,,,,,,10/09/2018,10/09/2018,0.00,,18.37,,"-914,724.53"
,IN,AR,30324061,1005,100,,Invoice,,,,,,10/09/2018,10/09/2018,0.00,,10.51,,"-914,735.04"
,IN,AR,30324100,1005,100,,Invoice,,,,,,10/09/2018,10/09/2018,0.00,,4.24,,"-914,739.28"
,IN,AR,30324140,1005,100,,Invoice,,,,,,10/09/2018,10/09/2018,0.00,,16.95,,"-914,756.23"
,IN,AR,30324145,1005,100,,Invoice,,,,,,10/09/2018,10/09/2018,0.00,,29.66,,"-914,785.89"
,IN,AR,30324154,1005,100,,Invoice,,,,,,10/09/2018,10/09/2018,0.00,,25.85,,"-914,811.74"
,IN,AR,30324172,1005,100,,Invoice,,,,,,10/09/2018,10/09/2018,0.00,,8.90,,"-914,820.64"
,IN,AR,30324175,1005,100,,Invoice,,,,,,10/09/2018,10/09/2018,0.00,,15.25,,"-914,835.89"
,IN,AR,30324226,1005,100,,Invoice,,,,,,10/09/2018,10/09/2018,0.00,,100.49,,"-914,936.38"
,IN,AR,30324239,1005,100,,Invoice,,,,,,10/09/2018,10/09/2018,0.00,,48.31,,"-914,984.69"
,IN,AR,30324258,1005,100,,Invoice,,,,,,10/09/2018,10/09/2018,0.00,,19.12,,"-915,003.81"
,IN,AR,30324259,1005,100,,Invoice,,,,,,10/09/2018,10/09/2018,0.00,,19.12,,"-915,022.93"
,IN,AR,30324267,1005,100,,Invoice,,,,,,10/09/2018,10/09/2018,0.00,,25.76,,"-915,048.69"
,IN,AR,30324274,1005,100,,Invoice,,,,,,10/09/2018,10/09/2018,0.00,,21.06,,"-915,069.75"
,IN,AR,30324317,1005,100,,Invoice,,,,,,10/09/2018,10/09/2018,0.00,,6.36,,"-915,076.11"
,IN,AR,30324323,1005,100,,Invoice,,,,,,10/09/2018,10/09/2018,0.00,,42.12,,"-915,118.23"
,IN,AR,30324332,1005,100,,Invoice,,,,,,10/09/2018,10/09/2018,0.00,,6.02,,"-915,124.25"
,IN,AR,30324396,1005,100,,Invoice,,,,,,10/09/2018,10/09/2018,0.00,,7.63,,"-915,131.88"
,IN,AR,30324529,1005,100,,Invoice,,,,,,10/09/2018,10/09/2018,0.00,,30.51,,"-915,162.39"
,IN,AR,30324544,1005,100,,Invoice,,,,,,10/09/2018,10/09/2018,0.00,,16.27,,"-915,178.66"
,IN,AR,30324584,1005,100,,Invoice,,,,,,10/09/2018,10/09/2018,0.00,,3.64,,"-915,182.30"
,IN,AR,30324590,1005,100,,Invoice,,,,,,10/09/2018,10/09/2018,0.00,,10.93,,"-915,193.23"
,IN,AR,30324631,1005,100,,Invoice,,,,,,10/09/2018,10/09/2018,0.00,,2.75,,"-915,195.98"
,IN,AR,30324634,1005,100,,Invoice,,,,,,10/09/2018,10/09/2018,0.00,,7.29,,"-915,203.27"
,IN,AR,30324651,1005,100,,Invoice,,,,,,10/09/2018,10/09/2018,0.00,,54.66,,"-915,257.93"
,IN,AR,30324659,1005,100,,Invoice,,,,,,10/09/2018,10/09/2018,0.00,,9.19,,"-915,267.12"
,IN,AR,30324671,1005,100,,Invoice,,,,,,10/09/2018,10/09/2018,0.00,,13.14,,"-915,280.26"
,IN,AR,30324736,1005,100,,Invoice,,,,,,10/09/2018,10/09/2018,0.00,,14.83,,"-915,295.09"
,IN,AR,30324760,1005,100,,Invoice,,,,,,10/09/2018,10/09/2018,0.00,,73.22,,"-915,368.31"
,IN,AR,30324775,1005,100,,Invoice,,,,,,10/09/2018,10/09/2018,0.00,,16.00,,"-915,384.31"
,IN,AR,30324791,1005,100,,Invoice,,,,,,10/09/2018,10/09/2018,0.00,,364.41,,"-915,748.72"
,IN,AR,30324838,1005,100,,Invoice,,,,,,10/09/2018,10/09/2018,0.00,,49.25,,"-915,797.97"
,IN,AR,30324869,1005,100,,Invoice,,,,,,10/09/2018,10/09/2018,0.00,,14.63,,"-915,812.60"
,IN,AR,30324904,1005,100,,Invoice,,,,,,10/09/2018,10/09/2018,0.00,,22.71,,"-915,835.31"
,IN,AR,30324951,1005,100,,Invoice,,,,,,10/09/2018,10/09/2018,0.00,,3.53,,"-915,838.84"
,IN,AR,30324962,1005,100,,Invoice,,,,,,10/09/2018,10/09/2018,0.00,,10.93,,"-915,849.77"
,IN,AR,30325002,1005,100,,Invoice,,,,,,10/09/2018,10/09/2018,0.00,,54.66,,"-915,904.43"
,IN,AR,30325031,1005,100,,Invoice,,,,,,10/09/2018,10/09/2018,0.00,,54.66,,"-915,959.09"
,IN,AR,30325063,1005,100,,Invoice,,,,,,10/09/2018,10/09/2018,0.00,,2.58,,"-915,961.67"
,IN,AR,30325165,1005,100,,Invoice,,,,,,10/09/2018,10/09/2018,0.00,,32.07,,"-915,993.74"
,IN,AR,30325191,1005,100,,Invoice,,,,,,10/09/2018,10/09/2018,0.00,,12.14,,"-916,005.88"
,IN,AR,30325214,1005,100,,Invoice,,,,,,10/09/2018,10/09/2018,0.00,,9.84,,"-916,015.72"
,IN,AR,30325227,1005,100,,Invoice,,,,,,10/09/2018,10/09/2018,0.00,,31.53,,"-916,047.25"
,IN,AR,30325232,1005,100,,Invoice,,,,,,10/09/2018,10/09/2018,0.00,,4.58,,"-916,051.83"
,IN,AR,30325273,1005,100,,Invoice,,,,,,10/09/2018,10/09/2018,0.00,,18.22,,"-916,070.05"
,IN,AR,30325304,1005,100,,Invoice,,,,,,10/09/2018,10/09/2018,0.00,,28.01,,"-916,098.06"
,IN,AR,30325321,1005,100,,Invoice,,,,,,10/09/2018,10/09/2018,0.00,,14.00,,"-916,112.06"
,IN,AR,30325354,1005,100,,Invoice,,,,,,10/09/2018,10/09/2018,0.00,,61.85,,"-916,173.91"
,IN,AR,30325388,1005,100,,Invoice,,,,,,10/09/2018,10/09/2018,0.00,,6.31,,"-916,180.22"
,IN,AR,30325407,1005,100,,Invoice,,,,,,10/09/2018,10/09/2018,0.00,,2.33,,"-916,182.55"
,IN,AR,30325418,1005,100,,Invoice,,,,,,10/09/2018,10/09/2018,0.00,,54.66,,"-916,237.21"
,IN,AR,30325421,1005,100,,Invoice,,,,,,10/09/2018,10/09/2018,0.00,,21.75,,"-916,258.96"
,IN,AR,30325425,1005,100,,Invoice,,,,,,10/09/2018,10/09/2018,0.00,,167.80,,"-916,426.76"
,IN,AR,30325437,1005,100,,Invoice,,,,,,10/09/2018,10/09/2018,0.00,,19.64,,"-916,446.40"
,IN,AR,30325535,1005,100,,Invoice,,,,,,10/09/2018,10/09/2018,0.00,,26.69,,"-916,473.09"
,IN,AR,30325689,1005,100,,Invoice,,,,,,10/09/2018,10/09/2018,0.00,,3.76,,"-916,476.85"
,IN,AR,30325708,1005,100,,Invoice,,,,,,10/09/2018,10/09/2018,0.00,,9.08,,"-916,485.93"
,IN,AR,30325755,1005,100,,Invoice,,,,,,10/09/2018,10/09/2018,0.00,,5.47,,"-916,491.40"
,IN,AR,30325806,1005,100,,Invoice,,,,,,10/09/2018,10/09/2018,0.00,,10.47,,"-916,501.87"
,IN,AR,30325813,1005,100,,Invoice,,,,,,10/09/2018,10/09/2018,0.00,,13.09,,"-916,514.96"
,IN,AR,30325828,1005,100,,Invoice,,,,,,10/09/2018,10/09/2018,0.00,,6.13,,"-916,521.09"
,IN,AR,30325884,1005,100,,Invoice,,,,,,10/09/2018,10/09/2018,0.00,,15.18,,"-916,536.27"
,IN,AR,30325940,1005,100,,Invoice,,,,,,10/09/2018,10/09/2018,0.00,,2.08,,"-916,538.35"
,IN,AR,30325941,1005,100,,Invoice,,,,,,10/09/2018,10/09/2018,0.00,,12.46,,"-916,550.81"
,IN,AR,30325942,1005,100,,Invoice,,,,,,10/09/2018,10/09/2018,0.00,,4.15,,"-916,554.96"
,IN,AR,30325943,1005,100,,Invoice,,,,,,10/09/2018,10/09/2018,0.00,,4.15,,"-916,559.11"
,IN,AR,30325944,1005,100,,Invoice,,,,,,10/09/2018,10/09/2018,0.00,,4.15,,"-916,563.26"
,IN,AR,30325967,1005,100,,Invoice,,,,,,10/09/2018,10/09/2018,0.00,,9.84,,"-916,573.10"
,IN,AR,30326017,1005,100,,Invoice,,,,,,10/09/2018,10/09/2018,0.00,,14.58,,"-916,587.68"
,IN,AR,30326048,1005,100,,Invoice,,,,,,10/09/2018,10/09/2018,0.00,,29.15,,"-916,616.83"
,IN,AR,30326057,1005,100,,Invoice,,,,,,10/09/2018,10/09/2018,0.00,,1.75,,"-916,618.58"
,IN,AR,30326091,1005,100,,Invoice,,,,,,10/09/2018,10/09/2018,0.00,,25.23,,"-916,643.81"
,IN,AR,30326104,1005,100,,Invoice,,,,,,10/09/2018,10/09/2018,0.00,,5.17,,"-916,648.98"
,IN,AR,30326145,1005,100,,Invoice,,,,,,10/09/2018,10/09/2018,0.00,,7.29,,"-916,656.27"
,IN,AR,30326150,1005,100,,Invoice,,,,,,10/09/2018,10/09/2018,0.00,,3.64,,"-916,659.91"
,IN,AR,30326251,1005,100,,Invoice,,,,,,10/09/2018,10/09/2018,0.00,,29.15,,"-916,689.06"
,IN,AR,30326252,1005,100,,Invoice,,,,,,10/09/2018,10/09/2018,0.00,,29.15,,"-916,718.21"
,CN,AR,31018970,1005,100,,Credit Note,,,,,,11/09/2018,11/09/2018,10.98,,0.00,,"-916,707.23"
,CS,AR,32007924,1005,100,,Cash sale,,,,,,11/09/2018,11/09/2018,0.00,,12.03,,"-916,719.26"
,CS,AR,32007993,1005,100,,Cash sale,,,,,,11/09/2018,11/09/2018,0.00,,10.93,,"-916,730.19"
,CS,AR,32008030,1005,100,,Cash sale,,,,,,11/09/2018,11/09/2018,0.00,,14.58,,"-916,744.77"
,CS,AR,32008055,1005,100,,Cash sale,,,,,,11/09/2018,11/09/2018,0.00,,7.29,,"-916,752.06"
,CS,AR,32008118,1005,100,,Cash sale,,,,,,11/09/2018,11/09/2018,0.00,,7.29,,"-916,759.35"
,CS,AR,32008125,1005,100,,Cash sale,,,,,,11/09/2018,11/09/2018,0.00,,4.32,,"-916,763.67"
,CS,AR,32008128,1005,100,,Cash sale,,,,,,11/09/2018,11/09/2018,0.00,,2.16,,"-916,765.83"
,CS,AR,32008163,1005,100,,Cash sale,,,,,,11/09/2018,11/09/2018,0.00,,5.17,,"-916,771.00"
,CS,AR,32008186,1005,100,,Cash sale,,,,,,11/09/2018,11/09/2018,0.00,,7.29,,"-916,778.29"
,CS,AR,32008188,1005,100,,Cash sale,,,,,,11/09/2018,11/09/2018,0.00,,5.17,,"-916,783.46"
,CS,AR,32008216,1005,100,,Cash sale,,,,,,11/09/2018,11/09/2018,0.00,,10.93,,"-916,794.39"
,CS,AR,32008230,1005,100,,Cash sale,,,,,,11/09/2018,11/09/2018,0.00,,3.64,,"-916,798.03"
,CS,AR,32008257,1005,100,,Cash sale,,,,,,11/09/2018,11/09/2018,0.00,,13.47,,"-916,811.50"
,CS,AR,32008260,1005,100,,Cash sale,,,,,,11/09/2018,11/09/2018,0.00,,13.64,,"-916,825.14"
,CS,AR,32008275,1005,100,,Cash sale,,,,,,11/09/2018,11/09/2018,0.00,,13.98,,"-916,839.12"
,CS,AR,32008288,1005,100,,Cash sale,,,,,,11/09/2018,11/09/2018,0.00,,7.80,,"-916,846.92"
,CS,AR,32008295,1005,100,,Cash sale,,,,,,11/09/2018,11/09/2018,0.00,,7.29,,"-916,854.21"
,CS,AR,32008296,1005,100,,Cash sale,,,,,,11/09/2018,11/09/2018,0.00,,12.92,,"-916,867.13"
,CS,AR,32008320,1005,100,,Cash sale,,,,,,11/09/2018,11/09/2018,0.00,,5.08,,"-916,872.21"
,CS,AR,32008327,1005,100,,Cash sale,,,,,,11/09/2018,11/09/2018,0.00,,10.34,,"-916,882.55"
,CS,AR,32008345,1005,100,,Cash sale,,,,,,11/09/2018,11/09/2018,0.00,,23.26,,"-916,905.81"
,CS,AR,32008352,1005,100,,Cash sale,,,,,,11/09/2018,11/09/2018,0.00,,10.93,,"-916,916.74"
,CS,AR,32008359,1005,100,,Cash sale,,,,,,11/09/2018,11/09/2018,0.00,,7.29,,"-916,924.03"
,CS,AR,32008395,1005,100,,Cash sale,,,,,,11/09/2018,11/09/2018,0.00,,14.58,,"-916,938.61"
,CS,AR,32008421,1005,100,,Cash sale,,,,,,11/09/2018,11/09/2018,0.00,,7.29,,"-916,945.90"
,CS,AR,32008457,1005,100,,Cash sale,,,,,,11/09/2018,11/09/2018,0.00,,17.15,,"-916,963.05"
,CS,AR,32008460,1005,100,,Cash sale,,,,,,11/09/2018,11/09/2018,0.00,,14.58,,"-916,977.63"
,CS,AR,32008463,1005,100,,Cash sale,,,,,,11/09/2018,11/09/2018,0.00,,1.88,,"-916,979.51"
,CS,AR,32008479,1005,100,,Cash sale,,,,,,11/09/2018,11/09/2018,0.00,,7.76,,"-916,987.27"
,CS,AR,32008489,1005,100,,Cash sale,,,,,,11/09/2018,11/09/2018,0.00,,10.95,,"-916,998.22"
,CS,AR,32008494,1005,100,,Cash sale,,,,,,11/09/2018,11/09/2018,0.00,,7.29,,"-917,005.51"
,CS,AR,32008543,1005,100,,Cash sale,,,,,,11/09/2018,11/09/2018,0.00,,22.88,,"-917,028.39"
,CS,AR,32008601,1005,100,,Cash sale,,,,,,11/09/2018,11/09/2018,0.00,,5.93,,"-917,034.32"
,CS,AR,32008610,1005,100,,Cash sale,,,,,,11/09/2018,11/09/2018,0.00,,20.76,,"-917,055.08"
,CS,AR,32008626,1005,100,,Cash sale,,,,,,11/09/2018,11/09/2018,0.00,,11.01,,"-917,066.09"
,CS,AR,32008651,1005,100,,Cash sale,,,,,,11/09/2018,11/09/2018,0.00,,7.29,,"-917,073.38"
,CS,AR,32008682,1005,100,,Cash sale,,,,,,11/09/2018,11/09/2018,0.00,,3.64,,"-917,077.02"
,CS,AR,32008705,1005,100,,Cash sale,,,,,,11/09/2018,11/09/2018,0.00,,7.29,,"-917,084.31"
,CS,AR,32008715,1005,100,,Cash sale,,,,,,11/09/2018,11/09/2018,0.00,,14.58,,"-917,098.89"
,CS,AR,32008722,1005,100,,Cash sale,,,,,,11/09/2018,11/09/2018,0.00,,8.21,,"-917,107.10"
,CS,AR,32008734,1005,100,,Cash sale,,,,,,11/09/2018,11/09/2018,0.00,,14.58,,"-917,121.68"
,CS,AR,32008835,1005,100,,Cash sale,,,,,,11/09/2018,11/09/2018,0.00,,7.29,,"-917,128.97"
,CS,AR,32008843,1005,100,,Cash sale,,,,,,11/09/2018,11/09/2018,0.00,,5.47,,"-917,134.44"
,CS,AR,32008883,1005,100,,Cash sale,,,,,,11/09/2018,11/09/2018,0.00,,7.29,,"-917,141.73"
,IN,AR,30323529,1005,100,,Invoice,,,,,,11/09/2018,11/09/2018,0.00,,23.73,,"-917,165.46"
,IN,AR,30323571,1005,100,,Invoice,,,,,,11/09/2018,11/09/2018,0.00,,364.41,,"-917,529.87"
,IN,AR,30323628,1005,100,,Invoice,,,,,,11/09/2018,11/09/2018,0.00,,6.08,,"-917,535.95"
,IN,AR,30323632,1005,100,,Invoice,,,,,,11/09/2018,11/09/2018,0.00,,27.12,,"-917,563.07"
,IN,AR,30323651,1005,100,,Invoice,,,,,,11/09/2018,11/09/2018,0.00,,3.64,,"-917,566.71"
,IN,AR,30323684,1005,100,,Invoice,,,,,,11/09/2018,11/09/2018,0.00,,7.29,,"-917,574.00"
,IN,AR,30323687,1005,100,,Invoice,,,,,,11/09/2018,11/09/2018,0.00,,7.00,,"-917,581.00"
,IN,AR,30323698,1005,100,,Invoice,,,,,,11/09/2018,11/09/2018,0.00,,29.15,,"-917,610.15"
,IN,AR,30323748,1005,100,,Invoice,,,,,,11/09/2018,11/09/2018,0.00,,26.10,,"-917,636.25"
,IN,AR,30323759,1005,100,,Invoice,,,,,,11/09/2018,11/09/2018,0.00,,18.22,,"-917,654.47"
,IN,AR,30323786,1005,100,,Invoice,,,,,,11/09/2018,11/09/2018,0.00,,10.93,,"-917,665.40"
,IN,AR,30323804,1005,100,,Invoice,,,,,,11/09/2018,11/09/2018,0.00,,3.01,,"-917,668.41"
,IN,AR,30323852,1005,100,,Invoice,,,,,,11/09/2018,11/09/2018,0.00,,18.22,,"-917,686.63"
,IN,AR,30323913,1005,100,,Invoice,,,,,,11/09/2018,11/09/2018,0.00,,14.58,,"-917,701.21"
,IN,AR,30323929,1005,100,,Invoice,,,,,,11/09/2018,11/09/2018,0.00,,11.64,,"-917,712.85"
,IN,AR,30323956,1005,100,,Invoice,,,,,,11/09/2018,11/09/2018,0.00,,19.24,,"-917,732.09"
,IN,AR,30323968,1005,100,,Invoice,,,,,,11/09/2018,11/09/2018,0.00,,364.41,,"-918,096.50"
,IN,AR,30323983,1005,100,,Invoice,,,,,,11/09/2018,11/09/2018,0.00,,10.93,,"-918,107.43"
,IN,AR,30324036,1005,100,,Invoice,,,,,,11/09/2018,11/09/2018,0.00,,4.64,,"-918,112.07"
,IN,AR,30324085,1005,100,,Invoice,,,,,,11/09/2018,11/09/2018,0.00,,29.66,,"-918,141.73"
,IN,AR,30324108,1005,100,,Invoice,,,,,,11/09/2018,11/09/2018,0.00,,30.51,,"-918,172.24"
,IN,AR,30324109,1005,100,,Invoice,,,,,,11/09/2018,11/09/2018,0.00,,61.02,,"-918,233.26"
,IN,AR,30324125,1005,100,,Invoice,,,,,,11/09/2018,11/09/2018,0.00,,4.24,,"-918,237.50"
,IN,AR,30324130,1005,100,,Invoice,,,,,,11/09/2018,11/09/2018,0.00,,6.36,,"-918,243.86"
,IN,AR,30324213,1005,100,,Invoice,,,,,,11/09/2018,11/09/2018,0.00,,7.80,,"-918,251.66"
,IN,AR,30324295,1005,100,,Invoice,,,,,,11/09/2018,11/09/2018,0.00,,9.03,,"-918,260.69"
,IN,AR,30324377,1005,100,,Invoice,,,,,,11/09/2018,11/09/2018,0.00,,3.90,,"-918,264.59"
,IN,AR,30324410,1005,100,,Invoice,,,,,,11/09/2018,11/09/2018,0.00,,11.23,,"-918,275.82"
,IN,AR,30324460,1005,100,,Invoice,,,,,,11/09/2018,11/09/2018,0.00,,3.43,,"-918,279.25"
,IN,AR,30324498,1005,100,,Invoice,,,,,,11/09/2018,11/09/2018,0.00,,7.29,,"-918,286.54"
,IN,AR,30324517,1005,100,,Invoice,,,,,,11/09/2018,11/09/2018,0.00,,42.71,,"-918,329.25"
,IN,AR,30324545,1005,100,,Invoice,,,,,,11/09/2018,11/09/2018,0.00,,36.61,,"-918,365.86"
,IN,AR,30324557,1005,100,,Invoice,,,,,,11/09/2018,11/09/2018,0.00,,13.22,,"-918,379.08"
,IN,AR,30324558,1005,100,,Invoice,,,,,,11/09/2018,11/09/2018,0.00,,9.92,,"-918,389.00"
,IN,AR,30324569,1005,100,,Invoice,,,,,,11/09/2018,11/09/2018,0.00,,15.25,,"-918,404.25"
,IN,AR,30324575,1005,100,,Invoice,,,,,,11/09/2018,11/09/2018,0.00,,7.80,,"-918,412.05"
,IN,AR,30324578,1005,100,,Invoice,,,,,,11/09/2018,11/09/2018,0.00,,17.54,,"-918,429.59"
,IN,AR,30324598,1005,100,,Invoice,,,,,,11/09/2018,11/09/2018,0.00,,16.95,,"-918,446.54"
,IN,AR,30324619,1005,100,,Invoice,,,,,,11/09/2018,11/09/2018,0.00,,6.36,,"-918,452.90"
,IN,AR,30324637,1005,100,,Invoice,,,,,,11/09/2018,11/09/2018,0.00,,10.93,,"-918,463.83"
,IN,AR,30324649,1005,100,,Invoice,,,,,,11/09/2018,11/09/2018,0.00,,29.15,,"-918,492.98"
,IN,AR,30324680,1005,100,,Invoice,,,,,,11/09/2018,11/09/2018,0.00,,19.07,,"-918,512.05"
,IN,AR,30324701,1005,100,,Invoice,,,,,,11/09/2018,11/09/2018,0.00,,7.80,,"-918,519.85"
,IN,AR,30324717,1005,100,,Invoice,,,,,,11/09/2018,11/09/2018,0.00,,7.29,,"-918,527.14"
,IN,AR,30324761,1005,100,,Invoice,,,,,,11/09/2018,11/09/2018,0.00,,23.90,,"-918,551.04"
,IN,AR,30324779,1005,100,,Invoice,,,,,,11/09/2018,11/09/2018,0.00,,22.81,,"-918,573.85"
,IN,AR,30324804,1005,100,,Invoice,,,,,,11/09/2018,11/09/2018,0.00,,10.93,,"-918,584.78"
,IN,AR,30324810,1005,100,,Invoice,,,,,,11/09/2018,11/09/2018,0.00,,8.26,,"-918,593.04"
,IN,AR,30324813,1005,100,,Invoice,,,,,,11/09/2018,11/09/2018,0.00,,5.59,,"-918,598.63"
,IN,AR,30324902,1005,100,,Invoice,,,,,,11/09/2018,11/09/2018,0.00,,14.58,,"-918,613.21"
,IN,AR,30324922,1005,100,,Invoice,,,,,,11/09/2018,11/09/2018,0.00,,25.73,,"-918,638.94"
,IN,AR,30324952,1005,100,,Invoice,,,,,,11/09/2018,11/09/2018,0.00,,5.29,,"-918,644.23"
,IN,AR,30324986,1005,100,,Invoice,,,,,,11/09/2018,11/09/2018,0.00,,76.27,,"-918,720.50"
,IN,AR,30325048,1005,100,,Invoice,,,,,,11/09/2018,11/09/2018,0.00,,7.29,,"-918,727.79"
,IN,AR,30325072,1005,100,,Invoice,,,,,,11/09/2018,11/09/2018,0.00,,29.15,,"-918,756.94"
,IN,AR,30325087,1005,100,,Invoice,,,,,,11/09/2018,11/09/2018,0.00,,35.85,,"-918,792.79"
,IN,AR,30325107,1005,100,,Invoice,,,,,,11/09/2018,11/09/2018,0.00,,4.77,,"-918,797.56"
,IN,AR,30325120,1005,100,,Invoice,,,,,,11/09/2018,11/09/2018,0.00,,48.26,,"-918,845.82"
,IN,AR,30325124,1005,100,,Invoice,,,,,,11/09/2018,11/09/2018,0.00,,30.00,,"-918,875.82"
,IN,AR,30325134,1005,100,,Invoice,,,,,,11/09/2018,11/09/2018,0.00,,40.00,,"-918,915.82"
,IN,AR,30325207,1005,100,,Invoice,,,,,,11/09/2018,11/09/2018,0.00,,209.17,,"-919,124.99"
,IN,AR,30325236,1005,100,,Invoice,,,,,,11/09/2018,11/09/2018,0.00,,10.93,,"-919,135.92"
,IN,AR,30325251,1005,100,,Invoice,,,,,,11/09/2018,11/09/2018,0.00,,10.93,,"-919,146.85"
,IN,AR,30325276,1005,100,,Invoice,,,,,,11/09/2018,11/09/2018,0.00,,14.58,,"-919,161.43"
,IN,AR,30325293,1005,100,,Invoice,,,,,,11/09/2018,11/09/2018,0.00,,15.25,,"-919,176.68"
,IN,AR,30325309,1005,100,,Invoice,,,,,,11/09/2018,11/09/2018,0.00,,24.01,,"-919,200.69"
,IN,AR,30325431,1005,100,,Invoice,,,,,,11/09/2018,11/09/2018,0.00,,5.47,,"-919,206.16"
,IN,AR,30325471,1005,100,,Invoice,,,,,,11/09/2018,11/09/2018,0.00,,20.44,,"-919,226.60"
,IN,AR,30325500,1005,100,,Invoice,,,,,,11/09/2018,11/09/2018,0.00,,33.22,,"-919,259.82"
,IN,AR,30325501,1005,100,,Invoice,,,,,,11/09/2018,11/09/2018,0.00,,7.29,,"-919,267.11"
,IN,AR,30325530,1005,100,,Invoice,,,,,,11/09/2018,11/09/2018,0.00,,20.41,,"-919,287.52"
,IN,AR,30325579,1005,100,,Invoice,,,,,,11/09/2018,11/09/2018,0.00,,89.49,,"-919,377.01"
,IN,AR,30325625,1005,100,,Invoice,,,,,,11/09/2018,11/09/2018,0.00,,33.22,,"-919,410.23"
,IN,AR,30325626,1005,100,,Invoice,,,,,,11/09/2018,11/09/2018,0.00,,147.13,,"-919,557.36"
,IN,AR,30325661,1005,100,,Invoice,,,,,,11/09/2018,11/09/2018,0.00,,18.31,,"-919,575.67"
,IN,AR,30325673,1005,100,,Invoice,,,,,,11/09/2018,11/09/2018,0.00,,4.00,,"-919,579.67"
,IN,AR,30325696,1005,100,,Invoice,,,,,,11/09/2018,11/09/2018,0.00,,1.75,,"-919,581.42"
,IN,AR,30325703,1005,100,,Invoice,,,,,,11/09/2018,11/09/2018,0.00,,8.00,,"-919,589.42"
,IN,AR,30325705,1005,100,,Invoice,,,,,,11/09/2018,11/09/2018,0.00,,8.90,,"-919,598.32"
,IN,AR,30325718,1005,100,,Invoice,,,,,,11/09/2018,11/09/2018,0.00,,86.73,,"-919,685.05"
,IN,AR,30325736,1005,100,,Invoice,,,,,,11/09/2018,11/09/2018,0.00,,7.02,,"-919,692.07"
,IN,AR,30325746,1005,100,,Invoice,,,,,,11/09/2018,11/09/2018,0.00,,10.99,,"-919,703.06"
,IN,AR,30325791,1005,100,,Invoice,,,,,,11/09/2018,11/09/2018,0.00,,91.27,,"-919,794.33"
,IN,AR,30325854,1005,100,,Invoice,,,,,,11/09/2018,11/09/2018,0.00,,54.66,,"-919,848.99"
,IN,AR,30325861,1005,100,,Invoice,,,,,,11/09/2018,11/09/2018,0.00,,5.97,,"-919,854.96"
,IN,AR,30325867,1005,100,,Invoice,,,,,,11/09/2018,11/09/2018,0.00,,49.70,,"-919,904.66"
,IN,AR,30325879,1005,100,,Invoice,,,,,,11/09/2018,11/09/2018,0.00,,4.83,,"-919,909.49"
,IN,AR,30325945,1005,100,,Invoice,,,,,,11/09/2018,11/09/2018,0.00,,16.61,,"-919,926.10"
,IN,AR,30325946,1005,100,,Invoice,,,,,,11/09/2018,11/09/2018,0.00,,4.15,,"-919,930.25"
,IN,AR,30325962,1005,100,,Invoice,,,,,,11/09/2018,11/09/2018,0.00,,22.88,,"-919,953.13"
,IN,AR,30325971,1005,100,,Invoice,,,,,,11/09/2018,11/09/2018,0.00,,16.91,,"-919,970.04"
,IN,AR,30325975,1005,100,,Invoice,,,,,,11/09/2018,11/09/2018,0.00,,10.93,,"-919,980.97"
,IN,AR,30326032,1005,100,,Invoice,,,,,,11/09/2018,11/09/2018,0.00,,5.08,,"-919,986.05"
,IN,AR,30326033,1005,100,,Invoice,,,,,,11/09/2018,11/09/2018,0.00,,10.93,,"-919,996.98"
,IN,AR,30326083,1005,100,,Invoice,,,,,,11/09/2018,11/09/2018,0.00,,10.98,,"-920,007.96"
,IN,AR,30326100,1005,100,,Invoice,,,,,,11/09/2018,11/09/2018,0.00,,7.29,,"-920,015.25"
,IN,AR,30326139,1005,100,,Invoice,,,,,,11/09/2018,11/09/2018,0.00,,115.29,,"-920,130.54"
,IN,AR,30326219,1005,100,,Invoice,,,,,,11/09/2018,11/09/2018,0.00,,7.29,,"-920,137.83"
,IN,AR,30326221,1005,100,,Invoice,,,,,,11/09/2018,11/09/2018,0.00,,5.93,,"-920,143.76"
,IN,AR,30326225,1005,100,,Invoice,,,,,,11/09/2018,11/09/2018,0.00,,6.07,,"-920,149.83"
,IN,AR,30326233,1005,100,,Invoice,,,,,,11/09/2018,11/09/2018,0.00,,10.93,,"-920,160.76"
,IN,AR,30326247,1005,100,,Invoice,,,,,,11/09/2018,11/09/2018,0.00,,8.77,,"-920,169.53"
,IN,AR,30326254,1005,100,,Invoice,,,,,,11/09/2018,11/09/2018,0.00,,29.15,,"-920,198.68"
,IN,AR,30326257,1005,100,,Invoice,,,,,,11/09/2018,11/09/2018,0.00,,29.15,,"-920,227.83"
,CN,AR,31018986,1005,100,,Credit Note,,,,,,12/09/2018,12/09/2018,10.93,,0.00,,"-920,216.90"
,CN,AR,31018989,1005,100,,Credit Note,,,,,,12/09/2018,12/09/2018,29.15,,0.00,,"-920,187.75"
,CR,AR,33000252,1005,100,,Cash Return,,,,,,12/09/2018,12/09/2018,10.19,,0.00,,"-920,177.56"
,CS,AR,32007893,1005,100,,Cash sale,,,,,,12/09/2018,12/09/2018,0.00,,28.05,,"-920,205.61"
,CS,AR,32007895,1005,100,,Cash sale,,,,,,12/09/2018,12/09/2018,0.00,,10.93,,"-920,216.54"
,CS,AR,32007898,1005,100,,Cash sale,,,,,,12/09/2018,12/09/2018,0.00,,7.29,,"-920,223.83"
,CS,AR,32007902,1005,100,,Cash sale,,,,,,12/09/2018,12/09/2018,0.00,,40.14,,"-920,263.97"
,CS,AR,32007923,1005,100,,Cash sale,,,,,,12/09/2018,12/09/2018,0.00,,7.29,,"-920,271.26"
,CS,AR,32007941,1005,100,,Cash sale,,,,,,12/09/2018,12/09/2018,0.00,,7.29,,"-920,278.55"
,CS,AR,32007949,1005,100,,Cash sale,,,,,,12/09/2018,12/09/2018,0.00,,7.29,,"-920,285.84"
,CS,AR,32007958,1005,100,,Cash sale,,,,,,12/09/2018,12/09/2018,0.00,,25.51,,"-920,311.35"
,CS,AR,32007961,1005,100,,Cash sale,,,,,,12/09/2018,12/09/2018,0.00,,3.64,,"-920,314.99"
,CS,AR,32007980,1005,100,,Cash sale,,,,,,12/09/2018,12/09/2018,0.00,,3.64,,"-920,318.63"
,CS,AR,32008024,1005,100,,Cash sale,,,,,,12/09/2018,12/09/2018,0.00,,7.29,,"-920,325.92"
,CS,AR,32008037,1005,100,,Cash sale,,,,,,12/09/2018,12/09/2018,0.00,,6.02,,"-920,331.94"
,CS,AR,32008066,1005,100,,Cash sale,,,,,,12/09/2018,12/09/2018,0.00,,7.29,,"-920,339.23"
,CS,AR,32008093,1005,100,,Cash sale,,,,,,12/09/2018,12/09/2018,0.00,,5.86,,"-920,345.09"
,CS,AR,32008100,1005,100,,Cash sale,,,,,,12/09/2018,12/09/2018,0.00,,7.29,,"-920,352.38"
,CS,AR,32008105,1005,100,,Cash sale,,,,,,12/09/2018,12/09/2018,0.00,,7.29,,"-920,359.67"
,CS,AR,32008112,1005,100,,Cash sale,,,,,,12/09/2018,12/09/2018,0.00,,10.34,,"-920,370.01"
,CS,AR,32008124,1005,100,,Cash sale,,,,,,12/09/2018,12/09/2018,0.00,,3.64,,"-920,373.65"
,CS,AR,32008134,1005,100,,Cash sale,,,,,,12/09/2018,12/09/2018,0.00,,10.93,,"-920,384.58"
,CS,AR,32008169,1005,100,,Cash sale,,,,,,12/09/2018,12/09/2018,0.00,,10.34,,"-920,394.92"
,CS,AR,32008182,1005,100,,Cash sale,,,,,,12/09/2018,12/09/2018,0.00,,7.29,,"-920,402.21"
,CS,AR,32008195,1005,100,,Cash sale,,,,,,12/09/2018,12/09/2018,0.00,,21.06,,"-920,423.27"
,CS,AR,32008199,1005,100,,Cash sale,,,,,,12/09/2018,12/09/2018,0.00,,8.58,,"-920,431.85"
,CS,AR,32008223,1005,100,,Cash sale,,,,,,12/09/2018,12/09/2018,0.00,,14.58,,"-920,446.43"
,CS,AR,32008228,1005,100,,Cash sale,,,,,,12/09/2018,12/09/2018,0.00,,11.65,,"-920,458.08"
,CS,AR,32008233,1005,100,,Cash sale,,,,,,12/09/2018,12/09/2018,0.00,,5.08,,"-920,463.16"
,CS,AR,32008256,1005,100,,Cash sale,,,,,,12/09/2018,12/09/2018,0.00,,6.74,,"-920,469.90"
,CS,AR,32008281,1005,100,,Cash sale,,,,,,12/09/2018,12/09/2018,0.00,,14.58,,"-920,484.48"
,CS,AR,32008287,1005,100,,Cash sale,,,,,,12/09/2018,12/09/2018,0.00,,10.93,,"-920,495.41"
,CS,AR,32008318,1005,100,,Cash sale,,,,,,12/09/2018,12/09/2018,0.00,,4.32,,"-920,499.73"
,CS,AR,32008356,1005,100,,Cash sale,,,,,,12/09/2018,12/09/2018,0.00,,14.58,,"-920,514.31"
,CS,AR,32008372,1005,100,,Cash sale,,,,,,12/09/2018,12/09/2018,0.00,,10.34,,"-920,524.65"
,CS,AR,32008381,1005,100,,Cash sale,,,,,,12/09/2018,12/09/2018,0.00,,10.93,,"-920,535.58"
,CS,AR,32008383,1005,100,,Cash sale,,,,,,12/09/2018,12/09/2018,0.00,,14.58,,"-920,550.16"
,CS,AR,32008465,1005,100,,Cash sale,,,,,,12/09/2018,12/09/2018,0.00,,7.75,,"-920,557.91"
,CS,AR,32008483,1005,100,,Cash sale,,,,,,12/09/2018,12/09/2018,0.00,,21.36,,"-920,579.27"
,CS,AR,32008487,1005,100,,Cash sale,,,,,,12/09/2018,12/09/2018,0.00,,8.90,,"-920,588.17"
,CS,AR,32008488,1005,100,,Cash sale,,,,,,12/09/2018,12/09/2018,0.00,,7.29,,"-920,595.46"
,CS,AR,32008501,1005,100,,Cash sale,,,,,,12/09/2018,12/09/2018,0.00,,14.58,,"-920,610.04"
,CS,AR,32008507,1005,100,,Cash sale,,,,,,12/09/2018,12/09/2018,0.00,,7.29,,"-920,617.33"
,CS,AR,32008532,1005,100,,Cash sale,,,,,,12/09/2018,12/09/2018,0.00,,35.59,,"-920,652.92"
,CS,AR,32008537,1005,100,,Cash sale,,,,,,12/09/2018,12/09/2018,0.00,,7.29,,"-920,660.21"
,CS,AR,32008540,1005,100,,Cash sale,,,,,,12/09/2018,12/09/2018,0.00,,9.15,,"-920,669.36"
,CS,AR,32008554,1005,100,,Cash sale,,,,,,12/09/2018,12/09/2018,0.00,,13.77,,"-920,683.13"
,CS,AR,32008558,1005,100,,Cash sale,,,,,,12/09/2018,12/09/2018,0.00,,9.03,,"-920,692.16"
,CS,AR,32008575,1005,100,,Cash sale,,,,,,12/09/2018,12/09/2018,0.00,,10.19,,"-920,702.35"
,CS,AR,32008592,1005,100,,Cash sale,,,,,,12/09/2018,12/09/2018,0.00,,9.15,,"-920,711.50"
,CS,AR,32008623,1005,100,,Cash sale,,,,,,12/09/2018,12/09/2018,0.00,,7.29,,"-920,718.79"
,CS,AR,32008636,1005,100,,Cash sale,,,,,,12/09/2018,12/09/2018,0.00,,15.04,,"-920,733.83"
,CS,AR,32008644,1005,100,,Cash sale,,,,,,12/09/2018,12/09/2018,0.00,,30.36,,"-920,764.19"
,CS,AR,32008647,1005,100,,Cash sale,,,,,,12/09/2018,12/09/2018,0.00,,7.29,,"-920,771.48"
,CS,AR,32008656,1005,100,,Cash sale,,,,,,12/09/2018,12/09/2018,0.00,,10.34,,"-920,781.82"
,CS,AR,32008668,1005,100,,Cash sale,,,,,,12/09/2018,12/09/2018,0.00,,7.29,,"-920,789.11"
,CS,AR,32008677,1005,100,,Cash sale,,,,,,12/09/2018,12/09/2018,0.00,,2.54,,"-920,791.65"
,CS,AR,32008719,1005,100,,Cash sale,,,,,,12/09/2018,12/09/2018,0.00,,3.64,,"-920,795.29"
,CS,AR,32008749,1005,100,,Cash sale,,,,,,12/09/2018,12/09/2018,0.00,,16.48,,"-920,811.77"
,CS,AR,32008759,1005,100,,Cash sale,,,,,,12/09/2018,12/09/2018,0.00,,7.29,,"-920,819.06"
,CS,AR,32008770,1005,100,,Cash sale,,,,,,12/09/2018,12/09/2018,0.00,,5.94,,"-920,825.00"
,IN,AR,30323552,1005,100,,Invoice,,,,,,12/09/2018,12/09/2018,0.00,,53.39,,"-920,878.39"
,IN,AR,30323592,1005,100,,Invoice,,,,,,12/09/2018,12/09/2018,0.00,,14.58,,"-920,892.97"
,IN,AR,30323602,1005,100,,Invoice,,,,,,12/09/2018,12/09/2018,0.00,,82.98,,"-920,975.95"
,IN,AR,30323603,1005,100,,Invoice,,,,,,12/09/2018,12/09/2018,0.00,,29.29,,"-921,005.24"
,IN,AR,30323633,1005,100,,Invoice,,,,,,12/09/2018,12/09/2018,0.00,,24.41,,"-921,029.65"
,IN,AR,30323642,1005,100,,Invoice,,,,,,12/09/2018,12/09/2018,0.00,,5.68,,"-921,035.33"
,IN,AR,30323645,1005,100,,Invoice,,,,,,12/09/2018,12/09/2018,0.00,,7.29,,"-921,042.62"
,IN,AR,30323647,1005,100,,Invoice,,,,,,12/09/2018,12/09/2018,0.00,,27.88,,"-921,070.50"
,IN,AR,30323661,1005,100,,Invoice,,,,,,12/09/2018,12/09/2018,0.00,,81.44,,"-921,151.94"
,IN,AR,30323662,1005,100,,Invoice,,,,,,12/09/2018,12/09/2018,0.00,,28.90,,"-921,180.84"
,IN,AR,30323669,1005,100,,Invoice,,,,,,12/09/2018,12/09/2018,0.00,,25.51,,"-921,206.35"
,IN,AR,30323683,1005,100,,Invoice,,,,,,12/09/2018,12/09/2018,0.00,,364.41,,"-921,570.76"
,IN,AR,30323703,1005,100,,Invoice,,,,,,12/09/2018,12/09/2018,0.00,,364.41,,"-921,935.17"
,IN,AR,30323726,1005,100,,Invoice,,,,,,12/09/2018,12/09/2018,0.00,,13.94,,"-921,949.11"
,IN,AR,30323727,1005,100,,Invoice,,,,,,12/09/2018,12/09/2018,0.00,,5.97,,"-921,955.08"
,IN,AR,30323749,1005,100,,Invoice,,,,,,12/09/2018,12/09/2018,0.00,,92.54,,"-922,047.62"
,IN,AR,30323825,1005,100,,Invoice,,,,,,12/09/2018,12/09/2018,0.00,,36.00,,"-922,083.62"
,IN,AR,30323842,1005,100,,Invoice,,,,,,12/09/2018,12/09/2018,0.00,,182.20,,"-922,265.82"
,IN,AR,30323858,1005,100,,Invoice,,,,,,12/09/2018,12/09/2018,0.00,,38.00,,"-922,303.82"
,IN,AR,30323869,1005,100,,Invoice,,,,,,12/09/2018,12/09/2018,0.00,,7.29,,"-922,311.11"
,IN,AR,30323899,1005,100,,Invoice,,,,,,12/09/2018,12/09/2018,0.00,,21.86,,"-922,332.97"
,IN,AR,30323902,1005,100,,Invoice,,,,,,12/09/2018,12/09/2018,0.00,,14.58,,"-922,347.55"
,IN,AR,30323911,1005,100,,Invoice,,,,,,12/09/2018,12/09/2018,0.00,,335.64,,"-922,683.19"
,IN,AR,30323961,1005,100,,Invoice,,,,,,12/09/2018,12/09/2018,0.00,,9.03,,"-922,692.22"
,IN,AR,30323993,1005,100,,Invoice,,,,,,12/09/2018,12/09/2018,0.00,,10.93,,"-922,703.15"
,IN,AR,30323995,1005,100,,Invoice,,,,,,12/09/2018,12/09/2018,0.00,,218.64,,"-922,921.79"
,IN,AR,30324025,1005,100,,Invoice,,,,,,12/09/2018,12/09/2018,0.00,,12.92,,"-922,934.71"
,IN,AR,30324065,1005,100,,Invoice,,,,,,12/09/2018,12/09/2018,0.00,,27.97,,"-922,962.68"
,IN,AR,30324089,1005,100,,Invoice,,,,,,12/09/2018,12/09/2018,0.00,,4.24,,"-922,966.92"
,IN,AR,30324095,1005,100,,Invoice,,,,,,12/09/2018,12/09/2018,0.00,,4.24,,"-922,971.16"
,IN,AR,30324102,1005,100,,Invoice,,,,,,12/09/2018,12/09/2018,0.00,,364.41,,"-923,335.57"
,IN,AR,30324135,1005,100,,Invoice,,,,,,12/09/2018,12/09/2018,0.00,,8.39,,"-923,343.96"
,IN,AR,30324177,1005,100,,Invoice,,,,,,12/09/2018,12/09/2018,0.00,,28.68,,"-923,372.64"
,IN,AR,30324178,1005,100,,Invoice,,,,,,12/09/2018,12/09/2018,0.00,,22.03,,"-923,394.67"
,IN,AR,30324187,1005,100,,Invoice,,,,,,12/09/2018,12/09/2018,0.00,,18.22,,"-923,412.89"
,IN,AR,30324202,1005,100,,Invoice,,,,,,12/09/2018,12/09/2018,0.00,,23.90,,"-923,436.79"
,IN,AR,30324227,1005,100,,Invoice,,,,,,12/09/2018,12/09/2018,0.00,,77.93,,"-923,514.72"
,IN,AR,30324245,1005,100,,Invoice,,,,,,12/09/2018,12/09/2018,0.00,,54.66,,"-923,569.38"
,IN,AR,30324311,1005,100,,Invoice,,,,,,12/09/2018,12/09/2018,0.00,,5.17,,"-923,574.55"
,IN,AR,30324336,1005,100,,Invoice,,,,,,12/09/2018,12/09/2018,0.00,,216.07,,"-923,790.62"
,IN,AR,30324397,1005,100,,Invoice,,,,,,12/09/2018,12/09/2018,0.00,,2.54,,"-923,793.16"
,IN,AR,30324414,1005,100,,Invoice,,,,,,12/09/2018,12/09/2018,0.00,,14.71,,"-923,807.87"
,IN,AR,30324427,1005,100,,Invoice,,,,,,12/09/2018,12/09/2018,0.00,,27.97,,"-923,835.84"
,IN,AR,30324509,1005,100,,Invoice,,,,,,12/09/2018,12/09/2018,0.00,,12.92,,"-923,848.76"
,IN,AR,30324514,1005,100,,Invoice,,,,,,12/09/2018,12/09/2018,0.00,,18.17,,"-923,866.93"
,IN,AR,30324570,1005,100,,Invoice,,,,,,12/09/2018,12/09/2018,0.00,,5.08,,"-923,872.01"
,IN,AR,30324579,1005,100,,Invoice,,,,,,12/09/2018,12/09/2018,0.00,,7.29,,"-923,879.30"
,IN,AR,30324615,1005,100,,Invoice,,,,,,12/09/2018,12/09/2018,0.00,,14.58,,"-923,893.88"
,IN,AR,30324664,1005,100,,Invoice,,,,,,12/09/2018,12/09/2018,0.00,,28.05,,"-923,921.93"
,IN,AR,30324687,1005,100,,Invoice,,,,,,12/09/2018,12/09/2018,0.00,,32.63,,"-923,954.56"
,IN,AR,30324712,1005,100,,Invoice,,,,,,12/09/2018,12/09/2018,0.00,,1.88,,"-923,956.44"
,IN,AR,30324726,1005,100,,Invoice,,,,,,12/09/2018,12/09/2018,0.00,,7.29,,"-923,963.73"
,IN,AR,30324753,1005,100,,Invoice,,,,,,12/09/2018,12/09/2018,0.00,,27.97,,"-923,991.70"
,IN,AR,30324765,1005,100,,Invoice,,,,,,12/09/2018,12/09/2018,0.00,,12.71,,"-924,004.41"
,IN,AR,30324766,1005,100,,Invoice,,,,,,12/09/2018,12/09/2018,0.00,,54.66,,"-924,059.07"
,IN,AR,30324784,1005,100,,Invoice,,,,,,12/09/2018,12/09/2018,0.00,,2.71,,"-924,061.78"
,IN,AR,30324803,1005,100,,Invoice,,,,,,12/09/2018,12/09/2018,0.00,,54.66,,"-924,116.44"
,IN,AR,30324842,1005,100,,Invoice,,,,,,12/09/2018,12/09/2018,0.00,,29.15,,"-924,145.59"
,IN,AR,30324917,1005,100,,Invoice,,,,,,12/09/2018,12/09/2018,0.00,,54.66,,"-924,200.25"
,IN,AR,30324923,1005,100,,Invoice,,,,,,12/09/2018,12/09/2018,0.00,,42.88,,"-924,243.13"
,IN,AR,30324958,1005,100,,Invoice,,,,,,12/09/2018,12/09/2018,0.00,,21.06,,"-924,264.19"
,IN,AR,30325019,1005,100,,Invoice,,,,,,12/09/2018,12/09/2018,0.00,,24.01,,"-924,288.20"
,IN,AR,30325027,1005,100,,Invoice,,,,,,12/09/2018,12/09/2018,0.00,,36.44,,"-924,324.64"
,IN,AR,30325028,1005,100,,Invoice,,,,,,12/09/2018,12/09/2018,0.00,,40.08,,"-924,364.72"
,IN,AR,30325070,1005,100,,Invoice,,,,,,12/09/2018,12/09/2018,0.00,,5.08,,"-924,369.80"
,IN,AR,30325108,1005,100,,Invoice,,,,,,12/09/2018,12/09/2018,0.00,,16.86,,"-924,386.66"
,IN,AR,30325113,1005,100,,Invoice,,,,,,12/09/2018,12/09/2018,0.00,,4.01,,"-924,390.67"
,IN,AR,30325128,1005,100,,Invoice,,,,,,12/09/2018,12/09/2018,0.00,,42.00,,"-924,432.67"
,IN,AR,30325155,1005,100,,Invoice,,,,,,12/09/2018,12/09/2018,0.00,,80.17,,"-924,512.84"
,IN,AR,30325166,1005,100,,Invoice,,,,,,12/09/2018,12/09/2018,0.00,,44.09,,"-924,556.93"
,IN,AR,30325175,1005,100,,Invoice,,,,,,12/09/2018,12/09/2018,0.00,,14.58,,"-924,571.51"
,IN,AR,30325180,1005,100,,Invoice,,,,,,12/09/2018,12/09/2018,0.00,,7.29,,"-924,578.80"
,IN,AR,30325203,1005,100,,Invoice,,,,,,12/09/2018,12/09/2018,0.00,,25.93,,"-924,604.73"
,IN,AR,30325209,1005,100,,Invoice,,,,,,12/09/2018,12/09/2018,0.00,,12.14,,"-924,616.87"
,IN,AR,30325229,1005,100,,Invoice,,,,,,12/09/2018,12/09/2018,0.00,,29.15,,"-924,646.02"
,IN,AR,30325240,1005,100,,Invoice,,,,,,12/09/2018,12/09/2018,0.00,,9.84,,"-924,655.86"
,IN,AR,30325245,1005,100,,Invoice,,,,,,12/09/2018,12/09/2018,0.00,,10.19,,"-924,666.05"
,IN,AR,30325261,1005,100,,Invoice,,,,,,12/09/2018,12/09/2018,0.00,,38.81,,"-924,704.86"
,IN,AR,30325294,1005,100,,Invoice,,,,,,12/09/2018,12/09/2018,0.00,,17.80,,"-924,722.66"
,IN,AR,30325295,1005,100,,Invoice,,,,,,12/09/2018,12/09/2018,0.00,,22.88,,"-924,745.54"
,IN,AR,30325347,1005,100,,Invoice,,,,,,12/09/2018,12/09/2018,0.00,,102.20,,"-924,847.74"
,IN,AR,30325355,1005,100,,Invoice,,,,,,12/09/2018,12/09/2018,0.00,,3.02,,"-924,850.76"
,IN,AR,30325389,1005,100,,Invoice,,,,,,12/09/2018,12/09/2018,0.00,,27.33,,"-924,878.09"
,IN,AR,30325390,1005,100,,Invoice,,,,,,12/09/2018,12/09/2018,0.00,,33.64,,"-924,911.73"
,IN,AR,30325391,1005,100,,Invoice,,,,,,12/09/2018,12/09/2018,0.00,,8.41,,"-924,920.14"
,IN,AR,30325408,1005,100,,Invoice,,,,,,12/09/2018,12/09/2018,0.00,,14.58,,"-924,934.72"
,IN,AR,30325412,1005,100,,Invoice,,,,,,12/09/2018,12/09/2018,0.00,,"1,093.22",,"-926,027.94"
,IN,AR,30325455,1005,100,,Invoice,,,,,,12/09/2018,12/09/2018,0.00,,2.80,,"-926,030.74"
,IN,AR,30325463,1005,100,,Invoice,,,,,,12/09/2018,12/09/2018,0.00,,6.42,,"-926,037.16"
,IN,AR,30325468,1005,100,,Invoice,,,,,,12/09/2018,12/09/2018,0.00,,130.00,,"-926,167.16"
,IN,AR,30325502,1005,100,,Invoice,,,,,,12/09/2018,12/09/2018,0.00,,182.20,,"-926,349.36"
,IN,AR,30325519,1005,100,,Invoice,,,,,,12/09/2018,12/09/2018,0.00,,2.54,,"-926,351.90"
,IN,AR,30325569,1005,100,,Invoice,,,,,,12/09/2018,12/09/2018,0.00,,20.71,,"-926,372.61"
,IN,AR,30325570,1005,100,,Invoice,,,,,,12/09/2018,12/09/2018,0.00,,6.37,,"-926,378.98"
,IN,AR,30325581,1005,100,,Invoice,,,,,,12/09/2018,12/09/2018,0.00,,21.30,,"-926,400.28"
,IN,AR,30325627,1005,100,,Invoice,,,,,,12/09/2018,12/09/2018,0.00,,14.24,,"-926,414.52"
,IN,AR,30325680,1005,100,,Invoice,,,,,,12/09/2018,12/09/2018,0.00,,26.00,,"-926,440.52"
,IN,AR,30325693,1005,100,,Invoice,,,,,,12/09/2018,12/09/2018,0.00,,5.26,,"-926,445.78"
,IN,AR,30325758,1005,100,,Invoice,,,,,,12/09/2018,12/09/2018,0.00,,54.66,,"-926,500.44"
,IN,AR,30325761,1005,100,,Invoice,,,,,,12/09/2018,12/09/2018,0.00,,182.20,,"-926,682.64"
,IN,AR,30325776,1005,100,,Invoice,,,,,,12/09/2018,12/09/2018,0.00,,9.41,,"-926,692.05"
,IN,AR,30325818,1005,100,,Invoice,,,,,,12/09/2018,12/09/2018,0.00,,22.37,,"-926,714.42"
,IN,AR,30325829,1005,100,,Invoice,,,,,,12/09/2018,12/09/2018,0.00,,44.93,,"-926,759.35"
,IN,AR,30325830,1005,100,,Invoice,,,,,,12/09/2018,12/09/2018,0.00,,26.55,,"-926,785.90"
,IN,AR,30325847,1005,100,,Invoice,,,,,,12/09/2018,12/09/2018,0.00,,32.80,,"-926,818.70"
,IN,AR,30325876,1005,100,,Invoice,,,,,,12/09/2018,12/09/2018,0.00,,9.15,,"-926,827.85"
,IN,AR,30325947,1005,100,,Invoice,,,,,,12/09/2018,12/09/2018,0.00,,10.38,,"-926,838.23"
,IN,AR,30325948,1005,100,,Invoice,,,,,,12/09/2018,12/09/2018,0.00,,66.44,,"-926,904.67"
,IN,AR,30325949,1005,100,,Invoice,,,,,,12/09/2018,12/09/2018,0.00,,10.38,,"-926,915.05"
,IN,AR,30325950,1005,100,,Invoice,,,,,,12/09/2018,12/09/2018,0.00,,4.15,,"-926,919.20"
,IN,AR,30325951,1005,100,,Invoice,,,,,,12/09/2018,12/09/2018,0.00,,14.53,,"-926,933.73"
,IN,AR,30325964,1005,100,,Invoice,,,,,,12/09/2018,12/09/2018,0.00,,2.54,,"-926,936.27"
,IN,AR,30325982,1005,100,,Invoice,,,,,,12/09/2018,12/09/2018,0.00,,30.34,,"-926,966.61"
,IN,AR,30326000,1005,100,,Invoice,,,,,,12/09/2018,12/09/2018,0.00,,3.64,,"-926,970.25"
,IN,AR,30326005,1005,100,,Invoice,,,,,,12/09/2018,12/09/2018,0.00,,19.32,,"-926,989.57"
,IN,AR,30326007,1005,100,,Invoice,,,,,,12/09/2018,12/09/2018,0.00,,7.29,,"-926,996.86"
,IN,AR,30326060,1005,100,,Invoice,,,,,,12/09/2018,12/09/2018,0.00,,54.66,,"-927,051.52"
,IN,AR,30326076,1005,100,,Invoice,,,,,,12/09/2018,12/09/2018,0.00,,29.15,,"-927,080.67"
,IN,AR,30326115,1005,100,,Invoice,,,,,,12/09/2018,12/09/2018,0.00,,33.56,,"-927,114.23"
,IN,AR,30326126,1005,100,,Invoice,,,,,,12/09/2018,12/09/2018,0.00,,38.81,,"-927,153.04"
,IN,AR,30326142,1005,100,,Invoice,,,,,,12/09/2018,12/09/2018,0.00,,29.15,,"-927,182.19"
,IN,AR,30326146,1005,100,,Invoice,,,,,,12/09/2018,12/09/2018,0.00,,10.93,,"-927,193.12"
,IN,AR,30326164,1005,100,,Invoice,,,,,,12/09/2018,12/09/2018,0.00,,3.64,,"-927,196.76"
,IN,AR,30326178,1005,100,,Invoice,,,,,,12/09/2018,12/09/2018,0.00,,5.93,,"-927,202.69"
,IN,AR,30326258,1005,100,,Invoice,,,,,,12/09/2018,12/09/2018,0.00,,29.15,,"-927,231.84"
,IN,AR,30326259,1005,100,,Invoice,,,,,,12/09/2018,12/09/2018,0.00,,10.93,,"-927,242.77"
,CN,AR,31018767,1005,100,,Credit Note,,,,,,13/09/2018,13/09/2018,364.41,,0.00,,"-926,878.36"
,CS,AR,32007883,1005,100,,Cash sale,,,,,,13/09/2018,13/09/2018,0.00,,18.05,,"-926,896.41"
,CS,AR,32007896,1005,100,,Cash sale,,,,,,13/09/2018,13/09/2018,0.00,,8.11,,"-926,904.52"
,CS,AR,32007915,1005,100,,Cash sale,,,,,,13/09/2018,13/09/2018,0.00,,3.64,,"-926,908.16"
,CS,AR,32007953,1005,100,,Cash sale,,,,,,13/09/2018,13/09/2018,0.00,,3.64,,"-926,911.80"
,CS,AR,32008002,1005,100,,Cash sale,,,,,,13/09/2018,13/09/2018,0.00,,18.22,,"-926,930.02"
,CS,AR,32008003,1005,100,,Cash sale,,,,,,13/09/2018,13/09/2018,0.00,,7.29,,"-926,937.31"
,CS,AR,32008097,1005,100,,Cash sale,,,,,,13/09/2018,13/09/2018,0.00,,7.29,,"-926,944.60"
,CS,AR,32008099,1005,100,,Cash sale,,,,,,13/09/2018,13/09/2018,0.00,,3.64,,"-926,948.24"
,CS,AR,32008130,1005,100,,Cash sale,,,,,,13/09/2018,13/09/2018,0.00,,7.29,,"-926,955.53"
,CS,AR,32008247,1005,100,,Cash sale,,,,,,13/09/2018,13/09/2018,0.00,,7.29,,"-926,962.82"
,CS,AR,32008291,1005,100,,Cash sale,,,,,,13/09/2018,13/09/2018,0.00,,7.75,,"-926,970.57"
,CS,AR,32008310,1005,100,,Cash sale,,,,,,13/09/2018,13/09/2018,0.00,,16.53,,"-926,987.10"
,CS,AR,32008358,1005,100,,Cash sale,,,,,,13/09/2018,13/09/2018,0.00,,12.88,,"-926,999.98"
,CS,AR,32008363,1005,100,,Cash sale,,,,,,13/09/2018,13/09/2018,0.00,,83.90,,"-927,083.88"
,CS,AR,32008367,1005,100,,Cash sale,,,,,,13/09/2018,13/09/2018,0.00,,31.02,,"-927,114.90"
,CS,AR,32008405,1005,100,,Cash sale,,,,,,13/09/2018,13/09/2018,0.00,,6.02,,"-927,120.92"
,CS,AR,32008412,1005,100,,Cash sale,,,,,,13/09/2018,13/09/2018,0.00,,6.44,,"-927,127.36"
,CS,AR,32008459,1005,100,,Cash sale,,,,,,13/09/2018,13/09/2018,0.00,,27.08,,"-927,154.44"
,CS,AR,32008496,1005,100,,Cash sale,,,,,,13/09/2018,13/09/2018,0.00,,10.93,,"-927,165.37"
,CS,AR,32008518,1005,100,,Cash sale,,,,,,13/09/2018,13/09/2018,0.00,,6.53,,"-927,171.90"
,CS,AR,32008562,1005,100,,Cash sale,,,,,,13/09/2018,13/09/2018,0.00,,5.93,,"-927,177.83"
,CS,AR,32008578,1005,100,,Cash sale,,,,,,13/09/2018,13/09/2018,0.00,,6.56,,"-927,184.39"
,CS,AR,32008639,1005,100,,Cash sale,,,,,,13/09/2018,13/09/2018,0.00,,10.93,,"-927,195.32"
,CS,AR,32008655,1005,100,,Cash sale,,,,,,13/09/2018,13/09/2018,0.00,,15.25,,"-927,210.57"
,CS,AR,32008692,1005,100,,Cash sale,,,,,,13/09/2018,13/09/2018,0.00,,5.17,,"-927,215.74"
,CS,AR,32008712,1005,100,,Cash sale,,,,,,13/09/2018,13/09/2018,0.00,,7.29,,"-927,223.03"
,CS,AR,32008720,1005,100,,Cash sale,,,,,,13/09/2018,13/09/2018,0.00,,14.58,,"-927,237.61"
,CS,AR,32008723,1005,100,,Cash sale,,,,,,13/09/2018,13/09/2018,0.00,,14.58,,"-927,252.19"
,CS,AR,32008738,1005,100,,Cash sale,,,,,,13/09/2018,13/09/2018,0.00,,5.86,,"-927,258.05"
,CS,AR,32008763,1005,100,,Cash sale,,,,,,13/09/2018,13/09/2018,0.00,,7.29,,"-927,265.34"
,CS,AR,32008840,1005,100,,Cash sale,,,,,,13/09/2018,13/09/2018,0.00,,10.93,,"-927,276.27"
,CS,AR,32008850,1005,100,,Cash sale,,,,,,13/09/2018,13/09/2018,0.00,,7.29,,"-927,283.56"
,CS,AR,32008861,1005,100,,Cash sale,,,,,,13/09/2018,13/09/2018,0.00,,18.22,,"-927,301.78"
,IN,AR,30323556,1005,100,,Invoice,,,,,,13/09/2018,13/09/2018,0.00,,12.03,,"-927,313.81"
,IN,AR,30323564,1005,100,,Invoice,,,,,,13/09/2018,13/09/2018,0.00,,3.64,,"-927,317.45"
,IN,AR,30323595,1005,100,,Invoice,,,,,,13/09/2018,13/09/2018,0.00,,7.29,,"-927,324.74"
,IN,AR,30323650,1005,100,,Invoice,,,,,,13/09/2018,13/09/2018,0.00,,3.64,,"-927,328.38"
,IN,AR,30323663,1005,100,,Invoice,,,,,,13/09/2018,13/09/2018,0.00,,7.88,,"-927,336.26"
,IN,AR,30323680,1005,100,,Invoice,,,,,,13/09/2018,13/09/2018,0.00,,7.29,,"-927,343.55"
,IN,AR,30323708,1005,100,,Invoice,,,,,,13/09/2018,13/09/2018,0.00,,58.31,,"-927,401.86"
,IN,AR,30323750,1005,100,,Invoice,,,,,,13/09/2018,13/09/2018,0.00,,56.95,,"-927,458.81"
,IN,AR,30323777,1005,100,,Invoice,,,,,,13/09/2018,13/09/2018,0.00,,42.00,,"-927,500.81"
,IN,AR,30323896,1005,100,,Invoice,,,,,,13/09/2018,13/09/2018,0.00,,41.19,,"-927,542.00"
,IN,AR,30323920,1005,100,,Invoice,,,,,,13/09/2018,13/09/2018,0.00,,650.81,,"-928,192.81"
,IN,AR,30324004,1005,100,,Invoice,,,,,,13/09/2018,13/09/2018,0.00,,25.51,,"-928,218.32"
,IN,AR,30324011,1005,100,,Invoice,,,,,,13/09/2018,13/09/2018,0.00,,14.58,,"-928,232.90"
,IN,AR,30324017,1005,100,,Invoice,,,,,,13/09/2018,13/09/2018,0.00,,28.00,,"-928,260.90"
,IN,AR,30324050,1005,100,,Invoice,,,,,,13/09/2018,13/09/2018,0.00,,16.79,,"-928,277.69"
,IN,AR,30324162,1005,100,,Invoice,,,,,,13/09/2018,13/09/2018,0.00,,7.29,,"-928,284.98"
,IN,AR,30324167,1005,100,,Invoice,,,,,,13/09/2018,13/09/2018,0.00,,198.11,,"-928,483.09"
,IN,AR,30324173,1005,100,,Invoice,,,,,,13/09/2018,13/09/2018,0.00,,54.33,,"-928,537.42"
,IN,AR,30324217,1005,100,,Invoice,,,,,,13/09/2018,13/09/2018,0.00,,30.51,,"-928,567.93"
,IN,AR,30324240,1005,100,,Invoice,,,,,,13/09/2018,13/09/2018,0.00,,20.34,,"-928,588.27"
,IN,AR,30324241,1005,100,,Invoice,,,,,,13/09/2018,13/09/2018,0.00,,55.93,,"-928,644.20"
,IN,AR,30324244,1005,100,,Invoice,,,,,,13/09/2018,13/09/2018,0.00,,10.93,,"-928,655.13"
,IN,AR,30324260,1005,100,,Invoice,,,,,,13/09/2018,13/09/2018,0.00,,19.12,,"-928,674.25"
,IN,AR,30324272,1005,100,,Invoice,,,,,,13/09/2018,13/09/2018,0.00,,25.76,,"-928,700.01"
,IN,AR,30324292,1005,100,,Invoice,,,,,,13/09/2018,13/09/2018,0.00,,12.71,,"-928,712.72"
,IN,AR,30324325,1005,100,,Invoice,,,,,,13/09/2018,13/09/2018,0.00,,14.58,,"-928,727.30"
,IN,AR,30324338,1005,100,,Invoice,,,,,,13/09/2018,13/09/2018,0.00,,14.58,,"-928,741.88"
,IN,AR,30324420,1005,100,,Invoice,,,,,,13/09/2018,13/09/2018,0.00,,5.17,,"-928,747.05"
,IN,AR,30324490,1005,100,,Invoice,,,,,,13/09/2018,13/09/2018,0.00,,12.71,,"-928,759.76"
,IN,AR,30324522,1005,100,,Invoice,,,,,,13/09/2018,13/09/2018,0.00,,419.07,,"-929,178.83"
,IN,AR,30324530,1005,100,,Invoice,,,,,,13/09/2018,13/09/2018,0.00,,33.05,,"-929,211.88"
,IN,AR,30324538,1005,100,,Invoice,,,,,,13/09/2018,13/09/2018,0.00,,20.00,,"-929,231.88"
,IN,AR,30324541,1005,100,,Invoice,,,,,,13/09/2018,13/09/2018,0.00,,364.41,,"-929,596.29"
,IN,AR,30324553,1005,100,,Invoice,,,,,,13/09/2018,13/09/2018,0.00,,7.29,,"-929,603.58"
,IN,AR,30324587,1005,100,,Invoice,,,,,,13/09/2018,13/09/2018,0.00,,9.03,,"-929,612.61"
,IN,AR,30324611,1005,100,,Invoice,,,,,,13/09/2018,13/09/2018,0.00,,6.36,,"-929,618.97"
,IN,AR,30324627,1005,100,,Invoice,,,,,,13/09/2018,13/09/2018,0.00,,14.83,,"-929,633.80"
,IN,AR,30324655,1005,100,,Invoice,,,,,,13/09/2018,13/09/2018,0.00,,16.47,,"-929,650.27"
,IN,AR,30324675,1005,100,,Invoice,,,,,,13/09/2018,13/09/2018,0.00,,23.31,,"-929,673.58"
,IN,AR,30324688,1005,100,,Invoice,,,,,,13/09/2018,13/09/2018,0.00,,53.39,,"-929,726.97"
,IN,AR,30324690,1005,100,,Invoice,,,,,,13/09/2018,13/09/2018,0.00,,4.58,,"-929,731.55"
,IN,AR,30324723,1005,100,,Invoice,,,,,,13/09/2018,13/09/2018,0.00,,10.93,,"-929,742.48"
,IN,AR,30324731,1005,100,,Invoice,,,,,,13/09/2018,13/09/2018,0.00,,12.71,,"-929,755.19"
,IN,AR,30324742,1005,100,,Invoice,,,,,,13/09/2018,13/09/2018,0.00,,16.95,,"-929,772.14"
,IN,AR,30324770,1005,100,,Invoice,,,,,,13/09/2018,13/09/2018,0.00,,364.41,,"-930,136.55"
,IN,AR,30324771,1005,100,,Invoice,,,,,,13/09/2018,13/09/2018,0.00,,65.60,,"-930,202.15"
,IN,AR,30324781,1005,100,,Invoice,,,,,,13/09/2018,13/09/2018,0.00,,29.15,,"-930,231.30"
,IN,AR,30324788,1005,100,,Invoice,,,,,,13/09/2018,13/09/2018,0.00,,2.32,,"-930,233.62"
,IN,AR,30324798,1005,100,,Invoice,,,,,,13/09/2018,13/09/2018,0.00,,11.69,,"-930,245.31"
,IN,AR,30324802,1005,100,,Invoice,,,,,,13/09/2018,13/09/2018,0.00,,25.51,,"-930,270.82"
,IN,AR,30324811,1005,100,,Invoice,,,,,,13/09/2018,13/09/2018,0.00,,24.79,,"-930,295.61"
,IN,AR,30324828,1005,100,,Invoice,,,,,,13/09/2018,13/09/2018,0.00,,364.41,,"-930,660.02"
,IN,AR,30324889,1005,100,,Invoice,,,,,,13/09/2018,13/09/2018,0.00,,11.64,,"-930,671.66"
,IN,AR,30324894,1005,100,,Invoice,,,,,,13/09/2018,13/09/2018,0.00,,10.17,,"-930,681.83"
,IN,AR,30324896,1005,100,,Invoice,,,,,,13/09/2018,13/09/2018,0.00,,6.53,,"-930,688.36"
,IN,AR,30324911,1005,100,,Invoice,,,,,,13/09/2018,13/09/2018,0.00,,30.08,,"-930,718.44"
,IN,AR,30324915,1005,100,,Invoice,,,,,,13/09/2018,13/09/2018,0.00,,8.00,,"-930,726.44"
,IN,AR,30324927,1005,100,,Invoice,,,,,,13/09/2018,13/09/2018,0.00,,10.68,,"-930,737.12"
,IN,AR,30324934,1005,100,,Invoice,,,,,,13/09/2018,13/09/2018,0.00,,19.58,,"-930,756.70"
,IN,AR,30324953,1005,100,,Invoice,,,,,,13/09/2018,13/09/2018,0.00,,3.53,,"-930,760.23"
,IN,AR,30324979,1005,100,,Invoice,,,,,,13/09/2018,13/09/2018,0.00,,8.24,,"-930,768.47"
,IN,AR,30324997,1005,100,,Invoice,,,,,,13/09/2018,13/09/2018,0.00,,7.29,,"-930,775.76"
,IN,AR,30325011,1005,100,,Invoice,,,,,,13/09/2018,13/09/2018,0.00,,13.09,,"-930,788.85"
,IN,AR,30325013,1005,100,,Invoice,,,,,,13/09/2018,13/09/2018,0.00,,29.15,,"-930,818.00"
,IN,AR,30325034,1005,100,,Invoice,,,,,,13/09/2018,13/09/2018,0.00,,10.93,,"-930,828.93"
,IN,AR,30325066,1005,100,,Invoice,,,,,,13/09/2018,13/09/2018,0.00,,18.22,,"-930,847.15"
,IN,AR,30325088,1005,100,,Invoice,,,,,,13/09/2018,13/09/2018,0.00,,5.97,,"-930,853.12"
,IN,AR,30325089,1005,100,,Invoice,,,,,,13/09/2018,13/09/2018,0.00,,19.92,,"-930,873.04"
,IN,AR,30325090,1005,100,,Invoice,,,,,,13/09/2018,13/09/2018,0.00,,9.96,,"-930,883.00"
,IN,AR,30325109,1005,100,,Invoice,,,,,,13/09/2018,13/09/2018,0.00,,39.83,,"-930,922.83"
,IN,AR,30325151,1005,100,,Invoice,,,,,,13/09/2018,13/09/2018,0.00,,254.37,,"-931,177.20"
,IN,AR,30325184,1005,100,,Invoice,,,,,,13/09/2018,13/09/2018,0.00,,3.64,,"-931,180.84"
,IN,AR,30325246,1005,100,,Invoice,,,,,,13/09/2018,13/09/2018,0.00,,80.17,,"-931,261.01"
,IN,AR,30325254,1005,100,,Invoice,,,,,,13/09/2018,13/09/2018,0.00,,7.29,,"-931,268.30"
,IN,AR,30325300,1005,100,,Invoice,,,,,,13/09/2018,13/09/2018,0.00,,20.01,,"-931,288.31"
,IN,AR,30325313,1005,100,,Invoice,,,,,,13/09/2018,13/09/2018,0.00,,28.01,,"-931,316.32"
,IN,AR,30325339,1005,100,,Invoice,,,,,,13/09/2018,13/09/2018,0.00,,20.41,,"-931,336.73"
,IN,AR,30325340,1005,100,,Invoice,,,,,,13/09/2018,13/09/2018,0.00,,11.66,,"-931,348.39"
,IN,AR,30325359,1005,100,,Invoice,,,,,,13/09/2018,13/09/2018,0.00,,29.15,,"-931,377.54"
,IN,AR,30325392,1005,100,,Invoice,,,,,,13/09/2018,13/09/2018,0.00,,18.92,,"-931,396.46"
,IN,AR,30325411,1005,100,,Invoice,,,,,,13/09/2018,13/09/2018,0.00,,26.24,,"-931,422.70"
,IN,AR,30325415,1005,100,,Invoice,,,,,,13/09/2018,13/09/2018,0.00,,21.86,,"-931,444.56"
,IN,AR,30325438,1005,100,,Invoice,,,,,,13/09/2018,13/09/2018,0.00,,11.22,,"-931,455.78"
,IN,AR,30325450,1005,100,,Invoice,,,,,,13/09/2018,13/09/2018,0.00,,32.03,,"-931,487.81"
,IN,AR,30325476,1005,100,,Invoice,,,,,,13/09/2018,13/09/2018,0.00,,12.14,,"-931,499.95"
,IN,AR,30325511,1005,100,,Invoice,,,,,,13/09/2018,13/09/2018,0.00,,18.22,,"-931,518.17"
,IN,AR,30325541,1005,100,,Invoice,,,,,,13/09/2018,13/09/2018,0.00,,81.15,,"-931,599.32"
,IN,AR,30325571,1005,100,,Invoice,,,,,,13/09/2018,13/09/2018,0.00,,7.97,,"-931,607.29"
,IN,AR,30325572,1005,100,,Invoice,,,,,,13/09/2018,13/09/2018,0.00,,6.37,,"-931,613.66"
,IN,AR,30325573,1005,100,,Invoice,,,,,,13/09/2018,13/09/2018,0.00,,105.15,,"-931,718.81"
,IN,AR,30325574,1005,100,,Invoice,,,,,,13/09/2018,13/09/2018,0.00,,11.15,,"-931,729.96"
,IN,AR,30325575,1005,100,,Invoice,,,,,,13/09/2018,13/09/2018,0.00,,3.19,,"-931,733.15"
,IN,AR,30325576,1005,100,,Invoice,,,,,,13/09/2018,13/09/2018,0.00,,23.90,,"-931,757.05"
,IN,AR,30325667,1005,100,,Invoice,,,,,,13/09/2018,13/09/2018,0.00,,26.44,,"-931,783.49"
,IN,AR,30325779,1005,100,,Invoice,,,,,,13/09/2018,13/09/2018,0.00,,15.17,,"-931,798.66"
,IN,AR,30325834,1005,100,,Invoice,,,,,,13/09/2018,13/09/2018,0.00,,16.34,,"-931,815.00"
,IN,AR,30325841,1005,100,,Invoice,,,,,,13/09/2018,13/09/2018,0.00,,6.56,,"-931,821.56"
,IN,AR,30325880,1005,100,,Invoice,,,,,,13/09/2018,13/09/2018,0.00,,364.41,,"-932,185.97"
,IN,AR,30325952,1005,100,,Invoice,,,,,,13/09/2018,13/09/2018,0.00,,10.38,,"-932,196.35"
,IN,AR,30325953,1005,100,,Invoice,,,,,,13/09/2018,13/09/2018,0.00,,2.08,,"-932,198.43"
,IN,AR,30325954,1005,100,,Invoice,,,,,,13/09/2018,13/09/2018,0.00,,4.15,,"-932,202.58"
,IN,AR,30325955,1005,100,,Invoice,,,,,,13/09/2018,13/09/2018,0.00,,14.53,,"-932,217.11"
,IN,AR,30325972,1005,100,,Invoice,,,,,,13/09/2018,13/09/2018,0.00,,16.65,,"-932,233.76"
,IN,AR,30326021,1005,100,,Invoice,,,,,,13/09/2018,13/09/2018,0.00,,3.28,,"-932,237.04"
,IN,AR,30326034,1005,100,,Invoice,,,,,,13/09/2018,13/09/2018,0.00,,4.78,,"-932,241.82"
,IN,AR,30326043,1005,100,,Invoice,,,,,,13/09/2018,13/09/2018,0.00,,36.44,,"-932,278.26"
,IN,AR,30326077,1005,100,,Invoice,,,,,,13/09/2018,13/09/2018,0.00,,15.25,,"-932,293.51"
,IN,AR,30326092,1005,100,,Invoice,,,,,,13/09/2018,13/09/2018,0.00,,23.13,,"-932,316.64"
,IN,AR,30326140,1005,100,,Invoice,,,,,,13/09/2018,13/09/2018,0.00,,78.88,,"-932,395.52"
,IN,AR,30326180,1005,100,,Invoice,,,,,,13/09/2018,13/09/2018,0.00,,3.64,,"-932,399.16"
,CN,AR,31018662,1005,100,,Credit Note,,,,,,14/09/2018,14/09/2018,1.94,,0.00,,"-932,397.22"
,CN,AR,31018722,1005,100,,Credit Note,,,,,,14/09/2018,14/09/2018,27.97,,0.00,,"-932,369.25"
,CN,AR,31018728,1005,100,,Credit Note,,,,,,14/09/2018,14/09/2018,8.42,,0.00,,"-932,360.83"
,CS,AR,32007879,1005,100,,Cash sale,,,,,,14/09/2018,14/09/2018,0.00,,10.93,,"-932,371.76"
,CS,AR,32007894,1005,100,,Cash sale,,,,,,14/09/2018,14/09/2018,0.00,,22.44,,"-932,394.20"
,CS,AR,32007909,1005,100,,Cash sale,,,,,,14/09/2018,14/09/2018,0.00,,11.86,,"-932,406.06"
,CS,AR,32007963,1005,100,,Cash sale,,,,,,14/09/2018,14/09/2018,0.00,,10.93,,"-932,416.99"
,CS,AR,32007973,1005,100,,Cash sale,,,,,,14/09/2018,14/09/2018,0.00,,48.14,,"-932,465.13"
,CS,AR,32007981,1005,100,,Cash sale,,,,,,14/09/2018,14/09/2018,0.00,,7.29,,"-932,472.42"
,CS,AR,32008004,1005,100,,Cash sale,,,,,,14/09/2018,14/09/2018,0.00,,7.29,,"-932,479.71"
,CS,AR,32008010,1005,100,,Cash sale,,,,,,14/09/2018,14/09/2018,0.00,,14.58,,"-932,494.29"
,CS,AR,32008017,1005,100,,Cash sale,,,,,,14/09/2018,14/09/2018,0.00,,14.53,,"-932,508.82"
,CS,AR,32008029,1005,100,,Cash sale,,,,,,14/09/2018,14/09/2018,0.00,,7.29,,"-932,516.11"
,CS,AR,32008044,1005,100,,Cash sale,,,,,,14/09/2018,14/09/2018,0.00,,3.64,,"-932,519.75"
,CS,AR,32008049,1005,100,,Cash sale,,,,,,14/09/2018,14/09/2018,0.00,,3.89,,"-932,523.64"
,CS,AR,32008053,1005,100,,Cash sale,,,,,,14/09/2018,14/09/2018,0.00,,3.64,,"-932,527.28"
,CS,AR,32008056,1005,100,,Cash sale,,,,,,14/09/2018,14/09/2018,0.00,,3.64,,"-932,530.92"
,CS,AR,32008062,1005,100,,Cash sale,,,,,,14/09/2018,14/09/2018,0.00,,7.29,,"-932,538.21"
,CS,AR,32008079,1005,100,,Cash sale,,,,,,14/09/2018,14/09/2018,0.00,,25.87,,"-932,564.08"
,CS,AR,32008140,1005,100,,Cash sale,,,,,,14/09/2018,14/09/2018,0.00,,25.51,,"-932,589.59"
,CS,AR,32008144,1005,100,,Cash sale,,,,,,14/09/2018,14/09/2018,0.00,,2.58,,"-932,592.17"
,CS,AR,32008153,1005,100,,Cash sale,,,,,,14/09/2018,14/09/2018,0.00,,12.71,,"-932,604.88"
,CS,AR,32008159,1005,100,,Cash sale,,,,,,14/09/2018,14/09/2018,0.00,,19.58,,"-932,624.46"
,CS,AR,32008171,1005,100,,Cash sale,,,,,,14/09/2018,14/09/2018,0.00,,3.64,,"-932,628.10"
,CS,AR,32008178,1005,100,,Cash sale,,,,,,14/09/2018,14/09/2018,0.00,,35.72,,"-932,663.82"
,CS,AR,32008184,1005,100,,Cash sale,,,,,,14/09/2018,14/09/2018,0.00,,42.08,,"-932,705.90"
,CS,AR,32008205,1005,100,,Cash sale,,,,,,14/09/2018,14/09/2018,0.00,,10.93,,"-932,716.83"
,CS,AR,32008211,1005,100,,Cash sale,,,,,,14/09/2018,14/09/2018,0.00,,9.03,,"-932,725.86"
,CS,AR,32008242,1005,100,,Cash sale,,,,,,14/09/2018,14/09/2018,0.00,,20.34,,"-932,746.20"
,CS,AR,32008243,1005,100,,Cash sale,,,,,,14/09/2018,14/09/2018,0.00,,5.08,,"-932,751.28"
,CS,AR,32008255,1005,100,,Cash sale,,,,,,14/09/2018,14/09/2018,0.00,,23.39,,"-932,774.67"
,CS,AR,32008273,1005,100,,Cash sale,,,,,,14/09/2018,14/09/2018,0.00,,30.08,,"-932,804.75"
,CS,AR,32008285,1005,100,,Cash sale,,,,,,14/09/2018,14/09/2018,0.00,,10.17,,"-932,814.92"
,CS,AR,32008299,1005,100,,Cash sale,,,,,,14/09/2018,14/09/2018,0.00,,10.93,,"-932,825.85"
,CS,AR,32008323,1005,100,,Cash sale,,,,,,14/09/2018,14/09/2018,0.00,,7.29,,"-932,833.14"
,CS,AR,32008334,1005,100,,Cash sale,,,,,,14/09/2018,14/09/2018,0.00,,3.64,,"-932,836.78"
,CS,AR,32008387,1005,100,,Cash sale,,,,,,14/09/2018,14/09/2018,0.00,,25.51,,"-932,862.29"
,CS,AR,32008408,1005,100,,Cash sale,,,,,,14/09/2018,14/09/2018,0.00,,10.93,,"-932,873.22"
,CS,AR,32008425,1005,100,,Cash sale,,,,,,14/09/2018,14/09/2018,0.00,,10.93,,"-932,884.15"
,CS,AR,32008472,1005,100,,Cash sale,,,,,,14/09/2018,14/09/2018,0.00,,7.29,,"-932,891.44"
,CS,AR,32008512,1005,100,,Cash sale,,,,,,14/09/2018,14/09/2018,0.00,,15.25,,"-932,906.69"
,CS,AR,32008515,1005,100,,Cash sale,,,,,,14/09/2018,14/09/2018,0.00,,6.02,,"-932,912.71"
,CS,AR,32008529,1005,100,,Cash sale,,,,,,14/09/2018,14/09/2018,0.00,,7.29,,"-932,920.00"
,CS,AR,32008533,1005,100,,Cash sale,,,,,,14/09/2018,14/09/2018,0.00,,7.29,,"-932,927.29"
,CS,AR,32008547,1005,100,,Cash sale,,,,,,14/09/2018,14/09/2018,0.00,,3.64,,"-932,930.93"
,CS,AR,32008572,1005,100,,Cash sale,,,,,,14/09/2018,14/09/2018,0.00,,12.71,,"-932,943.64"
,CS,AR,32008593,1005,100,,Cash sale,,,,,,14/09/2018,14/09/2018,0.00,,6.86,,"-932,950.50"
,CS,AR,32008629,1005,100,,Cash sale,,,,,,14/09/2018,14/09/2018,0.00,,10.93,,"-932,961.43"
,CS,AR,32008645,1005,100,,Cash sale,,,,,,14/09/2018,14/09/2018,0.00,,9.11,,"-932,970.54"
,CS,AR,32008669,1005,100,,Cash sale,,,,,,14/09/2018,14/09/2018,0.00,,10.93,,"-932,981.47"
,CS,AR,32008670,1005,100,,Cash sale,,,,,,14/09/2018,14/09/2018,0.00,,5.08,,"-932,986.55"
,CS,AR,32008680,1005,100,,Cash sale,,,,,,14/09/2018,14/09/2018,0.00,,12.20,,"-932,998.75"
,CS,AR,32008698,1005,100,,Cash sale,,,,,,14/09/2018,14/09/2018,0.00,,7.29,,"-933,006.04"
,CS,AR,32008708,1005,100,,Cash sale,,,,,,14/09/2018,14/09/2018,0.00,,10.93,,"-933,016.97"
,CS,AR,32008726,1005,100,,Cash sale,,,,,,14/09/2018,14/09/2018,0.00,,7.29,,"-933,024.26"
,CS,AR,32008741,1005,100,,Cash sale,,,,,,14/09/2018,14/09/2018,0.00,,3.64,,"-933,027.90"
,CS,AR,32008758,1005,100,,Cash sale,,,,,,14/09/2018,14/09/2018,0.00,,6.02,,"-933,033.92"
,CS,AR,32008767,1005,100,,Cash sale,,,,,,14/09/2018,14/09/2018,0.00,,7.29,,"-933,041.21"
,CS,AR,32008823,1005,100,,Cash sale,,,,,,14/09/2018,14/09/2018,0.00,,3.64,,"-933,044.85"
,CS,AR,32008831,1005,100,,Cash sale,,,,,,14/09/2018,14/09/2018,0.00,,3.03,,"-933,047.88"
,CS,AR,32008857,1005,100,,Cash sale,,,,,,14/09/2018,14/09/2018,0.00,,18.22,,"-933,066.10"
,CS,AR,32008877,1005,100,,Cash sale,,,,,,14/09/2018,14/09/2018,0.00,,7.29,,"-933,073.39"
,CS,AR,32008879,1005,100,,Cash sale,,,,,,14/09/2018,14/09/2018,0.00,,3.64,,"-933,077.03"
,IN,AR,30323527,1005,100,,Invoice,,,,,,14/09/2018,14/09/2018,0.00,,10.93,,"-933,087.96"
,IN,AR,30323553,1005,100,,Invoice,,,,,,14/09/2018,14/09/2018,0.00,,5.93,,"-933,093.89"
,IN,AR,30323554,1005,100,,Invoice,,,,,,14/09/2018,14/09/2018,0.00,,29.66,,"-933,123.55"
,IN,AR,30323560,1005,100,,Invoice,,,,,,14/09/2018,14/09/2018,0.00,,43.73,,"-933,167.28"
,IN,AR,30323638,1005,100,,Invoice,,,,,,14/09/2018,14/09/2018,0.00,,29.15,,"-933,196.43"
,IN,AR,30323676,1005,100,,Invoice,,,,,,14/09/2018,14/09/2018,0.00,,26.57,,"-933,223.00"
,IN,AR,30323682,1005,100,,Invoice,,,,,,14/09/2018,14/09/2018,0.00,,7.29,,"-933,230.29"
,IN,AR,30323696,1005,100,,Invoice,,,,,,14/09/2018,14/09/2018,0.00,,61.30,,"-933,291.59"
,IN,AR,30323712,1005,100,,Invoice,,,,,,14/09/2018,14/09/2018,0.00,,25.26,,"-933,316.85"
,IN,AR,30323718,1005,100,,Invoice,,,,,,14/09/2018,14/09/2018,0.00,,87.33,,"-933,404.18"
,IN,AR,30323719,1005,100,,Invoice,,,,,,14/09/2018,14/09/2018,0.00,,5.82,,"-933,410.00"
,IN,AR,30323728,1005,100,,Invoice,,,,,,14/09/2018,14/09/2018,0.00,,5.97,,"-933,415.97"
,IN,AR,30323751,1005,100,,Invoice,,,,,,14/09/2018,14/09/2018,0.00,,90.17,,"-933,506.14"
,IN,AR,30323769,1005,100,,Invoice,,,,,,14/09/2018,14/09/2018,0.00,,10.93,,"-933,517.07"
,IN,AR,30323778,1005,100,,Invoice,,,,,,14/09/2018,14/09/2018,0.00,,28.00,,"-933,545.07"
,IN,AR,30323789,1005,100,,Invoice,,,,,,14/09/2018,14/09/2018,0.00,,54.66,,"-933,599.73"
,IN,AR,30323826,1005,100,,Invoice,,,,,,14/09/2018,14/09/2018,0.00,,48.00,,"-933,647.73"
,IN,AR,30323876,1005,100,,Invoice,,,,,,14/09/2018,14/09/2018,0.00,,7.12,,"-933,654.85"
,IN,AR,30323877,1005,100,,Invoice,,,,,,14/09/2018,14/09/2018,0.00,,87.80,,"-933,742.65"
,IN,AR,30323886,1005,100,,Invoice,,,,,,14/09/2018,14/09/2018,0.00,,20.00,,"-933,762.65"
,IN,AR,30323907,1005,100,,Invoice,,,,,,14/09/2018,14/09/2018,0.00,,28.39,,"-933,791.04"
,IN,AR,30323930,1005,100,,Invoice,,,,,,14/09/2018,14/09/2018,0.00,,15.53,,"-933,806.57"
,IN,AR,30323931,1005,100,,Invoice,,,,,,14/09/2018,14/09/2018,0.00,,7.76,,"-933,814.33"
,IN,AR,30323933,1005,100,,Invoice,,,,,,14/09/2018,14/09/2018,0.00,,102.76,,"-933,917.09"
,IN,AR,30323939,1005,100,,Invoice,,,,,,14/09/2018,14/09/2018,0.00,,7.29,,"-933,924.38"
,IN,AR,30323948,1005,100,,Invoice,,,,,,14/09/2018,14/09/2018,0.00,,38.00,,"-933,962.38"
,IN,AR,30323952,1005,100,,Invoice,,,,,,14/09/2018,14/09/2018,0.00,,3.64,,"-933,966.02"
,IN,AR,30323965,1005,100,,Invoice,,,,,,14/09/2018,14/09/2018,0.00,,36.44,,"-934,002.46"
,IN,AR,30323971,1005,100,,Invoice,,,,,,14/09/2018,14/09/2018,0.00,,11.19,,"-934,013.65"
,IN,AR,30324022,1005,100,,Invoice,,,,,,14/09/2018,14/09/2018,0.00,,7.75,,"-934,021.40"
,IN,AR,30324058,1005,100,,Invoice,,,,,,14/09/2018,14/09/2018,0.00,,7.29,,"-934,028.69"
,IN,AR,30324155,1005,100,,Invoice,,,,,,14/09/2018,14/09/2018,0.00,,33.60,,"-934,062.29"
,IN,AR,30324160,1005,100,,Invoice,,,,,,14/09/2018,14/09/2018,0.00,,7.17,,"-934,069.46"
,IN,AR,30324174,1005,100,,Invoice,,,,,,14/09/2018,14/09/2018,0.00,,5.18,,"-934,074.64"
,IN,AR,30324182,1005,100,,Invoice,,,,,,14/09/2018,14/09/2018,0.00,,27.97,,"-934,102.61"
,IN,AR,30324198,1005,100,,Invoice,,,,,,14/09/2018,14/09/2018,0.00,,18.05,,"-934,120.66"
,IN,AR,30324228,1005,100,,Invoice,,,,,,14/09/2018,14/09/2018,0.00,,53.32,,"-934,173.98"
,IN,AR,30324286,1005,100,,Invoice,,,,,,14/09/2018,14/09/2018,0.00,,6.02,,"-934,180.00"
,IN,AR,30324303,1005,100,,Invoice,,,,,,14/09/2018,14/09/2018,0.00,,15.04,,"-934,195.04"
,IN,AR,30324324,1005,100,,Invoice,,,,,,14/09/2018,14/09/2018,0.00,,21.06,,"-934,216.10"
,IN,AR,30324375,1005,100,,Invoice,,,,,,14/09/2018,14/09/2018,0.00,,2.39,,"-934,218.49"
,IN,AR,30324398,1005,100,,Invoice,,,,,,14/09/2018,14/09/2018,0.00,,5.08,,"-934,223.57"
,IN,AR,30324399,1005,100,,Invoice,,,,,,14/09/2018,14/09/2018,0.00,,10.17,,"-934,233.74"
,IN,AR,30324400,1005,100,,Invoice,,,,,,14/09/2018,14/09/2018,0.00,,2.54,,"-934,236.28"
,IN,AR,30324401,1005,100,,Invoice,,,,,,14/09/2018,14/09/2018,0.00,,2.54,,"-934,238.82"
,IN,AR,30324406,1005,100,,Invoice,,,,,,14/09/2018,14/09/2018,0.00,,7.63,,"-934,246.45"
,IN,AR,30324473,1005,100,,Invoice,,,,,,14/09/2018,14/09/2018,0.00,,15.25,,"-934,261.70"
,IN,AR,30324481,1005,100,,Invoice,,,,,,14/09/2018,14/09/2018,0.00,,12.71,,"-934,274.41"
,IN,AR,30324540,1005,100,,Invoice,,,,,,14/09/2018,14/09/2018,0.00,,3.01,,"-934,277.42"
,IN,AR,30324564,1005,100,,Invoice,,,,,,14/09/2018,14/09/2018,0.00,,25.51,,"-934,302.93"
,IN,AR,30324593,1005,100,,Invoice,,,,,,14/09/2018,14/09/2018,0.00,,12.71,,"-934,315.64"
,IN,AR,30324622,1005,100,,Invoice,,,,,,14/09/2018,14/09/2018,0.00,,29.66,,"-934,345.30"
,IN,AR,30324665,1005,100,,Invoice,,,,,,14/09/2018,14/09/2018,0.00,,11.22,,"-934,356.52"
,IN,AR,30324776,1005,100,,Invoice,,,,,,14/09/2018,14/09/2018,0.00,,6.00,,"-934,362.52"
,IN,AR,30324794,1005,100,,Invoice,,,,,,14/09/2018,14/09/2018,0.00,,20.48,,"-934,383.00"
,IN,AR,30324820,1005,100,,Invoice,,,,,,14/09/2018,14/09/2018,0.00,,5.17,,"-934,388.17"
,IN,AR,30324865,1005,100,,Invoice,,,,,,14/09/2018,14/09/2018,0.00,,21.06,,"-934,409.23"
,IN,AR,30324954,1005,100,,Invoice,,,,,,14/09/2018,14/09/2018,0.00,,3.53,,"-934,412.76"
,IN,AR,30324970,1005,100,,Invoice,,,,,,14/09/2018,14/09/2018,0.00,,4.85,,"-934,417.61"
,IN,AR,30325005,1005,100,,Invoice,,,,,,14/09/2018,14/09/2018,0.00,,10.93,,"-934,428.54"
,IN,AR,30325007,1005,100,,Invoice,,,,,,14/09/2018,14/09/2018,0.00,,14.58,,"-934,443.12"
,IN,AR,30325114,1005,100,,Invoice,,,,,,14/09/2018,14/09/2018,0.00,,9.74,,"-934,452.86"
,IN,AR,30325121,1005,100,,Invoice,,,,,,14/09/2018,14/09/2018,0.00,,31.23,,"-934,484.09"
,IN,AR,30325135,1005,100,,Invoice,,,,,,14/09/2018,14/09/2018,0.00,,18.00,,"-934,502.09"
,IN,AR,30325140,1005,100,,Invoice,,,,,,14/09/2018,14/09/2018,0.00,,36.66,,"-934,538.75"
,IN,AR,30325147,1005,100,,Invoice,,,,,,14/09/2018,14/09/2018,0.00,,5.93,,"-934,544.68"
,IN,AR,30325167,1005,100,,Invoice,,,,,,14/09/2018,14/09/2018,0.00,,26.06,,"-934,570.74"
,IN,AR,30325176,1005,100,,Invoice,,,,,,14/09/2018,14/09/2018,0.00,,29.15,,"-934,599.89"
,IN,AR,30325192,1005,100,,Invoice,,,,,,14/09/2018,14/09/2018,0.00,,21.25,,"-934,621.14"
,IN,AR,30325197,1005,100,,Invoice,,,,,,14/09/2018,14/09/2018,0.00,,3.64,,"-934,624.78"
,IN,AR,30325204,1005,100,,Invoice,,,,,,14/09/2018,14/09/2018,0.00,,15.13,,"-934,639.91"
,IN,AR,30325220,1005,100,,Invoice,,,,,,14/09/2018,14/09/2018,0.00,,7.29,,"-934,647.20"
,IN,AR,30325228,1005,100,,Invoice,,,,,,14/09/2018,14/09/2018,0.00,,57.80,,"-934,705.00"
,IN,AR,30325265,1005,100,,Invoice,,,,,,14/09/2018,14/09/2018,0.00,,31.08,,"-934,736.08"
,IN,AR,30325296,1005,100,,Invoice,,,,,,14/09/2018,14/09/2018,0.00,,10.17,,"-934,746.25"
,IN,AR,30325305,1005,100,,Invoice,,,,,,14/09/2018,14/09/2018,0.00,,12.00,,"-934,758.25"
,IN,AR,30325315,1005,100,,Invoice,,,,,,14/09/2018,14/09/2018,0.00,,20.01,,"-934,778.26"
,IN,AR,30325322,1005,100,,Invoice,,,,,,14/09/2018,14/09/2018,0.00,,10.00,,"-934,788.26"
,IN,AR,30325371,1005,100,,Invoice,,,,,,14/09/2018,14/09/2018,0.00,,27.37,,"-934,815.63"
,IN,AR,30325393,1005,100,,Invoice,,,,,,14/09/2018,14/09/2018,0.00,,6.31,,"-934,821.94"
,IN,AR,30325394,1005,100,,Invoice,,,,,,14/09/2018,14/09/2018,0.00,,50.47,,"-934,872.41"
,IN,AR,30325413,1005,100,,Invoice,,,,,,14/09/2018,14/09/2018,0.00,,12.14,,"-934,884.55"
,IN,AR,30325444,1005,100,,Invoice,,,,,,14/09/2018,14/09/2018,0.00,,11.48,,"-934,896.03"
,IN,AR,30325472,1005,100,,Invoice,,,,,,14/09/2018,14/09/2018,0.00,,22.71,,"-934,918.74"
,IN,AR,30325481,1005,100,,Invoice,,,,,,14/09/2018,14/09/2018,0.00,,6.23,,"-934,924.97"
,IN,AR,30325514,1005,100,,Invoice,,,,,,14/09/2018,14/09/2018,0.00,,21.86,,"-934,946.83"
,IN,AR,30325528,1005,100,,Invoice,,,,,,14/09/2018,14/09/2018,0.00,,14.49,,"-934,961.32"
,IN,AR,30325615,1005,100,,Invoice,,,,,,14/09/2018,14/09/2018,0.00,,25.51,,"-934,986.83"
,IN,AR,30325681,1005,100,,Invoice,,,,,,14/09/2018,14/09/2018,0.00,,18.00,,"-935,004.83"
,IN,AR,30325719,1005,100,,Invoice,,,,,,14/09/2018,14/09/2018,0.00,,80.68,,"-935,085.51"
,IN,AR,30325740,1005,100,,Invoice,,,,,,14/09/2018,14/09/2018,0.00,,5.83,,"-935,091.34"
,IN,AR,30325756,1005,100,,Invoice,,,,,,14/09/2018,14/09/2018,0.00,,13.69,,"-935,105.03"
,IN,AR,30325757,1005,100,,Invoice,,,,,,14/09/2018,14/09/2018,0.00,,14.58,,"-935,119.61"
,IN,AR,30325765,1005,100,,Invoice,,,,,,14/09/2018,14/09/2018,0.00,,6.02,,"-935,125.63"
,IN,AR,30325770,1005,100,,Invoice,,,,,,14/09/2018,14/09/2018,0.00,,31.78,,"-935,157.41"
,IN,AR,30325777,1005,100,,Invoice,,,,,,14/09/2018,14/09/2018,0.00,,29.15,,"-935,186.56"
,IN,AR,30325802,1005,100,,Invoice,,,,,,14/09/2018,14/09/2018,0.00,,14.58,,"-935,201.14"
,IN,AR,30325831,1005,100,,Invoice,,,,,,14/09/2018,14/09/2018,0.00,,6.13,,"-935,207.27"
,IN,AR,30325862,1005,100,,Invoice,,,,,,14/09/2018,14/09/2018,0.00,,7.97,,"-935,215.24"
,IN,AR,30325894,1005,100,,Invoice,,,,,,14/09/2018,14/09/2018,0.00,,4.00,,"-935,219.24"
,IN,AR,30325895,1005,100,,Invoice,,,,,,14/09/2018,14/09/2018,0.00,,2.00,,"-935,221.24"
,IN,AR,30325959,1005,100,,Invoice,,,,,,14/09/2018,14/09/2018,0.00,,54.66,,"-935,275.90"
,IN,AR,30325993,1005,100,,Invoice,,,,,,14/09/2018,14/09/2018,0.00,,18.64,,"-935,294.54"
,IN,AR,30325997,1005,100,,Invoice,,,,,,14/09/2018,14/09/2018,0.00,,10.86,,"-935,305.40"
,IN,AR,30326018,1005,100,,Invoice,,,,,,14/09/2018,14/09/2018,0.00,,21.86,,"-935,327.26"
,IN,AR,30326047,1005,100,,Invoice,,,,,,14/09/2018,14/09/2018,0.00,,10.93,,"-935,338.19"
,IN,AR,30326064,1005,100,,Invoice,,,,,,14/09/2018,14/09/2018,0.00,,7.29,,"-935,345.48"
,IN,AR,30326066,1005,100,,Invoice,,,,,,14/09/2018,14/09/2018,0.00,,7.29,,"-935,352.77"
,IN,AR,30326103,1005,100,,Invoice,,,,,,14/09/2018,14/09/2018,0.00,,18.20,,"-935,370.97"
,IN,AR,30326117,1005,100,,Invoice,,,,,,14/09/2018,14/09/2018,0.00,,29.15,,"-935,400.12"
,IN,AR,30326131,1005,100,,Invoice,,,,,,14/09/2018,14/09/2018,0.00,,6.56,,"-935,406.68"
,IN,AR,30326184,1005,100,,Invoice,,,,,,14/09/2018,14/09/2018,0.00,,59.75,,"-935,466.43"
,IN,AR,30326224,1005,100,,Invoice,,,,,,14/09/2018,14/09/2018,0.00,,12.14,,"-935,478.57"
,IN,AR,30326236,1005,100,,Invoice,,,,,,14/09/2018,14/09/2018,0.00,,9.84,,"-935,488.41"
,IN,AR,30326261,1005,100,,Invoice,,,,,,14/09/2018,14/09/2018,0.00,,29.15,,"-935,517.56"
,IN,AR,30326262,1005,100,,Invoice,,,,,,14/09/2018,14/09/2018,0.00,,29.15,,"-935,546.71"
,CN,AR,31018945,1005,100,,Credit Note,,,,,,15/09/2018,15/09/2018,3.64,,0.00,,"-935,543.07"
,CN,AR,31018981,1005,100,,Credit Note,,,,,,15/09/2018,15/09/2018,7.29,,0.00,,"-935,535.78"
,CN,AR,31018985,1005,100,,Credit Note,,,,,,15/09/2018,15/09/2018,7.29,,0.00,,"-935,528.49"
,CR,AR,33000254,1005,100,,Cash Return,,,,,,15/09/2018,15/09/2018,7.63,,0.00,,"-935,520.86"
,CS,AR,32007926,1005,100,,Cash sale,,,,,,15/09/2018,15/09/2018,0.00,,7.29,,"-935,528.15"
,CS,AR,32007955,1005,100,,Cash sale,,,,,,15/09/2018,15/09/2018,0.00,,7.29,,"-935,535.44"
,CS,AR,32007974,1005,100,,Cash sale,,,,,,15/09/2018,15/09/2018,0.00,,36.10,,"-935,571.54"
,CS,AR,32007985,1005,100,,Cash sale,,,,,,15/09/2018,15/09/2018,0.00,,7.25,,"-935,578.79"
,CS,AR,32008219,1005,100,,Cash sale,,,,,,15/09/2018,15/09/2018,0.00,,7.29,,"-935,586.08"
,CS,AR,32008231,1005,100,,Cash sale,,,,,,15/09/2018,15/09/2018,0.00,,5.17,,"-935,591.25"
,CS,AR,32008293,1005,100,,Cash sale,,,,,,15/09/2018,15/09/2018,0.00,,10.93,,"-935,602.18"
,CS,AR,32008315,1005,100,,Cash sale,,,,,,15/09/2018,15/09/2018,0.00,,3.64,,"-935,605.82"
,CS,AR,32008504,1005,100,,Cash sale,,,,,,15/09/2018,15/09/2018,0.00,,18.22,,"-935,624.04"
,CS,AR,32008621,1005,100,,Cash sale,,,,,,15/09/2018,15/09/2018,0.00,,7.63,,"-935,631.67"
,CS,AR,32008686,1005,100,,Cash sale,,,,,,15/09/2018,15/09/2018,0.00,,5.93,,"-935,637.60"
,CS,AR,32008779,1005,100,,Cash sale,,,,,,15/09/2018,15/09/2018,0.00,,7.29,,"-935,644.89"
,CS,AR,32008848,1005,100,,Cash sale,,,,,,15/09/2018,15/09/2018,0.00,,14.58,,"-935,659.47"
,CS,AR,32008894,1005,100,,Cash sale,,,,,,15/09/2018,15/09/2018,0.00,,3.64,,"-935,663.11"
,IN,AR,30323555,1005,100,,Invoice,,,,,,15/09/2018,15/09/2018,0.00,,44.49,,"-935,707.60"
,IN,AR,30323652,1005,100,,Invoice,,,,,,15/09/2018,15/09/2018,0.00,,6.08,,"-935,713.68"
,IN,AR,30324055,1005,100,,Invoice,,,,,,15/09/2018,15/09/2018,0.00,,10.93,,"-935,724.61"
,IN,AR,30324066,1005,100,,Invoice,,,,,,15/09/2018,15/09/2018,0.00,,9.03,,"-935,733.64"
,IN,AR,30324110,1005,100,,Invoice,,,,,,15/09/2018,15/09/2018,0.00,,101.69,,"-935,835.33"
,IN,AR,30324209,1005,100,,Invoice,,,,,,15/09/2018,15/09/2018,0.00,,204.07,,"-936,039.40"
,IN,AR,30324642,1005,100,,Invoice,,,,,,15/09/2018,15/09/2018,0.00,,10.93,,"-936,050.33"
,IN,AR,30325324,1005,100,,Invoice,,,,,,15/09/2018,15/09/2018,0.00,,7.63,,"-936,057.96"
,IN,AR,30325780,1005,100,,Invoice,,,,,,15/09/2018,15/09/2018,0.00,,12.14,,"-936,070.10"
,IN,AR,30326148,1005,100,,Invoice,,,,,,15/09/2018,15/09/2018,0.00,,7.29,,"-936,077.39"
,IN,AR,30326201,1005,100,,Invoice,,,,,,15/09/2018,15/09/2018,0.00,,7.29,,"-936,084.68"
,IN,AR,30326229,1005,100,,Invoice,,,,,,15/09/2018,15/09/2018,0.00,,7.29,,"-936,091.97"
,IN,AR,30326232,1005,100,,Invoice,,,,,,15/09/2018,15/09/2018,0.00,,9.84,,"-936,101.81"
,IN,AR,30326234,1005,100,,Invoice,,,,,,15/09/2018,15/09/2018,0.00,,9.84,,"-936,111.65"
,CN,AR,31019005,1005,100,,Credit Note,,,,,,17/09/2018,17/09/2018,47.37,,0.00,,"-936,064.28"
,CN,AR,31019007,1005,100,,Credit Note,,,,,,17/09/2018,17/09/2018,2.37,,0.00,,"-936,061.91"
,CN,AR,31019051,1005,100,,Credit Note,,,,,,17/09/2018,17/09/2018,47.37,,0.00,,"-936,014.54"
,CN,AR,31019121,1005,100,,Credit Note,,,,,,17/09/2018,17/09/2018,29.15,,0.00,,"-935,985.39"
,CS,AR,32008899,1005,100,,Cash sale,,,,,,17/09/2018,17/09/2018,0.00,,11.22,,"-935,996.61"
,CS,AR,32008907,1005,100,,Cash sale,,,,,,17/09/2018,17/09/2018,0.00,,14.24,,"-936,010.85"
,CS,AR,32008917,1005,100,,Cash sale,,,,,,17/09/2018,17/09/2018,0.00,,7.29,,"-936,018.14"
,CS,AR,32008927,1005,100,,Cash sale,,,,,,17/09/2018,17/09/2018,0.00,,14.58,,"-936,032.72"
,CS,AR,32008937,1005,100,,Cash sale,,,,,,17/09/2018,17/09/2018,0.00,,10.93,,"-936,043.65"
,CS,AR,32008940,1005,100,,Cash sale,,,,,,17/09/2018,17/09/2018,0.00,,7.29,,"-936,050.94"
,CS,AR,32008943,1005,100,,Cash sale,,,,,,17/09/2018,17/09/2018,0.00,,36.10,,"-936,087.04"
,CS,AR,32008948,1005,100,,Cash sale,,,,,,17/09/2018,17/09/2018,0.00,,14.58,,"-936,101.62"
,CS,AR,32008958,1005,100,,Cash sale,,,,,,17/09/2018,17/09/2018,0.00,,10.93,,"-936,112.55"
,CS,AR,32008963,1005,100,,Cash sale,,,,,,17/09/2018,17/09/2018,0.00,,12.46,,"-936,125.01"
,CS,AR,32008976,1005,100,,Cash sale,,,,,,17/09/2018,17/09/2018,0.00,,10.93,,"-936,135.94"
,CS,AR,32008979,1005,100,,Cash sale,,,,,,17/09/2018,17/09/2018,0.00,,3.89,,"-936,139.83"
,CS,AR,32008987,1005,100,,Cash sale,,,,,,17/09/2018,17/09/2018,0.00,,7.29,,"-936,147.12"
,CS,AR,32008999,1005,100,,Cash sale,,,,,,17/09/2018,17/09/2018,0.00,,10.93,,"-936,158.05"
,CS,AR,32009005,1005,100,,Cash sale,,,,,,17/09/2018,17/09/2018,0.00,,7.29,,"-936,165.34"
,CS,AR,32009013,1005,100,,Cash sale,,,,,,17/09/2018,17/09/2018,0.00,,3.64,,"-936,168.98"
,CS,AR,32009016,1005,100,,Cash sale,,,,,,17/09/2018,17/09/2018,0.00,,10.34,,"-936,179.32"
,CS,AR,32009033,1005,100,,Cash sale,,,,,,17/09/2018,17/09/2018,0.00,,10.93,,"-936,190.25"
,CS,AR,32009034,1005,100,,Cash sale,,,,,,17/09/2018,17/09/2018,0.00,,10.93,,"-936,201.18"
,CS,AR,32009041,1005,100,,Cash sale,,,,,,17/09/2018,17/09/2018,0.00,,10.17,,"-936,211.35"
,CS,AR,32009056,1005,100,,Cash sale,,,,,,17/09/2018,17/09/2018,0.00,,38.77,,"-936,250.12"
,CS,AR,32009074,1005,100,,Cash sale,,,,,,17/09/2018,17/09/2018,0.00,,10.93,,"-936,261.05"
,CS,AR,32009079,1005,100,,Cash sale,,,,,,17/09/2018,17/09/2018,0.00,,3.64,,"-936,264.69"
,CS,AR,32009082,1005,100,,Cash sale,,,,,,17/09/2018,17/09/2018,0.00,,3.64,,"-936,268.33"
,CS,AR,32009098,1005,100,,Cash sale,,,,,,17/09/2018,17/09/2018,0.00,,23.39,,"-936,291.72"
,CS,AR,32009106,1005,100,,Cash sale,,,,,,17/09/2018,17/09/2018,0.00,,12.92,,"-936,304.64"
,CS,AR,32009108,1005,100,,Cash sale,,,,,,17/09/2018,17/09/2018,0.00,,30.08,,"-936,334.72"
,CS,AR,32009109,1005,100,,Cash sale,,,,,,17/09/2018,17/09/2018,0.00,,18.05,,"-936,352.77"
,CS,AR,32009141,1005,100,,Cash sale,,,,,,17/09/2018,17/09/2018,0.00,,2.54,,"-936,355.31"
,CS,AR,32009160,1005,100,,Cash sale,,,,,,17/09/2018,17/09/2018,0.00,,5.17,,"-936,360.48"
,CS,AR,32009170,1005,100,,Cash sale,,,,,,17/09/2018,17/09/2018,0.00,,7.29,,"-936,367.77"
,CS,AR,32009172,1005,100,,Cash sale,,,,,,17/09/2018,17/09/2018,0.00,,10.93,,"-936,378.70"
,CS,AR,32009175,1005,100,,Cash sale,,,,,,17/09/2018,17/09/2018,0.00,,2.16,,"-936,380.86"
,CS,AR,32009199,1005,100,,Cash sale,,,,,,17/09/2018,17/09/2018,0.00,,3.64,,"-936,384.50"
,CS,AR,32009203,1005,100,,Cash sale,,,,,,17/09/2018,17/09/2018,0.00,,12.17,,"-936,396.67"
,CS,AR,32009217,1005,100,,Cash sale,,,,,,17/09/2018,17/09/2018,0.00,,7.29,,"-936,403.96"
,CS,AR,32009226,1005,100,,Cash sale,,,,,,17/09/2018,17/09/2018,0.00,,7.29,,"-936,411.25"
,CS,AR,32009236,1005,100,,Cash sale,,,,,,17/09/2018,17/09/2018,0.00,,17.80,,"-936,429.05"
,CS,AR,32009271,1005,100,,Cash sale,,,,,,17/09/2018,17/09/2018,0.00,,9.15,,"-936,438.20"
,CS,AR,32009278,1005,100,,Cash sale,,,,,,17/09/2018,17/09/2018,0.00,,2.97,,"-936,441.17"
,CS,AR,32009291,1005,100,,Cash sale,,,,,,17/09/2018,17/09/2018,0.00,,14.58,,"-936,455.75"
,CS,AR,32009305,1005,100,,Cash sale,,,,,,17/09/2018,17/09/2018,0.00,,18.21,,"-936,473.96"
,CS,AR,32009315,1005,100,,Cash sale,,,,,,17/09/2018,17/09/2018,0.00,,10.93,,"-936,484.89"
,CS,AR,32009334,1005,100,,Cash sale,,,,,,17/09/2018,17/09/2018,0.00,,10.93,,"-936,495.82"
,CS,AR,32009345,1005,100,,Cash sale,,,,,,17/09/2018,17/09/2018,0.00,,3.64,,"-936,499.46"
,CS,AR,32009348,1005,100,,Cash sale,,,,,,17/09/2018,17/09/2018,0.00,,6.56,,"-936,506.02"
,CS,AR,32009365,1005,100,,Cash sale,,,,,,17/09/2018,17/09/2018,0.00,,10.93,,"-936,516.95"
,CS,AR,32009406,1005,100,,Cash sale,,,,,,17/09/2018,17/09/2018,0.00,,6.99,,"-936,523.94"
,CS,AR,32009414,1005,100,,Cash sale,,,,,,17/09/2018,17/09/2018,0.00,,3.64,,"-936,527.58"
,IN,AR,30326267,1005,100,,Invoice,,,,,,17/09/2018,17/09/2018,0.00,,29.66,,"-936,557.24"
,IN,AR,30326268,1005,100,,Invoice,,,,,,17/09/2018,17/09/2018,0.00,,38.56,,"-936,595.80"
,IN,AR,30326280,1005,100,,Invoice,,,,,,17/09/2018,17/09/2018,0.00,,14.58,,"-936,610.38"
,IN,AR,30326303,1005,100,,Invoice,,,,,,17/09/2018,17/09/2018,0.00,,2.03,,"-936,612.41"
,IN,AR,30326304,1005,100,,Invoice,,,,,,17/09/2018,17/09/2018,0.00,,14.18,,"-936,626.59"
,IN,AR,30326305,1005,100,,Invoice,,,,,,17/09/2018,17/09/2018,0.00,,8.10,,"-936,634.69"
,IN,AR,30326306,1005,100,,Invoice,,,,,,17/09/2018,17/09/2018,0.00,,24.31,,"-936,659.00"
,IN,AR,30326307,1005,100,,Invoice,,,,,,17/09/2018,17/09/2018,0.00,,4.05,,"-936,663.05"
,IN,AR,30326308,1005,100,,Invoice,,,,,,17/09/2018,17/09/2018,0.00,,14.18,,"-936,677.23"
,IN,AR,30326309,1005,100,,Invoice,,,,,,17/09/2018,17/09/2018,0.00,,10.13,,"-936,687.36"
,IN,AR,30326334,1005,100,,Invoice,,,,,,17/09/2018,17/09/2018,0.00,,7.29,,"-936,694.65"
,IN,AR,30326349,1005,100,,Invoice,,,,,,17/09/2018,17/09/2018,0.00,,80.31,,"-936,774.96"
,IN,AR,30326367,1005,100,,Invoice,,,,,,17/09/2018,17/09/2018,0.00,,3.98,,"-936,778.94"
,IN,AR,30326374,1005,100,,Invoice,,,,,,17/09/2018,17/09/2018,0.00,,68.81,,"-936,847.75"
,IN,AR,30326375,1005,100,,Invoice,,,,,,17/09/2018,17/09/2018,0.00,,92.54,,"-936,940.29"
,IN,AR,30326387,1005,100,,Invoice,,,,,,17/09/2018,17/09/2018,0.00,,22.03,,"-936,962.32"
,IN,AR,30326399,1005,100,,Invoice,,,,,,17/09/2018,17/09/2018,0.00,,28.00,,"-936,990.32"
,IN,AR,30326412,1005,100,,Invoice,,,,,,17/09/2018,17/09/2018,0.00,,95.44,,"-937,085.76"
,IN,AR,30326430,1005,100,,Invoice,,,,,,17/09/2018,17/09/2018,0.00,,34.00,,"-937,119.76"
,IN,AR,30326431,1005,100,,Invoice,,,,,,17/09/2018,17/09/2018,0.00,,16.00,,"-937,135.76"
,IN,AR,30326440,1005,100,,Invoice,,,,,,17/09/2018,17/09/2018,0.00,,2.75,,"-937,138.51"
,IN,AR,30326443,1005,100,,Invoice,,,,,,17/09/2018,17/09/2018,0.00,,45.76,,"-937,184.27"
,IN,AR,30326445,1005,100,,Invoice,,,,,,17/09/2018,17/09/2018,0.00,,5.51,,"-937,189.78"
,IN,AR,30326455,1005,100,,Invoice,,,,,,17/09/2018,17/09/2018,0.00,,11.69,,"-937,201.47"
,IN,AR,30326464,1005,100,,Invoice,,,,,,17/09/2018,17/09/2018,0.00,,20.00,,"-937,221.47"
,IN,AR,30326485,1005,100,,Invoice,,,,,,17/09/2018,17/09/2018,0.00,,11.64,,"-937,233.11"
,IN,AR,30326496,1005,100,,Invoice,,,,,,17/09/2018,17/09/2018,0.00,,38.00,,"-937,271.11"
,IN,AR,30326502,1005,100,,Invoice,,,,,,17/09/2018,17/09/2018,0.00,,47.37,,"-937,318.48"
,IN,AR,30326512,1005,100,,Invoice,,,,,,17/09/2018,17/09/2018,0.00,,17.71,,"-937,336.19"
,IN,AR,30326522,1005,100,,Invoice,,,,,,17/09/2018,17/09/2018,0.00,,25.51,,"-937,361.70"
,IN,AR,30326535,1005,100,,Invoice,,,,,,17/09/2018,17/09/2018,0.00,,23.26,,"-937,384.96"
,IN,AR,30326543,1005,100,,Invoice,,,,,,17/09/2018,17/09/2018,0.00,,7.75,,"-937,392.71"
,IN,AR,30326553,1005,100,,Invoice,,,,,,17/09/2018,17/09/2018,0.00,,7.19,,"-937,399.90"
,IN,AR,30326557,1005,100,,Invoice,,,,,,17/09/2018,17/09/2018,0.00,,16.08,,"-937,415.98"
,IN,AR,30326579,1005,100,,Invoice,,,,,,17/09/2018,17/09/2018,0.00,,4.24,,"-937,420.22"
,IN,AR,30326588,1005,100,,Invoice,,,,,,17/09/2018,17/09/2018,0.00,,6.36,,"-937,426.58"
,IN,AR,30326594,1005,100,,Invoice,,,,,,17/09/2018,17/09/2018,0.00,,8.39,,"-937,434.97"
,IN,AR,30326596,1005,100,,Invoice,,,,,,17/09/2018,17/09/2018,0.00,,8.47,,"-937,443.44"
,IN,AR,30326597,1005,100,,Invoice,,,,,,17/09/2018,17/09/2018,0.00,,14.83,,"-937,458.27"
,IN,AR,30326599,1005,100,,Invoice,,,,,,17/09/2018,17/09/2018,0.00,,25.85,,"-937,484.12"
,IN,AR,30326613,1005,100,,Invoice,,,,,,17/09/2018,17/09/2018,0.00,,10.38,,"-937,494.50"
,IN,AR,30326615,1005,100,,Invoice,,,,,,17/09/2018,17/09/2018,0.00,,5.18,,"-937,499.68"
,IN,AR,30326622,1005,100,,Invoice,,,,,,17/09/2018,17/09/2018,0.00,,10.93,,"-937,510.61"
,IN,AR,30326640,1005,100,,Invoice,,,,,,17/09/2018,17/09/2018,0.00,,100.49,,"-937,611.10"
,IN,AR,30326645,1005,100,,Invoice,,,,,,17/09/2018,17/09/2018,0.00,,25.42,,"-937,636.52"
,IN,AR,30326653,1005,100,,Invoice,,,,,,17/09/2018,17/09/2018,0.00,,23.90,,"-937,660.42"
,IN,AR,30326661,1005,100,,Invoice,,,,,,17/09/2018,17/09/2018,0.00,,25.76,,"-937,686.18"
,IN,AR,30326670,1005,100,,Invoice,,,,,,17/09/2018,17/09/2018,0.00,,21.06,,"-937,707.24"
,IN,AR,30326685,1005,100,,Invoice,,,,,,17/09/2018,17/09/2018,0.00,,10.59,,"-937,717.83"
,IN,AR,30326691,1005,100,,Invoice,,,,,,17/09/2018,17/09/2018,0.00,,5.51,,"-937,723.34"
,IN,AR,30326696,1005,100,,Invoice,,,,,,17/09/2018,17/09/2018,0.00,,2.12,,"-937,725.46"
,IN,AR,30326735,1005,100,,Invoice,,,,,,17/09/2018,17/09/2018,0.00,,7.63,,"-937,733.09"
,IN,AR,30326759,1005,100,,Invoice,,,,,,17/09/2018,17/09/2018,0.00,,7.63,,"-937,740.72"
,IN,AR,30326761,1005,100,,Invoice,,,,,,17/09/2018,17/09/2018,0.00,,9.49,,"-937,750.21"
,IN,AR,30326802,1005,100,,Invoice,,,,,,17/09/2018,17/09/2018,0.00,,12.71,,"-937,762.92"
,IN,AR,30326805,1005,100,,Invoice,,,,,,17/09/2018,17/09/2018,0.00,,21.19,,"-937,784.11"
,IN,AR,30326826,1005,100,,Invoice,,,,,,17/09/2018,17/09/2018,0.00,,10.17,,"-937,794.28"
,IN,AR,30326843,1005,100,,Invoice,,,,,,17/09/2018,17/09/2018,0.00,,3.64,,"-937,797.92"
,IN,AR,30326847,1005,100,,Invoice,,,,,,17/09/2018,17/09/2018,0.00,,3.64,,"-937,801.56"
,IN,AR,30326850,1005,100,,Invoice,,,,,,17/09/2018,17/09/2018,0.00,,10.93,,"-937,812.49"
,IN,AR,30326864,1005,100,,Invoice,,,,,,17/09/2018,17/09/2018,0.00,,11.02,,"-937,823.51"
,IN,AR,30326866,1005,100,,Invoice,,,,,,17/09/2018,17/09/2018,0.00,,3.64,,"-937,827.15"
,IN,AR,30326876,1005,100,,Invoice,,,,,,17/09/2018,17/09/2018,0.00,,6.13,,"-937,833.28"
,IN,AR,30326877,1005,100,,Invoice,,,,,,17/09/2018,17/09/2018,0.00,,15.21,,"-937,848.49"
,IN,AR,30326881,1005,100,,Invoice,,,,,,17/09/2018,17/09/2018,0.00,,13.78,,"-937,862.27"
,IN,AR,30326891,1005,100,,Invoice,,,,,,17/09/2018,17/09/2018,0.00,,13.14,,"-937,875.41"
,IN,AR,30326914,1005,100,,Invoice,,,,,,17/09/2018,17/09/2018,0.00,,182.20,,"-938,057.61"
,IN,AR,30326915,1005,100,,Invoice,,,,,,17/09/2018,17/09/2018,0.00,,8.77,,"-938,066.38"
,IN,AR,30326921,1005,100,,Invoice,,,,,,17/09/2018,17/09/2018,0.00,,8.47,,"-938,074.85"
,IN,AR,30326925,1005,100,,Invoice,,,,,,17/09/2018,17/09/2018,0.00,,14.58,,"-938,089.43"
,IN,AR,30326928,1005,100,,Invoice,,,,,,17/09/2018,17/09/2018,0.00,,68.34,,"-938,157.77"
,IN,AR,30326937,1005,100,,Invoice,,,,,,17/09/2018,17/09/2018,0.00,,64.00,,"-938,221.77"
,IN,AR,30326960,1005,100,,Invoice,,,,,,17/09/2018,17/09/2018,0.00,,5.17,,"-938,226.94"
,IN,AR,30326968,1005,100,,Invoice,,,,,,17/09/2018,17/09/2018,0.00,,39.40,,"-938,266.34"
,IN,AR,30326974,1005,100,,Invoice,,,,,,17/09/2018,17/09/2018,0.00,,36.10,,"-938,302.44"
,IN,AR,30327021,1005,100,,Invoice,,,,,,17/09/2018,17/09/2018,0.00,,3.64,,"-938,306.08"
,IN,AR,30327101,1005,100,,Invoice,,,,,,17/09/2018,17/09/2018,0.00,,27.88,,"-938,333.96"
,IN,AR,30327131,1005,100,,Invoice,,,,,,17/09/2018,17/09/2018,0.00,,26.06,,"-938,360.02"
,IN,AR,30327138,1005,100,,Invoice,,,,,,17/09/2018,17/09/2018,0.00,,51.02,,"-938,411.04"
,IN,AR,30327147,1005,100,,Invoice,,,,,,17/09/2018,17/09/2018,0.00,,12.14,,"-938,423.18"
,IN,AR,30327151,1005,100,,Invoice,,,,,,17/09/2018,17/09/2018,0.00,,21.61,,"-938,444.79"
,IN,AR,30327158,1005,100,,Invoice,,,,,,17/09/2018,17/09/2018,0.00,,9.84,,"-938,454.63"
,IN,AR,30327163,1005,100,,Invoice,,,,,,17/09/2018,17/09/2018,0.00,,39.41,,"-938,494.04"
,IN,AR,30327168,1005,100,,Invoice,,,,,,17/09/2018,17/09/2018,0.00,,6.86,,"-938,500.90"
,IN,AR,30327197,1005,100,,Invoice,,,,,,17/09/2018,17/09/2018,0.00,,5.08,,"-938,505.98"
,IN,AR,30327206,1005,100,,Invoice,,,,,,17/09/2018,17/09/2018,0.00,,8.00,,"-938,513.98"
,IN,AR,30327209,1005,100,,Invoice,,,,,,17/09/2018,17/09/2018,0.00,,24.01,,"-938,537.99"
,IN,AR,30327232,1005,100,,Invoice,,,,,,17/09/2018,17/09/2018,0.00,,43.75,,"-938,581.74"
,IN,AR,30327245,1005,100,,Invoice,,,,,,17/09/2018,17/09/2018,0.00,,16.82,,"-938,598.56"
,IN,AR,30327246,1005,100,,Invoice,,,,,,17/09/2018,17/09/2018,0.00,,10.52,,"-938,609.08"
,IN,AR,30327263,1005,100,,Invoice,,,,,,17/09/2018,17/09/2018,0.00,,26.58,,"-938,635.66"
,IN,AR,30327265,1005,100,,Invoice,,,,,,17/09/2018,17/09/2018,0.00,,172.46,,"-938,808.12"
,IN,AR,30327273,1005,100,,Invoice,,,,,,17/09/2018,17/09/2018,0.00,,16.83,,"-938,824.95"
,IN,AR,30327319,1005,100,,Invoice,,,,,,17/09/2018,17/09/2018,0.00,,2.54,,"-938,827.49"
,IN,AR,30327323,1005,100,,Invoice,,,,,,17/09/2018,17/09/2018,0.00,,11.36,,"-938,838.85"
,IN,AR,30327330,1005,100,,Invoice,,,,,,17/09/2018,17/09/2018,0.00,,26.69,,"-938,865.54"
,IN,AR,30327334,1005,100,,Invoice,,,,,,17/09/2018,17/09/2018,0.00,,12.75,,"-938,878.29"
,IN,AR,30327335,1005,100,,Invoice,,,,,,17/09/2018,17/09/2018,0.00,,9.56,,"-938,887.85"
,IN,AR,30327428,1005,100,,Invoice,,,,,,17/09/2018,17/09/2018,0.00,,3.76,,"-938,891.61"
,IN,AR,30327429,1005,100,,Invoice,,,,,,17/09/2018,17/09/2018,0.00,,7.53,,"-938,899.14"
,IN,AR,30327438,1005,100,,Invoice,,,,,,17/09/2018,17/09/2018,0.00,,11.02,,"-938,910.16"
,IN,AR,30327443,1005,100,,Invoice,,,,,,17/09/2018,17/09/2018,0.00,,13.63,,"-938,923.79"
,IN,AR,30327446,1005,100,,Invoice,,,,,,17/09/2018,17/09/2018,0.00,,14.19,,"-938,937.98"
,IN,AR,30327462,1005,100,,Invoice,,,,,,17/09/2018,17/09/2018,0.00,,8.21,,"-938,946.19"
,IN,AR,30327489,1005,100,,Invoice,,,,,,17/09/2018,17/09/2018,0.00,,10.53,,"-938,956.72"
,IN,AR,30327497,1005,100,,Invoice,,,,,,17/09/2018,17/09/2018,0.00,,4.08,,"-938,960.80"
,IN,AR,30327498,1005,100,,Invoice,,,,,,17/09/2018,17/09/2018,0.00,,28.59,,"-938,989.39"
,IN,AR,30327499,1005,100,,Invoice,,,,,,17/09/2018,17/09/2018,0.00,,16.34,,"-939,005.73"
,IN,AR,30327506,1005,100,,Invoice,,,,,,17/09/2018,17/09/2018,0.00,,21.86,,"-939,027.59"
,IN,AR,30327524,1005,100,,Invoice,,,,,,17/09/2018,17/09/2018,0.00,,35.08,,"-939,062.67"
,IN,AR,30327543,1005,100,,Invoice,,,,,,17/09/2018,17/09/2018,0.00,,4.00,,"-939,066.67"
,IN,AR,30327544,1005,100,,Invoice,,,,,,17/09/2018,17/09/2018,0.00,,4.00,,"-939,070.67"
,IN,AR,30327547,1005,100,,Invoice,,,,,,17/09/2018,17/09/2018,0.00,,4.15,,"-939,074.82"
,IN,AR,30327548,1005,100,,Invoice,,,,,,17/09/2018,17/09/2018,0.00,,8.31,,"-939,083.13"
,IN,AR,30327549,1005,100,,Invoice,,,,,,17/09/2018,17/09/2018,0.00,,6.23,,"-939,089.36"
,IN,AR,30327550,1005,100,,Invoice,,,,,,17/09/2018,17/09/2018,0.00,,4.15,,"-939,093.51"
,IN,AR,30327591,1005,100,,Invoice,,,,,,17/09/2018,17/09/2018,0.00,,7.37,,"-939,100.88"
,IN,AR,30327599,1005,100,,Invoice,,,,,,17/09/2018,17/09/2018,0.00,,10.93,,"-939,111.81"
,IN,AR,30327616,1005,100,,Invoice,,,,,,17/09/2018,17/09/2018,0.00,,1.75,,"-939,113.56"
,IN,AR,30327623,1005,100,,Invoice,,,,,,17/09/2018,17/09/2018,0.00,,42.05,,"-939,155.61"
,IN,AR,30327647,1005,100,,Invoice,,,,,,17/09/2018,17/09/2018,0.00,,29.15,,"-939,184.76"
,IN,AR,30327681,1005,100,,Invoice,,,,,,17/09/2018,17/09/2018,0.00,,10.93,,"-939,195.69"
,CN,AR,31019079,1005,100,,Credit Note,,,,,,18/09/2018,18/09/2018,70.46,,0.00,,"-939,125.23"
,CS,AR,32008923,1005,100,,Cash sale,,,,,,18/09/2018,18/09/2018,0.00,,7.29,,"-939,132.52"
,CS,AR,32008938,1005,100,,Cash sale,,,,,,18/09/2018,18/09/2018,0.00,,7.29,,"-939,139.81"
,CS,AR,32008952,1005,100,,Cash sale,,,,,,18/09/2018,18/09/2018,0.00,,6.02,,"-939,145.83"
,CS,AR,32008954,1005,100,,Cash sale,,,,,,18/09/2018,18/09/2018,0.00,,10.93,,"-939,156.76"
,CS,AR,32008967,1005,100,,Cash sale,,,,,,18/09/2018,18/09/2018,0.00,,3.64,,"-939,160.40"
,CS,AR,32008970,1005,100,,Cash sale,,,,,,18/09/2018,18/09/2018,0.00,,3.64,,"-939,164.04"
,CS,AR,32009003,1005,100,,Cash sale,,,,,,18/09/2018,18/09/2018,0.00,,7.29,,"-939,171.33"
,CS,AR,32009018,1005,100,,Cash sale,,,,,,18/09/2018,18/09/2018,0.00,,29.15,,"-939,200.48"
,CS,AR,32009029,1005,100,,Cash sale,,,,,,18/09/2018,18/09/2018,0.00,,8.64,,"-939,209.12"
,CS,AR,32009047,1005,100,,Cash sale,,,,,,18/09/2018,18/09/2018,0.00,,7.75,,"-939,216.87"
,CS,AR,32009049,1005,100,,Cash sale,,,,,,18/09/2018,18/09/2018,0.00,,5.68,,"-939,222.55"
,CS,AR,32009054,1005,100,,Cash sale,,,,,,18/09/2018,18/09/2018,0.00,,10.93,,"-939,233.48"
,CS,AR,32009061,1005,100,,Cash sale,,,,,,18/09/2018,18/09/2018,0.00,,14.58,,"-939,248.06"
,CS,AR,32009063,1005,100,,Cash sale,,,,,,18/09/2018,18/09/2018,0.00,,5.17,,"-939,253.23"
,CS,AR,32009081,1005,100,,Cash sale,,,,,,18/09/2018,18/09/2018,0.00,,8.58,,"-939,261.81"
,CS,AR,32009086,1005,100,,Cash sale,,,,,,18/09/2018,18/09/2018,0.00,,3.64,,"-939,265.45"
,CS,AR,32009104,1005,100,,Cash sale,,,,,,18/09/2018,18/09/2018,0.00,,5.85,,"-939,271.30"
,CS,AR,32009105,1005,100,,Cash sale,,,,,,18/09/2018,18/09/2018,0.00,,7.29,,"-939,278.59"
,CS,AR,32009121,1005,100,,Cash sale,,,,,,18/09/2018,18/09/2018,0.00,,7.80,,"-939,286.39"
,CS,AR,32009131,1005,100,,Cash sale,,,,,,18/09/2018,18/09/2018,0.00,,5.08,,"-939,291.47"
,CS,AR,32009136,1005,100,,Cash sale,,,,,,18/09/2018,18/09/2018,0.00,,10.34,,"-939,301.81"
,CS,AR,32009146,1005,100,,Cash sale,,,,,,18/09/2018,18/09/2018,0.00,,1.95,,"-939,303.76"
,CS,AR,32009148,1005,100,,Cash sale,,,,,,18/09/2018,18/09/2018,0.00,,7.29,,"-939,311.05"
,CS,AR,32009149,1005,100,,Cash sale,,,,,,18/09/2018,18/09/2018,0.00,,5.08,,"-939,316.13"
,CS,AR,32009154,1005,100,,Cash sale,,,,,,18/09/2018,18/09/2018,0.00,,3.64,,"-939,319.77"
,CS,AR,32009161,1005,100,,Cash sale,,,,,,18/09/2018,18/09/2018,0.00,,3.64,,"-939,323.41"
,CS,AR,32009169,1005,100,,Cash sale,,,,,,18/09/2018,18/09/2018,0.00,,3.64,,"-939,327.05"
,CS,AR,32009180,1005,100,,Cash sale,,,,,,18/09/2018,18/09/2018,0.00,,7.29,,"-939,334.34"
,CS,AR,32009188,1005,100,,Cash sale,,,,,,18/09/2018,18/09/2018,0.00,,7.29,,"-939,341.63"
,CS,AR,32009198,1005,100,,Cash sale,,,,,,18/09/2018,18/09/2018,0.00,,7.29,,"-939,348.92"
,CS,AR,32009209,1005,100,,Cash sale,,,,,,18/09/2018,18/09/2018,0.00,,17.15,,"-939,366.07"
,CS,AR,32009212,1005,100,,Cash sale,,,,,,18/09/2018,18/09/2018,0.00,,3.76,,"-939,369.83"
,CS,AR,32009235,1005,100,,Cash sale,,,,,,18/09/2018,18/09/2018,0.00,,7.29,,"-939,377.12"
,CS,AR,32009239,1005,100,,Cash sale,,,,,,18/09/2018,18/09/2018,0.00,,15.04,,"-939,392.16"
,CS,AR,32009243,1005,100,,Cash sale,,,,,,18/09/2018,18/09/2018,0.00,,14.58,,"-939,406.74"
,CS,AR,32009246,1005,100,,Cash sale,,,,,,18/09/2018,18/09/2018,0.00,,7.29,,"-939,414.03"
,CS,AR,32009253,1005,100,,Cash sale,,,,,,18/09/2018,18/09/2018,0.00,,33.05,,"-939,447.08"
,CS,AR,32009254,1005,100,,Cash sale,,,,,,18/09/2018,18/09/2018,0.00,,34.00,,"-939,481.08"
,CS,AR,32009283,1005,100,,Cash sale,,,,,,18/09/2018,18/09/2018,0.00,,11.86,,"-939,492.94"
,CS,AR,32009294,1005,100,,Cash sale,,,,,,18/09/2018,18/09/2018,0.00,,5.50,,"-939,498.44"
,CS,AR,32009296,1005,100,,Cash sale,,,,,,18/09/2018,18/09/2018,0.00,,14.58,,"-939,513.02"
,CS,AR,32009310,1005,100,,Cash sale,,,,,,18/09/2018,18/09/2018,0.00,,7.29,,"-939,520.31"
,CS,AR,32009313,1005,100,,Cash sale,,,,,,18/09/2018,18/09/2018,0.00,,5.47,,"-939,525.78"
,CS,AR,32009327,1005,100,,Cash sale,,,,,,18/09/2018,18/09/2018,0.00,,5.08,,"-939,530.86"
,CS,AR,32009341,1005,100,,Cash sale,,,,,,18/09/2018,18/09/2018,0.00,,3.64,,"-939,534.50"
,CS,AR,32009343,1005,100,,Cash sale,,,,,,18/09/2018,18/09/2018,0.00,,7.29,,"-939,541.79"
,CS,AR,32009350,1005,100,,Cash sale,,,,,,18/09/2018,18/09/2018,0.00,,7.29,,"-939,549.08"
,CS,AR,32009354,1005,100,,Cash sale,,,,,,18/09/2018,18/09/2018,0.00,,5.47,,"-939,554.55"
,CS,AR,32009369,1005,100,,Cash sale,,,,,,18/09/2018,18/09/2018,0.00,,10.34,,"-939,564.89"
,CS,AR,32009411,1005,100,,Cash sale,,,,,,18/09/2018,18/09/2018,0.00,,7.29,,"-939,572.18"
,CS,AR,32009417,1005,100,,Cash sale,,,,,,18/09/2018,18/09/2018,0.00,,10.93,,"-939,583.11"
,CS,AR,32009424,1005,100,,Cash sale,,,,,,18/09/2018,18/09/2018,0.00,,54.66,,"-939,637.77"
,IN,AR,30326269,1005,100,,Invoice,,,,,,18/09/2018,18/09/2018,0.00,,59.32,,"-939,697.09"
,IN,AR,30326292,1005,100,,Invoice,,,,,,18/09/2018,18/09/2018,0.00,,14.58,,"-939,711.67"
,IN,AR,30326295,1005,100,,Invoice,,,,,,18/09/2018,18/09/2018,0.00,,14.58,,"-939,726.25"
,IN,AR,30326297,1005,100,,Invoice,,,,,,18/09/2018,18/09/2018,0.00,,39.05,,"-939,765.30"
,IN,AR,30326302,1005,100,,Invoice,,,,,,18/09/2018,18/09/2018,0.00,,49.46,,"-939,814.76"
,IN,AR,30326322,1005,100,,Invoice,,,,,,18/09/2018,18/09/2018,0.00,,7.29,,"-939,822.05"
,IN,AR,30326325,1005,100,,Invoice,,,,,,18/09/2018,18/09/2018,0.00,,7.29,,"-939,829.34"
,IN,AR,30326329,1005,100,,Invoice,,,,,,18/09/2018,18/09/2018,0.00,,15.76,,"-939,845.10"
,IN,AR,30326330,1005,100,,Invoice,,,,,,18/09/2018,18/09/2018,0.00,,68.31,,"-939,913.41"
,IN,AR,30326336,1005,100,,Invoice,,,,,,18/09/2018,18/09/2018,0.00,,10.93,,"-939,924.34"
,IN,AR,30326337,1005,100,,Invoice,,,,,,18/09/2018,18/09/2018,0.00,,12.08,,"-939,936.42"
,IN,AR,30326343,1005,100,,Invoice,,,,,,18/09/2018,18/09/2018,0.00,,3.64,,"-939,940.06"
,IN,AR,30326344,1005,100,,Invoice,,,,,,18/09/2018,18/09/2018,0.00,,10.50,,"-939,950.56"
,IN,AR,30326363,1005,100,,Invoice,,,,,,18/09/2018,18/09/2018,0.00,,14.58,,"-939,965.14"
,IN,AR,30326376,1005,100,,Invoice,,,,,,18/09/2018,18/09/2018,0.00,,113.90,,"-940,079.04"
,IN,AR,30326386,1005,100,,Invoice,,,,,,18/09/2018,18/09/2018,0.00,,18.22,,"-940,097.26"
,IN,AR,30326392,1005,100,,Invoice,,,,,,18/09/2018,18/09/2018,0.00,,455.51,,"-940,552.77"
,IN,AR,30326393,1005,100,,Invoice,,,,,,18/09/2018,18/09/2018,0.00,,7.29,,"-940,560.06"
,IN,AR,30326404,1005,100,,Invoice,,,,,,18/09/2018,18/09/2018,0.00,,364.41,,"-940,924.47"
,IN,AR,30326408,1005,100,,Invoice,,,,,,18/09/2018,18/09/2018,0.00,,7.29,,"-940,931.76"
,IN,AR,30326477,1005,100,,Invoice,,,,,,18/09/2018,18/09/2018,0.00,,188.29,,"-941,120.05"
,IN,AR,30326479,1005,100,,Invoice,,,,,,18/09/2018,18/09/2018,0.00,,14.58,,"-941,134.63"
,IN,AR,30326480,1005,100,,Invoice,,,,,,18/09/2018,18/09/2018,0.00,,780.96,,"-941,915.59"
,IN,AR,30326486,1005,100,,Invoice,,,,,,18/09/2018,18/09/2018,0.00,,3.88,,"-941,919.47"
,IN,AR,30326503,1005,100,,Invoice,,,,,,18/09/2018,18/09/2018,0.00,,27.47,,"-941,946.94"
,IN,AR,30326508,1005,100,,Invoice,,,,,,18/09/2018,18/09/2018,0.00,,7.29,,"-941,954.23"
,IN,AR,30326509,1005,100,,Invoice,,,,,,18/09/2018,18/09/2018,0.00,,7.29,,"-941,961.52"
,IN,AR,30326525,1005,100,,Invoice,,,,,,18/09/2018,18/09/2018,0.00,,3.64,,"-941,965.16"
,IN,AR,30326545,1005,100,,Invoice,,,,,,18/09/2018,18/09/2018,0.00,,27.46,,"-941,992.62"
,IN,AR,30326547,1005,100,,Invoice,,,,,,18/09/2018,18/09/2018,0.00,,6.97,,"-941,999.59"
,IN,AR,30326559,1005,100,,Invoice,,,,,,18/09/2018,18/09/2018,0.00,,10.17,,"-942,009.76"
,IN,AR,30326562,1005,100,,Invoice,,,,,,18/09/2018,18/09/2018,0.00,,10.93,,"-942,020.69"
,IN,AR,30326572,1005,100,,Invoice,,,,,,18/09/2018,18/09/2018,0.00,,4.32,,"-942,025.01"
,IN,AR,30326575,1005,100,,Invoice,,,,,,18/09/2018,18/09/2018,0.00,,8.47,,"-942,033.48"
,IN,AR,30326591,1005,100,,Invoice,,,,,,18/09/2018,18/09/2018,0.00,,4.24,,"-942,037.72"
,IN,AR,30326606,1005,100,,Invoice,,,,,,18/09/2018,18/09/2018,0.00,,54.66,,"-942,092.38"
,IN,AR,30326625,1005,100,,Invoice,,,,,,18/09/2018,18/09/2018,0.00,,6.02,,"-942,098.40"
,IN,AR,30326636,1005,100,,Invoice,,,,,,18/09/2018,18/09/2018,0.00,,5.85,,"-942,104.25"
,IN,AR,30326651,1005,100,,Invoice,,,,,,18/09/2018,18/09/2018,0.00,,9.43,,"-942,113.68"
,IN,AR,30326654,1005,100,,Invoice,,,,,,18/09/2018,18/09/2018,0.00,,7.17,,"-942,120.85"
,IN,AR,30326662,1005,100,,Invoice,,,,,,18/09/2018,18/09/2018,0.00,,6.44,,"-942,127.29"
,IN,AR,30326677,1005,100,,Invoice,,,,,,18/09/2018,18/09/2018,0.00,,18.05,,"-942,145.34"
,IN,AR,30326699,1005,100,,Invoice,,,,,,18/09/2018,18/09/2018,0.00,,36.10,,"-942,181.44"
,IN,AR,30326736,1005,100,,Invoice,,,,,,18/09/2018,18/09/2018,0.00,,10.17,,"-942,191.61"
,IN,AR,30326747,1005,100,,Invoice,,,,,,18/09/2018,18/09/2018,0.00,,7.29,,"-942,198.90"
,IN,AR,30326752,1005,100,,Invoice,,,,,,18/09/2018,18/09/2018,0.00,,16.55,,"-942,215.45"
,IN,AR,30326800,1005,100,,Invoice,,,,,,18/09/2018,18/09/2018,0.00,,3.64,,"-942,219.09"
,IN,AR,30326806,1005,100,,Invoice,,,,,,18/09/2018,18/09/2018,0.00,,14.58,,"-942,233.67"
,IN,AR,30326814,1005,100,,Invoice,,,,,,18/09/2018,18/09/2018,0.00,,26.69,,"-942,260.36"
,IN,AR,30326817,1005,100,,Invoice,,,,,,18/09/2018,18/09/2018,0.00,,50.85,,"-942,311.21"
,IN,AR,30326821,1005,100,,Invoice,,,,,,18/09/2018,18/09/2018,0.00,,11.70,,"-942,322.91"
,IN,AR,30326824,1005,100,,Invoice,,,,,,18/09/2018,18/09/2018,0.00,,3.01,,"-942,325.92"
,IN,AR,30326829,1005,100,,Invoice,,,,,,18/09/2018,18/09/2018,0.00,,13.22,,"-942,339.14"
,IN,AR,30326832,1005,100,,Invoice,,,,,,18/09/2018,18/09/2018,0.00,,2.39,,"-942,341.53"
,IN,AR,30326833,1005,100,,Invoice,,,,,,18/09/2018,18/09/2018,0.00,,54.66,,"-942,396.19"
,IN,AR,30326835,1005,100,,Invoice,,,,,,18/09/2018,18/09/2018,0.00,,15.25,,"-942,411.44"
,IN,AR,30326841,1005,100,,Invoice,,,,,,18/09/2018,18/09/2018,0.00,,12.28,,"-942,423.72"
,IN,AR,30326844,1005,100,,Invoice,,,,,,18/09/2018,18/09/2018,0.00,,10.93,,"-942,434.65"
,IN,AR,30326853,1005,100,,Invoice,,,,,,18/09/2018,18/09/2018,0.00,,8.47,,"-942,443.12"
,IN,AR,30326855,1005,100,,Invoice,,,,,,18/09/2018,18/09/2018,0.00,,12.71,,"-942,455.83"
,IN,AR,30326859,1005,100,,Invoice,,,,,,18/09/2018,18/09/2018,0.00,,4.24,,"-942,460.07"
,IN,AR,30326863,1005,100,,Invoice,,,,,,18/09/2018,18/09/2018,0.00,,4.29,,"-942,464.36"
,IN,AR,30326883,1005,100,,Invoice,,,,,,18/09/2018,18/09/2018,0.00,,22.44,,"-942,486.80"
,IN,AR,30326887,1005,100,,Invoice,,,,,,18/09/2018,18/09/2018,0.00,,8.47,,"-942,495.27"
,IN,AR,30326894,1005,100,,Invoice,,,,,,18/09/2018,18/09/2018,0.00,,10.59,,"-942,505.86"
,IN,AR,30326896,1005,100,,Invoice,,,,,,18/09/2018,18/09/2018,0.00,,20.76,,"-942,526.62"
,IN,AR,30326897,1005,100,,Invoice,,,,,,18/09/2018,18/09/2018,0.00,,23.73,,"-942,550.35"
,IN,AR,30326911,1005,100,,Invoice,,,,,,18/09/2018,18/09/2018,0.00,,7.29,,"-942,557.64"
,IN,AR,30326940,1005,100,,Invoice,,,,,,18/09/2018,18/09/2018,0.00,,22.81,,"-942,580.45"
,IN,AR,30326956,1005,100,,Invoice,,,,,,18/09/2018,18/09/2018,0.00,,5.59,,"-942,586.04"
,IN,AR,30326958,1005,100,,Invoice,,,,,,18/09/2018,18/09/2018,0.00,,7.29,,"-942,593.33"
,IN,AR,30326965,1005,100,,Invoice,,,,,,18/09/2018,18/09/2018,0.00,,11.36,,"-942,604.69"
,IN,AR,30326981,1005,100,,Invoice,,,,,,18/09/2018,18/09/2018,0.00,,30.22,,"-942,634.91"
,IN,AR,30326997,1005,100,,Invoice,,,,,,18/09/2018,18/09/2018,0.00,,5.34,,"-942,640.25"
,IN,AR,30327003,1005,100,,Invoice,,,,,,18/09/2018,18/09/2018,0.00,,21.44,,"-942,661.69"
,IN,AR,30327007,1005,100,,Invoice,,,,,,18/09/2018,18/09/2018,0.00,,3.53,,"-942,665.22"
,IN,AR,30327031,1005,100,,Invoice,,,,,,18/09/2018,18/09/2018,0.00,,5.17,,"-942,670.39"
,IN,AR,30327032,1005,100,,Invoice,,,,,,18/09/2018,18/09/2018,0.00,,46.61,,"-942,717.00"
,IN,AR,30327033,1005,100,,Invoice,,,,,,18/09/2018,18/09/2018,0.00,,29.15,,"-942,746.15"
,IN,AR,30327038,1005,100,,Invoice,,,,,,18/09/2018,18/09/2018,0.00,,3.64,,"-942,749.79"
,IN,AR,30327046,1005,100,,Invoice,,,,,,18/09/2018,18/09/2018,0.00,,182.20,,"-942,931.99"
,IN,AR,30327060,1005,100,,Invoice,,,,,,18/09/2018,18/09/2018,0.00,,54.66,,"-942,986.65"
,IN,AR,30327102,1005,100,,Invoice,,,,,,18/09/2018,18/09/2018,0.00,,5.97,,"-942,992.62"
,IN,AR,30327103,1005,100,,Invoice,,,,,,18/09/2018,18/09/2018,0.00,,3.98,,"-942,996.60"
,IN,AR,30327104,1005,100,,Invoice,,,,,,18/09/2018,18/09/2018,0.00,,1.99,,"-942,998.59"
,IN,AR,30327105,1005,100,,Invoice,,,,,,18/09/2018,18/09/2018,0.00,,250.93,,"-943,249.52"
,IN,AR,30327116,1005,100,,Invoice,,,,,,18/09/2018,18/09/2018,0.00,,34.07,,"-943,283.59"
,IN,AR,30327122,1005,100,,Invoice,,,,,,18/09/2018,18/09/2018,0.00,,26.00,,"-943,309.59"
,IN,AR,30327155,1005,100,,Invoice,,,,,,18/09/2018,18/09/2018,0.00,,214.27,,"-943,523.86"
,IN,AR,30327170,1005,100,,Invoice,,,,,,18/09/2018,18/09/2018,0.00,,14.58,,"-943,538.44"
,IN,AR,30327186,1005,100,,Invoice,,,,,,18/09/2018,18/09/2018,0.00,,36.22,,"-943,574.66"
,IN,AR,30327195,1005,100,,Invoice,,,,,,18/09/2018,18/09/2018,0.00,,10.93,,"-943,585.59"
,IN,AR,30327198,1005,100,,Invoice,,,,,,18/09/2018,18/09/2018,0.00,,27.97,,"-943,613.56"
,IN,AR,30327228,1005,100,,Invoice,,,,,,18/09/2018,18/09/2018,0.00,,29.15,,"-943,642.71"
,IN,AR,30327257,1005,100,,Invoice,,,,,,18/09/2018,18/09/2018,0.00,,14.58,,"-943,657.29"
,IN,AR,30327270,1005,100,,Invoice,,,,,,18/09/2018,18/09/2018,0.00,,5.47,,"-943,662.76"
,IN,AR,30327290,1005,100,,Invoice,,,,,,18/09/2018,18/09/2018,0.00,,116.00,,"-943,778.76"
,IN,AR,30327292,1005,100,,Invoice,,,,,,18/09/2018,18/09/2018,0.00,,9.10,,"-943,787.86"
,IN,AR,30327303,1005,100,,Invoice,,,,,,18/09/2018,18/09/2018,0.00,,35.59,,"-943,823.45"
,IN,AR,30327351,1005,100,,Invoice,,,,,,18/09/2018,18/09/2018,0.00,,46.10,,"-943,869.55"
,IN,AR,30327386,1005,100,,Invoice,,,,,,18/09/2018,18/09/2018,0.00,,18.98,,"-943,888.53"
,IN,AR,30327387,1005,100,,Invoice,,,,,,18/09/2018,18/09/2018,0.00,,140.01,,"-944,028.54"
,IN,AR,30327388,1005,100,,Invoice,,,,,,18/09/2018,18/09/2018,0.00,,45.08,,"-944,073.62"
,IN,AR,30327394,1005,100,,Invoice,,,,,,18/09/2018,18/09/2018,0.00,,18.31,,"-944,091.93"
,IN,AR,30327430,1005,100,,Invoice,,,,,,18/09/2018,18/09/2018,0.00,,5.64,,"-944,097.57"
,IN,AR,30327432,1005,100,,Invoice,,,,,,18/09/2018,18/09/2018,0.00,,7.02,,"-944,104.59"
,IN,AR,30327434,1005,100,,Invoice,,,,,,18/09/2018,18/09/2018,0.00,,7.02,,"-944,111.61"
,IN,AR,30327435,1005,100,,Invoice,,,,,,18/09/2018,18/09/2018,0.00,,3.51,,"-944,115.12"
,IN,AR,30327439,1005,100,,Invoice,,,,,,18/09/2018,18/09/2018,0.00,,14.00,,"-944,129.12"
,IN,AR,30327445,1005,100,,Invoice,,,,,,18/09/2018,18/09/2018,0.00,,14.58,,"-944,143.70"
,IN,AR,30327448,1005,100,,Invoice,,,,,,18/09/2018,18/09/2018,0.00,,86.73,,"-944,230.43"
,IN,AR,30327456,1005,100,,Invoice,,,,,,18/09/2018,18/09/2018,0.00,,10.93,,"-944,241.36"
,IN,AR,30327468,1005,100,,Invoice,,,,,,18/09/2018,18/09/2018,0.00,,7.29,,"-944,248.65"
,IN,AR,30327470,1005,100,,Invoice,,,,,,18/09/2018,18/09/2018,0.00,,5.64,,"-944,254.29"
,IN,AR,30327483,1005,100,,Invoice,,,,,,18/09/2018,18/09/2018,0.00,,145.76,,"-944,400.05"
,IN,AR,30327519,1005,100,,Invoice,,,,,,18/09/2018,18/09/2018,0.00,,16.78,,"-944,416.83"
,IN,AR,30327535,1005,100,,Invoice,,,,,,18/09/2018,18/09/2018,0.00,,9.66,,"-944,426.49"
,IN,AR,30327551,1005,100,,Invoice,,,,,,18/09/2018,18/09/2018,0.00,,6.23,,"-944,432.72"
,IN,AR,30327552,1005,100,,Invoice,,,,,,18/09/2018,18/09/2018,0.00,,16.61,,"-944,449.33"
,IN,AR,30327579,1005,100,,Invoice,,,,,,18/09/2018,18/09/2018,0.00,,25.42,,"-944,474.75"
,IN,AR,30327583,1005,100,,Invoice,,,,,,18/09/2018,18/09/2018,0.00,,21.74,,"-944,496.49"
,IN,AR,30327608,1005,100,,Invoice,,,,,,18/09/2018,18/09/2018,0.00,,8.47,,"-944,504.96"
,IN,AR,30327622,1005,100,,Invoice,,,,,,18/09/2018,18/09/2018,0.00,,3.64,,"-944,508.60"
,IN,AR,30327643,1005,100,,Invoice,,,,,,18/09/2018,18/09/2018,0.00,,118.32,,"-944,626.92"
,IN,AR,30327656,1005,100,,Invoice,,,,,,18/09/2018,18/09/2018,0.00,,3.64,,"-944,630.56"
,IN,AR,30327663,1005,100,,Invoice,,,,,,18/09/2018,18/09/2018,0.00,,7.29,,"-944,637.85"
,IN,AR,30327667,1005,100,,Invoice,,,,,,18/09/2018,18/09/2018,0.00,,2.97,,"-944,640.82"
,IN,AR,30327682,1005,100,,Invoice,,,,,,18/09/2018,18/09/2018,0.00,,29.15,,"-944,669.97"
,IN,AR,30327684,1005,100,,Invoice,,,,,,18/09/2018,18/09/2018,0.00,,72.88,,"-944,742.85"
,CS,AR,32008900,1005,100,,Cash sale,,,,,,19/09/2018,19/09/2018,0.00,,11.22,,"-944,754.07"
,CS,AR,32008904,1005,100,,Cash sale,,,,,,19/09/2018,19/09/2018,0.00,,3.64,,"-944,757.71"
,CS,AR,32008905,1005,100,,Cash sale,,,,,,19/09/2018,19/09/2018,0.00,,35.12,,"-944,792.83"
,CS,AR,32008911,1005,100,,Cash sale,,,,,,19/09/2018,19/09/2018,0.00,,3.64,,"-944,796.47"
,CS,AR,32008913,1005,100,,Cash sale,,,,,,19/09/2018,19/09/2018,0.00,,25.55,,"-944,822.02"
,CS,AR,32008922,1005,100,,Cash sale,,,,,,19/09/2018,19/09/2018,0.00,,10.93,,"-944,832.95"
,CS,AR,32008929,1005,100,,Cash sale,,,,,,19/09/2018,19/09/2018,0.00,,3.64,,"-944,836.59"
,CS,AR,32008932,1005,100,,Cash sale,,,,,,19/09/2018,19/09/2018,0.00,,3.64,,"-944,840.23"
,CS,AR,32008947,1005,100,,Cash sale,,,,,,19/09/2018,19/09/2018,0.00,,7.29,,"-944,847.52"
,CS,AR,32008955,1005,100,,Cash sale,,,,,,19/09/2018,19/09/2018,0.00,,3.64,,"-944,851.16"
,CS,AR,32008988,1005,100,,Cash sale,,,,,,19/09/2018,19/09/2018,0.00,,3.64,,"-944,854.80"
,CS,AR,32008989,1005,100,,Cash sale,,,,,,19/09/2018,19/09/2018,0.00,,7.29,,"-944,862.09"
,CS,AR,32008991,1005,100,,Cash sale,,,,,,19/09/2018,19/09/2018,0.00,,7.29,,"-944,869.38"
,CS,AR,32008993,1005,100,,Cash sale,,,,,,19/09/2018,19/09/2018,0.00,,10.93,,"-944,880.31"
,CS,AR,32008998,1005,100,,Cash sale,,,,,,19/09/2018,19/09/2018,0.00,,10.93,,"-944,891.24"
,CS,AR,32009009,1005,100,,Cash sale,,,,,,19/09/2018,19/09/2018,0.00,,5.86,,"-944,897.10"
,CS,AR,32009019,1005,100,,Cash sale,,,,,,19/09/2018,19/09/2018,0.00,,5.17,,"-944,902.27"
,CS,AR,32009027,1005,100,,Cash sale,,,,,,19/09/2018,19/09/2018,0.00,,3.64,,"-944,905.91"
,CS,AR,32009051,1005,100,,Cash sale,,,,,,19/09/2018,19/09/2018,0.00,,12.92,,"-944,918.83"
,CS,AR,32009059,1005,100,,Cash sale,,,,,,19/09/2018,19/09/2018,0.00,,10.93,,"-944,929.76"
,CS,AR,32009068,1005,100,,Cash sale,,,,,,19/09/2018,19/09/2018,0.00,,6.43,,"-944,936.19"
,CS,AR,32009077,1005,100,,Cash sale,,,,,,19/09/2018,19/09/2018,0.00,,14.58,,"-944,950.77"
,CS,AR,32009087,1005,100,,Cash sale,,,,,,19/09/2018,19/09/2018,0.00,,3.64,,"-944,954.41"
,CS,AR,32009091,1005,100,,Cash sale,,,,,,19/09/2018,19/09/2018,0.00,,10.17,,"-944,964.58"
,CS,AR,32009124,1005,100,,Cash sale,,,,,,19/09/2018,19/09/2018,0.00,,3.64,,"-944,968.22"
,CS,AR,32009126,1005,100,,Cash sale,,,,,,19/09/2018,19/09/2018,0.00,,3.64,,"-944,971.86"
,CS,AR,32009133,1005,100,,Cash sale,,,,,,19/09/2018,19/09/2018,0.00,,7.29,,"-944,979.15"
,CS,AR,32009152,1005,100,,Cash sale,,,,,,19/09/2018,19/09/2018,0.00,,27.97,,"-945,007.12"
,CS,AR,32009162,1005,100,,Cash sale,,,,,,19/09/2018,19/09/2018,0.00,,10.93,,"-945,018.05"
,CS,AR,32009166,1005,100,,Cash sale,,,,,,19/09/2018,19/09/2018,0.00,,29.14,,"-945,047.19"
,CS,AR,32009183,1005,100,,Cash sale,,,,,,19/09/2018,19/09/2018,0.00,,8.14,,"-945,055.33"
,CS,AR,32009190,1005,100,,Cash sale,,,,,,19/09/2018,19/09/2018,0.00,,5.17,,"-945,060.50"
,CS,AR,32009197,1005,100,,Cash sale,,,,,,19/09/2018,19/09/2018,0.00,,5.17,,"-945,065.67"
,CS,AR,32009215,1005,100,,Cash sale,,,,,,19/09/2018,19/09/2018,0.00,,19.58,,"-945,085.25"
,CS,AR,32009221,1005,100,,Cash sale,,,,,,19/09/2018,19/09/2018,0.00,,18.98,,"-945,104.23"
,CS,AR,32009223,1005,100,,Cash sale,,,,,,19/09/2018,19/09/2018,0.00,,5.93,,"-945,110.16"
,CS,AR,32009225,1005,100,,Cash sale,,,,,,19/09/2018,19/09/2018,0.00,,3.64,,"-945,113.80"
,CS,AR,32009250,1005,100,,Cash sale,,,,,,19/09/2018,19/09/2018,0.00,,7.29,,"-945,121.09"
,CS,AR,32009260,1005,100,,Cash sale,,,,,,19/09/2018,19/09/2018,0.00,,10.93,,"-945,132.02"
,CS,AR,32009270,1005,100,,Cash sale,,,,,,19/09/2018,19/09/2018,0.00,,7.29,,"-945,139.31"
,CS,AR,32009279,1005,100,,Cash sale,,,,,,19/09/2018,19/09/2018,0.00,,14.58,,"-945,153.89"
,CS,AR,32009280,1005,100,,Cash sale,,,,,,19/09/2018,19/09/2018,0.00,,18.22,,"-945,172.11"
,CS,AR,32009281,1005,100,,Cash sale,,,,,,19/09/2018,19/09/2018,0.00,,9.10,,"-945,181.21"
,CS,AR,32009286,1005,100,,Cash sale,,,,,,19/09/2018,19/09/2018,0.00,,10.93,,"-945,192.14"
,CS,AR,32009298,1005,100,,Cash sale,,,,,,19/09/2018,19/09/2018,0.00,,14.83,,"-945,206.97"
,CS,AR,32009300,1005,100,,Cash sale,,,,,,19/09/2018,19/09/2018,0.00,,51.60,,"-945,258.57"
,CS,AR,32009301,1005,100,,Cash sale,,,,,,19/09/2018,19/09/2018,0.00,,12.03,,"-945,270.60"
,CS,AR,32009316,1005,100,,Cash sale,,,,,,19/09/2018,19/09/2018,0.00,,7.29,,"-945,277.89"
,CS,AR,32009322,1005,100,,Cash sale,,,,,,19/09/2018,19/09/2018,0.00,,10.93,,"-945,288.82"
,CS,AR,32009336,1005,100,,Cash sale,,,,,,19/09/2018,19/09/2018,0.00,,25.51,,"-945,314.33"
,CS,AR,32009337,1005,100,,Cash sale,,,,,,19/09/2018,19/09/2018,0.00,,7.29,,"-945,321.62"
,CS,AR,32009347,1005,100,,Cash sale,,,,,,19/09/2018,19/09/2018,0.00,,9.84,,"-945,331.46"
,CS,AR,32009363,1005,100,,Cash sale,,,,,,19/09/2018,19/09/2018,0.00,,10.99,,"-945,342.45"
,IN,AR,30326265,1005,100,,Invoice,,,,,,19/09/2018,19/09/2018,0.00,,84.54,,"-945,426.99"
,IN,AR,30326270,1005,100,,Invoice,,,,,,19/09/2018,19/09/2018,0.00,,35.59,,"-945,462.58"
,IN,AR,30326283,1005,100,,Invoice,,,,,,19/09/2018,19/09/2018,0.00,,26.10,,"-945,488.68"
,IN,AR,30326284,1005,100,,Invoice,,,,,,19/09/2018,19/09/2018,0.00,,54.66,,"-945,543.34"
,IN,AR,30326298,1005,100,,Invoice,,,,,,19/09/2018,19/09/2018,0.00,,36.61,,"-945,579.95"
,IN,AR,30326319,1005,100,,Invoice,,,,,,19/09/2018,19/09/2018,0.00,,18.98,,"-945,598.93"
,IN,AR,30326359,1005,100,,Invoice,,,,,,19/09/2018,19/09/2018,0.00,,54.66,,"-945,653.59"
,IN,AR,30326368,1005,100,,Invoice,,,,,,19/09/2018,19/09/2018,0.00,,5.97,,"-945,659.56"
,IN,AR,30326369,1005,100,,Invoice,,,,,,19/09/2018,19/09/2018,0.00,,7.97,,"-945,667.53"
,IN,AR,30326377,1005,100,,Invoice,,,,,,19/09/2018,19/09/2018,0.00,,59.32,,"-945,726.85"
,IN,AR,30326406,1005,100,,Invoice,,,,,,19/09/2018,19/09/2018,0.00,,21.86,,"-945,748.71"
,IN,AR,30326407,1005,100,,Invoice,,,,,,19/09/2018,19/09/2018,0.00,,14.83,,"-945,763.54"
,IN,AR,30326423,1005,100,,Invoice,,,,,,19/09/2018,19/09/2018,0.00,,36.44,,"-945,799.98"
,IN,AR,30326425,1005,100,,Invoice,,,,,,19/09/2018,19/09/2018,0.00,,14.58,,"-945,814.56"
,IN,AR,30326426,1005,100,,Invoice,,,,,,19/09/2018,19/09/2018,0.00,,3.64,,"-945,818.20"
,IN,AR,30326432,1005,100,,Invoice,,,,,,19/09/2018,19/09/2018,0.00,,30.00,,"-945,848.20"
,IN,AR,30326438,1005,100,,Invoice,,,,,,19/09/2018,19/09/2018,0.00,,7.29,,"-945,855.49"
,IN,AR,30326452,1005,100,,Invoice,,,,,,19/09/2018,19/09/2018,0.00,,40.00,,"-945,895.49"
,IN,AR,30326456,1005,100,,Invoice,,,,,,19/09/2018,19/09/2018,0.00,,2.92,,"-945,898.41"
,IN,AR,30326459,1005,100,,Invoice,,,,,,19/09/2018,19/09/2018,0.00,,56.95,,"-945,955.36"
,IN,AR,30326469,1005,100,,Invoice,,,,,,19/09/2018,19/09/2018,0.00,,54.66,,"-946,010.02"
,IN,AR,30326472,1005,100,,Invoice,,,,,,19/09/2018,19/09/2018,0.00,,35.69,,"-946,045.71"
,IN,AR,30326518,1005,100,,Invoice,,,,,,19/09/2018,19/09/2018,0.00,,29.18,,"-946,074.89"
,IN,AR,30326524,1005,100,,Invoice,,,,,,19/09/2018,19/09/2018,0.00,,7.29,,"-946,082.18"
,IN,AR,30326530,1005,100,,Invoice,,,,,,19/09/2018,19/09/2018,0.00,,9.56,,"-946,091.74"
,IN,AR,30326531,1005,100,,Invoice,,,,,,19/09/2018,19/09/2018,0.00,,3.19,,"-946,094.93"
,IN,AR,30326538,1005,100,,Invoice,,,,,,19/09/2018,19/09/2018,0.00,,28.00,,"-946,122.93"
,IN,AR,30326565,1005,100,,Invoice,,,,,,19/09/2018,19/09/2018,0.00,,53.39,,"-946,176.32"
,IN,AR,30326577,1005,100,,Invoice,,,,,,19/09/2018,19/09/2018,0.00,,4.24,,"-946,180.56"
,IN,AR,30326581,1005,100,,Invoice,,,,,,19/09/2018,19/09/2018,0.00,,22.37,,"-946,202.93"
,IN,AR,30326589,1005,100,,Invoice,,,,,,19/09/2018,19/09/2018,0.00,,2.12,,"-946,205.05"
,IN,AR,30326611,1005,100,,Invoice,,,,,,19/09/2018,19/09/2018,0.00,,149.09,,"-946,354.14"
,IN,AR,30326620,1005,100,,Invoice,,,,,,19/09/2018,19/09/2018,0.00,,10.93,,"-946,365.07"
,IN,AR,30326624,1005,100,,Invoice,,,,,,19/09/2018,19/09/2018,0.00,,28.68,,"-946,393.75"
,IN,AR,30326629,1005,100,,Invoice,,,,,,19/09/2018,19/09/2018,0.00,,27.03,,"-946,420.78"
,IN,AR,30326630,1005,100,,Invoice,,,,,,19/09/2018,19/09/2018,0.00,,52.58,,"-946,473.36"
,IN,AR,30326634,1005,100,,Invoice,,,,,,19/09/2018,19/09/2018,0.00,,306.10,,"-946,779.46"
,IN,AR,30326646,1005,100,,Invoice,,,,,,19/09/2018,19/09/2018,0.00,,81.36,,"-946,860.82"
,IN,AR,30326647,1005,100,,Invoice,,,,,,19/09/2018,19/09/2018,0.00,,5.08,,"-946,865.90"
,IN,AR,30326648,1005,100,,Invoice,,,,,,19/09/2018,19/09/2018,0.00,,43.22,,"-946,909.12"
,IN,AR,30326655,1005,100,,Invoice,,,,,,19/09/2018,19/09/2018,0.00,,26.29,,"-946,935.41"
,IN,AR,30326687,1005,100,,Invoice,,,,,,19/09/2018,19/09/2018,0.00,,14.58,,"-946,949.99"
,IN,AR,30326688,1005,100,,Invoice,,,,,,19/09/2018,19/09/2018,0.00,,20.88,,"-946,970.87"
,IN,AR,30326693,1005,100,,Invoice,,,,,,19/09/2018,19/09/2018,0.00,,5.17,,"-946,976.04"
,IN,AR,30326705,1005,100,,Invoice,,,,,,19/09/2018,19/09/2018,0.00,,180.05,,"-947,156.09"
,IN,AR,30326727,1005,100,,Invoice,,,,,,19/09/2018,19/09/2018,0.00,,12.71,,"-947,168.80"
,IN,AR,30326737,1005,100,,Invoice,,,,,,19/09/2018,19/09/2018,0.00,,7.63,,"-947,176.43"
,IN,AR,30326750,1005,100,,Invoice,,,,,,19/09/2018,19/09/2018,0.00,,1.59,,"-947,178.02"
,IN,AR,30326756,1005,100,,Invoice,,,,,,19/09/2018,19/09/2018,0.00,,5.17,,"-947,183.19"
,IN,AR,30326758,1005,100,,Invoice,,,,,,19/09/2018,19/09/2018,0.00,,12.71,,"-947,195.90"
,IN,AR,30326804,1005,100,,Invoice,,,,,,19/09/2018,19/09/2018,0.00,,8.47,,"-947,204.37"
,IN,AR,30326812,1005,100,,Invoice,,,,,,19/09/2018,19/09/2018,0.00,,18.17,,"-947,222.54"
,IN,AR,30326822,1005,100,,Invoice,,,,,,19/09/2018,19/09/2018,0.00,,15.00,,"-947,237.54"
,IN,AR,30326834,1005,100,,Invoice,,,,,,19/09/2018,19/09/2018,0.00,,7.29,,"-947,244.83"
,IN,AR,30326836,1005,100,,Invoice,,,,,,19/09/2018,19/09/2018,0.00,,2.54,,"-947,247.37"
,IN,AR,30326854,1005,100,,Invoice,,,,,,19/09/2018,19/09/2018,0.00,,10.59,,"-947,257.96"
,IN,AR,30326857,1005,100,,Invoice,,,,,,19/09/2018,19/09/2018,0.00,,18.22,,"-947,276.18"
,IN,AR,30326879,1005,100,,Invoice,,,,,,19/09/2018,19/09/2018,0.00,,13.73,,"-947,289.91"
,IN,AR,30326888,1005,100,,Invoice,,,,,,19/09/2018,19/09/2018,0.00,,51.14,,"-947,341.05"
,IN,AR,30326889,1005,100,,Invoice,,,,,,19/09/2018,19/09/2018,0.00,,7.29,,"-947,348.34"
,IN,AR,30326901,1005,100,,Invoice,,,,,,19/09/2018,19/09/2018,0.00,,10.50,,"-947,358.84"
,IN,AR,30326909,1005,100,,Invoice,,,,,,19/09/2018,19/09/2018,0.00,,14.58,,"-947,373.42"
,IN,AR,30326923,1005,100,,Invoice,,,,,,19/09/2018,19/09/2018,0.00,,27.97,,"-947,401.39"
,IN,AR,30326930,1005,100,,Invoice,,,,,,19/09/2018,19/09/2018,0.00,,15.25,,"-947,416.64"
,IN,AR,30326943,1005,100,,Invoice,,,,,,19/09/2018,19/09/2018,0.00,,54.66,,"-947,471.30"
,IN,AR,30326944,1005,100,,Invoice,,,,,,19/09/2018,19/09/2018,0.00,,6.97,,"-947,478.27"
,IN,AR,30326947,1005,100,,Invoice,,,,,,19/09/2018,19/09/2018,0.00,,8.77,,"-947,487.04"
,IN,AR,30326950,1005,100,,Invoice,,,,,,19/09/2018,19/09/2018,0.00,,10.93,,"-947,497.97"
,IN,AR,30326954,1005,100,,Invoice,,,,,,19/09/2018,19/09/2018,0.00,,16.53,,"-947,514.50"
,IN,AR,30326967,1005,100,,Invoice,,,,,,19/09/2018,19/09/2018,0.00,,37.12,,"-947,551.62"
,IN,AR,30326970,1005,100,,Invoice,,,,,,19/09/2018,19/09/2018,0.00,,5.17,,"-947,556.79"
,IN,AR,30326975,1005,100,,Invoice,,,,,,19/09/2018,19/09/2018,0.00,,6.02,,"-947,562.81"
,IN,AR,30326977,1005,100,,Invoice,,,,,,19/09/2018,19/09/2018,0.00,,9.03,,"-947,571.84"
,IN,AR,30326987,1005,100,,Invoice,,,,,,19/09/2018,19/09/2018,0.00,,15.53,,"-947,587.37"
,IN,AR,30326995,1005,100,,Invoice,,,,,,19/09/2018,19/09/2018,0.00,,18.22,,"-947,605.59"
,IN,AR,30326999,1005,100,,Invoice,,,,,,19/09/2018,19/09/2018,0.00,,10.00,,"-947,615.59"
,IN,AR,30327008,1005,100,,Invoice,,,,,,19/09/2018,19/09/2018,0.00,,3.53,,"-947,619.12"
,IN,AR,30327009,1005,100,,Invoice,,,,,,19/09/2018,19/09/2018,0.00,,7.05,,"-947,626.17"
,IN,AR,30327010,1005,100,,Invoice,,,,,,19/09/2018,19/09/2018,0.00,,1.76,,"-947,627.93"
,IN,AR,30327011,1005,100,,Invoice,,,,,,19/09/2018,19/09/2018,0.00,,12.33,,"-947,640.26"
,IN,AR,30327018,1005,100,,Invoice,,,,,,19/09/2018,19/09/2018,0.00,,15.04,,"-947,655.30"
,IN,AR,30327037,1005,100,,Invoice,,,,,,19/09/2018,19/09/2018,0.00,,54.66,,"-947,709.96"
,IN,AR,30327039,1005,100,,Invoice,,,,,,19/09/2018,19/09/2018,0.00,,25.85,,"-947,735.81"
,IN,AR,30327045,1005,100,,Invoice,,,,,,19/09/2018,19/09/2018,0.00,,10.93,,"-947,746.74"
,IN,AR,30327047,1005,100,,Invoice,,,,,,19/09/2018,19/09/2018,0.00,,10.47,,"-947,757.21"
,IN,AR,30327050,1005,100,,Invoice,,,,,,19/09/2018,19/09/2018,0.00,,24.01,,"-947,781.22"
,IN,AR,30327052,1005,100,,Invoice,,,,,,19/09/2018,19/09/2018,0.00,,43.73,,"-947,824.95"
,IN,AR,30327053,1005,100,,Invoice,,,,,,19/09/2018,19/09/2018,0.00,,36.44,,"-947,861.39"
,IN,AR,30327065,1005,100,,Invoice,,,,,,19/09/2018,19/09/2018,0.00,,2.84,,"-947,864.23"
,IN,AR,30327081,1005,100,,Invoice,,,,,,19/09/2018,19/09/2018,0.00,,11.25,,"-947,875.48"
,IN,AR,30327083,1005,100,,Invoice,,,,,,19/09/2018,19/09/2018,0.00,,7.75,,"-947,883.23"
,IN,AR,30327086,1005,100,,Invoice,,,,,,19/09/2018,19/09/2018,0.00,,17.80,,"-947,901.03"
,IN,AR,30327091,1005,100,,Invoice,,,,,,19/09/2018,19/09/2018,0.00,,10.93,,"-947,911.96"
,IN,AR,30327092,1005,100,,Invoice,,,,,,19/09/2018,19/09/2018,0.00,,9.96,,"-947,921.92"
,IN,AR,30327093,1005,100,,Invoice,,,,,,19/09/2018,19/09/2018,0.00,,5.97,,"-947,927.89"
,IN,AR,30327106,1005,100,,Invoice,,,,,,19/09/2018,19/09/2018,0.00,,19.92,,"-947,947.81"
,IN,AR,30327112,1005,100,,Invoice,,,,,,19/09/2018,19/09/2018,0.00,,10.03,,"-947,957.84"
,IN,AR,30327120,1005,100,,Invoice,,,,,,19/09/2018,19/09/2018,0.00,,40.00,,"-947,997.84"
,IN,AR,30327128,1005,100,,Invoice,,,,,,19/09/2018,19/09/2018,0.00,,127.19,,"-948,125.03"
,IN,AR,30327129,1005,100,,Invoice,,,,,,19/09/2018,19/09/2018,0.00,,70.15,,"-948,195.18"
,IN,AR,30327139,1005,100,,Invoice,,,,,,19/09/2018,19/09/2018,0.00,,10.93,,"-948,206.11"
,IN,AR,30327141,1005,100,,Invoice,,,,,,19/09/2018,19/09/2018,0.00,,53.39,,"-948,259.50"
,IN,AR,30327150,1005,100,,Invoice,,,,,,19/09/2018,19/09/2018,0.00,,21.25,,"-948,280.75"
,IN,AR,30327174,1005,100,,Invoice,,,,,,19/09/2018,19/09/2018,0.00,,13.12,,"-948,293.87"
,IN,AR,30327177,1005,100,,Invoice,,,,,,19/09/2018,19/09/2018,0.00,,7.64,,"-948,301.51"
,IN,AR,30327179,1005,100,,Invoice,,,,,,19/09/2018,19/09/2018,0.00,,21.86,,"-948,323.37"
,IN,AR,30327183,1005,100,,Invoice,,,,,,19/09/2018,19/09/2018,0.00,,14.58,,"-948,337.95"
,IN,AR,30327184,1005,100,,Invoice,,,,,,19/09/2018,19/09/2018,0.00,,7.29,,"-948,345.24"
,IN,AR,30327199,1005,100,,Invoice,,,,,,19/09/2018,19/09/2018,0.00,,2.54,,"-948,347.78"
,IN,AR,30327211,1005,100,,Invoice,,,,,,19/09/2018,19/09/2018,0.00,,24.01,,"-948,371.79"
,IN,AR,30327220,1005,100,,Invoice,,,,,,19/09/2018,19/09/2018,0.00,,8.75,,"-948,380.54"
,IN,AR,30327221,1005,100,,Invoice,,,,,,19/09/2018,19/09/2018,0.00,,17.49,,"-948,398.03"
,IN,AR,30327222,1005,100,,Invoice,,,,,,19/09/2018,19/09/2018,0.00,,11.66,,"-948,409.69"
,IN,AR,30327223,1005,100,,Invoice,,,,,,19/09/2018,19/09/2018,0.00,,17.49,,"-948,427.18"
,IN,AR,30327224,1005,100,,Invoice,,,,,,19/09/2018,19/09/2018,0.00,,11.66,,"-948,438.84"
,IN,AR,30327230,1005,100,,Invoice,,,,,,19/09/2018,19/09/2018,0.00,,34.07,,"-948,472.91"
,IN,AR,30327233,1005,100,,Invoice,,,,,,19/09/2018,19/09/2018,0.00,,7.54,,"-948,480.45"
,IN,AR,30327241,1005,100,,Invoice,,,,,,19/09/2018,19/09/2018,0.00,,7.29,,"-948,487.74"
,IN,AR,30327247,1005,100,,Invoice,,,,,,19/09/2018,19/09/2018,0.00,,23.13,,"-948,510.87"
,IN,AR,30327255,1005,100,,Invoice,,,,,,19/09/2018,19/09/2018,0.00,,29.90,,"-948,540.77"
,IN,AR,30327281,1005,100,,Invoice,,,,,,19/09/2018,19/09/2018,0.00,,29.75,,"-948,570.52"
,IN,AR,30327283,1005,100,,Invoice,,,,,,19/09/2018,19/09/2018,0.00,,54.66,,"-948,625.18"
,IN,AR,30327284,1005,100,,Invoice,,,,,,19/09/2018,19/09/2018,0.00,,8.39,,"-948,633.57"
,IN,AR,30327288,1005,100,,Invoice,,,,,,19/09/2018,19/09/2018,0.00,,12.85,,"-948,646.42"
,IN,AR,30327316,1005,100,,Invoice,,,,,,19/09/2018,19/09/2018,0.00,,7.29,,"-948,653.71"
,IN,AR,30327336,1005,100,,Invoice,,,,,,19/09/2018,19/09/2018,0.00,,3.19,,"-948,656.90"
,IN,AR,30327337,1005,100,,Invoice,,,,,,19/09/2018,19/09/2018,0.00,,9.56,,"-948,666.46"
,IN,AR,30327479,1005,100,,Invoice,,,,,,19/09/2018,19/09/2018,0.00,,5.86,,"-948,672.32"
,IN,AR,30327490,1005,100,,Invoice,,,,,,19/09/2018,19/09/2018,0.00,,54.66,,"-948,726.98"
,IN,AR,30327491,1005,100,,Invoice,,,,,,19/09/2018,19/09/2018,0.00,,14.83,,"-948,741.81"
,IN,AR,30327495,1005,100,,Invoice,,,,,,19/09/2018,19/09/2018,0.00,,30.76,,"-948,772.57"
,IN,AR,30327522,1005,100,,Invoice,,,,,,19/09/2018,19/09/2018,0.00,,9.96,,"-948,782.53"
,IN,AR,30327532,1005,100,,Invoice,,,,,,19/09/2018,19/09/2018,0.00,,13.73,,"-948,796.26"
,IN,AR,30327537,1005,100,,Invoice,,,,,,19/09/2018,19/09/2018,0.00,,21.25,,"-948,817.51"
,IN,AR,30327553,1005,100,,Invoice,,,,,,19/09/2018,19/09/2018,0.00,,14.53,,"-948,832.04"
,IN,AR,30327554,1005,100,,Invoice,,,,,,19/09/2018,19/09/2018,0.00,,43.60,,"-948,875.64"
,IN,AR,30327555,1005,100,,Invoice,,,,,,19/09/2018,19/09/2018,0.00,,8.31,,"-948,883.95"
,IN,AR,30327556,1005,100,,Invoice,,,,,,19/09/2018,19/09/2018,0.00,,8.31,,"-948,892.26"
,IN,AR,30327557,1005,100,,Invoice,,,,,,19/09/2018,19/09/2018,0.00,,22.84,,"-948,915.10"
,IN,AR,30327589,1005,100,,Invoice,,,,,,19/09/2018,19/09/2018,0.00,,24.27,,"-948,939.37"
,IN,AR,30327597,1005,100,,Invoice,,,,,,19/09/2018,19/09/2018,0.00,,12.08,,"-948,951.45"
,IN,AR,30327603,1005,100,,Invoice,,,,,,19/09/2018,19/09/2018,0.00,,7.29,,"-948,958.74"
,IN,AR,30327604,1005,100,,Invoice,,,,,,19/09/2018,19/09/2018,0.00,,10.93,,"-948,969.67"
,IN,AR,30327610,1005,100,,Invoice,,,,,,19/09/2018,19/09/2018,0.00,,14.58,,"-948,984.25"
,IN,AR,30327620,1005,100,,Invoice,,,,,,19/09/2018,19/09/2018,0.00,,29.15,,"-949,013.40"
,IN,AR,30327630,1005,100,,Invoice,,,,,,19/09/2018,19/09/2018,0.00,,10.93,,"-949,024.33"
,IN,AR,30327637,1005,100,,Invoice,,,,,,19/09/2018,19/09/2018,0.00,,11.19,,"-949,035.52"
,IN,AR,30327653,1005,100,,Invoice,,,,,,19/09/2018,19/09/2018,0.00,,7.29,,"-949,042.81"
,IN,AR,30327660,1005,100,,Invoice,,,,,,19/09/2018,19/09/2018,0.00,,7.29,,"-949,050.10"
,IN,AR,30327668,1005,100,,Invoice,,,,,,19/09/2018,19/09/2018,0.00,,7.29,,"-949,057.39"
,IN,AR,30327673,1005,100,,Invoice,,,,,,19/09/2018,19/09/2018,0.00,,7.29,,"-949,064.68"
,IN,AR,30327680,1005,100,,Invoice,,,,,,19/09/2018,19/09/2018,0.00,,182.20,,"-949,246.88"
,IN,AR,30327685,1005,100,,Invoice,,,,,,19/09/2018,19/09/2018,0.00,,8.64,,"-949,255.52"
,IN,AR,30327686,1005,100,,Invoice,,,,,,19/09/2018,19/09/2018,0.00,,10.93,,"-949,266.45"
,IN,AR,30327691,1005,100,,Invoice,,,,,,19/09/2018,19/09/2018,0.00,,29.15,,"-949,295.60"
,CN,AR,31019013,1005,100,,Credit Note,,,,,,20/09/2018,20/09/2018,3.64,,0.00,,"-949,291.96"
,CN,AR,31019038,1005,100,,Credit Note,,,,,,20/09/2018,20/09/2018,14.58,,0.00,,"-949,277.38"
,CS,AR,32008896,1005,100,,Cash sale,,,,,,20/09/2018,20/09/2018,0.00,,7.29,,"-949,284.67"
,CS,AR,32008908,1005,100,,Cash sale,,,,,,20/09/2018,20/09/2018,0.00,,9.49,,"-949,294.16"
,CS,AR,32008918,1005,100,,Cash sale,,,,,,20/09/2018,20/09/2018,0.00,,3.64,,"-949,297.80"
,CS,AR,32008919,1005,100,,Cash sale,,,,,,20/09/2018,20/09/2018,0.00,,11.22,,"-949,309.02"
,CS,AR,32008921,1005,100,,Cash sale,,,,,,20/09/2018,20/09/2018,0.00,,18.22,,"-949,327.24"
,CS,AR,32008925,1005,100,,Cash sale,,,,,,20/09/2018,20/09/2018,0.00,,7.29,,"-949,334.53"
,CS,AR,32008950,1005,100,,Cash sale,,,,,,20/09/2018,20/09/2018,0.00,,7.25,,"-949,341.78"
,CS,AR,32008961,1005,100,,Cash sale,,,,,,20/09/2018,20/09/2018,0.00,,7.29,,"-949,349.07"
,CS,AR,32008964,1005,100,,Cash sale,,,,,,20/09/2018,20/09/2018,0.00,,14.53,,"-949,363.60"
,CS,AR,32008968,1005,100,,Cash sale,,,,,,20/09/2018,20/09/2018,0.00,,3.64,,"-949,367.24"
,CS,AR,32008977,1005,100,,Cash sale,,,,,,20/09/2018,20/09/2018,0.00,,7.29,,"-949,374.53"
,CS,AR,32008980,1005,100,,Cash sale,,,,,,20/09/2018,20/09/2018,0.00,,5.84,,"-949,380.37"
,CS,AR,32008984,1005,100,,Cash sale,,,,,,20/09/2018,20/09/2018,0.00,,3.64,,"-949,384.01"
,CS,AR,32008992,1005,100,,Cash sale,,,,,,20/09/2018,20/09/2018,0.00,,14.58,,"-949,398.59"
,CS,AR,32008996,1005,100,,Cash sale,,,,,,20/09/2018,20/09/2018,0.00,,10.93,,"-949,409.52"
,CS,AR,32009008,1005,100,,Cash sale,,,,,,20/09/2018,20/09/2018,0.00,,7.29,,"-949,416.81"
,CS,AR,32009011,1005,100,,Cash sale,,,,,,20/09/2018,20/09/2018,0.00,,10.93,,"-949,427.74"
,CS,AR,32009024,1005,100,,Cash sale,,,,,,20/09/2018,20/09/2018,0.00,,7.17,,"-949,434.91"
,CS,AR,32009038,1005,100,,Cash sale,,,,,,20/09/2018,20/09/2018,0.00,,2.58,,"-949,437.49"
,CS,AR,32009040,1005,100,,Cash sale,,,,,,20/09/2018,20/09/2018,0.00,,3.64,,"-949,441.13"
,CS,AR,32009042,1005,100,,Cash sale,,,,,,20/09/2018,20/09/2018,0.00,,7.63,,"-949,448.76"
,CS,AR,32009057,1005,100,,Cash sale,,,,,,20/09/2018,20/09/2018,0.00,,38.47,,"-949,487.23"
,CS,AR,32009065,1005,100,,Cash sale,,,,,,20/09/2018,20/09/2018,0.00,,16.48,,"-949,503.71"
,CS,AR,32009076,1005,100,,Cash sale,,,,,,20/09/2018,20/09/2018,0.00,,7.29,,"-949,511.00"
,CS,AR,32009099,1005,100,,Cash sale,,,,,,20/09/2018,20/09/2018,0.00,,23.39,,"-949,534.39"
,CS,AR,32009107,1005,100,,Cash sale,,,,,,20/09/2018,20/09/2018,0.00,,2.58,,"-949,536.97"
,CS,AR,32009110,1005,100,,Cash sale,,,,,,20/09/2018,20/09/2018,0.00,,18.05,,"-949,555.02"
,CS,AR,32009115,1005,100,,Cash sale,,,,,,20/09/2018,20/09/2018,0.00,,10.93,,"-949,565.95"
,CS,AR,32009116,1005,100,,Cash sale,,,,,,20/09/2018,20/09/2018,0.00,,15.25,,"-949,581.20"
,CS,AR,32009130,1005,100,,Cash sale,,,,,,20/09/2018,20/09/2018,0.00,,15.04,,"-949,596.24"
,CS,AR,32009139,1005,100,,Cash sale,,,,,,20/09/2018,20/09/2018,0.00,,7.29,,"-949,603.53"
,CS,AR,32009143,1005,100,,Cash sale,,,,,,20/09/2018,20/09/2018,0.00,,3.64,,"-949,607.17"
,CS,AR,32009147,1005,100,,Cash sale,,,,,,20/09/2018,20/09/2018,0.00,,14.58,,"-949,621.75"
,CS,AR,32009158,1005,100,,Cash sale,,,,,,20/09/2018,20/09/2018,0.00,,7.29,,"-949,629.04"
,CS,AR,32009167,1005,100,,Cash sale,,,,,,20/09/2018,20/09/2018,0.00,,29.15,,"-949,658.19"
,CS,AR,32009174,1005,100,,Cash sale,,,,,,20/09/2018,20/09/2018,0.00,,3.64,,"-949,661.83"
,CS,AR,32009177,1005,100,,Cash sale,,,,,,20/09/2018,20/09/2018,0.00,,7.29,,"-949,669.12"
,CS,AR,32009178,1005,100,,Cash sale,,,,,,20/09/2018,20/09/2018,0.00,,14.58,,"-949,683.70"
,CS,AR,32009181,1005,100,,Cash sale,,,,,,20/09/2018,20/09/2018,0.00,,6.44,,"-949,690.14"
,CS,AR,32009185,1005,100,,Cash sale,,,,,,20/09/2018,20/09/2018,0.00,,14.63,,"-949,704.77"
,CS,AR,32009201,1005,100,,Cash sale,,,,,,20/09/2018,20/09/2018,0.00,,5.17,,"-949,709.94"
,CS,AR,32009206,1005,100,,Cash sale,,,,,,20/09/2018,20/09/2018,0.00,,8.34,,"-949,718.28"
,CS,AR,32009207,1005,100,,Cash sale,,,,,,20/09/2018,20/09/2018,0.00,,10.93,,"-949,729.21"
,CS,AR,32009218,1005,100,,Cash sale,,,,,,20/09/2018,20/09/2018,0.00,,7.29,,"-949,736.50"
,CS,AR,32009228,1005,100,,Cash sale,,,,,,20/09/2018,20/09/2018,0.00,,7.29,,"-949,743.79"
,CS,AR,32009258,1005,100,,Cash sale,,,,,,20/09/2018,20/09/2018,0.00,,10.17,,"-949,753.96"
,CS,AR,32009265,1005,100,,Cash sale,,,,,,20/09/2018,20/09/2018,0.00,,7.63,,"-949,761.59"
,CS,AR,32009268,1005,100,,Cash sale,,,,,,20/09/2018,20/09/2018,0.00,,7.29,,"-949,768.88"
,CS,AR,32009272,1005,100,,Cash sale,,,,,,20/09/2018,20/09/2018,0.00,,11.44,,"-949,780.32"
,CS,AR,32009277,1005,100,,Cash sale,,,,,,20/09/2018,20/09/2018,0.00,,10.93,,"-949,791.25"
,CS,AR,32009285,1005,100,,Cash sale,,,,,,20/09/2018,20/09/2018,0.00,,21.86,,"-949,813.11"
,CS,AR,32009299,1005,100,,Cash sale,,,,,,20/09/2018,20/09/2018,0.00,,18.22,,"-949,831.33"
,CS,AR,32009306,1005,100,,Cash sale,,,,,,20/09/2018,20/09/2018,0.00,,18.21,,"-949,849.54"
,CS,AR,32009317,1005,100,,Cash sale,,,,,,20/09/2018,20/09/2018,0.00,,7.29,,"-949,856.83"
,CS,AR,32009323,1005,100,,Cash sale,,,,,,20/09/2018,20/09/2018,0.00,,3.64,,"-949,860.47"
,CS,AR,32009328,1005,100,,Cash sale,,,,,,20/09/2018,20/09/2018,0.00,,27.31,,"-949,887.78"
,CS,AR,32009330,1005,100,,Cash sale,,,,,,20/09/2018,20/09/2018,0.00,,6.10,,"-949,893.88"
,CS,AR,32009339,1005,100,,Cash sale,,,,,,20/09/2018,20/09/2018,0.00,,10.93,,"-949,904.81"
,CS,AR,32009358,1005,100,,Cash sale,,,,,,20/09/2018,20/09/2018,0.00,,18.22,,"-949,923.03"
,CS,AR,32009372,1005,100,,Cash sale,,,,,,20/09/2018,20/09/2018,0.00,,14.58,,"-949,937.61"
,CS,AR,32009375,1005,100,,Cash sale,,,,,,20/09/2018,20/09/2018,0.00,,5.94,,"-949,943.55"
,CS,AR,32009407,1005,100,,Cash sale,,,,,,20/09/2018,20/09/2018,0.00,,9.32,,"-949,952.87"
,CS,AR,32009422,1005,100,,Cash sale,,,,,,20/09/2018,20/09/2018,0.00,,14.58,,"-949,967.45"
,CS,AR,32009427,1005,100,,Cash sale,,,,,,20/09/2018,20/09/2018,0.00,,3.64,,"-949,971.09"
,CS,AR,32009430,1005,100,,Cash sale,,,,,,20/09/2018,20/09/2018,0.00,,3.64,,"-949,974.73"
,CS,AR,32009442,1005,100,,Cash sale,,,,,,20/09/2018,20/09/2018,0.00,,40.08,,"-950,014.81"
,IN,AR,30326276,1005,100,,Invoice,,,,,,20/09/2018,20/09/2018,0.00,,25.51,,"-950,040.32"
,IN,AR,30326290,1005,100,,Invoice,,,,,,20/09/2018,20/09/2018,0.00,,19.58,,"-950,059.90"
,IN,AR,30326296,1005,100,,Invoice,,,,,,20/09/2018,20/09/2018,0.00,,3.64,,"-950,063.54"
,IN,AR,30326320,1005,100,,Invoice,,,,,,20/09/2018,20/09/2018,0.00,,10.93,,"-950,074.47"
,IN,AR,30326326,1005,100,,Invoice,,,,,,20/09/2018,20/09/2018,0.00,,3.04,,"-950,077.51"
,IN,AR,30326338,1005,100,,Invoice,,,,,,20/09/2018,20/09/2018,0.00,,19.32,,"-950,096.83"
,IN,AR,30326341,1005,100,,Invoice,,,,,,20/09/2018,20/09/2018,0.00,,14.58,,"-950,111.41"
,IN,AR,30326350,1005,100,,Invoice,,,,,,20/09/2018,20/09/2018,0.00,,57.07,,"-950,168.48"
,IN,AR,30326356,1005,100,,Invoice,,,,,,20/09/2018,20/09/2018,0.00,,3.64,,"-950,172.12"
,IN,AR,30326358,1005,100,,Invoice,,,,,,20/09/2018,20/09/2018,0.00,,18.22,,"-950,190.34"
,IN,AR,30326361,1005,100,,Invoice,,,,,,20/09/2018,20/09/2018,0.00,,9.19,,"-950,199.53"
,IN,AR,30326364,1005,100,,Invoice,,,,,,20/09/2018,20/09/2018,0.00,,91.21,,"-950,290.74"
,IN,AR,30326378,1005,100,,Invoice,,,,,,20/09/2018,20/09/2018,0.00,,61.69,,"-950,352.43"
,IN,AR,30326400,1005,100,,Invoice,,,,,,20/09/2018,20/09/2018,0.00,,56.00,,"-950,408.43"
,IN,AR,30326411,1005,100,,Invoice,,,,,,20/09/2018,20/09/2018,0.00,,18.22,,"-950,426.65"
,IN,AR,30326433,1005,100,,Invoice,,,,,,20/09/2018,20/09/2018,0.00,,8.00,,"-950,434.65"
,IN,AR,30326487,1005,100,,Invoice,,,,,,20/09/2018,20/09/2018,0.00,,15.53,,"-950,450.18"
,IN,AR,30326488,1005,100,,Invoice,,,,,,20/09/2018,20/09/2018,0.00,,3.88,,"-950,454.06"
,IN,AR,30326497,1005,100,,Invoice,,,,,,20/09/2018,20/09/2018,0.00,,30.00,,"-950,484.06"
,IN,AR,30326500,1005,100,,Invoice,,,,,,20/09/2018,20/09/2018,0.00,,7.29,,"-950,491.35"
,IN,AR,30326506,1005,100,,Invoice,,,,,,20/09/2018,20/09/2018,0.00,,25.51,,"-950,516.86"
,IN,AR,30326515,1005,100,,Invoice,,,,,,20/09/2018,20/09/2018,0.00,,15.53,,"-950,532.39"
,IN,AR,30326516,1005,100,,Invoice,,,,,,20/09/2018,20/09/2018,0.00,,3.01,,"-950,535.40"
,IN,AR,30326550,1005,100,,Invoice,,,,,,20/09/2018,20/09/2018,0.00,,9.03,,"-950,544.43"
,IN,AR,30326554,1005,100,,Invoice,,,,,,20/09/2018,20/09/2018,0.00,,4.80,,"-950,549.23"
,IN,AR,30326582,1005,100,,Invoice,,,,,,20/09/2018,20/09/2018,0.00,,61.02,,"-950,610.25"
,IN,AR,30326586,1005,100,,Invoice,,,,,,20/09/2018,20/09/2018,0.00,,18.05,,"-950,628.30"
,IN,AR,30326600,1005,100,,Invoice,,,,,,20/09/2018,20/09/2018,0.00,,25.85,,"-950,654.15"
,IN,AR,30326604,1005,100,,Invoice,,,,,,20/09/2018,20/09/2018,0.00,,2.39,,"-950,656.54"
,IN,AR,30326617,1005,100,,Invoice,,,,,,20/09/2018,20/09/2018,0.00,,7.29,,"-950,663.83"
,IN,AR,30326638,1005,100,,Invoice,,,,,,20/09/2018,20/09/2018,0.00,,25.42,,"-950,689.25"
,IN,AR,30326641,1005,100,,Invoice,,,,,,20/09/2018,20/09/2018,0.00,,104.59,,"-950,793.84"
,IN,AR,30326656,1005,100,,Invoice,,,,,,20/09/2018,20/09/2018,0.00,,23.90,,"-950,817.74"
,IN,AR,30326657,1005,100,,Invoice,,,,,,20/09/2018,20/09/2018,0.00,,11.95,,"-950,829.69"
,IN,AR,30326663,1005,100,,Invoice,,,,,,20/09/2018,20/09/2018,0.00,,16.10,,"-950,845.79"
,IN,AR,30326666,1005,100,,Invoice,,,,,,20/09/2018,20/09/2018,0.00,,3.22,,"-950,849.01"
,IN,AR,30326678,1005,100,,Invoice,,,,,,20/09/2018,20/09/2018,0.00,,6.02,,"-950,855.03"
,IN,AR,30326738,1005,100,,Invoice,,,,,,20/09/2018,20/09/2018,0.00,,5.08,,"-950,860.11"
,IN,AR,30326739,1005,100,,Invoice,,,,,,20/09/2018,20/09/2018,0.00,,5.08,,"-950,865.19"
,IN,AR,30326748,1005,100,,Invoice,,,,,,20/09/2018,20/09/2018,0.00,,5.08,,"-950,870.27"
,IN,AR,30326754,1005,100,,Invoice,,,,,,20/09/2018,20/09/2018,0.00,,7.29,,"-950,877.56"
,IN,AR,30326762,1005,100,,Invoice,,,,,,20/09/2018,20/09/2018,0.00,,4.32,,"-950,881.88"
,IN,AR,30326763,1005,100,,Invoice,,,,,,20/09/2018,20/09/2018,0.00,,4.32,,"-950,886.20"
,IN,AR,30326798,1005,100,,Invoice,,,,,,20/09/2018,20/09/2018,0.00,,15.25,,"-950,901.45"
,IN,AR,30326801,1005,100,,Invoice,,,,,,20/09/2018,20/09/2018,0.00,,4.24,,"-950,905.69"
,IN,AR,30326803,1005,100,,Invoice,,,,,,20/09/2018,20/09/2018,0.00,,8.47,,"-950,914.16"
,IN,AR,30326810,1005,100,,Invoice,,,,,,20/09/2018,20/09/2018,0.00,,10.93,,"-950,925.09"
,IN,AR,30326818,1005,100,,Invoice,,,,,,20/09/2018,20/09/2018,0.00,,7.63,,"-950,932.72"
,IN,AR,30326839,1005,100,,Invoice,,,,,,20/09/2018,20/09/2018,0.00,,38.14,,"-950,970.86"
,IN,AR,30326845,1005,100,,Invoice,,,,,,20/09/2018,20/09/2018,0.00,,3.64,,"-950,974.50"
,IN,AR,30326872,1005,100,,Invoice,,,,,,20/09/2018,20/09/2018,0.00,,7.29,,"-950,981.79"
,IN,AR,30326918,1005,100,,Invoice,,,,,,20/09/2018,20/09/2018,0.00,,6.36,,"-950,988.15"
,IN,AR,30326934,1005,100,,Invoice,,,,,,20/09/2018,20/09/2018,0.00,,10.93,,"-950,999.08"
,IN,AR,30326942,1005,100,,Invoice,,,,,,20/09/2018,20/09/2018,0.00,,10.93,,"-951,010.01"
,IN,AR,30326952,1005,100,,Invoice,,,,,,20/09/2018,20/09/2018,0.00,,14.58,,"-951,024.59"
,IN,AR,30326989,1005,100,,Invoice,,,,,,20/09/2018,20/09/2018,0.00,,7.63,,"-951,032.22"
,IN,AR,30326991,1005,100,,Invoice,,,,,,20/09/2018,20/09/2018,0.00,,6.53,,"-951,038.75"
,IN,AR,30326992,1005,100,,Invoice,,,,,,20/09/2018,20/09/2018,0.00,,29.15,,"-951,067.90"
,IN,AR,30327012,1005,100,,Invoice,,,,,,20/09/2018,20/09/2018,0.00,,7.05,,"-951,074.95"
,IN,AR,30327024,1005,100,,Invoice,,,,,,20/09/2018,20/09/2018,0.00,,18.22,,"-951,093.17"
,IN,AR,30327026,1005,100,,Invoice,,,,,,20/09/2018,20/09/2018,0.00,,2.42,,"-951,095.59"
,IN,AR,30327029,1005,100,,Invoice,,,,,,20/09/2018,20/09/2018,0.00,,13.63,,"-951,109.22"
,IN,AR,30327043,1005,100,,Invoice,,,,,,20/09/2018,20/09/2018,0.00,,14.58,,"-951,123.80"
,IN,AR,30327048,1005,100,,Invoice,,,,,,20/09/2018,20/09/2018,0.00,,11.70,,"-951,135.50"
,IN,AR,30327077,1005,100,,Invoice,,,,,,20/09/2018,20/09/2018,0.00,,4.08,,"-951,139.58"
,IN,AR,30327084,1005,100,,Invoice,,,,,,20/09/2018,20/09/2018,0.00,,10.93,,"-951,150.51"
,IN,AR,30327094,1005,100,,Invoice,,,,,,20/09/2018,20/09/2018,0.00,,3.98,,"-951,154.49"
,IN,AR,30327117,1005,100,,Invoice,,,,,,20/09/2018,20/09/2018,0.00,,34.07,,"-951,188.56"
,IN,AR,30327123,1005,100,,Invoice,,,,,,20/09/2018,20/09/2018,0.00,,16.00,,"-951,204.56"
,IN,AR,30327125,1005,100,,Invoice,,,,,,20/09/2018,20/09/2018,0.00,,49.75,,"-951,254.31"
,IN,AR,30327127,1005,100,,Invoice,,,,,,20/09/2018,20/09/2018,0.00,,5.93,,"-951,260.24"
,IN,AR,30327132,1005,100,,Invoice,,,,,,20/09/2018,20/09/2018,0.00,,40.08,,"-951,300.32"
,IN,AR,30327152,1005,100,,Invoice,,,,,,20/09/2018,20/09/2018,0.00,,21.61,,"-951,321.93"
,IN,AR,30327161,1005,100,,Invoice,,,,,,20/09/2018,20/09/2018,0.00,,10.93,,"-951,332.86"
,IN,AR,30327164,1005,100,,Invoice,,,,,,20/09/2018,20/09/2018,0.00,,34.15,,"-951,367.01"
,IN,AR,30327181,1005,100,,Invoice,,,,,,20/09/2018,20/09/2018,0.00,,7.29,,"-951,374.30"
,IN,AR,30327188,1005,100,,Invoice,,,,,,20/09/2018,20/09/2018,0.00,,26.30,,"-951,400.60"
,IN,AR,30327200,1005,100,,Invoice,,,,,,20/09/2018,20/09/2018,0.00,,10.17,,"-951,410.77"
,IN,AR,30327204,1005,100,,Invoice,,,,,,20/09/2018,20/09/2018,0.00,,30.01,,"-951,440.78"
,IN,AR,30327214,1005,100,,Invoice,,,,,,20/09/2018,20/09/2018,0.00,,8.00,,"-951,448.78"
,IN,AR,30327227,1005,100,,Invoice,,,,,,20/09/2018,20/09/2018,0.00,,12.14,,"-951,460.92"
,IN,AR,30327243,1005,100,,Invoice,,,,,,20/09/2018,20/09/2018,0.00,,35.58,,"-951,496.50"
,IN,AR,30327248,1005,100,,Invoice,,,,,,20/09/2018,20/09/2018,0.00,,10.52,,"-951,507.02"
,IN,AR,30327277,1005,100,,Invoice,,,,,,20/09/2018,20/09/2018,0.00,,11.48,,"-951,518.50"
,IN,AR,30327318,1005,100,,Invoice,,,,,,20/09/2018,20/09/2018,0.00,,3.64,,"-951,522.14"
,IN,AR,30327321,1005,100,,Invoice,,,,,,20/09/2018,20/09/2018,0.00,,6.07,,"-951,528.21"
,IN,AR,30327324,1005,100,,Invoice,,,,,,20/09/2018,20/09/2018,0.00,,5.68,,"-951,533.89"
,IN,AR,30327326,1005,100,,Invoice,,,,,,20/09/2018,20/09/2018,0.00,,9.66,,"-951,543.55"
,IN,AR,30327338,1005,100,,Invoice,,,,,,20/09/2018,20/09/2018,0.00,,98.78,,"-951,642.33"
,IN,AR,30327339,1005,100,,Invoice,,,,,,20/09/2018,20/09/2018,0.00,,9.56,,"-951,651.89"
,IN,AR,30327340,1005,100,,Invoice,,,,,,20/09/2018,20/09/2018,0.00,,22.31,,"-951,674.20"
,IN,AR,30327399,1005,100,,Invoice,,,,,,20/09/2018,20/09/2018,0.00,,24.41,,"-951,698.61"
,IN,AR,30327458,1005,100,,Invoice,,,,,,20/09/2018,20/09/2018,0.00,,5.83,,"-951,704.44"
,IN,AR,30327463,1005,100,,Invoice,,,,,,20/09/2018,20/09/2018,0.00,,10.95,,"-951,715.39"
,IN,AR,30327500,1005,100,,Invoice,,,,,,20/09/2018,20/09/2018,0.00,,6.13,,"-951,721.52"
,IN,AR,30327504,1005,100,,Invoice,,,,,,20/09/2018,20/09/2018,0.00,,10.93,,"-951,732.45"
,IN,AR,30327518,1005,100,,Invoice,,,,,,20/09/2018,20/09/2018,0.00,,5.51,,"-951,737.96"
,IN,AR,30327521,1005,100,,Invoice,,,,,,20/09/2018,20/09/2018,0.00,,54.66,,"-951,792.62"
,IN,AR,30327558,1005,100,,Invoice,,,,,,20/09/2018,20/09/2018,0.00,,2.08,,"-951,794.70"
,IN,AR,30327559,1005,100,,Invoice,,,,,,20/09/2018,20/09/2018,0.00,,4.15,,"-951,798.85"
,IN,AR,30327560,1005,100,,Invoice,,,,,,20/09/2018,20/09/2018,0.00,,4.15,,"-951,803.00"
,IN,AR,30327586,1005,100,,Invoice,,,,,,20/09/2018,20/09/2018,0.00,,3.64,,"-951,806.64"
,IN,AR,30327587,1005,100,,Invoice,,,,,,20/09/2018,20/09/2018,0.00,,18.21,,"-951,824.85"
,IN,AR,30327592,1005,100,,Invoice,,,,,,20/09/2018,20/09/2018,0.00,,27.03,,"-951,851.88"
,IN,AR,30327594,1005,100,,Invoice,,,,,,20/09/2018,20/09/2018,0.00,,9.31,,"-951,861.19"
,IN,AR,30327600,1005,100,,Invoice,,,,,,20/09/2018,20/09/2018,0.00,,14.58,,"-951,875.77"
,IN,AR,30327605,1005,100,,Invoice,,,,,,20/09/2018,20/09/2018,0.00,,4.07,,"-951,879.84"
,IN,AR,30327624,1005,100,,Invoice,,,,,,20/09/2018,20/09/2018,0.00,,54.67,,"-951,934.51"
,IN,AR,30327635,1005,100,,Invoice,,,,,,20/09/2018,20/09/2018,0.00,,54.66,,"-951,989.17"
,IN,AR,30327639,1005,100,,Invoice,,,,,,20/09/2018,20/09/2018,0.00,,7.29,,"-951,996.46"
,IN,AR,30327644,1005,100,,Invoice,,,,,,20/09/2018,20/09/2018,0.00,,72.81,,"-952,069.27"
,IN,AR,30327689,1005,100,,Invoice,,,,,,20/09/2018,20/09/2018,0.00,,14.58,,"-952,083.85"
,IN,AR,30327692,1005,100,,Invoice,,,,,,20/09/2018,20/09/2018,0.00,,29.15,,"-952,113.00"
,IN,AR,30327693,1005,100,,Invoice,,,,,,20/09/2018,20/09/2018,0.00,,692.37,,"-952,805.37"
,IN,AR,30327627,1005,100,,Invoice,,,,,,21/09/2018,21/09/2018,0.00,,10.93,,"-952,816.30"
,CS,AR,32008946,1005,100,,Cash sale,,,,,,22/09/2018,22/09/2018,0.00,,3.64,,"-952,819.94"
,CS,AR,32008974,1005,100,,Cash sale,,,,,,22/09/2018,22/09/2018,0.00,,25.51,,"-952,845.45"
,CS,AR,32009092,1005,100,,Cash sale,,,,,,22/09/2018,22/09/2018,0.00,,7.63,,"-952,853.08"
,CS,AR,32009123,1005,100,,Cash sale,,,,,,22/09/2018,22/09/2018,0.00,,7.29,,"-952,860.37"
,CS,AR,32009231,1005,100,,Cash sale,,,,,,22/09/2018,22/09/2018,0.00,,7.29,,"-952,867.66"
,CS,AR,32009318,1005,100,,Cash sale,,,,,,22/09/2018,22/09/2018,0.00,,3.64,,"-952,871.30"
,CS,AR,32009326,1005,100,,Cash sale,,,,,,22/09/2018,22/09/2018,0.00,,13.98,,"-952,885.28"
,CS,AR,32009340,1005,100,,Cash sale,,,,,,22/09/2018,22/09/2018,0.00,,18.22,,"-952,903.50"
,CS,AR,32009368,1005,100,,Cash sale,,,,,,22/09/2018,22/09/2018,0.00,,5.85,,"-952,909.35"
,IN,AR,30326282,1005,100,,Invoice,,,,,,22/09/2018,22/09/2018,0.00,,8.42,,"-952,917.77"
,IN,AR,30326379,1005,100,,Invoice,,,,,,22/09/2018,22/09/2018,0.00,,59.32,,"-952,977.09"
,IN,AR,30326460,1005,100,,Invoice,,,,,,22/09/2018,22/09/2018,0.00,,7.12,,"-952,984.21"
,IN,AR,30326465,1005,100,,Invoice,,,,,,22/09/2018,22/09/2018,0.00,,10.00,,"-952,994.21"
,IN,AR,30326510,1005,100,,Invoice,,,,,,22/09/2018,22/09/2018,0.00,,5.59,,"-952,999.80"
,IN,AR,30326598,1005,100,,Invoice,,,,,,22/09/2018,22/09/2018,0.00,,7.29,,"-953,007.09"
,IN,AR,30326740,1005,100,,Invoice,,,,,,22/09/2018,22/09/2018,0.00,,10.17,,"-953,017.26"
,IN,AR,30326884,1005,100,,Invoice,,,,,,22/09/2018,22/09/2018,0.00,,14.03,,"-953,031.29"
,IN,AR,30327078,1005,100,,Invoice,,,,,,22/09/2018,22/09/2018,0.00,,7.29,,"-953,038.58"
,IN,AR,30327149,1005,100,,Invoice,,,,,,22/09/2018,22/09/2018,0.00,,7.29,,"-953,045.87"
,IN,AR,30327274,1005,100,,Invoice,,,,,,22/09/2018,22/09/2018,0.00,,5.61,,"-953,051.48"
,IN,AR,30327295,1005,100,,Invoice,,,,,,22/09/2018,22/09/2018,0.00,,14.58,,"-953,066.06"
,IN,AR,30327420,1005,100,,Invoice,,,,,,22/09/2018,22/09/2018,0.00,,12.00,,"-953,078.06"
,IN,AR,30327441,1005,100,,Invoice,,,,,,22/09/2018,22/09/2018,0.00,,18.22,,"-953,096.28"
,IN,AR,30327460,1005,100,,Invoice,,,,,,22/09/2018,22/09/2018,0.00,,8.75,,"-953,105.03"
,IN,AR,30327484,1005,100,,Invoice,,,,,,22/09/2018,22/09/2018,0.00,,10.93,,"-953,115.96"
,IN,AR,30327523,1005,100,,Invoice,,,,,,22/09/2018,22/09/2018,0.00,,5.97,,"-953,121.93"
,IN,AR,30327545,1005,100,,Invoice,,,,,,22/09/2018,22/09/2018,0.00,,4.00,,"-953,125.93"
,IN,AR,30327598,1005,100,,Invoice,,,,,,22/09/2018,22/09/2018,0.00,,3.03,,"-953,128.96"
,CS,AR,32009189,1005,100,,Cash sale,,,,,,23/09/2018,23/09/2018,0.00,,29.15,,"-953,158.11"
,IN,AR,30326482,1005,100,,Invoice,,,,,,23/09/2018,23/09/2018,0.00,,518.61,,"-953,676.72"
,IN,AR,30327654,1005,100,,Invoice,,,,,,23/09/2018,23/09/2018,0.00,,7.29,,"-953,684.01"
,CN,AR,31019084,1005,100,,Credit Note,,,,,,24/09/2018,24/09/2018,52.88,,0.00,,"-953,631.13"
,CS,AR,32008901,1005,100,,Cash sale,,,,,,24/09/2018,24/09/2018,0.00,,28.05,,"-953,659.18"
,CS,AR,32008909,1005,100,,Cash sale,,,,,,24/09/2018,24/09/2018,0.00,,18.98,,"-953,678.16"
,CS,AR,32008928,1005,100,,Cash sale,,,,,,24/09/2018,24/09/2018,0.00,,7.29,,"-953,685.45"
,CS,AR,32008941,1005,100,,Cash sale,,,,,,24/09/2018,24/09/2018,0.00,,7.29,,"-953,692.74"
,CS,AR,32008957,1005,100,,Cash sale,,,,,,24/09/2018,24/09/2018,0.00,,7.29,,"-953,700.03"
,CS,AR,32008965,1005,100,,Cash sale,,,,,,24/09/2018,24/09/2018,0.00,,18.69,,"-953,718.72"
,CS,AR,32008969,1005,100,,Cash sale,,,,,,24/09/2018,24/09/2018,0.00,,14.58,,"-953,733.30"
,CS,AR,32008973,1005,100,,Cash sale,,,,,,24/09/2018,24/09/2018,0.00,,7.29,,"-953,740.59"
,CS,AR,32008978,1005,100,,Cash sale,,,,,,24/09/2018,24/09/2018,0.00,,7.29,,"-953,747.88"
,CS,AR,32008981,1005,100,,Cash sale,,,,,,24/09/2018,24/09/2018,0.00,,7.78,,"-953,755.66"
,CS,AR,32008995,1005,100,,Cash sale,,,,,,24/09/2018,24/09/2018,0.00,,3.64,,"-953,759.30"
,CS,AR,32008997,1005,100,,Cash sale,,,,,,24/09/2018,24/09/2018,0.00,,10.93,,"-953,770.23"
,CS,AR,32009014,1005,100,,Cash sale,,,,,,24/09/2018,24/09/2018,0.00,,3.64,,"-953,773.87"
,CS,AR,32009017,1005,100,,Cash sale,,,,,,24/09/2018,24/09/2018,0.00,,10.34,,"-953,784.21"
,CS,AR,32009035,1005,100,,Cash sale,,,,,,24/09/2018,24/09/2018,0.00,,7.29,,"-953,791.50"
,CS,AR,32009036,1005,100,,Cash sale,,,,,,24/09/2018,24/09/2018,0.00,,21.86,,"-953,813.36"
,CS,AR,32009043,1005,100,,Cash sale,,,,,,24/09/2018,24/09/2018,0.00,,10.17,,"-953,823.53"
,CS,AR,32009062,1005,100,,Cash sale,,,,,,24/09/2018,24/09/2018,0.00,,7.29,,"-953,830.82"
,CS,AR,32009070,1005,100,,Cash sale,,,,,,24/09/2018,24/09/2018,0.00,,3.64,,"-953,834.46"
,CS,AR,32009071,1005,100,,Cash sale,,,,,,24/09/2018,24/09/2018,0.00,,14.58,,"-953,849.04"
,CS,AR,32009072,1005,100,,Cash sale,,,,,,24/09/2018,24/09/2018,0.00,,7.29,,"-953,856.33"
,CS,AR,32009080,1005,100,,Cash sale,,,,,,24/09/2018,24/09/2018,0.00,,10.93,,"-953,867.26"
,CS,AR,32009083,1005,100,,Cash sale,,,,,,24/09/2018,24/09/2018,0.00,,10.93,,"-953,878.19"
,CS,AR,32009093,1005,100,,Cash sale,,,,,,24/09/2018,24/09/2018,0.00,,2.54,,"-953,880.73"
,CS,AR,32009100,1005,100,,Cash sale,,,,,,24/09/2018,24/09/2018,0.00,,17.54,,"-953,898.27"
,CS,AR,32009102,1005,100,,Cash sale,,,,,,24/09/2018,24/09/2018,0.00,,8.16,,"-953,906.43"
,CS,AR,32009103,1005,100,,Cash sale,,,,,,24/09/2018,24/09/2018,0.00,,6.02,,"-953,912.45"
,CS,AR,32009111,1005,100,,Cash sale,,,,,,24/09/2018,24/09/2018,0.00,,30.08,,"-953,942.53"
,CS,AR,32009119,1005,100,,Cash sale,,,,,,24/09/2018,24/09/2018,0.00,,7.29,,"-953,949.82"
,CS,AR,32009120,1005,100,,Cash sale,,,,,,24/09/2018,24/09/2018,0.00,,6.48,,"-953,956.30"
,CS,AR,32009128,1005,100,,Cash sale,,,,,,24/09/2018,24/09/2018,0.00,,10.93,,"-953,967.23"
,CS,AR,32009142,1005,100,,Cash sale,,,,,,24/09/2018,24/09/2018,0.00,,5.08,,"-953,972.31"
,CS,AR,32009156,1005,100,,Cash sale,,,,,,24/09/2018,24/09/2018,0.00,,29.15,,"-954,001.46"
,CS,AR,32009171,1005,100,,Cash sale,,,,,,24/09/2018,24/09/2018,0.00,,7.29,,"-954,008.75"
,CS,AR,32009173,1005,100,,Cash sale,,,,,,24/09/2018,24/09/2018,0.00,,7.29,,"-954,016.04"
,CS,AR,32009192,1005,100,,Cash sale,,,,,,24/09/2018,24/09/2018,0.00,,12.03,,"-954,028.07"
,CS,AR,32009193,1005,100,,Cash sale,,,,,,24/09/2018,24/09/2018,0.00,,7.29,,"-954,035.36"
,CS,AR,32009200,1005,100,,Cash sale,,,,,,24/09/2018,24/09/2018,0.00,,6.42,,"-954,041.78"
,CS,AR,32009204,1005,100,,Cash sale,,,,,,24/09/2018,24/09/2018,0.00,,9.13,,"-954,050.91"
,CS,AR,32009211,1005,100,,Cash sale,,,,,,24/09/2018,24/09/2018,0.00,,24.07,,"-954,074.98"
,CS,AR,32009237,1005,100,,Cash sale,,,,,,24/09/2018,24/09/2018,0.00,,20.34,,"-954,095.32"
,CS,AR,32009241,1005,100,,Cash sale,,,,,,24/09/2018,24/09/2018,0.00,,29.15,,"-954,124.47"
,CS,AR,32009244,1005,100,,Cash sale,,,,,,24/09/2018,24/09/2018,0.00,,7.29,,"-954,131.76"
,CS,AR,32009247,1005,100,,Cash sale,,,,,,24/09/2018,24/09/2018,0.00,,2.58,,"-954,134.34"
,CS,AR,32009263,1005,100,,Cash sale,,,,,,24/09/2018,24/09/2018,0.00,,9.84,,"-954,144.18"
,CS,AR,32009264,1005,100,,Cash sale,,,,,,24/09/2018,24/09/2018,0.00,,7.29,,"-954,151.47"
,CS,AR,32009266,1005,100,,Cash sale,,,,,,24/09/2018,24/09/2018,0.00,,7.63,,"-954,159.10"
,CS,AR,32009273,1005,100,,Cash sale,,,,,,24/09/2018,24/09/2018,0.00,,13.73,,"-954,172.83"
,CS,AR,32009293,1005,100,,Cash sale,,,,,,24/09/2018,24/09/2018,0.00,,14.58,,"-954,187.41"
,CS,AR,32009307,1005,100,,Cash sale,,,,,,24/09/2018,24/09/2018,0.00,,24.29,,"-954,211.70"
,CS,AR,32009319,1005,100,,Cash sale,,,,,,24/09/2018,24/09/2018,0.00,,10.93,,"-954,222.63"
,CS,AR,32009335,1005,100,,Cash sale,,,,,,24/09/2018,24/09/2018,0.00,,7.29,,"-954,229.92"
,CS,AR,32009346,1005,100,,Cash sale,,,,,,24/09/2018,24/09/2018,0.00,,3.64,,"-954,233.56"
,CS,AR,32009366,1005,100,,Cash sale,,,,,,24/09/2018,24/09/2018,0.00,,7.29,,"-954,240.85"
,CS,AR,32009373,1005,100,,Cash sale,,,,,,24/09/2018,24/09/2018,0.00,,7.29,,"-954,248.14"
,CS,AR,32009408,1005,100,,Cash sale,,,,,,24/09/2018,24/09/2018,0.00,,11.65,,"-954,259.79"
,CS,AR,32009410,1005,100,,Cash sale,,,,,,24/09/2018,24/09/2018,0.00,,6.07,,"-954,265.86"
,CS,AR,32009416,1005,100,,Cash sale,,,,,,24/09/2018,24/09/2018,0.00,,5.17,,"-954,271.03"
,CS,AR,32009440,1005,100,,Cash sale,,,,,,24/09/2018,24/09/2018,0.00,,5.17,,"-954,276.20"
,CS,AR,32009444,1005,100,,Cash sale,,,,,,24/09/2018,24/09/2018,0.00,,10.93,,"-954,287.13"
,IN,AR,30326271,1005,100,,Invoice,,,,,,24/09/2018,24/09/2018,0.00,,17.80,,"-954,304.93"
,IN,AR,30326272,1005,100,,Invoice,,,,,,24/09/2018,24/09/2018,0.00,,68.22,,"-954,373.15"
,IN,AR,30326281,1005,100,,Invoice,,,,,,24/09/2018,24/09/2018,0.00,,29.15,,"-954,402.30"
,IN,AR,30326310,1005,100,,Invoice,,,,,,24/09/2018,24/09/2018,0.00,,6.08,,"-954,408.38"
,IN,AR,30326311,1005,100,,Invoice,,,,,,24/09/2018,24/09/2018,0.00,,6.08,,"-954,414.46"
,IN,AR,30326312,1005,100,,Invoice,,,,,,24/09/2018,24/09/2018,0.00,,4.05,,"-954,418.51"
,IN,AR,30326313,1005,100,,Invoice,,,,,,24/09/2018,24/09/2018,0.00,,4.05,,"-954,422.56"
,IN,AR,30326314,1005,100,,Invoice,,,,,,24/09/2018,24/09/2018,0.00,,16.20,,"-954,438.76"
,IN,AR,30326315,1005,100,,Invoice,,,,,,24/09/2018,24/09/2018,0.00,,2.03,,"-954,440.79"
,IN,AR,30326316,1005,100,,Invoice,,,,,,24/09/2018,24/09/2018,0.00,,8.10,,"-954,448.89"
,IN,AR,30326317,1005,100,,Invoice,,,,,,24/09/2018,24/09/2018,0.00,,4.05,,"-954,452.94"
,IN,AR,30326328,1005,100,,Invoice,,,,,,24/09/2018,24/09/2018,0.00,,546.61,,"-954,999.55"
,IN,AR,30326335,1005,100,,Invoice,,,,,,24/09/2018,24/09/2018,0.00,,3.64,,"-955,003.19"
,IN,AR,30326351,1005,100,,Invoice,,,,,,24/09/2018,24/09/2018,0.00,,52.84,,"-955,056.03"
,IN,AR,30326355,1005,100,,Invoice,,,,,,24/09/2018,24/09/2018,0.00,,8.39,,"-955,064.42"
,IN,AR,30326366,1005,100,,Invoice,,,,,,24/09/2018,24/09/2018,0.00,,7.29,,"-955,071.71"
,IN,AR,30326380,1005,100,,Invoice,,,,,,24/09/2018,24/09/2018,0.00,,140.00,,"-955,211.71"
,IN,AR,30326388,1005,100,,Invoice,,,,,,24/09/2018,24/09/2018,0.00,,13.77,,"-955,225.48"
,IN,AR,30326398,1005,100,,Invoice,,,,,,24/09/2018,24/09/2018,0.00,,10.93,,"-955,236.41"
,IN,AR,30326401,1005,100,,Invoice,,,,,,24/09/2018,24/09/2018,0.00,,52.00,,"-955,288.41"
,IN,AR,30326413,1005,100,,Invoice,,,,,,24/09/2018,24/09/2018,0.00,,42.42,,"-955,330.83"
,IN,AR,30326434,1005,100,,Invoice,,,,,,24/09/2018,24/09/2018,0.00,,40.00,,"-955,370.83"
,IN,AR,30326435,1005,100,,Invoice,,,,,,24/09/2018,24/09/2018,0.00,,16.00,,"-955,386.83"
,IN,AR,30326441,1005,100,,Invoice,,,,,,24/09/2018,24/09/2018,0.00,,2.75,,"-955,389.58"
,IN,AR,30326442,1005,100,,Invoice,,,,,,24/09/2018,24/09/2018,0.00,,13.77,,"-955,403.35"
,IN,AR,30326444,1005,100,,Invoice,,,,,,24/09/2018,24/09/2018,0.00,,38.14,,"-955,441.49"
,IN,AR,30326446,1005,100,,Invoice,,,,,,24/09/2018,24/09/2018,0.00,,5.51,,"-955,447.00"
,IN,AR,30326449,1005,100,,Invoice,,,,,,24/09/2018,24/09/2018,0.00,,10.93,,"-955,457.93"
,IN,AR,30326457,1005,100,,Invoice,,,,,,24/09/2018,24/09/2018,0.00,,11.69,,"-955,469.62"
,IN,AR,30326458,1005,100,,Invoice,,,,,,24/09/2018,24/09/2018,0.00,,54.66,,"-955,524.28"
,IN,AR,30326466,1005,100,,Invoice,,,,,,24/09/2018,24/09/2018,0.00,,16.00,,"-955,540.28"
,IN,AR,30326489,1005,100,,Invoice,,,,,,24/09/2018,24/09/2018,0.00,,5.82,,"-955,546.10"
,IN,AR,30326490,1005,100,,Invoice,,,,,,24/09/2018,24/09/2018,0.00,,13.58,,"-955,559.68"
,IN,AR,30326495,1005,100,,Invoice,,,,,,24/09/2018,24/09/2018,0.00,,10.93,,"-955,570.61"
,IN,AR,30326498,1005,100,,Invoice,,,,,,24/09/2018,24/09/2018,0.00,,48.00,,"-955,618.61"
,IN,AR,30326513,1005,100,,Invoice,,,,,,24/09/2018,24/09/2018,0.00,,19.32,,"-955,637.93"
,IN,AR,30326523,1005,100,,Invoice,,,,,,24/09/2018,24/09/2018,0.00,,36.44,,"-955,674.37"
,IN,AR,30326527,1005,100,,Invoice,,,,,,24/09/2018,24/09/2018,0.00,,7.29,,"-955,681.66"
,IN,AR,30326536,1005,100,,Invoice,,,,,,24/09/2018,24/09/2018,0.00,,23.26,,"-955,704.92"
,IN,AR,30326539,1005,100,,Invoice,,,,,,24/09/2018,24/09/2018,0.00,,7.00,,"-955,711.92"
,IN,AR,30326544,1005,100,,Invoice,,,,,,24/09/2018,24/09/2018,0.00,,12.92,,"-955,724.84"
,IN,AR,30326549,1005,100,,Invoice,,,,,,24/09/2018,24/09/2018,0.00,,3.64,,"-955,728.48"
,IN,AR,30326555,1005,100,,Invoice,,,,,,24/09/2018,24/09/2018,0.00,,4.80,,"-955,733.28"
,IN,AR,30326558,1005,100,,Invoice,,,,,,24/09/2018,24/09/2018,0.00,,13.78,,"-955,747.06"
,IN,AR,30326580,1005,100,,Invoice,,,,,,24/09/2018,24/09/2018,0.00,,2.12,,"-955,749.18"
,IN,AR,30326583,1005,100,,Invoice,,,,,,24/09/2018,24/09/2018,0.00,,20.34,,"-955,769.52"
,IN,AR,30326601,1005,100,,Invoice,,,,,,24/09/2018,24/09/2018,0.00,,36.19,,"-955,805.71"
,IN,AR,30326614,1005,100,,Invoice,,,,,,24/09/2018,24/09/2018,0.00,,8.90,,"-955,814.61"
,IN,AR,30326623,1005,100,,Invoice,,,,,,24/09/2018,24/09/2018,0.00,,3.64,,"-955,818.25"
,IN,AR,30326628,1005,100,,Invoice,,,,,,24/09/2018,24/09/2018,0.00,,54.66,,"-955,872.91"
,IN,AR,30326642,1005,100,,Invoice,,,,,,24/09/2018,24/09/2018,0.00,,151.76,,"-956,024.67"
,IN,AR,30326649,1005,100,,Invoice,,,,,,24/09/2018,24/09/2018,0.00,,20.34,,"-956,045.01"
,IN,AR,30326658,1005,100,,Invoice,,,,,,24/09/2018,24/09/2018,0.00,,35.85,,"-956,080.86"
,IN,AR,30326659,1005,100,,Invoice,,,,,,24/09/2018,24/09/2018,0.00,,11.95,,"-956,092.81"
,IN,AR,30326664,1005,100,,Invoice,,,,,,24/09/2018,24/09/2018,0.00,,19.32,,"-956,112.13"
,IN,AR,30326671,1005,100,,Invoice,,,,,,24/09/2018,24/09/2018,0.00,,12.03,,"-956,124.16"
,IN,AR,30326686,1005,100,,Invoice,,,,,,24/09/2018,24/09/2018,0.00,,4.24,,"-956,128.40"
,IN,AR,30326690,1005,100,,Invoice,,,,,,24/09/2018,24/09/2018,0.00,,6.02,,"-956,134.42"
,IN,AR,30326700,1005,100,,Invoice,,,,,,24/09/2018,24/09/2018,0.00,,42.12,,"-956,176.54"
,IN,AR,30326703,1005,100,,Invoice,,,,,,24/09/2018,24/09/2018,0.00,,6.02,,"-956,182.56"
,IN,AR,30326741,1005,100,,Invoice,,,,,,24/09/2018,24/09/2018,0.00,,15.25,,"-956,197.81"
,IN,AR,30326808,1005,100,,Invoice,,,,,,24/09/2018,24/09/2018,0.00,,7.17,,"-956,204.98"
,IN,AR,30326819,1005,100,,Invoice,,,,,,24/09/2018,24/09/2018,0.00,,38.14,,"-956,243.12"
,IN,AR,30326827,1005,100,,Invoice,,,,,,24/09/2018,24/09/2018,0.00,,20.34,,"-956,263.46"
,IN,AR,30326848,1005,100,,Invoice,,,,,,24/09/2018,24/09/2018,0.00,,3.64,,"-956,267.10"
,IN,AR,30326851,1005,100,,Invoice,,,,,,24/09/2018,24/09/2018,0.00,,10.93,,"-956,278.03"
,IN,AR,30326852,1005,100,,Invoice,,,,,,24/09/2018,24/09/2018,0.00,,14.58,,"-956,292.61"
,IN,AR,30326865,1005,100,,Invoice,,,,,,24/09/2018,24/09/2018,0.00,,8.26,,"-956,300.87"
,IN,AR,30326867,1005,100,,Invoice,,,,,,24/09/2018,24/09/2018,0.00,,7.29,,"-956,308.16"
,IN,AR,30326878,1005,100,,Invoice,,,,,,24/09/2018,24/09/2018,0.00,,3.64,,"-956,311.80"
,IN,AR,30326882,1005,100,,Invoice,,,,,,24/09/2018,24/09/2018,0.00,,6.89,,"-956,318.69"
,IN,AR,30326885,1005,100,,Invoice,,,,,,24/09/2018,24/09/2018,0.00,,19.64,,"-956,338.33"
,IN,AR,30326892,1005,100,,Invoice,,,,,,24/09/2018,24/09/2018,0.00,,15.76,,"-956,354.09"
,IN,AR,30326913,1005,100,,Invoice,,,,,,24/09/2018,24/09/2018,0.00,,5.17,,"-956,359.26"
,IN,AR,30326917,1005,100,,Invoice,,,,,,24/09/2018,24/09/2018,0.00,,54.66,,"-956,413.92"
,IN,AR,30326929,1005,100,,Invoice,,,,,,24/09/2018,24/09/2018,0.00,,65.90,,"-956,479.82"
,IN,AR,30326935,1005,100,,Invoice,,,,,,24/09/2018,24/09/2018,0.00,,7.29,,"-956,487.11"
,IN,AR,30326938,1005,100,,Invoice,,,,,,24/09/2018,24/09/2018,0.00,,26.00,,"-956,513.11"
,IN,AR,30326961,1005,100,,Invoice,,,,,,24/09/2018,24/09/2018,0.00,,10.34,,"-956,523.45"
,IN,AR,30326962,1005,100,,Invoice,,,,,,24/09/2018,24/09/2018,0.00,,7.75,,"-956,531.20"
,IN,AR,30326969,1005,100,,Invoice,,,,,,24/09/2018,24/09/2018,0.00,,42.69,,"-956,573.89"
,IN,AR,30326972,1005,100,,Invoice,,,,,,24/09/2018,24/09/2018,0.00,,6.74,,"-956,580.63"
,IN,AR,30326985,1005,100,,Invoice,,,,,,24/09/2018,24/09/2018,0.00,,51.91,,"-956,632.54"
,IN,AR,30326986,1005,100,,Invoice,,,,,,24/09/2018,24/09/2018,0.00,,37.37,,"-956,669.91"
,IN,AR,30327022,1005,100,,Invoice,,,,,,24/09/2018,24/09/2018,0.00,,7.29,,"-956,677.20"
,IN,AR,30327025,1005,100,,Invoice,,,,,,24/09/2018,24/09/2018,0.00,,7.29,,"-956,684.49"
,IN,AR,30327062,1005,100,,Invoice,,,,,,24/09/2018,24/09/2018,0.00,,2.14,,"-956,686.63"
,IN,AR,30327066,1005,100,,Invoice,,,,,,24/09/2018,24/09/2018,0.00,,18.22,,"-956,704.85"
,IN,AR,30327133,1005,100,,Invoice,,,,,,24/09/2018,24/09/2018,0.00,,36.08,,"-956,740.93"
,IN,AR,30327136,1005,100,,Invoice,,,,,,24/09/2018,24/09/2018,0.00,,7.29,,"-956,748.22"
,IN,AR,30327148,1005,100,,Invoice,,,,,,24/09/2018,24/09/2018,0.00,,12.14,,"-956,760.36"
,IN,AR,30327165,1005,100,,Invoice,,,,,,24/09/2018,24/09/2018,0.00,,34.15,,"-956,794.51"
,IN,AR,30327169,1005,100,,Invoice,,,,,,24/09/2018,24/09/2018,0.00,,2.29,,"-956,796.80"
,IN,AR,30327180,1005,100,,Invoice,,,,,,24/09/2018,24/09/2018,0.00,,9.84,,"-956,806.64"
,IN,AR,30327192,1005,100,,Invoice,,,,,,24/09/2018,24/09/2018,0.00,,32.80,,"-956,839.44"
,IN,AR,30327207,1005,100,,Invoice,,,,,,24/09/2018,24/09/2018,0.00,,22.01,,"-956,861.45"
,IN,AR,30327215,1005,100,,Invoice,,,,,,24/09/2018,24/09/2018,0.00,,16.01,,"-956,877.46"
,IN,AR,30327217,1005,100,,Invoice,,,,,,24/09/2018,24/09/2018,0.00,,54.66,,"-956,932.12"
,IN,AR,30327234,1005,100,,Invoice,,,,,,24/09/2018,24/09/2018,0.00,,27.15,,"-956,959.27"
,IN,AR,30327238,1005,100,,Invoice,,,,,,24/09/2018,24/09/2018,0.00,,14.58,,"-956,973.85"
,IN,AR,30327249,1005,100,,Invoice,,,,,,24/09/2018,24/09/2018,0.00,,65.18,,"-957,039.03"
,IN,AR,30327250,1005,100,,Invoice,,,,,,24/09/2018,24/09/2018,0.00,,12.62,,"-957,051.65"
,IN,AR,30327260,1005,100,,Invoice,,,,,,24/09/2018,24/09/2018,0.00,,23.32,,"-957,074.97"
,IN,AR,30327264,1005,100,,Invoice,,,,,,24/09/2018,24/09/2018,0.00,,31.41,,"-957,106.38"
,IN,AR,30327266,1005,100,,Invoice,,,,,,24/09/2018,24/09/2018,0.00,,165.47,,"-957,271.85"
,IN,AR,30327275,1005,100,,Invoice,,,,,,24/09/2018,24/09/2018,0.00,,28.05,,"-957,299.90"
,IN,AR,30327280,1005,100,,Invoice,,,,,,24/09/2018,24/09/2018,0.00,,7.29,,"-957,307.19"
,IN,AR,30327289,1005,100,,Invoice,,,,,,24/09/2018,24/09/2018,0.00,,14.58,,"-957,321.77"
,IN,AR,30327331,1005,100,,Invoice,,,,,,24/09/2018,24/09/2018,0.00,,24.03,,"-957,345.80"
,IN,AR,30327341,1005,100,,Invoice,,,,,,24/09/2018,24/09/2018,0.00,,22.31,,"-957,368.11"
,IN,AR,30327385,1005,100,,Invoice,,,,,,24/09/2018,24/09/2018,0.00,,63.90,,"-957,432.01"
,IN,AR,30327421,1005,100,,Invoice,,,,,,24/09/2018,24/09/2018,0.00,,12.00,,"-957,444.01"
,IN,AR,30327431,1005,100,,Invoice,,,,,,24/09/2018,24/09/2018,0.00,,1.88,,"-957,445.89"
,IN,AR,30327444,1005,100,,Invoice,,,,,,24/09/2018,24/09/2018,0.00,,13.63,,"-957,459.52"
,IN,AR,30327464,1005,100,,Invoice,,,,,,24/09/2018,24/09/2018,0.00,,13.69,,"-957,473.21"
,IN,AR,30327475,1005,100,,Invoice,,,,,,24/09/2018,24/09/2018,0.00,,10.93,,"-957,484.14"
,IN,AR,30327487,1005,100,,Invoice,,,,,,24/09/2018,24/09/2018,0.00,,5.24,,"-957,489.38"
,IN,AR,30327501,1005,100,,Invoice,,,,,,24/09/2018,24/09/2018,0.00,,6.13,,"-957,495.51"
,IN,AR,30327525,1005,100,,Invoice,,,,,,24/09/2018,24/09/2018,0.00,,40.93,,"-957,536.44"
,IN,AR,30327546,1005,100,,Invoice,,,,,,24/09/2018,24/09/2018,0.00,,2.00,,"-957,538.44"
,IN,AR,30327561,1005,100,,Invoice,,,,,,24/09/2018,24/09/2018,0.00,,16.61,,"-957,555.05"
,IN,AR,30327562,1005,100,,Invoice,,,,,,24/09/2018,24/09/2018,0.00,,2.08,,"-957,557.13"
,IN,AR,30327563,1005,100,,Invoice,,,,,,24/09/2018,24/09/2018,0.00,,8.31,,"-957,565.44"
,IN,AR,30327564,1005,100,,Invoice,,,,,,24/09/2018,24/09/2018,0.00,,6.23,,"-957,571.67"
,IN,AR,30327565,1005,100,,Invoice,,,,,,24/09/2018,24/09/2018,0.00,,2.08,,"-957,573.75"
,IN,AR,30327566,1005,100,,Invoice,,,,,,24/09/2018,24/09/2018,0.00,,12.46,,"-957,586.21"
,IN,AR,30327601,1005,100,,Invoice,,,,,,24/09/2018,24/09/2018,0.00,,25.51,,"-957,611.72"
,IN,AR,30327602,1005,100,,Invoice,,,,,,24/09/2018,24/09/2018,0.00,,6.56,,"-957,618.28"
,IN,AR,30327606,1005,100,,Invoice,,,,,,24/09/2018,24/09/2018,0.00,,2.03,,"-957,620.31"
,IN,AR,30327612,1005,100,,Invoice,,,,,,24/09/2018,24/09/2018,0.00,,10.93,,"-957,631.24"
,IN,AR,30327617,1005,100,,Invoice,,,,,,24/09/2018,24/09/2018,0.00,,1.75,,"-957,632.99"
,IN,AR,30327625,1005,100,,Invoice,,,,,,24/09/2018,24/09/2018,0.00,,39.95,,"-957,672.94"
,IN,AR,30327657,1005,100,,Invoice,,,,,,24/09/2018,24/09/2018,0.00,,29.15,,"-957,702.09"
,IN,AR,30327659,1005,100,,Invoice,,,,,,24/09/2018,24/09/2018,0.00,,69.71,,"-957,771.80"
,CN,AR,31019033,1005,100,,Credit Note,,,,,,25/09/2018,25/09/2018,7.75,,0.00,,"-957,764.05"
,CN,AR,31019055,1005,100,,Credit Note,,,,,,25/09/2018,25/09/2018,7.29,,0.00,,"-957,756.76"
,CN,AR,31019110,1005,100,,Credit Note,,,,,,25/09/2018,25/09/2018,10.93,,0.00,,"-957,745.83"
,CN,AR,31019116,1005,100,,Credit Note,,,,,,25/09/2018,25/09/2018,7.29,,0.00,,"-957,738.54"
,CS,AR,32008897,1005,100,,Cash sale,,,,,,25/09/2018,25/09/2018,0.00,,18.05,,"-957,756.59"
,CS,AR,32008915,1005,100,,Cash sale,,,,,,25/09/2018,25/09/2018,0.00,,3.64,,"-957,760.23"
,CS,AR,32008924,1005,100,,Cash sale,,,,,,25/09/2018,25/09/2018,0.00,,7.29,,"-957,767.52"
,CS,AR,32008926,1005,100,,Cash sale,,,,,,25/09/2018,25/09/2018,0.00,,18.22,,"-957,785.74"
,CS,AR,32008939,1005,100,,Cash sale,,,,,,25/09/2018,25/09/2018,0.00,,7.29,,"-957,793.03"
,CS,AR,32008945,1005,100,,Cash sale,,,,,,25/09/2018,25/09/2018,0.00,,7.29,,"-957,800.32"
,CS,AR,32008953,1005,100,,Cash sale,,,,,,25/09/2018,25/09/2018,0.00,,6.02,,"-957,806.34"
,CS,AR,32008960,1005,100,,Cash sale,,,,,,25/09/2018,25/09/2018,0.00,,10.93,,"-957,817.27"
,CS,AR,32008990,1005,100,,Cash sale,,,,,,25/09/2018,25/09/2018,0.00,,29.15,,"-957,846.42"
,CS,AR,32008994,1005,100,,Cash sale,,,,,,25/09/2018,25/09/2018,0.00,,7.29,,"-957,853.71"
,CS,AR,32009004,1005,100,,Cash sale,,,,,,25/09/2018,25/09/2018,0.00,,21.86,,"-957,875.57"
,CS,AR,32009023,1005,100,,Cash sale,,,,,,25/09/2018,25/09/2018,0.00,,7.29,,"-957,882.86"
,CS,AR,32009026,1005,100,,Cash sale,,,,,,25/09/2018,25/09/2018,0.00,,7.29,,"-957,890.15"
,CS,AR,32009030,1005,100,,Cash sale,,,,,,25/09/2018,25/09/2018,0.00,,4.32,,"-957,894.47"
,CS,AR,32009045,1005,100,,Cash sale,,,,,,25/09/2018,25/09/2018,0.00,,5.85,,"-957,900.32"
,CS,AR,32009046,1005,100,,Cash sale,,,,,,25/09/2018,25/09/2018,0.00,,25.17,,"-957,925.49"
,CS,AR,32009050,1005,100,,Cash sale,,,,,,25/09/2018,25/09/2018,0.00,,2.84,,"-957,928.33"
,CS,AR,32009055,1005,100,,Cash sale,,,,,,25/09/2018,25/09/2018,0.00,,7.29,,"-957,935.62"
,CS,AR,32009064,1005,100,,Cash sale,,,,,,25/09/2018,25/09/2018,0.00,,5.17,,"-957,940.79"
,CS,AR,32009075,1005,100,,Cash sale,,,,,,25/09/2018,25/09/2018,0.00,,10.93,,"-957,951.72"
,CS,AR,32009085,1005,100,,Cash sale,,,,,,25/09/2018,25/09/2018,0.00,,11.65,,"-957,963.37"
,CS,AR,32009088,1005,100,,Cash sale,,,,,,25/09/2018,25/09/2018,0.00,,7.75,,"-957,971.12"
,CS,AR,32009096,1005,100,,Cash sale,,,,,,25/09/2018,25/09/2018,0.00,,15.04,,"-957,986.16"
,CS,AR,32009097,1005,100,,Cash sale,,,,,,25/09/2018,25/09/2018,0.00,,12.97,,"-957,999.13"
,CS,AR,32009113,1005,100,,Cash sale,,,,,,25/09/2018,25/09/2018,0.00,,3.43,,"-958,002.56"
,CS,AR,32009122,1005,100,,Cash sale,,,,,,25/09/2018,25/09/2018,0.00,,7.80,,"-958,010.36"
,CS,AR,32009125,1005,100,,Cash sale,,,,,,25/09/2018,25/09/2018,0.00,,4.78,,"-958,015.14"
,CS,AR,32009129,1005,100,,Cash sale,,,,,,25/09/2018,25/09/2018,0.00,,3.64,,"-958,018.78"
,CS,AR,32009137,1005,100,,Cash sale,,,,,,25/09/2018,25/09/2018,0.00,,7.75,,"-958,026.53"
,CS,AR,32009145,1005,100,,Cash sale,,,,,,25/09/2018,25/09/2018,0.00,,10.34,,"-958,036.87"
,CS,AR,32009155,1005,100,,Cash sale,,,,,,25/09/2018,25/09/2018,0.00,,3.64,,"-958,040.51"
,CS,AR,32009165,1005,100,,Cash sale,,,,,,25/09/2018,25/09/2018,0.00,,7.29,,"-958,047.80"
,CS,AR,32009187,1005,100,,Cash sale,,,,,,25/09/2018,25/09/2018,0.00,,14.58,,"-958,062.38"
,CS,AR,32009195,1005,100,,Cash sale,,,,,,25/09/2018,25/09/2018,0.00,,9.66,,"-958,072.04"
,CS,AR,32009196,1005,100,,Cash sale,,,,,,25/09/2018,25/09/2018,0.00,,7.29,,"-958,079.33"
,CS,AR,32009210,1005,100,,Cash sale,,,,,,25/09/2018,25/09/2018,0.00,,12.86,,"-958,092.19"
,CS,AR,32009229,1005,100,,Cash sale,,,,,,25/09/2018,25/09/2018,0.00,,3.64,,"-958,095.83"
,CS,AR,32009234,1005,100,,Cash sale,,,,,,25/09/2018,25/09/2018,0.00,,29.15,,"-958,124.98"
,CS,AR,32009245,1005,100,,Cash sale,,,,,,25/09/2018,25/09/2018,0.00,,7.29,,"-958,132.27"
,CS,AR,32009248,1005,100,,Cash sale,,,,,,25/09/2018,25/09/2018,0.00,,10.93,,"-958,143.20"
,CS,AR,32009255,1005,100,,Cash sale,,,,,,25/09/2018,25/09/2018,0.00,,32.00,,"-958,175.20"
,CS,AR,32009262,1005,100,,Cash sale,,,,,,25/09/2018,25/09/2018,0.00,,10.93,,"-958,186.13"
,CS,AR,32009269,1005,100,,Cash sale,,,,,,25/09/2018,25/09/2018,0.00,,8.20,,"-958,194.33"
,CS,AR,32009284,1005,100,,Cash sale,,,,,,25/09/2018,25/09/2018,0.00,,23.73,,"-958,218.06"
,CS,AR,32009295,1005,100,,Cash sale,,,,,,25/09/2018,25/09/2018,0.00,,8.25,,"-958,226.31"
,CS,AR,32009297,1005,100,,Cash sale,,,,,,25/09/2018,25/09/2018,0.00,,18.22,,"-958,244.53"
,CS,AR,32009303,1005,100,,Cash sale,,,,,,25/09/2018,25/09/2018,0.00,,15.51,,"-958,260.04"
,CS,AR,32009309,1005,100,,Cash sale,,,,,,25/09/2018,25/09/2018,0.00,,18.22,,"-958,278.26"
,CS,AR,32009311,1005,100,,Cash sale,,,,,,25/09/2018,25/09/2018,0.00,,7.29,,"-958,285.55"
,CS,AR,32009314,1005,100,,Cash sale,,,,,,25/09/2018,25/09/2018,0.00,,5.47,,"-958,291.02"
,CS,AR,32009355,1005,100,,Cash sale,,,,,,25/09/2018,25/09/2018,0.00,,5.47,,"-958,296.49"
,CS,AR,32009357,1005,100,,Cash sale,,,,,,25/09/2018,25/09/2018,0.00,,8.75,,"-958,305.24"
,CS,AR,32009361,1005,100,,Cash sale,,,,,,25/09/2018,25/09/2018,0.00,,10.93,,"-958,316.17"
,CS,AR,32009409,1005,100,,Cash sale,,,,,,25/09/2018,25/09/2018,0.00,,6.19,,"-958,322.36"
,CS,AR,32009419,1005,100,,Cash sale,,,,,,25/09/2018,25/09/2018,0.00,,3.64,,"-958,326.00"
,CS,AR,32009426,1005,100,,Cash sale,,,,,,25/09/2018,25/09/2018,0.00,,14.58,,"-958,340.58"
,IN,AR,30326266,1005,100,,Invoice,,,,,,25/09/2018,25/09/2018,0.00,,169.08,,"-958,509.66"
,IN,AR,30326285,1005,100,,Invoice,,,,,,25/09/2018,25/09/2018,0.00,,329.71,,"-958,839.37"
,IN,AR,30326345,1005,100,,Invoice,,,,,,25/09/2018,25/09/2018,0.00,,3.50,,"-958,842.87"
,IN,AR,30326370,1005,100,,Invoice,,,,,,25/09/2018,25/09/2018,0.00,,3.98,,"-958,846.85"
,IN,AR,30326371,1005,100,,Invoice,,,,,,25/09/2018,25/09/2018,0.00,,7.97,,"-958,854.82"
,IN,AR,30326381,1005,100,,Invoice,,,,,,25/09/2018,25/09/2018,0.00,,83.05,,"-958,937.87"
,IN,AR,30326394,1005,100,,Invoice,,,,,,25/09/2018,25/09/2018,0.00,,7.29,,"-958,945.16"
,IN,AR,30326395,1005,100,,Invoice,,,,,,25/09/2018,25/09/2018,0.00,,75.21,,"-959,020.37"
,IN,AR,30326396,1005,100,,Invoice,,,,,,25/09/2018,25/09/2018,0.00,,7.29,,"-959,027.66"
,IN,AR,30326409,1005,100,,Invoice,,,,,,25/09/2018,25/09/2018,0.00,,10.93,,"-959,038.59"
,IN,AR,30326467,1005,100,,Invoice,,,,,,25/09/2018,25/09/2018,0.00,,36.00,,"-959,074.59"
,IN,AR,30326470,1005,100,,Invoice,,,,,,25/09/2018,25/09/2018,0.00,,14.58,,"-959,089.17"
,IN,AR,30326471,1005,100,,Invoice,,,,,,25/09/2018,25/09/2018,0.00,,21.86,,"-959,111.03"
,IN,AR,30326475,1005,100,,Invoice,,,,,,25/09/2018,25/09/2018,0.00,,29.15,,"-959,140.18"
,IN,AR,30326484,1005,100,,Invoice,,,,,,25/09/2018,25/09/2018,0.00,,12.92,,"-959,153.10"
,IN,AR,30326504,1005,100,,Invoice,,,,,,25/09/2018,25/09/2018,0.00,,19.24,,"-959,172.34"
,IN,AR,30326505,1005,100,,Invoice,,,,,,25/09/2018,25/09/2018,0.00,,7.29,,"-959,179.63"
,IN,AR,30326533,1005,100,,Invoice,,,,,,25/09/2018,25/09/2018,0.00,,25.51,,"-959,205.14"
,IN,AR,30326537,1005,100,,Invoice,,,,,,25/09/2018,25/09/2018,0.00,,10.93,,"-959,216.07"
,IN,AR,30326548,1005,100,,Invoice,,,,,,25/09/2018,25/09/2018,0.00,,4.64,,"-959,220.71"
,IN,AR,30326560,1005,100,,Invoice,,,,,,25/09/2018,25/09/2018,0.00,,15.25,,"-959,235.96"
,IN,AR,30326567,1005,100,,Invoice,,,,,,25/09/2018,25/09/2018,0.00,,7.29,,"-959,243.25"
,IN,AR,30326576,1005,100,,Invoice,,,,,,25/09/2018,25/09/2018,0.00,,12.71,,"-959,255.96"
,IN,AR,30326584,1005,100,,Invoice,,,,,,25/09/2018,25/09/2018,0.00,,40.68,,"-959,296.64"
,IN,AR,30326592,1005,100,,Invoice,,,,,,25/09/2018,25/09/2018,0.00,,4.24,,"-959,300.88"
,IN,AR,30326593,1005,100,,Invoice,,,,,,25/09/2018,25/09/2018,0.00,,8.47,,"-959,309.35"
,IN,AR,30326610,1005,100,,Invoice,,,,,,25/09/2018,25/09/2018,0.00,,5.17,,"-959,314.52"
,IN,AR,30326626,1005,100,,Invoice,,,,,,25/09/2018,25/09/2018,0.00,,18.05,,"-959,332.57"
,IN,AR,30326637,1005,100,,Invoice,,,,,,25/09/2018,25/09/2018,0.00,,5.85,,"-959,338.42"
,IN,AR,30326669,1005,100,,Invoice,,,,,,25/09/2018,25/09/2018,0.00,,18.22,,"-959,356.64"
,IN,AR,30326697,1005,100,,Invoice,,,,,,25/09/2018,25/09/2018,0.00,,30.64,,"-959,387.28"
,IN,AR,30326698,1005,100,,Invoice,,,,,,25/09/2018,25/09/2018,0.00,,38.81,,"-959,426.09"
,IN,AR,30326760,1005,100,,Invoice,,,,,,25/09/2018,25/09/2018,0.00,,27.97,,"-959,454.06"
,IN,AR,30326807,1005,100,,Invoice,,,,,,25/09/2018,25/09/2018,0.00,,7.29,,"-959,461.35"
,IN,AR,30326815,1005,100,,Invoice,,,,,,25/09/2018,25/09/2018,0.00,,24.92,,"-959,486.27"
,IN,AR,30326828,1005,100,,Invoice,,,,,,25/09/2018,25/09/2018,0.00,,4.08,,"-959,490.35"
,IN,AR,30326830,1005,100,,Invoice,,,,,,25/09/2018,25/09/2018,0.00,,9.92,,"-959,500.27"
,IN,AR,30326837,1005,100,,Invoice,,,,,,25/09/2018,25/09/2018,0.00,,10.17,,"-959,510.44"
,IN,AR,30326840,1005,100,,Invoice,,,,,,25/09/2018,25/09/2018,0.00,,3.90,,"-959,514.34"
,IN,AR,30326842,1005,100,,Invoice,,,,,,25/09/2018,25/09/2018,0.00,,10.53,,"-959,524.87"
,IN,AR,30326860,1005,100,,Invoice,,,,,,25/09/2018,25/09/2018,0.00,,4.24,,"-959,529.11"
,IN,AR,30326868,1005,100,,Invoice,,,,,,25/09/2018,25/09/2018,0.00,,2.54,,"-959,531.65"
,IN,AR,30326869,1005,100,,Invoice,,,,,,25/09/2018,25/09/2018,0.00,,7.29,,"-959,538.94"
,IN,AR,30326874,1005,100,,Invoice,,,,,,25/09/2018,25/09/2018,0.00,,14.58,,"-959,553.52"
,IN,AR,30326895,1005,100,,Invoice,,,,,,25/09/2018,25/09/2018,0.00,,6.36,,"-959,559.88"
,IN,AR,30326905,1005,100,,Invoice,,,,,,25/09/2018,25/09/2018,0.00,,10.93,,"-959,570.81"
,IN,AR,30326912,1005,100,,Invoice,,,,,,25/09/2018,25/09/2018,0.00,,21.86,,"-959,592.67"
,IN,AR,30326939,1005,100,,Invoice,,,,,,25/09/2018,25/09/2018,0.00,,52.00,,"-959,644.67"
,IN,AR,30326941,1005,100,,Invoice,,,,,,25/09/2018,25/09/2018,0.00,,17.54,,"-959,662.21"
,IN,AR,30326957,1005,100,,Invoice,,,,,,25/09/2018,25/09/2018,0.00,,5.59,,"-959,667.80"
,IN,AR,30326993,1005,100,,Invoice,,,,,,25/09/2018,25/09/2018,0.00,,3.64,,"-959,671.44"
,IN,AR,30327004,1005,100,,Invoice,,,,,,25/09/2018,25/09/2018,0.00,,30.02,,"-959,701.46"
,IN,AR,30327005,1005,100,,Invoice,,,,,,25/09/2018,25/09/2018,0.00,,10.93,,"-959,712.39"
,IN,AR,30327013,1005,100,,Invoice,,,,,,25/09/2018,25/09/2018,0.00,,3.53,,"-959,715.92"
,IN,AR,30327020,1005,100,,Invoice,,,,,,25/09/2018,25/09/2018,0.00,,10.93,,"-959,726.85"
,IN,AR,30327023,1005,100,,Invoice,,,,,,25/09/2018,25/09/2018,0.00,,10.93,,"-959,737.78"
,IN,AR,30327049,1005,100,,Invoice,,,,,,25/09/2018,25/09/2018,0.00,,18.22,,"-959,756.00"
,IN,AR,30327082,1005,100,,Invoice,,,,,,25/09/2018,25/09/2018,0.00,,11.25,,"-959,767.25"
,IN,AR,30327095,1005,100,,Invoice,,,,,,25/09/2018,25/09/2018,0.00,,39.83,,"-959,807.08"
,IN,AR,30327107,1005,100,,Invoice,,,,,,25/09/2018,25/09/2018,0.00,,7.97,,"-959,815.05"
,IN,AR,30327108,1005,100,,Invoice,,,,,,25/09/2018,25/09/2018,0.00,,7.97,,"-959,823.02"
,IN,AR,30327118,1005,100,,Invoice,,,,,,25/09/2018,25/09/2018,0.00,,45.42,,"-959,868.44"
,IN,AR,30327124,1005,100,,Invoice,,,,,,25/09/2018,25/09/2018,0.00,,42.00,,"-959,910.44"
,IN,AR,30327156,1005,100,,Invoice,,,,,,25/09/2018,25/09/2018,0.00,,211.72,,"-960,122.16"
,IN,AR,30327191,1005,100,,Invoice,,,,,,25/09/2018,25/09/2018,0.00,,14.58,,"-960,136.74"
,IN,AR,30327193,1005,100,,Invoice,,,,,,25/09/2018,25/09/2018,0.00,,40.08,,"-960,176.82"
,IN,AR,30327210,1005,100,,Invoice,,,,,,25/09/2018,25/09/2018,0.00,,20.01,,"-960,196.83"
,IN,AR,30327251,1005,100,,Invoice,,,,,,25/09/2018,25/09/2018,0.00,,21.03,,"-960,217.86"
,IN,AR,30327258,1005,100,,Invoice,,,,,,25/09/2018,25/09/2018,0.00,,29.15,,"-960,247.01"
,IN,AR,30327271,1005,100,,Invoice,,,,,,25/09/2018,25/09/2018,0.00,,5.47,,"-960,252.48"
,IN,AR,30327291,1005,100,,Invoice,,,,,,25/09/2018,25/09/2018,0.00,,148.00,,"-960,400.48"
,IN,AR,30327306,1005,100,,Invoice,,,,,,25/09/2018,25/09/2018,0.00,,23.73,,"-960,424.21"
,IN,AR,30327312,1005,100,,Invoice,,,,,,25/09/2018,25/09/2018,0.00,,7.29,,"-960,431.50"
,IN,AR,30327333,1005,100,,Invoice,,,,,,25/09/2018,25/09/2018,0.00,,10.93,,"-960,442.43"
,IN,AR,30327342,1005,100,,Invoice,,,,,,25/09/2018,25/09/2018,0.00,,14.34,,"-960,456.77"
,IN,AR,30327352,1005,100,,Invoice,,,,,,25/09/2018,25/09/2018,0.00,,111.19,,"-960,567.96"
,IN,AR,30327389,1005,100,,Invoice,,,,,,25/09/2018,25/09/2018,0.00,,28.47,,"-960,596.43"
,IN,AR,30327390,1005,100,,Invoice,,,,,,25/09/2018,25/09/2018,0.00,,104.42,,"-960,700.85"
,IN,AR,30327409,1005,100,,Invoice,,,,,,25/09/2018,25/09/2018,0.00,,22.37,,"-960,723.22"
,IN,AR,30327436,1005,100,,Invoice,,,,,,25/09/2018,25/09/2018,0.00,,3.51,,"-960,726.73"
,IN,AR,30327440,1005,100,,Invoice,,,,,,25/09/2018,25/09/2018,0.00,,8.00,,"-960,734.73"
,IN,AR,30327442,1005,100,,Invoice,,,,,,25/09/2018,25/09/2018,0.00,,8.90,,"-960,743.63"
,IN,AR,30327449,1005,100,,Invoice,,,,,,25/09/2018,25/09/2018,0.00,,70.59,,"-960,814.22"
,IN,AR,30327457,1005,100,,Invoice,,,,,,25/09/2018,25/09/2018,0.00,,7.02,,"-960,821.24"
,IN,AR,30327472,1005,100,,Invoice,,,,,,25/09/2018,25/09/2018,0.00,,21.86,,"-960,843.10"
,IN,AR,30327492,1005,100,,Invoice,,,,,,25/09/2018,25/09/2018,0.00,,12.14,,"-960,855.24"
,IN,AR,30327511,1005,100,,Invoice,,,,,,25/09/2018,25/09/2018,0.00,,32.80,,"-960,888.04"
,IN,AR,30327520,1005,100,,Invoice,,,,,,25/09/2018,25/09/2018,0.00,,2.80,,"-960,890.84"
,IN,AR,30327534,1005,100,,Invoice,,,,,,25/09/2018,25/09/2018,0.00,,7.29,,"-960,898.13"
,IN,AR,30327567,1005,100,,Invoice,,,,,,25/09/2018,25/09/2018,0.00,,20.76,,"-960,918.89"
,IN,AR,30327568,1005,100,,Invoice,,,,,,25/09/2018,25/09/2018,0.00,,6.23,,"-960,925.12"
,IN,AR,30327569,1005,100,,Invoice,,,,,,25/09/2018,25/09/2018,0.00,,97.58,,"-961,022.70"
,IN,AR,30327580,1005,100,,Invoice,,,,,,25/09/2018,25/09/2018,0.00,,25.42,,"-961,048.12"
,IN,AR,30327584,1005,100,,Invoice,,,,,,25/09/2018,25/09/2018,0.00,,12.08,,"-961,060.20"
,IN,AR,30327607,1005,100,,Invoice,,,,,,25/09/2018,25/09/2018,0.00,,12.71,,"-961,072.91"
,IN,AR,30327609,1005,100,,Invoice,,,,,,25/09/2018,25/09/2018,0.00,,10.17,,"-961,083.08"
,IN,AR,30327640,1005,100,,Invoice,,,,,,25/09/2018,25/09/2018,0.00,,10.93,,"-961,094.01"
,IN,AR,30327641,1005,100,,Invoice,,,,,,25/09/2018,25/09/2018,0.00,,2.00,,"-961,096.01"
,IN,AR,30327645,1005,100,,Invoice,,,,,,25/09/2018,25/09/2018,0.00,,84.95,,"-961,180.96"
,IN,AR,30327649,1005,100,,Invoice,,,,,,25/09/2018,25/09/2018,0.00,,3.64,,"-961,184.60"
,IN,AR,30327664,1005,100,,Invoice,,,,,,25/09/2018,25/09/2018,0.00,,3.64,,"-961,188.24"
,IN,AR,30327666,1005,100,,Invoice,,,,,,25/09/2018,25/09/2018,0.00,,7.29,,"-961,195.53"
,IN,AR,30327671,1005,100,,Invoice,,,,,,25/09/2018,25/09/2018,0.00,,7.29,,"-961,202.82"
,CS,AR,32008902,1005,100,,Cash sale,,,,,,26/09/2018,26/09/2018,0.00,,19.64,,"-961,222.46"
,CS,AR,32008906,1005,100,,Cash sale,,,,,,26/09/2018,26/09/2018,0.00,,37.63,,"-961,260.09"
,CS,AR,32008916,1005,100,,Cash sale,,,,,,26/09/2018,26/09/2018,0.00,,10.93,,"-961,271.02"
,CS,AR,32008930,1005,100,,Cash sale,,,,,,26/09/2018,26/09/2018,0.00,,3.64,,"-961,274.66"
,CS,AR,32008931,1005,100,,Cash sale,,,,,,26/09/2018,26/09/2018,0.00,,7.29,,"-961,281.95"
,CS,AR,32008934,1005,100,,Cash sale,,,,,,26/09/2018,26/09/2018,0.00,,18.22,,"-961,300.17"
,CS,AR,32008956,1005,100,,Cash sale,,,,,,26/09/2018,26/09/2018,0.00,,3.64,,"-961,303.81"
,CS,AR,32008971,1005,100,,Cash sale,,,,,,26/09/2018,26/09/2018,0.00,,10.93,,"-961,314.74"
,CS,AR,32009006,1005,100,,Cash sale,,,,,,26/09/2018,26/09/2018,0.00,,3.64,,"-961,318.38"
,CS,AR,32009010,1005,100,,Cash sale,,,,,,26/09/2018,26/09/2018,0.00,,2.92,,"-961,321.30"
,CS,AR,32009020,1005,100,,Cash sale,,,,,,26/09/2018,26/09/2018,0.00,,7.75,,"-961,329.05"
,CS,AR,32009021,1005,100,,Cash sale,,,,,,26/09/2018,26/09/2018,0.00,,10.93,,"-961,339.98"
,CS,AR,32009025,1005,100,,Cash sale,,,,,,26/09/2018,26/09/2018,0.00,,5.17,,"-961,345.15"
,CS,AR,32009028,1005,100,,Cash sale,,,,,,26/09/2018,26/09/2018,0.00,,3.64,,"-961,348.79"
,CS,AR,32009032,1005,100,,Cash sale,,,,,,26/09/2018,26/09/2018,0.00,,54.66,,"-961,403.45"
,CS,AR,32009052,1005,100,,Cash sale,,,,,,26/09/2018,26/09/2018,0.00,,12.92,,"-961,416.37"
,CS,AR,32009060,1005,100,,Cash sale,,,,,,26/09/2018,26/09/2018,0.00,,10.93,,"-961,427.30"
,CS,AR,32009067,1005,100,,Cash sale,,,,,,26/09/2018,26/09/2018,0.00,,24.07,,"-961,451.37"
,CS,AR,32009069,1005,100,,Cash sale,,,,,,26/09/2018,26/09/2018,0.00,,6.43,,"-961,457.80"
,CS,AR,32009078,1005,100,,Cash sale,,,,,,26/09/2018,26/09/2018,0.00,,14.58,,"-961,472.38"
,CS,AR,32009084,1005,100,,Cash sale,,,,,,26/09/2018,26/09/2018,0.00,,10.93,,"-961,483.31"
,CS,AR,32009090,1005,100,,Cash sale,,,,,,26/09/2018,26/09/2018,0.00,,5.08,,"-961,488.39"
,CS,AR,32009095,1005,100,,Cash sale,,,,,,26/09/2018,26/09/2018,0.00,,18.09,,"-961,506.48"
,CS,AR,32009127,1005,100,,Cash sale,,,,,,26/09/2018,26/09/2018,0.00,,3.64,,"-961,510.12"
,CS,AR,32009150,1005,100,,Cash sale,,,,,,26/09/2018,26/09/2018,0.00,,10.17,,"-961,520.29"
,CS,AR,32009151,1005,100,,Cash sale,,,,,,26/09/2018,26/09/2018,0.00,,10.93,,"-961,531.22"
,CS,AR,32009157,1005,100,,Cash sale,,,,,,26/09/2018,26/09/2018,0.00,,33.60,,"-961,564.82"
,CS,AR,32009159,1005,100,,Cash sale,,,,,,26/09/2018,26/09/2018,0.00,,7.29,,"-961,572.11"
,CS,AR,32009163,1005,100,,Cash sale,,,,,,26/09/2018,26/09/2018,0.00,,14.58,,"-961,586.69"
,CS,AR,32009179,1005,100,,Cash sale,,,,,,26/09/2018,26/09/2018,0.00,,6.02,,"-961,592.71"
,CS,AR,32009184,1005,100,,Cash sale,,,,,,26/09/2018,26/09/2018,0.00,,3.64,,"-961,596.35"
,CS,AR,32009208,1005,100,,Cash sale,,,,,,26/09/2018,26/09/2018,0.00,,10.93,,"-961,607.28"
,CS,AR,32009220,1005,100,,Cash sale,,,,,,26/09/2018,26/09/2018,0.00,,10.93,,"-961,618.21"
,CS,AR,32009222,1005,100,,Cash sale,,,,,,26/09/2018,26/09/2018,0.00,,14.24,,"-961,632.45"
,CS,AR,32009224,1005,100,,Cash sale,,,,,,26/09/2018,26/09/2018,0.00,,5.93,,"-961,638.38"
,CS,AR,32009227,1005,100,,Cash sale,,,,,,26/09/2018,26/09/2018,0.00,,7.29,,"-961,645.67"
,CS,AR,32009230,1005,100,,Cash sale,,,,,,26/09/2018,26/09/2018,0.00,,18.22,,"-961,663.89"
,CS,AR,32009242,1005,100,,Cash sale,,,,,,26/09/2018,26/09/2018,0.00,,10.93,,"-961,674.82"
,CS,AR,32009251,1005,100,,Cash sale,,,,,,26/09/2018,26/09/2018,0.00,,14.58,,"-961,689.40"
,CS,AR,32009252,1005,100,,Cash sale,,,,,,26/09/2018,26/09/2018,0.00,,9.15,,"-961,698.55"
,CS,AR,32009259,1005,100,,Cash sale,,,,,,26/09/2018,26/09/2018,0.00,,11.02,,"-961,709.57"
,CS,AR,32009274,1005,100,,Cash sale,,,,,,26/09/2018,26/09/2018,0.00,,6.86,,"-961,716.43"
,CS,AR,32009282,1005,100,,Cash sale,,,,,,26/09/2018,26/09/2018,0.00,,9.10,,"-961,725.53"
,CS,AR,32009289,1005,100,,Cash sale,,,,,,26/09/2018,26/09/2018,0.00,,20.34,,"-961,745.87"
,CS,AR,32009302,1005,100,,Cash sale,,,,,,26/09/2018,26/09/2018,0.00,,15.04,,"-961,760.91"
,CS,AR,32009304,1005,100,,Cash sale,,,,,,26/09/2018,26/09/2018,0.00,,21.86,,"-961,782.77"
,CS,AR,32009320,1005,100,,Cash sale,,,,,,26/09/2018,26/09/2018,0.00,,10.93,,"-961,793.70"
,CS,AR,32009325,1005,100,,Cash sale,,,,,,26/09/2018,26/09/2018,0.00,,44.75,,"-961,838.45"
,CS,AR,32009353,1005,100,,Cash sale,,,,,,26/09/2018,26/09/2018,0.00,,3.64,,"-961,842.09"
,CS,AR,32009364,1005,100,,Cash sale,,,,,,26/09/2018,26/09/2018,0.00,,13.74,,"-961,855.83"
,CS,AR,32009376,1005,100,,Cash sale,,,,,,26/09/2018,26/09/2018,0.00,,2.97,,"-961,858.80"
,CS,AR,32009420,1005,100,,Cash sale,,,,,,26/09/2018,26/09/2018,0.00,,7.29,,"-961,866.09"
,CS,AR,32009425,1005,100,,Cash sale,,,,,,26/09/2018,26/09/2018,0.00,,7.29,,"-961,873.38"
,IN,AR,30326273,1005,100,,Invoice,,,,,,26/09/2018,26/09/2018,0.00,,41.53,,"-961,914.91"
,IN,AR,30326299,1005,100,,Invoice,,,,,,26/09/2018,26/09/2018,0.00,,17.08,,"-961,931.99"
,IN,AR,30326300,1005,100,,Invoice,,,,,,26/09/2018,26/09/2018,0.00,,61.02,,"-961,993.01"
,IN,AR,30326318,1005,100,,Invoice,,,,,,26/09/2018,26/09/2018,0.00,,6.08,,"-961,999.09"
,IN,AR,30326331,1005,100,,Invoice,,,,,,26/09/2018,26/09/2018,0.00,,34.15,,"-962,033.24"
,IN,AR,30326332,1005,100,,Invoice,,,,,,26/09/2018,26/09/2018,0.00,,91.95,,"-962,125.19"
,IN,AR,30326339,1005,100,,Invoice,,,,,,26/09/2018,26/09/2018,0.00,,16.91,,"-962,142.10"
,IN,AR,30326372,1005,100,,Invoice,,,,,,26/09/2018,26/09/2018,0.00,,5.97,,"-962,148.07"
,IN,AR,30326382,1005,100,,Invoice,,,,,,26/09/2018,26/09/2018,0.00,,68.81,,"-962,216.88"
,IN,AR,30326422,1005,100,,Invoice,,,,,,26/09/2018,26/09/2018,0.00,,10.93,,"-962,227.81"
,IN,AR,30326424,1005,100,,Invoice,,,,,,26/09/2018,26/09/2018,0.00,,14.58,,"-962,242.39"
,IN,AR,30326436,1005,100,,Invoice,,,,,,26/09/2018,26/09/2018,0.00,,56.00,,"-962,298.39"
,IN,AR,30326451,1005,100,,Invoice,,,,,,26/09/2018,26/09/2018,0.00,,12.03,,"-962,310.42"
,IN,AR,30326453,1005,100,,Invoice,,,,,,26/09/2018,26/09/2018,0.00,,34.00,,"-962,344.42"
,IN,AR,30326478,1005,100,,Invoice,,,,,,26/09/2018,26/09/2018,0.00,,311.08,,"-962,655.50"
,IN,AR,30326483,1005,100,,Invoice,,,,,,26/09/2018,26/09/2018,0.00,,683.34,,"-963,338.84"
,IN,AR,30326493,1005,100,,Invoice,,,,,,26/09/2018,26/09/2018,0.00,,88.42,,"-963,427.26"
,IN,AR,30326514,1005,100,,Invoice,,,,,,26/09/2018,26/09/2018,0.00,,7.29,,"-963,434.55"
,IN,AR,30326519,1005,100,,Invoice,,,,,,26/09/2018,26/09/2018,0.00,,15.92,,"-963,450.47"
,IN,AR,30326528,1005,100,,Invoice,,,,,,26/09/2018,26/09/2018,0.00,,10.93,,"-963,461.40"
,IN,AR,30326552,1005,100,,Invoice,,,,,,26/09/2018,26/09/2018,0.00,,29.15,,"-963,490.55"
,IN,AR,30326566,1005,100,,Invoice,,,,,,26/09/2018,26/09/2018,0.00,,25.42,,"-963,515.97"
,IN,AR,30326578,1005,100,,Invoice,,,,,,26/09/2018,26/09/2018,0.00,,4.24,,"-963,520.21"
,IN,AR,30326590,1005,100,,Invoice,,,,,,26/09/2018,26/09/2018,0.00,,2.12,,"-963,522.33"
,IN,AR,30326595,1005,100,,Invoice,,,,,,26/09/2018,26/09/2018,0.00,,8.39,,"-963,530.72"
,IN,AR,30326607,1005,100,,Invoice,,,,,,26/09/2018,26/09/2018,0.00,,2.75,,"-963,533.47"
,IN,AR,30326618,1005,100,,Invoice,,,,,,26/09/2018,26/09/2018,0.00,,33.46,,"-963,566.93"
,IN,AR,30326621,1005,100,,Invoice,,,,,,26/09/2018,26/09/2018,0.00,,18.22,,"-963,585.15"
,IN,AR,30326631,1005,100,,Invoice,,,,,,26/09/2018,26/09/2018,0.00,,9.56,,"-963,594.71"
,IN,AR,30326643,1005,100,,Invoice,,,,,,26/09/2018,26/09/2018,0.00,,63.58,,"-963,658.29"
,IN,AR,30326650,1005,100,,Invoice,,,,,,26/09/2018,26/09/2018,0.00,,33.05,,"-963,691.34"
,IN,AR,30326679,1005,100,,Invoice,,,,,,26/09/2018,26/09/2018,0.00,,15.04,,"-963,706.38"
,IN,AR,30326681,1005,100,,Invoice,,,,,,26/09/2018,26/09/2018,0.00,,7.29,,"-963,713.67"
,IN,AR,30326682,1005,100,,Invoice,,,,,,26/09/2018,26/09/2018,0.00,,3.64,,"-963,717.31"
,IN,AR,30326683,1005,100,,Invoice,,,,,,26/09/2018,26/09/2018,0.00,,7.29,,"-963,724.60"
,IN,AR,30326689,1005,100,,Invoice,,,,,,26/09/2018,26/09/2018,0.00,,10.44,,"-963,735.04"
,IN,AR,30326701,1005,100,,Invoice,,,,,,26/09/2018,26/09/2018,0.00,,14.83,,"-963,749.87"
,IN,AR,30326706,1005,100,,Invoice,,,,,,26/09/2018,26/09/2018,0.00,,148.04,,"-963,897.91"
,IN,AR,30326751,1005,100,,Invoice,,,,,,26/09/2018,26/09/2018,0.00,,1.59,,"-963,899.50"
,IN,AR,30326753,1005,100,,Invoice,,,,,,26/09/2018,26/09/2018,0.00,,25.75,,"-963,925.25"
,IN,AR,30326813,1005,100,,Invoice,,,,,,26/09/2018,26/09/2018,0.00,,13.63,,"-963,938.88"
,IN,AR,30326838,1005,100,,Invoice,,,,,,26/09/2018,26/09/2018,0.00,,5.08,,"-963,943.96"
,IN,AR,30326858,1005,100,,Invoice,,,,,,26/09/2018,26/09/2018,0.00,,18.22,,"-963,962.18"
,IN,AR,30326862,1005,100,,Invoice,,,,,,26/09/2018,26/09/2018,0.00,,10.93,,"-963,973.11"
,IN,AR,30326898,1005,100,,Invoice,,,,,,26/09/2018,26/09/2018,0.00,,29.66,,"-964,002.77"
,IN,AR,30326902,1005,100,,Invoice,,,,,,26/09/2018,26/09/2018,0.00,,13.98,,"-964,016.75"
,IN,AR,30326920,1005,100,,Invoice,,,,,,26/09/2018,26/09/2018,0.00,,14.58,,"-964,031.33"
,IN,AR,30326922,1005,100,,Invoice,,,,,,26/09/2018,26/09/2018,0.00,,6.36,,"-964,037.69"
,IN,AR,30326924,1005,100,,Invoice,,,,,,26/09/2018,26/09/2018,0.00,,30.76,,"-964,068.45"
,IN,AR,30326931,1005,100,,Invoice,,,,,,26/09/2018,26/09/2018,0.00,,7.63,,"-964,076.08"
,IN,AR,30326971,1005,100,,Invoice,,,,,,26/09/2018,26/09/2018,0.00,,3.64,,"-964,079.72"
,IN,AR,30326980,1005,100,,Invoice,,,,,,26/09/2018,26/09/2018,0.00,,18.20,,"-964,097.92"
,IN,AR,30327002,1005,100,,Invoice,,,,,,26/09/2018,26/09/2018,0.00,,7.75,,"-964,105.67"
,IN,AR,30327014,1005,100,,Invoice,,,,,,26/09/2018,26/09/2018,0.00,,3.53,,"-964,109.20"
,IN,AR,30327019,1005,100,,Invoice,,,,,,26/09/2018,26/09/2018,0.00,,15.04,,"-964,124.24"
,IN,AR,30327040,1005,100,,Invoice,,,,,,26/09/2018,26/09/2018,0.00,,5.17,,"-964,129.41"
,IN,AR,30327051,1005,100,,Invoice,,,,,,26/09/2018,26/09/2018,0.00,,24.01,,"-964,153.42"
,IN,AR,30327054,1005,100,,Invoice,,,,,,26/09/2018,26/09/2018,0.00,,29.15,,"-964,182.57"
,IN,AR,30327055,1005,100,,Invoice,,,,,,26/09/2018,26/09/2018,0.00,,25.51,,"-964,208.08"
,IN,AR,30327087,1005,100,,Invoice,,,,,,26/09/2018,26/09/2018,0.00,,10.17,,"-964,218.25"
,IN,AR,30327109,1005,100,,Invoice,,,,,,26/09/2018,26/09/2018,0.00,,47.80,,"-964,266.05"
,IN,AR,30327113,1005,100,,Invoice,,,,,,26/09/2018,26/09/2018,0.00,,4.01,,"-964,270.06"
,IN,AR,30327121,1005,100,,Invoice,,,,,,26/09/2018,26/09/2018,0.00,,28.00,,"-964,298.06"
,IN,AR,30327130,1005,100,,Invoice,,,,,,26/09/2018,26/09/2018,0.00,,40.08,,"-964,338.14"
,IN,AR,30327134,1005,100,,Invoice,,,,,,26/09/2018,26/09/2018,0.00,,44.09,,"-964,382.23"
,IN,AR,30327140,1005,100,,Invoice,,,,,,26/09/2018,26/09/2018,0.00,,14.58,,"-964,396.81"
,IN,AR,30327142,1005,100,,Invoice,,,,,,26/09/2018,26/09/2018,0.00,,3.64,,"-964,400.45"
,IN,AR,30327153,1005,100,,Invoice,,,,,,26/09/2018,26/09/2018,0.00,,34.58,,"-964,435.03"
,IN,AR,30327157,1005,100,,Invoice,,,,,,26/09/2018,26/09/2018,0.00,,9.11,,"-964,444.14"
,IN,AR,30327167,1005,100,,Invoice,,,,,,26/09/2018,26/09/2018,0.00,,54.66,,"-964,498.80"
,IN,AR,30327178,1005,100,,Invoice,,,,,,26/09/2018,26/09/2018,0.00,,7.64,,"-964,506.44"
,IN,AR,30327187,1005,100,,Invoice,,,,,,26/09/2018,26/09/2018,0.00,,41.39,,"-964,547.83"
,IN,AR,30327190,1005,100,,Invoice,,,,,,26/09/2018,26/09/2018,0.00,,5.93,,"-964,553.76"
,IN,AR,30327201,1005,100,,Invoice,,,,,,26/09/2018,26/09/2018,0.00,,7.63,,"-964,561.39"
,IN,AR,30327231,1005,100,,Invoice,,,,,,26/09/2018,26/09/2018,0.00,,68.14,,"-964,629.53"
,IN,AR,30327235,1005,100,,Invoice,,,,,,26/09/2018,26/09/2018,0.00,,1.51,,"-964,631.04"
,IN,AR,30327252,1005,100,,Invoice,,,,,,26/09/2018,26/09/2018,0.00,,37.85,,"-964,668.89"
,IN,AR,30327256,1005,100,,Invoice,,,,,,26/09/2018,26/09/2018,0.00,,17.44,,"-964,686.33"
,IN,AR,30327285,1005,100,,Invoice,,,,,,26/09/2018,26/09/2018,0.00,,22.37,,"-964,708.70"
,IN,AR,30327294,1005,100,,Invoice,,,,,,26/09/2018,26/09/2018,0.00,,7.29,,"-964,715.99"
,IN,AR,30327320,1005,100,,Invoice,,,,,,26/09/2018,26/09/2018,0.00,,2.54,,"-964,718.53"
,IN,AR,30327322,1005,100,,Invoice,,,,,,26/09/2018,26/09/2018,0.00,,6.07,,"-964,724.60"
,IN,AR,30327343,1005,100,,Invoice,,,,,,26/09/2018,26/09/2018,0.00,,7.97,,"-964,732.57"
,IN,AR,30327433,1005,100,,Invoice,,,,,,26/09/2018,26/09/2018,0.00,,5.26,,"-964,737.83"
,IN,AR,30327461,1005,100,,Invoice,,,,,,26/09/2018,26/09/2018,0.00,,9.84,,"-964,747.67"
,IN,AR,30327471,1005,100,,Invoice,,,,,,26/09/2018,26/09/2018,0.00,,11.29,,"-964,758.96"
,IN,AR,30327493,1005,100,,Invoice,,,,,,26/09/2018,26/09/2018,0.00,,10.47,,"-964,769.43"
,IN,AR,30327496,1005,100,,Invoice,,,,,,26/09/2018,26/09/2018,0.00,,16.78,,"-964,786.21"
,IN,AR,30327526,1005,100,,Invoice,,,,,,26/09/2018,26/09/2018,0.00,,11.66,,"-964,797.87"
,IN,AR,30327533,1005,100,,Invoice,,,,,,26/09/2018,26/09/2018,0.00,,16.02,,"-964,813.89"
,IN,AR,30327538,1005,100,,Invoice,,,,,,26/09/2018,26/09/2018,0.00,,12.14,,"-964,826.03"
,IN,AR,30327570,1005,100,,Invoice,,,,,,26/09/2018,26/09/2018,0.00,,39.45,,"-964,865.48"
,IN,AR,30327571,1005,100,,Invoice,,,,,,26/09/2018,26/09/2018,0.00,,8.31,,"-964,873.79"
,IN,AR,30327572,1005,100,,Invoice,,,,,,26/09/2018,26/09/2018,0.00,,16.61,,"-964,890.40"
,IN,AR,30327573,1005,100,,Invoice,,,,,,26/09/2018,26/09/2018,0.00,,12.46,,"-964,902.86"
,IN,AR,30327581,1005,100,,Invoice,,,,,,26/09/2018,26/09/2018,0.00,,5.08,,"-964,907.94"
,IN,AR,30327590,1005,100,,Invoice,,,,,,26/09/2018,26/09/2018,0.00,,24.27,,"-964,932.21"
,IN,AR,30327596,1005,100,,Invoice,,,,,,26/09/2018,26/09/2018,0.00,,7.29,,"-964,939.50"
,IN,AR,30327611,1005,100,,Invoice,,,,,,26/09/2018,26/09/2018,0.00,,25.51,,"-964,965.01"
,IN,AR,30327634,1005,100,,Invoice,,,,,,26/09/2018,26/09/2018,0.00,,3.64,,"-964,968.65"
,IN,AR,30327638,1005,100,,Invoice,,,,,,26/09/2018,26/09/2018,0.00,,16.78,,"-964,985.43"
,IN,AR,30327669,1005,100,,Invoice,,,,,,26/09/2018,26/09/2018,0.00,,12.14,,"-964,997.57"
,IN,AR,30327670,1005,100,,Invoice,,,,,,26/09/2018,26/09/2018,0.00,,15.17,,"-965,012.74"
,CN,AR,31019031,1005,100,,Credit Note,,,,,,27/09/2018,27/09/2018,10.93,,0.00,,"-965,001.81"
,CN,AR,31019120,1005,100,,Credit Note,,,,,,27/09/2018,27/09/2018,29.15,,0.00,,"-964,972.66"
,CS,AR,32008912,1005,100,,Cash sale,,,,,,27/09/2018,27/09/2018,0.00,,7.29,,"-964,979.95"
,CS,AR,32008914,1005,100,,Cash sale,,,,,,27/09/2018,27/09/2018,0.00,,11.36,,"-964,991.31"
,CS,AR,32008920,1005,100,,Cash sale,,,,,,27/09/2018,27/09/2018,0.00,,10.93,,"-965,002.24"
,CS,AR,32008935,1005,100,,Cash sale,,,,,,27/09/2018,27/09/2018,0.00,,18.22,,"-965,020.46"
,CS,AR,32008942,1005,100,,Cash sale,,,,,,27/09/2018,27/09/2018,0.00,,3.64,,"-965,024.10"
,CS,AR,32008949,1005,100,,Cash sale,,,,,,27/09/2018,27/09/2018,0.00,,7.29,,"-965,031.39"
,CS,AR,32008959,1005,100,,Cash sale,,,,,,27/09/2018,27/09/2018,0.00,,14.58,,"-965,045.97"
,CS,AR,32008983,1005,100,,Cash sale,,,,,,27/09/2018,27/09/2018,0.00,,10.93,,"-965,056.90"
,CS,AR,32009001,1005,100,,Cash sale,,,,,,27/09/2018,27/09/2018,0.00,,7.29,,"-965,064.19"
,CS,AR,32009012,1005,100,,Cash sale,,,,,,27/09/2018,27/09/2018,0.00,,7.29,,"-965,071.48"
,CS,AR,32009015,1005,100,,Cash sale,,,,,,27/09/2018,27/09/2018,0.00,,7.29,,"-965,078.77"
,CS,AR,32009048,1005,100,,Cash sale,,,,,,27/09/2018,27/09/2018,0.00,,7.75,,"-965,086.52"
,CS,AR,32009089,1005,100,,Cash sale,,,,,,27/09/2018,27/09/2018,0.00,,10.93,,"-965,097.45"
,CS,AR,32009114,1005,100,,Cash sale,,,,,,27/09/2018,27/09/2018,0.00,,8.17,,"-965,105.62"
,CS,AR,32009138,1005,100,,Cash sale,,,,,,27/09/2018,27/09/2018,0.00,,7.29,,"-965,112.91"
,CS,AR,32009140,1005,100,,Cash sale,,,,,,27/09/2018,27/09/2018,0.00,,60.17,,"-965,173.08"
,CS,AR,32009144,1005,100,,Cash sale,,,,,,27/09/2018,27/09/2018,0.00,,3.64,,"-965,176.72"
,CS,AR,32009153,1005,100,,Cash sale,,,,,,27/09/2018,27/09/2018,0.00,,19.58,,"-965,196.30"
,CS,AR,32009164,1005,100,,Cash sale,,,,,,27/09/2018,27/09/2018,0.00,,10.93,,"-965,207.23"
,CS,AR,32009182,1005,100,,Cash sale,,,,,,27/09/2018,27/09/2018,0.00,,6.44,,"-965,213.67"
,CS,AR,32009191,1005,100,,Cash sale,,,,,,27/09/2018,27/09/2018,0.00,,7.75,,"-965,221.42"
,CS,AR,32009213,1005,100,,Cash sale,,,,,,27/09/2018,27/09/2018,0.00,,10.93,,"-965,232.35"
,CS,AR,32009214,1005,100,,Cash sale,,,,,,27/09/2018,27/09/2018,0.00,,5.34,,"-965,237.69"
,CS,AR,32009216,1005,100,,Cash sale,,,,,,27/09/2018,27/09/2018,0.00,,16.78,,"-965,254.47"
,CS,AR,32009233,1005,100,,Cash sale,,,,,,27/09/2018,27/09/2018,0.00,,7.29,,"-965,261.76"
,CS,AR,32009261,1005,100,,Cash sale,,,,,,27/09/2018,27/09/2018,0.00,,8.90,,"-965,270.66"
,CS,AR,32009332,1005,100,,Cash sale,,,,,,27/09/2018,27/09/2018,0.00,,7.29,,"-965,277.95"
,CS,AR,32009333,1005,100,,Cash sale,,,,,,27/09/2018,27/09/2018,0.00,,25.51,,"-965,303.46"
,CS,AR,32009342,1005,100,,Cash sale,,,,,,27/09/2018,27/09/2018,0.00,,29.15,,"-965,332.61"
,CS,AR,32009349,1005,100,,Cash sale,,,,,,27/09/2018,27/09/2018,0.00,,10.93,,"-965,343.54"
,CS,AR,32009351,1005,100,,Cash sale,,,,,,27/09/2018,27/09/2018,0.00,,10.93,,"-965,354.47"
,CS,AR,32009359,1005,100,,Cash sale,,,,,,27/09/2018,27/09/2018,0.00,,11.70,,"-965,366.17"
,CS,AR,32009367,1005,100,,Cash sale,,,,,,27/09/2018,27/09/2018,0.00,,7.29,,"-965,373.46"
,CS,AR,32009370,1005,100,,Cash sale,,,,,,27/09/2018,27/09/2018,0.00,,54.66,,"-965,428.12"
,CS,AR,32009377,1005,100,,Cash sale,,,,,,27/09/2018,27/09/2018,0.00,,10.93,,"-965,439.05"
,CS,AR,32009418,1005,100,,Cash sale,,,,,,27/09/2018,27/09/2018,0.00,,5.08,,"-965,444.13"
,IN,AR,30326324,1005,100,,Invoice,,,,,,27/09/2018,27/09/2018,0.00,,3.64,,"-965,447.77"
,IN,AR,30326342,1005,100,,Invoice,,,,,,27/09/2018,27/09/2018,0.00,,7.29,,"-965,455.06"
,IN,AR,30326360,1005,100,,Invoice,,,,,,27/09/2018,27/09/2018,0.00,,54.66,,"-965,509.72"
,IN,AR,30326373,1005,100,,Invoice,,,,,,27/09/2018,27/09/2018,0.00,,3.98,,"-965,513.70"
,IN,AR,30326383,1005,100,,Invoice,,,,,,27/09/2018,27/09/2018,0.00,,14.24,,"-965,527.94"
,IN,AR,30326389,1005,100,,Invoice,,,,,,27/09/2018,27/09/2018,0.00,,3.64,,"-965,531.58"
,IN,AR,30326390,1005,100,,Invoice,,,,,,27/09/2018,27/09/2018,0.00,,10.93,,"-965,542.51"
,IN,AR,30326402,1005,100,,Invoice,,,,,,27/09/2018,27/09/2018,0.00,,52.00,,"-965,594.51"
,IN,AR,30326410,1005,100,,Invoice,,,,,,27/09/2018,27/09/2018,0.00,,728.81,,"-966,323.32"
,IN,AR,30326414,1005,100,,Invoice,,,,,,27/09/2018,27/09/2018,0.00,,29.15,,"-966,352.47"
,IN,AR,30326427,1005,100,,Invoice,,,,,,27/09/2018,27/09/2018,0.00,,7.29,,"-966,359.76"
,IN,AR,30326439,1005,100,,Invoice,,,,,,27/09/2018,27/09/2018,0.00,,10.93,,"-966,370.69"
,IN,AR,30326450,1005,100,,Invoice,,,,,,27/09/2018,27/09/2018,0.00,,14.58,,"-966,385.27"
,IN,AR,30326473,1005,100,,Invoice,,,,,,27/09/2018,27/09/2018,0.00,,30.20,,"-966,415.47"
,IN,AR,30326476,1005,100,,Invoice,,,,,,27/09/2018,27/09/2018,0.00,,25.55,,"-966,441.02"
,IN,AR,30326511,1005,100,,Invoice,,,,,,27/09/2018,27/09/2018,0.00,,36.36,,"-966,477.38"
,IN,AR,30326517,1005,100,,Invoice,,,,,,27/09/2018,27/09/2018,0.00,,54.66,,"-966,532.04"
,IN,AR,30326521,1005,100,,Invoice,,,,,,27/09/2018,27/09/2018,0.00,,29.15,,"-966,561.19"
,IN,AR,30326540,1005,100,,Invoice,,,,,,27/09/2018,27/09/2018,0.00,,31.50,,"-966,592.69"
,IN,AR,30326556,1005,100,,Invoice,,,,,,27/09/2018,27/09/2018,0.00,,4.80,,"-966,597.49"
,IN,AR,30326585,1005,100,,Invoice,,,,,,27/09/2018,27/09/2018,0.00,,18.31,,"-966,615.80"
,IN,AR,30326603,1005,100,,Invoice,,,,,,27/09/2018,27/09/2018,0.00,,11.66,,"-966,627.46"
,IN,AR,30326608,1005,100,,Invoice,,,,,,27/09/2018,27/09/2018,0.00,,10.98,,"-966,638.44"
,IN,AR,30326612,1005,100,,Invoice,,,,,,27/09/2018,27/09/2018,0.00,,234.87,,"-966,873.31"
,IN,AR,30326639,1005,100,,Invoice,,,,,,27/09/2018,27/09/2018,0.00,,16.95,,"-966,890.26"
,IN,AR,30326652,1005,100,,Invoice,,,,,,27/09/2018,27/09/2018,0.00,,32.80,,"-966,923.06"
,IN,AR,30326660,1005,100,,Invoice,,,,,,27/09/2018,27/09/2018,0.00,,19.12,,"-966,942.18"
,IN,AR,30326684,1005,100,,Invoice,,,,,,27/09/2018,27/09/2018,0.00,,8.47,,"-966,950.65"
,IN,AR,30326694,1005,100,,Invoice,,,,,,27/09/2018,27/09/2018,0.00,,28.43,,"-966,979.08"
,IN,AR,30326757,1005,100,,Invoice,,,,,,27/09/2018,27/09/2018,0.00,,5.17,,"-966,984.25"
,IN,AR,30326820,1005,100,,Invoice,,,,,,27/09/2018,27/09/2018,0.00,,33.05,,"-967,017.30"
,IN,AR,30326823,1005,100,,Invoice,,,,,,27/09/2018,27/09/2018,0.00,,25.00,,"-967,042.30"
,IN,AR,30326825,1005,100,,Invoice,,,,,,27/09/2018,27/09/2018,0.00,,3.01,,"-967,045.31"
,IN,AR,30326831,1005,100,,Invoice,,,,,,27/09/2018,27/09/2018,0.00,,4.96,,"-967,050.27"
,IN,AR,30326849,1005,100,,Invoice,,,,,,27/09/2018,27/09/2018,0.00,,12.03,,"-967,062.30"
,IN,AR,30326856,1005,100,,Invoice,,,,,,27/09/2018,27/09/2018,0.00,,10.59,,"-967,072.89"
,IN,AR,30326880,1005,100,,Invoice,,,,,,27/09/2018,27/09/2018,0.00,,21.97,,"-967,094.86"
,IN,AR,30326890,1005,100,,Invoice,,,,,,27/09/2018,27/09/2018,0.00,,7.29,,"-967,102.15"
,IN,AR,30326893,1005,100,,Invoice,,,,,,27/09/2018,27/09/2018,0.00,,10.59,,"-967,112.74"
,IN,AR,30326899,1005,100,,Invoice,,,,,,27/09/2018,27/09/2018,0.00,,62.29,,"-967,175.03"
,IN,AR,30326927,1005,100,,Invoice,,,,,,27/09/2018,27/09/2018,0.00,,29.15,,"-967,204.18"
,IN,AR,30326945,1005,100,,Invoice,,,,,,27/09/2018,27/09/2018,0.00,,9.29,,"-967,213.47"
,IN,AR,30326948,1005,100,,Invoice,,,,,,27/09/2018,27/09/2018,0.00,,8.77,,"-967,222.24"
,IN,AR,30326949,1005,100,,Invoice,,,,,,27/09/2018,27/09/2018,0.00,,21.86,,"-967,244.10"
,IN,AR,30326953,1005,100,,Invoice,,,,,,27/09/2018,27/09/2018,0.00,,7.29,,"-967,251.39"
,IN,AR,30326955,1005,100,,Invoice,,,,,,27/09/2018,27/09/2018,0.00,,22.03,,"-967,273.42"
,IN,AR,30326966,1005,100,,Invoice,,,,,,27/09/2018,27/09/2018,0.00,,11.36,,"-967,284.78"
,IN,AR,30326976,1005,100,,Invoice,,,,,,27/09/2018,27/09/2018,0.00,,42.12,,"-967,326.90"
,IN,AR,30326979,1005,100,,Invoice,,,,,,27/09/2018,27/09/2018,0.00,,14.58,,"-967,341.48"
,IN,AR,30326990,1005,100,,Invoice,,,,,,27/09/2018,27/09/2018,0.00,,5.08,,"-967,346.56"
,IN,AR,30326994,1005,100,,Invoice,,,,,,27/09/2018,27/09/2018,0.00,,28.39,,"-967,374.95"
,IN,AR,30326998,1005,100,,Invoice,,,,,,27/09/2018,27/09/2018,0.00,,48.14,,"-967,423.09"
,IN,AR,30327000,1005,100,,Invoice,,,,,,27/09/2018,27/09/2018,0.00,,6.00,,"-967,429.09"
,IN,AR,30327001,1005,100,,Invoice,,,,,,27/09/2018,27/09/2018,0.00,,13.14,,"-967,442.23"
,IN,AR,30327015,1005,100,,Invoice,,,,,,27/09/2018,27/09/2018,0.00,,7.05,,"-967,449.28"
,IN,AR,30327016,1005,100,,Invoice,,,,,,27/09/2018,27/09/2018,0.00,,1.76,,"-967,451.04"
,IN,AR,30327030,1005,100,,Invoice,,,,,,27/09/2018,27/09/2018,0.00,,5.49,,"-967,456.53"
,IN,AR,30327034,1005,100,,Invoice,,,,,,27/09/2018,27/09/2018,0.00,,30.11,,"-967,486.64"
,IN,AR,30327063,1005,100,,Invoice,,,,,,27/09/2018,27/09/2018,0.00,,6.53,,"-967,493.17"
,IN,AR,30327080,1005,100,,Invoice,,,,,,27/09/2018,27/09/2018,0.00,,5.17,,"-967,498.34"
,IN,AR,30327089,1005,100,,Invoice,,,,,,27/09/2018,27/09/2018,0.00,,18.22,,"-967,516.56"
,IN,AR,30327096,1005,100,,Invoice,,,,,,27/09/2018,27/09/2018,0.00,,11.95,,"-967,528.51"
,IN,AR,30327097,1005,100,,Invoice,,,,,,27/09/2018,27/09/2018,0.00,,17.92,,"-967,546.43"
,IN,AR,30327110,1005,100,,Invoice,,,,,,27/09/2018,27/09/2018,0.00,,19.92,,"-967,566.35"
,IN,AR,30327143,1005,100,,Invoice,,,,,,27/09/2018,27/09/2018,0.00,,54.66,,"-967,621.01"
,IN,AR,30327145,1005,100,,Invoice,,,,,,27/09/2018,27/09/2018,0.00,,7.29,,"-967,628.30"
,IN,AR,30327185,1005,100,,Invoice,,,,,,27/09/2018,27/09/2018,0.00,,3.64,,"-967,631.94"
,IN,AR,30327194,1005,100,,Invoice,,,,,,27/09/2018,27/09/2018,0.00,,11.86,,"-967,643.80"
,IN,AR,30327202,1005,100,,Invoice,,,,,,27/09/2018,27/09/2018,0.00,,33.05,,"-967,676.85"
,IN,AR,30327205,1005,100,,Invoice,,,,,,27/09/2018,27/09/2018,0.00,,20.01,,"-967,696.86"
,IN,AR,30327212,1005,100,,Invoice,,,,,,27/09/2018,27/09/2018,0.00,,20.01,,"-967,716.87"
,IN,AR,30327225,1005,100,,Invoice,,,,,,27/09/2018,27/09/2018,0.00,,11.66,,"-967,728.53"
,IN,AR,30327226,1005,100,,Invoice,,,,,,27/09/2018,27/09/2018,0.00,,23.32,,"-967,751.85"
,IN,AR,30327239,1005,100,,Invoice,,,,,,27/09/2018,27/09/2018,0.00,,18.22,,"-967,770.07"
,IN,AR,30327262,1005,100,,Invoice,,,,,,27/09/2018,27/09/2018,0.00,,21.86,,"-967,791.93"
,IN,AR,30327276,1005,100,,Invoice,,,,,,27/09/2018,27/09/2018,0.00,,16.83,,"-967,808.76"
,IN,AR,30327282,1005,100,,Invoice,,,,,,27/09/2018,27/09/2018,0.00,,38.90,,"-967,847.66"
,IN,AR,30327293,1005,100,,Invoice,,,,,,27/09/2018,27/09/2018,0.00,,18.20,,"-967,865.86"
,IN,AR,30327332,1005,100,,Invoice,,,,,,27/09/2018,27/09/2018,0.00,,121.73,,"-967,987.59"
,IN,AR,30327344,1005,100,,Invoice,,,,,,27/09/2018,27/09/2018,0.00,,7.97,,"-967,995.56"
,IN,AR,30327345,1005,100,,Invoice,,,,,,27/09/2018,27/09/2018,0.00,,111.53,,"-968,107.09"
,IN,AR,30327346,1005,100,,Invoice,,,,,,27/09/2018,27/09/2018,0.00,,6.37,,"-968,113.46"
,IN,AR,30327347,1005,100,,Invoice,,,,,,27/09/2018,27/09/2018,0.00,,9.56,,"-968,123.02"
,IN,AR,30327348,1005,100,,Invoice,,,,,,27/09/2018,27/09/2018,0.00,,6.37,,"-968,129.39"
,IN,AR,30327349,1005,100,,Invoice,,,,,,27/09/2018,27/09/2018,0.00,,19.12,,"-968,148.51"
,IN,AR,30327391,1005,100,,Invoice,,,,,,27/09/2018,27/09/2018,0.00,,28.47,,"-968,176.98"
,IN,AR,30327413,1005,100,,Invoice,,,,,,27/09/2018,27/09/2018,0.00,,20.34,,"-968,197.32"
,IN,AR,30327494,1005,100,,Invoice,,,,,,27/09/2018,27/09/2018,0.00,,15.71,,"-968,213.03"
,IN,AR,30327505,1005,100,,Invoice,,,,,,27/09/2018,27/09/2018,0.00,,18.22,,"-968,231.25"
,IN,AR,30327536,1005,100,,Invoice,,,,,,27/09/2018,27/09/2018,0.00,,7.25,,"-968,238.50"
,IN,AR,30327542,1005,100,,Invoice,,,,,,27/09/2018,27/09/2018,0.00,,14.58,,"-968,253.08"
,IN,AR,30327574,1005,100,,Invoice,,,,,,27/09/2018,27/09/2018,0.00,,4.15,,"-968,257.23"
,IN,AR,30327575,1005,100,,Invoice,,,,,,27/09/2018,27/09/2018,0.00,,4.15,,"-968,261.38"
,IN,AR,30327576,1005,100,,Invoice,,,,,,27/09/2018,27/09/2018,0.00,,31.14,,"-968,292.52"
,IN,AR,30327626,1005,100,,Invoice,,,,,,27/09/2018,27/09/2018,0.00,,37.85,,"-968,330.37"
,IN,AR,30327646,1005,100,,Invoice,,,,,,27/09/2018,27/09/2018,0.00,,24.27,,"-968,354.64"
,IN,AR,30327658,1005,100,,Invoice,,,,,,27/09/2018,27/09/2018,0.00,,3.64,,"-968,358.28"
,IN,AR,30327661,1005,100,,Invoice,,,,,,27/09/2018,27/09/2018,0.00,,7.29,,"-968,365.57"
,IN,AR,30327672,1005,100,,Invoice,,,,,,27/09/2018,27/09/2018,0.00,,8.77,,"-968,374.34"
,IN,AR,30327677,1005,100,,Invoice,,,,,,27/09/2018,27/09/2018,0.00,,54.66,,"-968,429.00"
,IN,AR,30327695,1005,100,,Invoice,,,,,,27/09/2018,27/09/2018,0.00,,29.15,,"-968,458.15"
,IN,AR,30327696,1005,100,,Invoice,,,,,,27/09/2018,27/09/2018,0.00,,364.41,,"-968,822.56"
,CN,AR,31019059,1005,100,,Credit Note,,,,,,28/09/2018,28/09/2018,11.95,,0.00,,"-968,810.61"
,CN,AR,31019093,1005,100,,Credit Note,,,,,,28/09/2018,28/09/2018,8.47,,0.00,,"-968,802.14"
,CR,AR,33000274,1005,100,,Cash Return,,,,,,28/09/2018,28/09/2018,13.98,,0.00,,"-968,788.16"
,CS,AR,32008898,1005,100,,Cash sale,,,,,,28/09/2018,28/09/2018,0.00,,15.04,,"-968,803.20"
,CS,AR,32008903,1005,100,,Cash sale,,,,,,28/09/2018,28/09/2018,0.00,,14.03,,"-968,817.23"
,CS,AR,32008910,1005,100,,Cash sale,,,,,,28/09/2018,28/09/2018,0.00,,11.86,,"-968,829.09"
,CS,AR,32008933,1005,100,,Cash sale,,,,,,28/09/2018,28/09/2018,0.00,,7.29,,"-968,836.38"
,CS,AR,32008951,1005,100,,Cash sale,,,,,,28/09/2018,28/09/2018,0.00,,9.66,,"-968,846.04"
,CS,AR,32008962,1005,100,,Cash sale,,,,,,28/09/2018,28/09/2018,0.00,,14.58,,"-968,860.62"
,CS,AR,32008966,1005,100,,Cash sale,,,,,,28/09/2018,28/09/2018,0.00,,16.61,,"-968,877.23"
,CS,AR,32008972,1005,100,,Cash sale,,,,,,28/09/2018,28/09/2018,0.00,,3.64,,"-968,880.87"
,CS,AR,32008982,1005,100,,Cash sale,,,,,,28/09/2018,28/09/2018,0.00,,11.68,,"-968,892.55"
,CS,AR,32008985,1005,100,,Cash sale,,,,,,28/09/2018,28/09/2018,0.00,,3.64,,"-968,896.19"
,CS,AR,32008986,1005,100,,Cash sale,,,,,,28/09/2018,28/09/2018,0.00,,7.29,,"-968,903.48"
,CS,AR,32009000,1005,100,,Cash sale,,,,,,28/09/2018,28/09/2018,0.00,,25.87,,"-968,929.35"
,CS,AR,32009007,1005,100,,Cash sale,,,,,,28/09/2018,28/09/2018,0.00,,3.64,,"-968,932.99"
,CS,AR,32009022,1005,100,,Cash sale,,,,,,28/09/2018,28/09/2018,0.00,,12.92,,"-968,945.91"
,CS,AR,32009031,1005,100,,Cash sale,,,,,,28/09/2018,28/09/2018,0.00,,7.29,,"-968,953.20"
,CS,AR,32009037,1005,100,,Cash sale,,,,,,28/09/2018,28/09/2018,0.00,,21.86,,"-968,975.06"
,CS,AR,32009039,1005,100,,Cash sale,,,,,,28/09/2018,28/09/2018,0.00,,2.58,,"-968,977.64"
,CS,AR,32009044,1005,100,,Cash sale,,,,,,28/09/2018,28/09/2018,0.00,,17.80,,"-968,995.44"
,CS,AR,32009053,1005,100,,Cash sale,,,,,,28/09/2018,28/09/2018,0.00,,3.64,,"-968,999.08"
,CS,AR,32009058,1005,100,,Cash sale,,,,,,28/09/2018,28/09/2018,0.00,,71.44,,"-969,070.52"
,CS,AR,32009066,1005,100,,Cash sale,,,,,,28/09/2018,28/09/2018,0.00,,21.98,,"-969,092.50"
,CS,AR,32009073,1005,100,,Cash sale,,,,,,28/09/2018,28/09/2018,0.00,,10.93,,"-969,103.43"
,CS,AR,32009094,1005,100,,Cash sale,,,,,,28/09/2018,28/09/2018,0.00,,10.17,,"-969,113.60"
,CS,AR,32009101,1005,100,,Cash sale,,,,,,28/09/2018,28/09/2018,0.00,,29.24,,"-969,142.84"
,CS,AR,32009112,1005,100,,Cash sale,,,,,,28/09/2018,28/09/2018,0.00,,27.08,,"-969,169.92"
,CS,AR,32009117,1005,100,,Cash sale,,,,,,28/09/2018,28/09/2018,0.00,,15.25,,"-969,185.17"
,CS,AR,32009132,1005,100,,Cash sale,,,,,,28/09/2018,28/09/2018,0.00,,25.42,,"-969,210.59"
,CS,AR,32009134,1005,100,,Cash sale,,,,,,28/09/2018,28/09/2018,0.00,,21.86,,"-969,232.45"
,CS,AR,32009168,1005,100,,Cash sale,,,,,,28/09/2018,28/09/2018,0.00,,36.44,,"-969,268.89"
,CS,AR,32009176,1005,100,,Cash sale,,,,,,28/09/2018,28/09/2018,0.00,,18.22,,"-969,287.11"
,CS,AR,32009186,1005,100,,Cash sale,,,,,,28/09/2018,28/09/2018,0.00,,23.41,,"-969,310.52"
,CS,AR,32009202,1005,100,,Cash sale,,,,,,28/09/2018,28/09/2018,0.00,,5.17,,"-969,315.69"
,CS,AR,32009238,1005,100,,Cash sale,,,,,,28/09/2018,28/09/2018,0.00,,15.25,,"-969,330.94"
,CS,AR,32009240,1005,100,,Cash sale,,,,,,28/09/2018,28/09/2018,0.00,,3.01,,"-969,333.95"
,CS,AR,32009249,1005,100,,Cash sale,,,,,,28/09/2018,28/09/2018,0.00,,7.29,,"-969,341.24"
,CS,AR,32009267,1005,100,,Cash sale,,,,,,28/09/2018,28/09/2018,0.00,,5.08,,"-969,346.32"
,CS,AR,32009275,1005,100,,Cash sale,,,,,,28/09/2018,28/09/2018,0.00,,9.15,,"-969,355.47"
,CS,AR,32009276,1005,100,,Cash sale,,,,,,28/09/2018,28/09/2018,0.00,,29.15,,"-969,384.62"
,CS,AR,32009290,1005,100,,Cash sale,,,,,,28/09/2018,28/09/2018,0.00,,7.29,,"-969,391.91"
,CS,AR,32009292,1005,100,,Cash sale,,,,,,28/09/2018,28/09/2018,0.00,,7.29,,"-969,399.20"
,CS,AR,32009308,1005,100,,Cash sale,,,,,,28/09/2018,28/09/2018,0.00,,15.18,,"-969,414.38"
,CS,AR,32009312,1005,100,,Cash sale,,,,,,28/09/2018,28/09/2018,0.00,,3.64,,"-969,418.02"
,CS,AR,32009321,1005,100,,Cash sale,,,,,,28/09/2018,28/09/2018,0.00,,18.22,,"-969,436.24"
,CS,AR,32009324,1005,100,,Cash sale,,,,,,28/09/2018,28/09/2018,0.00,,3.64,,"-969,439.88"
,CS,AR,32009329,1005,100,,Cash sale,,,,,,28/09/2018,28/09/2018,0.00,,6.07,,"-969,445.95"
,CS,AR,32009331,1005,100,,Cash sale,,,,,,28/09/2018,28/09/2018,0.00,,9.15,,"-969,455.10"
,CS,AR,32009338,1005,100,,Cash sale,,,,,,28/09/2018,28/09/2018,0.00,,12.17,,"-969,467.27"
,CS,AR,32009356,1005,100,,Cash sale,,,,,,28/09/2018,28/09/2018,0.00,,14.58,,"-969,481.85"
,CS,AR,32009362,1005,100,,Cash sale,,,,,,28/09/2018,28/09/2018,0.00,,9.84,,"-969,491.69"
,CS,AR,32009371,1005,100,,Cash sale,,,,,,28/09/2018,28/09/2018,0.00,,3.01,,"-969,494.70"
,CS,AR,32009374,1005,100,,Cash sale,,,,,,28/09/2018,28/09/2018,0.00,,7.29,,"-969,501.99"
,CS,AR,32009380,1005,100,,Cash sale,,,,,,28/09/2018,28/09/2018,0.00,,7.29,,"-969,509.28"
,CS,AR,32009412,1005,100,,Cash sale,,,,,,28/09/2018,28/09/2018,0.00,,7.29,,"-969,516.57"
,CS,AR,32009413,1005,100,,Cash sale,,,,,,28/09/2018,28/09/2018,0.00,,7.29,,"-969,523.86"
,CS,AR,32009421,1005,100,,Cash sale,,,,,,28/09/2018,28/09/2018,0.00,,7.29,,"-969,531.15"
,CS,AR,32009423,1005,100,,Cash sale,,,,,,28/09/2018,28/09/2018,0.00,,14.58,,"-969,545.73"
,CS,AR,32009431,1005,100,,Cash sale,,,,,,28/09/2018,28/09/2018,0.00,,7.29,,"-969,553.02"
,CS,AR,32009443,1005,100,,Cash sale,,,,,,28/09/2018,28/09/2018,0.00,,65.59,,"-969,618.61"
,IN,AR,30326274,1005,100,,Invoice,,,,,,28/09/2018,28/09/2018,0.00,,5.93,,"-969,624.54"
,IN,AR,30326277,1005,100,,Invoice,,,,,,28/09/2018,28/09/2018,0.00,,21.86,,"-969,646.40"
,IN,AR,30326278,1005,100,,Invoice,,,,,,28/09/2018,28/09/2018,0.00,,3.64,,"-969,650.04"
,IN,AR,30326279,1005,100,,Invoice,,,,,,28/09/2018,28/09/2018,0.00,,364.41,,"-970,014.45"
,IN,AR,30326288,1005,100,,Invoice,,,,,,28/09/2018,28/09/2018,0.00,,364.41,,"-970,378.86"
,IN,AR,30326291,1005,100,,Invoice,,,,,,28/09/2018,28/09/2018,0.00,,19.58,,"-970,398.44"
,IN,AR,30326321,1005,100,,Invoice,,,,,,28/09/2018,28/09/2018,0.00,,14.58,,"-970,413.02"
,IN,AR,30326327,1005,100,,Invoice,,,,,,28/09/2018,28/09/2018,0.00,,3.04,,"-970,416.06"
,IN,AR,30326340,1005,100,,Invoice,,,,,,28/09/2018,28/09/2018,0.00,,9.66,,"-970,425.72"
,IN,AR,30326348,1005,100,,Invoice,,,,,,28/09/2018,28/09/2018,0.00,,182.20,,"-970,607.92"
,IN,AR,30326352,1005,100,,Invoice,,,,,,28/09/2018,28/09/2018,0.00,,42.27,,"-970,650.19"
,IN,AR,30326353,1005,100,,Invoice,,,,,,28/09/2018,28/09/2018,0.00,,182.20,,"-970,832.39"
,IN,AR,30326362,1005,100,,Invoice,,,,,,28/09/2018,28/09/2018,0.00,,9.19,,"-970,841.58"
,IN,AR,30326365,1005,100,,Invoice,,,,,,28/09/2018,28/09/2018,0.00,,110.62,,"-970,952.20"
,IN,AR,30326384,1005,100,,Invoice,,,,,,28/09/2018,28/09/2018,0.00,,106.78,,"-971,058.98"
,IN,AR,30326397,1005,100,,Invoice,,,,,,28/09/2018,28/09/2018,0.00,,10.93,,"-971,069.91"
,IN,AR,30326403,1005,100,,Invoice,,,,,,28/09/2018,28/09/2018,0.00,,14.58,,"-971,084.49"
,IN,AR,30326417,1005,100,,Invoice,,,,,,28/09/2018,28/09/2018,0.00,,182.20,,"-971,266.69"
,IN,AR,30326418,1005,100,,Invoice,,,,,,28/09/2018,28/09/2018,0.00,,"1,093.22",,"-972,359.91"
,IN,AR,30326421,1005,100,,Invoice,,,,,,28/09/2018,28/09/2018,0.00,,10.93,,"-972,370.84"
,IN,AR,30326437,1005,100,,Invoice,,,,,,28/09/2018,28/09/2018,0.00,,34.00,,"-972,404.84"
,IN,AR,30326448,1005,100,,Invoice,,,,,,28/09/2018,28/09/2018,0.00,,364.41,,"-972,769.25"
,IN,AR,30326461,1005,100,,Invoice,,,,,,28/09/2018,28/09/2018,0.00,,94.92,,"-972,864.17"
,IN,AR,30326462,1005,100,,Invoice,,,,,,28/09/2018,28/09/2018,0.00,,4.75,,"-972,868.92"
,IN,AR,30326491,1005,100,,Invoice,,,,,,28/09/2018,28/09/2018,0.00,,5.82,,"-972,874.74"
,IN,AR,30326492,1005,100,,Invoice,,,,,,28/09/2018,28/09/2018,0.00,,3.88,,"-972,878.62"
,IN,AR,30326499,1005,100,,Invoice,,,,,,28/09/2018,28/09/2018,0.00,,34.00,,"-972,912.62"
,IN,AR,30326501,1005,100,,Invoice,,,,,,28/09/2018,28/09/2018,0.00,,3.64,,"-972,916.26"
,IN,AR,30326507,1005,100,,Invoice,,,,,,28/09/2018,28/09/2018,0.00,,29.15,,"-972,945.41"
,IN,AR,30326526,1005,100,,Invoice,,,,,,28/09/2018,28/09/2018,0.00,,182.20,,"-973,127.61"
,IN,AR,30326529,1005,100,,Invoice,,,,,,28/09/2018,28/09/2018,0.00,,364.41,,"-973,492.02"
,IN,AR,30326532,1005,100,,Invoice,,,,,,28/09/2018,28/09/2018,0.00,,15.93,,"-973,507.95"
,IN,AR,30326542,1005,100,,Invoice,,,,,,28/09/2018,28/09/2018,0.00,,7.75,,"-973,515.70"
,IN,AR,30326561,1005,100,,Invoice,,,,,,28/09/2018,28/09/2018,0.00,,18.22,,"-973,533.92"
,IN,AR,30326574,1005,100,,Invoice,,,,,,28/09/2018,28/09/2018,0.00,,12.03,,"-973,545.95"
,IN,AR,30326602,1005,100,,Invoice,,,,,,28/09/2018,28/09/2018,0.00,,23.26,,"-973,569.21"
,IN,AR,30326605,1005,100,,Invoice,,,,,,28/09/2018,28/09/2018,0.00,,4.78,,"-973,573.99"
,IN,AR,30326616,1005,100,,Invoice,,,,,,28/09/2018,28/09/2018,0.00,,5.18,,"-973,579.17"
,IN,AR,30326627,1005,100,,Invoice,,,,,,28/09/2018,28/09/2018,0.00,,6.02,,"-973,585.19"
,IN,AR,30326644,1005,100,,Invoice,,,,,,28/09/2018,28/09/2018,0.00,,63.58,,"-973,648.77"
,IN,AR,30326665,1005,100,,Invoice,,,,,,28/09/2018,28/09/2018,0.00,,12.88,,"-973,661.65"
,IN,AR,30326667,1005,100,,Invoice,,,,,,28/09/2018,28/09/2018,0.00,,22.54,,"-973,684.19"
,IN,AR,30326668,1005,100,,Invoice,,,,,,28/09/2018,28/09/2018,0.00,,74.07,,"-973,758.26"
,IN,AR,30326680,1005,100,,Invoice,,,,,,28/09/2018,28/09/2018,0.00,,6.02,,"-973,764.28"
,IN,AR,30326732,1005,100,,Invoice,,,,,,28/09/2018,28/09/2018,0.00,,54.66,,"-973,818.94"
,IN,AR,30326733,1005,100,,Invoice,,,,,,28/09/2018,28/09/2018,0.00,,7.17,,"-973,826.11"
,IN,AR,30326742,1005,100,,Invoice,,,,,,28/09/2018,28/09/2018,0.00,,12.71,,"-973,838.82"
,IN,AR,30326743,1005,100,,Invoice,,,,,,28/09/2018,28/09/2018,0.00,,5.08,,"-973,843.90"
,IN,AR,30326744,1005,100,,Invoice,,,,,,28/09/2018,28/09/2018,0.00,,2.54,,"-973,846.44"
,IN,AR,30326745,1005,100,,Invoice,,,,,,28/09/2018,28/09/2018,0.00,,12.71,,"-973,859.15"
,IN,AR,30326749,1005,100,,Invoice,,,,,,28/09/2018,28/09/2018,0.00,,5.08,,"-973,864.23"
,IN,AR,30326799,1005,100,,Invoice,,,,,,28/09/2018,28/09/2018,0.00,,17.80,,"-973,882.03"
,IN,AR,30326811,1005,100,,Invoice,,,,,,28/09/2018,28/09/2018,0.00,,8.39,,"-973,890.42"
,IN,AR,30326816,1005,100,,Invoice,,,,,,28/09/2018,28/09/2018,0.00,,7.29,,"-973,897.71"
,IN,AR,30326846,1005,100,,Invoice,,,,,,28/09/2018,28/09/2018,0.00,,3.64,,"-973,901.35"
,IN,AR,30326870,1005,100,,Invoice,,,,,,28/09/2018,28/09/2018,0.00,,18.22,,"-973,919.57"
,IN,AR,30326873,1005,100,,Invoice,,,,,,28/09/2018,28/09/2018,0.00,,7.29,,"-973,926.86"
,IN,AR,30326886,1005,100,,Invoice,,,,,,28/09/2018,28/09/2018,0.00,,25.25,,"-973,952.11"
,IN,AR,30326900,1005,100,,Invoice,,,,,,28/09/2018,28/09/2018,0.00,,10.93,,"-973,963.04"
,IN,AR,30326904,1005,100,,Invoice,,,,,,28/09/2018,28/09/2018,0.00,,756.08,,"-974,719.12"
,IN,AR,30326916,1005,100,,Invoice,,,,,,28/09/2018,28/09/2018,0.00,,7.29,,"-974,726.41"
,IN,AR,30326919,1005,100,,Invoice,,,,,,28/09/2018,28/09/2018,0.00,,4.24,,"-974,730.65"
,IN,AR,30326932,1005,100,,Invoice,,,,,,28/09/2018,28/09/2018,0.00,,10.17,,"-974,740.82"
,IN,AR,30326933,1005,100,,Invoice,,,,,,28/09/2018,28/09/2018,0.00,,10.85,,"-974,751.67"
,IN,AR,30326946,1005,100,,Invoice,,,,,,28/09/2018,28/09/2018,0.00,,364.41,,"-975,116.08"
,IN,AR,30326963,1005,100,,Invoice,,,,,,28/09/2018,28/09/2018,0.00,,5.17,,"-975,121.25"
,IN,AR,30326964,1005,100,,Invoice,,,,,,28/09/2018,28/09/2018,0.00,,7.29,,"-975,128.54"
,IN,AR,30326978,1005,100,,Invoice,,,,,,28/09/2018,28/09/2018,0.00,,21.06,,"-975,149.60"
,IN,AR,30326982,1005,100,,Invoice,,,,,,28/09/2018,28/09/2018,0.00,,10.99,,"-975,160.59"
,IN,AR,30326988,1005,100,,Invoice,,,,,,28/09/2018,28/09/2018,0.00,,17.47,,"-975,178.06"
,IN,AR,30327006,1005,100,,Invoice,,,,,,28/09/2018,28/09/2018,0.00,,10.93,,"-975,188.99"
,IN,AR,30327017,1005,100,,Invoice,,,,,,28/09/2018,28/09/2018,0.00,,3.53,,"-975,192.52"
,IN,AR,30327027,1005,100,,Invoice,,,,,,28/09/2018,28/09/2018,0.00,,4.85,,"-975,197.37"
,IN,AR,30327028,1005,100,,Invoice,,,,,,28/09/2018,28/09/2018,0.00,,10.68,,"-975,208.05"
,IN,AR,30327041,1005,100,,Invoice,,,,,,28/09/2018,28/09/2018,0.00,,29.15,,"-975,237.20"
,IN,AR,30327044,1005,100,,Invoice,,,,,,28/09/2018,28/09/2018,0.00,,14.58,,"-975,251.78"
,IN,AR,30327056,1005,100,,Invoice,,,,,,28/09/2018,28/09/2018,0.00,,54.66,,"-975,306.44"
,IN,AR,30327064,1005,100,,Invoice,,,,,,28/09/2018,28/09/2018,0.00,,54.66,,"-975,361.10"
,IN,AR,30327085,1005,100,,Invoice,,,,,,28/09/2018,28/09/2018,0.00,,14.58,,"-975,375.68"
,IN,AR,30327098,1005,100,,Invoice,,,,,,28/09/2018,28/09/2018,0.00,,7.97,,"-975,383.65"
,IN,AR,30327099,1005,100,,Invoice,,,,,,28/09/2018,28/09/2018,0.00,,33.86,,"-975,417.51"
,IN,AR,30327100,1005,100,,Invoice,,,,,,28/09/2018,28/09/2018,0.00,,11.95,,"-975,429.46"
,IN,AR,30327111,1005,100,,Invoice,,,,,,28/09/2018,28/09/2018,0.00,,27.88,,"-975,457.34"
,IN,AR,30327119,1005,100,,Invoice,,,,,,28/09/2018,28/09/2018,0.00,,34.07,,"-975,491.41"
,IN,AR,30327126,1005,100,,Invoice,,,,,,28/09/2018,28/09/2018,0.00,,34.04,,"-975,525.45"
,IN,AR,30327135,1005,100,,Invoice,,,,,,28/09/2018,28/09/2018,0.00,,28.06,,"-975,553.51"
,IN,AR,30327154,1005,100,,Invoice,,,,,,28/09/2018,28/09/2018,0.00,,8.64,,"-975,562.15"
,IN,AR,30327160,1005,100,,Invoice,,,,,,28/09/2018,28/09/2018,0.00,,28.03,,"-975,590.18"
,IN,AR,30327162,1005,100,,Invoice,,,,,,28/09/2018,28/09/2018,0.00,,10.93,,"-975,601.11"
,IN,AR,30327166,1005,100,,Invoice,,,,,,28/09/2018,28/09/2018,0.00,,42.03,,"-975,643.14"
,IN,AR,30327171,1005,100,,Invoice,,,,,,28/09/2018,28/09/2018,0.00,,2.54,,"-975,645.68"
,IN,AR,30327175,1005,100,,Invoice,,,,,,28/09/2018,28/09/2018,0.00,,6.56,,"-975,652.24"
,IN,AR,30327182,1005,100,,Invoice,,,,,,28/09/2018,28/09/2018,0.00,,182.20,,"-975,834.44"
,IN,AR,30327189,1005,100,,Invoice,,,,,,28/09/2018,28/09/2018,0.00,,23.91,,"-975,858.35"
,IN,AR,30327203,1005,100,,Invoice,,,,,,28/09/2018,28/09/2018,0.00,,22.88,,"-975,881.23"
,IN,AR,30327208,1005,100,,Invoice,,,,,,28/09/2018,28/09/2018,0.00,,8.00,,"-975,889.23"
,IN,AR,30327213,1005,100,,Invoice,,,,,,28/09/2018,28/09/2018,0.00,,8.00,,"-975,897.23"
,IN,AR,30327218,1005,100,,Invoice,,,,,,28/09/2018,28/09/2018,0.00,,114.19,,"-976,011.42"
,IN,AR,30327236,1005,100,,Invoice,,,,,,28/09/2018,28/09/2018,0.00,,51.29,,"-976,062.71"
,IN,AR,30327244,1005,100,,Invoice,,,,,,28/09/2018,28/09/2018,0.00,,43.80,,"-976,106.51"
,IN,AR,30327253,1005,100,,Invoice,,,,,,28/09/2018,28/09/2018,0.00,,29.44,,"-976,135.95"
,IN,AR,30327254,1005,100,,Invoice,,,,,,28/09/2018,28/09/2018,0.00,,182.20,,"-976,318.15"
,IN,AR,30327259,1005,100,,Invoice,,,,,,28/09/2018,28/09/2018,0.00,,6.99,,"-976,325.14"
,IN,AR,30327261,1005,100,,Invoice,,,,,,28/09/2018,28/09/2018,0.00,,26.24,,"-976,351.38"
,IN,AR,30327267,1005,100,,Invoice,,,,,,28/09/2018,28/09/2018,0.00,,37.29,,"-976,388.67"
,IN,AR,30327278,1005,100,,Invoice,,,,,,28/09/2018,28/09/2018,0.00,,13.78,,"-976,402.45"
,IN,AR,30327286,1005,100,,Invoice,,,,,,28/09/2018,28/09/2018,0.00,,29.15,,"-976,431.60"
,IN,AR,30327287,1005,100,,Invoice,,,,,,28/09/2018,28/09/2018,0.00,,13.98,,"-976,445.58"
,IN,AR,30327296,1005,100,,Invoice,,,,,,28/09/2018,28/09/2018,0.00,,12.46,,"-976,458.04"
,IN,AR,30327314,1005,100,,Invoice,,,,,,28/09/2018,28/09/2018,0.00,,182.20,,"-976,640.24"
,IN,AR,30327325,1005,100,,Invoice,,,,,,28/09/2018,28/09/2018,0.00,,11.36,,"-976,651.60"
,IN,AR,30327327,1005,100,,Invoice,,,,,,28/09/2018,28/09/2018,0.00,,9.66,,"-976,661.26"
,IN,AR,30327329,1005,100,,Invoice,,,,,,28/09/2018,28/09/2018,0.00,,20.41,,"-976,681.67"
,IN,AR,30327350,1005,100,,Invoice,,,,,,28/09/2018,28/09/2018,0.00,,46.20,,"-976,727.87"
,IN,AR,30327422,1005,100,,Invoice,,,,,,28/09/2018,28/09/2018,0.00,,12.00,,"-976,739.87"
,IN,AR,30327451,1005,100,,Invoice,,,,,,28/09/2018,28/09/2018,0.00,,133.12,,"-976,872.99"
,IN,AR,30327459,1005,100,,Invoice,,,,,,28/09/2018,28/09/2018,0.00,,5.83,,"-976,878.82"
,IN,AR,30327465,1005,100,,Invoice,,,,,,28/09/2018,28/09/2018,0.00,,10.95,,"-976,889.77"
,IN,AR,30327469,1005,100,,Invoice,,,,,,28/09/2018,28/09/2018,0.00,,72.03,,"-976,961.80"
,IN,AR,30327478,1005,100,,Invoice,,,,,,28/09/2018,28/09/2018,0.00,,182.20,,"-977,144.00"
,IN,AR,30327480,1005,100,,Invoice,,,,,,28/09/2018,28/09/2018,0.00,,305.00,,"-977,449.00"
,IN,AR,30327481,1005,100,,Invoice,,,,,,28/09/2018,28/09/2018,0.00,,195.00,,"-977,644.00"
,IN,AR,30327482,1005,100,,Invoice,,,,,,28/09/2018,28/09/2018,0.00,,367.50,,"-978,011.50"
,IN,AR,30327485,1005,100,,Invoice,,,,,,28/09/2018,28/09/2018,0.00,,7.29,,"-978,018.79"
,IN,AR,30327502,1005,100,,Invoice,,,,,,28/09/2018,28/09/2018,0.00,,12.25,,"-978,031.04"
,IN,AR,30327503,1005,100,,Invoice,,,,,,28/09/2018,28/09/2018,0.00,,10.21,,"-978,041.25"
,IN,AR,30327514,1005,100,,Invoice,,,,,,28/09/2018,28/09/2018,0.00,,7.29,,"-978,048.54"
,IN,AR,30327539,1005,100,,Invoice,,,,,,28/09/2018,28/09/2018,0.00,,9.11,,"-978,057.65"
,IN,AR,30327577,1005,100,,Invoice,,,,,,28/09/2018,28/09/2018,0.00,,8.31,,"-978,065.96"
,IN,AR,30327578,1005,100,,Invoice,,,,,,28/09/2018,28/09/2018,0.00,,87.20,,"-978,153.16"
,IN,AR,30327593,1005,100,,Invoice,,,,,,28/09/2018,28/09/2018,0.00,,14.75,,"-978,167.91"
,IN,AR,30327595,1005,100,,Invoice,,,,,,28/09/2018,28/09/2018,0.00,,10.86,,"-978,178.77"
,IN,AR,30327615,1005,100,,Invoice,,,,,,28/09/2018,28/09/2018,0.00,,29.15,,"-978,207.92"
,IN,AR,30327619,1005,100,,Invoice,,,,,,28/09/2018,28/09/2018,0.00,,7.29,,"-978,215.21"
,IN,AR,30327621,1005,100,,Invoice,,,,,,28/09/2018,28/09/2018,0.00,,29.15,,"-978,244.36"
,IN,AR,30327631,1005,100,,Invoice,,,,,,28/09/2018,28/09/2018,0.00,,10.93,,"-978,255.29"
,IN,AR,30327632,1005,100,,Invoice,,,,,,28/09/2018,28/09/2018,0.00,,7.75,,"-978,263.04"
,IN,AR,30327698,1005,100,,Invoice,,,,,,28/09/2018,28/09/2018,0.00,,54.66,,"-978,317.70"
,CN,AR,31019086,1005,100,,Credit Note,,,,,,29/09/2018,29/09/2018,46.78,,0.00,,"-978,270.92"
,CS,AR,32008975,1005,100,,Cash sale,,,,,,29/09/2018,29/09/2018,0.00,,10.93,,"-978,281.85"
,CS,AR,32009118,1005,100,,Cash sale,,,,,,29/09/2018,29/09/2018,0.00,,54.66,,"-978,336.51"
,CS,AR,32009232,1005,100,,Cash sale,,,,,,29/09/2018,29/09/2018,0.00,,7.29,,"-978,343.80"
,CS,AR,32009257,1005,100,,Cash sale,,,,,,29/09/2018,29/09/2018,0.00,,3.64,,"-978,347.44"
,CS,AR,32009415,1005,100,,Cash sale,,,,,,29/09/2018,29/09/2018,0.00,,10.93,,"-978,358.37"
,IN,AR,30326275,1005,100,,Invoice,,,,,,29/09/2018,29/09/2018,0.00,,41.53,,"-978,399.90"
,IN,AR,30326287,1005,100,,Invoice,,,,,,29/09/2018,29/09/2018,0.00,,364.41,,"-978,764.31"
,IN,AR,30326289,1005,100,,Invoice,,,,,,29/09/2018,29/09/2018,0.00,,364.41,,"-979,128.72"
,IN,AR,30326294,1005,100,,Invoice,,,,,,29/09/2018,29/09/2018,0.00,,182.20,,"-979,310.92"
,IN,AR,30326333,1005,100,,Invoice,,,,,,29/09/2018,29/09/2018,0.00,,9.03,,"-979,319.95"
,IN,AR,30326346,1005,100,,Invoice,,,,,,29/09/2018,29/09/2018,0.00,,364.41,,"-979,684.36"
,IN,AR,30326354,1005,100,,Invoice,,,,,,29/09/2018,29/09/2018,0.00,,54.03,,"-979,738.39"
,IN,AR,30326357,1005,100,,Invoice,,,,,,29/09/2018,29/09/2018,0.00,,182.20,,"-979,920.59"
,IN,AR,30326385,1005,100,,Invoice,,,,,,29/09/2018,29/09/2018,0.00,,45.08,,"-979,965.67"
,IN,AR,30326468,1005,100,,Invoice,,,,,,29/09/2018,29/09/2018,0.00,,10.00,,"-979,975.67"
,IN,AR,30326494,1005,100,,Invoice,,,,,,29/09/2018,29/09/2018,0.00,,14.58,,"-979,990.25"
,IN,AR,30326541,1005,100,,Invoice,,,,,,29/09/2018,29/09/2018,0.00,,54.66,,"-980,044.91"
,IN,AR,30326563,1005,100,,Invoice,,,,,,29/09/2018,29/09/2018,0.00,,"1,093.22",,"-981,138.13"
,IN,AR,30326635,1005,100,,Invoice,,,,,,29/09/2018,29/09/2018,0.00,,612.20,,"-981,750.33"
,IN,AR,30326692,1005,100,,Invoice,,,,,,29/09/2018,29/09/2018,0.00,,"1,093.22",,"-982,843.55"
,IN,AR,30326809,1005,100,,Invoice,,,,,,29/09/2018,29/09/2018,0.00,,7.75,,"-982,851.30"
,IN,AR,30326875,1005,100,,Invoice,,,,,,29/09/2018,29/09/2018,0.00,,54.66,,"-982,905.96"
,IN,AR,30326910,1005,100,,Invoice,,,,,,29/09/2018,29/09/2018,0.00,,"1,093.22",,"-983,999.18"
,IN,AR,30326983,1005,100,,Invoice,,,,,,29/09/2018,29/09/2018,0.00,,"1,093.22",,"-985,092.40"
,IN,AR,30327035,1005,100,,Invoice,,,,,,29/09/2018,29/09/2018,0.00,,364.41,,"-985,456.81"
,IN,AR,30327159,1005,100,,Invoice,,,,,,29/09/2018,29/09/2018,0.00,,10.93,,"-985,467.74"
,IN,AR,30327172,1005,100,,Invoice,,,,,,29/09/2018,29/09/2018,0.00,,54.66,,"-985,522.40"
,IN,AR,30327196,1005,100,,Invoice,,,,,,29/09/2018,29/09/2018,0.00,,14.58,,"-985,536.98"
,IN,AR,30327317,1005,100,,Invoice,,,,,,29/09/2018,29/09/2018,0.00,,29.15,,"-985,566.13"
,IN,AR,30327466,1005,100,,Invoice,,,,,,29/09/2018,29/09/2018,0.00,,29.15,,"-985,595.28"
,IN,AR,30327488,1005,100,,Invoice,,,,,,29/09/2018,29/09/2018,0.00,,40.08,,"-985,635.36"
,IN,AR,30327655,1005,100,,Invoice,,,,,,29/09/2018,29/09/2018,0.00,,7.29,,"-985,642.65"
,IN,AR,30327699,1005,100,,Invoice,,,,,,29/09/2018,29/09/2018,0.00,,29.15,,"-985,671.80"
,CN,AR,31019052,1005,100,,Credit Note,,,,,,30/09/2018,30/09/2018,550.41,,0.00,,"-985,121.39"
,CR,AR,33000280,1005,100,,Cash Return,,,,,,30/09/2018,30/09/2018,7.29,,0.00,,"-985,114.10"
,CS,AR,32009256,1005,100,,Cash sale,,,,,,30/09/2018,30/09/2018,0.00,,29.15,,"-985,143.25"
,CS,AR,32009344,1005,100,,Cash sale,,,,,,30/09/2018,30/09/2018,0.00,,182.20,,"-985,325.45"
,CS,AR,32009433,1005,100,,Cash sale,,,,,,30/09/2018,30/09/2018,0.00,,10.93,,"-985,336.38"
,IN,AR,30326323,1005,100,,Invoice,,,,,,30/09/2018,30/09/2018,0.00,,"1,623.89",,"-986,960.27"
,IN,AR,30326391,1005,100,,Invoice,,,,,,30/09/2018,30/09/2018,0.00,,"1,626.69",,"-988,586.96"
,IN,AR,30326463,1005,100,,Invoice,,,,,,30/09/2018,30/09/2018,0.00,,58.26,,"-988,645.22"
,IN,AR,30326520,1005,100,,Invoice,,,,,,30/09/2018,30/09/2018,0.00,,87.25,,"-988,732.47"
,IN,AR,30326568,1005,100,,Invoice,,,,,,30/09/2018,30/09/2018,0.00,,"1,410.41",,"-990,142.88"
,IN,AR,30326569,1005,100,,Invoice,,,,,,30/09/2018,30/09/2018,0.00,,59.64,,"-990,202.52"
,IN,AR,30326570,1005,100,,Invoice,,,,,,30/09/2018,30/09/2018,0.00,,15.79,,"-990,218.31"
,IN,AR,30326571,1005,100,,Invoice,,,,,,30/09/2018,30/09/2018,0.00,,82.45,,"-990,300.76"
,IN,AR,30326587,1005,100,,Invoice,,,,,,30/09/2018,30/09/2018,0.00,,288.14,,"-990,588.90"
,IN,AR,30326633,1005,100,,Invoice,,,,,,30/09/2018,30/09/2018,0.00,,"1,652.71",,"-992,241.61"
,IN,AR,30326672,1005,100,,Invoice,,,,,,30/09/2018,30/09/2018,0.00,,20.14,,"-992,261.75"
,IN,AR,30326673,1005,100,,Invoice,,,,,,30/09/2018,30/09/2018,0.00,,3.36,,"-992,265.11"
,IN,AR,30326674,1005,100,,Invoice,,,,,,30/09/2018,30/09/2018,0.00,,16.78,,"-992,281.89"
,IN,AR,30326675,1005,100,,Invoice,,,,,,30/09/2018,30/09/2018,0.00,,15.10,,"-992,296.99"
,IN,AR,30326676,1005,100,,Invoice,,,,,,30/09/2018,30/09/2018,0.00,,15.10,,"-992,312.09"
,IN,AR,30326702,1005,100,,Invoice,,,,,,30/09/2018,30/09/2018,0.00,,128.06,,"-992,440.15"
,IN,AR,30326704,1005,100,,Invoice,,,,,,30/09/2018,30/09/2018,0.00,,187.70,,"-992,627.85"
,IN,AR,30326707,1005,100,,Invoice,,,,,,30/09/2018,30/09/2018,0.00,,39.51,,"-992,667.36"
,IN,AR,30326708,1005,100,,Invoice,,,,,,30/09/2018,30/09/2018,0.00,,57.89,,"-992,725.25"
,IN,AR,30326709,1005,100,,Invoice,,,,,,30/09/2018,30/09/2018,0.00,,177.18,,"-992,902.43"
,IN,AR,30326710,1005,100,,Invoice,,,,,,30/09/2018,30/09/2018,0.00,,43.86,,"-992,946.29"
,IN,AR,30326711,1005,100,,Invoice,,,,,,30/09/2018,30/09/2018,0.00,,5.64,,"-992,951.93"
,IN,AR,30326712,1005,100,,Invoice,,,,,,30/09/2018,30/09/2018,0.00,,3.76,,"-992,955.69"
,IN,AR,30326713,1005,100,,Invoice,,,,,,30/09/2018,30/09/2018,0.00,,33.86,,"-992,989.55"
,IN,AR,30326714,1005,100,,Invoice,,,,,,30/09/2018,30/09/2018,0.00,,45.15,,"-993,034.70"
,IN,AR,30326715,1005,100,,Invoice,,,,,,30/09/2018,30/09/2018,0.00,,7.53,,"-993,042.23"
,IN,AR,30326716,1005,100,,Invoice,,,,,,30/09/2018,30/09/2018,0.00,,22.58,,"-993,064.81"
,IN,AR,30326717,1005,100,,Invoice,,,,,,30/09/2018,30/09/2018,0.00,,39.51,,"-993,104.32"
,IN,AR,30326718,1005,100,,Invoice,,,,,,30/09/2018,30/09/2018,0.00,,26.34,,"-993,130.66"
,IN,AR,30326719,1005,100,,Invoice,,,,,,30/09/2018,30/09/2018,0.00,,24.46,,"-993,155.12"
,IN,AR,30326720,1005,100,,Invoice,,,,,,30/09/2018,30/09/2018,0.00,,7.53,,"-993,162.65"
,IN,AR,30326721,1005,100,,Invoice,,,,,,30/09/2018,30/09/2018,0.00,,352.60,,"-993,515.25"
,IN,AR,30326722,1005,100,,Invoice,,,,,,30/09/2018,30/09/2018,0.00,,61.40,,"-993,576.65"
,IN,AR,30326723,1005,100,,Invoice,,,,,,30/09/2018,30/09/2018,0.00,,42.10,,"-993,618.75"
,IN,AR,30326724,1005,100,,Invoice,,,,,,30/09/2018,30/09/2018,0.00,,16.93,,"-993,635.68"
,IN,AR,30326725,1005,100,,Invoice,,,,,,30/09/2018,30/09/2018,0.00,,24.56,,"-993,660.24"
,IN,AR,30326726,1005,100,,Invoice,,,,,,30/09/2018,30/09/2018,0.00,,31.58,,"-993,691.82"
,IN,AR,30326728,1005,100,,Invoice,,,,,,30/09/2018,30/09/2018,0.00,,14.03,,"-993,705.85"
,IN,AR,30326729,1005,100,,Invoice,,,,,,30/09/2018,30/09/2018,0.00,,19.30,,"-993,725.15"
,IN,AR,30326730,1005,100,,Invoice,,,,,,30/09/2018,30/09/2018,0.00,,1.75,,"-993,726.90"
,IN,AR,30326731,1005,100,,Invoice,,,,,,30/09/2018,30/09/2018,0.00,,21.05,,"-993,747.95"
,IN,AR,30326734,1005,100,,Invoice,,,,,,30/09/2018,30/09/2018,0.00,,5.26,,"-993,753.21"
,IN,AR,30326746,1005,100,,Invoice,,,,,,30/09/2018,30/09/2018,0.00,,19.30,,"-993,772.51"
,IN,AR,30326755,1005,100,,Invoice,,,,,,30/09/2018,30/09/2018,0.00,,361.37,,"-994,133.88"
,IN,AR,30326764,1005,100,,Invoice,,,,,,30/09/2018,30/09/2018,0.00,,107.29,,"-994,241.17"
,IN,AR,30326765,1005,100,,Invoice,,,,,,30/09/2018,30/09/2018,0.00,,3.58,,"-994,244.75"
,IN,AR,30326766,1005,100,,Invoice,,,,,,30/09/2018,30/09/2018,0.00,,17.88,,"-994,262.63"
,IN,AR,30326767,1005,100,,Invoice,,,,,,30/09/2018,30/09/2018,0.00,,64.37,,"-994,327.00"
,IN,AR,30326768,1005,100,,Invoice,,,,,,30/09/2018,30/09/2018,0.00,,33.97,,"-994,360.97"
,IN,AR,30326769,1005,100,,Invoice,,,,,,30/09/2018,30/09/2018,0.00,,50.07,,"-994,411.04"
,IN,AR,30326770,1005,100,,Invoice,,,,,,30/09/2018,30/09/2018,0.00,,32.19,,"-994,443.23"
,IN,AR,30326771,1005,100,,Invoice,,,,,,30/09/2018,30/09/2018,0.00,,46.49,,"-994,489.72"
,IN,AR,30326772,1005,100,,Invoice,,,,,,30/09/2018,30/09/2018,0.00,,91.19,,"-994,580.91"
,IN,AR,30326773,1005,100,,Invoice,,,,,,30/09/2018,30/09/2018,0.00,,211.00,,"-994,791.91"
,IN,AR,30326774,1005,100,,Invoice,,,,,,30/09/2018,30/09/2018,0.00,,7.15,,"-994,799.06"
,IN,AR,30326775,1005,100,,Invoice,,,,,,30/09/2018,30/09/2018,0.00,,19.67,,"-994,818.73"
,IN,AR,30326776,1005,100,,Invoice,,,,,,30/09/2018,30/09/2018,0.00,,14.31,,"-994,833.04"
,IN,AR,30326778,1005,100,,Invoice,,,,,,30/09/2018,30/09/2018,0.00,,57.22,,"-994,890.26"
,IN,AR,30326779,1005,100,,Invoice,,,,,,30/09/2018,30/09/2018,0.00,,85.83,,"-994,976.09"
,IN,AR,30326780,1005,100,,Invoice,,,,,,30/09/2018,30/09/2018,0.00,,28.61,,"-995,004.70"
,IN,AR,30326781,1005,100,,Invoice,,,,,,30/09/2018,30/09/2018,0.00,,10.73,,"-995,015.43"
,IN,AR,30326782,1005,100,,Invoice,,,,,,30/09/2018,30/09/2018,0.00,,8.94,,"-995,024.37"
,IN,AR,30326783,1005,100,,Invoice,,,,,,30/09/2018,30/09/2018,0.00,,44.70,,"-995,069.07"
,IN,AR,30326784,1005,100,,Invoice,,,,,,30/09/2018,30/09/2018,0.00,,12.52,,"-995,081.59"
,IN,AR,30326785,1005,100,,Invoice,,,,,,30/09/2018,30/09/2018,0.00,,16.09,,"-995,097.68"
,IN,AR,30326786,1005,100,,Invoice,,,,,,30/09/2018,30/09/2018,0.00,,30.40,,"-995,128.08"
,IN,AR,30326787,1005,100,,Invoice,,,,,,30/09/2018,30/09/2018,0.00,,7.15,,"-995,135.23"
,IN,AR,30326788,1005,100,,Invoice,,,,,,30/09/2018,30/09/2018,0.00,,5.36,,"-995,140.59"
,IN,AR,30326789,1005,100,,Invoice,,,,,,30/09/2018,30/09/2018,0.00,,128.06,,"-995,268.65"
,IN,AR,30326790,1005,100,,Invoice,,,,,,30/09/2018,30/09/2018,0.00,,196.07,,"-995,464.72"
,IN,AR,30326791,1005,100,,Invoice,,,,,,30/09/2018,30/09/2018,0.00,,59.23,,"-995,523.95"
,IN,AR,30326792,1005,100,,Invoice,,,,,,30/09/2018,30/09/2018,0.00,,30.64,,"-995,554.59"
,IN,AR,30326793,1005,100,,Invoice,,,,,,30/09/2018,30/09/2018,0.00,,20.42,,"-995,575.01"
,IN,AR,30326794,1005,100,,Invoice,,,,,,30/09/2018,30/09/2018,0.00,,130.71,,"-995,705.72"
,IN,AR,30326795,1005,100,,Invoice,,,,,,30/09/2018,30/09/2018,0.00,,61.27,,"-995,766.99"
,IN,AR,30326796,1005,100,,Invoice,,,,,,30/09/2018,30/09/2018,0.00,,277.76,,"-996,044.75"
,IN,AR,30326797,1005,100,,Invoice,,,,,,30/09/2018,30/09/2018,0.00,,6.13,,"-996,050.88"
,IN,AR,30326861,1005,100,,Invoice,,,,,,30/09/2018,30/09/2018,0.00,,60.59,,"-996,111.47"
,IN,AR,30326903,1005,100,,Invoice,,,,,,30/09/2018,30/09/2018,0.00,,"1,236.99",,"-997,348.46"
,IN,AR,30326906,1005,100,,Invoice,,,,,,30/09/2018,30/09/2018,0.00,,436.27,,"-997,784.73"
,IN,AR,30326907,1005,100,,Invoice,,,,,,30/09/2018,30/09/2018,0.00,,63.76,,"-997,848.49"
,IN,AR,30326908,1005,100,,Invoice,,,,,,30/09/2018,30/09/2018,0.00,,31.58,,"-997,880.07"
,IN,AR,30326973,1005,100,,Invoice,,,,,,30/09/2018,30/09/2018,0.00,,87.96,,"-997,968.03"
,IN,AR,30326996,1005,100,,Invoice,,,,,,30/09/2018,30/09/2018,0.00,,166.10,,"-998,134.13"
,IN,AR,30327057,1005,100,,Invoice,,,,,,30/09/2018,30/09/2018,0.00,,550.41,,"-998,684.54"
,IN,AR,30327058,1005,100,,Invoice,,,,,,30/09/2018,30/09/2018,0.00,,748.37,,"-999,432.91"
,IN,AR,30327067,1005,100,,Invoice,,,,,,30/09/2018,30/09/2018,0.00,,69.92,,"-999,502.83"
,IN,AR,30327068,1005,100,,Invoice,,,,,,30/09/2018,30/09/2018,0.00,,23.31,,"-999,526.14"
,IN,AR,30327069,1005,100,,Invoice,,,,,,30/09/2018,30/09/2018,0.00,,51.27,,"-999,577.41"
,IN,AR,30327070,1005,100,,Invoice,,,,,,30/09/2018,30/09/2018,0.00,,16.31,,"-999,593.72"
,IN,AR,30327071,1005,100,,Invoice,,,,,,30/09/2018,30/09/2018,0.00,,46.61,,"-999,640.33"
,IN,AR,30327072,1005,100,,Invoice,,,,,,30/09/2018,30/09/2018,0.00,,72.25,,"-999,712.58"
,IN,AR,30327073,1005,100,,Invoice,,,,,,30/09/2018,30/09/2018,0.00,,34.96,,"-999,747.54"
,IN,AR,30327074,1005,100,,Invoice,,,,,,30/09/2018,30/09/2018,0.00,,37.29,,"-999,784.83"
,IN,AR,30327075,1005,100,,Invoice,,,,,,30/09/2018,30/09/2018,0.00,,30.30,,"-999,815.13"
,IN,AR,30327076,1005,100,,Invoice,,,,,,30/09/2018,30/09/2018,0.00,,25.64,,"-999,840.77"
,IN,AR,30327079,1005,100,,Invoice,,,,,,30/09/2018,30/09/2018,0.00,,737.64,,"-1,000,578.41"
,IN,AR,30327137,1005,100,,Invoice,,,,,,30/09/2018,30/09/2018,0.00,,445.14,,"-1,001,023.55"
,IN,AR,30327146,1005,100,,Invoice,,,,,,30/09/2018,30/09/2018,0.00,,117.12,,"-1,001,140.67"
,IN,AR,30327176,1005,100,,Invoice,,,,,,30/09/2018,30/09/2018,0.00,,228.41,,"-1,001,369.08"
,IN,AR,30327242,1005,100,,Invoice,,,,,,30/09/2018,30/09/2018,0.00,,58.84,,"-1,001,427.92"
,IN,AR,30327353,1005,100,,Invoice,,,,,,30/09/2018,30/09/2018,0.00,,600.34,,"-1,002,028.26"
,IN,AR,30327354,1005,100,,Invoice,,,,,,30/09/2018,30/09/2018,0.00,,11.69,,"-1,002,039.95"
,IN,AR,30327355,1005,100,,Invoice,,,,,,30/09/2018,30/09/2018,0.00,,13.64,,"-1,002,053.59"
,IN,AR,30327356,1005,100,,Invoice,,,,,,30/09/2018,30/09/2018,0.00,,40.93,,"-1,002,094.52"
,IN,AR,30327357,1005,100,,Invoice,,,,,,30/09/2018,30/09/2018,0.00,,19.49,,"-1,002,114.01"
,IN,AR,30327358,1005,100,,Invoice,,,,,,30/09/2018,30/09/2018,0.00,,23.39,,"-1,002,137.40"
,IN,AR,30327359,1005,100,,Invoice,,,,,,30/09/2018,30/09/2018,0.00,,15.59,,"-1,002,152.99"
,IN,AR,30327360,1005,100,,Invoice,,,,,,30/09/2018,30/09/2018,0.00,,9.75,,"-1,002,162.74"
,IN,AR,30327361,1005,100,,Invoice,,,,,,30/09/2018,30/09/2018,0.00,,33.14,,"-1,002,195.88"
,IN,AR,30327362,1005,100,,Invoice,,,,,,30/09/2018,30/09/2018,0.00,,44.83,,"-1,002,240.71"
,IN,AR,30327363,1005,100,,Invoice,,,,,,30/09/2018,30/09/2018,0.00,,9.75,,"-1,002,250.46"
,IN,AR,30327364,1005,100,,Invoice,,,,,,30/09/2018,30/09/2018,0.00,,13.64,,"-1,002,264.10"
,IN,AR,30327365,1005,100,,Invoice,,,,,,30/09/2018,30/09/2018,0.00,,40.93,,"-1,002,305.03"
,IN,AR,30327366,1005,100,,Invoice,,,,,,30/09/2018,30/09/2018,0.00,,19.49,,"-1,002,324.52"
,IN,AR,30327367,1005,100,,Invoice,,,,,,30/09/2018,30/09/2018,0.00,,15.59,,"-1,002,340.11"
,IN,AR,30327368,1005,100,,Invoice,,,,,,30/09/2018,30/09/2018,0.00,,7.80,,"-1,002,347.91"
,IN,AR,30327369,1005,100,,Invoice,,,,,,30/09/2018,30/09/2018,0.00,,9.75,,"-1,002,357.66"
,IN,AR,30327370,1005,100,,Invoice,,,,,,30/09/2018,30/09/2018,0.00,,15.59,,"-1,002,373.25"
,IN,AR,30327371,1005,100,,Invoice,,,,,,30/09/2018,30/09/2018,0.00,,1.95,,"-1,002,375.20"
,IN,AR,30327372,1005,100,,Invoice,,,,,,30/09/2018,30/09/2018,0.00,,625.68,,"-1,003,000.88"
,IN,AR,30327373,1005,100,,Invoice,,,,,,30/09/2018,30/09/2018,0.00,,15.59,,"-1,003,016.47"
,IN,AR,30327374,1005,100,,Invoice,,,,,,30/09/2018,30/09/2018,0.00,,52.63,,"-1,003,069.10"
,IN,AR,30327375,1005,100,,Invoice,,,,,,30/09/2018,30/09/2018,0.00,,666.61,,"-1,003,735.71"
,IN,AR,30327376,1005,100,,Invoice,,,,,,30/09/2018,30/09/2018,0.00,,17.54,,"-1,003,753.25"
,IN,AR,30327377,1005,100,,Invoice,,,,,,30/09/2018,30/09/2018,0.00,,9.75,,"-1,003,763.00"
,IN,AR,30327378,1005,100,,Invoice,,,,,,30/09/2018,30/09/2018,0.00,,7.80,,"-1,003,770.80"
,IN,AR,30327379,1005,100,,Invoice,,,,,,30/09/2018,30/09/2018,0.00,,3.90,,"-1,003,774.70"
,IN,AR,30327380,1005,100,,Invoice,,,,,,30/09/2018,30/09/2018,0.00,,19.49,,"-1,003,794.19"
,IN,AR,30327381,1005,100,,Invoice,,,,,,30/09/2018,30/09/2018,0.00,,97.46,,"-1,003,891.65"
,IN,AR,30327382,1005,100,,Invoice,,,,,,30/09/2018,30/09/2018,0.00,,15.59,,"-1,003,907.24"
,IN,AR,30327383,1005,100,,Invoice,,,,,,30/09/2018,30/09/2018,0.00,,3.90,,"-1,003,911.14"
,IN,AR,30327384,1005,100,,Invoice,,,,,,30/09/2018,30/09/2018,0.00,,7.80,,"-1,003,918.94"
,IN,AR,30327423,1005,100,,Invoice,,,,,,30/09/2018,30/09/2018,0.00,,15.05,,"-1,003,933.99"
,IN,AR,30327424,1005,100,,Invoice,,,,,,30/09/2018,30/09/2018,0.00,,9.41,,"-1,003,943.40"
,IN,AR,30327425,1005,100,,Invoice,,,,,,30/09/2018,30/09/2018,0.00,,7.53,,"-1,003,950.93"
,IN,AR,30327426,1005,100,,Invoice,,,,,,30/09/2018,30/09/2018,0.00,,11.29,,"-1,003,962.22"
,IN,AR,30327427,1005,100,,Invoice,,,,,,30/09/2018,30/09/2018,0.00,,9.41,,"-1,003,971.63"
,IN,AR,30327453,1005,100,,Invoice,,,,,,30/09/2018,30/09/2018,0.00,,656.08,,"-1,004,627.71"
,IN,AR,30327476,1005,100,,Invoice,,,,,,30/09/2018,30/09/2018,0.00,,226.21,,"-1,004,853.92"
,IN,AR,30327477,1005,100,,Invoice,,,,,,30/09/2018,30/09/2018,0.00,,185.39,,"-1,005,039.31"
,IN,AR,30327527,1005,100,,Invoice,,,,,,30/09/2018,30/09/2018,0.00,,49.27,,"-1,005,088.58"
,IN,AR,30327528,1005,100,,Invoice,,,,,,30/09/2018,30/09/2018,0.00,,24.64,,"-1,005,113.22"
,IN,AR,30327529,1005,100,,Invoice,,,,,,30/09/2018,30/09/2018,0.00,,10.95,,"-1,005,124.17"
,IN,AR,30327530,1005,100,,Invoice,,,,,,30/09/2018,30/09/2018,0.00,,5.47,,"-1,005,129.64"
,IN,AR,30327531,1005,100,,Invoice,,,,,,30/09/2018,30/09/2018,0.00,,5.47,,"-1,005,135.11"
,IN,AR,30327618,1005,100,,Invoice,,,,,,30/09/2018,30/09/2018,0.00,,195.48,,"-1,005,330.59"
,IN,AR,30327700,1005,100,,Invoice,,,,,,30/09/2018,30/09/2018,0.00,,54.66,,"-1,005,385.25"
,CN,AR,31019281,1005,100,,Credit Note,,,,,,30/09/2018,30/09/2018,748.37,,0.00,,"-1,004,636.88"
,CN,AR,31019283,1005,100,,Credit Note,,,,,,30/09/2018,30/09/2018,511.63,,0.00,,"-1,004,125.25"
,CN,AR,31019284,1005,100,,Credit Note,,,,,,30/09/2018,30/09/2018,39.16,,0.00,,"-1,004,086.09"
,IN,AR,30329567,1005,100,,Invoice,,,,,,30/09/2018,30/09/2018,0.00,,550.41,,"-1,004,636.50"
,IN,AR,30329568,1005,100,,Invoice,,,,,,30/09/2018,30/09/2018,0.00,,197.97,,"-1,004,834.47"
,IN,AR,30329570,1005,100,,Invoice,,,,,,30/09/2018,30/09/2018,0.00,,39.16,,"-1,004,873.63"
,CN,AR,31019172,1005,100,,Credit Note,,,,,,01/10/2018,01/10/2018,364.41,,0.00,,"-1,004,509.22"
,CS,AR,32009447,1005,100,,Cash sale,,,,,,01/10/2018,01/10/2018,0.00,,14.03,,"-1,004,523.25"
,CS,AR,32009452,1005,100,,Cash sale,,,,,,01/10/2018,01/10/2018,0.00,,16.61,,"-1,004,539.86"
,CS,AR,32009460,1005,100,,Cash sale,,,,,,01/10/2018,01/10/2018,0.00,,14.58,,"-1,004,554.44"
,CS,AR,32009461,1005,100,,Cash sale,,,,,,01/10/2018,01/10/2018,0.00,,5.61,,"-1,004,560.05"
,CS,AR,32009463,1005,100,,Cash sale,,,,,,01/10/2018,01/10/2018,0.00,,3.64,,"-1,004,563.69"
,CS,AR,32009470,1005,100,,Cash sale,,,,,,01/10/2018,01/10/2018,0.00,,3.64,,"-1,004,567.33"
,CS,AR,32009472,1005,100,,Cash sale,,,,,,01/10/2018,01/10/2018,0.00,,36.10,,"-1,004,603.43"
,CS,AR,32009482,1005,100,,Cash sale,,,,,,01/10/2018,01/10/2018,0.00,,12.46,,"-1,004,615.89"
,CS,AR,32009487,1005,100,,Cash sale,,,,,,01/10/2018,01/10/2018,0.00,,7.78,,"-1,004,623.67"
,CS,AR,32009488,1005,100,,Cash sale,,,,,,01/10/2018,01/10/2018,0.00,,7.29,,"-1,004,630.96"
,CS,AR,32009490,1005,100,,Cash sale,,,,,,01/10/2018,01/10/2018,0.00,,7.29,,"-1,004,638.25"
,CS,AR,32009496,1005,100,,Cash sale,,,,,,01/10/2018,01/10/2018,0.00,,7.29,,"-1,004,645.54"
,CS,AR,32009499,1005,100,,Cash sale,,,,,,01/10/2018,01/10/2018,0.00,,3.64,,"-1,004,649.18"
,CS,AR,32009504,1005,100,,Cash sale,,,,,,01/10/2018,01/10/2018,0.00,,3.64,,"-1,004,652.82"
,CS,AR,32009506,1005,100,,Cash sale,,,,,,01/10/2018,01/10/2018,0.00,,3.64,,"-1,004,656.46"
,CS,AR,32009508,1005,100,,Cash sale,,,,,,01/10/2018,01/10/2018,0.00,,10.34,,"-1,004,666.80"
,CS,AR,32009513,1005,100,,Cash sale,,,,,,01/10/2018,01/10/2018,0.00,,7.29,,"-1,004,674.09"
,CS,AR,32009514,1005,100,,Cash sale,,,,,,01/10/2018,01/10/2018,0.00,,7.29,,"-1,004,681.38"
,CS,AR,32009529,1005,100,,Cash sale,,,,,,01/10/2018,01/10/2018,0.00,,7.29,,"-1,004,688.67"
,CS,AR,32009534,1005,100,,Cash sale,,,,,,01/10/2018,01/10/2018,0.00,,7.29,,"-1,004,695.96"
,CS,AR,32009535,1005,100,,Cash sale,,,,,,01/10/2018,01/10/2018,0.00,,10.93,,"-1,004,706.89"
,CS,AR,32009541,1005,100,,Cash sale,,,,,,01/10/2018,01/10/2018,0.00,,7.75,,"-1,004,714.64"
,CS,AR,32009542,1005,100,,Cash sale,,,,,,01/10/2018,01/10/2018,0.00,,14.62,,"-1,004,729.26"
,CS,AR,32009544,1005,100,,Cash sale,,,,,,01/10/2018,01/10/2018,0.00,,2.72,,"-1,004,731.98"
,CS,AR,32009546,1005,100,,Cash sale,,,,,,01/10/2018,01/10/2018,0.00,,7.17,,"-1,004,739.15"
,CS,AR,32009547,1005,100,,Cash sale,,,,,,01/10/2018,01/10/2018,0.00,,18.05,,"-1,004,757.20"
,CS,AR,32009556,1005,100,,Cash sale,,,,,,01/10/2018,01/10/2018,0.00,,25.51,,"-1,004,782.71"
,CS,AR,32009557,1005,100,,Cash sale,,,,,,01/10/2018,01/10/2018,0.00,,7.29,,"-1,004,790.00"
,CS,AR,32009561,1005,100,,Cash sale,,,,,,01/10/2018,01/10/2018,0.00,,13.14,,"-1,004,803.14"
,CS,AR,32009562,1005,100,,Cash sale,,,,,,01/10/2018,01/10/2018,0.00,,5.08,,"-1,004,808.22"
,CS,AR,32009574,1005,100,,Cash sale,,,,,,01/10/2018,01/10/2018,0.00,,3.64,,"-1,004,811.86"
,CS,AR,32009575,1005,100,,Cash sale,,,,,,01/10/2018,01/10/2018,0.00,,7.29,,"-1,004,819.15"
,CS,AR,32009587,1005,100,,Cash sale,,,,,,01/10/2018,01/10/2018,0.00,,3.64,,"-1,004,822.79"
,CS,AR,32009589,1005,100,,Cash sale,,,,,,01/10/2018,01/10/2018,0.00,,6.08,,"-1,004,828.87"
,CS,AR,32009596,1005,100,,Cash sale,,,,,,01/10/2018,01/10/2018,0.00,,10.93,,"-1,004,839.80"
,CS,AR,32009608,1005,100,,Cash sale,,,,,,01/10/2018,01/10/2018,0.00,,17.80,,"-1,004,857.60"
,CS,AR,32009610,1005,100,,Cash sale,,,,,,01/10/2018,01/10/2018,0.00,,10.93,,"-1,004,868.53"
,CS,AR,32009618,1005,100,,Cash sale,,,,,,01/10/2018,01/10/2018,0.00,,15.17,,"-1,004,883.70"
,CS,AR,32009624,1005,100,,Cash sale,,,,,,01/10/2018,01/10/2018,0.00,,9.84,,"-1,004,893.54"
,CS,AR,32009626,1005,100,,Cash sale,,,,,,01/10/2018,01/10/2018,0.00,,36.44,,"-1,004,929.98"
,CS,AR,32009630,1005,100,,Cash sale,,,,,,01/10/2018,01/10/2018,0.00,,11.44,,"-1,004,941.42"
,CS,AR,32009642,1005,100,,Cash sale,,,,,,01/10/2018,01/10/2018,0.00,,9.10,,"-1,004,950.52"
,CS,AR,32009644,1005,100,,Cash sale,,,,,,01/10/2018,01/10/2018,0.00,,182.20,,"-1,005,132.72"
,CS,AR,32009648,1005,100,,Cash sale,,,,,,01/10/2018,01/10/2018,0.00,,12.14,,"-1,005,144.86"
,CS,AR,32009652,1005,100,,Cash sale,,,,,,01/10/2018,01/10/2018,0.00,,14.58,,"-1,005,159.44"
,CS,AR,32009663,1005,100,,Cash sale,,,,,,01/10/2018,01/10/2018,0.00,,3.64,,"-1,005,163.08"
,CS,AR,32009664,1005,100,,Cash sale,,,,,,01/10/2018,01/10/2018,0.00,,14.58,,"-1,005,177.66"
,CS,AR,32009665,1005,100,,Cash sale,,,,,,01/10/2018,01/10/2018,0.00,,3.28,,"-1,005,180.94"
,CS,AR,32009676,1005,100,,Cash sale,,,,,,01/10/2018,01/10/2018,0.00,,3.64,,"-1,005,184.58"
,CS,AR,32009686,1005,100,,Cash sale,,,,,,01/10/2018,01/10/2018,0.00,,13.98,,"-1,005,198.56"
,CS,AR,32009699,1005,100,,Cash sale,,,,,,01/10/2018,01/10/2018,0.00,,10.93,,"-1,005,209.49"
,CS,AR,32009706,1005,100,,Cash sale,,,,,,01/10/2018,01/10/2018,0.00,,54.66,,"-1,005,264.15"
,IN,AR,30327704,1005,100,,Invoice,,,,,,01/10/2018,01/10/2018,0.00,,35.59,,"-1,005,299.74"
,IN,AR,30327709,1005,100,,Invoice,,,,,,01/10/2018,01/10/2018,0.00,,21.86,,"-1,005,321.60"
,IN,AR,30327713,1005,100,,Invoice,,,,,,01/10/2018,01/10/2018,0.00,,182.20,,"-1,005,503.80"
,IN,AR,30327719,1005,100,,Invoice,,,,,,01/10/2018,01/10/2018,0.00,,10.13,,"-1,005,513.93"
,IN,AR,30327720,1005,100,,Invoice,,,,,,01/10/2018,01/10/2018,0.00,,28.36,,"-1,005,542.29"
,IN,AR,30327721,1005,100,,Invoice,,,,,,01/10/2018,01/10/2018,0.00,,4.05,,"-1,005,546.34"
,IN,AR,30327722,1005,100,,Invoice,,,,,,01/10/2018,01/10/2018,0.00,,16.20,,"-1,005,562.54"
,IN,AR,30327723,1005,100,,Invoice,,,,,,01/10/2018,01/10/2018,0.00,,10.13,,"-1,005,572.67"
,IN,AR,30327739,1005,100,,Invoice,,,,,,01/10/2018,01/10/2018,0.00,,84.54,,"-1,005,657.21"
,IN,AR,30327752,1005,100,,Invoice,,,,,,01/10/2018,01/10/2018,0.00,,47.46,,"-1,005,704.67"
,IN,AR,30327759,1005,100,,Invoice,,,,,,01/10/2018,01/10/2018,0.00,,13.77,,"-1,005,718.44"
,IN,AR,30327761,1005,100,,Invoice,,,,,,01/10/2018,01/10/2018,0.00,,42.00,,"-1,005,760.44"
,IN,AR,30327763,1005,100,,Invoice,,,,,,01/10/2018,01/10/2018,0.00,,3.64,,"-1,005,764.08"
,IN,AR,30327764,1005,100,,Invoice,,,,,,01/10/2018,01/10/2018,0.00,,54.66,,"-1,005,818.74"
,IN,AR,30327765,1005,100,,Invoice,,,,,,01/10/2018,01/10/2018,0.00,,2.97,,"-1,005,821.71"
,IN,AR,30327768,1005,100,,Invoice,,,,,,01/10/2018,01/10/2018,0.00,,50.90,,"-1,005,872.61"
,IN,AR,30327774,1005,100,,Invoice,,,,,,01/10/2018,01/10/2018,0.00,,34.00,,"-1,005,906.61"
,IN,AR,30327775,1005,100,,Invoice,,,,,,01/10/2018,01/10/2018,0.00,,20.00,,"-1,005,926.61"
,IN,AR,30327780,1005,100,,Invoice,,,,,,01/10/2018,01/10/2018,0.00,,20.34,,"-1,005,946.95"
,IN,AR,30327781,1005,100,,Invoice,,,,,,01/10/2018,01/10/2018,0.00,,16.53,,"-1,005,963.48"
,IN,AR,30327784,1005,100,,Invoice,,,,,,01/10/2018,01/10/2018,0.00,,14.62,,"-1,005,978.10"
,IN,AR,30327787,1005,100,,Invoice,,,,,,01/10/2018,01/10/2018,0.00,,18.00,,"-1,005,996.10"
,IN,AR,30327802,1005,100,,Invoice,,,,,,01/10/2018,01/10/2018,0.00,,30.00,,"-1,006,026.10"
,IN,AR,30327809,1005,100,,Invoice,,,,,,01/10/2018,01/10/2018,0.00,,22.54,,"-1,006,048.64"
,IN,AR,30327811,1005,100,,Invoice,,,,,,01/10/2018,01/10/2018,0.00,,29.15,,"-1,006,077.79"
,IN,AR,30327813,1005,100,,Invoice,,,,,,01/10/2018,01/10/2018,0.00,,12.75,,"-1,006,090.54"
,IN,AR,30327815,1005,100,,Invoice,,,,,,01/10/2018,01/10/2018,0.00,,18.09,,"-1,006,108.63"
,IN,AR,30327820,1005,100,,Invoice,,,,,,01/10/2018,01/10/2018,0.00,,10.34,,"-1,006,118.97"
,IN,AR,30327827,1005,100,,Invoice,,,,,,01/10/2018,01/10/2018,0.00,,7.19,,"-1,006,126.16"
,IN,AR,30327829,1005,100,,Invoice,,,,,,01/10/2018,01/10/2018,0.00,,13.78,,"-1,006,139.94"
,IN,AR,30327837,1005,100,,Invoice,,,,,,01/10/2018,01/10/2018,0.00,,4.24,,"-1,006,144.18"
,IN,AR,30327844,1005,100,,Invoice,,,,,,01/10/2018,01/10/2018,0.00,,18.09,,"-1,006,162.27"
,IN,AR,30327847,1005,100,,Invoice,,,,,,01/10/2018,01/10/2018,0.00,,11.86,,"-1,006,174.13"
,IN,AR,30327852,1005,100,,Invoice,,,,,,01/10/2018,01/10/2018,0.00,,7.29,,"-1,006,181.42"
,IN,AR,30327860,1005,100,,Invoice,,,,,,01/10/2018,01/10/2018,0.00,,86.14,,"-1,006,267.56"
,IN,AR,30327863,1005,100,,Invoice,,,,,,01/10/2018,01/10/2018,0.00,,38.14,,"-1,006,305.70"
,IN,AR,30327868,1005,100,,Invoice,,,,,,01/10/2018,01/10/2018,0.00,,19.12,,"-1,006,324.82"
,IN,AR,30327872,1005,100,,Invoice,,,,,,01/10/2018,01/10/2018,0.00,,25.76,,"-1,006,350.58"
,IN,AR,30327875,1005,100,,Invoice,,,,,,01/10/2018,01/10/2018,0.00,,9.03,,"-1,006,359.61"
,IN,AR,30327881,1005,100,,Invoice,,,,,,01/10/2018,01/10/2018,0.00,,4.24,,"-1,006,363.85"
,IN,AR,30327885,1005,100,,Invoice,,,,,,01/10/2018,01/10/2018,0.00,,5.76,,"-1,006,369.61"
,IN,AR,30327887,1005,100,,Invoice,,,,,,01/10/2018,01/10/2018,0.00,,5.08,,"-1,006,374.69"
,IN,AR,30327898,1005,100,,Invoice,,,,,,01/10/2018,01/10/2018,0.00,,10.93,,"-1,006,385.62"
,IN,AR,30327909,1005,100,,Invoice,,,,,,01/10/2018,01/10/2018,0.00,,35.59,,"-1,006,421.21"
,IN,AR,30327911,1005,100,,Invoice,,,,,,01/10/2018,01/10/2018,0.00,,17.56,,"-1,006,438.77"
,IN,AR,30327915,1005,100,,Invoice,,,,,,01/10/2018,01/10/2018,0.00,,32.54,,"-1,006,471.31"
,IN,AR,30327923,1005,100,,Invoice,,,,,,01/10/2018,01/10/2018,0.00,,10.93,,"-1,006,482.24"
,IN,AR,30327929,1005,100,,Invoice,,,,,,01/10/2018,01/10/2018,0.00,,8.26,,"-1,006,490.50"
,IN,AR,30327930,1005,100,,Invoice,,,,,,01/10/2018,01/10/2018,0.00,,7.29,,"-1,006,497.79"
,IN,AR,30327932,1005,100,,Invoice,,,,,,01/10/2018,01/10/2018,0.00,,3.64,,"-1,006,501.43"
,IN,AR,30327934,1005,100,,Invoice,,,,,,01/10/2018,01/10/2018,0.00,,13.78,,"-1,006,515.21"
,IN,AR,30327942,1005,100,,Invoice,,,,,,01/10/2018,01/10/2018,0.00,,14.58,,"-1,006,529.79"
,IN,AR,30327943,1005,100,,Invoice,,,,,,01/10/2018,01/10/2018,0.00,,8.39,,"-1,006,538.18"
,IN,AR,30327951,1005,100,,Invoice,,,,,,01/10/2018,01/10/2018,0.00,,48.81,,"-1,006,586.99"
,IN,AR,30327954,1005,100,,Invoice,,,,,,01/10/2018,01/10/2018,0.00,,16.00,,"-1,006,602.99"
,IN,AR,30327959,1005,100,,Invoice,,,,,,01/10/2018,01/10/2018,0.00,,"1,093.22",,"-1,007,696.21"
,IN,AR,30327969,1005,100,,Invoice,,,,,,01/10/2018,01/10/2018,0.00,,182.20,,"-1,007,878.41"
,IN,AR,30327970,1005,100,,Invoice,,,,,,01/10/2018,01/10/2018,0.00,,42.69,,"-1,007,921.10"
,IN,AR,30327972,1005,100,,Invoice,,,,,,01/10/2018,01/10/2018,0.00,,4.49,,"-1,007,925.59"
,IN,AR,30327988,1005,100,,Invoice,,,,,,01/10/2018,01/10/2018,0.00,,13.14,,"-1,007,938.73"
,IN,AR,30327995,1005,100,,Invoice,,,,,,01/10/2018,01/10/2018,0.00,,54.66,,"-1,007,993.39"
,IN,AR,30327997,1005,100,,Invoice,,,,,,01/10/2018,01/10/2018,0.00,,7.29,,"-1,008,000.68"
,IN,AR,30328011,1005,100,,Invoice,,,,,,01/10/2018,01/10/2018,0.00,,2.14,,"-1,008,002.82"
,IN,AR,30328024,1005,100,,Invoice,,,,,,01/10/2018,01/10/2018,0.00,,3.98,,"-1,008,006.80"
,IN,AR,30328039,1005,100,,Invoice,,,,,,01/10/2018,01/10/2018,0.00,,11.86,,"-1,008,018.66"
,IN,AR,30328043,1005,100,,Invoice,,,,,,01/10/2018,01/10/2018,0.00,,32.07,,"-1,008,050.73"
,IN,AR,30328052,1005,100,,Invoice,,,,,,01/10/2018,01/10/2018,0.00,,12.14,,"-1,008,062.87"
,IN,AR,30328056,1005,100,,Invoice,,,,,,01/10/2018,01/10/2018,0.00,,26.27,,"-1,008,089.14"
,IN,AR,30328058,1005,100,,Invoice,,,,,,01/10/2018,01/10/2018,0.00,,4.58,,"-1,008,093.72"
,IN,AR,30328064,1005,100,,Invoice,,,,,,01/10/2018,01/10/2018,0.00,,18.22,,"-1,008,111.94"
,IN,AR,30328065,1005,100,,Invoice,,,,,,01/10/2018,01/10/2018,0.00,,21.86,,"-1,008,133.80"
,IN,AR,30328072,1005,100,,Invoice,,,,,,01/10/2018,01/10/2018,0.00,,8.00,,"-1,008,141.80"
,IN,AR,30328079,1005,100,,Invoice,,,,,,01/10/2018,01/10/2018,0.00,,67.88,,"-1,008,209.68"
,IN,AR,30328083,1005,100,,Invoice,,,,,,01/10/2018,01/10/2018,0.00,,21.03,,"-1,008,230.71"
,IN,AR,30328084,1005,100,,Invoice,,,,,,01/10/2018,01/10/2018,0.00,,6.31,,"-1,008,237.02"
,IN,AR,30328085,1005,100,,Invoice,,,,,,01/10/2018,01/10/2018,0.00,,8.41,,"-1,008,245.43"
,IN,AR,30328097,1005,100,,Invoice,,,,,,01/10/2018,01/10/2018,0.00,,54.66,,"-1,008,300.09"
,IN,AR,30328098,1005,100,,Invoice,,,,,,01/10/2018,01/10/2018,0.00,,26.58,,"-1,008,326.67"
,IN,AR,30328099,1005,100,,Invoice,,,,,,01/10/2018,01/10/2018,0.00,,172.46,,"-1,008,499.13"
,IN,AR,30328101,1005,100,,Invoice,,,,,,01/10/2018,01/10/2018,0.00,,25.25,,"-1,008,524.38"
,IN,AR,30328131,1005,100,,Invoice,,,,,,01/10/2018,01/10/2018,0.00,,10.93,,"-1,008,535.31"
,IN,AR,30328133,1005,100,,Invoice,,,,,,01/10/2018,01/10/2018,0.00,,21.36,,"-1,008,556.67"
,IN,AR,30328135,1005,100,,Invoice,,,,,,01/10/2018,01/10/2018,0.00,,22.31,,"-1,008,578.98"
,IN,AR,30328164,1005,100,,Invoice,,,,,,01/10/2018,01/10/2018,0.00,,20.00,,"-1,008,598.98"
,IN,AR,30328166,1005,100,,Invoice,,,,,,01/10/2018,01/10/2018,0.00,,3.76,,"-1,008,602.74"
,IN,AR,30328167,1005,100,,Invoice,,,,,,01/10/2018,01/10/2018,0.00,,7.53,,"-1,008,610.27"
,IN,AR,30328187,1005,100,,Invoice,,,,,,01/10/2018,01/10/2018,0.00,,13.69,,"-1,008,623.96"
,IN,AR,30328199,1005,100,,Invoice,,,,,,01/10/2018,01/10/2018,0.00,,7.02,,"-1,008,630.98"
,IN,AR,30328202,1005,100,,Invoice,,,,,,01/10/2018,01/10/2018,0.00,,6.13,,"-1,008,637.11"
,IN,AR,30328213,1005,100,,Invoice,,,,,,01/10/2018,01/10/2018,0.00,,19.92,,"-1,008,657.03"
,IN,AR,30328215,1005,100,,Invoice,,,,,,01/10/2018,01/10/2018,0.00,,29.15,,"-1,008,686.18"
,IN,AR,30328216,1005,100,,Invoice,,,,,,01/10/2018,01/10/2018,0.00,,46.78,,"-1,008,732.96"
,IN,AR,30328221,1005,100,,Invoice,,,,,,01/10/2018,01/10/2018,0.00,,4.00,,"-1,008,736.96"
,IN,AR,30328222,1005,100,,Invoice,,,,,,01/10/2018,01/10/2018,0.00,,4.00,,"-1,008,740.96"
,IN,AR,30328224,1005,100,,Invoice,,,,,,01/10/2018,01/10/2018,0.00,,12.46,,"-1,008,753.42"
,IN,AR,30328225,1005,100,,Invoice,,,,,,01/10/2018,01/10/2018,0.00,,6.23,,"-1,008,759.65"
,IN,AR,30328226,1005,100,,Invoice,,,,,,01/10/2018,01/10/2018,0.00,,6.23,,"-1,008,765.88"
,IN,AR,30328227,1005,100,,Invoice,,,,,,01/10/2018,01/10/2018,0.00,,4.15,,"-1,008,770.03"
,IN,AR,30328228,1005,100,,Invoice,,,,,,01/10/2018,01/10/2018,0.00,,8.31,,"-1,008,778.34"
,IN,AR,30328229,1005,100,,Invoice,,,,,,01/10/2018,01/10/2018,0.00,,12.46,,"-1,008,790.80"
,IN,AR,30328242,1005,100,,Invoice,,,,,,01/10/2018,01/10/2018,0.00,,6.56,,"-1,008,797.36"
,IN,AR,30328248,1005,100,,Invoice,,,,,,01/10/2018,01/10/2018,0.00,,6.07,,"-1,008,803.43"
,IN,AR,30328253,1005,100,,Invoice,,,,,,01/10/2018,01/10/2018,0.00,,14.58,,"-1,008,818.01"
,IN,AR,30328255,1005,100,,Invoice,,,,,,01/10/2018,01/10/2018,0.00,,20.34,,"-1,008,838.35"
,IN,AR,30328257,1005,100,,Invoice,,,,,,01/10/2018,01/10/2018,0.00,,364.41,,"-1,009,202.76"
,IN,AR,30328258,1005,100,,Invoice,,,,,,01/10/2018,01/10/2018,0.00,,"1,093.22",,"-1,010,295.98"
,IN,AR,30328262,1005,100,,Invoice,,,,,,01/10/2018,01/10/2018,0.00,,7.29,,"-1,010,303.27"
,IN,AR,30328269,1005,100,,Invoice,,,,,,01/10/2018,01/10/2018,0.00,,52.57,,"-1,010,355.84"
,IN,AR,30328283,1005,100,,Invoice,,,,,,01/10/2018,01/10/2018,0.00,,79.68,,"-1,010,435.52"
,IN,AR,30328293,1005,100,,Invoice,,,,,,01/10/2018,01/10/2018,0.00,,2.12,,"-1,010,437.64"
,IN,AR,30328299,1005,100,,Invoice,,,,,,01/10/2018,01/10/2018,0.00,,29.15,,"-1,010,466.79"
,CN,AR,31019126,1005,100,,Credit Note,,,,,,02/10/2018,02/10/2018,182.20,,0.00,,"-1,010,284.59"
,CN,AR,31019139,1005,100,,Credit Note,,,,,,02/10/2018,02/10/2018,163.98,,0.00,,"-1,010,120.61"
,CS,AR,32009456,1005,100,,Cash sale,,,,,,02/10/2018,02/10/2018,0.00,,3.64,,"-1,010,124.25"
,CS,AR,32009458,1005,100,,Cash sale,,,,,,02/10/2018,02/10/2018,0.00,,7.29,,"-1,010,131.54"
,CS,AR,32009462,1005,100,,Cash sale,,,,,,02/10/2018,02/10/2018,0.00,,10.93,,"-1,010,142.47"
,CS,AR,32009468,1005,100,,Cash sale,,,,,,02/10/2018,02/10/2018,0.00,,3.64,,"-1,010,146.11"
,CS,AR,32009476,1005,100,,Cash sale,,,,,,02/10/2018,02/10/2018,0.00,,6.02,,"-1,010,152.13"
,CS,AR,32009478,1005,100,,Cash sale,,,,,,02/10/2018,02/10/2018,0.00,,14.58,,"-1,010,166.71"
,CS,AR,32009485,1005,100,,Cash sale,,,,,,02/10/2018,02/10/2018,0.00,,7.29,,"-1,010,174.00"
,CS,AR,32009493,1005,100,,Cash sale,,,,,,02/10/2018,02/10/2018,0.00,,18.22,,"-1,010,192.22"
,CS,AR,32009511,1005,100,,Cash sale,,,,,,02/10/2018,02/10/2018,0.00,,14.58,,"-1,010,206.80"
,CS,AR,32009512,1005,100,,Cash sale,,,,,,02/10/2018,02/10/2018,0.00,,4.32,,"-1,010,211.12"
,CS,AR,32009515,1005,100,,Cash sale,,,,,,02/10/2018,02/10/2018,0.00,,14.58,,"-1,010,225.70"
,CS,AR,32009517,1005,100,,Cash sale,,,,,,02/10/2018,02/10/2018,0.00,,2.81,,"-1,010,228.51"
,CS,AR,32009520,1005,100,,Cash sale,,,,,,02/10/2018,02/10/2018,0.00,,2.84,,"-1,010,231.35"
,CS,AR,32009525,1005,100,,Cash sale,,,,,,02/10/2018,02/10/2018,0.00,,5.17,,"-1,010,236.52"
,CS,AR,32009531,1005,100,,Cash sale,,,,,,02/10/2018,02/10/2018,0.00,,7.29,,"-1,010,243.81"
,CS,AR,32009540,1005,100,,Cash sale,,,,,,02/10/2018,02/10/2018,0.00,,6.74,,"-1,010,250.55"
,CS,AR,32009549,1005,100,,Cash sale,,,,,,02/10/2018,02/10/2018,0.00,,14.58,,"-1,010,265.13"
,CS,AR,32009550,1005,100,,Cash sale,,,,,,02/10/2018,02/10/2018,0.00,,10.93,,"-1,010,276.06"
,CS,AR,32009552,1005,100,,Cash sale,,,,,,02/10/2018,02/10/2018,0.00,,7.80,,"-1,010,283.86"
,CS,AR,32009555,1005,100,,Cash sale,,,,,,02/10/2018,02/10/2018,0.00,,10.93,,"-1,010,294.79"
,CS,AR,32009560,1005,100,,Cash sale,,,,,,02/10/2018,02/10/2018,0.00,,2.54,,"-1,010,297.33"
,CS,AR,32009563,1005,100,,Cash sale,,,,,,02/10/2018,02/10/2018,0.00,,8.39,,"-1,010,305.72"
,CS,AR,32009564,1005,100,,Cash sale,,,,,,02/10/2018,02/10/2018,0.00,,7.75,,"-1,010,313.47"
,CS,AR,32009565,1005,100,,Cash sale,,,,,,02/10/2018,02/10/2018,0.00,,7.80,,"-1,010,321.27"
,CS,AR,32009566,1005,100,,Cash sale,,,,,,02/10/2018,02/10/2018,0.00,,7.29,,"-1,010,328.56"
,CS,AR,32009568,1005,100,,Cash sale,,,,,,02/10/2018,02/10/2018,0.00,,9.66,,"-1,010,338.22"
,CS,AR,32009572,1005,100,,Cash sale,,,,,,02/10/2018,02/10/2018,0.00,,3.64,,"-1,010,341.86"
,CS,AR,32009580,1005,100,,Cash sale,,,,,,02/10/2018,02/10/2018,0.00,,7.29,,"-1,010,349.15"
,CS,AR,32009582,1005,100,,Cash sale,,,,,,02/10/2018,02/10/2018,0.00,,5.17,,"-1,010,354.32"
,CS,AR,32009592,1005,100,,Cash sale,,,,,,02/10/2018,02/10/2018,0.00,,3.76,,"-1,010,358.08"
,CS,AR,32009602,1005,100,,Cash sale,,,,,,02/10/2018,02/10/2018,0.00,,10.93,,"-1,010,369.01"
,CS,AR,32009603,1005,100,,Cash sale,,,,,,02/10/2018,02/10/2018,0.00,,7.29,,"-1,010,376.30"
,CS,AR,32009616,1005,100,,Cash sale,,,,,,02/10/2018,02/10/2018,0.00,,30.51,,"-1,010,406.81"
,CS,AR,32009617,1005,100,,Cash sale,,,,,,02/10/2018,02/10/2018,0.00,,30.00,,"-1,010,436.81"
,CS,AR,32009622,1005,100,,Cash sale,,,,,,02/10/2018,02/10/2018,0.00,,6.02,,"-1,010,442.83"
,CS,AR,32009636,1005,100,,Cash sale,,,,,,02/10/2018,02/10/2018,0.00,,20.76,,"-1,010,463.59"
,CS,AR,32009643,1005,100,,Cash sale,,,,,,02/10/2018,02/10/2018,0.00,,5.50,,"-1,010,469.09"
,CS,AR,32009647,1005,100,,Cash sale,,,,,,02/10/2018,02/10/2018,0.00,,7.75,,"-1,010,476.84"
,CS,AR,32009651,1005,100,,Cash sale,,,,,,02/10/2018,02/10/2018,0.00,,5.47,,"-1,010,482.31"
,CS,AR,32009657,1005,100,,Cash sale,,,,,,02/10/2018,02/10/2018,0.00,,14.58,,"-1,010,496.89"
,CS,AR,32009667,1005,100,,Cash sale,,,,,,02/10/2018,02/10/2018,0.00,,14.58,,"-1,010,511.47"
,CS,AR,32009669,1005,100,,Cash sale,,,,,,02/10/2018,02/10/2018,0.00,,10.95,,"-1,010,522.42"
,CS,AR,32009672,1005,100,,Cash sale,,,,,,02/10/2018,02/10/2018,0.00,,7.29,,"-1,010,529.71"
,CS,AR,32009673,1005,100,,Cash sale,,,,,,02/10/2018,02/10/2018,0.00,,7.29,,"-1,010,537.00"
,CS,AR,32009675,1005,100,,Cash sale,,,,,,02/10/2018,02/10/2018,0.00,,5.17,,"-1,010,542.17"
,CS,AR,32009687,1005,100,,Cash sale,,,,,,02/10/2018,02/10/2018,0.00,,3.64,,"-1,010,545.81"
,CS,AR,32009693,1005,100,,Cash sale,,,,,,02/10/2018,02/10/2018,0.00,,7.29,,"-1,010,553.10"
,CS,AR,32009705,1005,100,,Cash sale,,,,,,02/10/2018,02/10/2018,0.00,,14.58,,"-1,010,567.68"
,IN,AR,30327701,1005,100,,Invoice,,,,,,02/10/2018,02/10/2018,0.00,,12.03,,"-1,010,579.71"
,IN,AR,30327718,1005,100,,Invoice,,,,,,02/10/2018,02/10/2018,0.00,,30.22,,"-1,010,609.93"
,IN,AR,30327738,1005,100,,Invoice,,,,,,02/10/2018,02/10/2018,0.00,,7.00,,"-1,010,616.93"
,IN,AR,30327744,1005,100,,Invoice,,,,,,02/10/2018,02/10/2018,0.00,,7.29,,"-1,010,624.22"
,IN,AR,30327749,1005,100,,Invoice,,,,,,02/10/2018,02/10/2018,0.00,,3.98,,"-1,010,628.20"
,IN,AR,30327753,1005,100,,Invoice,,,,,,02/10/2018,02/10/2018,0.00,,109.15,,"-1,010,737.35"
,IN,AR,30327758,1005,100,,Invoice,,,,,,02/10/2018,02/10/2018,0.00,,10.93,,"-1,010,748.28"
,IN,AR,30327766,1005,100,,Invoice,,,,,,02/10/2018,02/10/2018,0.00,,7.29,,"-1,010,755.57"
,IN,AR,30327796,1005,100,,Invoice,,,,,,02/10/2018,02/10/2018,0.00,,14.58,,"-1,010,770.15"
,IN,AR,30327805,1005,100,,Invoice,,,,,,02/10/2018,02/10/2018,0.00,,19.24,,"-1,010,789.39"
,IN,AR,30327822,1005,100,,Invoice,,,,,,02/10/2018,02/10/2018,0.00,,21.97,,"-1,010,811.36"
,IN,AR,30327823,1005,100,,Invoice,,,,,,02/10/2018,02/10/2018,0.00,,4.64,,"-1,010,816.00"
,IN,AR,30327828,1005,100,,Invoice,,,,,,02/10/2018,02/10/2018,0.00,,16.79,,"-1,010,832.79"
,IN,AR,30327833,1005,100,,Invoice,,,,,,02/10/2018,02/10/2018,0.00,,4.32,,"-1,010,837.11"
,IN,AR,30327834,1005,100,,Invoice,,,,,,02/10/2018,02/10/2018,0.00,,12.71,,"-1,010,849.82"
,IN,AR,30327841,1005,100,,Invoice,,,,,,02/10/2018,02/10/2018,0.00,,4.24,,"-1,010,854.06"
,IN,AR,30327843,1005,100,,Invoice,,,,,,02/10/2018,02/10/2018,0.00,,163.98,,"-1,011,018.04"
,IN,AR,30327854,1005,100,,Invoice,,,,,,02/10/2018,02/10/2018,0.00,,9.03,,"-1,011,027.07"
,IN,AR,30327855,1005,100,,Invoice,,,,,,02/10/2018,02/10/2018,0.00,,9.03,,"-1,011,036.10"
,IN,AR,30327858,1005,100,,Invoice,,,,,,02/10/2018,02/10/2018,0.00,,7.80,,"-1,011,043.90"
,IN,AR,30327866,1005,100,,Invoice,,,,,,02/10/2018,02/10/2018,0.00,,9.43,,"-1,011,053.33"
,IN,AR,30327869,1005,100,,Invoice,,,,,,02/10/2018,02/10/2018,0.00,,4.78,,"-1,011,058.11"
,IN,AR,30327877,1005,100,,Invoice,,,,,,02/10/2018,02/10/2018,0.00,,13.77,,"-1,011,071.88"
,IN,AR,30327878,1005,100,,Invoice,,,,,,02/10/2018,02/10/2018,0.00,,4.29,,"-1,011,076.17"
,IN,AR,30327882,1005,100,,Invoice,,,,,,02/10/2018,02/10/2018,0.00,,30.64,,"-1,011,106.81"
,IN,AR,30327897,1005,100,,Invoice,,,,,,02/10/2018,02/10/2018,0.00,,15.25,,"-1,011,122.06"
,IN,AR,30327903,1005,100,,Invoice,,,,,,02/10/2018,02/10/2018,0.00,,3.64,,"-1,011,125.70"
,IN,AR,30327904,1005,100,,Invoice,,,,,,02/10/2018,02/10/2018,0.00,,7.29,,"-1,011,132.99"
,IN,AR,30327908,1005,100,,Invoice,,,,,,02/10/2018,02/10/2018,0.00,,12.46,,"-1,011,145.45"
,IN,AR,30327917,1005,100,,Invoice,,,,,,02/10/2018,02/10/2018,0.00,,13.22,,"-1,011,158.67"
,IN,AR,30327918,1005,100,,Invoice,,,,,,02/10/2018,02/10/2018,0.00,,2.39,,"-1,011,161.06"
,IN,AR,30327919,1005,100,,Invoice,,,,,,02/10/2018,02/10/2018,0.00,,15.25,,"-1,011,176.31"
,IN,AR,30327921,1005,100,,Invoice,,,,,,02/10/2018,02/10/2018,0.00,,10.53,,"-1,011,186.84"
,IN,AR,30327922,1005,100,,Invoice,,,,,,02/10/2018,02/10/2018,0.00,,10.93,,"-1,011,197.77"
,IN,AR,30327926,1005,100,,Invoice,,,,,,02/10/2018,02/10/2018,0.00,,6.36,,"-1,011,204.13"
,IN,AR,30327938,1005,100,,Invoice,,,,,,02/10/2018,02/10/2018,0.00,,2.12,,"-1,011,206.25"
,IN,AR,30327945,1005,100,,Invoice,,,,,,02/10/2018,02/10/2018,0.00,,364.41,,"-1,011,570.66"
,IN,AR,30327955,1005,100,,Invoice,,,,,,02/10/2018,02/10/2018,0.00,,24.56,,"-1,011,595.22"
,IN,AR,30327961,1005,100,,Invoice,,,,,,02/10/2018,02/10/2018,0.00,,8.26,,"-1,011,603.48"
,IN,AR,30327964,1005,100,,Invoice,,,,,,02/10/2018,02/10/2018,0.00,,8.39,,"-1,011,611.87"
,IN,AR,30327966,1005,100,,Invoice,,,,,,02/10/2018,02/10/2018,0.00,,8.78,,"-1,011,620.65"
,IN,AR,30327971,1005,100,,Invoice,,,,,,02/10/2018,02/10/2018,0.00,,29.15,,"-1,011,649.80"
,IN,AR,30327981,1005,100,,Invoice,,,,,,02/10/2018,02/10/2018,0.00,,18.22,,"-1,011,668.02"
,IN,AR,30327982,1005,100,,Invoice,,,,,,02/10/2018,02/10/2018,0.00,,25.73,,"-1,011,693.75"
,IN,AR,30327985,1005,100,,Invoice,,,,,,02/10/2018,02/10/2018,0.00,,32.16,,"-1,011,725.91"
,IN,AR,30327989,1005,100,,Invoice,,,,,,02/10/2018,02/10/2018,0.00,,5.29,,"-1,011,731.20"
,IN,AR,30327990,1005,100,,Invoice,,,,,,02/10/2018,02/10/2018,0.00,,3.53,,"-1,011,734.73"
,IN,AR,30328001,1005,100,,Invoice,,,,,,02/10/2018,02/10/2018,0.00,,2.58,,"-1,011,737.31"
,IN,AR,30328025,1005,100,,Invoice,,,,,,02/10/2018,02/10/2018,0.00,,23.90,,"-1,011,761.21"
,IN,AR,30328026,1005,100,,Invoice,,,,,,02/10/2018,02/10/2018,0.00,,15.93,,"-1,011,777.14"
,IN,AR,30328027,1005,100,,Invoice,,,,,,02/10/2018,02/10/2018,0.00,,3.98,,"-1,011,781.12"
,IN,AR,30328028,1005,100,,Invoice,,,,,,02/10/2018,02/10/2018,0.00,,11.95,,"-1,011,793.07"
,IN,AR,30328034,1005,100,,Invoice,,,,,,02/10/2018,02/10/2018,0.00,,34.07,,"-1,011,827.14"
,IN,AR,30328055,1005,100,,Invoice,,,,,,02/10/2018,02/10/2018,0.00,,209.17,,"-1,012,036.31"
,IN,AR,30328067,1005,100,,Invoice,,,,,,02/10/2018,02/10/2018,0.00,,2.54,,"-1,012,038.85"
,IN,AR,30328074,1005,100,,Invoice,,,,,,02/10/2018,02/10/2018,0.00,,22.01,,"-1,012,060.86"
,IN,AR,30328106,1005,100,,Invoice,,,,,,02/10/2018,02/10/2018,0.00,,12.85,,"-1,012,073.71"
,IN,AR,30328107,1005,100,,Invoice,,,,,,02/10/2018,02/10/2018,0.00,,108.00,,"-1,012,181.71"
,IN,AR,30328112,1005,100,,Invoice,,,,,,02/10/2018,02/10/2018,0.00,,30.85,,"-1,012,212.56"
,IN,AR,30328127,1005,100,,Invoice,,,,,,02/10/2018,02/10/2018,0.00,,3.64,,"-1,012,216.20"
,IN,AR,30328144,1005,100,,Invoice,,,,,,02/10/2018,02/10/2018,0.00,,100.34,,"-1,012,316.54"
,IN,AR,30328147,1005,100,,Invoice,,,,,,02/10/2018,02/10/2018,0.00,,21.36,,"-1,012,337.90"
,IN,AR,30328155,1005,100,,Invoice,,,,,,02/10/2018,02/10/2018,0.00,,14.24,,"-1,012,352.14"
,IN,AR,30328163,1005,100,,Invoice,,,,,,02/10/2018,02/10/2018,0.00,,7.29,,"-1,012,359.43"
,IN,AR,30328169,1005,100,,Invoice,,,,,,02/10/2018,02/10/2018,0.00,,5.26,,"-1,012,364.69"
,IN,AR,30328171,1005,100,,Invoice,,,,,,02/10/2018,02/10/2018,0.00,,8.00,,"-1,012,372.69"
,IN,AR,30328173,1005,100,,Invoice,,,,,,02/10/2018,02/10/2018,0.00,,2.97,,"-1,012,375.66"
,IN,AR,30328176,1005,100,,Invoice,,,,,,02/10/2018,02/10/2018,0.00,,78.66,,"-1,012,454.32"
,IN,AR,30328178,1005,100,,Invoice,,,,,,02/10/2018,02/10/2018,0.00,,3.64,,"-1,012,457.96"
,IN,AR,30328180,1005,100,,Invoice,,,,,,02/10/2018,02/10/2018,0.00,,29.15,,"-1,012,487.11"
,IN,AR,30328183,1005,100,,Invoice,,,,,,02/10/2018,02/10/2018,0.00,,8.77,,"-1,012,495.88"
,IN,AR,30328191,1005,100,,Invoice,,,,,,02/10/2018,02/10/2018,0.00,,29.15,,"-1,012,525.03"
,IN,AR,30328195,1005,100,,Invoice,,,,,,02/10/2018,02/10/2018,0.00,,14.58,,"-1,012,539.61"
,IN,AR,30328196,1005,100,,Invoice,,,,,,02/10/2018,02/10/2018,0.00,,7.29,,"-1,012,546.90"
,IN,AR,30328230,1005,100,,Invoice,,,,,,02/10/2018,02/10/2018,0.00,,4.15,,"-1,012,551.05"
,IN,AR,30328231,1005,100,,Invoice,,,,,,02/10/2018,02/10/2018,0.00,,4.15,,"-1,012,555.20"
,IN,AR,30328244,1005,100,,Invoice,,,,,,02/10/2018,02/10/2018,0.00,,16.91,,"-1,012,572.11"
,IN,AR,30328245,1005,100,,Invoice,,,,,,02/10/2018,02/10/2018,0.00,,14.58,,"-1,012,586.69"
,IN,AR,30328273,1005,100,,Invoice,,,,,,02/10/2018,02/10/2018,0.00,,29.15,,"-1,012,615.84"
,IN,AR,30328275,1005,100,,Invoice,,,,,,02/10/2018,02/10/2018,0.00,,6.00,,"-1,012,621.84"
,IN,AR,30328276,1005,100,,Invoice,,,,,,02/10/2018,02/10/2018,0.00,,100.12,,"-1,012,721.96"
,IN,AR,30328281,1005,100,,Invoice,,,,,,02/10/2018,02/10/2018,0.00,,3.64,,"-1,012,725.60"
,IN,AR,30328285,1005,100,,Invoice,,,,,,02/10/2018,02/10/2018,0.00,,2.97,,"-1,012,728.57"
,IN,AR,30328292,1005,100,,Invoice,,,,,,02/10/2018,02/10/2018,0.00,,2.12,,"-1,012,730.69"
,CS,AR,32009449,1005,100,,Cash sale,,,,,,03/10/2018,03/10/2018,0.00,,3.64,,"-1,012,734.33"
,CS,AR,32009450,1005,100,,Cash sale,,,,,,03/10/2018,03/10/2018,0.00,,10.03,,"-1,012,744.36"
,CS,AR,32009464,1005,100,,Cash sale,,,,,,03/10/2018,03/10/2018,0.00,,3.64,,"-1,012,748.00"
,CS,AR,32009467,1005,100,,Cash sale,,,,,,03/10/2018,03/10/2018,0.00,,14.58,,"-1,012,762.58"
,CS,AR,32009471,1005,100,,Cash sale,,,,,,03/10/2018,03/10/2018,0.00,,3.64,,"-1,012,766.22"
,CS,AR,32009473,1005,100,,Cash sale,,,,,,03/10/2018,03/10/2018,0.00,,3.64,,"-1,012,769.86"
,CS,AR,32009479,1005,100,,Cash sale,,,,,,03/10/2018,03/10/2018,0.00,,7.29,,"-1,012,777.15"
,CS,AR,32009480,1005,100,,Cash sale,,,,,,03/10/2018,03/10/2018,0.00,,10.93,,"-1,012,788.08"
,CS,AR,32009489,1005,100,,Cash sale,,,,,,03/10/2018,03/10/2018,0.00,,7.29,,"-1,012,795.37"
,CS,AR,32009491,1005,100,,Cash sale,,,,,,03/10/2018,03/10/2018,0.00,,3.64,,"-1,012,799.01"
,CS,AR,32009492,1005,100,,Cash sale,,,,,,03/10/2018,03/10/2018,0.00,,3.64,,"-1,012,802.65"
,CS,AR,32009501,1005,100,,Cash sale,,,,,,03/10/2018,03/10/2018,0.00,,5.86,,"-1,012,808.51"
,CS,AR,32009509,1005,100,,Cash sale,,,,,,03/10/2018,03/10/2018,0.00,,5.17,,"-1,012,813.68"
,CS,AR,32009521,1005,100,,Cash sale,,,,,,03/10/2018,03/10/2018,0.00,,10.34,,"-1,012,824.02"
,CS,AR,32009524,1005,100,,Cash sale,,,,,,03/10/2018,03/10/2018,0.00,,7.29,,"-1,012,831.31"
,CS,AR,32009527,1005,100,,Cash sale,,,,,,03/10/2018,03/10/2018,0.00,,18.05,,"-1,012,849.36"
,CS,AR,32009533,1005,100,,Cash sale,,,,,,03/10/2018,03/10/2018,0.00,,21.86,,"-1,012,871.22"
,CS,AR,32009538,1005,100,,Cash sale,,,,,,03/10/2018,03/10/2018,0.00,,15.25,,"-1,012,886.47"
,CS,AR,32009553,1005,100,,Cash sale,,,,,,03/10/2018,03/10/2018,0.00,,7.75,,"-1,012,894.22"
,CS,AR,32009567,1005,100,,Cash sale,,,,,,03/10/2018,03/10/2018,0.00,,7.29,,"-1,012,901.51"
,CS,AR,32009570,1005,100,,Cash sale,,,,,,03/10/2018,03/10/2018,0.00,,3.64,,"-1,012,905.15"
,CS,AR,32009571,1005,100,,Cash sale,,,,,,03/10/2018,03/10/2018,0.00,,7.29,,"-1,012,912.44"
,CS,AR,32009576,1005,100,,Cash sale,,,,,,03/10/2018,03/10/2018,0.00,,10.93,,"-1,012,923.37"
,CS,AR,32009584,1005,100,,Cash sale,,,,,,03/10/2018,03/10/2018,0.00,,2.58,,"-1,012,925.95"
,CS,AR,32009586,1005,100,,Cash sale,,,,,,03/10/2018,03/10/2018,0.00,,3.64,,"-1,012,929.59"
,CS,AR,32009591,1005,100,,Cash sale,,,,,,03/10/2018,03/10/2018,0.00,,8.02,,"-1,012,937.61"
,CS,AR,32009598,1005,100,,Cash sale,,,,,,03/10/2018,03/10/2018,0.00,,16.61,,"-1,012,954.22"
,CS,AR,32009599,1005,100,,Cash sale,,,,,,03/10/2018,03/10/2018,0.00,,11.86,,"-1,012,966.08"
,CS,AR,32009601,1005,100,,Cash sale,,,,,,03/10/2018,03/10/2018,0.00,,7.29,,"-1,012,973.37"
,CS,AR,32009605,1005,100,,Cash sale,,,,,,03/10/2018,03/10/2018,0.00,,7.29,,"-1,012,980.66"
,CS,AR,32009609,1005,100,,Cash sale,,,,,,03/10/2018,03/10/2018,0.00,,7.75,,"-1,012,988.41"
,CS,AR,32009613,1005,100,,Cash sale,,,,,,03/10/2018,03/10/2018,0.00,,7.29,,"-1,012,995.70"
,CS,AR,32009614,1005,100,,Cash sale,,,,,,03/10/2018,03/10/2018,0.00,,6.86,,"-1,013,002.56"
,CS,AR,32009627,1005,100,,Cash sale,,,,,,03/10/2018,03/10/2018,0.00,,9.84,,"-1,013,012.40"
,CS,AR,32009629,1005,100,,Cash sale,,,,,,03/10/2018,03/10/2018,0.00,,7.29,,"-1,013,019.69"
,CS,AR,32009631,1005,100,,Cash sale,,,,,,03/10/2018,03/10/2018,0.00,,9.15,,"-1,013,028.84"
,CS,AR,32009635,1005,100,,Cash sale,,,,,,03/10/2018,03/10/2018,0.00,,9.10,,"-1,013,037.94"
,CS,AR,32009638,1005,100,,Cash sale,,,,,,03/10/2018,03/10/2018,0.00,,7.29,,"-1,013,045.23"
,CS,AR,32009640,1005,100,,Cash sale,,,,,,03/10/2018,03/10/2018,0.00,,5.47,,"-1,013,050.70"
,CS,AR,32009646,1005,100,,Cash sale,,,,,,03/10/2018,03/10/2018,0.00,,9.03,,"-1,013,059.73"
,CS,AR,32009660,1005,100,,Cash sale,,,,,,03/10/2018,03/10/2018,0.00,,7.29,,"-1,013,067.02"
,CS,AR,32009690,1005,100,,Cash sale,,,,,,03/10/2018,03/10/2018,0.00,,10.93,,"-1,013,077.95"
,CS,AR,32009692,1005,100,,Cash sale,,,,,,03/10/2018,03/10/2018,0.00,,5.47,,"-1,013,083.42"
,CS,AR,32009703,1005,100,,Cash sale,,,,,,03/10/2018,03/10/2018,0.00,,7.29,,"-1,013,090.71"
,IN,AR,30327705,1005,100,,Invoice,,,,,,03/10/2018,03/10/2018,0.00,,17.80,,"-1,013,108.51"
,IN,AR,30327714,1005,100,,Invoice,,,,,,03/10/2018,03/10/2018,0.00,,14.58,,"-1,013,123.09"
,IN,AR,30327716,1005,100,,Invoice,,,,,,03/10/2018,03/10/2018,0.00,,51.25,,"-1,013,174.34"
,IN,AR,30327717,1005,100,,Invoice,,,,,,03/10/2018,03/10/2018,0.00,,12.20,,"-1,013,186.54"
,IN,AR,30327725,1005,100,,Invoice,,,,,,03/10/2018,03/10/2018,0.00,,6.02,,"-1,013,192.56"
,IN,AR,30327726,1005,100,,Invoice,,,,,,03/10/2018,03/10/2018,0.00,,21.69,,"-1,013,214.25"
,IN,AR,30327727,1005,100,,Invoice,,,,,,03/10/2018,03/10/2018,0.00,,18.22,,"-1,013,232.47"
,IN,AR,30327728,1005,100,,Invoice,,,,,,03/10/2018,03/10/2018,0.00,,15.93,,"-1,013,248.40"
,IN,AR,30327732,1005,100,,Invoice,,,,,,03/10/2018,03/10/2018,0.00,,28.90,,"-1,013,277.30"
,IN,AR,30327733,1005,100,,Invoice,,,,,,03/10/2018,03/10/2018,0.00,,78.81,,"-1,013,356.11"
,IN,AR,30327734,1005,100,,Invoice,,,,,,03/10/2018,03/10/2018,0.00,,29.15,,"-1,013,385.26"
,IN,AR,30327735,1005,100,,Invoice,,,,,,03/10/2018,03/10/2018,0.00,,16.91,,"-1,013,402.17"
,IN,AR,30327750,1005,100,,Invoice,,,,,,03/10/2018,03/10/2018,0.00,,3.98,,"-1,013,406.15"
,IN,AR,30327754,1005,100,,Invoice,,,,,,03/10/2018,03/10/2018,0.00,,73.56,,"-1,013,479.71"
,IN,AR,30327770,1005,100,,Invoice,,,,,,03/10/2018,03/10/2018,0.00,,10.93,,"-1,013,490.64"
,IN,AR,30327772,1005,100,,Invoice,,,,,,03/10/2018,03/10/2018,0.00,,14.58,,"-1,013,505.22"
,IN,AR,30327776,1005,100,,Invoice,,,,,,03/10/2018,03/10/2018,0.00,,12.00,,"-1,013,517.22"
,IN,AR,30327783,1005,100,,Invoice,,,,,,03/10/2018,03/10/2018,0.00,,34.00,,"-1,013,551.22"
,IN,AR,30327795,1005,100,,Invoice,,,,,,03/10/2018,03/10/2018,0.00,,174.64,,"-1,013,725.86"
,IN,AR,30327798,1005,100,,Invoice,,,,,,03/10/2018,03/10/2018,0.00,,748.42,,"-1,014,474.28"
,IN,AR,30327806,1005,100,,Invoice,,,,,,03/10/2018,03/10/2018,0.00,,12.03,,"-1,014,486.31"
,IN,AR,30327810,1005,100,,Invoice,,,,,,03/10/2018,03/10/2018,0.00,,10.93,,"-1,014,497.24"
,IN,AR,30327821,1005,100,,Invoice,,,,,,03/10/2018,03/10/2018,0.00,,182.20,,"-1,014,679.44"
,IN,AR,30327826,1005,100,,Invoice,,,,,,03/10/2018,03/10/2018,0.00,,364.41,,"-1,015,043.85"
,IN,AR,30327832,1005,100,,Invoice,,,,,,03/10/2018,03/10/2018,0.00,,25.42,,"-1,015,069.27"
,IN,AR,30327835,1005,100,,Invoice,,,,,,03/10/2018,03/10/2018,0.00,,4.24,,"-1,015,073.51"
,IN,AR,30327836,1005,100,,Invoice,,,,,,03/10/2018,03/10/2018,0.00,,2.12,,"-1,015,075.63"
,IN,AR,30327839,1005,100,,Invoice,,,,,,03/10/2018,03/10/2018,0.00,,4.24,,"-1,015,079.87"
,IN,AR,30327842,1005,100,,Invoice,,,,,,03/10/2018,03/10/2018,0.00,,8.39,,"-1,015,088.26"
,IN,AR,30327851,1005,100,,Invoice,,,,,,03/10/2018,03/10/2018,0.00,,14.58,,"-1,015,102.84"
,IN,AR,30327857,1005,100,,Invoice,,,,,,03/10/2018,03/10/2018,0.00,,26.29,,"-1,015,129.13"
,IN,AR,30327861,1005,100,,Invoice,,,,,,03/10/2018,03/10/2018,0.00,,57.42,,"-1,015,186.55"
,IN,AR,30327867,1005,100,,Invoice,,,,,,03/10/2018,03/10/2018,0.00,,6.43,,"-1,015,192.98"
,IN,AR,30327873,1005,100,,Invoice,,,,,,03/10/2018,03/10/2018,0.00,,12.88,,"-1,015,205.86"
,IN,AR,30327880,1005,100,,Invoice,,,,,,03/10/2018,03/10/2018,0.00,,10.34,,"-1,015,216.20"
,IN,AR,30327883,1005,100,,Invoice,,,,,,03/10/2018,03/10/2018,0.00,,45.13,,"-1,015,261.33"
,IN,AR,30327884,1005,100,,Invoice,,,,,,03/10/2018,03/10/2018,0.00,,108.03,,"-1,015,369.36"
,IN,AR,30327888,1005,100,,Invoice,,,,,,03/10/2018,03/10/2018,0.00,,5.08,,"-1,015,374.44"
,IN,AR,30327889,1005,100,,Invoice,,,,,,03/10/2018,03/10/2018,0.00,,7.63,,"-1,015,382.07"
,IN,AR,30327895,1005,100,,Invoice,,,,,,03/10/2018,03/10/2018,0.00,,14.71,,"-1,015,396.78"
,IN,AR,30327899,1005,100,,Invoice,,,,,,03/10/2018,03/10/2018,0.00,,21.86,,"-1,015,418.64"
,IN,AR,30327907,1005,100,,Invoice,,,,,,03/10/2018,03/10/2018,0.00,,18.17,,"-1,015,436.81"
,IN,AR,30327920,1005,100,,Invoice,,,,,,03/10/2018,03/10/2018,0.00,,2.54,,"-1,015,439.35"
,IN,AR,30327924,1005,100,,Invoice,,,,,,03/10/2018,03/10/2018,0.00,,14.83,,"-1,015,454.18"
,IN,AR,30327925,1005,100,,Invoice,,,,,,03/10/2018,03/10/2018,0.00,,14.58,,"-1,015,468.76"
,IN,AR,30327927,1005,100,,Invoice,,,,,,03/10/2018,03/10/2018,0.00,,54.66,,"-1,015,523.42"
,IN,AR,30327928,1005,100,,Invoice,,,,,,03/10/2018,03/10/2018,0.00,,8.47,,"-1,015,531.89"
,IN,AR,30327935,1005,100,,Invoice,,,,,,03/10/2018,03/10/2018,0.00,,22.44,,"-1,015,554.33"
,IN,AR,30327939,1005,100,,Invoice,,,,,,03/10/2018,03/10/2018,0.00,,26.69,,"-1,015,581.02"
,IN,AR,30327946,1005,100,,Invoice,,,,,,03/10/2018,03/10/2018,0.00,,14.58,,"-1,015,595.60"
,IN,AR,30327948,1005,100,,Invoice,,,,,,03/10/2018,03/10/2018,0.00,,21.86,,"-1,015,617.46"
,IN,AR,30327950,1005,100,,Invoice,,,,,,03/10/2018,03/10/2018,0.00,,27.97,,"-1,015,645.43"
,IN,AR,30327952,1005,100,,Invoice,,,,,,03/10/2018,03/10/2018,0.00,,12.71,,"-1,015,658.14"
,IN,AR,30327957,1005,100,,Invoice,,,,,,03/10/2018,03/10/2018,0.00,,8.14,,"-1,015,666.28"
,IN,AR,30327963,1005,100,,Invoice,,,,,,03/10/2018,03/10/2018,0.00,,18.22,,"-1,015,684.50"
,IN,AR,30327965,1005,100,,Invoice,,,,,,03/10/2018,03/10/2018,0.00,,7.75,,"-1,015,692.25"
,IN,AR,30327973,1005,100,,Invoice,,,,,,03/10/2018,03/10/2018,0.00,,29.15,,"-1,015,721.40"
,IN,AR,30327974,1005,100,,Invoice,,,,,,03/10/2018,03/10/2018,0.00,,21.06,,"-1,015,742.46"
,IN,AR,30327986,1005,100,,Invoice,,,,,,03/10/2018,03/10/2018,0.00,,10.68,,"-1,015,753.14"
,IN,AR,30327991,1005,100,,Invoice,,,,,,03/10/2018,03/10/2018,0.00,,3.53,,"-1,015,756.67"
,IN,AR,30327992,1005,100,,Invoice,,,,,,03/10/2018,03/10/2018,0.00,,12.33,,"-1,015,769.00"
,IN,AR,30327994,1005,100,,Invoice,,,,,,03/10/2018,03/10/2018,0.00,,9.03,,"-1,015,778.03"
,IN,AR,30328002,1005,100,,Invoice,,,,,,03/10/2018,03/10/2018,0.00,,25.85,,"-1,015,803.88"
,IN,AR,30328005,1005,100,,Invoice,,,,,,03/10/2018,03/10/2018,0.00,,8.78,,"-1,015,812.66"
,IN,AR,30328006,1005,100,,Invoice,,,,,,03/10/2018,03/10/2018,0.00,,16.01,,"-1,015,828.67"
,IN,AR,30328007,1005,100,,Invoice,,,,,,03/10/2018,03/10/2018,0.00,,36.44,,"-1,015,865.11"
,IN,AR,30328008,1005,100,,Invoice,,,,,,03/10/2018,03/10/2018,0.00,,25.51,,"-1,015,890.62"
,IN,AR,30328016,1005,100,,Invoice,,,,,,03/10/2018,03/10/2018,0.00,,12.71,,"-1,015,903.33"
,IN,AR,30328019,1005,100,,Invoice,,,,,,03/10/2018,03/10/2018,0.00,,10.93,,"-1,015,914.26"
,IN,AR,30328033,1005,100,,Invoice,,,,,,03/10/2018,03/10/2018,0.00,,4.01,,"-1,015,918.27"
,IN,AR,30328036,1005,100,,Invoice,,,,,,03/10/2018,03/10/2018,0.00,,30.00,,"-1,015,948.27"
,IN,AR,30328037,1005,100,,Invoice,,,,,,03/10/2018,03/10/2018,0.00,,42.00,,"-1,015,990.27"
,IN,AR,30328041,1005,100,,Invoice,,,,,,03/10/2018,03/10/2018,0.00,,40.08,,"-1,016,030.35"
,IN,AR,30328044,1005,100,,Invoice,,,,,,03/10/2018,03/10/2018,0.00,,22.05,,"-1,016,052.40"
,IN,AR,30328046,1005,100,,Invoice,,,,,,03/10/2018,03/10/2018,0.00,,14.58,,"-1,016,066.98"
,IN,AR,30328061,1005,100,,Invoice,,,,,,03/10/2018,03/10/2018,0.00,,5.09,,"-1,016,072.07"
,IN,AR,30328062,1005,100,,Invoice,,,,,,03/10/2018,03/10/2018,0.00,,41.39,,"-1,016,113.46"
,IN,AR,30328068,1005,100,,Invoice,,,,,,03/10/2018,03/10/2018,0.00,,7.63,,"-1,016,121.09"
,IN,AR,30328076,1005,100,,Invoice,,,,,,03/10/2018,03/10/2018,0.00,,8.00,,"-1,016,129.09"
,IN,AR,30328078,1005,100,,Invoice,,,,,,03/10/2018,03/10/2018,0.00,,62.46,,"-1,016,191.55"
,IN,AR,30328080,1005,100,,Invoice,,,,,,03/10/2018,03/10/2018,0.00,,3.02,,"-1,016,194.57"
,IN,AR,30328086,1005,100,,Invoice,,,,,,03/10/2018,03/10/2018,0.00,,33.64,,"-1,016,228.21"
,IN,AR,30328087,1005,100,,Invoice,,,,,,03/10/2018,03/10/2018,0.00,,8.41,,"-1,016,236.62"
,IN,AR,30328091,1005,100,,Invoice,,,,,,03/10/2018,03/10/2018,0.00,,22.42,,"-1,016,259.04"
,IN,AR,30328093,1005,100,,Invoice,,,,,,03/10/2018,03/10/2018,0.00,,2.33,,"-1,016,261.37"
,IN,AR,30328129,1005,100,,Invoice,,,,,,03/10/2018,03/10/2018,0.00,,10.93,,"-1,016,272.30"
,IN,AR,30328136,1005,100,,Invoice,,,,,,03/10/2018,03/10/2018,0.00,,4.78,,"-1,016,277.08"
,IN,AR,30328148,1005,100,,Invoice,,,,,,03/10/2018,03/10/2018,0.00,,49.83,,"-1,016,326.91"
,IN,AR,30328158,1005,100,,Invoice,,,,,,03/10/2018,03/10/2018,0.00,,46.78,,"-1,016,373.69"
,IN,AR,30328168,1005,100,,Invoice,,,,,,03/10/2018,03/10/2018,0.00,,5.26,,"-1,016,378.95"
,IN,AR,30328170,1005,100,,Invoice,,,,,,03/10/2018,03/10/2018,0.00,,11.02,,"-1,016,389.97"
,IN,AR,30328190,1005,100,,Invoice,,,,,,03/10/2018,03/10/2018,0.00,,14.83,,"-1,016,404.80"
,IN,AR,30328193,1005,100,,Invoice,,,,,,03/10/2018,03/10/2018,0.00,,7.53,,"-1,016,412.33"
,IN,AR,30328200,1005,100,,Invoice,,,,,,03/10/2018,03/10/2018,0.00,,18.33,,"-1,016,430.66"
,IN,AR,30328201,1005,100,,Invoice,,,,,,03/10/2018,03/10/2018,0.00,,22.37,,"-1,016,453.03"
,IN,AR,30328204,1005,100,,Invoice,,,,,,03/10/2018,03/10/2018,0.00,,12.25,,"-1,016,465.28"
,IN,AR,30328208,1005,100,,Invoice,,,,,,03/10/2018,03/10/2018,0.00,,21.86,,"-1,016,487.14"
,IN,AR,30328210,1005,100,,Invoice,,,,,,03/10/2018,03/10/2018,0.00,,10.99,,"-1,016,498.13"
,IN,AR,30328217,1005,100,,Invoice,,,,,,03/10/2018,03/10/2018,0.00,,11.44,,"-1,016,509.57"
,IN,AR,30328232,1005,100,,Invoice,,,,,,03/10/2018,03/10/2018,0.00,,66.44,,"-1,016,576.01"
,IN,AR,30328233,1005,100,,Invoice,,,,,,03/10/2018,03/10/2018,0.00,,16.61,,"-1,016,592.62"
,IN,AR,30328234,1005,100,,Invoice,,,,,,03/10/2018,03/10/2018,0.00,,6.23,,"-1,016,598.85"
,IN,AR,30328235,1005,100,,Invoice,,,,,,03/10/2018,03/10/2018,0.00,,4.15,,"-1,016,603.00"
,IN,AR,30328241,1005,100,,Invoice,,,,,,03/10/2018,03/10/2018,0.00,,5.08,,"-1,016,608.08"
,IN,AR,30328246,1005,100,,Invoice,,,,,,03/10/2018,03/10/2018,0.00,,24.27,,"-1,016,632.35"
,IN,AR,30328259,1005,100,,Invoice,,,,,,03/10/2018,03/10/2018,0.00,,29.15,,"-1,016,661.50"
,IN,AR,30328272,1005,100,,Invoice,,,,,,03/10/2018,03/10/2018,0.00,,11.19,,"-1,016,672.69"
,IN,AR,30328279,1005,100,,Invoice,,,,,,03/10/2018,03/10/2018,0.00,,3.64,,"-1,016,676.33"
,IN,AR,30328297,1005,100,,Invoice,,,,,,03/10/2018,03/10/2018,0.00,,3.64,,"-1,016,679.97"
,IN,AR,30328302,1005,100,,Invoice,,,,,,03/10/2018,03/10/2018,0.00,,10.78,,"-1,016,690.75"
,IN,AR,30328304,1005,100,,Invoice,,,,,,03/10/2018,03/10/2018,0.00,,10.93,,"-1,016,701.68"
,CN,AR,31019124,1005,100,,Credit Note,,,,,,04/10/2018,04/10/2018,182.20,,0.00,,"-1,016,519.48"
,CN,AR,31019125,1005,100,,Credit Note,,,,,,04/10/2018,04/10/2018,3.64,,0.00,,"-1,016,515.84"
,CN,AR,31019176,1005,100,,Credit Note,,,,,,04/10/2018,04/10/2018,364.41,,0.00,,"-1,016,151.43"
,CN,AR,31019184,1005,100,,Credit Note,,,,,,04/10/2018,04/10/2018,10.93,,0.00,,"-1,016,140.50"
,CS,AR,32009446,1005,100,,Cash sale,,,,,,04/10/2018,04/10/2018,0.00,,15.04,,"-1,016,155.54"
,CS,AR,32009454,1005,100,,Cash sale,,,,,,04/10/2018,04/10/2018,0.00,,3.64,,"-1,016,159.18"
,CS,AR,32009455,1005,100,,Cash sale,,,,,,04/10/2018,04/10/2018,0.00,,11.36,,"-1,016,170.54"
,CS,AR,32009465,1005,100,,Cash sale,,,,,,04/10/2018,04/10/2018,0.00,,7.29,,"-1,016,177.83"
,CS,AR,32009474,1005,100,,Cash sale,,,,,,04/10/2018,04/10/2018,0.00,,35.59,,"-1,016,213.42"
,CS,AR,32009477,1005,100,,Cash sale,,,,,,04/10/2018,04/10/2018,0.00,,3.64,,"-1,016,217.06"
,CS,AR,32009484,1005,100,,Cash sale,,,,,,04/10/2018,04/10/2018,0.00,,3.64,,"-1,016,220.70"
,CS,AR,32009486,1005,100,,Cash sale,,,,,,04/10/2018,04/10/2018,0.00,,3.64,,"-1,016,224.34"
,CS,AR,32009498,1005,100,,Cash sale,,,,,,04/10/2018,04/10/2018,0.00,,3.01,,"-1,016,227.35"
,CS,AR,32009502,1005,100,,Cash sale,,,,,,04/10/2018,04/10/2018,0.00,,10.93,,"-1,016,238.28"
,CS,AR,32009505,1005,100,,Cash sale,,,,,,04/10/2018,04/10/2018,0.00,,3.64,,"-1,016,241.92"
,CS,AR,32009507,1005,100,,Cash sale,,,,,,04/10/2018,04/10/2018,0.00,,7.29,,"-1,016,249.21"
,CS,AR,32009526,1005,100,,Cash sale,,,,,,04/10/2018,04/10/2018,0.00,,13.74,,"-1,016,262.95"
,CS,AR,32009536,1005,100,,Cash sale,,,,,,04/10/2018,04/10/2018,0.00,,18.22,,"-1,016,281.17"
,CS,AR,32009543,1005,100,,Cash sale,,,,,,04/10/2018,04/10/2018,0.00,,23.39,,"-1,016,304.56"
,CS,AR,32009545,1005,100,,Cash sale,,,,,,04/10/2018,04/10/2018,0.00,,4.32,,"-1,016,308.88"
,CS,AR,32009548,1005,100,,Cash sale,,,,,,04/10/2018,04/10/2018,0.00,,6.86,,"-1,016,315.74"
,CS,AR,32009558,1005,100,,Cash sale,,,,,,04/10/2018,04/10/2018,0.00,,16.53,,"-1,016,332.27"
,CS,AR,32009569,1005,100,,Cash sale,,,,,,04/10/2018,04/10/2018,0.00,,33.56,,"-1,016,365.83"
,CS,AR,32009578,1005,100,,Cash sale,,,,,,04/10/2018,04/10/2018,0.00,,9.66,,"-1,016,375.49"
,CS,AR,32009593,1005,100,,Cash sale,,,,,,04/10/2018,04/10/2018,0.00,,13.98,,"-1,016,389.47"
,CS,AR,32009597,1005,100,,Cash sale,,,,,,04/10/2018,04/10/2018,0.00,,7.29,,"-1,016,396.76"
,CS,AR,32009607,1005,100,,Cash sale,,,,,,04/10/2018,04/10/2018,0.00,,3.64,,"-1,016,400.40"
,CS,AR,32009611,1005,100,,Cash sale,,,,,,04/10/2018,04/10/2018,0.00,,18.22,,"-1,016,418.62"
,CS,AR,32009615,1005,100,,Cash sale,,,,,,04/10/2018,04/10/2018,0.00,,9.84,,"-1,016,428.46"
,CS,AR,32009619,1005,100,,Cash sale,,,,,,04/10/2018,04/10/2018,0.00,,7.29,,"-1,016,435.75"
,CS,AR,32009621,1005,100,,Cash sale,,,,,,04/10/2018,04/10/2018,0.00,,7.29,,"-1,016,443.04"
,CS,AR,32009623,1005,100,,Cash sale,,,,,,04/10/2018,04/10/2018,0.00,,5.93,,"-1,016,448.97"
,CS,AR,32009628,1005,100,,Cash sale,,,,,,04/10/2018,04/10/2018,0.00,,3.64,,"-1,016,452.61"
,CS,AR,32009634,1005,100,,Cash sale,,,,,,04/10/2018,04/10/2018,0.00,,14.58,,"-1,016,467.19"
,CS,AR,32009645,1005,100,,Cash sale,,,,,,04/10/2018,04/10/2018,0.00,,54.64,,"-1,016,521.83"
,CS,AR,32009668,1005,100,,Cash sale,,,,,,04/10/2018,04/10/2018,0.00,,10.93,,"-1,016,532.76"
,CS,AR,32009670,1005,100,,Cash sale,,,,,,04/10/2018,04/10/2018,0.00,,10.93,,"-1,016,543.69"
,CS,AR,32009671,1005,100,,Cash sale,,,,,,04/10/2018,04/10/2018,0.00,,5.86,,"-1,016,549.55"
,CS,AR,32009695,1005,100,,Cash sale,,,,,,04/10/2018,04/10/2018,0.00,,7.29,,"-1,016,556.84"
,CS,AR,32009697,1005,100,,Cash sale,,,,,,04/10/2018,04/10/2018,0.00,,29.15,,"-1,016,585.99"
,CS,AR,32009700,1005,100,,Cash sale,,,,,,04/10/2018,04/10/2018,0.00,,3.64,,"-1,016,589.63"
,CS,AR,32009701,1005,100,,Cash sale,,,,,,04/10/2018,04/10/2018,0.00,,7.29,,"-1,016,596.92"
,IN,AR,30327708,1005,100,,Invoice,,,,,,04/10/2018,04/10/2018,0.00,,3.64,,"-1,016,600.56"
,IN,AR,30327710,1005,100,,Invoice,,,,,,04/10/2018,04/10/2018,0.00,,28.47,,"-1,016,629.03"
,IN,AR,30327715,1005,100,,Invoice,,,,,,04/10/2018,04/10/2018,0.00,,7.29,,"-1,016,636.32"
,IN,AR,30327730,1005,100,,Invoice,,,,,,04/10/2018,04/10/2018,0.00,,10.93,,"-1,016,647.25"
,IN,AR,30327736,1005,100,,Invoice,,,,,,04/10/2018,04/10/2018,0.00,,10.93,,"-1,016,658.18"
,IN,AR,30327737,1005,100,,Invoice,,,,,,04/10/2018,04/10/2018,0.00,,182.20,,"-1,016,840.38"
,IN,AR,30327741,1005,100,,Invoice,,,,,,04/10/2018,04/10/2018,0.00,,419.07,,"-1,017,259.45"
,IN,AR,30327742,1005,100,,Invoice,,,,,,04/10/2018,04/10/2018,0.00,,3.64,,"-1,017,263.09"
,IN,AR,30327743,1005,100,,Invoice,,,,,,04/10/2018,04/10/2018,0.00,,419.07,,"-1,017,682.16"
,IN,AR,30327745,1005,100,,Invoice,,,,,,04/10/2018,04/10/2018,0.00,,163.98,,"-1,017,846.14"
,IN,AR,30327751,1005,100,,Invoice,,,,,,04/10/2018,04/10/2018,0.00,,3.98,,"-1,017,850.12"
,IN,AR,30327755,1005,100,,Invoice,,,,,,04/10/2018,04/10/2018,0.00,,61.69,,"-1,017,911.81"
,IN,AR,30327762,1005,100,,Invoice,,,,,,04/10/2018,04/10/2018,0.00,,48.00,,"-1,017,959.81"
,IN,AR,30327769,1005,100,,Invoice,,,,,,04/10/2018,04/10/2018,0.00,,36.44,,"-1,017,996.25"
,IN,AR,30327771,1005,100,,Invoice,,,,,,04/10/2018,04/10/2018,0.00,,7.29,,"-1,018,003.54"
,IN,AR,30327778,1005,100,,Invoice,,,,,,04/10/2018,04/10/2018,0.00,,3.64,,"-1,018,007.18"
,IN,AR,30327779,1005,100,,Invoice,,,,,,04/10/2018,04/10/2018,0.00,,3.64,,"-1,018,010.82"
,IN,AR,30327782,1005,100,,Invoice,,,,,,04/10/2018,04/10/2018,0.00,,7.78,,"-1,018,018.60"
,IN,AR,30327785,1005,100,,Invoice,,,,,,04/10/2018,04/10/2018,0.00,,80.68,,"-1,018,099.28"
,IN,AR,30327790,1005,100,,Invoice,,,,,,04/10/2018,04/10/2018,0.00,,18.22,,"-1,018,117.50"
,IN,AR,30327791,1005,100,,Invoice,,,,,,04/10/2018,04/10/2018,0.00,,38.44,,"-1,018,155.94"
,IN,AR,30327792,1005,100,,Invoice,,,,,,04/10/2018,04/10/2018,0.00,,21.86,,"-1,018,177.80"
,IN,AR,30327793,1005,100,,Invoice,,,,,,04/10/2018,04/10/2018,0.00,,54.66,,"-1,018,232.46"
,IN,AR,30327794,1005,100,,Invoice,,,,,,04/10/2018,04/10/2018,0.00,,14.19,,"-1,018,246.65"
,IN,AR,30327803,1005,100,,Invoice,,,,,,04/10/2018,04/10/2018,0.00,,38.00,,"-1,018,284.65"
,IN,AR,30327812,1005,100,,Invoice,,,,,,04/10/2018,04/10/2018,0.00,,7.29,,"-1,018,291.94"
,IN,AR,30327814,1005,100,,Invoice,,,,,,04/10/2018,04/10/2018,0.00,,7.97,,"-1,018,299.91"
,IN,AR,30327816,1005,100,,Invoice,,,,,,04/10/2018,04/10/2018,0.00,,25.51,,"-1,018,325.42"
,IN,AR,30327819,1005,100,,Invoice,,,,,,04/10/2018,04/10/2018,0.00,,31.50,,"-1,018,356.92"
,IN,AR,30327825,1005,100,,Invoice,,,,,,04/10/2018,04/10/2018,0.00,,6.02,,"-1,018,362.94"
,IN,AR,30327830,1005,100,,Invoice,,,,,,04/10/2018,04/10/2018,0.00,,3.64,,"-1,018,366.58"
,IN,AR,30327838,1005,100,,Invoice,,,,,,04/10/2018,04/10/2018,0.00,,18.31,,"-1,018,384.89"
,IN,AR,30327848,1005,100,,Invoice,,,,,,04/10/2018,04/10/2018,0.00,,7.29,,"-1,018,392.18"
,IN,AR,30327849,1005,100,,Invoice,,,,,,04/10/2018,04/10/2018,0.00,,22.37,,"-1,018,414.55"
,IN,AR,30327853,1005,100,,Invoice,,,,,,04/10/2018,04/10/2018,0.00,,21.51,,"-1,018,436.06"
,IN,AR,30327859,1005,100,,Invoice,,,,,,04/10/2018,04/10/2018,0.00,,27.12,,"-1,018,463.18"
,IN,AR,30327864,1005,100,,Invoice,,,,,,04/10/2018,04/10/2018,0.00,,7.63,,"-1,018,470.81"
,IN,AR,30327870,1005,100,,Invoice,,,,,,04/10/2018,04/10/2018,0.00,,21.51,,"-1,018,492.32"
,IN,AR,30327874,1005,100,,Invoice,,,,,,04/10/2018,04/10/2018,0.00,,12.88,,"-1,018,505.20"
,IN,AR,30327896,1005,100,,Invoice,,,,,,04/10/2018,04/10/2018,0.00,,5.17,,"-1,018,510.37"
,IN,AR,30327900,1005,100,,Invoice,,,,,,04/10/2018,04/10/2018,0.00,,18.05,,"-1,018,528.42"
,IN,AR,30327905,1005,100,,Invoice,,,,,,04/10/2018,04/10/2018,0.00,,25.51,,"-1,018,553.93"
,IN,AR,30327910,1005,100,,Invoice,,,,,,04/10/2018,04/10/2018,0.00,,30.51,,"-1,018,584.44"
,IN,AR,30327913,1005,100,,Invoice,,,,,,04/10/2018,04/10/2018,0.00,,17.50,,"-1,018,601.94"
,IN,AR,30327916,1005,100,,Invoice,,,,,,04/10/2018,04/10/2018,0.00,,10.93,,"-1,018,612.87"
,IN,AR,30327931,1005,100,,Invoice,,,,,,04/10/2018,04/10/2018,0.00,,8.17,,"-1,018,621.04"
,IN,AR,30327933,1005,100,,Invoice,,,,,,04/10/2018,04/10/2018,0.00,,13.73,,"-1,018,634.77"
,IN,AR,30327937,1005,100,,Invoice,,,,,,04/10/2018,04/10/2018,0.00,,3.64,,"-1,018,638.41"
,IN,AR,30327940,1005,100,,Invoice,,,,,,04/10/2018,04/10/2018,0.00,,35.59,,"-1,018,674.00"
,IN,AR,30327941,1005,100,,Invoice,,,,,,04/10/2018,04/10/2018,0.00,,14.00,,"-1,018,688.00"
,IN,AR,30327944,1005,100,,Invoice,,,,,,04/10/2018,04/10/2018,0.00,,14.58,,"-1,018,702.58"
,IN,AR,30327953,1005,100,,Invoice,,,,,,04/10/2018,04/10/2018,0.00,,18.22,,"-1,018,720.80"
,IN,AR,30327958,1005,100,,Invoice,,,,,,04/10/2018,04/10/2018,0.00,,6.97,,"-1,018,727.77"
,IN,AR,30327960,1005,100,,Invoice,,,,,,04/10/2018,04/10/2018,0.00,,8.77,,"-1,018,736.54"
,IN,AR,30327962,1005,100,,Invoice,,,,,,04/10/2018,04/10/2018,0.00,,27.54,,"-1,018,764.08"
,IN,AR,30327976,1005,100,,Invoice,,,,,,04/10/2018,04/10/2018,0.00,,12.03,,"-1,018,776.11"
,IN,AR,30327977,1005,100,,Invoice,,,,,,04/10/2018,04/10/2018,0.00,,8.25,,"-1,018,784.36"
,IN,AR,30327979,1005,100,,Invoice,,,,,,04/10/2018,04/10/2018,0.00,,11.64,,"-1,018,796.00"
,IN,AR,30327980,1005,100,,Invoice,,,,,,04/10/2018,04/10/2018,0.00,,7.63,,"-1,018,803.63"
,IN,AR,30327983,1005,100,,Invoice,,,,,,04/10/2018,04/10/2018,0.00,,18.05,,"-1,018,821.68"
,IN,AR,30327984,1005,100,,Invoice,,,,,,04/10/2018,04/10/2018,0.00,,8.00,,"-1,018,829.68"
,IN,AR,30327999,1005,100,,Invoice,,,,,,04/10/2018,04/10/2018,0.00,,4.54,,"-1,018,834.22"
,IN,AR,30328000,1005,100,,Invoice,,,,,,04/10/2018,04/10/2018,0.00,,22.51,,"-1,018,856.73"
,IN,AR,30328004,1005,100,,Invoice,,,,,,04/10/2018,04/10/2018,0.00,,20.95,,"-1,018,877.68"
,IN,AR,30328009,1005,100,,Invoice,,,,,,04/10/2018,04/10/2018,0.00,,10.93,,"-1,018,888.61"
,IN,AR,30328012,1005,100,,Invoice,,,,,,04/10/2018,04/10/2018,0.00,,5.68,,"-1,018,894.29"
,IN,AR,30328013,1005,100,,Invoice,,,,,,04/10/2018,04/10/2018,0.00,,2.58,,"-1,018,896.87"
,IN,AR,30328015,1005,100,,Invoice,,,,,,04/10/2018,04/10/2018,0.00,,3.64,,"-1,018,900.51"
,IN,AR,30328018,1005,100,,Invoice,,,,,,04/10/2018,04/10/2018,0.00,,29.15,,"-1,018,929.66"
,IN,AR,30328020,1005,100,,Invoice,,,,,,04/10/2018,04/10/2018,0.00,,19.92,,"-1,018,949.58"
,IN,AR,30328021,1005,100,,Invoice,,,,,,04/10/2018,04/10/2018,0.00,,13.94,,"-1,018,963.52"
,IN,AR,30328022,1005,100,,Invoice,,,,,,04/10/2018,04/10/2018,0.00,,3.98,,"-1,018,967.50"
,IN,AR,30328023,1005,100,,Invoice,,,,,,04/10/2018,04/10/2018,0.00,,23.90,,"-1,018,991.40"
,IN,AR,30328029,1005,100,,Invoice,,,,,,04/10/2018,04/10/2018,0.00,,27.88,,"-1,019,019.28"
,IN,AR,30328030,1005,100,,Invoice,,,,,,04/10/2018,04/10/2018,0.00,,286.78,,"-1,019,306.06"
,IN,AR,30328040,1005,100,,Invoice,,,,,,04/10/2018,04/10/2018,0.00,,178.66,,"-1,019,484.72"
,IN,AR,30328042,1005,100,,Invoice,,,,,,04/10/2018,04/10/2018,0.00,,11.36,,"-1,019,496.08"
,IN,AR,30328050,1005,100,,Invoice,,,,,,04/10/2018,04/10/2018,0.00,,8.21,,"-1,019,504.29"
,IN,AR,30328051,1005,100,,Invoice,,,,,,04/10/2018,04/10/2018,0.00,,3.64,,"-1,019,507.93"
,IN,AR,30328060,1005,100,,Invoice,,,,,,04/10/2018,04/10/2018,0.00,,3.28,,"-1,019,511.21"
,IN,AR,30328069,1005,100,,Invoice,,,,,,04/10/2018,04/10/2018,0.00,,25.42,,"-1,019,536.63"
,IN,AR,30328071,1005,100,,Invoice,,,,,,04/10/2018,04/10/2018,0.00,,20.01,,"-1,019,556.64"
,IN,AR,30328075,1005,100,,Invoice,,,,,,04/10/2018,04/10/2018,0.00,,40.01,,"-1,019,596.65"
,IN,AR,30328077,1005,100,,Invoice,,,,,,04/10/2018,04/10/2018,0.00,,23.32,,"-1,019,619.97"
,IN,AR,30328081,1005,100,,Invoice,,,,,,04/10/2018,04/10/2018,0.00,,3.64,,"-1,019,623.61"
,IN,AR,30328092,1005,100,,Invoice,,,,,,04/10/2018,04/10/2018,0.00,,14.58,,"-1,019,638.19"
,IN,AR,30328102,1005,100,,Invoice,,,,,,04/10/2018,04/10/2018,0.00,,16.83,,"-1,019,655.02"
,IN,AR,30328104,1005,100,,Invoice,,,,,,04/10/2018,04/10/2018,0.00,,34.32,,"-1,019,689.34"
,IN,AR,30328108,1005,100,,Invoice,,,,,,04/10/2018,04/10/2018,0.00,,12.14,,"-1,019,701.48"
,IN,AR,30328130,1005,100,,Invoice,,,,,,04/10/2018,04/10/2018,0.00,,10.93,,"-1,019,712.41"
,IN,AR,30328132,1005,100,,Invoice,,,,,,04/10/2018,04/10/2018,0.00,,14.19,,"-1,019,726.60"
,IN,AR,30328134,1005,100,,Invoice,,,,,,04/10/2018,04/10/2018,0.00,,81.15,,"-1,019,807.75"
,IN,AR,30328137,1005,100,,Invoice,,,,,,04/10/2018,04/10/2018,0.00,,1.59,,"-1,019,809.34"
,IN,AR,30328138,1005,100,,Invoice,,,,,,04/10/2018,04/10/2018,0.00,,12.75,,"-1,019,822.09"
,IN,AR,30328139,1005,100,,Invoice,,,,,,04/10/2018,04/10/2018,0.00,,4.78,,"-1,019,826.87"
,IN,AR,30328140,1005,100,,Invoice,,,,,,04/10/2018,04/10/2018,0.00,,95.59,,"-1,019,922.46"
,IN,AR,30328141,1005,100,,Invoice,,,,,,04/10/2018,04/10/2018,0.00,,6.37,,"-1,019,928.83"
,IN,AR,30328142,1005,100,,Invoice,,,,,,04/10/2018,04/10/2018,0.00,,7.97,,"-1,019,936.80"
,IN,AR,30328143,1005,100,,Invoice,,,,,,04/10/2018,04/10/2018,0.00,,19.12,,"-1,019,955.92"
,IN,AR,30328145,1005,100,,Invoice,,,,,,04/10/2018,04/10/2018,0.00,,54.66,,"-1,020,010.58"
,IN,AR,30328161,1005,100,,Invoice,,,,,,04/10/2018,04/10/2018,0.00,,24.41,,"-1,020,034.99"
,IN,AR,30328172,1005,100,,Invoice,,,,,,04/10/2018,04/10/2018,0.00,,6.00,,"-1,020,040.99"
,IN,AR,30328194,1005,100,,Invoice,,,,,,04/10/2018,04/10/2018,0.00,,12.14,,"-1,020,053.13"
,IN,AR,30328205,1005,100,,Invoice,,,,,,04/10/2018,04/10/2018,0.00,,8.17,,"-1,020,061.30"
,IN,AR,30328219,1005,100,,Invoice,,,,,,04/10/2018,04/10/2018,0.00,,4.83,,"-1,020,066.13"
,IN,AR,30328220,1005,100,,Invoice,,,,,,04/10/2018,04/10/2018,0.00,,15.18,,"-1,020,081.31"
,IN,AR,30328236,1005,100,,Invoice,,,,,,04/10/2018,04/10/2018,0.00,,2.08,,"-1,020,083.39"
,IN,AR,30328237,1005,100,,Invoice,,,,,,04/10/2018,04/10/2018,0.00,,4.15,,"-1,020,087.54"
,IN,AR,30328238,1005,100,,Invoice,,,,,,04/10/2018,04/10/2018,0.00,,24.92,,"-1,020,112.46"
,IN,AR,30328250,1005,100,,Invoice,,,,,,04/10/2018,04/10/2018,0.00,,4.07,,"-1,020,116.53"
,IN,AR,30328256,1005,100,,Invoice,,,,,,04/10/2018,04/10/2018,0.00,,8.47,,"-1,020,125.00"
,IN,AR,30328265,1005,100,,Invoice,,,,,,04/10/2018,04/10/2018,0.00,,364.41,,"-1,020,489.41"
,IN,AR,30328270,1005,100,,Invoice,,,,,,04/10/2018,04/10/2018,0.00,,50.47,,"-1,020,539.88"
,IN,AR,30328271,1005,100,,Invoice,,,,,,04/10/2018,04/10/2018,0.00,,10.93,,"-1,020,550.81"
,IN,AR,30328278,1005,100,,Invoice,,,,,,04/10/2018,04/10/2018,0.00,,91.02,,"-1,020,641.83"
,IN,AR,30328282,1005,100,,Invoice,,,,,,04/10/2018,04/10/2018,0.00,,8.90,,"-1,020,650.73"
,IN,AR,30328286,1005,100,,Invoice,,,,,,04/10/2018,04/10/2018,0.00,,12.14,,"-1,020,662.87"
,IN,AR,30328287,1005,100,,Invoice,,,,,,04/10/2018,04/10/2018,0.00,,7.29,,"-1,020,670.16"
,IN,AR,30328288,1005,100,,Invoice,,,,,,04/10/2018,04/10/2018,0.00,,7.29,,"-1,020,677.45"
,IN,AR,30328305,1005,100,,Invoice,,,,,,04/10/2018,04/10/2018,0.00,,72.88,,"-1,020,750.33"
,CS,AR,32009448,1005,100,,Cash sale,,,,,,05/10/2018,05/10/2018,0.00,,8.42,,"-1,020,758.75"
,CS,AR,32009451,1005,100,,Cash sale,,,,,,05/10/2018,05/10/2018,0.00,,37.63,,"-1,020,796.38"
,CS,AR,32009453,1005,100,,Cash sale,,,,,,05/10/2018,05/10/2018,0.00,,18.98,,"-1,020,815.36"
,CS,AR,32009475,1005,100,,Cash sale,,,,,,05/10/2018,05/10/2018,0.00,,12.08,,"-1,020,827.44"
,CS,AR,32009481,1005,100,,Cash sale,,,,,,05/10/2018,05/10/2018,0.00,,14.58,,"-1,020,842.02"
,CS,AR,32009483,1005,100,,Cash sale,,,,,,05/10/2018,05/10/2018,0.00,,18.69,,"-1,020,860.71"
,CS,AR,32009494,1005,100,,Cash sale,,,,,,05/10/2018,05/10/2018,0.00,,11.19,,"-1,020,871.90"
,CS,AR,32009510,1005,100,,Cash sale,,,,,,05/10/2018,05/10/2018,0.00,,7.29,,"-1,020,879.19"
,CS,AR,32009516,1005,100,,Cash sale,,,,,,05/10/2018,05/10/2018,0.00,,2.58,,"-1,020,881.77"
,CS,AR,32009519,1005,100,,Cash sale,,,,,,05/10/2018,05/10/2018,0.00,,5.08,,"-1,020,886.85"
,CS,AR,32009522,1005,100,,Cash sale,,,,,,05/10/2018,05/10/2018,0.00,,3.64,,"-1,020,890.49"
,CS,AR,32009523,1005,100,,Cash sale,,,,,,05/10/2018,05/10/2018,0.00,,60.45,,"-1,020,950.94"
,CS,AR,32009528,1005,100,,Cash sale,,,,,,05/10/2018,05/10/2018,0.00,,7.29,,"-1,020,958.23"
,CS,AR,32009530,1005,100,,Cash sale,,,,,,05/10/2018,05/10/2018,0.00,,3.01,,"-1,020,961.24"
,CS,AR,32009537,1005,100,,Cash sale,,,,,,05/10/2018,05/10/2018,0.00,,12.92,,"-1,020,974.16"
,CS,AR,32009551,1005,100,,Cash sale,,,,,,05/10/2018,05/10/2018,0.00,,10.17,,"-1,020,984.33"
,CS,AR,32009573,1005,100,,Cash sale,,,,,,05/10/2018,05/10/2018,0.00,,25.51,,"-1,021,009.84"
,CS,AR,32009581,1005,100,,Cash sale,,,,,,05/10/2018,05/10/2018,0.00,,5.86,,"-1,021,015.70"
,CS,AR,32009583,1005,100,,Cash sale,,,,,,05/10/2018,05/10/2018,0.00,,18.22,,"-1,021,033.92"
,CS,AR,32009588,1005,100,,Cash sale,,,,,,05/10/2018,05/10/2018,0.00,,7.29,,"-1,021,041.21"
,CS,AR,32009590,1005,100,,Cash sale,,,,,,05/10/2018,05/10/2018,0.00,,13.90,,"-1,021,055.11"
,CS,AR,32009595,1005,100,,Cash sale,,,,,,05/10/2018,05/10/2018,0.00,,7.29,,"-1,021,062.40"
,CS,AR,32009600,1005,100,,Cash sale,,,,,,05/10/2018,05/10/2018,0.00,,21.86,,"-1,021,084.26"
,CS,AR,32009620,1005,100,,Cash sale,,,,,,05/10/2018,05/10/2018,0.00,,3.64,,"-1,021,087.90"
,CS,AR,32009625,1005,100,,Cash sale,,,,,,05/10/2018,05/10/2018,0.00,,7.29,,"-1,021,095.19"
,CS,AR,32009632,1005,100,,Cash sale,,,,,,05/10/2018,05/10/2018,0.00,,9.15,,"-1,021,104.34"
,CS,AR,32009649,1005,100,,Cash sale,,,,,,05/10/2018,05/10/2018,0.00,,15.18,,"-1,021,119.52"
,CS,AR,32009650,1005,100,,Cash sale,,,,,,05/10/2018,05/10/2018,0.00,,7.29,,"-1,021,126.81"
,CS,AR,32009653,1005,100,,Cash sale,,,,,,05/10/2018,05/10/2018,0.00,,10.93,,"-1,021,137.74"
,CS,AR,32009654,1005,100,,Cash sale,,,,,,05/10/2018,05/10/2018,0.00,,5.08,,"-1,021,142.82"
,CS,AR,32009656,1005,100,,Cash sale,,,,,,05/10/2018,05/10/2018,0.00,,9.15,,"-1,021,151.97"
,CS,AR,32009658,1005,100,,Cash sale,,,,,,05/10/2018,05/10/2018,0.00,,10.93,,"-1,021,162.90"
,CS,AR,32009662,1005,100,,Cash sale,,,,,,05/10/2018,05/10/2018,0.00,,14.58,,"-1,021,177.48"
,CS,AR,32009674,1005,100,,Cash sale,,,,,,05/10/2018,05/10/2018,0.00,,10.93,,"-1,021,188.41"
,CS,AR,32009677,1005,100,,Cash sale,,,,,,05/10/2018,05/10/2018,0.00,,5.94,,"-1,021,194.35"
,CS,AR,32009688,1005,100,,Cash sale,,,,,,05/10/2018,05/10/2018,0.00,,3.64,,"-1,021,197.99"
,CS,AR,32009698,1005,100,,Cash sale,,,,,,05/10/2018,05/10/2018,0.00,,7.29,,"-1,021,205.28"
,IN,AR,30327703,1005,100,,Invoice,,,,,,05/10/2018,05/10/2018,0.00,,253.63,,"-1,021,458.91"
,IN,AR,30327706,1005,100,,Invoice,,,,,,05/10/2018,05/10/2018,0.00,,5.93,,"-1,021,464.84"
,IN,AR,30327707,1005,100,,Invoice,,,,,,05/10/2018,05/10/2018,0.00,,47.46,,"-1,021,512.30"
,IN,AR,30327711,1005,100,,Invoice,,,,,,05/10/2018,05/10/2018,0.00,,16.78,,"-1,021,529.08"
,IN,AR,30327724,1005,100,,Invoice,,,,,,05/10/2018,05/10/2018,0.00,,6.08,,"-1,021,535.16"
,IN,AR,30327731,1005,100,,Invoice,,,,,,05/10/2018,05/10/2018,0.00,,10.93,,"-1,021,546.09"
,IN,AR,30327740,1005,100,,Invoice,,,,,,05/10/2018,05/10/2018,0.00,,50.73,,"-1,021,596.82"
,IN,AR,30327746,1005,100,,Invoice,,,,,,05/10/2018,05/10/2018,0.00,,18.37,,"-1,021,615.19"
,IN,AR,30327747,1005,100,,Invoice,,,,,,05/10/2018,05/10/2018,0.00,,89.27,,"-1,021,704.46"
,IN,AR,30327756,1005,100,,Invoice,,,,,,05/10/2018,05/10/2018,0.00,,45.08,,"-1,021,749.54"
,IN,AR,30327777,1005,100,,Invoice,,,,,,05/10/2018,05/10/2018,0.00,,18.00,,"-1,021,767.54"
,IN,AR,30327788,1005,100,,Invoice,,,,,,05/10/2018,05/10/2018,0.00,,12.00,,"-1,021,779.54"
,IN,AR,30327800,1005,100,,Invoice,,,,,,05/10/2018,05/10/2018,0.00,,3.88,,"-1,021,783.42"
,IN,AR,30327801,1005,100,,Invoice,,,,,,05/10/2018,05/10/2018,0.00,,7.76,,"-1,021,791.18"
,IN,AR,30327804,1005,100,,Invoice,,,,,,05/10/2018,05/10/2018,0.00,,3.64,,"-1,021,794.82"
,IN,AR,30327807,1005,100,,Invoice,,,,,,05/10/2018,05/10/2018,0.00,,32.80,,"-1,021,827.62"
,IN,AR,30327808,1005,100,,Invoice,,,,,,05/10/2018,05/10/2018,0.00,,8.39,,"-1,021,836.01"
,IN,AR,30327824,1005,100,,Invoice,,,,,,05/10/2018,05/10/2018,0.00,,4.64,,"-1,021,840.65"
,IN,AR,30327845,1005,100,,Invoice,,,,,,05/10/2018,05/10/2018,0.00,,12.92,,"-1,021,853.57"
,IN,AR,30327846,1005,100,,Invoice,,,,,,05/10/2018,05/10/2018,0.00,,4.78,,"-1,021,858.35"
,IN,AR,30327850,1005,100,,Invoice,,,,,,05/10/2018,05/10/2018,0.00,,52.20,,"-1,021,910.55"
,IN,AR,30327856,1005,100,,Invoice,,,,,,05/10/2018,05/10/2018,0.00,,9.03,,"-1,021,919.58"
,IN,AR,30327862,1005,100,,Invoice,,,,,,05/10/2018,05/10/2018,0.00,,65.63,,"-1,021,985.21"
,IN,AR,30327865,1005,100,,Invoice,,,,,,05/10/2018,05/10/2018,0.00,,180.51,,"-1,022,165.72"
,IN,AR,30327871,1005,100,,Invoice,,,,,,05/10/2018,05/10/2018,0.00,,21.51,,"-1,022,187.23"
,IN,AR,30327876,1005,100,,Invoice,,,,,,05/10/2018,05/10/2018,0.00,,15.04,,"-1,022,202.27"
,IN,AR,30327879,1005,100,,Invoice,,,,,,05/10/2018,05/10/2018,0.00,,9.03,,"-1,022,211.30"
,IN,AR,30327886,1005,100,,Invoice,,,,,,05/10/2018,05/10/2018,0.00,,2.39,,"-1,022,213.69"
,IN,AR,30327890,1005,100,,Invoice,,,,,,05/10/2018,05/10/2018,0.00,,12.71,,"-1,022,226.40"
,IN,AR,30327902,1005,100,,Invoice,,,,,,05/10/2018,05/10/2018,0.00,,22.88,,"-1,022,249.28"
,IN,AR,30327906,1005,100,,Invoice,,,,,,05/10/2018,05/10/2018,0.00,,14.58,,"-1,022,263.86"
,IN,AR,30327914,1005,100,,Invoice,,,,,,05/10/2018,05/10/2018,0.00,,3.01,,"-1,022,266.87"
,IN,AR,30327936,1005,100,,Invoice,,,,,,05/10/2018,05/10/2018,0.00,,11.22,,"-1,022,278.09"
,IN,AR,30327947,1005,100,,Invoice,,,,,,05/10/2018,05/10/2018,0.00,,4.24,,"-1,022,282.33"
,IN,AR,30327956,1005,100,,Invoice,,,,,,05/10/2018,05/10/2018,0.00,,10.93,,"-1,022,293.26"
,IN,AR,30327968,1005,100,,Invoice,,,,,,05/10/2018,05/10/2018,0.00,,7.29,,"-1,022,300.55"
,IN,AR,30327987,1005,100,,Invoice,,,,,,05/10/2018,05/10/2018,0.00,,47.37,,"-1,022,347.92"
,IN,AR,30327993,1005,100,,Invoice,,,,,,05/10/2018,05/10/2018,0.00,,7.05,,"-1,022,354.97"
,IN,AR,30327998,1005,100,,Invoice,,,,,,05/10/2018,05/10/2018,0.00,,4.85,,"-1,022,359.82"
,IN,AR,30328003,1005,100,,Invoice,,,,,,05/10/2018,05/10/2018,0.00,,10.93,,"-1,022,370.75"
,IN,AR,30328014,1005,100,,Invoice,,,,,,05/10/2018,05/10/2018,0.00,,8.44,,"-1,022,379.19"
,IN,AR,30328031,1005,100,,Invoice,,,,,,05/10/2018,05/10/2018,0.00,,65.72,,"-1,022,444.91"
,IN,AR,30328032,1005,100,,Invoice,,,,,,05/10/2018,05/10/2018,0.00,,31.86,,"-1,022,476.77"
,IN,AR,30328035,1005,100,,Invoice,,,,,,05/10/2018,05/10/2018,0.00,,48.26,,"-1,022,525.03"
,IN,AR,30328038,1005,100,,Invoice,,,,,,05/10/2018,05/10/2018,0.00,,39.28,,"-1,022,564.31"
,IN,AR,30328045,1005,100,,Invoice,,,,,,05/10/2018,05/10/2018,0.00,,26.06,,"-1,022,590.37"
,IN,AR,30328047,1005,100,,Invoice,,,,,,05/10/2018,05/10/2018,0.00,,14.58,,"-1,022,604.95"
,IN,AR,30328048,1005,100,,Invoice,,,,,,05/10/2018,05/10/2018,0.00,,16.02,,"-1,022,620.97"
,IN,AR,30328049,1005,100,,Invoice,,,,,,05/10/2018,05/10/2018,0.00,,56.06,,"-1,022,677.03"
,IN,AR,30328053,1005,100,,Invoice,,,,,,05/10/2018,05/10/2018,0.00,,7.29,,"-1,022,684.32"
,IN,AR,30328054,1005,100,,Invoice,,,,,,05/10/2018,05/10/2018,0.00,,43.22,,"-1,022,727.54"
,IN,AR,30328057,1005,100,,Invoice,,,,,,05/10/2018,05/10/2018,0.00,,36.78,,"-1,022,764.32"
,IN,AR,30328059,1005,100,,Invoice,,,,,,05/10/2018,05/10/2018,0.00,,2.54,,"-1,022,766.86"
,IN,AR,30328063,1005,100,,Invoice,,,,,,05/10/2018,05/10/2018,0.00,,28.69,,"-1,022,795.55"
,IN,AR,30328073,1005,100,,Invoice,,,,,,05/10/2018,05/10/2018,0.00,,12.00,,"-1,022,807.55"
,IN,AR,30328082,1005,100,,Invoice,,,,,,05/10/2018,05/10/2018,0.00,,21.90,,"-1,022,829.45"
,IN,AR,30328088,1005,100,,Invoice,,,,,,05/10/2018,05/10/2018,0.00,,12.62,,"-1,022,842.07"
,IN,AR,30328089,1005,100,,Invoice,,,,,,05/10/2018,05/10/2018,0.00,,33.64,,"-1,022,875.71"
,IN,AR,30328094,1005,100,,Invoice,,,,,,05/10/2018,05/10/2018,0.00,,14.58,,"-1,022,890.29"
,IN,AR,30328095,1005,100,,Invoice,,,,,,05/10/2018,05/10/2018,0.00,,11.66,,"-1,022,901.95"
,IN,AR,30328103,1005,100,,Invoice,,,,,,05/10/2018,05/10/2018,0.00,,11.48,,"-1,022,913.43"
,IN,AR,30328105,1005,100,,Invoice,,,,,,05/10/2018,05/10/2018,0.00,,11.19,,"-1,022,924.62"
,IN,AR,30328146,1005,100,,Invoice,,,,,,05/10/2018,05/10/2018,0.00,,14.58,,"-1,022,939.20"
,IN,AR,30328149,1005,100,,Invoice,,,,,,05/10/2018,05/10/2018,0.00,,56.95,,"-1,022,996.15"
,IN,AR,30328150,1005,100,,Invoice,,,,,,05/10/2018,05/10/2018,0.00,,113.91,,"-1,023,110.06"
,IN,AR,30328165,1005,100,,Invoice,,,,,,05/10/2018,05/10/2018,0.00,,10.00,,"-1,023,120.06"
,IN,AR,30328174,1005,100,,Invoice,,,,,,05/10/2018,05/10/2018,0.00,,8.52,,"-1,023,128.58"
,IN,AR,30328177,1005,100,,Invoice,,,,,,05/10/2018,05/10/2018,0.00,,58.49,,"-1,023,187.07"
,IN,AR,30328188,1005,100,,Invoice,,,,,,05/10/2018,05/10/2018,0.00,,8.21,,"-1,023,195.28"
,IN,AR,30328192,1005,100,,Invoice,,,,,,05/10/2018,05/10/2018,0.00,,29.66,,"-1,023,224.94"
,IN,AR,30328203,1005,100,,Invoice,,,,,,05/10/2018,05/10/2018,0.00,,12.25,,"-1,023,237.19"
,IN,AR,30328214,1005,100,,Invoice,,,,,,05/10/2018,05/10/2018,0.00,,5.97,,"-1,023,243.16"
,IN,AR,30328223,1005,100,,Invoice,,,,,,05/10/2018,05/10/2018,0.00,,2.00,,"-1,023,245.16"
,IN,AR,30328239,1005,100,,Invoice,,,,,,05/10/2018,05/10/2018,0.00,,26.99,,"-1,023,272.15"
,IN,AR,30328240,1005,100,,Invoice,,,,,,05/10/2018,05/10/2018,0.00,,12.46,,"-1,023,284.61"
,IN,AR,30328247,1005,100,,Invoice,,,,,,05/10/2018,05/10/2018,0.00,,18.61,,"-1,023,303.22"
,IN,AR,30328260,1005,100,,Invoice,,,,,,05/10/2018,05/10/2018,0.00,,14.58,,"-1,023,317.80"
,IN,AR,30328268,1005,100,,Invoice,,,,,,05/10/2018,05/10/2018,0.00,,18.22,,"-1,023,336.02"
,IN,AR,30328290,1005,100,,Invoice,,,,,,05/10/2018,05/10/2018,0.00,,10.93,,"-1,023,346.95"
,IN,AR,30328295,1005,100,,Invoice,,,,,,05/10/2018,05/10/2018,0.00,,7.29,,"-1,023,354.24"
,CS,AR,32009445,1005,100,,Cash sale,,,,,,06/10/2018,06/10/2018,0.00,,21.86,,"-1,023,376.10"
,CS,AR,32009457,1005,100,,Cash sale,,,,,,06/10/2018,06/10/2018,0.00,,3.64,,"-1,023,379.74"
,CS,AR,32009459,1005,100,,Cash sale,,,,,,06/10/2018,06/10/2018,0.00,,7.29,,"-1,023,387.03"
,CS,AR,32009466,1005,100,,Cash sale,,,,,,06/10/2018,06/10/2018,0.00,,7.29,,"-1,023,394.32"
,CS,AR,32009469,1005,100,,Cash sale,,,,,,06/10/2018,06/10/2018,0.00,,14.58,,"-1,023,408.90"
,CS,AR,32009495,1005,100,,Cash sale,,,,,,06/10/2018,06/10/2018,0.00,,10.93,,"-1,023,419.83"
,CS,AR,32009500,1005,100,,Cash sale,,,,,,06/10/2018,06/10/2018,0.00,,3.64,,"-1,023,423.47"
,CS,AR,32009503,1005,100,,Cash sale,,,,,,06/10/2018,06/10/2018,0.00,,10.93,,"-1,023,434.40"
,CS,AR,32009532,1005,100,,Cash sale,,,,,,06/10/2018,06/10/2018,0.00,,7.29,,"-1,023,441.69"
,CS,AR,32009554,1005,100,,Cash sale,,,,,,06/10/2018,06/10/2018,0.00,,7.29,,"-1,023,448.98"
,CS,AR,32009559,1005,100,,Cash sale,,,,,,06/10/2018,06/10/2018,0.00,,3.64,,"-1,023,452.62"
,CS,AR,32009577,1005,100,,Cash sale,,,,,,06/10/2018,06/10/2018,0.00,,7.29,,"-1,023,459.91"
,CS,AR,32009579,1005,100,,Cash sale,,,,,,06/10/2018,06/10/2018,0.00,,20.48,,"-1,023,480.39"
,CS,AR,32009585,1005,100,,Cash sale,,,,,,06/10/2018,06/10/2018,0.00,,5.17,,"-1,023,485.56"
,CS,AR,32009594,1005,100,,Cash sale,,,,,,06/10/2018,06/10/2018,0.00,,3.64,,"-1,023,489.20"
,CS,AR,32009604,1005,100,,Cash sale,,,,,,06/10/2018,06/10/2018,0.00,,10.93,,"-1,023,500.13"
,CS,AR,32009606,1005,100,,Cash sale,,,,,,06/10/2018,06/10/2018,0.00,,7.29,,"-1,023,507.42"
,CS,AR,32009612,1005,100,,Cash sale,,,,,,06/10/2018,06/10/2018,0.00,,3.64,,"-1,023,511.06"
,CS,AR,32009633,1005,100,,Cash sale,,,,,,06/10/2018,06/10/2018,0.00,,3.64,,"-1,023,514.70"
,CS,AR,32009641,1005,100,,Cash sale,,,,,,06/10/2018,06/10/2018,0.00,,4.24,,"-1,023,518.94"
,CS,AR,32009655,1005,100,,Cash sale,,,,,,06/10/2018,06/10/2018,0.00,,15.17,,"-1,023,534.11"
,CS,AR,32009659,1005,100,,Cash sale,,,,,,06/10/2018,06/10/2018,0.00,,3.64,,"-1,023,537.75"
,CS,AR,32009661,1005,100,,Cash sale,,,,,,06/10/2018,06/10/2018,0.00,,9.13,,"-1,023,546.88"
,CS,AR,32009694,1005,100,,Cash sale,,,,,,06/10/2018,06/10/2018,0.00,,7.29,,"-1,023,554.17"
,CS,AR,32009702,1005,100,,Cash sale,,,,,,06/10/2018,06/10/2018,0.00,,9.84,,"-1,023,564.01"
,IN,AR,30327729,1005,100,,Invoice,,,,,,06/10/2018,06/10/2018,0.00,,6.08,,"-1,023,570.09"
,IN,AR,30327757,1005,100,,Invoice,,,,,,06/10/2018,06/10/2018,0.00,,47.46,,"-1,023,617.55"
,IN,AR,30327786,1005,100,,Invoice,,,,,,06/10/2018,06/10/2018,0.00,,7.12,,"-1,023,624.67"
,IN,AR,30327891,1005,100,,Invoice,,,,,,06/10/2018,06/10/2018,0.00,,5.08,,"-1,023,629.75"
,IN,AR,30327892,1005,100,,Invoice,,,,,,06/10/2018,06/10/2018,0.00,,5.08,,"-1,023,634.83"
,IN,AR,30327893,1005,100,,Invoice,,,,,,06/10/2018,06/10/2018,0.00,,5.08,,"-1,023,639.91"
,IN,AR,30328070,1005,100,,Invoice,,,,,,06/10/2018,06/10/2018,0.00,,7.63,,"-1,023,647.54"
,IN,AR,30328090,1005,100,,Invoice,,,,,,06/10/2018,06/10/2018,0.00,,54.67,,"-1,023,702.21"
,IN,AR,30328096,1005,100,,Invoice,,,,,,06/10/2018,06/10/2018,0.00,,14.58,,"-1,023,716.79"
,IN,AR,30328184,1005,100,,Invoice,,,,,,06/10/2018,06/10/2018,0.00,,2.92,,"-1,023,719.71"
,IN,AR,30328209,1005,100,,Invoice,,,,,,06/10/2018,06/10/2018,0.00,,7.29,,"-1,023,727.00"
,IN,AR,30328251,1005,100,,Invoice,,,,,,06/10/2018,06/10/2018,0.00,,4.07,,"-1,023,731.07"
,IN,AR,30328254,1005,100,,Invoice,,,,,,06/10/2018,06/10/2018,0.00,,7.63,,"-1,023,738.70"
,IN,AR,30328280,1005,100,,Invoice,,,,,,06/10/2018,06/10/2018,0.00,,7.29,,"-1,023,745.99"
,IN,AR,30328301,1005,100,,Invoice,,,,,,06/10/2018,06/10/2018,0.00,,6.42,,"-1,023,752.41"
,CN,AR,31019245,1005,100,,Credit Note,,,,,,08/10/2018,08/10/2018,13.77,,0.00,,"-1,023,738.64"
,CS,AR,32009711,1005,100,,Cash sale,,,,,,08/10/2018,08/10/2018,0.00,,8.42,,"-1,023,747.06"
,CS,AR,32009729,1005,100,,Cash sale,,,,,,08/10/2018,08/10/2018,0.00,,14.24,,"-1,023,761.30"
,CS,AR,32009770,1005,100,,Cash sale,,,,,,08/10/2018,08/10/2018,0.00,,14.58,,"-1,023,775.88"
,CS,AR,32009789,1005,100,,Cash sale,,,,,,08/10/2018,08/10/2018,0.00,,7.29,,"-1,023,783.17"
,CS,AR,32009821,1005,100,,Cash sale,,,,,,08/10/2018,08/10/2018,0.00,,14.58,,"-1,023,797.75"
,CS,AR,32009823,1005,100,,Cash sale,,,,,,08/10/2018,08/10/2018,0.00,,16.61,,"-1,023,814.36"
,CS,AR,32009836,1005,100,,Cash sale,,,,,,08/10/2018,08/10/2018,0.00,,3.64,,"-1,023,818.00"
,CS,AR,32009841,1005,100,,Cash sale,,,,,,08/10/2018,08/10/2018,0.00,,7.29,,"-1,023,825.29"
,CS,AR,32009848,1005,100,,Cash sale,,,,,,08/10/2018,08/10/2018,0.00,,9.73,,"-1,023,835.02"
,CS,AR,32009880,1005,100,,Cash sale,,,,,,08/10/2018,08/10/2018,0.00,,7.29,,"-1,023,842.31"
,CS,AR,32009902,1005,100,,Cash sale,,,,,,08/10/2018,08/10/2018,0.00,,7.29,,"-1,023,849.60"
,CS,AR,32009903,1005,100,,Cash sale,,,,,,08/10/2018,08/10/2018,0.00,,10.34,,"-1,023,859.94"
,CS,AR,32009938,1005,100,,Cash sale,,,,,,08/10/2018,08/10/2018,0.00,,7.63,,"-1,023,867.57"
,CS,AR,32009979,1005,100,,Cash sale,,,,,,08/10/2018,08/10/2018,0.00,,7.29,,"-1,023,874.86"
,CS,AR,32009996,1005,100,,Cash sale,,,,,,08/10/2018,08/10/2018,0.00,,3.64,,"-1,023,878.50"
,CS,AR,32010022,1005,100,,Cash sale,,,,,,08/10/2018,08/10/2018,0.00,,14.62,,"-1,023,893.12"
,CS,AR,32010042,1005,100,,Cash sale,,,,,,08/10/2018,08/10/2018,0.00,,45.13,,"-1,023,938.25"
,CS,AR,32010089,1005,100,,Cash sale,,,,,,08/10/2018,08/10/2018,0.00,,7.29,,"-1,023,945.54"
,CS,AR,32010097,1005,100,,Cash sale,,,,,,08/10/2018,08/10/2018,0.00,,3.64,,"-1,023,949.18"
,CS,AR,32010104,1005,100,,Cash sale,,,,,,08/10/2018,08/10/2018,0.00,,5.08,,"-1,023,954.26"
,CS,AR,32010127,1005,100,,Cash sale,,,,,,08/10/2018,08/10/2018,0.00,,10.93,,"-1,023,965.19"
,CS,AR,32010145,1005,100,,Cash sale,,,,,,08/10/2018,08/10/2018,0.00,,10.93,,"-1,023,976.12"
,CS,AR,32010149,1005,100,,Cash sale,,,,,,08/10/2018,08/10/2018,0.00,,7.29,,"-1,023,983.41"
,CS,AR,32010154,1005,100,,Cash sale,,,,,,08/10/2018,08/10/2018,0.00,,6.02,,"-1,023,989.43"
,CS,AR,32010177,1005,100,,Cash sale,,,,,,08/10/2018,08/10/2018,0.00,,9.03,,"-1,023,998.46"
,CS,AR,32010180,1005,100,,Cash sale,,,,,,08/10/2018,08/10/2018,0.00,,3.64,,"-1,024,002.10"
,CS,AR,32010190,1005,100,,Cash sale,,,,,,08/10/2018,08/10/2018,0.00,,7.29,,"-1,024,009.39"
,CS,AR,32010201,1005,100,,Cash sale,,,,,,08/10/2018,08/10/2018,0.00,,6.08,,"-1,024,015.47"
,CS,AR,32010244,1005,100,,Cash sale,,,,,,08/10/2018,08/10/2018,0.00,,12.71,,"-1,024,028.18"
,CS,AR,32010252,1005,100,,Cash sale,,,,,,08/10/2018,08/10/2018,0.00,,6.53,,"-1,024,034.71"
,CS,AR,32010258,1005,100,,Cash sale,,,,,,08/10/2018,08/10/2018,0.00,,7.75,,"-1,024,042.46"
,CS,AR,32010284,1005,100,,Cash sale,,,,,,08/10/2018,08/10/2018,0.00,,10.17,,"-1,024,052.63"
,CS,AR,32010298,1005,100,,Cash sale,,,,,,08/10/2018,08/10/2018,0.00,,10.93,,"-1,024,063.56"
,CS,AR,32010320,1005,100,,Cash sale,,,,,,08/10/2018,08/10/2018,0.00,,11.44,,"-1,024,075.00"
,CS,AR,32010355,1005,100,,Cash sale,,,,,,08/10/2018,08/10/2018,0.00,,6.07,,"-1,024,081.07"
,CS,AR,32010376,1005,100,,Cash sale,,,,,,08/10/2018,08/10/2018,0.00,,12.14,,"-1,024,093.21"
,CS,AR,32010394,1005,100,,Cash sale,,,,,,08/10/2018,08/10/2018,0.00,,14.58,,"-1,024,107.79"
,CS,AR,32010408,1005,100,,Cash sale,,,,,,08/10/2018,08/10/2018,0.00,,14.58,,"-1,024,122.37"
,CS,AR,32010492,1005,100,,Cash sale,,,,,,08/10/2018,08/10/2018,0.00,,3.64,,"-1,024,126.01"
,CS,AR,32010545,1005,100,,Cash sale,,,,,,08/10/2018,08/10/2018,0.00,,16.31,,"-1,024,142.32"
,CS,AR,32010578,1005,100,,Cash sale,,,,,,08/10/2018,08/10/2018,0.00,,10.93,,"-1,024,153.25"
,CS,AR,32010579,1005,100,,Cash sale,,,,,,08/10/2018,08/10/2018,0.00,,14.58,,"-1,024,167.83"
,CS,AR,32010587,1005,100,,Cash sale,,,,,,08/10/2018,08/10/2018,0.00,,7.29,,"-1,024,175.12"
,CS,AR,32010596,1005,100,,Cash sale,,,,,,08/10/2018,08/10/2018,0.00,,43.73,,"-1,024,218.85"
,IN,AR,30328330,1005,100,,Invoice,,,,,,08/10/2018,08/10/2018,0.00,,25.51,,"-1,024,244.36"
,IN,AR,30328336,1005,100,,Invoice,,,,,,08/10/2018,08/10/2018,0.00,,21.86,,"-1,024,266.22"
,IN,AR,30328369,1005,100,,Invoice,,,,,,08/10/2018,08/10/2018,0.00,,6.08,,"-1,024,272.30"
,IN,AR,30328370,1005,100,,Invoice,,,,,,08/10/2018,08/10/2018,0.00,,4.05,,"-1,024,276.35"
,IN,AR,30328371,1005,100,,Invoice,,,,,,08/10/2018,08/10/2018,0.00,,8.10,,"-1,024,284.45"
,IN,AR,30328372,1005,100,,Invoice,,,,,,08/10/2018,08/10/2018,0.00,,20.25,,"-1,024,304.70"
,IN,AR,30328373,1005,100,,Invoice,,,,,,08/10/2018,08/10/2018,0.00,,4.05,,"-1,024,308.75"
,IN,AR,30328374,1005,100,,Invoice,,,,,,08/10/2018,08/10/2018,0.00,,14.18,,"-1,024,322.93"
,IN,AR,30328375,1005,100,,Invoice,,,,,,08/10/2018,08/10/2018,0.00,,8.10,,"-1,024,331.03"
,IN,AR,30328401,1005,100,,Invoice,,,,,,08/10/2018,08/10/2018,0.00,,3.64,,"-1,024,334.67"
,IN,AR,30328402,1005,100,,Invoice,,,,,,08/10/2018,08/10/2018,0.00,,21.86,,"-1,024,356.53"
,IN,AR,30328432,1005,100,,Invoice,,,,,,08/10/2018,08/10/2018,0.00,,16.91,,"-1,024,373.44"
,IN,AR,30328452,1005,100,,Invoice,,,,,,08/10/2018,08/10/2018,0.00,,33.81,,"-1,024,407.25"
,IN,AR,30328473,1005,100,,Invoice,,,,,,08/10/2018,08/10/2018,0.00,,5.82,,"-1,024,413.07"
,IN,AR,30328478,1005,100,,Invoice,,,,,,08/10/2018,08/10/2018,0.00,,7.29,,"-1,024,420.36"
,IN,AR,30328492,1005,100,,Invoice,,,,,,08/10/2018,08/10/2018,0.00,,104.41,,"-1,024,524.77"
,IN,AR,30328515,1005,100,,Invoice,,,,,,08/10/2018,08/10/2018,0.00,,16.53,,"-1,024,541.30"
,IN,AR,30328527,1005,100,,Invoice,,,,,,08/10/2018,08/10/2018,0.00,,42.00,,"-1,024,583.30"
,IN,AR,30328538,1005,100,,Invoice,,,,,,08/10/2018,08/10/2018,0.00,,29.66,,"-1,024,612.96"
,IN,AR,30328544,1005,100,,Invoice,,,,,,08/10/2018,08/10/2018,0.00,,74.23,,"-1,024,687.19"
,IN,AR,30328559,1005,100,,Invoice,,,,,,08/10/2018,08/10/2018,0.00,,7.29,,"-1,024,694.48"
,IN,AR,30328561,1005,100,,Invoice,,,,,,08/10/2018,08/10/2018,0.00,,38.00,,"-1,024,732.48"
,IN,AR,30328562,1005,100,,Invoice,,,,,,08/10/2018,08/10/2018,0.00,,8.00,,"-1,024,740.48"
,IN,AR,30328583,1005,100,,Invoice,,,,,,08/10/2018,08/10/2018,0.00,,5.51,,"-1,024,745.99"
,IN,AR,30328588,1005,100,,Invoice,,,,,,08/10/2018,08/10/2018,0.00,,30.51,,"-1,024,776.50"
,IN,AR,30328592,1005,100,,Invoice,,,,,,08/10/2018,08/10/2018,0.00,,5.51,,"-1,024,782.01"
,IN,AR,30328609,1005,100,,Invoice,,,,,,08/10/2018,08/10/2018,0.00,,5.85,,"-1,024,787.86"
,IN,AR,30328623,1005,100,,Invoice,,,,,,08/10/2018,08/10/2018,0.00,,8.00,,"-1,024,795.86"
,IN,AR,30328676,1005,100,,Invoice,,,,,,08/10/2018,08/10/2018,0.00,,10.93,,"-1,024,806.79"
,IN,AR,30328678,1005,100,,Invoice,,,,,,08/10/2018,08/10/2018,0.00,,32.00,,"-1,024,838.79"
,IN,AR,30328708,1005,100,,Invoice,,,,,,08/10/2018,08/10/2018,0.00,,16.10,,"-1,024,854.89"
,IN,AR,30328719,1005,100,,Invoice,,,,,,08/10/2018,08/10/2018,0.00,,32.80,,"-1,024,887.69"
,IN,AR,30328725,1005,100,,Invoice,,,,,,08/10/2018,08/10/2018,0.00,,10.93,,"-1,024,898.62"
,IN,AR,30328734,1005,100,,Invoice,,,,,,08/10/2018,08/10/2018,0.00,,14.58,,"-1,024,913.20"
,IN,AR,30328738,1005,100,,Invoice,,,,,,08/10/2018,08/10/2018,0.00,,18.09,,"-1,024,931.29"
,IN,AR,30328751,1005,100,,Invoice,,,,,,08/10/2018,08/10/2018,0.00,,12.92,,"-1,024,944.21"
,IN,AR,30328754,1005,100,,Invoice,,,,,,08/10/2018,08/10/2018,0.00,,3.64,,"-1,024,947.85"
,IN,AR,30328760,1005,100,,Invoice,,,,,,08/10/2018,08/10/2018,0.00,,7.19,,"-1,024,955.04"
,IN,AR,30328768,1005,100,,Invoice,,,,,,08/10/2018,08/10/2018,0.00,,11.48,,"-1,024,966.52"
,IN,AR,30328800,1005,100,,Invoice,,,,,,08/10/2018,08/10/2018,0.00,,6.36,,"-1,024,972.88"
,IN,AR,30328805,1005,100,,Invoice,,,,,,08/10/2018,08/10/2018,0.00,,58.98,,"-1,025,031.86"
,IN,AR,30328832,1005,100,,Invoice,,,,,,08/10/2018,08/10/2018,0.00,,14.83,,"-1,025,046.69"
,IN,AR,30328835,1005,100,,Invoice,,,,,,08/10/2018,08/10/2018,0.00,,25.85,,"-1,025,072.54"
,IN,AR,30328851,1005,100,,Invoice,,,,,,08/10/2018,08/10/2018,0.00,,10.38,,"-1,025,082.92"
,IN,AR,30328855,1005,100,,Invoice,,,,,,08/10/2018,08/10/2018,0.00,,2.58,,"-1,025,085.50"
,IN,AR,30328870,1005,100,,Invoice,,,,,,08/10/2018,08/10/2018,0.00,,7.29,,"-1,025,092.79"
,IN,AR,30328898,1005,100,,Invoice,,,,,,08/10/2018,08/10/2018,0.00,,98.44,,"-1,025,191.23"
,IN,AR,30328913,1005,100,,Invoice,,,,,,08/10/2018,08/10/2018,0.00,,20.34,,"-1,025,211.57"
,IN,AR,30328931,1005,100,,Invoice,,,,,,08/10/2018,08/10/2018,0.00,,7.17,,"-1,025,218.74"
,IN,AR,30328945,1005,100,,Invoice,,,,,,08/10/2018,08/10/2018,0.00,,28.98,,"-1,025,247.72"
,IN,AR,30328957,1005,100,,Invoice,,,,,,08/10/2018,08/10/2018,0.00,,12.03,,"-1,025,259.75"
,IN,AR,30328969,1005,100,,Invoice,,,,,,08/10/2018,08/10/2018,0.00,,4.24,,"-1,025,263.99"
,IN,AR,30328975,1005,100,,Invoice,,,,,,08/10/2018,08/10/2018,0.00,,6.02,,"-1,025,270.01"
,IN,AR,30328978,1005,100,,Invoice,,,,,,08/10/2018,08/10/2018,0.00,,5.51,,"-1,025,275.52"
,IN,AR,30328994,1005,100,,Invoice,,,,,,08/10/2018,08/10/2018,0.00,,6.02,,"-1,025,281.54"
,IN,AR,30329033,1005,100,,Invoice,,,,,,08/10/2018,08/10/2018,0.00,,7.63,,"-1,025,289.17"
,IN,AR,30329077,1005,100,,Invoice,,,,,,08/10/2018,08/10/2018,0.00,,20.68,,"-1,025,309.85"
,IN,AR,30329125,1005,100,,Invoice,,,,,,08/10/2018,08/10/2018,0.00,,4.24,,"-1,025,314.09"
,IN,AR,30329154,1005,100,,Invoice,,,,,,08/10/2018,08/10/2018,0.00,,27.97,,"-1,025,342.06"
,IN,AR,30329169,1005,100,,Invoice,,,,,,08/10/2018,08/10/2018,0.00,,14.24,,"-1,025,356.30"
,IN,AR,30329186,1005,100,,Invoice,,,,,,08/10/2018,08/10/2018,0.00,,14.58,,"-1,025,370.88"
,IN,AR,30329209,1005,100,,Invoice,,,,,,08/10/2018,08/10/2018,0.00,,3.64,,"-1,025,374.52"
,IN,AR,30329245,1005,100,,Invoice,,,,,,08/10/2018,08/10/2018,0.00,,5.51,,"-1,025,380.03"
,IN,AR,30329248,1005,100,,Invoice,,,,,,08/10/2018,08/10/2018,0.00,,7.29,,"-1,025,387.32"
,IN,AR,30329258,1005,100,,Invoice,,,,,,08/10/2018,08/10/2018,0.00,,8.26,,"-1,025,395.58"
,IN,AR,30329263,1005,100,,Invoice,,,,,,08/10/2018,08/10/2018,0.00,,15.21,,"-1,025,410.79"
,IN,AR,30329270,1005,100,,Invoice,,,,,,08/10/2018,08/10/2018,0.00,,11.48,,"-1,025,422.27"
,IN,AR,30329284,1005,100,,Invoice,,,,,,08/10/2018,08/10/2018,0.00,,10.51,,"-1,025,432.78"
,IN,AR,30329322,1005,100,,Invoice,,,,,,08/10/2018,08/10/2018,0.00,,5.85,,"-1,025,438.63"
,IN,AR,30329339,1005,100,,Invoice,,,,,,08/10/2018,08/10/2018,0.00,,68.34,,"-1,025,506.97"
,IN,AR,30329348,1005,100,,Invoice,,,,,,08/10/2018,08/10/2018,0.00,,7.29,,"-1,025,514.26"
,IN,AR,30329351,1005,100,,Invoice,,,,,,08/10/2018,08/10/2018,0.00,,18.00,,"-1,025,532.26"
,IN,AR,30329390,1005,100,,Invoice,,,,,,08/10/2018,08/10/2018,0.00,,7.75,,"-1,025,540.01"
,IN,AR,30329408,1005,100,,Invoice,,,,,,08/10/2018,08/10/2018,0.00,,45.97,,"-1,025,585.98"
,IN,AR,30329417,1005,100,,Invoice,,,,,,08/10/2018,08/10/2018,0.00,,4.49,,"-1,025,590.47"
,IN,AR,30329478,1005,100,,Invoice,,,,,,08/10/2018,08/10/2018,0.00,,8.81,,"-1,025,599.28"
,IN,AR,30329503,1005,100,,Invoice,,,,,,08/10/2018,08/10/2018,0.00,,7.29,,"-1,025,606.57"
,IN,AR,30329507,1005,100,,Invoice,,,,,,08/10/2018,08/10/2018,0.00,,10.93,,"-1,025,617.50"
,IN,AR,30329512,1005,100,,Invoice,,,,,,08/10/2018,08/10/2018,0.00,,7.29,,"-1,025,624.79"
,IN,AR,30329519,1005,100,,Invoice,,,,,,08/10/2018,08/10/2018,0.00,,14.58,,"-1,025,639.37"
,IN,AR,30329581,1005,100,,Invoice,,,,,,08/10/2018,08/10/2018,0.00,,4.29,,"-1,025,643.66"
,IN,AR,30329603,1005,100,,Invoice,,,,,,08/10/2018,08/10/2018,0.00,,10.93,,"-1,025,654.59"
,IN,AR,30329664,1005,100,,Invoice,,,,,,08/10/2018,08/10/2018,0.00,,56.78,,"-1,025,711.37"
,IN,AR,30329683,1005,100,,Invoice,,,,,,08/10/2018,08/10/2018,0.00,,6.43,,"-1,025,717.80"
,IN,AR,30329691,1005,100,,Invoice,,,,,,08/10/2018,08/10/2018,0.00,,22.05,,"-1,025,739.85"
,IN,AR,30329713,1005,100,,Invoice,,,,,,08/10/2018,08/10/2018,0.00,,24.29,,"-1,025,764.14"
,IN,AR,30329739,1005,100,,Invoice,,,,,,08/10/2018,08/10/2018,0.00,,18.39,,"-1,025,782.53"
,IN,AR,30329746,1005,100,,Invoice,,,,,,08/10/2018,08/10/2018,0.00,,4.58,,"-1,025,787.11"
,IN,AR,30329761,1005,100,,Invoice,,,,,,08/10/2018,08/10/2018,0.00,,21.86,,"-1,025,808.97"
,IN,AR,30329776,1005,100,,Invoice,,,,,,08/10/2018,08/10/2018,0.00,,10.93,,"-1,025,819.90"
,IN,AR,30329809,1005,100,,Invoice,,,,,,08/10/2018,08/10/2018,0.00,,8.00,,"-1,025,827.90"
,IN,AR,30329847,1005,100,,Invoice,,,,,,08/10/2018,08/10/2018,0.00,,48.27,,"-1,025,876.17"
,IN,AR,30329870,1005,100,,Invoice,,,,,,08/10/2018,08/10/2018,0.00,,4.20,,"-1,025,880.37"
,IN,AR,30329871,1005,100,,Invoice,,,,,,08/10/2018,08/10/2018,0.00,,16.82,,"-1,025,897.19"
,IN,AR,30329899,1005,100,,Invoice,,,,,,08/10/2018,08/10/2018,0.00,,14.58,,"-1,025,911.77"
,IN,AR,30329905,1005,100,,Invoice,,,,,,08/10/2018,08/10/2018,0.00,,24.16,,"-1,025,935.93"
,IN,AR,30329909,1005,100,,Invoice,,,,,,08/10/2018,08/10/2018,0.00,,156.14,,"-1,026,092.07"
,IN,AR,30329922,1005,100,,Invoice,,,,,,08/10/2018,08/10/2018,0.00,,19.64,,"-1,026,111.71"
,IN,AR,30329984,1005,100,,Invoice,,,,,,08/10/2018,08/10/2018,0.00,,37.37,,"-1,026,149.08"
,IN,AR,30329994,1005,100,,Invoice,,,,,,08/10/2018,08/10/2018,0.00,,12.75,,"-1,026,161.83"
,IN,AR,30330090,1005,100,,Invoice,,,,,,08/10/2018,08/10/2018,0.00,,12.00,,"-1,026,173.83"
,IN,AR,30330104,1005,100,,Invoice,,,,,,08/10/2018,08/10/2018,0.00,,1.88,,"-1,026,175.71"
,IN,AR,30330105,1005,100,,Invoice,,,,,,08/10/2018,08/10/2018,0.00,,5.64,,"-1,026,181.35"
,IN,AR,30330128,1005,100,,Invoice,,,,,,08/10/2018,08/10/2018,0.00,,18.17,,"-1,026,199.52"
,IN,AR,30330131,1005,100,,Invoice,,,,,,08/10/2018,08/10/2018,0.00,,14.58,,"-1,026,214.10"
,IN,AR,30330161,1005,100,,Invoice,,,,,,08/10/2018,08/10/2018,0.00,,10.95,,"-1,026,225.05"
,IN,AR,30330205,1005,100,,Invoice,,,,,,08/10/2018,08/10/2018,0.00,,5.24,,"-1,026,230.29"
,IN,AR,30330208,1005,100,,Invoice,,,,,,08/10/2018,08/10/2018,0.00,,5.26,,"-1,026,235.55"
,IN,AR,30330221,1005,100,,Invoice,,,,,,08/10/2018,08/10/2018,0.00,,4.08,,"-1,026,239.63"
,IN,AR,30330245,1005,100,,Invoice,,,,,,08/10/2018,08/10/2018,0.00,,5.51,,"-1,026,245.14"
,IN,AR,30330256,1005,100,,Invoice,,,,,,08/10/2018,08/10/2018,0.00,,35.08,,"-1,026,280.22"
,IN,AR,30330285,1005,100,,Invoice,,,,,,08/10/2018,08/10/2018,0.00,,4.15,,"-1,026,284.37"
,IN,AR,30330286,1005,100,,Invoice,,,,,,08/10/2018,08/10/2018,0.00,,8.31,,"-1,026,292.68"
,IN,AR,30330287,1005,100,,Invoice,,,,,,08/10/2018,08/10/2018,0.00,,14.53,,"-1,026,307.21"
,IN,AR,30330288,1005,100,,Invoice,,,,,,08/10/2018,08/10/2018,0.00,,6.23,,"-1,026,313.44"
,IN,AR,30330289,1005,100,,Invoice,,,,,,08/10/2018,08/10/2018,0.00,,4.15,,"-1,026,317.59"
,IN,AR,30330409,1005,100,,Invoice,,,,,,08/10/2018,08/10/2018,0.00,,42.05,,"-1,026,359.64"
,IN,AR,30330465,1005,100,,Invoice,,,,,,08/10/2018,08/10/2018,0.00,,8.77,,"-1,026,368.41"
,IN,AR,30330503,1005,100,,Invoice,,,,,,08/10/2018,08/10/2018,0.00,,29.15,,"-1,026,397.56"
,CS,AR,32010627,1005,100,,Cash sale,,,,,,08/10/2018,08/10/2018,0.00,,182.20,,"-1,026,579.76"
,IN,AR,30330552,1005,100,,Invoice,,,,,,08/10/2018,08/10/2018,0.00,,10.93,,"-1,026,590.69"
,IN,AR,30330605,1005,100,,Invoice,,,,,,08/10/2018,08/10/2018,0.00,,54.66,,"-1,026,645.35"
,CS,AR,32009752,1005,100,,Cash sale,,,,,,09/10/2018,09/10/2018,0.00,,7.29,,"-1,026,652.64"
,CS,AR,32009762,1005,100,,Cash sale,,,,,,09/10/2018,09/10/2018,0.00,,10.93,,"-1,026,663.57"
,CS,AR,32009764,1005,100,,Cash sale,,,,,,09/10/2018,09/10/2018,0.00,,3.64,,"-1,026,667.21"
,CS,AR,32009766,1005,100,,Cash sale,,,,,,09/10/2018,09/10/2018,0.00,,7.29,,"-1,026,674.50"
,CS,AR,32009783,1005,100,,Cash sale,,,,,,09/10/2018,09/10/2018,0.00,,10.93,,"-1,026,685.43"
,CS,AR,32009787,1005,100,,Cash sale,,,,,,09/10/2018,09/10/2018,0.00,,10.93,,"-1,026,696.36"
,CS,AR,32009795,1005,100,,Cash sale,,,,,,09/10/2018,09/10/2018,0.00,,18.22,,"-1,026,714.58"
,CS,AR,32009807,1005,100,,Cash sale,,,,,,09/10/2018,09/10/2018,0.00,,3.01,,"-1,026,717.59"
,CS,AR,32009839,1005,100,,Cash sale,,,,,,09/10/2018,09/10/2018,0.00,,10.93,,"-1,026,728.52"
,CS,AR,32009886,1005,100,,Cash sale,,,,,,09/10/2018,09/10/2018,0.00,,10.93,,"-1,026,739.45"
,CS,AR,32009920,1005,100,,Cash sale,,,,,,09/10/2018,09/10/2018,0.00,,6.48,,"-1,026,745.93"
,CS,AR,32009928,1005,100,,Cash sale,,,,,,09/10/2018,09/10/2018,0.00,,10.93,,"-1,026,756.86"
,CS,AR,32009952,1005,100,,Cash sale,,,,,,09/10/2018,09/10/2018,0.00,,2.84,,"-1,026,759.70"
,CS,AR,32009960,1005,100,,Cash sale,,,,,,09/10/2018,09/10/2018,0.00,,10.93,,"-1,026,770.63"
,CS,AR,32009989,1005,100,,Cash sale,,,,,,09/10/2018,09/10/2018,0.00,,7.29,,"-1,026,777.92"
,CS,AR,32010005,1005,100,,Cash sale,,,,,,09/10/2018,09/10/2018,0.00,,3.64,,"-1,026,781.56"
,CS,AR,32010013,1005,100,,Cash sale,,,,,,09/10/2018,09/10/2018,0.00,,10.17,,"-1,026,791.73"
,CS,AR,32010032,1005,100,,Cash sale,,,,,,09/10/2018,09/10/2018,0.00,,8.16,,"-1,026,799.89"
,CS,AR,32010037,1005,100,,Cash sale,,,,,,09/10/2018,09/10/2018,0.00,,3.90,,"-1,026,803.79"
,CS,AR,32010075,1005,100,,Cash sale,,,,,,09/10/2018,09/10/2018,0.00,,7.29,,"-1,026,811.08"
,CS,AR,32010091,1005,100,,Cash sale,,,,,,09/10/2018,09/10/2018,0.00,,10.34,,"-1,026,821.42"
,CS,AR,32010102,1005,100,,Cash sale,,,,,,09/10/2018,09/10/2018,0.00,,10.93,,"-1,026,832.35"
,CS,AR,32010112,1005,100,,Cash sale,,,,,,09/10/2018,09/10/2018,0.00,,3.90,,"-1,026,836.25"
,CS,AR,32010123,1005,100,,Cash sale,,,,,,09/10/2018,09/10/2018,0.00,,3.64,,"-1,026,839.89"
,CS,AR,32010184,1005,100,,Cash sale,,,,,,09/10/2018,09/10/2018,0.00,,7.29,,"-1,026,847.18"
,CS,AR,32010236,1005,100,,Cash sale,,,,,,09/10/2018,09/10/2018,0.00,,7.29,,"-1,026,854.47"
,CS,AR,32010255,1005,100,,Cash sale,,,,,,09/10/2018,09/10/2018,0.00,,7.29,,"-1,026,861.76"
,CS,AR,32010274,1005,100,,Cash sale,,,,,,09/10/2018,09/10/2018,0.00,,30.00,,"-1,026,891.76"
,CS,AR,32010311,1005,100,,Cash sale,,,,,,09/10/2018,09/10/2018,0.00,,5.47,,"-1,026,897.23"
,CS,AR,32010341,1005,100,,Cash sale,,,,,,09/10/2018,09/10/2018,0.00,,20.76,,"-1,026,917.99"
,CS,AR,32010361,1005,100,,Cash sale,,,,,,09/10/2018,09/10/2018,0.00,,5.50,,"-1,026,923.49"
,CS,AR,32010365,1005,100,,Cash sale,,,,,,09/10/2018,09/10/2018,0.00,,10.93,,"-1,026,934.42"
,CS,AR,32010443,1005,100,,Cash sale,,,,,,09/10/2018,09/10/2018,0.00,,10.93,,"-1,026,945.35"
,CS,AR,32010450,1005,100,,Cash sale,,,,,,09/10/2018,09/10/2018,0.00,,10.93,,"-1,026,956.28"
,CS,AR,32010452,1005,100,,Cash sale,,,,,,09/10/2018,09/10/2018,0.00,,8.21,,"-1,026,964.49"
,CS,AR,32010551,1005,100,,Cash sale,,,,,,09/10/2018,09/10/2018,0.00,,6.19,,"-1,026,970.68"
,CS,AR,32010564,1005,100,,Cash sale,,,,,,09/10/2018,09/10/2018,0.00,,7.29,,"-1,026,977.97"
,CS,AR,32010571,1005,100,,Cash sale,,,,,,09/10/2018,09/10/2018,0.00,,3.64,,"-1,026,981.61"
,IN,AR,30328307,1005,100,,Invoice,,,,,,09/10/2018,09/10/2018,0.00,,3.01,,"-1,026,984.62"
,IN,AR,30328314,1005,100,,Invoice,,,,,,09/10/2018,09/10/2018,0.00,,62.29,,"-1,027,046.91"
,IN,AR,30328442,1005,100,,Invoice,,,,,,09/10/2018,09/10/2018,0.00,,7.29,,"-1,027,054.20"
,IN,AR,30328448,1005,100,,Invoice,,,,,,09/10/2018,09/10/2018,0.00,,7.00,,"-1,027,061.20"
,IN,AR,30328480,1005,100,,Invoice,,,,,,09/10/2018,09/10/2018,0.00,,5.97,,"-1,027,067.17"
,IN,AR,30328493,1005,100,,Invoice,,,,,,09/10/2018,09/10/2018,0.00,,33.22,,"-1,027,100.39"
,IN,AR,30328579,1005,100,,Invoice,,,,,,09/10/2018,09/10/2018,0.00,,10.93,,"-1,027,111.32"
,IN,AR,30328593,1005,100,,Invoice,,,,,,09/10/2018,09/10/2018,0.00,,11.02,,"-1,027,122.34"
,IN,AR,30328637,1005,100,,Invoice,,,,,,09/10/2018,09/10/2018,0.00,,21.86,,"-1,027,144.20"
,IN,AR,30328640,1005,100,,Invoice,,,,,,09/10/2018,09/10/2018,0.00,,25.51,,"-1,027,169.71"
,IN,AR,30328656,1005,100,,Invoice,,,,,,09/10/2018,09/10/2018,0.00,,14.58,,"-1,027,184.29"
,IN,AR,30328690,1005,100,,Invoice,,,,,,09/10/2018,09/10/2018,0.00,,27.47,,"-1,027,211.76"
,IN,AR,30328694,1005,100,,Invoice,,,,,,09/10/2018,09/10/2018,0.00,,10.93,,"-1,027,222.69"
,IN,AR,30328724,1005,100,,Invoice,,,,,,09/10/2018,09/10/2018,0.00,,10.93,,"-1,027,233.62"
,IN,AR,30328730,1005,100,,Invoice,,,,,,09/10/2018,09/10/2018,0.00,,15.93,,"-1,027,249.55"
,IN,AR,30328757,1005,100,,Invoice,,,,,,09/10/2018,09/10/2018,0.00,,2.32,,"-1,027,251.87"
,IN,AR,30328772,1005,100,,Invoice,,,,,,09/10/2018,09/10/2018,0.00,,10.17,,"-1,027,262.04"
,IN,AR,30328778,1005,100,,Invoice,,,,,,09/10/2018,09/10/2018,0.00,,10.51,,"-1,027,272.55"
,IN,AR,30328791,1005,100,,Invoice,,,,,,09/10/2018,09/10/2018,0.00,,8.47,,"-1,027,281.02"
,IN,AR,30328816,1005,100,,Invoice,,,,,,09/10/2018,09/10/2018,0.00,,2.16,,"-1,027,283.18"
,IN,AR,30328825,1005,100,,Invoice,,,,,,09/10/2018,09/10/2018,0.00,,8.47,,"-1,027,291.65"
,IN,AR,30328866,1005,100,,Invoice,,,,,,09/10/2018,09/10/2018,0.00,,14.58,,"-1,027,306.23"
,IN,AR,30328876,1005,100,,Invoice,,,,,,09/10/2018,09/10/2018,0.00,,12.03,,"-1,027,318.26"
,IN,AR,30328892,1005,100,,Invoice,,,,,,09/10/2018,09/10/2018,0.00,,5.85,,"-1,027,324.11"
,IN,AR,30328981,1005,100,,Invoice,,,,,,09/10/2018,09/10/2018,0.00,,41.95,,"-1,027,366.06"
,IN,AR,30328988,1005,100,,Invoice,,,,,,09/10/2018,09/10/2018,0.00,,22.47,,"-1,027,388.53"
,IN,AR,30329052,1005,100,,Invoice,,,,,,09/10/2018,09/10/2018,0.00,,7.29,,"-1,027,395.82"
,IN,AR,30329072,1005,100,,Invoice,,,,,,09/10/2018,09/10/2018,0.00,,12.71,,"-1,027,408.53"
,IN,AR,30329128,1005,100,,Invoice,,,,,,09/10/2018,09/10/2018,0.00,,25.42,,"-1,027,433.95"
,IN,AR,30329135,1005,100,,Invoice,,,,,,09/10/2018,09/10/2018,0.00,,5.85,,"-1,027,439.80"
,IN,AR,30329147,1005,100,,Invoice,,,,,,09/10/2018,09/10/2018,0.00,,28.47,,"-1,027,468.27"
,IN,AR,30329178,1005,100,,Invoice,,,,,,09/10/2018,09/10/2018,0.00,,9.92,,"-1,027,478.19"
,IN,AR,30329189,1005,100,,Invoice,,,,,,09/10/2018,09/10/2018,0.00,,10.17,,"-1,027,488.36"
,IN,AR,30329198,1005,100,,Invoice,,,,,,09/10/2018,09/10/2018,0.00,,5.85,,"-1,027,494.21"
,IN,AR,30329199,1005,100,,Invoice,,,,,,09/10/2018,09/10/2018,0.00,,12.28,,"-1,027,506.49"
,IN,AR,30329215,1005,100,,Invoice,,,,,,09/10/2018,09/10/2018,0.00,,14.58,,"-1,027,521.07"
,IN,AR,30329233,1005,100,,Invoice,,,,,,09/10/2018,09/10/2018,0.00,,6.36,,"-1,027,527.43"
,IN,AR,30329241,1005,100,,Invoice,,,,,,09/10/2018,09/10/2018,0.00,,6.48,,"-1,027,533.91"
,IN,AR,30329252,1005,100,,Invoice,,,,,,09/10/2018,09/10/2018,0.00,,7.63,,"-1,027,541.54"
,IN,AR,30329254,1005,100,,Invoice,,,,,,09/10/2018,09/10/2018,0.00,,7.29,,"-1,027,548.83"
,IN,AR,30329274,1005,100,,Invoice,,,,,,09/10/2018,09/10/2018,0.00,,16.83,,"-1,027,565.66"
,IN,AR,30329300,1005,100,,Invoice,,,,,,09/10/2018,09/10/2018,0.00,,5.17,,"-1,027,570.83"
,IN,AR,30329358,1005,100,,Invoice,,,,,,09/10/2018,09/10/2018,0.00,,19.30,,"-1,027,590.13"
,IN,AR,30329385,1005,100,,Invoice,,,,,,09/10/2018,09/10/2018,0.00,,8.39,,"-1,027,598.52"
,IN,AR,30329397,1005,100,,Invoice,,,,,,09/10/2018,09/10/2018,0.00,,5.86,,"-1,027,604.38"
,IN,AR,30329415,1005,100,,Invoice,,,,,,09/10/2018,09/10/2018,0.00,,25.51,,"-1,027,629.89"
,IN,AR,30329433,1005,100,,Invoice,,,,,,09/10/2018,09/10/2018,0.00,,17.56,,"-1,027,647.45"
,IN,AR,30329448,1005,100,,Invoice,,,,,,09/10/2018,09/10/2018,0.00,,3.64,,"-1,027,651.09"
,IN,AR,30329453,1005,100,,Invoice,,,,,,09/10/2018,09/10/2018,0.00,,23.58,,"-1,027,674.67"
,IN,AR,30329479,1005,100,,Invoice,,,,,,09/10/2018,09/10/2018,0.00,,3.53,,"-1,027,678.20"
,IN,AR,30329522,1005,100,,Invoice,,,,,,09/10/2018,09/10/2018,0.00,,47.37,,"-1,027,725.57"
,IN,AR,30329632,1005,100,,Invoice,,,,,,09/10/2018,09/10/2018,0.00,,11.95,,"-1,027,737.52"
,IN,AR,30329633,1005,100,,Invoice,,,,,,09/10/2018,09/10/2018,0.00,,11.95,,"-1,027,749.47"
,IN,AR,30329726,1005,100,,Invoice,,,,,,09/10/2018,09/10/2018,0.00,,209.17,,"-1,027,958.64"
,IN,AR,30329752,1005,100,,Invoice,,,,,,09/10/2018,09/10/2018,0.00,,9.84,,"-1,027,968.48"
,IN,AR,30329789,1005,100,,Invoice,,,,,,09/10/2018,09/10/2018,0.00,,7.63,,"-1,027,976.11"
,IN,AR,30329816,1005,100,,Invoice,,,,,,09/10/2018,09/10/2018,0.00,,20.01,,"-1,027,996.12"
,IN,AR,30329864,1005,100,,Invoice,,,,,,09/10/2018,09/10/2018,0.00,,18.22,,"-1,028,014.34"
,IN,AR,30329917,1005,100,,Invoice,,,,,,09/10/2018,09/10/2018,0.00,,36.44,,"-1,028,050.78"
,IN,AR,30329918,1005,100,,Invoice,,,,,,09/10/2018,09/10/2018,0.00,,3.64,,"-1,028,054.42"
,IN,AR,30329944,1005,100,,Invoice,,,,,,09/10/2018,09/10/2018,0.00,,128.00,,"-1,028,182.42"
,IN,AR,30329956,1005,100,,Invoice,,,,,,09/10/2018,09/10/2018,0.00,,45.08,,"-1,028,227.50"
,IN,AR,30329973,1005,100,,Invoice,,,,,,09/10/2018,09/10/2018,0.00,,2.54,,"-1,028,230.04"
,IN,AR,30330024,1005,100,,Invoice,,,,,,09/10/2018,09/10/2018,0.00,,100.34,,"-1,028,330.38"
,IN,AR,30330064,1005,100,,Invoice,,,,,,09/10/2018,09/10/2018,0.00,,46.69,,"-1,028,377.07"
,IN,AR,30330066,1005,100,,Invoice,,,,,,09/10/2018,09/10/2018,0.00,,23.73,,"-1,028,400.80"
,IN,AR,30330067,1005,100,,Invoice,,,,,,09/10/2018,09/10/2018,0.00,,66.44,,"-1,028,467.24"
,IN,AR,30330078,1005,100,,Invoice,,,,,,09/10/2018,09/10/2018,0.00,,14.24,,"-1,028,481.48"
,IN,AR,30330087,1005,100,,Invoice,,,,,,09/10/2018,09/10/2018,0.00,,3.64,,"-1,028,485.12"
,IN,AR,30330097,1005,100,,Invoice,,,,,,09/10/2018,09/10/2018,0.00,,3.64,,"-1,028,488.76"
,IN,AR,30330116,1005,100,,Invoice,,,,,,09/10/2018,09/10/2018,0.00,,3.51,,"-1,028,492.27"
,IN,AR,30330121,1005,100,,Invoice,,,,,,09/10/2018,09/10/2018,0.00,,6.00,,"-1,028,498.27"
,IN,AR,30330134,1005,100,,Invoice,,,,,,09/10/2018,09/10/2018,0.00,,88.75,,"-1,028,587.02"
,IN,AR,30330141,1005,100,,Invoice,,,,,,09/10/2018,09/10/2018,0.00,,7.29,,"-1,028,594.31"
,IN,AR,30330148,1005,100,,Invoice,,,,,,09/10/2018,09/10/2018,0.00,,10.93,,"-1,028,605.24"
,IN,AR,30330149,1005,100,,Invoice,,,,,,09/10/2018,09/10/2018,0.00,,7.02,,"-1,028,612.26"
,IN,AR,30330171,1005,100,,Invoice,,,,,,09/10/2018,09/10/2018,0.00,,8.75,,"-1,028,621.01"
,IN,AR,30330172,1005,100,,Invoice,,,,,,09/10/2018,09/10/2018,0.00,,10.93,,"-1,028,631.94"
,IN,AR,30330184,1005,100,,Invoice,,,,,,09/10/2018,09/10/2018,0.00,,12.14,,"-1,028,644.08"
,IN,AR,30330215,1005,100,,Invoice,,,,,,09/10/2018,09/10/2018,0.00,,7.86,,"-1,028,651.94"
,IN,AR,30330222,1005,100,,Invoice,,,,,,09/10/2018,09/10/2018,0.00,,42.89,,"-1,028,694.83"
,IN,AR,30330247,1005,100,,Invoice,,,,,,09/10/2018,09/10/2018,0.00,,11.19,,"-1,028,706.02"
,IN,AR,30330249,1005,100,,Invoice,,,,,,09/10/2018,09/10/2018,0.00,,15.93,,"-1,028,721.95"
,IN,AR,30330290,1005,100,,Invoice,,,,,,09/10/2018,09/10/2018,0.00,,4.15,,"-1,028,726.10"
,IN,AR,30330291,1005,100,,Invoice,,,,,,09/10/2018,09/10/2018,0.00,,2.08,,"-1,028,728.18"
,IN,AR,30330292,1005,100,,Invoice,,,,,,09/10/2018,09/10/2018,0.00,,8.31,,"-1,028,736.49"
,IN,AR,30330346,1005,100,,Invoice,,,,,,09/10/2018,09/10/2018,0.00,,48.31,,"-1,028,784.80"
,IN,AR,30330352,1005,100,,Invoice,,,,,,09/10/2018,09/10/2018,0.00,,9.66,,"-1,028,794.46"
,IN,AR,30330372,1005,100,,Invoice,,,,,,09/10/2018,09/10/2018,0.00,,7.29,,"-1,028,801.75"
,IN,AR,30330384,1005,100,,Invoice,,,,,,09/10/2018,09/10/2018,0.00,,13.56,,"-1,028,815.31"
,IN,AR,30330417,1005,100,,Invoice,,,,,,09/10/2018,09/10/2018,0.00,,29.15,,"-1,028,844.46"
,IN,AR,30330431,1005,100,,Invoice,,,,,,09/10/2018,09/10/2018,0.00,,29.15,,"-1,028,873.61"
,IN,AR,30330432,1005,100,,Invoice,,,,,,09/10/2018,09/10/2018,0.00,,115.29,,"-1,028,988.90"
,IN,AR,30330442,1005,100,,Invoice,,,,,,09/10/2018,09/10/2018,0.00,,29.15,,"-1,029,018.05"
,IN,AR,30330446,1005,100,,Invoice,,,,,,09/10/2018,09/10/2018,0.00,,75.69,,"-1,029,093.74"
,IN,AR,30330452,1005,100,,Invoice,,,,,,09/10/2018,09/10/2018,0.00,,7.29,,"-1,029,101.03"
,IN,AR,30330500,1005,100,,Invoice,,,,,,09/10/2018,09/10/2018,0.00,,6.08,,"-1,029,107.11"
,CN,AR,31019383,1005,100,,Credit Note,,,,,,09/10/2018,09/10/2018,182.20,,0.00,,"-1,028,924.91"
,IN,AR,30330713,1005,100,,Invoice,,,,,,09/10/2018,09/10/2018,0.00,,419.07,,"-1,029,343.98"
,CN,AR,31019189,1005,100,,Credit Note,,,,,,10/10/2018,10/10/2018,10.93,,0.00,,"-1,029,333.05"
,CN,AR,31019308,1005,100,,Credit Note,,,,,,10/10/2018,10/10/2018,3.03,,0.00,,"-1,029,330.02"
,CS,AR,32009712,1005,100,,Cash sale,,,,,,10/10/2018,10/10/2018,0.00,,5.61,,"-1,029,335.63"
,CS,AR,32009725,1005,100,,Cash sale,,,,,,10/10/2018,10/10/2018,0.00,,20.07,,"-1,029,355.70"
,CS,AR,32009747,1005,100,,Cash sale,,,,,,10/10/2018,10/10/2018,0.00,,3.64,,"-1,029,359.34"
,CS,AR,32009772,1005,100,,Cash sale,,,,,,10/10/2018,10/10/2018,0.00,,7.29,,"-1,029,366.63"
,CS,AR,32009797,1005,100,,Cash sale,,,,,,10/10/2018,10/10/2018,0.00,,60.17,,"-1,029,426.80"
,CS,AR,32009817,1005,100,,Cash sale,,,,,,10/10/2018,10/10/2018,0.00,,3.64,,"-1,029,430.44"
,CS,AR,32009842,1005,100,,Cash sale,,,,,,10/10/2018,10/10/2018,0.00,,9.03,,"-1,029,439.47"
,CS,AR,32009894,1005,100,,Cash sale,,,,,,10/10/2018,10/10/2018,0.00,,2.92,,"-1,029,442.39"
,CS,AR,32009908,1005,100,,Cash sale,,,,,,10/10/2018,10/10/2018,0.00,,5.17,,"-1,029,447.56"
,CS,AR,32009955,1005,100,,Cash sale,,,,,,10/10/2018,10/10/2018,0.00,,12.92,,"-1,029,460.48"
,CS,AR,32009962,1005,100,,Cash sale,,,,,,10/10/2018,10/10/2018,0.00,,46.53,,"-1,029,507.01"
,CS,AR,32009973,1005,100,,Cash sale,,,,,,10/10/2018,10/10/2018,0.00,,21.06,,"-1,029,528.07"
,CS,AR,32009975,1005,100,,Cash sale,,,,,,10/10/2018,10/10/2018,0.00,,6.43,,"-1,029,534.50"
,CS,AR,32009992,1005,100,,Cash sale,,,,,,10/10/2018,10/10/2018,0.00,,18.22,,"-1,029,552.72"
,CS,AR,32010004,1005,100,,Cash sale,,,,,,10/10/2018,10/10/2018,0.00,,4.66,,"-1,029,557.38"
,CS,AR,32010011,1005,100,,Cash sale,,,,,,10/10/2018,10/10/2018,0.00,,3.64,,"-1,029,561.02"
,CS,AR,32010063,1005,100,,Cash sale,,,,,,10/10/2018,10/10/2018,0.00,,5.17,,"-1,029,566.19"
,CS,AR,32010068,1005,100,,Cash sale,,,,,,10/10/2018,10/10/2018,0.00,,7.29,,"-1,029,573.48"
,CS,AR,32010071,1005,100,,Cash sale,,,,,,10/10/2018,10/10/2018,0.00,,3.64,,"-1,029,577.12"
,CS,AR,32010088,1005,100,,Cash sale,,,,,,10/10/2018,10/10/2018,0.00,,7.29,,"-1,029,584.41"
,CS,AR,32010125,1005,100,,Cash sale,,,,,,10/10/2018,10/10/2018,0.00,,38.77,,"-1,029,623.18"
,CS,AR,32010129,1005,100,,Cash sale,,,,,,10/10/2018,10/10/2018,0.00,,10.34,,"-1,029,633.52"
,CS,AR,32010131,1005,100,,Cash sale,,,,,,10/10/2018,10/10/2018,0.00,,3.64,,"-1,029,637.16"
,CS,AR,32010134,1005,100,,Cash sale,,,,,,10/10/2018,10/10/2018,0.00,,14.58,,"-1,029,651.74"
,CS,AR,32010150,1005,100,,Cash sale,,,,,,10/10/2018,10/10/2018,0.00,,7.29,,"-1,029,659.03"
,CS,AR,32010161,1005,100,,Cash sale,,,,,,10/10/2018,10/10/2018,0.00,,7.29,,"-1,029,666.32"
,CS,AR,32010170,1005,100,,Cash sale,,,,,,10/10/2018,10/10/2018,0.00,,7.29,,"-1,029,673.61"
,CS,AR,32010226,1005,100,,Cash sale,,,,,,10/10/2018,10/10/2018,0.00,,21.36,,"-1,029,694.97"
,CS,AR,32010264,1005,100,,Cash sale,,,,,,10/10/2018,10/10/2018,0.00,,7.29,,"-1,029,702.26"
,CS,AR,32010268,1005,100,,Cash sale,,,,,,10/10/2018,10/10/2018,0.00,,4.58,,"-1,029,706.84"
,CS,AR,32010288,1005,100,,Cash sale,,,,,,10/10/2018,10/10/2018,0.00,,8.26,,"-1,029,715.10"
,CS,AR,32010300,1005,100,,Cash sale,,,,,,10/10/2018,10/10/2018,0.00,,12.14,,"-1,029,727.24"
,CS,AR,32010309,1005,100,,Cash sale,,,,,,10/10/2018,10/10/2018,0.00,,3.64,,"-1,029,730.88"
,CS,AR,32010313,1005,100,,Cash sale,,,,,,10/10/2018,10/10/2018,0.00,,5.18,,"-1,029,736.06"
,CS,AR,32010321,1005,100,,Cash sale,,,,,,10/10/2018,10/10/2018,0.00,,9.15,,"-1,029,745.21"
,CS,AR,32010336,1005,100,,Cash sale,,,,,,10/10/2018,10/10/2018,0.00,,14.58,,"-1,029,759.79"
,CS,AR,32010338,1005,100,,Cash sale,,,,,,10/10/2018,10/10/2018,0.00,,6.07,,"-1,029,765.86"
,CS,AR,32010371,1005,100,,Cash sale,,,,,,10/10/2018,10/10/2018,0.00,,12.03,,"-1,029,777.89"
,CS,AR,32010395,1005,100,,Cash sale,,,,,,10/10/2018,10/10/2018,0.00,,10.93,,"-1,029,788.82"
,CS,AR,32010410,1005,100,,Cash sale,,,,,,10/10/2018,10/10/2018,0.00,,2.54,,"-1,029,791.36"
,CS,AR,32010446,1005,100,,Cash sale,,,,,,10/10/2018,10/10/2018,0.00,,3.64,,"-1,029,795.00"
,CS,AR,32010449,1005,100,,Cash sale,,,,,,10/10/2018,10/10/2018,0.00,,29.15,,"-1,029,824.15"
,CS,AR,32010458,1005,100,,Cash sale,,,,,,10/10/2018,10/10/2018,0.00,,3.64,,"-1,029,827.79"
,CS,AR,32010460,1005,100,,Cash sale,,,,,,10/10/2018,10/10/2018,0.00,,10.93,,"-1,029,838.72"
,CS,AR,32010473,1005,100,,Cash sale,,,,,,10/10/2018,10/10/2018,0.00,,10.99,,"-1,029,849.71"
,CS,AR,32010487,1005,100,,Cash sale,,,,,,10/10/2018,10/10/2018,0.00,,3.01,,"-1,029,852.72"
,CS,AR,32010562,1005,100,,Cash sale,,,,,,10/10/2018,10/10/2018,0.00,,3.64,,"-1,029,856.36"
,CS,AR,32010569,1005,100,,Cash sale,,,,,,10/10/2018,10/10/2018,0.00,,14.58,,"-1,029,870.94"
,CS,AR,32010607,1005,100,,Cash sale,,,,,,10/10/2018,10/10/2018,0.00,,10.93,,"-1,029,881.87"
,IN,AR,30328349,1005,100,,Invoice,,,,,,10/10/2018,10/10/2018,0.00,,10.93,,"-1,029,892.80"
,IN,AR,30328356,1005,100,,Invoice,,,,,,10/10/2018,10/10/2018,0.00,,51.25,,"-1,029,944.05"
,IN,AR,30328357,1005,100,,Invoice,,,,,,10/10/2018,10/10/2018,0.00,,19.53,,"-1,029,963.58"
,IN,AR,30328407,1005,100,,Invoice,,,,,,10/10/2018,10/10/2018,0.00,,5.68,,"-1,029,969.26"
,IN,AR,30328419,1005,100,,Invoice,,,,,,10/10/2018,10/10/2018,0.00,,65.68,,"-1,030,034.94"
,IN,AR,30328420,1005,100,,Invoice,,,,,,10/10/2018,10/10/2018,0.00,,21.02,,"-1,030,055.96"
,IN,AR,30328433,1005,100,,Invoice,,,,,,10/10/2018,10/10/2018,0.00,,9.66,,"-1,030,065.62"
,IN,AR,30328481,1005,100,,Invoice,,,,,,10/10/2018,10/10/2018,0.00,,5.97,,"-1,030,071.59"
,IN,AR,30328494,1005,100,,Invoice,,,,,,10/10/2018,10/10/2018,0.00,,130.51,,"-1,030,202.10"
,IN,AR,30328563,1005,100,,Invoice,,,,,,10/10/2018,10/10/2018,0.00,,22.00,,"-1,030,224.10"
,IN,AR,30328605,1005,100,,Invoice,,,,,,10/10/2018,10/10/2018,0.00,,24.00,,"-1,030,248.10"
,IN,AR,30328610,1005,100,,Invoice,,,,,,10/10/2018,10/10/2018,0.00,,5.85,,"-1,030,253.95"
,IN,AR,30328613,1005,100,,Invoice,,,,,,10/10/2018,10/10/2018,0.00,,11.86,,"-1,030,265.81"
,IN,AR,30328644,1005,100,,Invoice,,,,,,10/10/2018,10/10/2018,0.00,,57.31,,"-1,030,323.12"
,IN,AR,30328645,1005,100,,Invoice,,,,,,10/10/2018,10/10/2018,0.00,,196.47,,"-1,030,519.59"
,IN,AR,30328671,1005,100,,Invoice,,,,,,10/10/2018,10/10/2018,0.00,,112.32,,"-1,030,631.91"
,IN,AR,30328697,1005,100,,Invoice,,,,,,10/10/2018,10/10/2018,0.00,,3.01,,"-1,030,634.92"
,IN,AR,30328716,1005,100,,Invoice,,,,,,10/10/2018,10/10/2018,0.00,,31.83,,"-1,030,666.75"
,IN,AR,30328727,1005,100,,Invoice,,,,,,10/10/2018,10/10/2018,0.00,,10.93,,"-1,030,677.68"
,IN,AR,30328780,1005,100,,Invoice,,,,,,10/10/2018,10/10/2018,0.00,,22.88,,"-1,030,700.56"
,IN,AR,30328796,1005,100,,Invoice,,,,,,10/10/2018,10/10/2018,0.00,,4.24,,"-1,030,704.80"
,IN,AR,30328804,1005,100,,Invoice,,,,,,10/10/2018,10/10/2018,0.00,,29.15,,"-1,030,733.95"
,IN,AR,30328806,1005,100,,Invoice,,,,,,10/10/2018,10/10/2018,0.00,,81.36,,"-1,030,815.31"
,IN,AR,30328818,1005,100,,Invoice,,,,,,10/10/2018,10/10/2018,0.00,,4.24,,"-1,030,819.55"
,IN,AR,30328827,1005,100,,Invoice,,,,,,10/10/2018,10/10/2018,0.00,,5.59,,"-1,030,825.14"
,IN,AR,30328848,1005,100,,Invoice,,,,,,10/10/2018,10/10/2018,0.00,,79.65,,"-1,030,904.79"
,IN,AR,30328861,1005,100,,Invoice,,,,,,10/10/2018,10/10/2018,0.00,,23.90,,"-1,030,928.69"
,IN,AR,30328865,1005,100,,Invoice,,,,,,10/10/2018,10/10/2018,0.00,,13.05,,"-1,030,941.74"
,IN,AR,30328884,1005,100,,Invoice,,,,,,10/10/2018,10/10/2018,0.00,,9.56,,"-1,030,951.30"
,IN,AR,30328899,1005,100,,Invoice,,,,,,10/10/2018,10/10/2018,0.00,,57.42,,"-1,031,008.72"
,IN,AR,30328910,1005,100,,Invoice,,,,,,10/10/2018,10/10/2018,0.00,,7.29,,"-1,031,016.01"
,IN,AR,30328914,1005,100,,Invoice,,,,,,10/10/2018,10/10/2018,0.00,,40.68,,"-1,031,056.69"
,IN,AR,30328963,1005,100,,Invoice,,,,,,10/10/2018,10/10/2018,0.00,,7.29,,"-1,031,063.98"
,IN,AR,30328990,1005,100,,Invoice,,,,,,10/10/2018,10/10/2018,0.00,,36.10,,"-1,031,100.08"
,IN,AR,30328997,1005,100,,Invoice,,,,,,10/10/2018,10/10/2018,0.00,,146.04,,"-1,031,246.12"
,IN,AR,30329034,1005,100,,Invoice,,,,,,10/10/2018,10/10/2018,0.00,,7.63,,"-1,031,253.75"
,IN,AR,30329057,1005,100,,Invoice,,,,,,10/10/2018,10/10/2018,0.00,,1.59,,"-1,031,255.34"
,IN,AR,30329059,1005,100,,Invoice,,,,,,10/10/2018,10/10/2018,0.00,,25.75,,"-1,031,281.09"
,IN,AR,30329071,1005,100,,Invoice,,,,,,10/10/2018,10/10/2018,0.00,,8.47,,"-1,031,289.56"
,IN,AR,30329139,1005,100,,Invoice,,,,,,10/10/2018,10/10/2018,0.00,,7.75,,"-1,031,297.31"
,IN,AR,30329143,1005,100,,Invoice,,,,,,10/10/2018,10/10/2018,0.00,,13.63,,"-1,031,310.94"
,IN,AR,30329190,1005,100,,Invoice,,,,,,10/10/2018,10/10/2018,0.00,,7.63,,"-1,031,318.57"
,IN,AR,30329196,1005,100,,Invoice,,,,,,10/10/2018,10/10/2018,0.00,,7.29,,"-1,031,325.86"
,IN,AR,30329229,1005,100,,Invoice,,,,,,10/10/2018,10/10/2018,0.00,,14.58,,"-1,031,340.44"
,IN,AR,30329290,1005,100,,Invoice,,,,,,10/10/2018,10/10/2018,0.00,,23.73,,"-1,031,364.17"
,IN,AR,30329326,1005,100,,Invoice,,,,,,10/10/2018,10/10/2018,0.00,,10.93,,"-1,031,375.10"
,IN,AR,30329334,1005,100,,Invoice,,,,,,10/10/2018,10/10/2018,0.00,,19.58,,"-1,031,394.68"
,IN,AR,30329343,1005,100,,Invoice,,,,,,10/10/2018,10/10/2018,0.00,,12.71,,"-1,031,407.39"
,IN,AR,30329384,1005,100,,Invoice,,,,,,10/10/2018,10/10/2018,0.00,,7.29,,"-1,031,414.68"
,IN,AR,30329391,1005,100,,Invoice,,,,,,10/10/2018,10/10/2018,0.00,,7.75,,"-1,031,422.43"
,IN,AR,30329405,1005,100,,Invoice,,,,,,10/10/2018,10/10/2018,0.00,,70.53,,"-1,031,492.96"
,IN,AR,30329412,1005,100,,Invoice,,,,,,10/10/2018,10/10/2018,0.00,,27.77,,"-1,031,520.73"
,IN,AR,30329422,1005,100,,Invoice,,,,,,10/10/2018,10/10/2018,0.00,,21.06,,"-1,031,541.79"
,IN,AR,30329467,1005,100,,Invoice,,,,,,10/10/2018,10/10/2018,0.00,,36.45,,"-1,031,578.24"
,IN,AR,30329473,1005,100,,Invoice,,,,,,10/10/2018,10/10/2018,0.00,,25.51,,"-1,031,603.75"
,IN,AR,30329480,1005,100,,Invoice,,,,,,10/10/2018,10/10/2018,0.00,,1.76,,"-1,031,605.51"
,IN,AR,30329481,1005,100,,Invoice,,,,,,10/10/2018,10/10/2018,0.00,,1.76,,"-1,031,607.27"
,IN,AR,30329497,1005,100,,Invoice,,,,,,10/10/2018,10/10/2018,0.00,,15.04,,"-1,031,622.31"
,IN,AR,30329535,1005,100,,Invoice,,,,,,10/10/2018,10/10/2018,0.00,,15.51,,"-1,031,637.82"
,IN,AR,30329539,1005,100,,Invoice,,,,,,10/10/2018,10/10/2018,0.00,,5.17,,"-1,031,642.99"
,IN,AR,30329551,1005,100,,Invoice,,,,,,10/10/2018,10/10/2018,0.00,,24.01,,"-1,031,667.00"
,IN,AR,30329556,1005,100,,Invoice,,,,,,10/10/2018,10/10/2018,0.00,,47.37,,"-1,031,714.37"
,IN,AR,30329557,1005,100,,Invoice,,,,,,10/10/2018,10/10/2018,0.00,,25.51,,"-1,031,739.88"
,IN,AR,30329605,1005,100,,Invoice,,,,,,10/10/2018,10/10/2018,0.00,,14.07,,"-1,031,753.95"
,IN,AR,30329611,1005,100,,Invoice,,,,,,10/10/2018,10/10/2018,0.00,,17.80,,"-1,031,771.75"
,IN,AR,30329659,1005,100,,Invoice,,,,,,10/10/2018,10/10/2018,0.00,,4.01,,"-1,031,775.76"
,IN,AR,30329672,1005,100,,Invoice,,,,,,10/10/2018,10/10/2018,0.00,,40.00,,"-1,031,815.76"
,IN,AR,30329679,1005,100,,Invoice,,,,,,10/10/2018,10/10/2018,0.00,,7.29,,"-1,031,823.05"
,IN,AR,30329687,1005,100,,Invoice,,,,,,10/10/2018,10/10/2018,0.00,,40.08,,"-1,031,863.13"
,IN,AR,30329692,1005,100,,Invoice,,,,,,10/10/2018,10/10/2018,0.00,,34.08,,"-1,031,897.21"
,IN,AR,30329704,1005,100,,Invoice,,,,,,10/10/2018,10/10/2018,0.00,,14.58,,"-1,031,911.79"
,IN,AR,30329714,1005,100,,Invoice,,,,,,10/10/2018,10/10/2018,0.00,,29.15,,"-1,031,940.94"
,IN,AR,30329721,1005,100,,Invoice,,,,,,10/10/2018,10/10/2018,0.00,,32.42,,"-1,031,973.36"
,IN,AR,30329731,1005,100,,Invoice,,,,,,10/10/2018,10/10/2018,0.00,,14.58,,"-1,031,987.94"
,IN,AR,30329757,1005,100,,Invoice,,,,,,10/10/2018,10/10/2018,0.00,,7.64,,"-1,031,995.58"
,IN,AR,30329766,1005,100,,Invoice,,,,,,10/10/2018,10/10/2018,0.00,,36.22,,"-1,032,031.80"
,IN,AR,30329790,1005,100,,Invoice,,,,,,10/10/2018,10/10/2018,0.00,,5.08,,"-1,032,036.88"
,IN,AR,30329791,1005,100,,Invoice,,,,,,10/10/2018,10/10/2018,0.00,,7.63,,"-1,032,044.51"
,IN,AR,30329792,1005,100,,Invoice,,,,,,10/10/2018,10/10/2018,0.00,,7.63,,"-1,032,052.14"
,IN,AR,30329829,1005,100,,Invoice,,,,,,10/10/2018,10/10/2018,0.00,,8.00,,"-1,032,060.14"
,IN,AR,30329844,1005,100,,Invoice,,,,,,10/10/2018,10/10/2018,0.00,,59.62,,"-1,032,119.76"
,IN,AR,30329848,1005,100,,Invoice,,,,,,10/10/2018,10/10/2018,0.00,,6.03,,"-1,032,125.79"
,IN,AR,30329857,1005,100,,Invoice,,,,,,10/10/2018,10/10/2018,0.00,,5.83,,"-1,032,131.62"
,IN,AR,30329872,1005,100,,Invoice,,,,,,10/10/2018,10/10/2018,0.00,,6.31,,"-1,032,137.93"
,IN,AR,30329873,1005,100,,Invoice,,,,,,10/10/2018,10/10/2018,0.00,,14.72,,"-1,032,152.65"
,IN,AR,30329874,1005,100,,Invoice,,,,,,10/10/2018,10/10/2018,0.00,,25.23,,"-1,032,177.88"
,IN,AR,30329890,1005,100,,Invoice,,,,,,10/10/2018,10/10/2018,0.00,,17.44,,"-1,032,195.32"
,IN,AR,30329897,1005,100,,Invoice,,,,,,10/10/2018,10/10/2018,0.00,,18.22,,"-1,032,213.54"
,IN,AR,30329967,1005,100,,Invoice,,,,,,10/10/2018,10/10/2018,0.00,,3.64,,"-1,032,217.18"
,IN,AR,30330112,1005,100,,Invoice,,,,,,10/10/2018,10/10/2018,0.00,,5.26,,"-1,032,222.44"
,IN,AR,30330130,1005,100,,Invoice,,,,,,10/10/2018,10/10/2018,0.00,,29.15,,"-1,032,251.59"
,IN,AR,30330180,1005,100,,Invoice,,,,,,10/10/2018,10/10/2018,0.00,,9.41,,"-1,032,261.00"
,IN,AR,30330194,1005,100,,Invoice,,,,,,10/10/2018,10/10/2018,0.00,,91.27,,"-1,032,352.27"
,IN,AR,30330218,1005,100,,Invoice,,,,,,10/10/2018,10/10/2018,0.00,,22.37,,"-1,032,374.64"
,IN,AR,30330238,1005,100,,Invoice,,,,,,10/10/2018,10/10/2018,0.00,,7.29,,"-1,032,381.93"
,IN,AR,30330264,1005,100,,Invoice,,,,,,10/10/2018,10/10/2018,0.00,,16.02,,"-1,032,397.95"
,IN,AR,30330293,1005,100,,Invoice,,,,,,10/10/2018,10/10/2018,0.00,,66.44,,"-1,032,464.39"
,IN,AR,30330294,1005,100,,Invoice,,,,,,10/10/2018,10/10/2018,0.00,,8.31,,"-1,032,472.70"
,IN,AR,30330295,1005,100,,Invoice,,,,,,10/10/2018,10/10/2018,0.00,,22.84,,"-1,032,495.54"
,IN,AR,30330349,1005,100,,Invoice,,,,,,10/10/2018,10/10/2018,0.00,,2.54,,"-1,032,498.08"
,IN,AR,30330361,1005,100,,Invoice,,,,,,10/10/2018,10/10/2018,0.00,,33.37,,"-1,032,531.45"
,IN,AR,30330388,1005,100,,Invoice,,,,,,10/10/2018,10/10/2018,0.00,,25.51,,"-1,032,556.96"
,IN,AR,30330422,1005,100,,Invoice,,,,,,10/10/2018,10/10/2018,0.00,,13.98,,"-1,032,570.94"
,IN,AR,30330450,1005,100,,Invoice,,,,,,10/10/2018,10/10/2018,0.00,,29.15,,"-1,032,600.09"
,IN,AR,30330460,1005,100,,Invoice,,,,,,10/10/2018,10/10/2018,0.00,,12.14,,"-1,032,612.23"
,IN,AR,30330462,1005,100,,Invoice,,,,,,10/10/2018,10/10/2018,0.00,,6.56,,"-1,032,618.79"
,IN,AR,30330477,1005,100,,Invoice,,,,,,10/10/2018,10/10/2018,0.00,,29.15,,"-1,032,647.94"
,IN,AR,30330481,1005,100,,Invoice,,,,,,10/10/2018,10/10/2018,0.00,,4.24,,"-1,032,652.18"
,IN,AR,30330488,1005,100,,Invoice,,,,,,10/10/2018,10/10/2018,0.00,,17.97,,"-1,032,670.15"
,IN,AR,30330506,1005,100,,Invoice,,,,,,10/10/2018,10/10/2018,0.00,,14.58,,"-1,032,684.73"
,CN,AR,31019381,1005,100,,Credit Note,,,,,,10/10/2018,10/10/2018,91.10,,0.00,,"-1,032,593.63"
,CN,AR,31019395,1005,100,,Credit Note,,,,,,10/10/2018,10/10/2018,54.66,,0.00,,"-1,032,538.97"
,IN,AR,30330627,1005,100,,Invoice,,,,,,10/10/2018,10/10/2018,0.00,,54.66,,"-1,032,593.63"
,IN,AR,30330693,1005,100,,Invoice,,,,,,10/10/2018,10/10/2018,0.00,,54.66,,"-1,032,648.29"
,IN,AR,30330696,1005,100,,Invoice,,,,,,10/10/2018,10/10/2018,0.00,,54.66,,"-1,032,702.95"
,IN,AR,30330714,1005,100,,Invoice,,,,,,10/10/2018,10/10/2018,0.00,,54.66,,"-1,032,757.61"
,IN,AR,30330715,1005,100,,Invoice,,,,,,10/10/2018,10/10/2018,0.00,,54.66,,"-1,032,812.27"
,IN,AR,30330716,1005,100,,Invoice,,,,,,10/10/2018,10/10/2018,0.00,,455.51,,"-1,033,267.78"
,CS,AR,32009709,1005,100,,Cash sale,,,,,,11/10/2018,11/10/2018,0.00,,18.05,,"-1,033,285.83"
,CS,AR,32009737,1005,100,,Cash sale,,,,,,11/10/2018,11/10/2018,0.00,,5.68,,"-1,033,291.51"
,CS,AR,32009739,1005,100,,Cash sale,,,,,,11/10/2018,11/10/2018,0.00,,3.64,,"-1,033,295.15"
,CS,AR,32009793,1005,100,,Cash sale,,,,,,11/10/2018,11/10/2018,0.00,,3.64,,"-1,033,298.79"
,CS,AR,32009812,1005,100,,Cash sale,,,,,,11/10/2018,11/10/2018,0.00,,3.64,,"-1,033,302.43"
,CS,AR,32009835,1005,100,,Cash sale,,,,,,11/10/2018,11/10/2018,0.00,,7.29,,"-1,033,309.72"
,CS,AR,32009846,1005,100,,Cash sale,,,,,,11/10/2018,11/10/2018,0.00,,3.64,,"-1,033,313.36"
,CS,AR,32009863,1005,100,,Cash sale,,,,,,11/10/2018,11/10/2018,0.00,,10.93,,"-1,033,324.29"
,CS,AR,32009871,1005,100,,Cash sale,,,,,,11/10/2018,11/10/2018,0.00,,18.22,,"-1,033,342.51"
,CS,AR,32009898,1005,100,,Cash sale,,,,,,11/10/2018,11/10/2018,0.00,,10.93,,"-1,033,353.44"
,CS,AR,32009932,1005,100,,Cash sale,,,,,,11/10/2018,11/10/2018,0.00,,21.86,,"-1,033,375.30"
,CS,AR,32009950,1005,100,,Cash sale,,,,,,11/10/2018,11/10/2018,0.00,,7.75,,"-1,033,383.05"
,CS,AR,32010049,1005,100,,Cash sale,,,,,,11/10/2018,11/10/2018,0.00,,8.17,,"-1,033,391.22"
,CS,AR,32010095,1005,100,,Cash sale,,,,,,11/10/2018,11/10/2018,0.00,,7.29,,"-1,033,398.51"
,CS,AR,32010099,1005,100,,Cash sale,,,,,,11/10/2018,11/10/2018,0.00,,7.29,,"-1,033,405.80"
,CS,AR,32010120,1005,100,,Cash sale,,,,,,11/10/2018,11/10/2018,0.00,,13.98,,"-1,033,419.78"
,CS,AR,32010159,1005,100,,Cash sale,,,,,,11/10/2018,11/10/2018,0.00,,6.44,,"-1,033,426.22"
,CS,AR,32010173,1005,100,,Cash sale,,,,,,11/10/2018,11/10/2018,0.00,,2.58,,"-1,033,428.80"
,CS,AR,32010217,1005,100,,Cash sale,,,,,,11/10/2018,11/10/2018,0.00,,16.78,,"-1,033,445.58"
,CS,AR,32010241,1005,100,,Cash sale,,,,,,11/10/2018,11/10/2018,0.00,,7.29,,"-1,033,452.87"
,CS,AR,32010250,1005,100,,Cash sale,,,,,,11/10/2018,11/10/2018,0.00,,7.29,,"-1,033,460.16"
,CS,AR,32010293,1005,100,,Cash sale,,,,,,11/10/2018,11/10/2018,0.00,,14.58,,"-1,033,474.74"
,CS,AR,32010295,1005,100,,Cash sale,,,,,,11/10/2018,11/10/2018,0.00,,5.93,,"-1,033,480.67"
,CS,AR,32010305,1005,100,,Cash sale,,,,,,11/10/2018,11/10/2018,0.00,,3.64,,"-1,033,484.31"
,CS,AR,32010333,1005,100,,Cash sale,,,,,,11/10/2018,11/10/2018,0.00,,10.93,,"-1,033,495.24"
,CS,AR,32010368,1005,100,,Cash sale,,,,,,11/10/2018,11/10/2018,0.00,,14.58,,"-1,033,509.82"
,CS,AR,32010384,1005,100,,Cash sale,,,,,,11/10/2018,11/10/2018,0.00,,18.22,,"-1,033,528.04"
,CS,AR,32010391,1005,100,,Cash sale,,,,,,11/10/2018,11/10/2018,0.00,,17.80,,"-1,033,545.84"
,CS,AR,32010392,1005,100,,Cash sale,,,,,,11/10/2018,11/10/2018,0.00,,5.47,,"-1,033,551.31"
,CS,AR,32010421,1005,100,,Cash sale,,,,,,11/10/2018,11/10/2018,0.00,,7.29,,"-1,033,558.60"
,CS,AR,32010441,1005,100,,Cash sale,,,,,,11/10/2018,11/10/2018,0.00,,7.29,,"-1,033,565.89"
,CS,AR,32010464,1005,100,,Cash sale,,,,,,11/10/2018,11/10/2018,0.00,,8.78,,"-1,033,574.67"
,CS,AR,32010555,1005,100,,Cash sale,,,,,,11/10/2018,11/10/2018,0.00,,7.29,,"-1,033,581.96"
,CS,AR,32010594,1005,100,,Cash sale,,,,,,11/10/2018,11/10/2018,0.00,,7.29,,"-1,033,589.25"
,CS,AR,32010610,1005,100,,Cash sale,,,,,,11/10/2018,11/10/2018,0.00,,5.17,,"-1,033,594.42"
,IN,AR,30328329,1005,100,,Invoice,,,,,,11/10/2018,11/10/2018,0.00,,12.03,,"-1,033,606.45"
,IN,AR,30328345,1005,100,,Invoice,,,,,,11/10/2018,11/10/2018,0.00,,7.29,,"-1,033,613.74"
,IN,AR,30328346,1005,100,,Invoice,,,,,,11/10/2018,11/10/2018,0.00,,21.86,,"-1,033,635.60"
,IN,AR,30328354,1005,100,,Invoice,,,,,,11/10/2018,11/10/2018,0.00,,3.64,,"-1,033,639.24"
,IN,AR,30328439,1005,100,,Invoice,,,,,,11/10/2018,11/10/2018,0.00,,7.29,,"-1,033,646.53"
,IN,AR,30328482,1005,100,,Invoice,,,,,,11/10/2018,11/10/2018,0.00,,3.98,,"-1,033,650.51"
,IN,AR,30328495,1005,100,,Invoice,,,,,,11/10/2018,11/10/2018,0.00,,54.58,,"-1,033,705.09"
,IN,AR,30328528,1005,100,,Invoice,,,,,,11/10/2018,11/10/2018,0.00,,72.00,,"-1,033,777.09"
,IN,AR,30328581,1005,100,,Invoice,,,,,,11/10/2018,11/10/2018,0.00,,3.64,,"-1,033,780.73"
,IN,AR,30328614,1005,100,,Invoice,,,,,,11/10/2018,11/10/2018,0.00,,71.19,,"-1,033,851.92"
,IN,AR,30328634,1005,100,,Invoice,,,,,,11/10/2018,11/10/2018,0.00,,38.44,,"-1,033,890.36"
,IN,AR,30328657,1005,100,,Invoice,,,,,,11/10/2018,11/10/2018,0.00,,780.96,,"-1,034,671.32"
,IN,AR,30328688,1005,100,,Invoice,,,,,,11/10/2018,11/10/2018,0.00,,18.22,,"-1,034,689.54"
,IN,AR,30328735,1005,100,,Invoice,,,,,,11/10/2018,11/10/2018,0.00,,18.22,,"-1,034,707.76"
,IN,AR,30328742,1005,100,,Invoice,,,,,,11/10/2018,11/10/2018,0.00,,21.00,,"-1,034,728.76"
,IN,AR,30328745,1005,100,,Invoice,,,,,,11/10/2018,11/10/2018,0.00,,14.58,,"-1,034,743.34"
,IN,AR,30328761,1005,100,,Invoice,,,,,,11/10/2018,11/10/2018,0.00,,7.19,,"-1,034,750.53"
,IN,AR,30328831,1005,100,,Invoice,,,,,,11/10/2018,11/10/2018,0.00,,12.71,,"-1,034,763.24"
,IN,AR,30328849,1005,100,,Invoice,,,,,,11/10/2018,11/10/2018,0.00,,149.09,,"-1,034,912.33"
,IN,AR,30328895,1005,100,,Invoice,,,,,,11/10/2018,11/10/2018,0.00,,20.34,,"-1,034,932.67"
,IN,AR,30328915,1005,100,,Invoice,,,,,,11/10/2018,11/10/2018,0.00,,12.71,,"-1,034,945.38"
,IN,AR,30328916,1005,100,,Invoice,,,,,,11/10/2018,11/10/2018,0.00,,30.51,,"-1,034,975.89"
,IN,AR,30328932,1005,100,,Invoice,,,,,,11/10/2018,11/10/2018,0.00,,16.73,,"-1,034,992.62"
,IN,AR,30328933,1005,100,,Invoice,,,,,,11/10/2018,11/10/2018,0.00,,33.46,,"-1,035,026.08"
,IN,AR,30328953,1005,100,,Invoice,,,,,,11/10/2018,11/10/2018,0.00,,19.32,,"-1,035,045.40"
,IN,AR,30328967,1005,100,,Invoice,,,,,,11/10/2018,11/10/2018,0.00,,6.36,,"-1,035,051.76"
,IN,AR,30329022,1005,100,,Invoice,,,,,,11/10/2018,11/10/2018,0.00,,10.59,,"-1,035,062.35"
,IN,AR,30329065,1005,100,,Invoice,,,,,,11/10/2018,11/10/2018,0.00,,6.02,,"-1,035,068.37"
,IN,AR,30329066,1005,100,,Invoice,,,,,,11/10/2018,11/10/2018,0.00,,2.58,,"-1,035,070.95"
,IN,AR,30329078,1005,100,,Invoice,,,,,,11/10/2018,11/10/2018,0.00,,6.48,,"-1,035,077.43"
,IN,AR,30329079,1005,100,,Invoice,,,,,,11/10/2018,11/10/2018,0.00,,21.86,,"-1,035,099.29"
,IN,AR,30329155,1005,100,,Invoice,,,,,,11/10/2018,11/10/2018,0.00,,30.51,,"-1,035,129.80"
,IN,AR,30329162,1005,100,,Invoice,,,,,,11/10/2018,11/10/2018,0.00,,20.00,,"-1,035,149.80"
,IN,AR,30329212,1005,100,,Invoice,,,,,,11/10/2018,11/10/2018,0.00,,9.03,,"-1,035,158.83"
,IN,AR,30329234,1005,100,,Invoice,,,,,,11/10/2018,11/10/2018,0.00,,12.71,,"-1,035,171.54"
,IN,AR,30329267,1005,100,,Invoice,,,,,,11/10/2018,11/10/2018,0.00,,19.22,,"-1,035,190.76"
,IN,AR,30329287,1005,100,,Invoice,,,,,,11/10/2018,11/10/2018,0.00,,6.36,,"-1,035,197.12"
,IN,AR,30329291,1005,100,,Invoice,,,,,,11/10/2018,11/10/2018,0.00,,41.53,,"-1,035,238.65"
,IN,AR,30329352,1005,100,,Invoice,,,,,,11/10/2018,11/10/2018,0.00,,38.00,,"-1,035,276.65"
,IN,AR,30329368,1005,100,,Invoice,,,,,,11/10/2018,11/10/2018,0.00,,9.29,,"-1,035,285.94"
,IN,AR,30329371,1005,100,,Invoice,,,,,,11/10/2018,11/10/2018,0.00,,8.77,,"-1,035,294.71"
,IN,AR,30329375,1005,100,,Invoice,,,,,,11/10/2018,11/10/2018,0.00,,18.22,,"-1,035,312.93"
,IN,AR,30329377,1005,100,,Invoice,,,,,,11/10/2018,11/10/2018,0.00,,14.58,,"-1,035,327.51"
,IN,AR,30329379,1005,100,,Invoice,,,,,,11/10/2018,11/10/2018,0.00,,27.54,,"-1,035,355.05"
,IN,AR,30329403,1005,100,,Invoice,,,,,,11/10/2018,11/10/2018,0.00,,19.87,,"-1,035,374.92"
,IN,AR,30329429,1005,100,,Invoice,,,,,,11/10/2018,11/10/2018,0.00,,18.05,,"-1,035,392.97"
,IN,AR,30329434,1005,100,,Invoice,,,,,,11/10/2018,11/10/2018,0.00,,12.14,,"-1,035,405.11"
,IN,AR,30329442,1005,100,,Invoice,,,,,,11/10/2018,11/10/2018,0.00,,7.76,,"-1,035,412.87"
,IN,AR,30329445,1005,100,,Invoice,,,,,,11/10/2018,11/10/2018,0.00,,10.17,,"-1,035,423.04"
,IN,AR,30329458,1005,100,,Invoice,,,,,,11/10/2018,11/10/2018,0.00,,39.11,,"-1,035,462.15"
,IN,AR,30329461,1005,100,,Invoice,,,,,,11/10/2018,11/10/2018,0.00,,6.00,,"-1,035,468.15"
,IN,AR,30329482,1005,100,,Invoice,,,,,,11/10/2018,11/10/2018,0.00,,3.53,,"-1,035,471.68"
,IN,AR,30329509,1005,100,,Invoice,,,,,,11/10/2018,11/10/2018,0.00,,21.86,,"-1,035,493.54"
,IN,AR,30329546,1005,100,,Invoice,,,,,,11/10/2018,11/10/2018,0.00,,13.09,,"-1,035,506.63"
,IN,AR,30329604,1005,100,,Invoice,,,,,,11/10/2018,11/10/2018,0.00,,2.58,,"-1,035,509.21"
,IN,AR,30329607,1005,100,,Invoice,,,,,,11/10/2018,11/10/2018,0.00,,7.29,,"-1,035,516.50"
,IN,AR,30329616,1005,100,,Invoice,,,,,,11/10/2018,11/10/2018,0.00,,18.22,,"-1,035,534.72"
,IN,AR,30329619,1005,100,,Invoice,,,,,,11/10/2018,11/10/2018,0.00,,13.94,,"-1,035,548.66"
,IN,AR,30329620,1005,100,,Invoice,,,,,,11/10/2018,11/10/2018,0.00,,17.92,,"-1,035,566.58"
,IN,AR,30329621,1005,100,,Invoice,,,,,,11/10/2018,11/10/2018,0.00,,3.98,,"-1,035,570.56"
,IN,AR,30329622,1005,100,,Invoice,,,,,,11/10/2018,11/10/2018,0.00,,37.84,,"-1,035,608.40"
,IN,AR,30329634,1005,100,,Invoice,,,,,,11/10/2018,11/10/2018,0.00,,11.95,,"-1,035,620.35"
,IN,AR,30329671,1005,100,,Invoice,,,,,,11/10/2018,11/10/2018,0.00,,20.34,,"-1,035,640.69"
,IN,AR,30329686,1005,100,,Invoice,,,,,,11/10/2018,11/10/2018,0.00,,90.85,,"-1,035,731.54"
,IN,AR,30329702,1005,100,,Invoice,,,,,,11/10/2018,11/10/2018,0.00,,7.29,,"-1,035,738.83"
,IN,AR,30329709,1005,100,,Invoice,,,,,,11/10/2018,11/10/2018,0.00,,3.64,,"-1,035,742.47"
,IN,AR,30329750,1005,100,,Invoice,,,,,,11/10/2018,11/10/2018,0.00,,14.58,,"-1,035,757.05"
,IN,AR,30329764,1005,100,,Invoice,,,,,,11/10/2018,11/10/2018,0.00,,10.93,,"-1,035,767.98"
,IN,AR,30329774,1005,100,,Invoice,,,,,,11/10/2018,11/10/2018,0.00,,10.93,,"-1,035,778.91"
,IN,AR,30329775,1005,100,,Invoice,,,,,,11/10/2018,11/10/2018,0.00,,21.86,,"-1,035,800.77"
,IN,AR,30329793,1005,100,,Invoice,,,,,,11/10/2018,11/10/2018,0.00,,27.97,,"-1,035,828.74"
,IN,AR,30329806,1005,100,,Invoice,,,,,,11/10/2018,11/10/2018,0.00,,22.01,,"-1,035,850.75"
,IN,AR,30329823,1005,100,,Invoice,,,,,,11/10/2018,11/10/2018,0.00,,20.01,,"-1,035,870.76"
,IN,AR,30329835,1005,100,,Invoice,,,,,,11/10/2018,11/10/2018,0.00,,11.66,,"-1,035,882.42"
,IN,AR,30329836,1005,100,,Invoice,,,,,,11/10/2018,11/10/2018,0.00,,20.41,,"-1,035,902.83"
,IN,AR,30329903,1005,100,,Invoice,,,,,,11/10/2018,11/10/2018,0.00,,18.22,,"-1,035,921.05"
,IN,AR,30329923,1005,100,,Invoice,,,,,,11/10/2018,11/10/2018,0.00,,14.03,,"-1,035,935.08"
,IN,AR,30329934,1005,100,,Invoice,,,,,,11/10/2018,11/10/2018,0.00,,36.61,,"-1,035,971.69"
,IN,AR,30329949,1005,100,,Invoice,,,,,,11/10/2018,11/10/2018,0.00,,9.10,,"-1,035,980.79"
,IN,AR,30329970,1005,100,,Invoice,,,,,,11/10/2018,11/10/2018,0.00,,25.51,,"-1,036,006.30"
,IN,AR,30329977,1005,100,,Invoice,,,,,,11/10/2018,11/10/2018,0.00,,3.64,,"-1,036,009.94"
,IN,AR,30329990,1005,100,,Invoice,,,,,,11/10/2018,11/10/2018,0.00,,3.64,,"-1,036,013.58"
,IN,AR,30329995,1005,100,,Invoice,,,,,,11/10/2018,11/10/2018,0.00,,6.37,,"-1,036,019.95"
,IN,AR,30329996,1005,100,,Invoice,,,,,,11/10/2018,11/10/2018,0.00,,132.24,,"-1,036,152.19"
,IN,AR,30329997,1005,100,,Invoice,,,,,,11/10/2018,11/10/2018,0.00,,7.97,,"-1,036,160.16"
,IN,AR,30329998,1005,100,,Invoice,,,,,,11/10/2018,11/10/2018,0.00,,7.97,,"-1,036,168.13"
,IN,AR,30329999,1005,100,,Invoice,,,,,,11/10/2018,11/10/2018,0.00,,12.75,,"-1,036,180.88"
,IN,AR,30330000,1005,100,,Invoice,,,,,,11/10/2018,11/10/2018,0.00,,4.78,,"-1,036,185.66"
,IN,AR,30330001,1005,100,,Invoice,,,,,,11/10/2018,11/10/2018,0.00,,15.93,,"-1,036,201.59"
,IN,AR,30330079,1005,100,,Invoice,,,,,,11/10/2018,11/10/2018,0.00,,24.41,,"-1,036,226.00"
,IN,AR,30330080,1005,100,,Invoice,,,,,,11/10/2018,11/10/2018,0.00,,"2,343.05",,"-1,038,569.05"
,IN,AR,30330280,1005,100,,Invoice,,,,,,11/10/2018,11/10/2018,0.00,,10.93,,"-1,038,579.98"
,IN,AR,30330296,1005,100,,Invoice,,,,,,11/10/2018,11/10/2018,0.00,,8.31,,"-1,038,588.29"
,IN,AR,30330297,1005,100,,Invoice,,,,,,11/10/2018,11/10/2018,0.00,,33.22,,"-1,038,621.51"
,IN,AR,30330298,1005,100,,Invoice,,,,,,11/10/2018,11/10/2018,0.00,,2.08,,"-1,038,623.59"
,IN,AR,30330299,1005,100,,Invoice,,,,,,11/10/2018,11/10/2018,0.00,,24.92,,"-1,038,648.51"
,IN,AR,30330300,1005,100,,Invoice,,,,,,11/10/2018,11/10/2018,0.00,,6.23,,"-1,038,654.74"
,IN,AR,30330360,1005,100,,Invoice,,,,,,11/10/2018,11/10/2018,0.00,,21.86,,"-1,038,676.60"
,IN,AR,30330394,1005,100,,Invoice,,,,,,11/10/2018,11/10/2018,0.00,,5.26,,"-1,038,681.86"
,IN,AR,30330406,1005,100,,Invoice,,,,,,11/10/2018,11/10/2018,0.00,,10.17,,"-1,038,692.03"
,IN,AR,30330429,1005,100,,Invoice,,,,,,11/10/2018,11/10/2018,0.00,,29.15,,"-1,038,721.18"
,IN,AR,30330433,1005,100,,Invoice,,,,,,11/10/2018,11/10/2018,0.00,,100.12,,"-1,038,821.30"
,IN,AR,30330466,1005,100,,Invoice,,,,,,11/10/2018,11/10/2018,0.00,,3.51,,"-1,038,824.81"
,IN,AR,30330471,1005,100,,Invoice,,,,,,11/10/2018,11/10/2018,0.00,,29.15,,"-1,038,853.96"
,IN,AR,30330510,1005,100,,Invoice,,,,,,11/10/2018,11/10/2018,0.00,,29.15,,"-1,038,883.11"
,IN,AR,30330542,1005,100,,Invoice,,,,,,11/10/2018,11/10/2018,0.00,,364.41,,"-1,039,247.52"
,IN,AR,30330551,1005,100,,Invoice,,,,,,11/10/2018,11/10/2018,0.00,,54.66,,"-1,039,302.18"
,IN,AR,30330560,1005,100,,Invoice,,,,,,11/10/2018,11/10/2018,0.00,,364.41,,"-1,039,666.59"
,IN,AR,30330574,1005,100,,Invoice,,,,,,11/10/2018,11/10/2018,0.00,,54.66,,"-1,039,721.25"
,IN,AR,30330582,1005,100,,Invoice,,,,,,11/10/2018,11/10/2018,0.00,,54.66,,"-1,039,775.91"
,IN,AR,30330596,1005,100,,Invoice,,,,,,11/10/2018,11/10/2018,0.00,,54.66,,"-1,039,830.57"
,IN,AR,30330612,1005,100,,Invoice,,,,,,11/10/2018,11/10/2018,0.00,,54.66,,"-1,039,885.23"
,IN,AR,30330691,1005,100,,Invoice,,,,,,11/10/2018,11/10/2018,0.00,,54.66,,"-1,039,939.89"
,IN,AR,30330704,1005,100,,Invoice,,,,,,11/10/2018,11/10/2018,0.00,,54.66,,"-1,039,994.55"
,CN,AR,31019297,1005,100,,Credit Note,,,,,,12/10/2018,12/10/2018,29.76,,0.00,,"-1,039,964.79"
,CN,AR,31019349,1005,100,,Credit Note,,,,,,12/10/2018,12/10/2018,"4,197.97",,0.00,,"-1,035,766.82"
,CS,AR,32009713,1005,100,,Cash sale,,,,,,12/10/2018,12/10/2018,0.00,,2.81,,"-1,035,769.63"
,CS,AR,32009730,1005,100,,Cash sale,,,,,,12/10/2018,12/10/2018,0.00,,16.61,,"-1,035,786.24"
,CS,AR,32009756,1005,100,,Cash sale,,,,,,12/10/2018,12/10/2018,0.00,,3.64,,"-1,035,789.88"
,CS,AR,32009761,1005,100,,Cash sale,,,,,,12/10/2018,12/10/2018,0.00,,18.22,,"-1,035,808.10"
,CS,AR,32009776,1005,100,,Cash sale,,,,,,12/10/2018,12/10/2018,0.00,,10.93,,"-1,035,819.03"
,CS,AR,32009804,1005,100,,Cash sale,,,,,,12/10/2018,12/10/2018,0.00,,9.66,,"-1,035,828.69"
,CS,AR,32009824,1005,100,,Cash sale,,,,,,12/10/2018,12/10/2018,0.00,,16.61,,"-1,035,845.30"
,CS,AR,32009849,1005,100,,Cash sale,,,,,,12/10/2018,12/10/2018,0.00,,9.73,,"-1,035,855.03"
,CS,AR,32009855,1005,100,,Cash sale,,,,,,12/10/2018,12/10/2018,0.00,,3.64,,"-1,035,858.67"
,CS,AR,32009885,1005,100,,Cash sale,,,,,,12/10/2018,12/10/2018,0.00,,9.03,,"-1,035,867.70"
,CS,AR,32009889,1005,100,,Cash sale,,,,,,12/10/2018,12/10/2018,0.00,,3.64,,"-1,035,871.34"
,CS,AR,32009933,1005,100,,Cash sale,,,,,,12/10/2018,12/10/2018,0.00,,2.58,,"-1,035,873.92"
,CS,AR,32009939,1005,100,,Cash sale,,,,,,12/10/2018,12/10/2018,0.00,,20.34,,"-1,035,894.26"
,CS,AR,32009964,1005,100,,Cash sale,,,,,,12/10/2018,12/10/2018,0.00,,38.47,,"-1,035,932.73"
,CS,AR,32009970,1005,100,,Cash sale,,,,,,12/10/2018,12/10/2018,0.00,,19.24,,"-1,035,951.97"
,CS,AR,32009981,1005,100,,Cash sale,,,,,,12/10/2018,12/10/2018,0.00,,10.93,,"-1,035,962.90"
,CS,AR,32009984,1005,100,,Cash sale,,,,,,12/10/2018,12/10/2018,0.00,,6.02,,"-1,035,968.92"
,CS,AR,32010023,1005,100,,Cash sale,,,,,,12/10/2018,12/10/2018,0.00,,20.47,,"-1,035,989.39"
,CS,AR,32010043,1005,100,,Cash sale,,,,,,12/10/2018,12/10/2018,0.00,,18.05,,"-1,036,007.44"
,CS,AR,32010054,1005,100,,Cash sale,,,,,,12/10/2018,12/10/2018,0.00,,15.25,,"-1,036,022.69"
,CS,AR,32010081,1005,100,,Cash sale,,,,,,12/10/2018,12/10/2018,0.00,,3.64,,"-1,036,026.33"
,CS,AR,32010086,1005,100,,Cash sale,,,,,,12/10/2018,12/10/2018,0.00,,7.29,,"-1,036,033.62"
,CS,AR,32010101,1005,100,,Cash sale,,,,,,12/10/2018,12/10/2018,0.00,,3.64,,"-1,036,037.26"
,CS,AR,32010140,1005,100,,Cash sale,,,,,,12/10/2018,12/10/2018,0.00,,18.22,,"-1,036,055.48"
,CS,AR,32010163,1005,100,,Cash sale,,,,,,12/10/2018,12/10/2018,0.00,,14.63,,"-1,036,070.11"
,CS,AR,32010198,1005,100,,Cash sale,,,,,,12/10/2018,12/10/2018,0.00,,7.75,,"-1,036,077.86"
,CS,AR,32010238,1005,100,,Cash sale,,,,,,12/10/2018,12/10/2018,0.00,,18.22,,"-1,036,096.08"
,CS,AR,32010245,1005,100,,Cash sale,,,,,,12/10/2018,12/10/2018,0.00,,20.34,,"-1,036,116.42"
,CS,AR,32010247,1005,100,,Cash sale,,,,,,12/10/2018,12/10/2018,0.00,,6.02,,"-1,036,122.44"
,CS,AR,32010249,1005,100,,Cash sale,,,,,,12/10/2018,12/10/2018,0.00,,7.29,,"-1,036,129.73"
,CS,AR,32010262,1005,100,,Cash sale,,,,,,12/10/2018,12/10/2018,0.00,,20.34,,"-1,036,150.07"
,CS,AR,32010263,1005,100,,Cash sale,,,,,,12/10/2018,12/10/2018,0.00,,7.29,,"-1,036,157.36"
,CS,AR,32010279,1005,100,,Cash sale,,,,,,12/10/2018,12/10/2018,0.00,,50.00,,"-1,036,207.36"
,CS,AR,32010280,1005,100,,Cash sale,,,,,,12/10/2018,12/10/2018,0.00,,3.64,,"-1,036,211.00"
,CS,AR,32010292,1005,100,,Cash sale,,,,,,12/10/2018,12/10/2018,0.00,,6.02,,"-1,036,217.02"
,CS,AR,32010315,1005,100,,Cash sale,,,,,,12/10/2018,12/10/2018,0.00,,9.84,,"-1,036,226.86"
,CS,AR,32010322,1005,100,,Cash sale,,,,,,12/10/2018,12/10/2018,0.00,,4.58,,"-1,036,231.44"
,CS,AR,32010332,1005,100,,Cash sale,,,,,,12/10/2018,12/10/2018,0.00,,10.93,,"-1,036,242.37"
,CS,AR,32010352,1005,100,,Cash sale,,,,,,12/10/2018,12/10/2018,0.00,,10.17,,"-1,036,252.54"
,CS,AR,32010354,1005,100,,Cash sale,,,,,,12/10/2018,12/10/2018,0.00,,7.29,,"-1,036,259.83"
,CS,AR,32010377,1005,100,,Cash sale,,,,,,12/10/2018,12/10/2018,0.00,,15.18,,"-1,036,275.01"
,CS,AR,32010396,1005,100,,Cash sale,,,,,,12/10/2018,12/10/2018,0.00,,14.58,,"-1,036,289.59"
,CS,AR,32010406,1005,100,,Cash sale,,,,,,12/10/2018,12/10/2018,0.00,,3.64,,"-1,036,293.23"
,CS,AR,32010412,1005,100,,Cash sale,,,,,,12/10/2018,12/10/2018,0.00,,12.14,,"-1,036,305.37"
,CS,AR,32010415,1005,100,,Cash sale,,,,,,12/10/2018,12/10/2018,0.00,,9.15,,"-1,036,314.52"
,CS,AR,32010419,1005,100,,Cash sale,,,,,,12/10/2018,12/10/2018,0.00,,6.23,,"-1,036,320.75"
,CS,AR,32010430,1005,100,,Cash sale,,,,,,12/10/2018,12/10/2018,0.00,,6.08,,"-1,036,326.83"
,CS,AR,32010433,1005,100,,Cash sale,,,,,,12/10/2018,12/10/2018,0.00,,10.93,,"-1,036,337.76"
,CS,AR,32010457,1005,100,,Cash sale,,,,,,12/10/2018,12/10/2018,0.00,,3.64,,"-1,036,341.40"
,CS,AR,32010463,1005,100,,Cash sale,,,,,,12/10/2018,12/10/2018,0.00,,18.22,,"-1,036,359.62"
,CS,AR,32010467,1005,100,,Cash sale,,,,,,12/10/2018,12/10/2018,0.00,,7.29,,"-1,036,366.91"
,CS,AR,32010477,1005,100,,Cash sale,,,,,,12/10/2018,12/10/2018,0.00,,7.29,,"-1,036,374.20"
,CS,AR,32010488,1005,100,,Cash sale,,,,,,12/10/2018,12/10/2018,0.00,,3.01,,"-1,036,377.21"
,CS,AR,32010504,1005,100,,Cash sale,,,,,,12/10/2018,12/10/2018,0.00,,7.29,,"-1,036,384.50"
,CS,AR,32010546,1005,100,,Cash sale,,,,,,12/10/2018,12/10/2018,0.00,,9.32,,"-1,036,393.82"
,CS,AR,32010553,1005,100,,Cash sale,,,,,,12/10/2018,12/10/2018,0.00,,6.07,,"-1,036,399.89"
,CS,AR,32010597,1005,100,,Cash sale,,,,,,12/10/2018,12/10/2018,0.00,,43.73,,"-1,036,443.62"
,IN,AR,30328315,1005,100,,Invoice,,,,,,12/10/2018,12/10/2018,0.00,,5.93,,"-1,036,449.55"
,IN,AR,30328316,1005,100,,Invoice,,,,,,12/10/2018,12/10/2018,0.00,,17.80,,"-1,036,467.35"
,IN,AR,30328331,1005,100,,Invoice,,,,,,12/10/2018,12/10/2018,0.00,,21.86,,"-1,036,489.21"
,IN,AR,30328342,1005,100,,Invoice,,,,,,12/10/2018,12/10/2018,0.00,,19.58,,"-1,036,508.79"
,IN,AR,30328376,1005,100,,Invoice,,,,,,12/10/2018,12/10/2018,0.00,,8.10,,"-1,036,516.89"
,IN,AR,30328403,1005,100,,Invoice,,,,,,12/10/2018,12/10/2018,0.00,,10.93,,"-1,036,527.82"
,IN,AR,30328416,1005,100,,Invoice,,,,,,12/10/2018,12/10/2018,0.00,,9.13,,"-1,036,536.95"
,IN,AR,30328434,1005,100,,Invoice,,,,,,12/10/2018,12/10/2018,0.00,,12.08,,"-1,036,549.03"
,IN,AR,30328453,1005,100,,Invoice,,,,,,12/10/2018,12/10/2018,0.00,,54.95,,"-1,036,603.98"
,IN,AR,30328463,1005,100,,Invoice,,,,,,12/10/2018,12/10/2018,0.00,,3.64,,"-1,036,607.62"
,IN,AR,30328469,1005,100,,Invoice,,,,,,12/10/2018,12/10/2018,0.00,,18.37,,"-1,036,625.99"
,IN,AR,30328474,1005,100,,Invoice,,,,,,12/10/2018,12/10/2018,0.00,,95.09,,"-1,036,721.08"
,IN,AR,30328496,1005,100,,Invoice,,,,,,12/10/2018,12/10/2018,0.00,,47.46,,"-1,036,768.54"
,IN,AR,30328523,1005,100,,Invoice,,,,,,12/10/2018,12/10/2018,0.00,,14.58,,"-1,036,783.12"
,IN,AR,30328552,1005,100,,Invoice,,,,,,12/10/2018,12/10/2018,0.00,,10.93,,"-1,036,794.05"
,IN,AR,30328556,1005,100,,Invoice,,,,,,12/10/2018,12/10/2018,0.00,,29.15,,"-1,036,823.20"
,IN,AR,30328564,1005,100,,Invoice,,,,,,12/10/2018,12/10/2018,0.00,,36.00,,"-1,036,859.20"
,IN,AR,30328603,1005,100,,Invoice,,,,,,12/10/2018,12/10/2018,0.00,,7.29,,"-1,036,866.49"
,IN,AR,30328612,1005,100,,Invoice,,,,,,12/10/2018,12/10/2018,0.00,,3.64,,"-1,036,870.13"
,IN,AR,30328615,1005,100,,Invoice,,,,,,12/10/2018,12/10/2018,0.00,,4.75,,"-1,036,874.88"
,IN,AR,30328624,1005,100,,Invoice,,,,,,12/10/2018,12/10/2018,0.00,,12.00,,"-1,036,886.88"
,IN,AR,30328641,1005,100,,Invoice,,,,,,12/10/2018,12/10/2018,0.00,,22.71,,"-1,036,909.59"
,IN,AR,30328663,1005,100,,Invoice,,,,,,12/10/2018,12/10/2018,0.00,,5.82,,"-1,036,915.41"
,IN,AR,30328664,1005,100,,Invoice,,,,,,12/10/2018,12/10/2018,0.00,,9.70,,"-1,036,925.11"
,IN,AR,30328665,1005,100,,Invoice,,,,,,12/10/2018,12/10/2018,0.00,,3.88,,"-1,036,928.99"
,IN,AR,30328679,1005,100,,Invoice,,,,,,12/10/2018,12/10/2018,0.00,,42.00,,"-1,036,970.99"
,IN,AR,30328685,1005,100,,Invoice,,,,,,12/10/2018,12/10/2018,0.00,,3.64,,"-1,036,974.63"
,IN,AR,30328701,1005,100,,Invoice,,,,,,12/10/2018,12/10/2018,0.00,,29.15,,"-1,037,003.78"
,IN,AR,30328706,1005,100,,Invoice,,,,,,12/10/2018,12/10/2018,0.00,,5.59,,"-1,037,009.37"
,IN,AR,30328731,1005,100,,Invoice,,,,,,12/10/2018,12/10/2018,0.00,,9.56,,"-1,037,018.93"
,IN,AR,30328747,1005,100,,Invoice,,,,,,12/10/2018,12/10/2018,0.00,,7.75,,"-1,037,026.68"
,IN,AR,30328775,1005,100,,Invoice,,,,,,12/10/2018,12/10/2018,0.00,,10.93,,"-1,037,037.61"
,IN,AR,30328807,1005,100,,Invoice,,,,,,12/10/2018,12/10/2018,0.00,,20.34,,"-1,037,057.95"
,IN,AR,30328808,1005,100,,Invoice,,,,,,12/10/2018,12/10/2018,0.00,,50.85,,"-1,037,108.80"
,IN,AR,30328824,1005,100,,Invoice,,,,,,12/10/2018,12/10/2018,0.00,,254.24,,"-1,037,363.04"
,IN,AR,30328836,1005,100,,Invoice,,,,,,12/10/2018,12/10/2018,0.00,,20.68,,"-1,037,383.72"
,IN,AR,30328842,1005,100,,Invoice,,,,,,12/10/2018,12/10/2018,0.00,,4.78,,"-1,037,388.50"
,IN,AR,30328856,1005,100,,Invoice,,,,,,12/10/2018,12/10/2018,0.00,,15.53,,"-1,037,404.03"
,IN,AR,30328877,1005,100,,Invoice,,,,,,12/10/2018,12/10/2018,0.00,,3.01,,"-1,037,407.04"
,IN,AR,30328900,1005,100,,Invoice,,,,,,12/10/2018,12/10/2018,0.00,,59.47,,"-1,037,466.51"
,IN,AR,30328934,1005,100,,Invoice,,,,,,12/10/2018,12/10/2018,0.00,,9.56,,"-1,037,476.07"
,IN,AR,30328962,1005,100,,Invoice,,,,,,12/10/2018,12/10/2018,0.00,,12.03,,"-1,037,488.10"
,IN,AR,30329028,1005,100,,Invoice,,,,,,12/10/2018,12/10/2018,0.00,,2.39,,"-1,037,490.49"
,IN,AR,30329035,1005,100,,Invoice,,,,,,12/10/2018,12/10/2018,0.00,,5.08,,"-1,037,495.57"
,IN,AR,30329036,1005,100,,Invoice,,,,,,12/10/2018,12/10/2018,0.00,,2.54,,"-1,037,498.11"
,IN,AR,30329054,1005,100,,Invoice,,,,,,12/10/2018,12/10/2018,0.00,,5.08,,"-1,037,503.19"
,IN,AR,30329118,1005,100,,Invoice,,,,,,12/10/2018,12/10/2018,0.00,,4.32,,"-1,037,507.51"
,IN,AR,30329119,1005,100,,Invoice,,,,,,12/10/2018,12/10/2018,0.00,,15.25,,"-1,037,522.76"
,IN,AR,30329151,1005,100,,Invoice,,,,,,12/10/2018,12/10/2018,0.00,,14.58,,"-1,037,537.34"
,IN,AR,30329179,1005,100,,Invoice,,,,,,12/10/2018,12/10/2018,0.00,,3.31,,"-1,037,540.65"
,IN,AR,30329205,1005,100,,Invoice,,,,,,12/10/2018,12/10/2018,0.00,,10.99,,"-1,037,551.64"
,IN,AR,30329225,1005,100,,Invoice,,,,,,12/10/2018,12/10/2018,0.00,,10.59,,"-1,037,562.23"
,IN,AR,30329275,1005,100,,Invoice,,,,,,12/10/2018,12/10/2018,0.00,,11.22,,"-1,037,573.45"
,IN,AR,30329283,1005,100,,Invoice,,,,,,12/10/2018,12/10/2018,0.00,,84.24,,"-1,037,657.69"
,IN,AR,30329392,1005,100,,Invoice,,,,,,12/10/2018,12/10/2018,0.00,,5.17,,"-1,037,662.86"
,IN,AR,30329483,1005,100,,Invoice,,,,,,12/10/2018,12/10/2018,0.00,,3.53,,"-1,037,666.39"
,IN,AR,30329502,1005,100,,Invoice,,,,,,12/10/2018,12/10/2018,0.00,,3.64,,"-1,037,670.03"
,IN,AR,30329514,1005,100,,Invoice,,,,,,12/10/2018,12/10/2018,0.00,,4.85,,"-1,037,674.88"
,IN,AR,30329520,1005,100,,Invoice,,,,,,12/10/2018,12/10/2018,0.00,,8.24,,"-1,037,683.12"
,IN,AR,30329542,1005,100,,Invoice,,,,,,12/10/2018,12/10/2018,0.00,,7.29,,"-1,037,690.41"
,IN,AR,30329543,1005,100,,Invoice,,,,,,12/10/2018,12/10/2018,0.00,,10.93,,"-1,037,701.34"
,IN,AR,30329549,1005,100,,Invoice,,,,,,12/10/2018,12/10/2018,0.00,,8.78,,"-1,037,710.12"
,IN,AR,30329606,1005,100,,Invoice,,,,,,12/10/2018,12/10/2018,0.00,,7.29,,"-1,037,717.41"
,IN,AR,30329635,1005,100,,Invoice,,,,,,12/10/2018,12/10/2018,0.00,,33.86,,"-1,037,751.27"
,IN,AR,30329636,1005,100,,Invoice,,,,,,12/10/2018,12/10/2018,0.00,,3.98,,"-1,037,755.25"
,IN,AR,30329665,1005,100,,Invoice,,,,,,12/10/2018,12/10/2018,0.00,,56.78,,"-1,037,812.03"
,IN,AR,30329680,1005,100,,Invoice,,,,,,12/10/2018,12/10/2018,0.00,,28.81,,"-1,037,840.84"
,IN,AR,30329693,1005,100,,Invoice,,,,,,12/10/2018,12/10/2018,0.00,,12.03,,"-1,037,852.87"
,IN,AR,30329722,1005,100,,Invoice,,,,,,12/10/2018,12/10/2018,0.00,,12.97,,"-1,037,865.84"
,IN,AR,30329736,1005,100,,Invoice,,,,,,12/10/2018,12/10/2018,0.00,,14.58,,"-1,037,880.42"
,IN,AR,30329740,1005,100,,Invoice,,,,,,12/10/2018,12/10/2018,0.00,,49.92,,"-1,037,930.34"
,IN,AR,30329751,1005,100,,Invoice,,,,,,12/10/2018,12/10/2018,0.00,,2.54,,"-1,037,932.88"
,IN,AR,30329770,1005,100,,Invoice,,,,,,12/10/2018,12/10/2018,0.00,,21.52,,"-1,037,954.40"
,IN,AR,30329787,1005,100,,Invoice,,,,,,12/10/2018,12/10/2018,0.00,,10.93,,"-1,037,965.33"
,IN,AR,30329794,1005,100,,Invoice,,,,,,12/10/2018,12/10/2018,0.00,,25.42,,"-1,037,990.75"
,IN,AR,30329810,1005,100,,Invoice,,,,,,12/10/2018,12/10/2018,0.00,,10.00,,"-1,038,000.75"
,IN,AR,30329817,1005,100,,Invoice,,,,,,12/10/2018,12/10/2018,0.00,,4.00,,"-1,038,004.75"
,IN,AR,30329826,1005,100,,Invoice,,,,,,12/10/2018,12/10/2018,0.00,,18.01,,"-1,038,022.76"
,IN,AR,30329866,1005,100,,Invoice,,,,,,12/10/2018,12/10/2018,0.00,,32.85,,"-1,038,055.61"
,IN,AR,30329875,1005,100,,Invoice,,,,,,12/10/2018,12/10/2018,0.00,,39.95,,"-1,038,095.56"
,IN,AR,30329893,1005,100,,Invoice,,,,,,12/10/2018,12/10/2018,0.00,,4.66,,"-1,038,100.22"
,IN,AR,30329931,1005,100,,Invoice,,,,,,12/10/2018,12/10/2018,0.00,,6.89,,"-1,038,107.11"
,IN,AR,30329963,1005,100,,Invoice,,,,,,12/10/2018,12/10/2018,0.00,,29.15,,"-1,038,136.26"
,IN,AR,30329966,1005,100,,Invoice,,,,,,12/10/2018,12/10/2018,0.00,,29.15,,"-1,038,165.41"
,IN,AR,30329978,1005,100,,Invoice,,,,,,12/10/2018,12/10/2018,0.00,,5.68,,"-1,038,171.09"
,IN,AR,30329981,1005,100,,Invoice,,,,,,12/10/2018,12/10/2018,0.00,,21.74,,"-1,038,192.83"
,IN,AR,30330091,1005,100,,Invoice,,,,,,12/10/2018,12/10/2018,0.00,,6.00,,"-1,038,198.83"
,IN,AR,30330135,1005,100,,Invoice,,,,,,12/10/2018,12/10/2018,0.00,,62.53,,"-1,038,261.36"
,IN,AR,30330154,1005,100,,Invoice,,,,,,12/10/2018,12/10/2018,0.00,,2.92,,"-1,038,264.28"
,IN,AR,30330162,1005,100,,Invoice,,,,,,12/10/2018,12/10/2018,0.00,,13.69,,"-1,038,277.97"
,IN,AR,30330175,1005,100,,Invoice,,,,,,12/10/2018,12/10/2018,0.00,,48.73,,"-1,038,326.70"
,IN,AR,30330202,1005,100,,Invoice,,,,,,12/10/2018,12/10/2018,0.00,,14.58,,"-1,038,341.28"
,IN,AR,30330213,1005,100,,Invoice,,,,,,12/10/2018,12/10/2018,0.00,,14.83,,"-1,038,356.11"
,IN,AR,30330223,1005,100,,Invoice,,,,,,12/10/2018,12/10/2018,0.00,,8.17,,"-1,038,364.28"
,IN,AR,30330250,1005,100,,Invoice,,,,,,12/10/2018,12/10/2018,0.00,,7.97,,"-1,038,372.25"
,IN,AR,30330270,1005,100,,Invoice,,,,,,12/10/2018,12/10/2018,0.00,,9.66,,"-1,038,381.91"
,IN,AR,30330275,1005,100,,Invoice,,,,,,12/10/2018,12/10/2018,0.00,,18.21,,"-1,038,400.12"
,IN,AR,30330281,1005,100,,Invoice,,,,,,12/10/2018,12/10/2018,0.00,,4.00,,"-1,038,404.12"
,IN,AR,30330301,1005,100,,Invoice,,,,,,12/10/2018,12/10/2018,0.00,,10.38,,"-1,038,414.50"
,IN,AR,30330366,1005,100,,Invoice,,,,,,12/10/2018,12/10/2018,0.00,,22.12,,"-1,038,436.62"
,IN,AR,30330368,1005,100,,Invoice,,,,,,12/10/2018,12/10/2018,0.00,,13.96,,"-1,038,450.58"
,IN,AR,30330379,1005,100,,Invoice,,,,,,12/10/2018,12/10/2018,0.00,,2.03,,"-1,038,452.61"
,IN,AR,30330399,1005,100,,Invoice,,,,,,12/10/2018,12/10/2018,0.00,,7.29,,"-1,038,459.90"
,IN,AR,30330401,1005,100,,Invoice,,,,,,12/10/2018,12/10/2018,0.00,,7.29,,"-1,038,467.19"
,IN,AR,30330410,1005,100,,Invoice,,,,,,12/10/2018,12/10/2018,0.00,,12.62,,"-1,038,479.81"
,IN,AR,30330457,1005,100,,Invoice,,,,,,12/10/2018,12/10/2018,0.00,,12.14,,"-1,038,491.95"
,IN,AR,30330479,1005,100,,Invoice,,,,,,12/10/2018,12/10/2018,0.00,,14.58,,"-1,038,506.53"
,IN,AR,30330489,1005,100,,Invoice,,,,,,12/10/2018,12/10/2018,0.00,,7.19,,"-1,038,513.72"
,IN,AR,30330516,1005,100,,Invoice,,,,,,12/10/2018,12/10/2018,0.00,,36.44,,"-1,038,550.16"
,CN,AR,31019380,1005,100,,Credit Note,,,,,,12/10/2018,12/10/2018,419.07,,0.00,,"-1,038,131.09"
,CS,AR,32009749,1005,100,,Cash sale,,,,,,13/10/2018,13/10/2018,0.00,,6.02,,"-1,038,137.11"
,CS,AR,32009844,1005,100,,Cash sale,,,,,,13/10/2018,13/10/2018,0.00,,18.22,,"-1,038,155.33"
,CS,AR,32010065,1005,100,,Cash sale,,,,,,13/10/2018,13/10/2018,0.00,,7.29,,"-1,038,162.62"
,IN,AR,30328497,1005,100,,Invoice,,,,,,13/10/2018,13/10/2018,0.00,,64.07,,"-1,038,226.69"
,IN,AR,30328891,1005,100,,Invoice,,,,,,13/10/2018,13/10/2018,0.00,,612.20,,"-1,038,838.89"
,IN,AR,30329402,1005,100,,Invoice,,,,,,13/10/2018,13/10/2018,0.00,,12.97,,"-1,038,851.86"
,IN,AR,30330376,1005,100,,Invoice,,,,,,13/10/2018,13/10/2018,0.00,,6.56,,"-1,038,858.42"
,IN,AR,30330513,1005,100,,Invoice,,,,,,13/10/2018,13/10/2018,0.00,,14.58,,"-1,038,873.00"
,IN,AR,30330717,1005,100,,Invoice,,,,,,13/10/2018,13/10/2018,0.00,,10.93,,"-1,038,883.93"
,CN,AR,31019326,1005,100,,Credit Note,,,,,,15/10/2018,15/10/2018,"1,518.73",,0.00,,"-1,037,365.20"
,CN,AR,31019333,1005,100,,Credit Note,,,,,,15/10/2018,15/10/2018,"2,343.01",,0.00,,"-1,035,022.19"
,CS,AR,32009714,1005,100,,Cash sale,,,,,,15/10/2018,15/10/2018,0.00,,5.61,,"-1,035,027.80"
,CS,AR,32009731,1005,100,,Cash sale,,,,,,15/10/2018,15/10/2018,0.00,,14.24,,"-1,035,042.04"
,CS,AR,32009741,1005,100,,Cash sale,,,,,,15/10/2018,15/10/2018,0.00,,14.58,,"-1,035,056.62"
,CS,AR,32009759,1005,100,,Cash sale,,,,,,15/10/2018,15/10/2018,0.00,,8.42,,"-1,035,065.04"
,CS,AR,32009779,1005,100,,Cash sale,,,,,,15/10/2018,15/10/2018,0.00,,4.32,,"-1,035,069.36"
,CS,AR,32009790,1005,100,,Cash sale,,,,,,15/10/2018,15/10/2018,0.00,,3.64,,"-1,035,073.00"
,CS,AR,32009825,1005,100,,Cash sale,,,,,,15/10/2018,15/10/2018,0.00,,14.53,,"-1,035,087.53"
,CS,AR,32009850,1005,100,,Cash sale,,,,,,15/10/2018,15/10/2018,0.00,,9.73,,"-1,035,097.26"
,CS,AR,32009858,1005,100,,Cash sale,,,,,,15/10/2018,15/10/2018,0.00,,5.85,,"-1,035,103.11"
,CS,AR,32009864,1005,100,,Cash sale,,,,,,15/10/2018,15/10/2018,0.00,,7.29,,"-1,035,110.40"
,CS,AR,32009877,1005,100,,Cash sale,,,,,,15/10/2018,15/10/2018,0.00,,3.64,,"-1,035,114.04"
,CS,AR,32009883,1005,100,,Cash sale,,,,,,15/10/2018,15/10/2018,0.00,,7.29,,"-1,035,121.33"
,CS,AR,32009900,1005,100,,Cash sale,,,,,,15/10/2018,15/10/2018,0.00,,3.64,,"-1,035,124.97"
,CS,AR,32009901,1005,100,,Cash sale,,,,,,15/10/2018,15/10/2018,0.00,,3.64,,"-1,035,128.61"
,CS,AR,32009904,1005,100,,Cash sale,,,,,,15/10/2018,15/10/2018,0.00,,10.34,,"-1,035,138.95"
,CS,AR,32009929,1005,100,,Cash sale,,,,,,15/10/2018,15/10/2018,0.00,,3.64,,"-1,035,142.59"
,CS,AR,32009940,1005,100,,Cash sale,,,,,,15/10/2018,15/10/2018,0.00,,5.08,,"-1,035,147.67"
,CS,AR,32009978,1005,100,,Cash sale,,,,,,15/10/2018,15/10/2018,0.00,,3.64,,"-1,035,151.31"
,CS,AR,32009997,1005,100,,Cash sale,,,,,,15/10/2018,15/10/2018,0.00,,7.29,,"-1,035,158.60"
,CS,AR,32010002,1005,100,,Cash sale,,,,,,15/10/2018,15/10/2018,0.00,,14.58,,"-1,035,173.18"
,CS,AR,32010024,1005,100,,Cash sale,,,,,,15/10/2018,15/10/2018,0.00,,20.47,,"-1,035,193.65"
,CS,AR,32010029,1005,100,,Cash sale,,,,,,15/10/2018,15/10/2018,0.00,,6.74,,"-1,035,200.39"
,CS,AR,32010044,1005,100,,Cash sale,,,,,,15/10/2018,15/10/2018,0.00,,27.08,,"-1,035,227.47"
,CS,AR,32010057,1005,100,,Cash sale,,,,,,15/10/2018,15/10/2018,0.00,,7.29,,"-1,035,234.76"
,CS,AR,32010105,1005,100,,Cash sale,,,,,,15/10/2018,15/10/2018,0.00,,5.08,,"-1,035,239.84"
,CS,AR,32010132,1005,100,,Cash sale,,,,,,15/10/2018,15/10/2018,0.00,,3.64,,"-1,035,243.48"
,CS,AR,32010143,1005,100,,Cash sale,,,,,,15/10/2018,15/10/2018,0.00,,10.93,,"-1,035,254.41"
,CS,AR,32010146,1005,100,,Cash sale,,,,,,15/10/2018,15/10/2018,0.00,,7.29,,"-1,035,261.70"
,CS,AR,32010152,1005,100,,Cash sale,,,,,,15/10/2018,15/10/2018,0.00,,2.16,,"-1,035,263.86"
,CS,AR,32010188,1005,100,,Cash sale,,,,,,15/10/2018,15/10/2018,0.00,,5.17,,"-1,035,269.03"
,CS,AR,32010191,1005,100,,Cash sale,,,,,,15/10/2018,15/10/2018,0.00,,3.64,,"-1,035,272.67"
,CS,AR,32010195,1005,100,,Cash sale,,,,,,15/10/2018,15/10/2018,0.00,,3.20,,"-1,035,275.87"
,CS,AR,32010202,1005,100,,Cash sale,,,,,,15/10/2018,15/10/2018,0.00,,6.08,,"-1,035,281.95"
,CS,AR,32010211,1005,100,,Cash sale,,,,,,15/10/2018,15/10/2018,0.00,,18.05,,"-1,035,300.00"
,CS,AR,32010259,1005,100,,Cash sale,,,,,,15/10/2018,15/10/2018,0.00,,5.17,,"-1,035,305.17"
,CS,AR,32010323,1005,100,,Cash sale,,,,,,15/10/2018,15/10/2018,0.00,,11.44,,"-1,035,316.61"
,CS,AR,32010356,1005,100,,Cash sale,,,,,,15/10/2018,15/10/2018,0.00,,9.10,,"-1,035,325.71"
,CS,AR,32010378,1005,100,,Cash sale,,,,,,15/10/2018,15/10/2018,0.00,,9.11,,"-1,035,334.82"
,CS,AR,32010397,1005,100,,Cash sale,,,,,,15/10/2018,15/10/2018,0.00,,14.58,,"-1,035,349.40"
,CS,AR,32010424,1005,100,,Cash sale,,,,,,15/10/2018,15/10/2018,0.00,,9.10,,"-1,035,358.50"
,CS,AR,32010426,1005,100,,Cash sale,,,,,,15/10/2018,15/10/2018,0.00,,7.29,,"-1,035,365.79"
,CS,AR,32010440,1005,100,,Cash sale,,,,,,15/10/2018,15/10/2018,0.00,,9.84,,"-1,035,375.63"
,CS,AR,32010478,1005,100,,Cash sale,,,,,,15/10/2018,15/10/2018,0.00,,7.29,,"-1,035,382.92"
,CS,AR,32010490,1005,100,,Cash sale,,,,,,15/10/2018,15/10/2018,0.00,,21.86,,"-1,035,404.78"
,CS,AR,32010493,1005,100,,Cash sale,,,,,,15/10/2018,15/10/2018,0.00,,3.64,,"-1,035,408.42"
,CS,AR,32010497,1005,100,,Cash sale,,,,,,15/10/2018,15/10/2018,0.00,,5.94,,"-1,035,414.36"
,CS,AR,32010547,1005,100,,Cash sale,,,,,,15/10/2018,15/10/2018,0.00,,6.99,,"-1,035,421.35"
,CS,AR,32010590,1005,100,,Cash sale,,,,,,15/10/2018,15/10/2018,0.00,,29.15,,"-1,035,450.50"
,IN,AR,30328317,1005,100,,Invoice,,,,,,15/10/2018,15/10/2018,0.00,,77.12,,"-1,035,527.62"
,IN,AR,30328337,1005,100,,Invoice,,,,,,15/10/2018,15/10/2018,0.00,,18.22,,"-1,035,545.84"
,IN,AR,30328347,1005,100,,Invoice,,,,,,15/10/2018,15/10/2018,0.00,,14.58,,"-1,035,560.42"
,IN,AR,30328377,1005,100,,Invoice,,,,,,15/10/2018,15/10/2018,0.00,,2.03,,"-1,035,562.45"
,IN,AR,30328378,1005,100,,Invoice,,,,,,15/10/2018,15/10/2018,0.00,,24.31,,"-1,035,586.76"
,IN,AR,30328379,1005,100,,Invoice,,,,,,15/10/2018,15/10/2018,0.00,,4.05,,"-1,035,590.81"
,IN,AR,30328380,1005,100,,Invoice,,,,,,15/10/2018,15/10/2018,0.00,,16.20,,"-1,035,607.01"
,IN,AR,30328381,1005,100,,Invoice,,,,,,15/10/2018,15/10/2018,0.00,,14.18,,"-1,035,621.19"
,IN,AR,30328382,1005,100,,Invoice,,,,,,15/10/2018,15/10/2018,0.00,,8.10,,"-1,035,629.29"
,IN,AR,30328383,1005,100,,Invoice,,,,,,15/10/2018,15/10/2018,0.00,,6.08,,"-1,035,635.37"
,IN,AR,30328428,1005,100,,Invoice,,,,,,15/10/2018,15/10/2018,0.00,,3.64,,"-1,035,639.01"
,IN,AR,30328454,1005,100,,Invoice,,,,,,15/10/2018,15/10/2018,0.00,,25.36,,"-1,035,664.37"
,IN,AR,30328466,1005,100,,Invoice,,,,,,15/10/2018,15/10/2018,0.00,,14.58,,"-1,035,678.95"
,IN,AR,30328498,1005,100,,Invoice,,,,,,15/10/2018,15/10/2018,0.00,,125.76,,"-1,035,804.71"
,IN,AR,30328529,1005,100,,Invoice,,,,,,15/10/2018,15/10/2018,0.00,,44.00,,"-1,035,848.71"
,IN,AR,30328545,1005,100,,Invoice,,,,,,15/10/2018,15/10/2018,0.00,,65.75,,"-1,035,914.46"
,IN,AR,30328565,1005,100,,Invoice,,,,,,15/10/2018,15/10/2018,0.00,,18.00,,"-1,035,932.46"
,IN,AR,30328566,1005,100,,Invoice,,,,,,15/10/2018,15/10/2018,0.00,,32.00,,"-1,035,964.46"
,IN,AR,30328589,1005,100,,Invoice,,,,,,15/10/2018,15/10/2018,0.00,,40.68,,"-1,036,005.14"
,IN,AR,30328680,1005,100,,Invoice,,,,,,15/10/2018,15/10/2018,0.00,,34.00,,"-1,036,039.14"
,IN,AR,30328709,1005,100,,Invoice,,,,,,15/10/2018,15/10/2018,0.00,,19.32,,"-1,036,058.46"
,IN,AR,30328721,1005,100,,Invoice,,,,,,15/10/2018,15/10/2018,0.00,,36.44,,"-1,036,094.90"
,IN,AR,30328752,1005,100,,Invoice,,,,,,15/10/2018,15/10/2018,0.00,,7.75,,"-1,036,102.65"
,IN,AR,30328762,1005,100,,Invoice,,,,,,15/10/2018,15/10/2018,0.00,,7.19,,"-1,036,109.84"
,IN,AR,30328769,1005,100,,Invoice,,,,,,15/10/2018,15/10/2018,0.00,,16.08,,"-1,036,125.92"
,IN,AR,30328801,1005,100,,Invoice,,,,,,15/10/2018,15/10/2018,0.00,,4.24,,"-1,036,130.16"
,IN,AR,30328837,1005,100,,Invoice,,,,,,15/10/2018,15/10/2018,0.00,,33.60,,"-1,036,163.76"
,IN,AR,30328852,1005,100,,Invoice,,,,,,15/10/2018,15/10/2018,0.00,,11.86,,"-1,036,175.62"
,IN,AR,30328857,1005,100,,Invoice,,,,,,15/10/2018,15/10/2018,0.00,,5.18,,"-1,036,180.80"
,IN,AR,30328871,1005,100,,Invoice,,,,,,15/10/2018,15/10/2018,0.00,,3.64,,"-1,036,184.44"
,IN,AR,30328901,1005,100,,Invoice,,,,,,15/10/2018,15/10/2018,0.00,,88.19,,"-1,036,272.63"
,IN,AR,30328917,1005,100,,Invoice,,,,,,15/10/2018,15/10/2018,0.00,,12.71,,"-1,036,285.34"
,IN,AR,30328935,1005,100,,Invoice,,,,,,15/10/2018,15/10/2018,0.00,,14.34,,"-1,036,299.68"
,IN,AR,30328946,1005,100,,Invoice,,,,,,15/10/2018,15/10/2018,0.00,,32.20,,"-1,036,331.88"
,IN,AR,30328958,1005,100,,Invoice,,,,,,15/10/2018,15/10/2018,0.00,,9.03,,"-1,036,340.91"
,IN,AR,30328970,1005,100,,Invoice,,,,,,15/10/2018,15/10/2018,0.00,,2.12,,"-1,036,343.03"
,IN,AR,30328986,1005,100,,Invoice,,,,,,15/10/2018,15/10/2018,0.00,,6.36,,"-1,036,349.39"
,IN,AR,30329037,1005,100,,Invoice,,,,,,15/10/2018,15/10/2018,0.00,,7.63,,"-1,036,357.02"
,IN,AR,30329076,1005,100,,Invoice,,,,,,15/10/2018,15/10/2018,0.00,,7.12,,"-1,036,364.14"
,IN,AR,30329123,1005,100,,Invoice,,,,,,15/10/2018,15/10/2018,0.00,,6.36,,"-1,036,370.50"
,IN,AR,30329134,1005,100,,Invoice,,,,,,15/10/2018,15/10/2018,0.00,,7.17,,"-1,036,377.67"
,IN,AR,30329156,1005,100,,Invoice,,,,,,15/10/2018,15/10/2018,0.00,,30.51,,"-1,036,408.18"
,IN,AR,30329170,1005,100,,Invoice,,,,,,15/10/2018,15/10/2018,0.00,,14.24,,"-1,036,422.42"
,IN,AR,30329210,1005,100,,Invoice,,,,,,15/10/2018,15/10/2018,0.00,,7.29,,"-1,036,429.71"
,IN,AR,30329216,1005,100,,Invoice,,,,,,15/10/2018,15/10/2018,0.00,,3.64,,"-1,036,433.35"
,IN,AR,30329249,1005,100,,Invoice,,,,,,15/10/2018,15/10/2018,0.00,,7.29,,"-1,036,440.64"
,IN,AR,30329265,1005,100,,Invoice,,,,,,15/10/2018,15/10/2018,0.00,,3.64,,"-1,036,444.28"
,IN,AR,30329271,1005,100,,Invoice,,,,,,15/10/2018,15/10/2018,0.00,,9.19,,"-1,036,453.47"
,IN,AR,30329285,1005,100,,Invoice,,,,,,15/10/2018,15/10/2018,0.00,,10.51,,"-1,036,463.98"
,IN,AR,30329301,1005,100,,Invoice,,,,,,15/10/2018,15/10/2018,0.00,,14.58,,"-1,036,478.56"
,IN,AR,30329330,1005,100,,Invoice,,,,,,15/10/2018,15/10/2018,0.00,,6.36,,"-1,036,484.92"
,IN,AR,30329340,1005,100,,Invoice,,,,,,15/10/2018,15/10/2018,0.00,,65.90,,"-1,036,550.82"
,IN,AR,30329353,1005,100,,Invoice,,,,,,15/10/2018,15/10/2018,0.00,,8.00,,"-1,036,558.82"
,IN,AR,30329409,1005,100,,Invoice,,,,,,15/10/2018,15/10/2018,0.00,,36.12,,"-1,036,594.94"
,IN,AR,30329418,1005,100,,Invoice,,,,,,15/10/2018,15/10/2018,0.00,,4.49,,"-1,036,599.43"
,IN,AR,30329484,1005,100,,Invoice,,,,,,15/10/2018,15/10/2018,0.00,,5.29,,"-1,036,604.72"
,IN,AR,30329504,1005,100,,Invoice,,,,,,15/10/2018,15/10/2018,0.00,,7.29,,"-1,036,612.01"
,IN,AR,30329513,1005,100,,Invoice,,,,,,15/10/2018,15/10/2018,0.00,,7.29,,"-1,036,619.30"
,IN,AR,30329582,1005,100,,Invoice,,,,,,15/10/2018,15/10/2018,0.00,,4.29,,"-1,036,623.59"
,IN,AR,30329589,1005,100,,Invoice,,,,,,15/10/2018,15/10/2018,0.00,,10.93,,"-1,036,634.52"
,IN,AR,30329637,1005,100,,Invoice,,,,,,15/10/2018,15/10/2018,0.00,,3.98,,"-1,036,638.50"
,IN,AR,30329694,1005,100,,Invoice,,,,,,15/10/2018,15/10/2018,0.00,,28.06,,"-1,036,666.56"
,IN,AR,30329733,1005,100,,Invoice,,,,,,15/10/2018,15/10/2018,0.00,,14.58,,"-1,036,681.14"
,IN,AR,30329734,1005,100,,Invoice,,,,,,15/10/2018,15/10/2018,0.00,,6.56,,"-1,036,687.70"
,IN,AR,30329741,1005,100,,Invoice,,,,,,15/10/2018,15/10/2018,0.00,,18.39,,"-1,036,706.09"
,IN,AR,30329747,1005,100,,Invoice,,,,,,15/10/2018,15/10/2018,0.00,,6.86,,"-1,036,712.95"
,IN,AR,30329777,1005,100,,Invoice,,,,,,15/10/2018,15/10/2018,0.00,,14.58,,"-1,036,727.53"
,IN,AR,30329811,1005,100,,Invoice,,,,,,15/10/2018,15/10/2018,0.00,,8.00,,"-1,036,735.53"
,IN,AR,30329830,1005,100,,Invoice,,,,,,15/10/2018,15/10/2018,0.00,,20.01,,"-1,036,755.54"
,IN,AR,30329849,1005,100,,Invoice,,,,,,15/10/2018,15/10/2018,0.00,,60.34,,"-1,036,815.88"
,IN,AR,30329858,1005,100,,Invoice,,,,,,15/10/2018,15/10/2018,0.00,,11.66,,"-1,036,827.54"
,IN,AR,30329876,1005,100,,Invoice,,,,,,15/10/2018,15/10/2018,0.00,,4.20,,"-1,036,831.74"
,IN,AR,30329906,1005,100,,Invoice,,,,,,15/10/2018,15/10/2018,0.00,,38.65,,"-1,036,870.39"
,IN,AR,30329910,1005,100,,Invoice,,,,,,15/10/2018,15/10/2018,0.00,,144.49,,"-1,037,014.88"
,IN,AR,30329924,1005,100,,Invoice,,,,,,15/10/2018,15/10/2018,0.00,,22.44,,"-1,037,037.32"
,IN,AR,30329957,1005,100,,Invoice,,,,,,15/10/2018,15/10/2018,0.00,,"1,518.73",,"-1,038,556.05"
,IN,AR,30329985,1005,100,,Invoice,,,,,,15/10/2018,15/10/2018,0.00,,26.69,,"-1,038,582.74"
,IN,AR,30330002,1005,100,,Invoice,,,,,,15/10/2018,15/10/2018,0.00,,20.71,,"-1,038,603.45"
,IN,AR,30330081,1005,100,,Invoice,,,,,,15/10/2018,15/10/2018,0.00,,52.88,,"-1,038,656.33"
,IN,AR,30330106,1005,100,,Invoice,,,,,,15/10/2018,15/10/2018,0.00,,3.76,,"-1,038,660.09"
,IN,AR,30330107,1005,100,,Invoice,,,,,,15/10/2018,15/10/2018,0.00,,5.64,,"-1,038,665.73"
,IN,AR,30330163,1005,100,,Invoice,,,,,,15/10/2018,15/10/2018,0.00,,2.74,,"-1,038,668.47"
,IN,AR,30330206,1005,100,,Invoice,,,,,,15/10/2018,15/10/2018,0.00,,18.33,,"-1,038,686.80"
,IN,AR,30330209,1005,100,,Invoice,,,,,,15/10/2018,15/10/2018,0.00,,5.26,,"-1,038,692.06"
,IN,AR,30330224,1005,100,,Invoice,,,,,,15/10/2018,15/10/2018,0.00,,4.08,,"-1,038,696.14"
,IN,AR,30330239,1005,100,,Invoice,,,,,,15/10/2018,15/10/2018,0.00,,"4,197.89",,"-1,042,894.03"
,IN,AR,30330257,1005,100,,Invoice,,,,,,15/10/2018,15/10/2018,0.00,,52.63,,"-1,042,946.66"
,IN,AR,30330302,1005,100,,Invoice,,,,,,15/10/2018,15/10/2018,0.00,,8.31,,"-1,042,954.97"
,IN,AR,30330303,1005,100,,Invoice,,,,,,15/10/2018,15/10/2018,0.00,,6.23,,"-1,042,961.20"
,IN,AR,30330304,1005,100,,Invoice,,,,,,15/10/2018,15/10/2018,0.00,,2.08,,"-1,042,963.28"
,IN,AR,30330305,1005,100,,Invoice,,,,,,15/10/2018,15/10/2018,0.00,,6.23,,"-1,042,969.51"
,IN,AR,30330306,1005,100,,Invoice,,,,,,15/10/2018,15/10/2018,0.00,,10.38,,"-1,042,979.89"
,IN,AR,30330375,1005,100,,Invoice,,,,,,15/10/2018,15/10/2018,0.00,,7.29,,"-1,042,987.18"
,IN,AR,30330395,1005,100,,Invoice,,,,,,15/10/2018,15/10/2018,0.00,,1.75,,"-1,042,988.93"
,IN,AR,30330411,1005,100,,Invoice,,,,,,15/10/2018,15/10/2018,0.00,,8.41,,"-1,042,997.34"
,IN,AR,30330447,1005,100,,Invoice,,,,,,15/10/2018,15/10/2018,0.00,,117.52,,"-1,043,114.86"
,IN,AR,30330519,1005,100,,Invoice,,,,,,15/10/2018,15/10/2018,0.00,,14.58,,"-1,043,129.44"
,CS,AR,32010630,1005,100,,Cash sale,,,,,,15/10/2018,15/10/2018,0.00,,182.20,,"-1,043,311.64"
,CS,AR,32010631,1005,100,,Cash sale,,,,,,15/10/2018,15/10/2018,0.00,,54.66,,"-1,043,366.30"
,IN,AR,30330577,1005,100,,Invoice,,,,,,15/10/2018,15/10/2018,0.00,,91.10,,"-1,043,457.40"
,IN,AR,30330591,1005,100,,Invoice,,,,,,15/10/2018,15/10/2018,0.00,,419.07,,"-1,043,876.47"
,IN,AR,30330610,1005,100,,Invoice,,,,,,15/10/2018,15/10/2018,0.00,,54.66,,"-1,043,931.13"
,IN,AR,30330701,1005,100,,Invoice,,,,,,15/10/2018,15/10/2018,0.00,,455.51,,"-1,044,386.64"
,IN,AR,30330703,1005,100,,Invoice,,,,,,15/10/2018,15/10/2018,0.00,,54.66,,"-1,044,441.30"
,IN,AR,30330709,1005,100,,Invoice,,,,,,15/10/2018,15/10/2018,0.00,,182.20,,"-1,044,623.50"
,CN,AR,31019194,1005,100,,Credit Note,,,,,,16/10/2018,16/10/2018,7.00,,0.00,,"-1,044,616.50"
,CN,AR,31019379,1005,100,,Credit Note,,,,,,16/10/2018,16/10/2018,36.44,,0.00,,"-1,044,580.06"
,CS,AR,32009742,1005,100,,Cash sale,,,,,,16/10/2018,16/10/2018,0.00,,3.64,,"-1,044,583.70"
,CS,AR,32009753,1005,100,,Cash sale,,,,,,16/10/2018,16/10/2018,0.00,,3.64,,"-1,044,587.34"
,CS,AR,32009765,1005,100,,Cash sale,,,,,,16/10/2018,16/10/2018,0.00,,3.64,,"-1,044,590.98"
,CS,AR,32009768,1005,100,,Cash sale,,,,,,16/10/2018,16/10/2018,0.00,,18.22,,"-1,044,609.20"
,CS,AR,32009784,1005,100,,Cash sale,,,,,,16/10/2018,16/10/2018,0.00,,7.29,,"-1,044,616.49"
,CS,AR,32009808,1005,100,,Cash sale,,,,,,16/10/2018,16/10/2018,0.00,,3.01,,"-1,044,619.50"
,CS,AR,32009814,1005,100,,Cash sale,,,,,,16/10/2018,16/10/2018,0.00,,21.86,,"-1,044,641.36"
,CS,AR,32009838,1005,100,,Cash sale,,,,,,16/10/2018,16/10/2018,0.00,,10.93,,"-1,044,652.29"
,CS,AR,32009873,1005,100,,Cash sale,,,,,,16/10/2018,16/10/2018,0.00,,14.58,,"-1,044,666.87"
,CS,AR,32009878,1005,100,,Cash sale,,,,,,16/10/2018,16/10/2018,0.00,,7.29,,"-1,044,674.16"
,CS,AR,32009913,1005,100,,Cash sale,,,,,,16/10/2018,16/10/2018,0.00,,10.93,,"-1,044,685.09"
,CS,AR,32009915,1005,100,,Cash sale,,,,,,16/10/2018,16/10/2018,0.00,,18.22,,"-1,044,703.31"
,CS,AR,32009921,1005,100,,Cash sale,,,,,,16/10/2018,16/10/2018,0.00,,2.16,,"-1,044,705.47"
,CS,AR,32009953,1005,100,,Cash sale,,,,,,16/10/2018,16/10/2018,0.00,,5.68,,"-1,044,711.15"
,CS,AR,32010000,1005,100,,Cash sale,,,,,,16/10/2018,16/10/2018,0.00,,8.58,,"-1,044,719.73"
,CS,AR,32010006,1005,100,,Cash sale,,,,,,16/10/2018,16/10/2018,0.00,,3.64,,"-1,044,723.37"
,CS,AR,32010038,1005,100,,Cash sale,,,,,,16/10/2018,16/10/2018,0.00,,1.95,,"-1,044,725.32"
,CS,AR,32010051,1005,100,,Cash sale,,,,,,16/10/2018,16/10/2018,0.00,,19.45,,"-1,044,744.77"
,CS,AR,32010060,1005,100,,Cash sale,,,,,,16/10/2018,16/10/2018,0.00,,5.85,,"-1,044,750.62"
,CS,AR,32010067,1005,100,,Cash sale,,,,,,16/10/2018,16/10/2018,0.00,,10.93,,"-1,044,761.55"
,CS,AR,32010078,1005,100,,Cash sale,,,,,,16/10/2018,16/10/2018,0.00,,7.29,,"-1,044,768.84"
,CS,AR,32010092,1005,100,,Cash sale,,,,,,16/10/2018,16/10/2018,0.00,,12.92,,"-1,044,781.76"
,CS,AR,32010108,1005,100,,Cash sale,,,,,,16/10/2018,16/10/2018,0.00,,10.34,,"-1,044,792.10"
,CS,AR,32010110,1005,100,,Cash sale,,,,,,16/10/2018,16/10/2018,0.00,,18.05,,"-1,044,810.15"
,CS,AR,32010113,1005,100,,Cash sale,,,,,,16/10/2018,16/10/2018,0.00,,14.58,,"-1,044,824.73"
,CS,AR,32010124,1005,100,,Cash sale,,,,,,16/10/2018,16/10/2018,0.00,,3.64,,"-1,044,828.37"
,CS,AR,32010137,1005,100,,Cash sale,,,,,,16/10/2018,16/10/2018,0.00,,7.29,,"-1,044,835.66"
,CS,AR,32010156,1005,100,,Cash sale,,,,,,16/10/2018,16/10/2018,0.00,,3.64,,"-1,044,839.30"
,CS,AR,32010168,1005,100,,Cash sale,,,,,,16/10/2018,16/10/2018,0.00,,7.29,,"-1,044,846.59"
,CS,AR,32010185,1005,100,,Cash sale,,,,,,16/10/2018,16/10/2018,0.00,,3.64,,"-1,044,850.23"
,CS,AR,32010213,1005,100,,Cash sale,,,,,,16/10/2018,16/10/2018,0.00,,3.76,,"-1,044,853.99"
,CS,AR,32010214,1005,100,,Cash sale,,,,,,16/10/2018,16/10/2018,0.00,,10.93,,"-1,044,864.92"
,CS,AR,32010224,1005,100,,Cash sale,,,,,,16/10/2018,16/10/2018,0.00,,5.18,,"-1,044,870.10"
,CS,AR,32010234,1005,100,,Cash sale,,,,,,16/10/2018,16/10/2018,0.00,,7.29,,"-1,044,877.39"
,CS,AR,32010271,1005,100,,Cash sale,,,,,,16/10/2018,16/10/2018,0.00,,17.80,,"-1,044,895.19"
,CS,AR,32010275,1005,100,,Cash sale,,,,,,16/10/2018,16/10/2018,0.00,,34.00,,"-1,044,929.19"
,CS,AR,32010286,1005,100,,Cash sale,,,,,,16/10/2018,16/10/2018,0.00,,3.64,,"-1,044,932.83"
,CS,AR,32010342,1005,100,,Cash sale,,,,,,16/10/2018,16/10/2018,0.00,,20.76,,"-1,044,953.59"
,CS,AR,32010362,1005,100,,Cash sale,,,,,,16/10/2018,16/10/2018,0.00,,8.25,,"-1,044,961.84"
,CS,AR,32010369,1005,100,,Cash sale,,,,,,16/10/2018,16/10/2018,0.00,,18.22,,"-1,044,980.06"
,CS,AR,32010386,1005,100,,Cash sale,,,,,,16/10/2018,16/10/2018,0.00,,18.22,,"-1,044,998.28"
,CS,AR,32010417,1005,100,,Cash sale,,,,,,16/10/2018,16/10/2018,0.00,,7.29,,"-1,045,005.57"
,CS,AR,32010435,1005,100,,Cash sale,,,,,,16/10/2018,16/10/2018,0.00,,3.64,,"-1,045,009.21"
,CS,AR,32010444,1005,100,,Cash sale,,,,,,16/10/2018,16/10/2018,0.00,,10.93,,"-1,045,020.14"
,CS,AR,32010453,1005,100,,Cash sale,,,,,,16/10/2018,16/10/2018,0.00,,5.47,,"-1,045,025.61"
,CS,AR,32010456,1005,100,,Cash sale,,,,,,16/10/2018,16/10/2018,0.00,,7.29,,"-1,045,032.90"
,CS,AR,32010461,1005,100,,Cash sale,,,,,,16/10/2018,16/10/2018,0.00,,14.58,,"-1,045,047.48"
,CS,AR,32010462,1005,100,,Cash sale,,,,,,16/10/2018,16/10/2018,0.00,,7.29,,"-1,045,054.77"
,CS,AR,32010485,1005,100,,Cash sale,,,,,,16/10/2018,16/10/2018,0.00,,7.75,,"-1,045,062.52"
,CS,AR,32010556,1005,100,,Cash sale,,,,,,16/10/2018,16/10/2018,0.00,,7.29,,"-1,045,069.81"
,CS,AR,32010572,1005,100,,Cash sale,,,,,,16/10/2018,16/10/2018,0.00,,3.64,,"-1,045,073.45"
,CS,AR,32010588,1005,100,,Cash sale,,,,,,16/10/2018,16/10/2018,0.00,,29.15,,"-1,045,102.60"
,CS,AR,32010591,1005,100,,Cash sale,,,,,,16/10/2018,16/10/2018,0.00,,5.93,,"-1,045,108.53"
,CS,AR,32010605,1005,100,,Cash sale,,,,,,16/10/2018,16/10/2018,0.00,,6.07,,"-1,045,114.60"
,CS,AR,32010608,1005,100,,Cash sale,,,,,,16/10/2018,16/10/2018,0.00,,12.17,,"-1,045,126.77"
,IN,AR,30328367,1005,100,,Invoice,,,,,,16/10/2018,16/10/2018,0.00,,27.47,,"-1,045,154.24"
,IN,AR,30328444,1005,100,,Invoice,,,,,,16/10/2018,16/10/2018,0.00,,3.64,,"-1,045,157.88"
,IN,AR,30328449,1005,100,,Invoice,,,,,,16/10/2018,16/10/2018,0.00,,14.00,,"-1,045,171.88"
,IN,AR,30328459,1005,100,,Invoice,,,,,,16/10/2018,16/10/2018,0.00,,3.64,,"-1,045,175.52"
,IN,AR,30328483,1005,100,,Invoice,,,,,,16/10/2018,16/10/2018,0.00,,3.98,,"-1,045,179.50"
,IN,AR,30328499,1005,100,,Invoice,,,,,,16/10/2018,16/10/2018,0.00,,47.46,,"-1,045,226.96"
,IN,AR,30328513,1005,100,,Invoice,,,,,,16/10/2018,16/10/2018,0.00,,14.58,,"-1,045,241.54"
,IN,AR,30328516,1005,100,,Invoice,,,,,,16/10/2018,16/10/2018,0.00,,24.79,,"-1,045,266.33"
,IN,AR,30328540,1005,100,,Invoice,,,,,,16/10/2018,16/10/2018,0.00,,14.58,,"-1,045,280.91"
,IN,AR,30328557,1005,100,,Invoice,,,,,,16/10/2018,16/10/2018,0.00,,7.29,,"-1,045,288.20"
,IN,AR,30328580,1005,100,,Invoice,,,,,,16/10/2018,16/10/2018,0.00,,3.64,,"-1,045,291.84"
,IN,AR,30328584,1005,100,,Invoice,,,,,,16/10/2018,16/10/2018,0.00,,5.51,,"-1,045,297.35"
,IN,AR,30328594,1005,100,,Invoice,,,,,,16/10/2018,16/10/2018,0.00,,11.02,,"-1,045,308.37"
,IN,AR,30328604,1005,100,,Invoice,,,,,,16/10/2018,16/10/2018,0.00,,14.58,,"-1,045,322.95"
,IN,AR,30328633,1005,100,,Invoice,,,,,,16/10/2018,16/10/2018,0.00,,18.22,,"-1,045,341.17"
,IN,AR,30328658,1005,100,,Invoice,,,,,,16/10/2018,16/10/2018,0.00,,162.70,,"-1,045,503.87"
,IN,AR,30328662,1005,100,,Invoice,,,,,,16/10/2018,16/10/2018,0.00,,12.92,,"-1,045,516.79"
,IN,AR,30328672,1005,100,,Invoice,,,,,,16/10/2018,16/10/2018,0.00,,43.02,,"-1,045,559.81"
,IN,AR,30328691,1005,100,,Invoice,,,,,,16/10/2018,16/10/2018,0.00,,13.74,,"-1,045,573.55"
,IN,AR,30328715,1005,100,,Invoice,,,,,,16/10/2018,16/10/2018,0.00,,7.29,,"-1,045,580.84"
,IN,AR,30328741,1005,100,,Invoice,,,,,,16/10/2018,16/10/2018,0.00,,10.93,,"-1,045,591.77"
,IN,AR,30328755,1005,100,,Invoice,,,,,,16/10/2018,16/10/2018,0.00,,13.73,,"-1,045,605.50"
,IN,AR,30328758,1005,100,,Invoice,,,,,,16/10/2018,16/10/2018,0.00,,4.64,,"-1,045,610.14"
,IN,AR,30328773,1005,100,,Invoice,,,,,,16/10/2018,16/10/2018,0.00,,10.17,,"-1,045,620.31"
,IN,AR,30328789,1005,100,,Invoice,,,,,,16/10/2018,16/10/2018,0.00,,4.32,,"-1,045,624.63"
,IN,AR,30328792,1005,100,,Invoice,,,,,,16/10/2018,16/10/2018,0.00,,8.47,,"-1,045,633.10"
,IN,AR,30328822,1005,100,,Invoice,,,,,,16/10/2018,16/10/2018,0.00,,8.47,,"-1,045,641.57"
,IN,AR,30328878,1005,100,,Invoice,,,,,,16/10/2018,16/10/2018,0.00,,12.03,,"-1,045,653.60"
,IN,AR,30328885,1005,100,,Invoice,,,,,,16/10/2018,16/10/2018,0.00,,19.12,,"-1,045,672.72"
,IN,AR,30328928,1005,100,,Invoice,,,,,,16/10/2018,16/10/2018,0.00,,9.43,,"-1,045,682.15"
,IN,AR,30328936,1005,100,,Invoice,,,,,,16/10/2018,16/10/2018,0.00,,4.78,,"-1,045,686.93"
,IN,AR,30329032,1005,100,,Invoice,,,,,,16/10/2018,16/10/2018,0.00,,3.90,,"-1,045,690.83"
,IN,AR,30329126,1005,100,,Invoice,,,,,,16/10/2018,16/10/2018,0.00,,23.31,,"-1,045,714.14"
,IN,AR,30329129,1005,100,,Invoice,,,,,,16/10/2018,16/10/2018,0.00,,14.58,,"-1,045,728.72"
,IN,AR,30329148,1005,100,,Invoice,,,,,,16/10/2018,16/10/2018,0.00,,17.80,,"-1,045,746.52"
,IN,AR,30329166,1005,100,,Invoice,,,,,,16/10/2018,16/10/2018,0.00,,3.01,,"-1,045,749.53"
,IN,AR,30329180,1005,100,,Invoice,,,,,,16/10/2018,16/10/2018,0.00,,11.57,,"-1,045,761.10"
,IN,AR,30329184,1005,100,,Invoice,,,,,,16/10/2018,16/10/2018,0.00,,2.39,,"-1,045,763.49"
,IN,AR,30329191,1005,100,,Invoice,,,,,,16/10/2018,16/10/2018,0.00,,15.25,,"-1,045,778.74"
,IN,AR,30329200,1005,100,,Invoice,,,,,,16/10/2018,16/10/2018,0.00,,10.53,,"-1,045,789.27"
,IN,AR,30329207,1005,100,,Invoice,,,,,,16/10/2018,16/10/2018,0.00,,10.93,,"-1,045,800.20"
,IN,AR,30329235,1005,100,,Invoice,,,,,,16/10/2018,16/10/2018,0.00,,4.24,,"-1,045,804.44"
,IN,AR,30329240,1005,100,,Invoice,,,,,,16/10/2018,16/10/2018,0.00,,29.15,,"-1,045,833.59"
,IN,AR,30329243,1005,100,,Invoice,,,,,,16/10/2018,16/10/2018,0.00,,6.36,,"-1,045,839.95"
,IN,AR,30329276,1005,100,,Invoice,,,,,,16/10/2018,16/10/2018,0.00,,28.05,,"-1,045,868.00"
,IN,AR,30329319,1005,100,,Invoice,,,,,,16/10/2018,16/10/2018,0.00,,10.93,,"-1,045,878.93"
,IN,AR,30329332,1005,100,,Invoice,,,,,,16/10/2018,16/10/2018,0.00,,6.36,,"-1,045,885.29"
,IN,AR,30329349,1005,100,,Invoice,,,,,,16/10/2018,16/10/2018,0.00,,21.86,,"-1,045,907.15"
,IN,AR,30329359,1005,100,,Invoice,,,,,,16/10/2018,16/10/2018,0.00,,21.05,,"-1,045,928.20"
,IN,AR,30329380,1005,100,,Invoice,,,,,,16/10/2018,16/10/2018,0.00,,8.26,,"-1,045,936.46"
,IN,AR,30329386,1005,100,,Invoice,,,,,,16/10/2018,16/10/2018,0.00,,5.59,,"-1,045,942.05"
,IN,AR,30329398,1005,100,,Invoice,,,,,,16/10/2018,16/10/2018,0.00,,5.86,,"-1,045,947.91"
,IN,AR,30329449,1005,100,,Invoice,,,,,,16/10/2018,16/10/2018,0.00,,14.58,,"-1,045,962.49"
,IN,AR,30329454,1005,100,,Invoice,,,,,,16/10/2018,16/10/2018,0.00,,21.44,,"-1,045,983.93"
,IN,AR,30329468,1005,100,,Invoice,,,,,,16/10/2018,16/10/2018,0.00,,8.58,,"-1,045,992.51"
,IN,AR,30329474,1005,100,,Invoice,,,,,,16/10/2018,16/10/2018,0.00,,29.15,,"-1,046,021.66"
,IN,AR,30329485,1005,100,,Invoice,,,,,,16/10/2018,16/10/2018,0.00,,7.05,,"-1,046,028.71"
,IN,AR,30329523,1005,100,,Invoice,,,,,,16/10/2018,16/10/2018,0.00,,5.17,,"-1,046,033.88"
,IN,AR,30329525,1005,100,,Invoice,,,,,,16/10/2018,16/10/2018,0.00,,78.39,,"-1,046,112.27"
,IN,AR,30329527,1005,100,,Invoice,,,,,,16/10/2018,16/10/2018,0.00,,29.15,,"-1,046,141.42"
,IN,AR,30329528,1005,100,,Invoice,,,,,,16/10/2018,16/10/2018,0.00,,30.11,,"-1,046,171.53"
,IN,AR,30329532,1005,100,,Invoice,,,,,,16/10/2018,16/10/2018,0.00,,29.15,,"-1,046,200.68"
,IN,AR,30329608,1005,100,,Invoice,,,,,,16/10/2018,16/10/2018,0.00,,14.58,,"-1,046,215.26"
,IN,AR,30329638,1005,100,,Invoice,,,,,,16/10/2018,16/10/2018,0.00,,221.06,,"-1,046,436.32"
,IN,AR,30329639,1005,100,,Invoice,,,,,,16/10/2018,16/10/2018,0.00,,15.93,,"-1,046,452.25"
,IN,AR,30329640,1005,100,,Invoice,,,,,,16/10/2018,16/10/2018,0.00,,5.97,,"-1,046,458.22"
,IN,AR,30329641,1005,100,,Invoice,,,,,,16/10/2018,16/10/2018,0.00,,23.90,,"-1,046,482.12"
,IN,AR,30329666,1005,100,,Invoice,,,,,,16/10/2018,16/10/2018,0.00,,39.75,,"-1,046,521.87"
,IN,AR,30329727,1005,100,,Invoice,,,,,,16/10/2018,16/10/2018,0.00,,51.02,,"-1,046,572.89"
,IN,AR,30329728,1005,100,,Invoice,,,,,,16/10/2018,16/10/2018,0.00,,168.36,,"-1,046,741.25"
,IN,AR,30329818,1005,100,,Invoice,,,,,,16/10/2018,16/10/2018,0.00,,14.00,,"-1,046,755.25"
,IN,AR,30329900,1005,100,,Invoice,,,,,,16/10/2018,16/10/2018,0.00,,17.49,,"-1,046,772.74"
,IN,AR,30329919,1005,100,,Invoice,,,,,,16/10/2018,16/10/2018,0.00,,16.42,,"-1,046,789.16"
,IN,AR,30329929,1005,100,,Invoice,,,,,,16/10/2018,16/10/2018,0.00,,29.15,,"-1,046,818.31"
,IN,AR,30329941,1005,100,,Invoice,,,,,,16/10/2018,16/10/2018,0.00,,19.27,,"-1,046,837.58"
,IN,AR,30329945,1005,100,,Invoice,,,,,,16/10/2018,16/10/2018,0.00,,120.00,,"-1,046,957.58"
,IN,AR,30329958,1005,100,,Invoice,,,,,,16/10/2018,16/10/2018,0.00,,28.47,,"-1,046,986.05"
,IN,AR,30329961,1005,100,,Invoice,,,,,,16/10/2018,16/10/2018,0.00,,7.29,,"-1,046,993.34"
,IN,AR,30330003,1005,100,,Invoice,,,,,,16/10/2018,16/10/2018,0.00,,12.75,,"-1,047,006.09"
,IN,AR,30330004,1005,100,,Invoice,,,,,,16/10/2018,16/10/2018,0.00,,19.12,,"-1,047,025.21"
,IN,AR,30330025,1005,100,,Invoice,,,,,,16/10/2018,16/10/2018,0.00,,108.47,,"-1,047,133.68"
,IN,AR,30330068,1005,100,,Invoice,,,,,,16/10/2018,16/10/2018,0.00,,40.34,,"-1,047,174.02"
,IN,AR,30330069,1005,100,,Invoice,,,,,,16/10/2018,16/10/2018,0.00,,99.67,,"-1,047,273.69"
,IN,AR,30330070,1005,100,,Invoice,,,,,,16/10/2018,16/10/2018,0.00,,42.71,,"-1,047,316.40"
,IN,AR,30330082,1005,100,,Invoice,,,,,,16/10/2018,16/10/2018,0.00,,12.20,,"-1,047,328.60"
,IN,AR,30330092,1005,100,,Invoice,,,,,,16/10/2018,16/10/2018,0.00,,12.00,,"-1,047,340.60"
,IN,AR,30330108,1005,100,,Invoice,,,,,,16/10/2018,16/10/2018,0.00,,3.76,,"-1,047,344.36"
,IN,AR,30330117,1005,100,,Invoice,,,,,,16/10/2018,16/10/2018,0.00,,3.51,,"-1,047,347.87"
,IN,AR,30330122,1005,100,,Invoice,,,,,,16/10/2018,16/10/2018,0.00,,14.00,,"-1,047,361.87"
,IN,AR,30330125,1005,100,,Invoice,,,,,,16/10/2018,16/10/2018,0.00,,14.58,,"-1,047,376.45"
,IN,AR,30330126,1005,100,,Invoice,,,,,,16/10/2018,16/10/2018,0.00,,8.90,,"-1,047,385.35"
,IN,AR,30330136,1005,100,,Invoice,,,,,,16/10/2018,16/10/2018,0.00,,68.58,,"-1,047,453.93"
,IN,AR,30330150,1005,100,,Invoice,,,,,,16/10/2018,16/10/2018,0.00,,7.02,,"-1,047,460.95"
,IN,AR,30330216,1005,100,,Invoice,,,,,,16/10/2018,16/10/2018,0.00,,10.47,,"-1,047,471.42"
,IN,AR,30330225,1005,100,,Invoice,,,,,,16/10/2018,16/10/2018,0.00,,28.59,,"-1,047,500.01"
,IN,AR,30330251,1005,100,,Invoice,,,,,,16/10/2018,16/10/2018,0.00,,7.97,,"-1,047,507.98"
,IN,AR,30330278,1005,100,,Invoice,,,,,,16/10/2018,16/10/2018,0.00,,10.93,,"-1,047,518.91"
,IN,AR,30330353,1005,100,,Invoice,,,,,,16/10/2018,16/10/2018,0.00,,9.66,,"-1,047,528.57"
,IN,AR,30330385,1005,100,,Invoice,,,,,,16/10/2018,16/10/2018,0.00,,20.34,,"-1,047,548.91"
,IN,AR,30330434,1005,100,,Invoice,,,,,,16/10/2018,16/10/2018,0.00,,121.36,,"-1,047,670.27"
,IN,AR,30330456,1005,100,,Invoice,,,,,,16/10/2018,16/10/2018,0.00,,18.22,,"-1,047,688.49"
,IN,AR,30330517,1005,100,,Invoice,,,,,,16/10/2018,16/10/2018,0.00,,27.46,,"-1,047,715.95"
,CS,AR,32010633,1005,100,,Cash sale,,,,,,16/10/2018,16/10/2018,0.00,,10.93,,"-1,047,726.88"
,IN,AR,30330579,1005,100,,Invoice,,,,,,16/10/2018,16/10/2018,0.00,,54.66,,"-1,047,781.54"
,CN,AR,31019233,1005,100,,Credit Note,,,,,,17/10/2018,17/10/2018,10.44,,0.00,,"-1,047,771.10"
,CN,AR,31019286,1005,100,,Credit Note,,,,,,17/10/2018,17/10/2018,8.70,,0.00,,"-1,047,762.40"
,CS,AR,32009715,1005,100,,Cash sale,,,,,,17/10/2018,17/10/2018,0.00,,5.61,,"-1,047,768.01"
,CS,AR,32009726,1005,100,,Cash sale,,,,,,17/10/2018,17/10/2018,0.00,,30.10,,"-1,047,798.11"
,CS,AR,32009773,1005,100,,Cash sale,,,,,,17/10/2018,17/10/2018,0.00,,3.64,,"-1,047,801.75"
,CS,AR,32009778,1005,100,,Cash sale,,,,,,17/10/2018,17/10/2018,0.00,,14.58,,"-1,047,816.33"
,CS,AR,32009780,1005,100,,Cash sale,,,,,,17/10/2018,17/10/2018,0.00,,7.29,,"-1,047,823.62"
,CS,AR,32009800,1005,100,,Cash sale,,,,,,17/10/2018,17/10/2018,0.00,,3.64,,"-1,047,827.26"
,CS,AR,32009820,1005,100,,Cash sale,,,,,,17/10/2018,17/10/2018,0.00,,3.64,,"-1,047,830.90"
,CS,AR,32009869,1005,100,,Cash sale,,,,,,17/10/2018,17/10/2018,0.00,,3.64,,"-1,047,834.54"
,CS,AR,32009891,1005,100,,Cash sale,,,,,,17/10/2018,17/10/2018,0.00,,3.64,,"-1,047,838.18"
,CS,AR,32009895,1005,100,,Cash sale,,,,,,17/10/2018,17/10/2018,0.00,,5.86,,"-1,047,844.04"
,CS,AR,32009909,1005,100,,Cash sale,,,,,,17/10/2018,17/10/2018,0.00,,5.17,,"-1,047,849.21"
,CS,AR,32009911,1005,100,,Cash sale,,,,,,17/10/2018,17/10/2018,0.00,,10.93,,"-1,047,860.14"
,CS,AR,32009917,1005,100,,Cash sale,,,,,,17/10/2018,17/10/2018,0.00,,3.64,,"-1,047,863.78"
,CS,AR,32009956,1005,100,,Cash sale,,,,,,17/10/2018,17/10/2018,0.00,,12.92,,"-1,047,876.70"
,CS,AR,32009976,1005,100,,Cash sale,,,,,,17/10/2018,17/10/2018,0.00,,6.43,,"-1,047,883.13"
,CS,AR,32009993,1005,100,,Cash sale,,,,,,17/10/2018,17/10/2018,0.00,,14.58,,"-1,047,897.71"
,CS,AR,32010036,1005,100,,Cash sale,,,,,,17/10/2018,17/10/2018,0.00,,4.32,,"-1,047,902.03"
,CS,AR,32010053,1005,100,,Cash sale,,,,,,17/10/2018,17/10/2018,0.00,,21.86,,"-1,047,923.89"
,CS,AR,32010135,1005,100,,Cash sale,,,,,,17/10/2018,17/10/2018,0.00,,14.58,,"-1,047,938.47"
,CS,AR,32010171,1005,100,,Cash sale,,,,,,17/10/2018,17/10/2018,0.00,,10.93,,"-1,047,949.40"
,CS,AR,32010208,1005,100,,Cash sale,,,,,,17/10/2018,17/10/2018,0.00,,9.79,,"-1,047,959.19"
,CS,AR,32010215,1005,100,,Cash sale,,,,,,17/10/2018,17/10/2018,0.00,,5.17,,"-1,047,964.36"
,CS,AR,32010227,1005,100,,Cash sale,,,,,,17/10/2018,17/10/2018,0.00,,21.36,,"-1,047,985.72"
,CS,AR,32010265,1005,100,,Cash sale,,,,,,17/10/2018,17/10/2018,0.00,,3.64,,"-1,047,989.36"
,CS,AR,32010269,1005,100,,Cash sale,,,,,,17/10/2018,17/10/2018,0.00,,9.15,,"-1,047,998.51"
,CS,AR,32010283,1005,100,,Cash sale,,,,,,17/10/2018,17/10/2018,0.00,,3.64,,"-1,048,002.15"
,CS,AR,32010303,1005,100,,Cash sale,,,,,,17/10/2018,17/10/2018,0.00,,13.12,,"-1,048,015.27"
,CS,AR,32010324,1005,100,,Cash sale,,,,,,17/10/2018,17/10/2018,0.00,,9.15,,"-1,048,024.42"
,CS,AR,32010346,1005,100,,Cash sale,,,,,,17/10/2018,17/10/2018,0.00,,10.93,,"-1,048,035.35"
,CS,AR,32010366,1005,100,,Cash sale,,,,,,17/10/2018,17/10/2018,0.00,,18.22,,"-1,048,053.57"
,CS,AR,32010372,1005,100,,Cash sale,,,,,,17/10/2018,17/10/2018,0.00,,9.03,,"-1,048,062.60"
,CS,AR,32010375,1005,100,,Cash sale,,,,,,17/10/2018,17/10/2018,0.00,,10.93,,"-1,048,073.53"
,CS,AR,32010398,1005,100,,Cash sale,,,,,,17/10/2018,17/10/2018,0.00,,14.58,,"-1,048,088.11"
,CS,AR,32010411,1005,100,,Cash sale,,,,,,17/10/2018,17/10/2018,0.00,,5.08,,"-1,048,093.19"
,CS,AR,32010437,1005,100,,Cash sale,,,,,,17/10/2018,17/10/2018,0.00,,25.51,,"-1,048,118.70"
,CS,AR,32010459,1005,100,,Cash sale,,,,,,17/10/2018,17/10/2018,0.00,,3.64,,"-1,048,122.34"
,CS,AR,32010474,1005,100,,Cash sale,,,,,,17/10/2018,17/10/2018,0.00,,10.99,,"-1,048,133.33"
,CS,AR,32010479,1005,100,,Cash sale,,,,,,17/10/2018,17/10/2018,0.00,,3.64,,"-1,048,136.97"
,CS,AR,32010501,1005,100,,Cash sale,,,,,,17/10/2018,17/10/2018,0.00,,10.93,,"-1,048,147.90"
,CS,AR,32010567,1005,100,,Cash sale,,,,,,17/10/2018,17/10/2018,0.00,,10.93,,"-1,048,158.83"
,CS,AR,32010574,1005,100,,Cash sale,,,,,,17/10/2018,17/10/2018,0.00,,7.29,,"-1,048,166.12"
,CS,AR,32010582,1005,100,,Cash sale,,,,,,17/10/2018,17/10/2018,0.00,,14.58,,"-1,048,180.70"
,CS,AR,32010593,1005,100,,Cash sale,,,,,,17/10/2018,17/10/2018,0.00,,3.64,,"-1,048,184.34"
,IN,AR,30328318,1005,100,,Invoice,,,,,,17/10/2018,17/10/2018,0.00,,23.73,,"-1,048,208.07"
,IN,AR,30328334,1005,100,,Invoice,,,,,,17/10/2018,17/10/2018,0.00,,10.93,,"-1,048,219.00"
,IN,AR,30328358,1005,100,,Invoice,,,,,,17/10/2018,17/10/2018,0.00,,75.66,,"-1,048,294.66"
,IN,AR,30328359,1005,100,,Invoice,,,,,,17/10/2018,17/10/2018,0.00,,24.41,,"-1,048,319.07"
,IN,AR,30328399,1005,100,,Invoice,,,,,,17/10/2018,17/10/2018,0.00,,13.56,,"-1,048,332.63"
,IN,AR,30328421,1005,100,,Invoice,,,,,,17/10/2018,17/10/2018,0.00,,39.41,,"-1,048,372.04"
,IN,AR,30328422,1005,100,,Invoice,,,,,,17/10/2018,17/10/2018,0.00,,102.46,,"-1,048,474.50"
,IN,AR,30328429,1005,100,,Invoice,,,,,,17/10/2018,17/10/2018,0.00,,25.51,,"-1,048,500.01"
,IN,AR,30328484,1005,100,,Invoice,,,,,,17/10/2018,17/10/2018,0.00,,5.97,,"-1,048,505.98"
,IN,AR,30328500,1005,100,,Invoice,,,,,,17/10/2018,17/10/2018,0.00,,83.05,,"-1,048,589.03"
,IN,AR,30328534,1005,100,,Invoice,,,,,,17/10/2018,17/10/2018,0.00,,7.29,,"-1,048,596.32"
,IN,AR,30328550,1005,100,,Invoice,,,,,,17/10/2018,17/10/2018,0.00,,10.93,,"-1,048,607.25"
,IN,AR,30328567,1005,100,,Invoice,,,,,,17/10/2018,17/10/2018,0.00,,30.00,,"-1,048,637.25"
,IN,AR,30328606,1005,100,,Invoice,,,,,,17/10/2018,17/10/2018,0.00,,38.00,,"-1,048,675.25"
,IN,AR,30328611,1005,100,,Invoice,,,,,,17/10/2018,17/10/2018,0.00,,2.92,,"-1,048,678.17"
,IN,AR,30328630,1005,100,,Invoice,,,,,,17/10/2018,17/10/2018,0.00,,3.64,,"-1,048,681.81"
,IN,AR,30328646,1005,100,,Invoice,,,,,,17/10/2018,17/10/2018,0.00,,114.61,,"-1,048,796.42"
,IN,AR,30328647,1005,100,,Invoice,,,,,,17/10/2018,17/10/2018,0.00,,24.56,,"-1,048,820.98"
,IN,AR,30328659,1005,100,,Invoice,,,,,,17/10/2018,17/10/2018,0.00,,667.07,,"-1,049,488.05"
,IN,AR,30328698,1005,100,,Invoice,,,,,,17/10/2018,17/10/2018,0.00,,6.02,,"-1,049,494.07"
,IN,AR,30328781,1005,100,,Invoice,,,,,,17/10/2018,17/10/2018,0.00,,35.59,,"-1,049,529.66"
,IN,AR,30328797,1005,100,,Invoice,,,,,,17/10/2018,17/10/2018,0.00,,4.24,,"-1,049,533.90"
,IN,AR,30328819,1005,100,,Invoice,,,,,,17/10/2018,17/10/2018,0.00,,2.12,,"-1,049,536.02"
,IN,AR,30328828,1005,100,,Invoice,,,,,,17/10/2018,17/10/2018,0.00,,5.59,,"-1,049,541.61"
,IN,AR,30328862,1005,100,,Invoice,,,,,,17/10/2018,17/10/2018,0.00,,35.85,,"-1,049,577.46"
,IN,AR,30328867,1005,100,,Invoice,,,,,,17/10/2018,17/10/2018,0.00,,14.58,,"-1,049,592.04"
,IN,AR,30328902,1005,100,,Invoice,,,,,,17/10/2018,17/10/2018,0.00,,69.73,,"-1,049,661.77"
,IN,AR,30328911,1005,100,,Invoice,,,,,,17/10/2018,17/10/2018,0.00,,3.64,,"-1,049,665.41"
,IN,AR,30328965,1005,100,,Invoice,,,,,,17/10/2018,17/10/2018,0.00,,10.93,,"-1,049,676.34"
,IN,AR,30328998,1005,100,,Invoice,,,,,,17/10/2018,17/10/2018,0.00,,108.03,,"-1,049,784.37"
,IN,AR,30329038,1005,100,,Invoice,,,,,,17/10/2018,17/10/2018,0.00,,5.08,,"-1,049,789.45"
,IN,AR,30329039,1005,100,,Invoice,,,,,,17/10/2018,17/10/2018,0.00,,7.63,,"-1,049,797.08"
,IN,AR,30329058,1005,100,,Invoice,,,,,,17/10/2018,17/10/2018,0.00,,1.59,,"-1,049,798.67"
,IN,AR,30329060,1005,100,,Invoice,,,,,,17/10/2018,17/10/2018,0.00,,11.03,,"-1,049,809.70"
,IN,AR,30329073,1005,100,,Invoice,,,,,,17/10/2018,17/10/2018,0.00,,25.42,,"-1,049,835.12"
,IN,AR,30329080,1005,100,,Invoice,,,,,,17/10/2018,17/10/2018,0.00,,18.22,,"-1,049,853.34"
,IN,AR,30329144,1005,100,,Invoice,,,,,,17/10/2018,17/10/2018,0.00,,11.36,,"-1,049,864.70"
,IN,AR,30329153,1005,100,,Invoice,,,,,,17/10/2018,17/10/2018,0.00,,10.00,,"-1,049,874.70"
,IN,AR,30329188,1005,100,,Invoice,,,,,,17/10/2018,17/10/2018,0.00,,3.64,,"-1,049,878.34"
,IN,AR,30329192,1005,100,,Invoice,,,,,,17/10/2018,17/10/2018,0.00,,2.54,,"-1,049,880.88"
,IN,AR,30329230,1005,100,,Invoice,,,,,,17/10/2018,17/10/2018,0.00,,10.93,,"-1,049,891.81"
,IN,AR,30329289,1005,100,,Invoice,,,,,,17/10/2018,17/10/2018,0.00,,72.88,,"-1,049,964.69"
,IN,AR,30329316,1005,100,,Invoice,,,,,,17/10/2018,17/10/2018,0.00,,10.93,,"-1,049,975.62"
,IN,AR,30329328,1005,100,,Invoice,,,,,,17/10/2018,17/10/2018,0.00,,18.22,,"-1,049,993.84"
,IN,AR,30329335,1005,100,,Invoice,,,,,,17/10/2018,17/10/2018,0.00,,30.76,,"-1,050,024.60"
,IN,AR,30329344,1005,100,,Invoice,,,,,,17/10/2018,17/10/2018,0.00,,12.71,,"-1,050,037.31"
,IN,AR,30329366,1005,100,,Invoice,,,,,,17/10/2018,17/10/2018,0.00,,10.85,,"-1,050,048.16"
,IN,AR,30329413,1005,100,,Invoice,,,,,,17/10/2018,17/10/2018,0.00,,14.83,,"-1,050,062.99"
,IN,AR,30329423,1005,100,,Invoice,,,,,,17/10/2018,17/10/2018,0.00,,27.08,,"-1,050,090.07"
,IN,AR,30329486,1005,100,,Invoice,,,,,,17/10/2018,17/10/2018,0.00,,15.86,,"-1,050,105.93"
,IN,AR,30329487,1005,100,,Invoice,,,,,,17/10/2018,17/10/2018,0.00,,5.29,,"-1,050,111.22"
,IN,AR,30329498,1005,100,,Invoice,,,,,,17/10/2018,17/10/2018,0.00,,18.05,,"-1,050,129.27"
,IN,AR,30329536,1005,100,,Invoice,,,,,,17/10/2018,17/10/2018,0.00,,10.34,,"-1,050,139.61"
,IN,AR,30329552,1005,100,,Invoice,,,,,,17/10/2018,17/10/2018,0.00,,20.01,,"-1,050,159.62"
,IN,AR,30329558,1005,100,,Invoice,,,,,,17/10/2018,17/10/2018,0.00,,36.44,,"-1,050,196.06"
,IN,AR,30329559,1005,100,,Invoice,,,,,,17/10/2018,17/10/2018,0.00,,25.51,,"-1,050,221.57"
,IN,AR,30329572,1005,100,,Invoice,,,,,,17/10/2018,17/10/2018,0.00,,495.63,,"-1,050,717.20"
,IN,AR,30329612,1005,100,,Invoice,,,,,,17/10/2018,17/10/2018,0.00,,12.71,,"-1,050,729.91"
,IN,AR,30329660,1005,100,,Invoice,,,,,,17/10/2018,17/10/2018,0.00,,6.02,,"-1,050,735.93"
,IN,AR,30329673,1005,100,,Invoice,,,,,,17/10/2018,17/10/2018,0.00,,14.00,,"-1,050,749.93"
,IN,AR,30329688,1005,100,,Invoice,,,,,,17/10/2018,17/10/2018,0.00,,40.08,,"-1,050,790.01"
,IN,AR,30329695,1005,100,,Invoice,,,,,,17/10/2018,17/10/2018,0.00,,26.06,,"-1,050,816.07"
,IN,AR,30329705,1005,100,,Invoice,,,,,,17/10/2018,17/10/2018,0.00,,10.93,,"-1,050,827.00"
,IN,AR,30329758,1005,100,,Invoice,,,,,,17/10/2018,17/10/2018,0.00,,10.19,,"-1,050,837.19"
,IN,AR,30329795,1005,100,,Invoice,,,,,,17/10/2018,17/10/2018,0.00,,7.63,,"-1,050,844.82"
,IN,AR,30329796,1005,100,,Invoice,,,,,,17/10/2018,17/10/2018,0.00,,7.63,,"-1,050,852.45"
,IN,AR,30329850,1005,100,,Invoice,,,,,,17/10/2018,17/10/2018,0.00,,6.03,,"-1,050,858.48"
,IN,AR,30329859,1005,100,,Invoice,,,,,,17/10/2018,17/10/2018,0.00,,2.92,,"-1,050,861.40"
,IN,AR,30329877,1005,100,,Invoice,,,,,,17/10/2018,17/10/2018,0.00,,35.75,,"-1,050,897.15"
,IN,AR,30329878,1005,100,,Invoice,,,,,,17/10/2018,17/10/2018,0.00,,4.20,,"-1,050,901.35"
,IN,AR,30329894,1005,100,,Invoice,,,,,,17/10/2018,17/10/2018,0.00,,4.66,,"-1,050,906.01"
,IN,AR,30329938,1005,100,,Invoice,,,,,,17/10/2018,17/10/2018,0.00,,19.58,,"-1,050,925.59"
,IN,AR,30329968,1005,100,,Invoice,,,,,,17/10/2018,17/10/2018,0.00,,7.29,,"-1,050,932.88"
,IN,AR,30329983,1005,100,,Invoice,,,,,,17/10/2018,17/10/2018,0.00,,20.41,,"-1,050,953.29"
,IN,AR,30329993,1005,100,,Invoice,,,,,,17/10/2018,17/10/2018,0.00,,25.51,,"-1,050,978.80"
,IN,AR,30330005,1005,100,,Invoice,,,,,,17/10/2018,17/10/2018,0.00,,12.75,,"-1,050,991.55"
,IN,AR,30330113,1005,100,,Invoice,,,,,,17/10/2018,17/10/2018,0.00,,5.26,,"-1,050,996.81"
,IN,AR,30330181,1005,100,,Invoice,,,,,,17/10/2018,17/10/2018,0.00,,11.29,,"-1,051,008.10"
,IN,AR,30330219,1005,100,,Invoice,,,,,,17/10/2018,17/10/2018,0.00,,16.78,,"-1,051,024.88"
,IN,AR,30330240,1005,100,,Invoice,,,,,,17/10/2018,17/10/2018,0.00,,10.93,,"-1,051,035.81"
,IN,AR,30330265,1005,100,,Invoice,,,,,,17/10/2018,17/10/2018,0.00,,20.59,,"-1,051,056.40"
,IN,AR,30330279,1005,100,,Invoice,,,,,,17/10/2018,17/10/2018,0.00,,7.29,,"-1,051,063.69"
,IN,AR,30330307,1005,100,,Invoice,,,,,,17/10/2018,17/10/2018,0.00,,56.06,,"-1,051,119.75"
,IN,AR,30330308,1005,100,,Invoice,,,,,,17/10/2018,17/10/2018,0.00,,10.38,,"-1,051,130.13"
,IN,AR,30330309,1005,100,,Invoice,,,,,,17/10/2018,17/10/2018,0.00,,12.46,,"-1,051,142.59"
,IN,AR,30330310,1005,100,,Invoice,,,,,,17/10/2018,17/10/2018,0.00,,24.92,,"-1,051,167.51"
,IN,AR,30330362,1005,100,,Invoice,,,,,,17/10/2018,17/10/2018,0.00,,30.34,,"-1,051,197.85"
,IN,AR,30330389,1005,100,,Invoice,,,,,,17/10/2018,17/10/2018,0.00,,32.80,,"-1,051,230.65"
,IN,AR,30330472,1005,100,,Invoice,,,,,,17/10/2018,17/10/2018,0.00,,29.15,,"-1,051,259.80"
,IN,AR,30330490,1005,100,,Invoice,,,,,,17/10/2018,17/10/2018,0.00,,7.19,,"-1,051,266.99"
,IN,AR,30330507,1005,100,,Invoice,,,,,,17/10/2018,17/10/2018,0.00,,7.29,,"-1,051,274.28"
,IN,AR,30330518,1005,100,,Invoice,,,,,,17/10/2018,17/10/2018,0.00,,29.15,,"-1,051,303.43"
,CS,AR,32010634,1005,100,,Cash sale,,,,,,17/10/2018,17/10/2018,0.00,,182.20,,"-1,051,485.63"
,IN,AR,30330690,1005,100,,Invoice,,,,,,17/10/2018,17/10/2018,0.00,,182.20,,"-1,051,667.83"
,IN,AR,30330711,1005,100,,Invoice,,,,,,17/10/2018,17/10/2018,0.00,,54.66,,"-1,051,722.49"
,CN,AR,31019344,1005,100,,Credit Note,,,,,,18/10/2018,18/10/2018,3.64,,0.00,,"-1,051,718.85"
,CS,AR,32009720,1005,100,,Cash sale,,,,,,18/10/2018,18/10/2018,0.00,,23.73,,"-1,051,742.58"
,CS,AR,32009745,1005,100,,Cash sale,,,,,,18/10/2018,18/10/2018,0.00,,10.93,,"-1,051,753.51"
,CS,AR,32009899,1005,100,,Cash sale,,,,,,18/10/2018,18/10/2018,0.00,,7.29,,"-1,051,760.80"
,CS,AR,32009948,1005,100,,Cash sale,,,,,,18/10/2018,18/10/2018,0.00,,27.97,,"-1,051,788.77"
,CS,AR,32010160,1005,100,,Cash sale,,,,,,18/10/2018,18/10/2018,0.00,,6.44,,"-1,051,795.21"
,CS,AR,32010222,1005,100,,Cash sale,,,,,,18/10/2018,18/10/2018,0.00,,7.29,,"-1,051,802.50"
,CS,AR,32010253,1005,100,,Cash sale,,,,,,18/10/2018,18/10/2018,0.00,,6.53,,"-1,051,809.03"
,CS,AR,32010296,1005,100,,Cash sale,,,,,,18/10/2018,18/10/2018,0.00,,5.93,,"-1,051,814.96"
,CS,AR,32010367,1005,100,,Cash sale,,,,,,18/10/2018,18/10/2018,0.00,,11.86,,"-1,051,826.82"
,CS,AR,32010370,1005,100,,Cash sale,,,,,,18/10/2018,18/10/2018,0.00,,60.71,,"-1,051,887.53"
,CS,AR,32010448,1005,100,,Cash sale,,,,,,18/10/2018,18/10/2018,0.00,,7.29,,"-1,051,894.82"
,CS,AR,32010455,1005,100,,Cash sale,,,,,,18/10/2018,18/10/2018,0.00,,14.58,,"-1,051,909.40"
,CS,AR,32010472,1005,100,,Cash sale,,,,,,18/10/2018,18/10/2018,0.00,,9.84,,"-1,051,919.24"
,CS,AR,32010491,1005,100,,Cash sale,,,,,,18/10/2018,18/10/2018,0.00,,14.58,,"-1,051,933.82"
,CS,AR,32010557,1005,100,,Cash sale,,,,,,18/10/2018,18/10/2018,0.00,,3.64,,"-1,051,937.46"
,CS,AR,32010576,1005,100,,Cash sale,,,,,,18/10/2018,18/10/2018,0.00,,7.29,,"-1,051,944.75"
,CS,AR,32010585,1005,100,,Cash sale,,,,,,18/10/2018,18/10/2018,0.00,,7.29,,"-1,051,952.04"
,CS,AR,32010611,1005,100,,Cash sale,,,,,,18/10/2018,18/10/2018,0.00,,7.29,,"-1,051,959.33"
,IN,AR,30328355,1005,100,,Invoice,,,,,,18/10/2018,18/10/2018,0.00,,7.29,,"-1,051,966.62"
,IN,AR,30328404,1005,100,,Invoice,,,,,,18/10/2018,18/10/2018,0.00,,10.93,,"-1,051,977.55"
,IN,AR,30328440,1005,100,,Invoice,,,,,,18/10/2018,18/10/2018,0.00,,10.93,,"-1,051,988.48"
,IN,AR,30328461,1005,100,,Invoice,,,,,,18/10/2018,18/10/2018,0.00,,2.80,,"-1,051,991.28"
,IN,AR,30328468,1005,100,,Invoice,,,,,,18/10/2018,18/10/2018,0.00,,109.32,,"-1,052,100.60"
,IN,AR,30328472,1005,100,,Invoice,,,,,,18/10/2018,18/10/2018,0.00,,14.58,,"-1,052,115.18"
,IN,AR,30328501,1005,100,,Invoice,,,,,,18/10/2018,18/10/2018,0.00,,32.00,,"-1,052,147.18"
,IN,AR,30328519,1005,100,,Invoice,,,,,,18/10/2018,18/10/2018,0.00,,3.64,,"-1,052,150.82"
,IN,AR,30328530,1005,100,,Invoice,,,,,,18/10/2018,18/10/2018,0.00,,30.00,,"-1,052,180.82"
,IN,AR,30328539,1005,100,,Invoice,,,,,,18/10/2018,18/10/2018,0.00,,8.90,,"-1,052,189.72"
,IN,AR,30328551,1005,100,,Invoice,,,,,,18/10/2018,18/10/2018,0.00,,25.51,,"-1,052,215.23"
,IN,AR,30328582,1005,100,,Invoice,,,,,,18/10/2018,18/10/2018,0.00,,3.64,,"-1,052,218.87"
,IN,AR,30328601,1005,100,,Invoice,,,,,,18/10/2018,18/10/2018,0.00,,51.02,,"-1,052,269.89"
,IN,AR,30328616,1005,100,,Invoice,,,,,,18/10/2018,18/10/2018,0.00,,59.32,,"-1,052,329.21"
,IN,AR,30328617,1005,100,,Invoice,,,,,,18/10/2018,18/10/2018,0.00,,9.49,,"-1,052,338.70"
,IN,AR,30328642,1005,100,,Invoice,,,,,,18/10/2018,18/10/2018,0.00,,11.36,,"-1,052,350.06"
,IN,AR,30328736,1005,100,,Invoice,,,,,,18/10/2018,18/10/2018,0.00,,18.22,,"-1,052,368.28"
,IN,AR,30328740,1005,100,,Invoice,,,,,,18/10/2018,18/10/2018,0.00,,21.86,,"-1,052,390.14"
,IN,AR,30328743,1005,100,,Invoice,,,,,,18/10/2018,18/10/2018,0.00,,24.50,,"-1,052,414.64"
,IN,AR,30328759,1005,100,,Invoice,,,,,,18/10/2018,18/10/2018,0.00,,7.29,,"-1,052,421.93"
,IN,AR,30328763,1005,100,,Invoice,,,,,,18/10/2018,18/10/2018,0.00,,4.80,,"-1,052,426.73"
,IN,AR,30328809,1005,100,,Invoice,,,,,,18/10/2018,18/10/2018,0.00,,54.92,,"-1,052,481.65"
,IN,AR,30328846,1005,100,,Invoice,,,,,,18/10/2018,18/10/2018,0.00,,10.93,,"-1,052,492.58"
,IN,AR,30328850,1005,100,,Invoice,,,,,,18/10/2018,18/10/2018,0.00,,95.99,,"-1,052,588.57"
,IN,AR,30328874,1005,100,,Invoice,,,,,,18/10/2018,18/10/2018,0.00,,28.68,,"-1,052,617.25"
,IN,AR,30328896,1005,100,,Invoice,,,,,,18/10/2018,18/10/2018,0.00,,22.03,,"-1,052,639.28"
,IN,AR,30328918,1005,100,,Invoice,,,,,,18/10/2018,18/10/2018,0.00,,10.17,,"-1,052,649.45"
,IN,AR,30328919,1005,100,,Invoice,,,,,,18/10/2018,18/10/2018,0.00,,142.37,,"-1,052,791.82"
,IN,AR,30328937,1005,100,,Invoice,,,,,,18/10/2018,18/10/2018,0.00,,16.73,,"-1,052,808.55"
,IN,AR,30328954,1005,100,,Invoice,,,,,,18/10/2018,18/10/2018,0.00,,9.66,,"-1,052,818.21"
,IN,AR,30328991,1005,100,,Invoice,,,,,,18/10/2018,18/10/2018,0.00,,39.11,,"-1,052,857.32"
,IN,AR,30329108,1005,100,,Invoice,,,,,,18/10/2018,18/10/2018,0.00,,3.43,,"-1,052,860.75"
,IN,AR,30329157,1005,100,,Invoice,,,,,,18/10/2018,18/10/2018,0.00,,35.59,,"-1,052,896.34"
,IN,AR,30329163,1005,100,,Invoice,,,,,,18/10/2018,18/10/2018,0.00,,25.00,,"-1,052,921.34"
,IN,AR,30329213,1005,100,,Invoice,,,,,,18/10/2018,18/10/2018,0.00,,6.02,,"-1,052,927.36"
,IN,AR,30329223,1005,100,,Invoice,,,,,,18/10/2018,18/10/2018,0.00,,8.47,,"-1,052,935.83"
,IN,AR,30329277,1005,100,,Invoice,,,,,,18/10/2018,18/10/2018,0.00,,19.64,,"-1,052,955.47"
,IN,AR,30329293,1005,100,,Invoice,,,,,,18/10/2018,18/10/2018,0.00,,35.59,,"-1,052,991.06"
,IN,AR,30329298,1005,100,,Invoice,,,,,,18/10/2018,18/10/2018,0.00,,4.58,,"-1,052,995.64"
,IN,AR,30329302,1005,100,,Invoice,,,,,,18/10/2018,18/10/2018,0.00,,28.00,,"-1,053,023.64"
,IN,AR,30329308,1005,100,,Invoice,,,,,,18/10/2018,18/10/2018,0.00,,14.58,,"-1,053,038.22"
,IN,AR,30329315,1005,100,,Invoice,,,,,,18/10/2018,18/10/2018,0.00,,7.29,,"-1,053,045.51"
,IN,AR,30329317,1005,100,,Invoice,,,,,,18/10/2018,18/10/2018,0.00,,10.93,,"-1,053,056.44"
,IN,AR,30329381,1005,100,,Invoice,,,,,,18/10/2018,18/10/2018,0.00,,27.54,,"-1,053,083.98"
,IN,AR,30329404,1005,100,,Invoice,,,,,,18/10/2018,18/10/2018,0.00,,8.52,,"-1,053,092.50"
,IN,AR,30329430,1005,100,,Invoice,,,,,,18/10/2018,18/10/2018,0.00,,12.03,,"-1,053,104.53"
,IN,AR,30329432,1005,100,,Invoice,,,,,,18/10/2018,18/10/2018,0.00,,5.17,,"-1,053,109.70"
,IN,AR,30329435,1005,100,,Invoice,,,,,,18/10/2018,18/10/2018,0.00,,9.10,,"-1,053,118.80"
,IN,AR,30329443,1005,100,,Invoice,,,,,,18/10/2018,18/10/2018,0.00,,11.64,,"-1,053,130.44"
,IN,AR,30329446,1005,100,,Invoice,,,,,,18/10/2018,18/10/2018,0.00,,7.63,,"-1,053,138.07"
,IN,AR,30329452,1005,100,,Invoice,,,,,,18/10/2018,18/10/2018,0.00,,34.07,,"-1,053,172.14"
,IN,AR,30329459,1005,100,,Invoice,,,,,,18/10/2018,18/10/2018,0.00,,15.04,,"-1,053,187.18"
,IN,AR,30329462,1005,100,,Invoice,,,,,,18/10/2018,18/10/2018,0.00,,6.00,,"-1,053,193.18"
,IN,AR,30329476,1005,100,,Invoice,,,,,,18/10/2018,18/10/2018,0.00,,10.68,,"-1,053,203.86"
,IN,AR,30329477,1005,100,,Invoice,,,,,,18/10/2018,18/10/2018,0.00,,29.15,,"-1,053,233.01"
,IN,AR,30329510,1005,100,,Invoice,,,,,,18/10/2018,18/10/2018,0.00,,3.64,,"-1,053,236.65"
,IN,AR,30329533,1005,100,,Invoice,,,,,,18/10/2018,18/10/2018,0.00,,29.15,,"-1,053,265.80"
,IN,AR,30329586,1005,100,,Invoice,,,,,,18/10/2018,18/10/2018,0.00,,5.68,,"-1,053,271.48"
,IN,AR,30329609,1005,100,,Invoice,,,,,,18/10/2018,18/10/2018,0.00,,7.29,,"-1,053,278.77"
,IN,AR,30329623,1005,100,,Invoice,,,,,,18/10/2018,18/10/2018,0.00,,3.98,,"-1,053,282.75"
,IN,AR,30329624,1005,100,,Invoice,,,,,,18/10/2018,18/10/2018,0.00,,3.98,,"-1,053,286.73"
,IN,AR,30329625,1005,100,,Invoice,,,,,,18/10/2018,18/10/2018,0.00,,15.93,,"-1,053,302.66"
,IN,AR,30329626,1005,100,,Invoice,,,,,,18/10/2018,18/10/2018,0.00,,49.79,,"-1,053,352.45"
,IN,AR,30329642,1005,100,,Invoice,,,,,,18/10/2018,18/10/2018,0.00,,9.96,,"-1,053,362.41"
,IN,AR,30329643,1005,100,,Invoice,,,,,,18/10/2018,18/10/2018,0.00,,7.97,,"-1,053,370.38"
,IN,AR,30329710,1005,100,,Invoice,,,,,,18/10/2018,18/10/2018,0.00,,7.29,,"-1,053,377.67"
,IN,AR,30329720,1005,100,,Invoice,,,,,,18/10/2018,18/10/2018,0.00,,8.20,,"-1,053,385.87"
,IN,AR,30329753,1005,100,,Invoice,,,,,,18/10/2018,18/10/2018,0.00,,9.84,,"-1,053,395.71"
,IN,AR,30329788,1005,100,,Invoice,,,,,,18/10/2018,18/10/2018,0.00,,10.93,,"-1,053,406.64"
,IN,AR,30329797,1005,100,,Invoice,,,,,,18/10/2018,18/10/2018,0.00,,22.88,,"-1,053,429.52"
,IN,AR,30329807,1005,100,,Invoice,,,,,,18/10/2018,18/10/2018,0.00,,18.01,,"-1,053,447.53"
,IN,AR,30329819,1005,100,,Invoice,,,,,,18/10/2018,18/10/2018,0.00,,8.00,,"-1,053,455.53"
,IN,AR,30329824,1005,100,,Invoice,,,,,,18/10/2018,18/10/2018,0.00,,34.01,,"-1,053,489.54"
,IN,AR,30329863,1005,100,,Invoice,,,,,,18/10/2018,18/10/2018,0.00,,3.64,,"-1,053,493.18"
,IN,AR,30329901,1005,100,,Invoice,,,,,,18/10/2018,18/10/2018,0.00,,34.98,,"-1,053,528.16"
,IN,AR,30329925,1005,100,,Invoice,,,,,,18/10/2018,18/10/2018,0.00,,14.03,,"-1,053,542.19"
,IN,AR,30329937,1005,100,,Invoice,,,,,,18/10/2018,18/10/2018,0.00,,14.58,,"-1,053,556.77"
,IN,AR,30329950,1005,100,,Invoice,,,,,,18/10/2018,18/10/2018,0.00,,9.10,,"-1,053,565.87"
,IN,AR,30329974,1005,100,,Invoice,,,,,,18/10/2018,18/10/2018,0.00,,2.54,,"-1,053,568.41"
,IN,AR,30329988,1005,100,,Invoice,,,,,,18/10/2018,18/10/2018,0.00,,81.15,,"-1,053,649.56"
,IN,AR,30330006,1005,100,,Invoice,,,,,,18/10/2018,18/10/2018,0.00,,116.31,,"-1,053,765.87"
,IN,AR,30330007,1005,100,,Invoice,,,,,,18/10/2018,18/10/2018,0.00,,7.97,,"-1,053,773.84"
,IN,AR,30330008,1005,100,,Invoice,,,,,,18/10/2018,18/10/2018,0.00,,6.37,,"-1,053,780.21"
,IN,AR,30330009,1005,100,,Invoice,,,,,,18/10/2018,18/10/2018,0.00,,6.37,,"-1,053,786.58"
,IN,AR,30330010,1005,100,,Invoice,,,,,,18/10/2018,18/10/2018,0.00,,17.53,,"-1,053,804.11"
,IN,AR,30330083,1005,100,,Invoice,,,,,,18/10/2018,18/10/2018,0.00,,22.37,,"-1,053,826.48"
,IN,AR,30330159,1005,100,,Invoice,,,,,,18/10/2018,18/10/2018,0.00,,10.99,,"-1,053,837.47"
,IN,AR,30330226,1005,100,,Invoice,,,,,,18/10/2018,18/10/2018,0.00,,24.51,,"-1,053,861.98"
,IN,AR,30330234,1005,100,,Invoice,,,,,,18/10/2018,18/10/2018,0.00,,10.21,,"-1,053,872.19"
,IN,AR,30330271,1005,100,,Invoice,,,,,,18/10/2018,18/10/2018,0.00,,16.91,,"-1,053,889.10"
,IN,AR,30330274,1005,100,,Invoice,,,,,,18/10/2018,18/10/2018,0.00,,1.95,,"-1,053,891.05"
,IN,AR,30330276,1005,100,,Invoice,,,,,,18/10/2018,18/10/2018,0.00,,15.18,,"-1,053,906.23"
,IN,AR,30330311,1005,100,,Invoice,,,,,,18/10/2018,18/10/2018,0.00,,4.15,,"-1,053,910.38"
,IN,AR,30330312,1005,100,,Invoice,,,,,,18/10/2018,18/10/2018,0.00,,4.15,,"-1,053,914.53"
,IN,AR,30330313,1005,100,,Invoice,,,,,,18/10/2018,18/10/2018,0.00,,2.08,,"-1,053,916.61"
,IN,AR,30330380,1005,100,,Invoice,,,,,,18/10/2018,18/10/2018,0.00,,4.07,,"-1,053,920.68"
,IN,AR,30330412,1005,100,,Invoice,,,,,,18/10/2018,18/10/2018,0.00,,6.31,,"-1,053,926.99"
,IN,AR,30330435,1005,100,,Invoice,,,,,,18/10/2018,18/10/2018,0.00,,81.92,,"-1,054,008.91"
,IN,AR,30330463,1005,100,,Invoice,,,,,,18/10/2018,18/10/2018,0.00,,7.29,,"-1,054,016.20"
,IN,AR,30330464,1005,100,,Invoice,,,,,,18/10/2018,18/10/2018,0.00,,10.93,,"-1,054,027.13"
,IN,AR,30330501,1005,100,,Invoice,,,,,,18/10/2018,18/10/2018,0.00,,3.04,,"-1,054,030.17"
,IN,AR,30330520,1005,100,,Invoice,,,,,,18/10/2018,18/10/2018,0.00,,24.07,,"-1,054,054.24"
,CS,AR,32010632,1005,100,,Cash sale,,,,,,18/10/2018,18/10/2018,0.00,,54.66,,"-1,054,108.90"
,IN,AR,30330546,1005,100,,Invoice,,,,,,18/10/2018,18/10/2018,0.00,,54.66,,"-1,054,163.56"
,IN,AR,30330705,1005,100,,Invoice,,,,,,18/10/2018,18/10/2018,0.00,,54.66,,"-1,054,218.22"
,IN,AR,30330706,1005,100,,Invoice,,,,,,18/10/2018,18/10/2018,0.00,,54.66,,"-1,054,272.88"
,CN,AR,31019363,1005,100,,Credit Note,,,,,,19/10/2018,19/10/2018,3.64,,0.00,,"-1,054,269.24"
,CS,AR,32009716,1005,100,,Cash sale,,,,,,19/10/2018,19/10/2018,0.00,,5.61,,"-1,054,274.85"
,CS,AR,32009732,1005,100,,Cash sale,,,,,,19/10/2018,19/10/2018,0.00,,16.61,,"-1,054,291.46"
,CS,AR,32009744,1005,100,,Cash sale,,,,,,19/10/2018,19/10/2018,0.00,,9.13,,"-1,054,300.59"
,CS,AR,32009799,1005,100,,Cash sale,,,,,,19/10/2018,19/10/2018,0.00,,14.58,,"-1,054,315.17"
,CS,AR,32009802,1005,100,,Cash sale,,,,,,19/10/2018,19/10/2018,0.00,,10.93,,"-1,054,326.10"
,CS,AR,32009803,1005,100,,Cash sale,,,,,,19/10/2018,19/10/2018,0.00,,7.29,,"-1,054,333.39"
,CS,AR,32009805,1005,100,,Cash sale,,,,,,19/10/2018,19/10/2018,0.00,,9.66,,"-1,054,343.05"
,CS,AR,32009811,1005,100,,Cash sale,,,,,,19/10/2018,19/10/2018,0.00,,7.29,,"-1,054,350.34"
,CS,AR,32009813,1005,100,,Cash sale,,,,,,19/10/2018,19/10/2018,0.00,,3.64,,"-1,054,353.98"
,CS,AR,32009826,1005,100,,Cash sale,,,,,,19/10/2018,19/10/2018,0.00,,14.53,,"-1,054,368.51"
,CS,AR,32009837,1005,100,,Cash sale,,,,,,19/10/2018,19/10/2018,0.00,,7.29,,"-1,054,375.80"
,CS,AR,32009851,1005,100,,Cash sale,,,,,,19/10/2018,19/10/2018,0.00,,11.68,,"-1,054,387.48"
,CS,AR,32009856,1005,100,,Cash sale,,,,,,19/10/2018,19/10/2018,0.00,,3.64,,"-1,054,391.12"
,CS,AR,32009862,1005,100,,Cash sale,,,,,,19/10/2018,19/10/2018,0.00,,7.29,,"-1,054,398.41"
,CS,AR,32009866,1005,100,,Cash sale,,,,,,19/10/2018,19/10/2018,0.00,,18.22,,"-1,054,416.63"
,CS,AR,32009872,1005,100,,Cash sale,,,,,,19/10/2018,19/10/2018,0.00,,22.44,,"-1,054,439.07"
,CS,AR,32009893,1005,100,,Cash sale,,,,,,19/10/2018,19/10/2018,0.00,,7.29,,"-1,054,446.36"
,CS,AR,32009934,1005,100,,Cash sale,,,,,,19/10/2018,19/10/2018,0.00,,2.58,,"-1,054,448.94"
,CS,AR,32009941,1005,100,,Cash sale,,,,,,19/10/2018,19/10/2018,0.00,,17.80,,"-1,054,466.74"
,CS,AR,32009965,1005,100,,Cash sale,,,,,,19/10/2018,19/10/2018,0.00,,27.47,,"-1,054,494.21"
,CS,AR,32009971,1005,100,,Cash sale,,,,,,19/10/2018,19/10/2018,0.00,,21.98,,"-1,054,516.19"
,CS,AR,32009982,1005,100,,Cash sale,,,,,,19/10/2018,19/10/2018,0.00,,7.29,,"-1,054,523.48"
,CS,AR,32009985,1005,100,,Cash sale,,,,,,19/10/2018,19/10/2018,0.00,,6.02,,"-1,054,529.50"
,CS,AR,32009986,1005,100,,Cash sale,,,,,,19/10/2018,19/10/2018,0.00,,18.05,,"-1,054,547.55"
,CS,AR,32010012,1005,100,,Cash sale,,,,,,19/10/2018,19/10/2018,0.00,,14.58,,"-1,054,562.13"
,CS,AR,32010014,1005,100,,Cash sale,,,,,,19/10/2018,19/10/2018,0.00,,20.34,,"-1,054,582.47"
,CS,AR,32010025,1005,100,,Cash sale,,,,,,19/10/2018,19/10/2018,0.00,,23.39,,"-1,054,605.86"
,CS,AR,32010045,1005,100,,Cash sale,,,,,,19/10/2018,19/10/2018,0.00,,24.07,,"-1,054,629.93"
,CS,AR,32010055,1005,100,,Cash sale,,,,,,19/10/2018,19/10/2018,0.00,,7.63,,"-1,054,637.56"
,CS,AR,32010080,1005,100,,Cash sale,,,,,,19/10/2018,19/10/2018,0.00,,10.93,,"-1,054,648.49"
,CS,AR,32010082,1005,100,,Cash sale,,,,,,19/10/2018,19/10/2018,0.00,,3.64,,"-1,054,652.13"
,CS,AR,32010085,1005,100,,Cash sale,,,,,,19/10/2018,19/10/2018,0.00,,20.34,,"-1,054,672.47"
,CS,AR,32010121,1005,100,,Cash sale,,,,,,19/10/2018,19/10/2018,0.00,,27.97,,"-1,054,700.44"
,CS,AR,32010141,1005,100,,Cash sale,,,,,,19/10/2018,19/10/2018,0.00,,18.22,,"-1,054,718.66"
,CS,AR,32010158,1005,100,,Cash sale,,,,,,19/10/2018,19/10/2018,0.00,,7.29,,"-1,054,725.95"
,CS,AR,32010164,1005,100,,Cash sale,,,,,,19/10/2018,19/10/2018,0.00,,14.63,,"-1,054,740.58"
,CS,AR,32010174,1005,100,,Cash sale,,,,,,19/10/2018,19/10/2018,0.00,,2.58,,"-1,054,743.16"
,CS,AR,32010192,1005,100,,Cash sale,,,,,,19/10/2018,19/10/2018,0.00,,3.64,,"-1,054,746.80"
,CS,AR,32010207,1005,100,,Cash sale,,,,,,19/10/2018,19/10/2018,0.00,,13.90,,"-1,054,760.70"
,CS,AR,32010281,1005,100,,Cash sale,,,,,,19/10/2018,19/10/2018,0.00,,3.64,,"-1,054,764.34"
,CS,AR,32010282,1005,100,,Cash sale,,,,,,19/10/2018,19/10/2018,0.00,,14.58,,"-1,054,778.92"
,CS,AR,32010285,1005,100,,Cash sale,,,,,,19/10/2018,19/10/2018,0.00,,7.63,,"-1,054,786.55"
,CS,AR,32010291,1005,100,,Cash sale,,,,,,19/10/2018,19/10/2018,0.00,,3.64,,"-1,054,790.19"
,CS,AR,32010307,1005,100,,Cash sale,,,,,,19/10/2018,19/10/2018,0.00,,7.63,,"-1,054,797.82"
,CS,AR,32010318,1005,100,,Cash sale,,,,,,19/10/2018,19/10/2018,0.00,,7.29,,"-1,054,805.11"
,CS,AR,32010325,1005,100,,Cash sale,,,,,,19/10/2018,19/10/2018,0.00,,6.86,,"-1,054,811.97"
,CS,AR,32010331,1005,100,,Cash sale,,,,,,19/10/2018,19/10/2018,0.00,,25.51,,"-1,054,837.48"
,CS,AR,32010379,1005,100,,Cash sale,,,,,,19/10/2018,19/10/2018,0.00,,15.18,,"-1,054,852.66"
,CS,AR,32010383,1005,100,,Cash sale,,,,,,19/10/2018,19/10/2018,0.00,,10.93,,"-1,054,863.59"
,CS,AR,32010399,1005,100,,Cash sale,,,,,,19/10/2018,19/10/2018,0.00,,7.29,,"-1,054,870.88"
,CS,AR,32010405,1005,100,,Cash sale,,,,,,19/10/2018,19/10/2018,0.00,,5.08,,"-1,054,875.96"
,CS,AR,32010407,1005,100,,Cash sale,,,,,,19/10/2018,19/10/2018,0.00,,3.64,,"-1,054,879.60"
,CS,AR,32010413,1005,100,,Cash sale,,,,,,19/10/2018,19/10/2018,0.00,,9.10,,"-1,054,888.70"
,CS,AR,32010420,1005,100,,Cash sale,,,,,,19/10/2018,19/10/2018,0.00,,10.38,,"-1,054,899.08"
,CS,AR,32010423,1005,100,,Cash sale,,,,,,19/10/2018,19/10/2018,0.00,,10.93,,"-1,054,910.01"
,CS,AR,32010431,1005,100,,Cash sale,,,,,,19/10/2018,19/10/2018,0.00,,9.13,,"-1,054,919.14"
,CS,AR,32010465,1005,100,,Cash sale,,,,,,19/10/2018,19/10/2018,0.00,,8.78,,"-1,054,927.92"
,CS,AR,32010468,1005,100,,Cash sale,,,,,,19/10/2018,19/10/2018,0.00,,3.64,,"-1,054,931.56"
,CS,AR,32010480,1005,100,,Cash sale,,,,,,19/10/2018,19/10/2018,0.00,,3.64,,"-1,054,935.20"
,CS,AR,32010496,1005,100,,Cash sale,,,,,,19/10/2018,19/10/2018,0.00,,7.29,,"-1,054,942.49"
,CS,AR,32010498,1005,100,,Cash sale,,,,,,19/10/2018,19/10/2018,0.00,,5.94,,"-1,054,948.43"
,CS,AR,32010548,1005,100,,Cash sale,,,,,,19/10/2018,19/10/2018,0.00,,6.99,,"-1,054,955.42"
,CS,AR,32010580,1005,100,,Cash sale,,,,,,19/10/2018,19/10/2018,0.00,,14.58,,"-1,054,970.00"
,CS,AR,32010583,1005,100,,Cash sale,,,,,,19/10/2018,19/10/2018,0.00,,3.64,,"-1,054,973.64"
,CS,AR,32010598,1005,100,,Cash sale,,,,,,19/10/2018,19/10/2018,0.00,,43.73,,"-1,055,017.37"
,IN,AR,30328319,1005,100,,Invoice,,,,,,19/10/2018,19/10/2018,0.00,,5.93,,"-1,055,023.30"
,IN,AR,30328320,1005,100,,Invoice,,,,,,19/10/2018,19/10/2018,0.00,,26.69,,"-1,055,049.99"
,IN,AR,30328321,1005,100,,Invoice,,,,,,19/10/2018,19/10/2018,0.00,,17.80,,"-1,055,067.79"
,IN,AR,30328332,1005,100,,Invoice,,,,,,19/10/2018,19/10/2018,0.00,,21.86,,"-1,055,089.65"
,IN,AR,30328343,1005,100,,Invoice,,,,,,19/10/2018,19/10/2018,0.00,,13.98,,"-1,055,103.63"
,IN,AR,30328348,1005,100,,Invoice,,,,,,19/10/2018,19/10/2018,0.00,,14.58,,"-1,055,118.21"
,IN,AR,30328409,1005,100,,Invoice,,,,,,19/10/2018,19/10/2018,0.00,,25.51,,"-1,055,143.72"
,IN,AR,30328435,1005,100,,Invoice,,,,,,19/10/2018,19/10/2018,0.00,,24.15,,"-1,055,167.87"
,IN,AR,30328455,1005,100,,Invoice,,,,,,19/10/2018,19/10/2018,0.00,,78.20,,"-1,055,246.07"
,IN,AR,30328470,1005,100,,Invoice,,,,,,19/10/2018,19/10/2018,0.00,,13.78,,"-1,055,259.85"
,IN,AR,30328475,1005,100,,Invoice,,,,,,19/10/2018,19/10/2018,0.00,,79.57,,"-1,055,339.42"
,IN,AR,30328476,1005,100,,Invoice,,,,,,19/10/2018,19/10/2018,0.00,,11.64,,"-1,055,351.06"
,IN,AR,30328485,1005,100,,Invoice,,,,,,19/10/2018,19/10/2018,0.00,,5.97,,"-1,055,357.03"
,IN,AR,30328502,1005,100,,Invoice,,,,,,19/10/2018,19/10/2018,0.00,,48.00,,"-1,055,405.03"
,IN,AR,30328520,1005,100,,Invoice,,,,,,19/10/2018,19/10/2018,0.00,,10.93,,"-1,055,415.96"
,IN,AR,30328526,1005,100,,Invoice,,,,,,19/10/2018,19/10/2018,0.00,,10.93,,"-1,055,426.89"
,IN,AR,30328568,1005,100,,Invoice,,,,,,19/10/2018,19/10/2018,0.00,,24.00,,"-1,055,450.89"
,IN,AR,30328577,1005,100,,Invoice,,,,,,19/10/2018,19/10/2018,0.00,,7.29,,"-1,055,458.18"
,IN,AR,30328618,1005,100,,Invoice,,,,,,19/10/2018,19/10/2018,0.00,,4.75,,"-1,055,462.93"
,IN,AR,30328625,1005,100,,Invoice,,,,,,19/10/2018,19/10/2018,0.00,,12.00,,"-1,055,474.93"
,IN,AR,30328635,1005,100,,Invoice,,,,,,19/10/2018,19/10/2018,0.00,,60.41,,"-1,055,535.34"
,IN,AR,30328681,1005,100,,Invoice,,,,,,19/10/2018,19/10/2018,0.00,,50.00,,"-1,055,585.34"
,IN,AR,30328686,1005,100,,Invoice,,,,,,19/10/2018,19/10/2018,0.00,,7.29,,"-1,055,592.63"
,IN,AR,30328702,1005,100,,Invoice,,,,,,19/10/2018,19/10/2018,0.00,,25.51,,"-1,055,618.14"
,IN,AR,30328707,1005,100,,Invoice,,,,,,19/10/2018,19/10/2018,0.00,,8.39,,"-1,055,626.53"
,IN,AR,30328712,1005,100,,Invoice,,,,,,19/10/2018,19/10/2018,0.00,,25.87,,"-1,055,652.40"
,IN,AR,30328714,1005,100,,Invoice,,,,,,19/10/2018,19/10/2018,0.00,,3.01,,"-1,055,655.41"
,IN,AR,30328728,1005,100,,Invoice,,,,,,19/10/2018,19/10/2018,0.00,,10.93,,"-1,055,666.34"
,IN,AR,30328748,1005,100,,Invoice,,,,,,19/10/2018,19/10/2018,0.00,,5.17,,"-1,055,671.51"
,IN,AR,30328764,1005,100,,Invoice,,,,,,19/10/2018,19/10/2018,0.00,,7.19,,"-1,055,678.70"
,IN,AR,30328810,1005,100,,Invoice,,,,,,19/10/2018,19/10/2018,0.00,,56.95,,"-1,055,735.65"
,IN,AR,30328833,1005,100,,Invoice,,,,,,19/10/2018,19/10/2018,0.00,,14.58,,"-1,055,750.23"
,IN,AR,30328838,1005,100,,Invoice,,,,,,19/10/2018,19/10/2018,0.00,,23.26,,"-1,055,773.49"
,IN,AR,30328843,1005,100,,Invoice,,,,,,19/10/2018,19/10/2018,0.00,,4.78,,"-1,055,778.27"
,IN,AR,30328879,1005,100,,Invoice,,,,,,19/10/2018,19/10/2018,0.00,,6.02,,"-1,055,784.29"
,IN,AR,30328903,1005,100,,Invoice,,,,,,19/10/2018,19/10/2018,0.00,,67.68,,"-1,055,851.97"
,IN,AR,30329040,1005,100,,Invoice,,,,,,19/10/2018,19/10/2018,0.00,,5.08,,"-1,055,857.05"
,IN,AR,30329041,1005,100,,Invoice,,,,,,19/10/2018,19/10/2018,0.00,,2.54,,"-1,055,859.59"
,IN,AR,30329042,1005,100,,Invoice,,,,,,19/10/2018,19/10/2018,0.00,,17.80,,"-1,055,877.39"
,IN,AR,30329055,1005,100,,Invoice,,,,,,19/10/2018,19/10/2018,0.00,,2.54,,"-1,055,879.93"
,IN,AR,30329067,1005,100,,Invoice,,,,,,19/10/2018,19/10/2018,0.00,,2.58,,"-1,055,882.51"
,IN,AR,30329120,1005,100,,Invoice,,,,,,19/10/2018,19/10/2018,0.00,,15.25,,"-1,055,897.76"
,IN,AR,30329124,1005,100,,Invoice,,,,,,19/10/2018,19/10/2018,0.00,,6.36,,"-1,055,904.12"
,IN,AR,30329136,1005,100,,Invoice,,,,,,19/10/2018,19/10/2018,0.00,,7.29,,"-1,055,911.41"
,IN,AR,30329206,1005,100,,Invoice,,,,,,19/10/2018,19/10/2018,0.00,,16.48,,"-1,055,927.89"
,IN,AR,30329260,1005,100,,Invoice,,,,,,19/10/2018,19/10/2018,0.00,,14.58,,"-1,055,942.47"
,IN,AR,30329268,1005,100,,Invoice,,,,,,19/10/2018,19/10/2018,0.00,,21.97,,"-1,055,964.44"
,IN,AR,30329294,1005,100,,Invoice,,,,,,19/10/2018,19/10/2018,0.00,,32.63,,"-1,055,997.07"
,IN,AR,30329324,1005,100,,Invoice,,,,,,19/10/2018,19/10/2018,0.00,,6.36,,"-1,056,003.43"
,IN,AR,30329354,1005,100,,Invoice,,,,,,19/10/2018,19/10/2018,0.00,,30.00,,"-1,056,033.43"
,IN,AR,30329372,1005,100,,Invoice,,,,,,19/10/2018,19/10/2018,0.00,,8.77,,"-1,056,042.20"
,IN,AR,30329393,1005,100,,Invoice,,,,,,19/10/2018,19/10/2018,0.00,,2.58,,"-1,056,044.78"
,IN,AR,30329488,1005,100,,Invoice,,,,,,19/10/2018,19/10/2018,0.00,,8.81,,"-1,056,053.59"
,IN,AR,30329540,1005,100,,Invoice,,,,,,19/10/2018,19/10/2018,0.00,,29.15,,"-1,056,082.74"
,IN,AR,30329548,1005,100,,Invoice,,,,,,19/10/2018,19/10/2018,0.00,,7.29,,"-1,056,090.03"
,IN,AR,30329565,1005,100,,Invoice,,,,,,19/10/2018,19/10/2018,0.00,,21.86,,"-1,056,111.89"
,IN,AR,30329588,1005,100,,Invoice,,,,,,19/10/2018,19/10/2018,0.00,,14.58,,"-1,056,126.47"
,IN,AR,30329600,1005,100,,Invoice,,,,,,19/10/2018,19/10/2018,0.00,,10.20,,"-1,056,136.67"
,IN,AR,30329644,1005,100,,Invoice,,,,,,19/10/2018,19/10/2018,0.00,,41.82,,"-1,056,178.49"
,IN,AR,30329667,1005,100,,Invoice,,,,,,19/10/2018,19/10/2018,0.00,,62.46,,"-1,056,240.95"
,IN,AR,30329676,1005,100,,Invoice,,,,,,19/10/2018,19/10/2018,0.00,,28.00,,"-1,056,268.95"
,IN,AR,30329681,1005,100,,Invoice,,,,,,19/10/2018,19/10/2018,0.00,,31.42,,"-1,056,300.37"
,IN,AR,30329684,1005,100,,Invoice,,,,,,19/10/2018,19/10/2018,0.00,,11.86,,"-1,056,312.23"
,IN,AR,30329690,1005,100,,Invoice,,,,,,19/10/2018,19/10/2018,0.00,,8.52,,"-1,056,320.75"
,IN,AR,30329696,1005,100,,Invoice,,,,,,19/10/2018,19/10/2018,0.00,,14.03,,"-1,056,334.78"
,IN,AR,30329706,1005,100,,Invoice,,,,,,19/10/2018,19/10/2018,0.00,,54.66,,"-1,056,389.44"
,IN,AR,30329718,1005,100,,Invoice,,,,,,19/10/2018,19/10/2018,0.00,,7.29,,"-1,056,396.73"
,IN,AR,30329723,1005,100,,Invoice,,,,,,19/10/2018,19/10/2018,0.00,,41.06,,"-1,056,437.79"
,IN,AR,30329737,1005,100,,Invoice,,,,,,19/10/2018,19/10/2018,0.00,,7.29,,"-1,056,445.08"
,IN,AR,30329742,1005,100,,Invoice,,,,,,19/10/2018,19/10/2018,0.00,,28.90,,"-1,056,473.98"
,IN,AR,30329762,1005,100,,Invoice,,,,,,19/10/2018,19/10/2018,0.00,,6.56,,"-1,056,480.54"
,IN,AR,30329765,1005,100,,Invoice,,,,,,19/10/2018,19/10/2018,0.00,,7.29,,"-1,056,487.83"
,IN,AR,30329767,1005,100,,Invoice,,,,,,19/10/2018,19/10/2018,0.00,,49.15,,"-1,056,536.98"
,IN,AR,30329771,1005,100,,Invoice,,,,,,19/10/2018,19/10/2018,0.00,,14.34,,"-1,056,551.32"
,IN,AR,30329798,1005,100,,Invoice,,,,,,19/10/2018,19/10/2018,0.00,,12.71,,"-1,056,564.03"
,IN,AR,30329812,1005,100,,Invoice,,,,,,19/10/2018,19/10/2018,0.00,,8.00,,"-1,056,572.03"
,IN,AR,30329827,1005,100,,Invoice,,,,,,19/10/2018,19/10/2018,0.00,,6.00,,"-1,056,578.03"
,IN,AR,30329837,1005,100,,Invoice,,,,,,19/10/2018,19/10/2018,0.00,,14.58,,"-1,056,592.61"
,IN,AR,30329838,1005,100,,Invoice,,,,,,19/10/2018,19/10/2018,0.00,,17.49,,"-1,056,610.10"
,IN,AR,30329867,1005,100,,Invoice,,,,,,19/10/2018,19/10/2018,0.00,,32.85,,"-1,056,642.95"
,IN,AR,30329879,1005,100,,Invoice,,,,,,19/10/2018,19/10/2018,0.00,,31.54,,"-1,056,674.49"
,IN,AR,30329880,1005,100,,Invoice,,,,,,19/10/2018,19/10/2018,0.00,,27.33,,"-1,056,701.82"
,IN,AR,30329932,1005,100,,Invoice,,,,,,19/10/2018,19/10/2018,0.00,,9.19,,"-1,056,711.01"
,IN,AR,30329935,1005,100,,Invoice,,,,,,19/10/2018,19/10/2018,0.00,,41.19,,"-1,056,752.20"
,IN,AR,30329948,1005,100,,Invoice,,,,,,19/10/2018,19/10/2018,0.00,,18.17,,"-1,056,770.37"
,IN,AR,30329979,1005,100,,Invoice,,,,,,19/10/2018,19/10/2018,0.00,,11.36,,"-1,056,781.73"
,IN,AR,30330011,1005,100,,Invoice,,,,,,19/10/2018,19/10/2018,0.00,,9.56,,"-1,056,791.29"
,IN,AR,30330093,1005,100,,Invoice,,,,,,19/10/2018,19/10/2018,0.00,,16.00,,"-1,056,807.29"
,IN,AR,30330133,1005,100,,Invoice,,,,,,19/10/2018,19/10/2018,0.00,,19.87,,"-1,056,827.16"
,IN,AR,30330137,1005,100,,Invoice,,,,,,19/10/2018,19/10/2018,0.00,,60.51,,"-1,056,887.67"
,IN,AR,30330155,1005,100,,Invoice,,,,,,19/10/2018,19/10/2018,0.00,,5.83,,"-1,056,893.50"
,IN,AR,30330157,1005,100,,Invoice,,,,,,19/10/2018,19/10/2018,0.00,,9.84,,"-1,056,903.34"
,IN,AR,30330160,1005,100,,Invoice,,,,,,19/10/2018,19/10/2018,0.00,,29.15,,"-1,056,932.49"
,IN,AR,30330164,1005,100,,Invoice,,,,,,19/10/2018,19/10/2018,0.00,,13.69,,"-1,056,946.18"
,IN,AR,30330170,1005,100,,Invoice,,,,,,19/10/2018,19/10/2018,0.00,,10.93,,"-1,056,957.11"
,IN,AR,30330174,1005,100,,Invoice,,,,,,19/10/2018,19/10/2018,0.00,,29.15,,"-1,056,986.26"
,IN,AR,30330176,1005,100,,Invoice,,,,,,19/10/2018,19/10/2018,0.00,,25.42,,"-1,057,011.68"
,IN,AR,30330227,1005,100,,Invoice,,,,,,19/10/2018,19/10/2018,0.00,,8.17,,"-1,057,019.85"
,IN,AR,30330241,1005,100,,Invoice,,,,,,19/10/2018,19/10/2018,0.00,,18.22,,"-1,057,038.07"
,IN,AR,30330252,1005,100,,Invoice,,,,,,19/10/2018,19/10/2018,0.00,,11.95,,"-1,057,050.02"
,IN,AR,30330314,1005,100,,Invoice,,,,,,19/10/2018,19/10/2018,0.00,,22.84,,"-1,057,072.86"
,IN,AR,30330369,1005,100,,Invoice,,,,,,19/10/2018,19/10/2018,0.00,,12.41,,"-1,057,085.27"
,IN,AR,30330371,1005,100,,Invoice,,,,,,19/10/2018,19/10/2018,0.00,,9.10,,"-1,057,094.37"
,IN,AR,30330383,1005,100,,Invoice,,,,,,19/10/2018,19/10/2018,0.00,,10.17,,"-1,057,104.54"
,IN,AR,30330392,1005,100,,Invoice,,,,,,19/10/2018,19/10/2018,0.00,,18.22,,"-1,057,122.76"
,IN,AR,30330413,1005,100,,Invoice,,,,,,19/10/2018,19/10/2018,0.00,,31.54,,"-1,057,154.30"
,IN,AR,30330423,1005,100,,Invoice,,,,,,19/10/2018,19/10/2018,0.00,,16.78,,"-1,057,171.08"
,IN,AR,30330439,1005,100,,Invoice,,,,,,19/10/2018,19/10/2018,0.00,,7.29,,"-1,057,178.37"
,IN,AR,30330458,1005,100,,Invoice,,,,,,19/10/2018,19/10/2018,0.00,,6.07,,"-1,057,184.44"
,IN,AR,30330467,1005,100,,Invoice,,,,,,19/10/2018,19/10/2018,0.00,,7.02,,"-1,057,191.46"
,IN,AR,30330469,1005,100,,Invoice,,,,,,19/10/2018,19/10/2018,0.00,,29.15,,"-1,057,220.61"
,IN,AR,30330491,1005,100,,Invoice,,,,,,19/10/2018,19/10/2018,0.00,,5.39,,"-1,057,226.00"
,IN,AR,30330524,1005,100,,Invoice,,,,,,19/10/2018,19/10/2018,0.00,,5.08,,"-1,057,231.08"
,IN,AR,30330544,1005,100,,Invoice,,,,,,19/10/2018,19/10/2018,0.00,,364.41,,"-1,057,595.49"
,IN,AR,30330547,1005,100,,Invoice,,,,,,19/10/2018,19/10/2018,0.00,,54.66,,"-1,057,650.15"
,IN,AR,30330558,1005,100,,Invoice,,,,,,19/10/2018,19/10/2018,0.00,,364.41,,"-1,058,014.56"
,IN,AR,30330567,1005,100,,Invoice,,,,,,19/10/2018,19/10/2018,0.00,,364.41,,"-1,058,378.97"
,IN,AR,30330572,1005,100,,Invoice,,,,,,19/10/2018,19/10/2018,0.00,,182.20,,"-1,058,561.17"
,IN,AR,30330580,1005,100,,Invoice,,,,,,19/10/2018,19/10/2018,0.00,,364.41,,"-1,058,925.58"
,IN,AR,30330581,1005,100,,Invoice,,,,,,19/10/2018,19/10/2018,0.00,,364.41,,"-1,059,289.99"
,IN,AR,30330583,1005,100,,Invoice,,,,,,19/10/2018,19/10/2018,0.00,,364.41,,"-1,059,654.40"
,IN,AR,30330586,1005,100,,Invoice,,,,,,19/10/2018,19/10/2018,0.00,,364.41,,"-1,060,018.81"
,IN,AR,30330594,1005,100,,Invoice,,,,,,19/10/2018,19/10/2018,0.00,,364.41,,"-1,060,383.22"
,IN,AR,30330615,1005,100,,Invoice,,,,,,19/10/2018,19/10/2018,0.00,,54.66,,"-1,060,437.88"
,IN,AR,30330617,1005,100,,Invoice,,,,,,19/10/2018,19/10/2018,0.00,,546.61,,"-1,060,984.49"
,IN,AR,30330631,1005,100,,Invoice,,,,,,19/10/2018,19/10/2018,0.00,,364.41,,"-1,061,348.90"
,IN,AR,30330634,1005,100,,Invoice,,,,,,19/10/2018,19/10/2018,0.00,,218.64,,"-1,061,567.54"
,IN,AR,30330699,1005,100,,Invoice,,,,,,19/10/2018,19/10/2018,0.00,,182.20,,"-1,061,749.74"
,IN,AR,30330718,1005,100,,Invoice,,,,,,19/10/2018,19/10/2018,0.00,,54.66,,"-1,061,804.40"
,CN,AR,31019491,1005,100,,Credit Note,,,,,,19/10/2018,19/10/2018,21.86,,0.00,,"-1,061,782.54"
,CS,AR,32009868,1005,100,,Cash sale,,,,,,20/10/2018,20/10/2018,0.00,,3.64,,"-1,061,786.18"
,CS,AR,32009876,1005,100,,Cash sale,,,,,,20/10/2018,20/10/2018,0.00,,10.93,,"-1,061,797.11"
,CS,AR,32009881,1005,100,,Cash sale,,,,,,20/10/2018,20/10/2018,0.00,,25.51,,"-1,061,822.62"
,CS,AR,32009887,1005,100,,Cash sale,,,,,,20/10/2018,20/10/2018,0.00,,7.29,,"-1,061,829.91"
,CS,AR,32010010,1005,100,,Cash sale,,,,,,20/10/2018,20/10/2018,0.00,,9.03,,"-1,061,838.94"
,CS,AR,32010066,1005,100,,Cash sale,,,,,,20/10/2018,20/10/2018,0.00,,7.29,,"-1,061,846.23"
,CS,AR,32010111,1005,100,,Cash sale,,,,,,20/10/2018,20/10/2018,0.00,,18.22,,"-1,061,864.45"
,CS,AR,32010119,1005,100,,Cash sale,,,,,,20/10/2018,20/10/2018,0.00,,12.88,,"-1,061,877.33"
,CS,AR,32010166,1005,100,,Cash sale,,,,,,20/10/2018,20/10/2018,0.00,,10.93,,"-1,061,888.26"
,CS,AR,32010240,1005,100,,Cash sale,,,,,,20/10/2018,20/10/2018,0.00,,10.93,,"-1,061,899.19"
,CS,AR,32010335,1005,100,,Cash sale,,,,,,20/10/2018,20/10/2018,0.00,,14.58,,"-1,061,913.77"
,CS,AR,32010339,1005,100,,Cash sale,,,,,,20/10/2018,20/10/2018,0.00,,9.10,,"-1,061,922.87"
,CS,AR,32010602,1005,100,,Cash sale,,,,,,20/10/2018,20/10/2018,0.00,,14.58,,"-1,061,937.45"
,IN,AR,30328322,1005,100,,Invoice,,,,,,20/10/2018,20/10/2018,0.00,,14.83,,"-1,061,952.28"
,IN,AR,30328503,1005,100,,Invoice,,,,,,20/10/2018,20/10/2018,0.00,,56.00,,"-1,062,008.28"
,IN,AR,30328578,1005,100,,Invoice,,,,,,20/10/2018,20/10/2018,0.00,,3.64,,"-1,062,011.92"
,IN,AR,30328602,1005,100,,Invoice,,,,,,20/10/2018,20/10/2018,0.00,,7.29,,"-1,062,019.21"
,IN,AR,30328666,1005,100,,Invoice,,,,,,20/10/2018,20/10/2018,0.00,,3.88,,"-1,062,023.09"
,IN,AR,30328667,1005,100,,Invoice,,,,,,20/10/2018,20/10/2018,0.00,,19.41,,"-1,062,042.50"
,IN,AR,30329363,1005,100,,Invoice,,,,,,20/10/2018,20/10/2018,0.00,,10.93,,"-1,062,053.43"
,IN,AR,30329369,1005,100,,Invoice,,,,,,20/10/2018,20/10/2018,0.00,,9.29,,"-1,062,062.72"
,IN,AR,30329515,1005,100,,Invoice,,,,,,20/10/2018,20/10/2018,0.00,,4.85,,"-1,062,067.57"
,IN,AR,30329840,1005,100,,Invoice,,,,,,20/10/2018,20/10/2018,0.00,,4.24,,"-1,062,071.81"
,IN,AR,30329930,1005,100,,Invoice,,,,,,20/10/2018,20/10/2018,0.00,,10.93,,"-1,062,082.74"
,IN,AR,30330063,1005,100,,Invoice,,,,,,20/10/2018,20/10/2018,0.00,,21.86,,"-1,062,104.60"
,CN,AR,31019348,1005,100,,Credit Note,,,,,,22/10/2018,22/10/2018,7.29,,0.00,,"-1,062,097.31"
,CS,AR,32009717,1005,100,,Cash sale,,,,,,22/10/2018,22/10/2018,0.00,,8.42,,"-1,062,105.73"
,CS,AR,32009733,1005,100,,Cash sale,,,,,,22/10/2018,22/10/2018,0.00,,11.86,,"-1,062,117.59"
,CS,AR,32009771,1005,100,,Cash sale,,,,,,22/10/2018,22/10/2018,0.00,,7.29,,"-1,062,124.88"
,CS,AR,32009791,1005,100,,Cash sale,,,,,,22/10/2018,22/10/2018,0.00,,3.64,,"-1,062,128.52"
,CS,AR,32009827,1005,100,,Cash sale,,,,,,22/10/2018,22/10/2018,0.00,,14.53,,"-1,062,143.05"
,CS,AR,32009840,1005,100,,Cash sale,,,,,,22/10/2018,22/10/2018,0.00,,7.29,,"-1,062,150.34"
,CS,AR,32009852,1005,100,,Cash sale,,,,,,22/10/2018,22/10/2018,0.00,,7.78,,"-1,062,158.12"
,CS,AR,32009859,1005,100,,Cash sale,,,,,,22/10/2018,22/10/2018,0.00,,5.85,,"-1,062,163.97"
,CS,AR,32009865,1005,100,,Cash sale,,,,,,22/10/2018,22/10/2018,0.00,,7.29,,"-1,062,171.26"
,CS,AR,32009905,1005,100,,Cash sale,,,,,,22/10/2018,22/10/2018,0.00,,10.34,,"-1,062,181.60"
,CS,AR,32009930,1005,100,,Cash sale,,,,,,22/10/2018,22/10/2018,0.00,,7.29,,"-1,062,188.89"
,CS,AR,32009942,1005,100,,Cash sale,,,,,,22/10/2018,22/10/2018,0.00,,15.25,,"-1,062,204.14"
,CS,AR,32009983,1005,100,,Cash sale,,,,,,22/10/2018,22/10/2018,0.00,,7.29,,"-1,062,211.43"
,CS,AR,32009998,1005,100,,Cash sale,,,,,,22/10/2018,22/10/2018,0.00,,7.29,,"-1,062,218.72"
,CS,AR,32010019,1005,100,,Cash sale,,,,,,22/10/2018,22/10/2018,0.00,,12.97,,"-1,062,231.69"
,CS,AR,32010026,1005,100,,Cash sale,,,,,,22/10/2018,22/10/2018,0.00,,14.62,,"-1,062,246.31"
,CS,AR,32010033,1005,100,,Cash sale,,,,,,22/10/2018,22/10/2018,0.00,,8.16,,"-1,062,254.47"
,CS,AR,32010041,1005,100,,Cash sale,,,,,,22/10/2018,22/10/2018,0.00,,7.17,,"-1,062,261.64"
,CS,AR,32010046,1005,100,,Cash sale,,,,,,22/10/2018,22/10/2018,0.00,,30.08,,"-1,062,291.72"
,CS,AR,32010058,1005,100,,Cash sale,,,,,,22/10/2018,22/10/2018,0.00,,6.48,,"-1,062,298.20"
,CS,AR,32010072,1005,100,,Cash sale,,,,,,22/10/2018,22/10/2018,0.00,,14.58,,"-1,062,312.78"
,CS,AR,32010076,1005,100,,Cash sale,,,,,,22/10/2018,22/10/2018,0.00,,7.29,,"-1,062,320.07"
,CS,AR,32010106,1005,100,,Cash sale,,,,,,22/10/2018,22/10/2018,0.00,,2.54,,"-1,062,322.61"
,CS,AR,32010116,1005,100,,Cash sale,,,,,,22/10/2018,22/10/2018,0.00,,10.17,,"-1,062,332.78"
,CS,AR,32010128,1005,100,,Cash sale,,,,,,22/10/2018,22/10/2018,0.00,,10.93,,"-1,062,343.71"
,CS,AR,32010147,1005,100,,Cash sale,,,,,,22/10/2018,22/10/2018,0.00,,7.29,,"-1,062,351.00"
,CS,AR,32010172,1005,100,,Cash sale,,,,,,22/10/2018,22/10/2018,0.00,,7.29,,"-1,062,358.29"
,CS,AR,32010181,1005,100,,Cash sale,,,,,,22/10/2018,22/10/2018,0.00,,3.64,,"-1,062,361.93"
,CS,AR,32010196,1005,100,,Cash sale,,,,,,22/10/2018,22/10/2018,0.00,,3.20,,"-1,062,365.13"
,CS,AR,32010220,1005,100,,Cash sale,,,,,,22/10/2018,22/10/2018,0.00,,7.29,,"-1,062,372.42"
,CS,AR,32010246,1005,100,,Cash sale,,,,,,22/10/2018,22/10/2018,0.00,,12.71,,"-1,062,385.13"
,CS,AR,32010254,1005,100,,Cash sale,,,,,,22/10/2018,22/10/2018,0.00,,7.29,,"-1,062,392.42"
,CS,AR,32010306,1005,100,,Cash sale,,,,,,22/10/2018,22/10/2018,0.00,,3.64,,"-1,062,396.06"
,CS,AR,32010326,1005,100,,Cash sale,,,,,,22/10/2018,22/10/2018,0.00,,11.44,,"-1,062,407.50"
,CS,AR,32010353,1005,100,,Cash sale,,,,,,22/10/2018,22/10/2018,0.00,,10.17,,"-1,062,417.67"
,CS,AR,32010357,1005,100,,Cash sale,,,,,,22/10/2018,22/10/2018,0.00,,9.10,,"-1,062,426.77"
,CS,AR,32010380,1005,100,,Cash sale,,,,,,22/10/2018,22/10/2018,0.00,,12.14,,"-1,062,438.91"
,CS,AR,32010400,1005,100,,Cash sale,,,,,,22/10/2018,22/10/2018,0.00,,14.58,,"-1,062,453.49"
,CS,AR,32010409,1005,100,,Cash sale,,,,,,22/10/2018,22/10/2018,0.00,,14.58,,"-1,062,468.07"
,CS,AR,32010416,1005,100,,Cash sale,,,,,,22/10/2018,22/10/2018,0.00,,12.20,,"-1,062,480.27"
,CS,AR,32010427,1005,100,,Cash sale,,,,,,22/10/2018,22/10/2018,0.00,,3.64,,"-1,062,483.91"
,CS,AR,32010434,1005,100,,Cash sale,,,,,,22/10/2018,22/10/2018,0.00,,10.93,,"-1,062,494.84"
,CS,AR,32010494,1005,100,,Cash sale,,,,,,22/10/2018,22/10/2018,0.00,,7.29,,"-1,062,502.13"
,CS,AR,32010505,1005,100,,Cash sale,,,,,,22/10/2018,22/10/2018,0.00,,10.93,,"-1,062,513.06"
,CS,AR,32010549,1005,100,,Cash sale,,,,,,22/10/2018,22/10/2018,0.00,,9.32,,"-1,062,522.38"
,CS,AR,32010554,1005,100,,Cash sale,,,,,,22/10/2018,22/10/2018,0.00,,6.07,,"-1,062,528.45"
,CS,AR,32010565,1005,100,,Cash sale,,,,,,22/10/2018,22/10/2018,0.00,,7.29,,"-1,062,535.74"
,CS,AR,32010575,1005,100,,Cash sale,,,,,,22/10/2018,22/10/2018,0.00,,7.75,,"-1,062,543.49"
,CS,AR,32010618,1005,100,,Cash sale,,,,,,22/10/2018,22/10/2018,0.00,,10.93,,"-1,062,554.42"
,IN,AR,30328323,1005,100,,Invoice,,,,,,22/10/2018,22/10/2018,0.00,,32.63,,"-1,062,587.05"
,IN,AR,30328338,1005,100,,Invoice,,,,,,22/10/2018,22/10/2018,0.00,,14.58,,"-1,062,601.63"
,IN,AR,30328384,1005,100,,Invoice,,,,,,22/10/2018,22/10/2018,0.00,,8.10,,"-1,062,609.73"
,IN,AR,30328385,1005,100,,Invoice,,,,,,22/10/2018,22/10/2018,0.00,,2.03,,"-1,062,611.76"
,IN,AR,30328386,1005,100,,Invoice,,,,,,22/10/2018,22/10/2018,0.00,,10.13,,"-1,062,621.89"
,IN,AR,30328387,1005,100,,Invoice,,,,,,22/10/2018,22/10/2018,0.00,,18.23,,"-1,062,640.12"
,IN,AR,30328388,1005,100,,Invoice,,,,,,22/10/2018,22/10/2018,0.00,,2.03,,"-1,062,642.15"
,IN,AR,30328389,1005,100,,Invoice,,,,,,22/10/2018,22/10/2018,0.00,,12.15,,"-1,062,654.30"
,IN,AR,30328390,1005,100,,Invoice,,,,,,22/10/2018,22/10/2018,0.00,,8.10,,"-1,062,662.40"
,IN,AR,30328456,1005,100,,Invoice,,,,,,22/10/2018,22/10/2018,0.00,,31.70,,"-1,062,694.10"
,IN,AR,30328465,1005,100,,Invoice,,,,,,22/10/2018,22/10/2018,0.00,,7.29,,"-1,062,701.39"
,IN,AR,30328479,1005,100,,Invoice,,,,,,22/10/2018,22/10/2018,0.00,,3.64,,"-1,062,705.03"
,IN,AR,30328504,1005,100,,Invoice,,,,,,22/10/2018,22/10/2018,0.00,,86.00,,"-1,062,791.03"
,IN,AR,30328518,1005,100,,Invoice,,,,,,22/10/2018,22/10/2018,0.00,,13.77,,"-1,062,804.80"
,IN,AR,30328531,1005,100,,Invoice,,,,,,22/10/2018,22/10/2018,0.00,,62.00,,"-1,062,866.80"
,IN,AR,30328546,1005,100,,Invoice,,,,,,22/10/2018,22/10/2018,0.00,,67.86,,"-1,062,934.66"
,IN,AR,30328558,1005,100,,Invoice,,,,,,22/10/2018,22/10/2018,0.00,,7.29,,"-1,062,941.95"
,IN,AR,30328569,1005,100,,Invoice,,,,,,22/10/2018,22/10/2018,0.00,,30.00,,"-1,062,971.95"
,IN,AR,30328570,1005,100,,Invoice,,,,,,22/10/2018,22/10/2018,0.00,,12.00,,"-1,062,983.95"
,IN,AR,30328585,1005,100,,Invoice,,,,,,22/10/2018,22/10/2018,0.00,,2.75,,"-1,062,986.70"
,IN,AR,30328590,1005,100,,Invoice,,,,,,22/10/2018,22/10/2018,0.00,,43.22,,"-1,063,029.92"
,IN,AR,30328595,1005,100,,Invoice,,,,,,22/10/2018,22/10/2018,0.00,,8.26,,"-1,063,038.18"
,IN,AR,30328626,1005,100,,Invoice,,,,,,22/10/2018,22/10/2018,0.00,,16.00,,"-1,063,054.18"
,IN,AR,30328631,1005,100,,Invoice,,,,,,22/10/2018,22/10/2018,0.00,,18.22,,"-1,063,072.40"
,IN,AR,30328648,1005,100,,Invoice,,,,,,22/10/2018,22/10/2018,0.00,,87.32,,"-1,063,159.72"
,IN,AR,30328682,1005,100,,Invoice,,,,,,22/10/2018,22/10/2018,0.00,,32.00,,"-1,063,191.72"
,IN,AR,30328710,1005,100,,Invoice,,,,,,22/10/2018,22/10/2018,0.00,,12.88,,"-1,063,204.60"
,IN,AR,30328722,1005,100,,Invoice,,,,,,22/10/2018,22/10/2018,0.00,,36.44,,"-1,063,241.04"
,IN,AR,30328726,1005,100,,Invoice,,,,,,22/10/2018,22/10/2018,0.00,,7.29,,"-1,063,248.33"
,IN,AR,30328732,1005,100,,Invoice,,,,,,22/10/2018,22/10/2018,0.00,,14.34,,"-1,063,262.67"
,IN,AR,30328767,1005,100,,Invoice,,,,,,22/10/2018,22/10/2018,0.00,,"1,468.54",,"-1,064,731.21"
,IN,AR,30328770,1005,100,,Invoice,,,,,,22/10/2018,22/10/2018,0.00,,11.48,,"-1,064,742.69"
,IN,AR,30328802,1005,100,,Invoice,,,,,,22/10/2018,22/10/2018,0.00,,4.24,,"-1,064,746.93"
,IN,AR,30328811,1005,100,,Invoice,,,,,,22/10/2018,22/10/2018,0.00,,61.02,,"-1,064,807.95"
,IN,AR,30328839,1005,100,,Invoice,,,,,,22/10/2018,22/10/2018,0.00,,20.68,,"-1,064,828.63"
,IN,AR,30328853,1005,100,,Invoice,,,,,,22/10/2018,22/10/2018,0.00,,10.38,,"-1,064,839.01"
,IN,AR,30328872,1005,100,,Invoice,,,,,,22/10/2018,22/10/2018,0.00,,7.29,,"-1,064,846.30"
,IN,AR,30328904,1005,100,,Invoice,,,,,,22/10/2018,22/10/2018,0.00,,102.54,,"-1,064,948.84"
,IN,AR,30328920,1005,100,,Invoice,,,,,,22/10/2018,22/10/2018,0.00,,25.42,,"-1,064,974.26"
,IN,AR,30328938,1005,100,,Invoice,,,,,,22/10/2018,22/10/2018,0.00,,19.12,,"-1,064,993.38"
,IN,AR,30328939,1005,100,,Invoice,,,,,,22/10/2018,22/10/2018,0.00,,7.17,,"-1,065,000.55"
,IN,AR,30328947,1005,100,,Invoice,,,,,,22/10/2018,22/10/2018,0.00,,25.76,,"-1,065,026.31"
,IN,AR,30328959,1005,100,,Invoice,,,,,,22/10/2018,22/10/2018,0.00,,12.03,,"-1,065,038.34"
,IN,AR,30328971,1005,100,,Invoice,,,,,,22/10/2018,22/10/2018,0.00,,2.12,,"-1,065,040.46"
,IN,AR,30328973,1005,100,,Invoice,,,,,,22/10/2018,22/10/2018,0.00,,14.58,,"-1,065,055.04"
,IN,AR,30328976,1005,100,,Invoice,,,,,,22/10/2018,22/10/2018,0.00,,6.02,,"-1,065,061.06"
,IN,AR,30328995,1005,100,,Invoice,,,,,,22/10/2018,22/10/2018,0.00,,6.02,,"-1,065,067.08"
,IN,AR,30329043,1005,100,,Invoice,,,,,,22/10/2018,22/10/2018,0.00,,10.17,,"-1,065,077.25"
,IN,AR,30329138,1005,100,,Invoice,,,,,,22/10/2018,22/10/2018,0.00,,8.39,,"-1,065,085.64"
,IN,AR,30329158,1005,100,,Invoice,,,,,,22/10/2018,22/10/2018,0.00,,17.80,,"-1,065,103.44"
,IN,AR,30329171,1005,100,,Invoice,,,,,,22/10/2018,22/10/2018,0.00,,30.51,,"-1,065,133.95"
,IN,AR,30329187,1005,100,,Invoice,,,,,,22/10/2018,22/10/2018,0.00,,10.93,,"-1,065,144.88"
,IN,AR,30329204,1005,100,,Invoice,,,,,,22/10/2018,22/10/2018,0.00,,19.28,,"-1,065,164.16"
,IN,AR,30329217,1005,100,,Invoice,,,,,,22/10/2018,22/10/2018,0.00,,10.93,,"-1,065,175.09"
,IN,AR,30329220,1005,100,,Invoice,,,,,,22/10/2018,22/10/2018,0.00,,10.59,,"-1,065,185.68"
,IN,AR,30329246,1005,100,,Invoice,,,,,,22/10/2018,22/10/2018,0.00,,13.77,,"-1,065,199.45"
,IN,AR,30329250,1005,100,,Invoice,,,,,,22/10/2018,22/10/2018,0.00,,3.64,,"-1,065,203.09"
,IN,AR,30329262,1005,100,,Invoice,,,,,,22/10/2018,22/10/2018,0.00,,8.17,,"-1,065,211.26"
,IN,AR,30329266,1005,100,,Invoice,,,,,,22/10/2018,22/10/2018,0.00,,3.64,,"-1,065,214.90"
,IN,AR,30329272,1005,100,,Invoice,,,,,,22/10/2018,22/10/2018,0.00,,11.48,,"-1,065,226.38"
,IN,AR,30329278,1005,100,,Invoice,,,,,,22/10/2018,22/10/2018,0.00,,19.64,,"-1,065,246.02"
,IN,AR,30329286,1005,100,,Invoice,,,,,,22/10/2018,22/10/2018,0.00,,13.14,,"-1,065,259.16"
,IN,AR,30329331,1005,100,,Invoice,,,,,,22/10/2018,22/10/2018,0.00,,8.47,,"-1,065,267.63"
,IN,AR,30329341,1005,100,,Invoice,,,,,,22/10/2018,22/10/2018,0.00,,58.58,,"-1,065,326.21"
,IN,AR,30329394,1005,100,,Invoice,,,,,,22/10/2018,22/10/2018,0.00,,7.75,,"-1,065,333.96"
,IN,AR,30329410,1005,100,,Invoice,,,,,,22/10/2018,22/10/2018,0.00,,45.97,,"-1,065,379.93"
,IN,AR,30329414,1005,100,,Invoice,,,,,,22/10/2018,22/10/2018,0.00,,5.17,,"-1,065,385.10"
,IN,AR,30329419,1005,100,,Invoice,,,,,,22/10/2018,22/10/2018,0.00,,4.49,,"-1,065,389.59"
,IN,AR,30329469,1005,100,,Invoice,,,,,,22/10/2018,22/10/2018,0.00,,21.44,,"-1,065,411.03"
,IN,AR,30329489,1005,100,,Invoice,,,,,,22/10/2018,22/10/2018,0.00,,8.81,,"-1,065,419.84"
,IN,AR,30329505,1005,100,,Invoice,,,,,,22/10/2018,22/10/2018,0.00,,3.64,,"-1,065,423.48"
,IN,AR,30329583,1005,100,,Invoice,,,,,,22/10/2018,22/10/2018,0.00,,4.29,,"-1,065,427.77"
,IN,AR,30329645,1005,100,,Invoice,,,,,,22/10/2018,22/10/2018,0.00,,1.99,,"-1,065,429.76"
,IN,AR,30329646,1005,100,,Invoice,,,,,,22/10/2018,22/10/2018,0.00,,35.85,,"-1,065,465.61"
,IN,AR,30329697,1005,100,,Invoice,,,,,,22/10/2018,22/10/2018,0.00,,34.08,,"-1,065,499.69"
,IN,AR,30329743,1005,100,,Invoice,,,,,,22/10/2018,22/10/2018,0.00,,21.02,,"-1,065,520.71"
,IN,AR,30329748,1005,100,,Invoice,,,,,,22/10/2018,22/10/2018,0.00,,2.29,,"-1,065,523.00"
,IN,AR,30329778,1005,100,,Invoice,,,,,,22/10/2018,22/10/2018,0.00,,14.58,,"-1,065,537.58"
,IN,AR,30329813,1005,100,,Invoice,,,,,,22/10/2018,22/10/2018,0.00,,14.00,,"-1,065,551.58"
,IN,AR,30329831,1005,100,,Invoice,,,,,,22/10/2018,22/10/2018,0.00,,12.00,,"-1,065,563.58"
,IN,AR,30329851,1005,100,,Invoice,,,,,,22/10/2018,22/10/2018,0.00,,63.36,,"-1,065,626.94"
,IN,AR,30329881,1005,100,,Invoice,,,,,,22/10/2018,22/10/2018,0.00,,6.31,,"-1,065,633.25"
,IN,AR,30329882,1005,100,,Invoice,,,,,,22/10/2018,22/10/2018,0.00,,4.20,,"-1,065,637.45"
,IN,AR,30329898,1005,100,,Invoice,,,,,,22/10/2018,22/10/2018,0.00,,14.58,,"-1,065,652.03"
,IN,AR,30329907,1005,100,,Invoice,,,,,,22/10/2018,22/10/2018,0.00,,33.82,,"-1,065,685.85"
,IN,AR,30329911,1005,100,,Invoice,,,,,,22/10/2018,22/10/2018,0.00,,165.47,,"-1,065,851.32"
,IN,AR,30329926,1005,100,,Invoice,,,,,,22/10/2018,22/10/2018,0.00,,16.83,,"-1,065,868.15"
,IN,AR,30329976,1005,100,,Invoice,,,,,,22/10/2018,22/10/2018,0.00,,29.15,,"-1,065,897.30"
,IN,AR,30329986,1005,100,,Invoice,,,,,,22/10/2018,22/10/2018,0.00,,29.36,,"-1,065,926.66"
,IN,AR,30330012,1005,100,,Invoice,,,,,,22/10/2018,22/10/2018,0.00,,12.75,,"-1,065,939.41"
,IN,AR,30330094,1005,100,,Invoice,,,,,,22/10/2018,22/10/2018,0.00,,12.00,,"-1,065,951.41"
,IN,AR,30330098,1005,100,,Invoice,,,,,,22/10/2018,22/10/2018,0.00,,3.64,,"-1,065,955.05"
,IN,AR,30330109,1005,100,,Invoice,,,,,,22/10/2018,22/10/2018,0.00,,1.88,,"-1,065,956.93"
,IN,AR,30330165,1005,100,,Invoice,,,,,,22/10/2018,22/10/2018,0.00,,13.69,,"-1,065,970.62"
,IN,AR,30330200,1005,100,,Invoice,,,,,,22/10/2018,22/10/2018,0.00,,80.17,,"-1,066,050.79"
,IN,AR,30330203,1005,100,,Invoice,,,,,,22/10/2018,22/10/2018,0.00,,7.29,,"-1,066,058.08"
,IN,AR,30330204,1005,100,,Invoice,,,,,,22/10/2018,22/10/2018,0.00,,7.29,,"-1,066,065.37"
,IN,AR,30330228,1005,100,,Invoice,,,,,,22/10/2018,22/10/2018,0.00,,12.25,,"-1,066,077.62"
,IN,AR,30330258,1005,100,,Invoice,,,,,,22/10/2018,22/10/2018,0.00,,40.93,,"-1,066,118.55"
,IN,AR,30330282,1005,100,,Invoice,,,,,,22/10/2018,22/10/2018,0.00,,6.00,,"-1,066,124.55"
,IN,AR,30330283,1005,100,,Invoice,,,,,,22/10/2018,22/10/2018,0.00,,6.00,,"-1,066,130.55"
,IN,AR,30330315,1005,100,,Invoice,,,,,,22/10/2018,22/10/2018,0.00,,6.23,,"-1,066,136.78"
,IN,AR,30330316,1005,100,,Invoice,,,,,,22/10/2018,22/10/2018,0.00,,8.31,,"-1,066,145.09"
,IN,AR,30330317,1005,100,,Invoice,,,,,,22/10/2018,22/10/2018,0.00,,4.15,,"-1,066,149.24"
,IN,AR,30330318,1005,100,,Invoice,,,,,,22/10/2018,22/10/2018,0.00,,2.08,,"-1,066,151.32"
,IN,AR,30330319,1005,100,,Invoice,,,,,,22/10/2018,22/10/2018,0.00,,22.84,,"-1,066,174.16"
,IN,AR,30330320,1005,100,,Invoice,,,,,,22/10/2018,22/10/2018,0.00,,8.31,,"-1,066,182.47"
,IN,AR,30330351,1005,100,,Invoice,,,,,,22/10/2018,22/10/2018,0.00,,9.84,,"-1,066,192.31"
,IN,AR,30330396,1005,100,,Invoice,,,,,,22/10/2018,22/10/2018,0.00,,1.75,,"-1,066,194.06"
,IN,AR,30330414,1005,100,,Invoice,,,,,,22/10/2018,22/10/2018,0.00,,16.82,,"-1,066,210.88"
,IN,AR,30330448,1005,100,,Invoice,,,,,,22/10/2018,22/10/2018,0.00,,119.51,,"-1,066,330.39"
,IN,AR,30330575,1005,100,,Invoice,,,,,,22/10/2018,22/10/2018,0.00,,54.66,,"-1,066,385.05"
,IN,AR,30330593,1005,100,,Invoice,,,,,,22/10/2018,22/10/2018,0.00,,54.66,,"-1,066,439.71"
,IN,AR,30330597,1005,100,,Invoice,,,,,,22/10/2018,22/10/2018,0.00,,54.66,,"-1,066,494.37"
,IN,AR,30330599,1005,100,,Invoice,,,,,,22/10/2018,22/10/2018,0.00,,54.66,,"-1,066,549.03"
,IN,AR,30330622,1005,100,,Invoice,,,,,,22/10/2018,22/10/2018,0.00,,54.66,,"-1,066,603.69"
,IN,AR,30330629,1005,100,,Invoice,,,,,,22/10/2018,22/10/2018,0.00,,54.66,,"-1,066,658.35"
,IN,AR,30330708,1005,100,,Invoice,,,,,,22/10/2018,22/10/2018,0.00,,54.66,,"-1,066,713.01"
,CN,AR,31019234,1005,100,,Credit Note,,,,,,23/10/2018,23/10/2018,12.03,,0.00,,"-1,066,700.98"
,CS,AR,32009723,1005,100,,Cash sale,,,,,,23/10/2018,23/10/2018,0.00,,7.29,,"-1,066,708.27"
,CS,AR,32009740,1005,100,,Cash sale,,,,,,23/10/2018,23/10/2018,0.00,,21.86,,"-1,066,730.13"
,CS,AR,32009763,1005,100,,Cash sale,,,,,,23/10/2018,23/10/2018,0.00,,7.29,,"-1,066,737.42"
,CS,AR,32009767,1005,100,,Cash sale,,,,,,23/10/2018,23/10/2018,0.00,,7.29,,"-1,066,744.71"
,CS,AR,32009785,1005,100,,Cash sale,,,,,,23/10/2018,23/10/2018,0.00,,10.93,,"-1,066,755.64"
,CS,AR,32009796,1005,100,,Cash sale,,,,,,23/10/2018,23/10/2018,0.00,,10.93,,"-1,066,766.57"
,CS,AR,32009798,1005,100,,Cash sale,,,,,,23/10/2018,23/10/2018,0.00,,63.18,,"-1,066,829.75"
,CS,AR,32009809,1005,100,,Cash sale,,,,,,23/10/2018,23/10/2018,0.00,,6.02,,"-1,066,835.77"
,CS,AR,32009815,1005,100,,Cash sale,,,,,,23/10/2018,23/10/2018,0.00,,14.58,,"-1,066,850.35"
,CS,AR,32009874,1005,100,,Cash sale,,,,,,23/10/2018,23/10/2018,0.00,,14.58,,"-1,066,864.93"
,CS,AR,32009888,1005,100,,Cash sale,,,,,,23/10/2018,23/10/2018,0.00,,10.93,,"-1,066,875.86"
,CS,AR,32009907,1005,100,,Cash sale,,,,,,23/10/2018,23/10/2018,0.00,,29.15,,"-1,066,905.01"
,CS,AR,32009916,1005,100,,Cash sale,,,,,,23/10/2018,23/10/2018,0.00,,4.78,,"-1,066,909.79"
,CS,AR,32009922,1005,100,,Cash sale,,,,,,23/10/2018,23/10/2018,0.00,,4.32,,"-1,066,914.11"
,CS,AR,32009946,1005,100,,Cash sale,,,,,,23/10/2018,23/10/2018,0.00,,5.85,,"-1,066,919.96"
,CS,AR,32009954,1005,100,,Cash sale,,,,,,23/10/2018,23/10/2018,0.00,,2.84,,"-1,066,922.80"
,CS,AR,32009963,1005,100,,Cash sale,,,,,,23/10/2018,23/10/2018,0.00,,46.53,,"-1,066,969.33"
,CS,AR,32009990,1005,100,,Cash sale,,,,,,23/10/2018,23/10/2018,0.00,,10.93,,"-1,066,980.26"
,CS,AR,32010021,1005,100,,Cash sale,,,,,,23/10/2018,23/10/2018,0.00,,6.74,,"-1,066,987.00"
,CS,AR,32010030,1005,100,,Cash sale,,,,,,23/10/2018,23/10/2018,0.00,,8.98,,"-1,066,995.98"
,CS,AR,32010031,1005,100,,Cash sale,,,,,,23/10/2018,23/10/2018,0.00,,13.47,,"-1,067,009.45"
,CS,AR,32010039,1005,100,,Cash sale,,,,,,23/10/2018,23/10/2018,0.00,,7.29,,"-1,067,016.74"
,CS,AR,32010061,1005,100,,Cash sale,,,,,,23/10/2018,23/10/2018,0.00,,7.80,,"-1,067,024.54"
,CS,AR,32010073,1005,100,,Cash sale,,,,,,23/10/2018,23/10/2018,0.00,,3.90,,"-1,067,028.44"
,CS,AR,32010084,1005,100,,Cash sale,,,,,,23/10/2018,23/10/2018,0.00,,3.64,,"-1,067,032.08"
,CS,AR,32010093,1005,100,,Cash sale,,,,,,23/10/2018,23/10/2018,0.00,,7.75,,"-1,067,039.83"
,CS,AR,32010109,1005,100,,Cash sale,,,,,,23/10/2018,23/10/2018,0.00,,12.92,,"-1,067,052.75"
,CS,AR,32010114,1005,100,,Cash sale,,,,,,23/10/2018,23/10/2018,0.00,,7.29,,"-1,067,060.04"
,CS,AR,32010138,1005,100,,Cash sale,,,,,,23/10/2018,23/10/2018,0.00,,3.64,,"-1,067,063.68"
,CS,AR,32010186,1005,100,,Cash sale,,,,,,23/10/2018,23/10/2018,0.00,,3.64,,"-1,067,067.32"
,CS,AR,32010209,1005,100,,Cash sale,,,,,,23/10/2018,23/10/2018,0.00,,10.93,,"-1,067,078.25"
,CS,AR,32010231,1005,100,,Cash sale,,,,,,23/10/2018,23/10/2018,0.00,,7.29,,"-1,067,085.54"
,CS,AR,32010243,1005,100,,Cash sale,,,,,,23/10/2018,23/10/2018,0.00,,18.33,,"-1,067,103.87"
,CS,AR,32010251,1005,100,,Cash sale,,,,,,23/10/2018,23/10/2018,0.00,,10.93,,"-1,067,114.80"
,CS,AR,32010272,1005,100,,Cash sale,,,,,,23/10/2018,23/10/2018,0.00,,17.80,,"-1,067,132.60"
,CS,AR,32010276,1005,100,,Cash sale,,,,,,23/10/2018,23/10/2018,0.00,,32.00,,"-1,067,164.60"
,CS,AR,32010312,1005,100,,Cash sale,,,,,,23/10/2018,23/10/2018,0.00,,8.20,,"-1,067,172.80"
,CS,AR,32010363,1005,100,,Cash sale,,,,,,23/10/2018,23/10/2018,0.00,,8.25,,"-1,067,181.05"
,CS,AR,32010393,1005,100,,Cash sale,,,,,,23/10/2018,23/10/2018,0.00,,5.47,,"-1,067,186.52"
,CS,AR,32010445,1005,100,,Cash sale,,,,,,23/10/2018,23/10/2018,0.00,,7.29,,"-1,067,193.81"
,CS,AR,32010471,1005,100,,Cash sale,,,,,,23/10/2018,23/10/2018,0.00,,10.93,,"-1,067,204.74"
,CS,AR,32010552,1005,100,,Cash sale,,,,,,23/10/2018,23/10/2018,0.00,,6.19,,"-1,067,210.93"
,CS,AR,32010558,1005,100,,Cash sale,,,,,,23/10/2018,23/10/2018,0.00,,3.64,,"-1,067,214.57"
,CS,AR,32010573,1005,100,,Cash sale,,,,,,23/10/2018,23/10/2018,0.00,,3.64,,"-1,067,218.21"
,CS,AR,32010577,1005,100,,Cash sale,,,,,,23/10/2018,23/10/2018,0.00,,14.58,,"-1,067,232.79"
,IN,AR,30328308,1005,100,,Invoice,,,,,,23/10/2018,23/10/2018,0.00,,9.03,,"-1,067,241.82"
,IN,AR,30328352,1005,100,,Invoice,,,,,,23/10/2018,23/10/2018,0.00,,36.44,,"-1,067,278.26"
,IN,AR,30328415,1005,100,,Invoice,,,,,,23/10/2018,23/10/2018,0.00,,7.29,,"-1,067,285.55"
,IN,AR,30328445,1005,100,,Invoice,,,,,,23/10/2018,23/10/2018,0.00,,3.64,,"-1,067,289.19"
,IN,AR,30328450,1005,100,,Invoice,,,,,,23/10/2018,23/10/2018,0.00,,7.00,,"-1,067,296.19"
,IN,AR,30328460,1005,100,,Invoice,,,,,,23/10/2018,23/10/2018,0.00,,3.64,,"-1,067,299.83"
,IN,AR,30328486,1005,100,,Invoice,,,,,,23/10/2018,23/10/2018,0.00,,1.99,,"-1,067,301.82"
,IN,AR,30328505,1005,100,,Invoice,,,,,,23/10/2018,23/10/2018,0.00,,54.00,,"-1,067,355.82"
,IN,AR,30328543,1005,100,,Invoice,,,,,,23/10/2018,23/10/2018,0.00,,3.64,,"-1,067,359.46"
,IN,AR,30328555,1005,100,,Invoice,,,,,,23/10/2018,23/10/2018,0.00,,10.93,,"-1,067,370.39"
,IN,AR,30328668,1005,100,,Invoice,,,,,,23/10/2018,23/10/2018,0.00,,9.70,,"-1,067,380.09"
,IN,AR,30328677,1005,100,,Invoice,,,,,,23/10/2018,23/10/2018,0.00,,3.64,,"-1,067,383.73"
,IN,AR,30328692,1005,100,,Invoice,,,,,,23/10/2018,23/10/2018,0.00,,24.73,,"-1,067,408.46"
,IN,AR,30328695,1005,100,,Invoice,,,,,,23/10/2018,23/10/2018,0.00,,7.29,,"-1,067,415.75"
,IN,AR,30328704,1005,100,,Invoice,,,,,,23/10/2018,23/10/2018,0.00,,7.29,,"-1,067,423.04"
,IN,AR,30328753,1005,100,,Invoice,,,,,,23/10/2018,23/10/2018,0.00,,10.34,,"-1,067,433.38"
,IN,AR,30328793,1005,100,,Invoice,,,,,,23/10/2018,23/10/2018,0.00,,10.59,,"-1,067,443.97"
,IN,AR,30328812,1005,100,,Invoice,,,,,,23/10/2018,23/10/2018,0.00,,28.47,,"-1,067,472.44"
,IN,AR,30328826,1005,100,,Invoice,,,,,,23/10/2018,23/10/2018,0.00,,6.36,,"-1,067,478.80"
,IN,AR,30328880,1005,100,,Invoice,,,,,,23/10/2018,23/10/2018,0.00,,12.03,,"-1,067,490.83"
,IN,AR,30328881,1005,100,,Invoice,,,,,,23/10/2018,23/10/2018,0.00,,6.02,,"-1,067,496.85"
,IN,AR,30328893,1005,100,,Invoice,,,,,,23/10/2018,23/10/2018,0.00,,11.69,,"-1,067,508.54"
,IN,AR,30328927,1005,100,,Invoice,,,,,,23/10/2018,23/10/2018,0.00,,5.17,,"-1,067,513.71"
,IN,AR,30328940,1005,100,,Invoice,,,,,,23/10/2018,23/10/2018,0.00,,38.24,,"-1,067,551.95"
,IN,AR,30329069,1005,100,,Invoice,,,,,,23/10/2018,23/10/2018,0.00,,5.85,,"-1,067,557.80"
,IN,AR,30329074,1005,100,,Invoice,,,,,,23/10/2018,23/10/2018,0.00,,12.71,,"-1,067,570.51"
,IN,AR,30329081,1005,100,,Invoice,,,,,,23/10/2018,23/10/2018,0.00,,36.44,,"-1,067,606.95"
,IN,AR,30329130,1005,100,,Invoice,,,,,,23/10/2018,23/10/2018,0.00,,7.29,,"-1,067,614.24"
,IN,AR,30329149,1005,100,,Invoice,,,,,,23/10/2018,23/10/2018,0.00,,17.80,,"-1,067,632.04"
,IN,AR,30329161,1005,100,,Invoice,,,,,,23/10/2018,23/10/2018,0.00,,11.70,,"-1,067,643.74"
,IN,AR,30329167,1005,100,,Invoice,,,,,,23/10/2018,23/10/2018,0.00,,3.01,,"-1,067,646.75"
,IN,AR,30329173,1005,100,,Invoice,,,,,,23/10/2018,23/10/2018,0.00,,4.08,,"-1,067,650.83"
,IN,AR,30329181,1005,100,,Invoice,,,,,,23/10/2018,23/10/2018,0.00,,11.57,,"-1,067,662.40"
,IN,AR,30329193,1005,100,,Invoice,,,,,,23/10/2018,23/10/2018,0.00,,10.17,,"-1,067,672.57"
,IN,AR,30329201,1005,100,,Invoice,,,,,,23/10/2018,23/10/2018,0.00,,10.53,,"-1,067,683.10"
,IN,AR,30329222,1005,100,,Invoice,,,,,,23/10/2018,23/10/2018,0.00,,12.71,,"-1,067,695.81"
,IN,AR,30329236,1005,100,,Invoice,,,,,,23/10/2018,23/10/2018,0.00,,4.24,,"-1,067,700.05"
,IN,AR,30329242,1005,100,,Invoice,,,,,,23/10/2018,23/10/2018,0.00,,6.48,,"-1,067,706.53"
,IN,AR,30329253,1005,100,,Invoice,,,,,,23/10/2018,23/10/2018,0.00,,5.08,,"-1,067,711.61"
,IN,AR,30329255,1005,100,,Invoice,,,,,,23/10/2018,23/10/2018,0.00,,7.29,,"-1,067,718.90"
,IN,AR,30329360,1005,100,,Invoice,,,,,,23/10/2018,23/10/2018,0.00,,26.31,,"-1,067,745.21"
,IN,AR,30329387,1005,100,,Invoice,,,,,,23/10/2018,23/10/2018,0.00,,5.59,,"-1,067,750.80"
,IN,AR,30329399,1005,100,,Invoice,,,,,,23/10/2018,23/10/2018,0.00,,5.86,,"-1,067,756.66"
,IN,AR,30329437,1005,100,,Invoice,,,,,,23/10/2018,23/10/2018,0.00,,21.98,,"-1,067,778.64"
,IN,AR,30329440,1005,100,,Invoice,,,,,,23/10/2018,23/10/2018,0.00,,31.14,,"-1,067,809.78"
,IN,AR,30329450,1005,100,,Invoice,,,,,,23/10/2018,23/10/2018,0.00,,7.29,,"-1,067,817.07"
,IN,AR,30329455,1005,100,,Invoice,,,,,,23/10/2018,23/10/2018,0.00,,30.02,,"-1,067,847.09"
,IN,AR,30329465,1005,100,,Invoice,,,,,,23/10/2018,23/10/2018,0.00,,3.76,,"-1,067,850.85"
,IN,AR,30329490,1005,100,,Invoice,,,,,,23/10/2018,23/10/2018,0.00,,3.53,,"-1,067,854.38"
,IN,AR,30329491,1005,100,,Invoice,,,,,,23/10/2018,23/10/2018,0.00,,3.53,,"-1,067,857.91"
,IN,AR,30329524,1005,100,,Invoice,,,,,,23/10/2018,23/10/2018,0.00,,5.17,,"-1,067,863.08"
,IN,AR,30329529,1005,100,,Invoice,,,,,,23/10/2018,23/10/2018,0.00,,5.47,,"-1,067,868.55"
,IN,AR,30329545,1005,100,,Invoice,,,,,,23/10/2018,23/10/2018,0.00,,18.22,,"-1,067,886.77"
,IN,AR,30329550,1005,100,,Invoice,,,,,,23/10/2018,23/10/2018,0.00,,8.78,,"-1,067,895.55"
,IN,AR,30329647,1005,100,,Invoice,,,,,,23/10/2018,23/10/2018,0.00,,5.97,,"-1,067,901.52"
,IN,AR,30329648,1005,100,,Invoice,,,,,,23/10/2018,23/10/2018,0.00,,7.97,,"-1,067,909.49"
,IN,AR,30329668,1005,100,,Invoice,,,,,,23/10/2018,23/10/2018,0.00,,56.78,,"-1,067,966.27"
,IN,AR,30329715,1005,100,,Invoice,,,,,,23/10/2018,23/10/2018,0.00,,6.02,,"-1,067,972.29"
,IN,AR,30329729,1005,100,,Invoice,,,,,,23/10/2018,23/10/2018,0.00,,198.97,,"-1,068,171.26"
,IN,AR,30329783,1005,100,,Invoice,,,,,,23/10/2018,23/10/2018,0.00,,7.29,,"-1,068,178.55"
,IN,AR,30329799,1005,100,,Invoice,,,,,,23/10/2018,23/10/2018,0.00,,5.08,,"-1,068,183.63"
,IN,AR,30329820,1005,100,,Invoice,,,,,,23/10/2018,23/10/2018,0.00,,14.00,,"-1,068,197.63"
,IN,AR,30329841,1005,100,,Invoice,,,,,,23/10/2018,23/10/2018,0.00,,29.15,,"-1,068,226.78"
,IN,AR,30329912,1005,100,,Invoice,,,,,,23/10/2018,23/10/2018,0.00,,86.23,,"-1,068,313.01"
,IN,AR,30329920,1005,100,,Invoice,,,,,,23/10/2018,23/10/2018,0.00,,2.74,,"-1,068,315.75"
,IN,AR,30329942,1005,100,,Invoice,,,,,,23/10/2018,23/10/2018,0.00,,6.42,,"-1,068,322.17"
,IN,AR,30329946,1005,100,,Invoice,,,,,,23/10/2018,23/10/2018,0.00,,128.00,,"-1,068,450.17"
,IN,AR,30329959,1005,100,,Invoice,,,,,,23/10/2018,23/10/2018,0.00,,23.73,,"-1,068,473.90"
,IN,AR,30329975,1005,100,,Invoice,,,,,,23/10/2018,23/10/2018,0.00,,2.54,,"-1,068,476.44"
,IN,AR,30330026,1005,100,,Invoice,,,,,,23/10/2018,23/10/2018,0.00,,105.76,,"-1,068,582.20"
,IN,AR,30330071,1005,100,,Invoice,,,,,,23/10/2018,23/10/2018,0.00,,14.24,,"-1,068,596.44"
,IN,AR,30330072,1005,100,,Invoice,,,,,,23/10/2018,23/10/2018,0.00,,121.03,,"-1,068,717.47"
,IN,AR,30330073,1005,100,,Invoice,,,,,,23/10/2018,23/10/2018,0.00,,18.98,,"-1,068,736.45"
,IN,AR,30330084,1005,100,,Invoice,,,,,,23/10/2018,23/10/2018,0.00,,14.24,,"-1,068,750.69"
,IN,AR,30330088,1005,100,,Invoice,,,,,,23/10/2018,23/10/2018,0.00,,3.64,,"-1,068,754.33"
,IN,AR,30330118,1005,100,,Invoice,,,,,,23/10/2018,23/10/2018,0.00,,5.26,,"-1,068,759.59"
,IN,AR,30330123,1005,100,,Invoice,,,,,,23/10/2018,23/10/2018,0.00,,10.00,,"-1,068,769.59"
,IN,AR,30330127,1005,100,,Invoice,,,,,,23/10/2018,23/10/2018,0.00,,5.93,,"-1,068,775.52"
,IN,AR,30330129,1005,100,,Invoice,,,,,,23/10/2018,23/10/2018,0.00,,29.15,,"-1,068,804.67"
,IN,AR,30330138,1005,100,,Invoice,,,,,,23/10/2018,23/10/2018,0.00,,70.59,,"-1,068,875.26"
,IN,AR,30330151,1005,100,,Invoice,,,,,,23/10/2018,23/10/2018,0.00,,7.02,,"-1,068,882.28"
,IN,AR,30330201,1005,100,,Invoice,,,,,,23/10/2018,23/10/2018,0.00,,145.76,,"-1,069,028.04"
,IN,AR,30330229,1005,100,,Invoice,,,,,,23/10/2018,23/10/2018,0.00,,30.64,,"-1,069,058.68"
,IN,AR,30330230,1005,100,,Invoice,,,,,,23/10/2018,23/10/2018,0.00,,12.25,,"-1,069,070.93"
,IN,AR,30330242,1005,100,,Invoice,,,,,,23/10/2018,23/10/2018,0.00,,7.29,,"-1,069,078.22"
,IN,AR,30330248,1005,100,,Invoice,,,,,,23/10/2018,23/10/2018,0.00,,11.19,,"-1,069,089.41"
,IN,AR,30330253,1005,100,,Invoice,,,,,,23/10/2018,23/10/2018,0.00,,7.97,,"-1,069,097.38"
,IN,AR,30330321,1005,100,,Invoice,,,,,,23/10/2018,23/10/2018,0.00,,8.31,,"-1,069,105.69"
,IN,AR,30330322,1005,100,,Invoice,,,,,,23/10/2018,23/10/2018,0.00,,8.31,,"-1,069,114.00"
,IN,AR,30330323,1005,100,,Invoice,,,,,,23/10/2018,23/10/2018,0.00,,16.61,,"-1,069,130.61"
,IN,AR,30330347,1005,100,,Invoice,,,,,,23/10/2018,23/10/2018,0.00,,25.42,,"-1,069,156.03"
,IN,AR,30330354,1005,100,,Invoice,,,,,,23/10/2018,23/10/2018,0.00,,19.32,,"-1,069,175.35"
,IN,AR,30330373,1005,100,,Invoice,,,,,,23/10/2018,23/10/2018,0.00,,7.29,,"-1,069,182.64"
,IN,AR,30330386,1005,100,,Invoice,,,,,,23/10/2018,23/10/2018,0.00,,13.56,,"-1,069,196.20"
,IN,AR,30330444,1005,100,,Invoice,,,,,,23/10/2018,23/10/2018,0.00,,14.83,,"-1,069,211.03"
,IN,AR,30330453,1005,100,,Invoice,,,,,,23/10/2018,23/10/2018,0.00,,7.29,,"-1,069,218.32"
,IN,AR,30330461,1005,100,,Invoice,,,,,,23/10/2018,23/10/2018,0.00,,15.17,,"-1,069,233.49"
,IN,AR,30330473,1005,100,,Invoice,,,,,,23/10/2018,23/10/2018,0.00,,7.29,,"-1,069,240.78"
,IN,AR,30330514,1005,100,,Invoice,,,,,,23/10/2018,23/10/2018,0.00,,7.29,,"-1,069,248.07"
,CS,AR,32010628,1005,100,,Cash sale,,,,,,23/10/2018,23/10/2018,0.00,,54.66,,"-1,069,302.73"
,IN,AR,30330539,1005,100,,Invoice,,,,,,23/10/2018,23/10/2018,0.00,,364.41,,"-1,069,667.14"
,IN,AR,30330540,1005,100,,Invoice,,,,,,23/10/2018,23/10/2018,0.00,,364.41,,"-1,070,031.55"
,IN,AR,30330554,1005,100,,Invoice,,,,,,23/10/2018,23/10/2018,0.00,,364.41,,"-1,070,395.96"
,IN,AR,30330565,1005,100,,Invoice,,,,,,23/10/2018,23/10/2018,0.00,,364.41,,"-1,070,760.37"
,IN,AR,30330578,1005,100,,Invoice,,,,,,23/10/2018,23/10/2018,0.00,,"1,093.22",,"-1,071,853.59"
,IN,AR,30330592,1005,100,,Invoice,,,,,,23/10/2018,23/10/2018,0.00,,364.41,,"-1,072,218.00"
,IN,AR,30330609,1005,100,,Invoice,,,,,,23/10/2018,23/10/2018,0.00,,182.20,,"-1,072,400.20"
,IN,AR,30330616,1005,100,,Invoice,,,,,,23/10/2018,23/10/2018,0.00,,182.20,,"-1,072,582.40"
,IN,AR,30330695,1005,100,,Invoice,,,,,,23/10/2018,23/10/2018,0.00,,364.41,,"-1,072,946.81"
,IN,AR,30330719,1005,100,,Invoice,,,,,,23/10/2018,23/10/2018,0.00,,419.07,,"-1,073,365.88"
,IN,AR,30330720,1005,100,,Invoice,,,,,,23/10/2018,23/10/2018,0.00,,54.66,,"-1,073,420.54"
,CN,AR,31019355,1005,100,,Credit Note,,,,,,24/10/2018,24/10/2018,8.31,,0.00,,"-1,073,412.23"
,CS,AR,32009727,1005,100,,Cash sale,,,,,,24/10/2018,24/10/2018,0.00,,30.10,,"-1,073,442.33"
,CS,AR,32009748,1005,100,,Cash sale,,,,,,24/10/2018,24/10/2018,0.00,,7.29,,"-1,073,449.62"
,CS,AR,32009754,1005,100,,Cash sale,,,,,,24/10/2018,24/10/2018,0.00,,3.64,,"-1,073,453.26"
,CS,AR,32009774,1005,100,,Cash sale,,,,,,24/10/2018,24/10/2018,0.00,,3.64,,"-1,073,456.90"
,CS,AR,32009818,1005,100,,Cash sale,,,,,,24/10/2018,24/10/2018,0.00,,3.64,,"-1,073,460.54"
,CS,AR,32009819,1005,100,,Cash sale,,,,,,24/10/2018,24/10/2018,0.00,,7.29,,"-1,073,467.83"
,CS,AR,32009843,1005,100,,Cash sale,,,,,,24/10/2018,24/10/2018,0.00,,9.03,,"-1,073,476.86"
,CS,AR,32009860,1005,100,,Cash sale,,,,,,24/10/2018,24/10/2018,0.00,,8.77,,"-1,073,485.63"
,CS,AR,32009896,1005,100,,Cash sale,,,,,,24/10/2018,24/10/2018,0.00,,2.92,,"-1,073,488.55"
,CS,AR,32009918,1005,100,,Cash sale,,,,,,24/10/2018,24/10/2018,0.00,,3.64,,"-1,073,492.19"
,CS,AR,32009957,1005,100,,Cash sale,,,,,,24/10/2018,24/10/2018,0.00,,12.92,,"-1,073,505.11"
,CS,AR,32009974,1005,100,,Cash sale,,,,,,24/10/2018,24/10/2018,0.00,,24.07,,"-1,073,529.18"
,CS,AR,32009977,1005,100,,Cash sale,,,,,,24/10/2018,24/10/2018,0.00,,6.43,,"-1,073,535.61"
,CS,AR,32009994,1005,100,,Cash sale,,,,,,24/10/2018,24/10/2018,0.00,,18.22,,"-1,073,553.83"
,CS,AR,32010015,1005,100,,Cash sale,,,,,,24/10/2018,24/10/2018,0.00,,7.63,,"-1,073,561.46"
,CS,AR,32010069,1005,100,,Cash sale,,,,,,24/10/2018,24/10/2018,0.00,,3.64,,"-1,073,565.10"
,CS,AR,32010126,1005,100,,Cash sale,,,,,,24/10/2018,24/10/2018,0.00,,15.51,,"-1,073,580.61"
,CS,AR,32010162,1005,100,,Cash sale,,,,,,24/10/2018,24/10/2018,0.00,,3.64,,"-1,073,584.25"
,CS,AR,32010225,1005,100,,Cash sale,,,,,,24/10/2018,24/10/2018,0.00,,10.93,,"-1,073,595.18"
,CS,AR,32010228,1005,100,,Cash sale,,,,,,24/10/2018,24/10/2018,0.00,,18.98,,"-1,073,614.16"
,CS,AR,32010266,1005,100,,Cash sale,,,,,,24/10/2018,24/10/2018,0.00,,7.29,,"-1,073,621.45"
,CS,AR,32010289,1005,100,,Cash sale,,,,,,24/10/2018,24/10/2018,0.00,,8.26,,"-1,073,629.71"
,CS,AR,32010301,1005,100,,Cash sale,,,,,,24/10/2018,24/10/2018,0.00,,6.07,,"-1,073,635.78"
,CS,AR,32010316,1005,100,,Cash sale,,,,,,24/10/2018,24/10/2018,0.00,,3.28,,"-1,073,639.06"
,CS,AR,32010327,1005,100,,Cash sale,,,,,,24/10/2018,24/10/2018,0.00,,11.44,,"-1,073,650.50"
,CS,AR,32010373,1005,100,,Cash sale,,,,,,24/10/2018,24/10/2018,0.00,,12.03,,"-1,073,662.53"
,CS,AR,32010401,1005,100,,Cash sale,,,,,,24/10/2018,24/10/2018,0.00,,3.64,,"-1,073,666.17"
,CS,AR,32010429,1005,100,,Cash sale,,,,,,24/10/2018,24/10/2018,0.00,,7.29,,"-1,073,673.46"
,CS,AR,32010475,1005,100,,Cash sale,,,,,,24/10/2018,24/10/2018,0.00,,16.48,,"-1,073,689.94"
,CS,AR,32010476,1005,100,,Cash sale,,,,,,24/10/2018,24/10/2018,0.00,,10.93,,"-1,073,700.87"
,CS,AR,32010481,1005,100,,Cash sale,,,,,,24/10/2018,24/10/2018,0.00,,7.29,,"-1,073,708.16"
,CS,AR,32010499,1005,100,,Cash sale,,,,,,24/10/2018,24/10/2018,0.00,,5.94,,"-1,073,714.10"
,IN,AR,30328324,1005,100,,Invoice,,,,,,24/10/2018,24/10/2018,0.00,,17.80,,"-1,073,731.90"
,IN,AR,30328360,1005,100,,Invoice,,,,,,24/10/2018,24/10/2018,0.00,,24.41,,"-1,073,756.31"
,IN,AR,30328361,1005,100,,Invoice,,,,,,24/10/2018,24/10/2018,0.00,,2.44,,"-1,073,758.75"
,IN,AR,30328362,1005,100,,Invoice,,,,,,24/10/2018,24/10/2018,0.00,,31.73,,"-1,073,790.48"
,IN,AR,30328408,1005,100,,Invoice,,,,,,24/10/2018,24/10/2018,0.00,,8.52,,"-1,073,799.00"
,IN,AR,30328412,1005,100,,Invoice,,,,,,24/10/2018,24/10/2018,0.00,,47.80,,"-1,073,846.80"
,IN,AR,30328423,1005,100,,Invoice,,,,,,24/10/2018,24/10/2018,0.00,,70.93,,"-1,073,917.73"
,IN,AR,30328424,1005,100,,Invoice,,,,,,24/10/2018,24/10/2018,0.00,,28.90,,"-1,073,946.63"
,IN,AR,30328430,1005,100,,Invoice,,,,,,24/10/2018,24/10/2018,0.00,,7.29,,"-1,073,953.92"
,IN,AR,30328436,1005,100,,Invoice,,,,,,24/10/2018,24/10/2018,0.00,,7.25,,"-1,073,961.17"
,IN,AR,30328487,1005,100,,Invoice,,,,,,24/10/2018,24/10/2018,0.00,,5.97,,"-1,073,967.14"
,IN,AR,30328506,1005,100,,Invoice,,,,,,24/10/2018,24/10/2018,0.00,,46.00,,"-1,074,013.14"
,IN,AR,30328541,1005,100,,Invoice,,,,,,24/10/2018,24/10/2018,0.00,,7.29,,"-1,074,020.43"
,IN,AR,30328553,1005,100,,Invoice,,,,,,24/10/2018,24/10/2018,0.00,,14.58,,"-1,074,035.01"
,IN,AR,30328571,1005,100,,Invoice,,,,,,24/10/2018,24/10/2018,0.00,,20.00,,"-1,074,055.01"
,IN,AR,30328607,1005,100,,Invoice,,,,,,24/10/2018,24/10/2018,0.00,,32.00,,"-1,074,087.01"
,IN,AR,30328649,1005,100,,Invoice,,,,,,24/10/2018,24/10/2018,0.00,,8.19,,"-1,074,095.20"
,IN,AR,30328650,1005,100,,Invoice,,,,,,24/10/2018,24/10/2018,0.00,,46.39,,"-1,074,141.59"
,IN,AR,30328651,1005,100,,Invoice,,,,,,24/10/2018,24/10/2018,0.00,,122.80,,"-1,074,264.39"
,IN,AR,30328660,1005,100,,Invoice,,,,,,24/10/2018,24/10/2018,0.00,,764.69,,"-1,075,029.08"
,IN,AR,30328699,1005,100,,Invoice,,,,,,24/10/2018,24/10/2018,0.00,,3.01,,"-1,075,032.09"
,IN,AR,30328717,1005,100,,Invoice,,,,,,24/10/2018,24/10/2018,0.00,,45.09,,"-1,075,077.18"
,IN,AR,30328733,1005,100,,Invoice,,,,,,24/10/2018,24/10/2018,0.00,,9.56,,"-1,075,086.74"
,IN,AR,30328739,1005,100,,Invoice,,,,,,24/10/2018,24/10/2018,0.00,,23.26,,"-1,075,110.00"
,IN,AR,30328782,1005,100,,Invoice,,,,,,24/10/2018,24/10/2018,0.00,,25.42,,"-1,075,135.42"
,IN,AR,30328795,1005,100,,Invoice,,,,,,24/10/2018,24/10/2018,0.00,,4.24,,"-1,075,139.66"
,IN,AR,30328798,1005,100,,Invoice,,,,,,24/10/2018,24/10/2018,0.00,,4.24,,"-1,075,143.90"
,IN,AR,30328820,1005,100,,Invoice,,,,,,24/10/2018,24/10/2018,0.00,,4.24,,"-1,075,148.14"
,IN,AR,30328829,1005,100,,Invoice,,,,,,24/10/2018,24/10/2018,0.00,,11.19,,"-1,075,159.33"
,IN,AR,30328868,1005,100,,Invoice,,,,,,24/10/2018,24/10/2018,0.00,,14.58,,"-1,075,173.91"
,IN,AR,30328886,1005,100,,Invoice,,,,,,24/10/2018,24/10/2018,0.00,,23.90,,"-1,075,197.81"
,IN,AR,30328905,1005,100,,Invoice,,,,,,24/10/2018,24/10/2018,0.00,,55.37,,"-1,075,253.18"
,IN,AR,30328912,1005,100,,Invoice,,,,,,24/10/2018,24/10/2018,0.00,,7.29,,"-1,075,260.47"
,IN,AR,30328921,1005,100,,Invoice,,,,,,24/10/2018,24/10/2018,0.00,,43.22,,"-1,075,303.69"
,IN,AR,30328979,1005,100,,Invoice,,,,,,24/10/2018,24/10/2018,0.00,,8.26,,"-1,075,311.95"
,IN,AR,30328983,1005,100,,Invoice,,,,,,24/10/2018,24/10/2018,0.00,,5.17,,"-1,075,317.12"
,IN,AR,30328999,1005,100,,Invoice,,,,,,24/10/2018,24/10/2018,0.00,,186.06,,"-1,075,503.18"
,IN,AR,30329027,1005,100,,Invoice,,,,,,24/10/2018,24/10/2018,0.00,,69.24,,"-1,075,572.42"
,IN,AR,30329061,1005,100,,Invoice,,,,,,24/10/2018,24/10/2018,0.00,,23.91,,"-1,075,596.33"
,IN,AR,30329140,1005,100,,Invoice,,,,,,24/10/2018,24/10/2018,0.00,,2.58,,"-1,075,598.91"
,IN,AR,30329145,1005,100,,Invoice,,,,,,24/10/2018,24/10/2018,0.00,,18.17,,"-1,075,617.08"
,IN,AR,30329208,1005,100,,Invoice,,,,,,24/10/2018,24/10/2018,0.00,,7.29,,"-1,075,624.37"
,IN,AR,30329231,1005,100,,Invoice,,,,,,24/10/2018,24/10/2018,0.00,,14.58,,"-1,075,638.95"
,IN,AR,30329259,1005,100,,Invoice,,,,,,24/10/2018,24/10/2018,0.00,,7.29,,"-1,075,646.24"
,IN,AR,30329306,1005,100,,Invoice,,,,,,24/10/2018,24/10/2018,0.00,,16.78,,"-1,075,663.02"
,IN,AR,30329318,1005,100,,Invoice,,,,,,24/10/2018,24/10/2018,0.00,,1.88,,"-1,075,664.90"
,IN,AR,30329323,1005,100,,Invoice,,,,,,24/10/2018,24/10/2018,0.00,,14.58,,"-1,075,679.48"
,IN,AR,30329329,1005,100,,Invoice,,,,,,24/10/2018,24/10/2018,0.00,,14.58,,"-1,075,694.06"
,IN,AR,30329336,1005,100,,Invoice,,,,,,24/10/2018,24/10/2018,0.00,,25.17,,"-1,075,719.23"
,IN,AR,30329345,1005,100,,Invoice,,,,,,24/10/2018,24/10/2018,0.00,,15.25,,"-1,075,734.48"
,IN,AR,30329355,1005,100,,Invoice,,,,,,24/10/2018,24/10/2018,0.00,,40.00,,"-1,075,774.48"
,IN,AR,30329406,1005,100,,Invoice,,,,,,24/10/2018,24/10/2018,0.00,,37.12,,"-1,075,811.60"
,IN,AR,30329424,1005,100,,Invoice,,,,,,24/10/2018,24/10/2018,0.00,,30.08,,"-1,075,841.68"
,IN,AR,30329441,1005,100,,Invoice,,,,,,24/10/2018,24/10/2018,0.00,,41.53,,"-1,075,883.21"
,IN,AR,30329470,1005,100,,Invoice,,,,,,24/10/2018,24/10/2018,0.00,,45.03,,"-1,075,928.24"
,IN,AR,30329492,1005,100,,Invoice,,,,,,24/10/2018,24/10/2018,0.00,,3.53,,"-1,075,931.77"
,IN,AR,30329499,1005,100,,Invoice,,,,,,24/10/2018,24/10/2018,0.00,,15.04,,"-1,075,946.81"
,IN,AR,30329537,1005,100,,Invoice,,,,,,24/10/2018,24/10/2018,0.00,,7.75,,"-1,075,954.56"
,IN,AR,30329553,1005,100,,Invoice,,,,,,24/10/2018,24/10/2018,0.00,,14.00,,"-1,075,968.56"
,IN,AR,30329560,1005,100,,Invoice,,,,,,24/10/2018,24/10/2018,0.00,,32.80,,"-1,076,001.36"
,IN,AR,30329561,1005,100,,Invoice,,,,,,24/10/2018,24/10/2018,0.00,,21.86,,"-1,076,023.22"
,IN,AR,30329613,1005,100,,Invoice,,,,,,24/10/2018,24/10/2018,0.00,,15.25,,"-1,076,038.47"
,IN,AR,30329618,1005,100,,Invoice,,,,,,24/10/2018,24/10/2018,0.00,,10.93,,"-1,076,049.40"
,IN,AR,30329663,1005,100,,Invoice,,,,,,24/10/2018,24/10/2018,0.00,,19.47,,"-1,076,068.87"
,IN,AR,30329674,1005,100,,Invoice,,,,,,24/10/2018,24/10/2018,0.00,,28.00,,"-1,076,096.87"
,IN,AR,30329689,1005,100,,Invoice,,,,,,24/10/2018,24/10/2018,0.00,,40.08,,"-1,076,136.95"
,IN,AR,30329698,1005,100,,Invoice,,,,,,24/10/2018,24/10/2018,0.00,,24.05,,"-1,076,161.00"
,IN,AR,30329707,1005,100,,Invoice,,,,,,24/10/2018,24/10/2018,0.00,,18.22,,"-1,076,179.22"
,IN,AR,30329724,1005,100,,Invoice,,,,,,24/10/2018,24/10/2018,0.00,,34.58,,"-1,076,213.80"
,IN,AR,30329759,1005,100,,Invoice,,,,,,24/10/2018,24/10/2018,0.00,,12.73,,"-1,076,226.53"
,IN,AR,30329768,1005,100,,Invoice,,,,,,24/10/2018,24/10/2018,0.00,,28.46,,"-1,076,254.99"
,IN,AR,30329800,1005,100,,Invoice,,,,,,24/10/2018,24/10/2018,0.00,,5.08,,"-1,076,260.07"
,IN,AR,30329832,1005,100,,Invoice,,,,,,24/10/2018,24/10/2018,0.00,,29.15,,"-1,076,289.22"
,IN,AR,30329845,1005,100,,Invoice,,,,,,24/10/2018,24/10/2018,0.00,,102.20,,"-1,076,391.42"
,IN,AR,30329852,1005,100,,Invoice,,,,,,24/10/2018,24/10/2018,0.00,,4.53,,"-1,076,395.95"
,IN,AR,30329861,1005,100,,Invoice,,,,,,24/10/2018,24/10/2018,0.00,,2.92,,"-1,076,398.87"
,IN,AR,30329883,1005,100,,Invoice,,,,,,24/10/2018,24/10/2018,0.00,,27.33,,"-1,076,426.20"
,IN,AR,30329884,1005,100,,Invoice,,,,,,24/10/2018,24/10/2018,0.00,,10.52,,"-1,076,436.72"
,IN,AR,30329891,1005,100,,Invoice,,,,,,24/10/2018,24/10/2018,0.00,,32.39,,"-1,076,469.11"
,IN,AR,30329955,1005,100,,Invoice,,,,,,24/10/2018,24/10/2018,0.00,,7.29,,"-1,076,476.40"
,IN,AR,30329969,1005,100,,Invoice,,,,,,24/10/2018,24/10/2018,0.00,,7.29,,"-1,076,483.69"
,IN,AR,30329991,1005,100,,Invoice,,,,,,24/10/2018,24/10/2018,0.00,,10.93,,"-1,076,494.62"
,IN,AR,30330013,1005,100,,Invoice,,,,,,24/10/2018,24/10/2018,0.00,,15.93,,"-1,076,510.55"
,IN,AR,30330114,1005,100,,Invoice,,,,,,24/10/2018,24/10/2018,0.00,,3.51,,"-1,076,514.06"
,IN,AR,30330182,1005,100,,Invoice,,,,,,24/10/2018,24/10/2018,0.00,,9.41,,"-1,076,523.47"
,IN,AR,30330217,1005,100,,Invoice,,,,,,24/10/2018,24/10/2018,0.00,,7.86,,"-1,076,531.33"
,IN,AR,30330266,1005,100,,Invoice,,,,,,24/10/2018,24/10/2018,0.00,,18.31,,"-1,076,549.64"
,IN,AR,30330324,1005,100,,Invoice,,,,,,24/10/2018,24/10/2018,0.00,,62.29,,"-1,076,611.93"
,IN,AR,30330325,1005,100,,Invoice,,,,,,24/10/2018,24/10/2018,0.00,,10.38,,"-1,076,622.31"
,IN,AR,30330326,1005,100,,Invoice,,,,,,24/10/2018,24/10/2018,0.00,,8.31,,"-1,076,630.62"
,IN,AR,30330327,1005,100,,Invoice,,,,,,24/10/2018,24/10/2018,0.00,,12.46,,"-1,076,643.08"
,IN,AR,30330363,1005,100,,Invoice,,,,,,24/10/2018,24/10/2018,0.00,,24.27,,"-1,076,667.35"
,IN,AR,30330390,1005,100,,Invoice,,,,,,24/10/2018,24/10/2018,0.00,,21.86,,"-1,076,689.21"
,IN,AR,30330420,1005,100,,Invoice,,,,,,24/10/2018,24/10/2018,0.00,,10.93,,"-1,076,700.14"
,IN,AR,30330424,1005,100,,Invoice,,,,,,24/10/2018,24/10/2018,0.00,,16.78,,"-1,076,716.92"
,IN,AR,30330436,1005,100,,Invoice,,,,,,24/10/2018,24/10/2018,0.00,,124.39,,"-1,076,841.31"
,IN,AR,30330486,1005,100,,Invoice,,,,,,24/10/2018,24/10/2018,0.00,,7.29,,"-1,076,848.60"
,IN,AR,30330492,1005,100,,Invoice,,,,,,24/10/2018,24/10/2018,0.00,,12.58,,"-1,076,861.18"
,IN,AR,30330493,1005,100,,Invoice,,,,,,24/10/2018,24/10/2018,0.00,,5.39,,"-1,076,866.57"
,IN,AR,30330499,1005,100,,Invoice,,,,,,24/10/2018,24/10/2018,0.00,,10.93,,"-1,076,877.50"
,IN,AR,30330603,1005,100,,Invoice,,,,,,24/10/2018,24/10/2018,0.00,,182.20,,"-1,077,059.70"
,IN,AR,30330618,1005,100,,Invoice,,,,,,24/10/2018,24/10/2018,0.00,,54.66,,"-1,077,114.36"
,IN,AR,30330721,1005,100,,Invoice,,,,,,24/10/2018,24/10/2018,0.00,,72.88,,"-1,077,187.24"
,IN,AR,30330722,1005,100,,Invoice,,,,,,24/10/2018,24/10/2018,0.00,,54.66,,"-1,077,241.90"
,IN,AR,30330723,1005,100,,Invoice,,,,,,24/10/2018,24/10/2018,0.00,,182.20,,"-1,077,424.10"
,CN,AR,31019250,1005,100,,Credit Note,,,,,,25/10/2018,25/10/2018,36.44,,0.00,,"-1,077,387.66"
,CS,AR,32009710,1005,100,,Cash sale,,,,,,25/10/2018,25/10/2018,0.00,,18.05,,"-1,077,405.71"
,CS,AR,32009721,1005,100,,Cash sale,,,,,,25/10/2018,25/10/2018,0.00,,10.93,,"-1,077,416.64"
,CS,AR,32009736,1005,100,,Cash sale,,,,,,25/10/2018,25/10/2018,0.00,,3.64,,"-1,077,420.28"
,CS,AR,32009738,1005,100,,Cash sale,,,,,,25/10/2018,25/10/2018,0.00,,5.68,,"-1,077,425.96"
,CS,AR,32009746,1005,100,,Cash sale,,,,,,25/10/2018,25/10/2018,0.00,,3.64,,"-1,077,429.60"
,CS,AR,32009777,1005,100,,Cash sale,,,,,,25/10/2018,25/10/2018,0.00,,7.29,,"-1,077,436.89"
,CS,AR,32009794,1005,100,,Cash sale,,,,,,25/10/2018,25/10/2018,0.00,,3.64,,"-1,077,440.53"
,CS,AR,32009830,1005,100,,Cash sale,,,,,,25/10/2018,25/10/2018,0.00,,7.29,,"-1,077,447.82"
,CS,AR,32009847,1005,100,,Cash sale,,,,,,25/10/2018,25/10/2018,0.00,,3.64,,"-1,077,451.46"
,CS,AR,32009890,1005,100,,Cash sale,,,,,,25/10/2018,25/10/2018,0.00,,3.01,,"-1,077,454.47"
,CS,AR,32009914,1005,100,,Cash sale,,,,,,25/10/2018,25/10/2018,0.00,,3.64,,"-1,077,458.11"
,CS,AR,32009925,1005,100,,Cash sale,,,,,,25/10/2018,25/10/2018,0.00,,7.29,,"-1,077,465.40"
,CS,AR,32009951,1005,100,,Cash sale,,,,,,25/10/2018,25/10/2018,0.00,,5.17,,"-1,077,470.57"
,CS,AR,32009967,1005,100,,Cash sale,,,,,,25/10/2018,25/10/2018,0.00,,14.58,,"-1,077,485.15"
,CS,AR,32010020,1005,100,,Cash sale,,,,,,25/10/2018,25/10/2018,0.00,,7.29,,"-1,077,492.44"
,CS,AR,32010079,1005,100,,Cash sale,,,,,,25/10/2018,25/10/2018,0.00,,13.77,,"-1,077,506.21"
,CS,AR,32010096,1005,100,,Cash sale,,,,,,25/10/2018,25/10/2018,0.00,,7.29,,"-1,077,513.50"
,CS,AR,32010122,1005,100,,Cash sale,,,,,,25/10/2018,25/10/2018,0.00,,22.37,,"-1,077,535.87"
,CS,AR,32010155,1005,100,,Cash sale,,,,,,25/10/2018,25/10/2018,0.00,,6.02,,"-1,077,541.89"
,CS,AR,32010175,1005,100,,Cash sale,,,,,,25/10/2018,25/10/2018,0.00,,2.58,,"-1,077,544.47"
,CS,AR,32010189,1005,100,,Cash sale,,,,,,25/10/2018,25/10/2018,0.00,,10.93,,"-1,077,555.40"
,CS,AR,32010212,1005,100,,Cash sale,,,,,,25/10/2018,25/10/2018,0.00,,33.09,,"-1,077,588.49"
,CS,AR,32010218,1005,100,,Cash sale,,,,,,25/10/2018,25/10/2018,0.00,,22.37,,"-1,077,610.86"
,CS,AR,32010242,1005,100,,Cash sale,,,,,,25/10/2018,25/10/2018,0.00,,3.64,,"-1,077,614.50"
,CS,AR,32010257,1005,100,,Cash sale,,,,,,25/10/2018,25/10/2018,0.00,,5.17,,"-1,077,619.67"
,CS,AR,32010277,1005,100,,Cash sale,,,,,,25/10/2018,25/10/2018,0.00,,6.00,,"-1,077,625.67"
,CS,AR,32010297,1005,100,,Cash sale,,,,,,25/10/2018,25/10/2018,0.00,,5.93,,"-1,077,631.60"
,CS,AR,32010337,1005,100,,Cash sale,,,,,,25/10/2018,25/10/2018,0.00,,14.58,,"-1,077,646.18"
,CS,AR,32010343,1005,100,,Cash sale,,,,,,25/10/2018,25/10/2018,0.00,,14.83,,"-1,077,661.01"
,CS,AR,32010345,1005,100,,Cash sale,,,,,,25/10/2018,25/10/2018,0.00,,18.22,,"-1,077,679.23"
,CS,AR,32010442,1005,100,,Cash sale,,,,,,25/10/2018,25/10/2018,0.00,,10.93,,"-1,077,690.16"
,CS,AR,32010466,1005,100,,Cash sale,,,,,,25/10/2018,25/10/2018,0.00,,2.92,,"-1,077,693.08"
,CS,AR,32010470,1005,100,,Cash sale,,,,,,25/10/2018,25/10/2018,0.00,,7.29,,"-1,077,700.37"
,CS,AR,32010559,1005,100,,Cash sale,,,,,,25/10/2018,25/10/2018,0.00,,3.64,,"-1,077,704.01"
,CS,AR,32010563,1005,100,,Cash sale,,,,,,25/10/2018,25/10/2018,0.00,,7.29,,"-1,077,711.30"
,CS,AR,32010566,1005,100,,Cash sale,,,,,,25/10/2018,25/10/2018,0.00,,5.17,,"-1,077,716.47"
,CS,AR,32010584,1005,100,,Cash sale,,,,,,25/10/2018,25/10/2018,0.00,,7.29,,"-1,077,723.76"
,CS,AR,32010586,1005,100,,Cash sale,,,,,,25/10/2018,25/10/2018,0.00,,7.29,,"-1,077,731.05"
,CS,AR,32010616,1005,100,,Cash sale,,,,,,25/10/2018,25/10/2018,0.00,,5.93,,"-1,077,736.98"
,IN,AR,30328325,1005,100,,Invoice,,,,,,25/10/2018,25/10/2018,0.00,,29.66,,"-1,077,766.64"
,IN,AR,30328335,1005,100,,Invoice,,,,,,25/10/2018,25/10/2018,0.00,,3.64,,"-1,077,770.28"
,IN,AR,30328391,1005,100,,Invoice,,,,,,25/10/2018,25/10/2018,0.00,,10.13,,"-1,077,780.41"
,IN,AR,30328414,1005,100,,Invoice,,,,,,25/10/2018,25/10/2018,0.00,,3.64,,"-1,077,784.05"
,IN,AR,30328441,1005,100,,Invoice,,,,,,25/10/2018,25/10/2018,0.00,,3.64,,"-1,077,787.69"
,IN,AR,30328443,1005,100,,Invoice,,,,,,25/10/2018,25/10/2018,0.00,,5.17,,"-1,077,792.86"
,IN,AR,30328488,1005,100,,Invoice,,,,,,25/10/2018,25/10/2018,0.00,,3.98,,"-1,077,796.84"
,IN,AR,30328507,1005,100,,Invoice,,,,,,25/10/2018,25/10/2018,0.00,,32.00,,"-1,077,828.84"
,IN,AR,30328532,1005,100,,Invoice,,,,,,25/10/2018,25/10/2018,0.00,,60.00,,"-1,077,888.84"
,IN,AR,30328537,1005,100,,Invoice,,,,,,25/10/2018,25/10/2018,0.00,,43.73,,"-1,077,932.57"
,IN,AR,30328549,1005,100,,Invoice,,,,,,25/10/2018,25/10/2018,0.00,,7.29,,"-1,077,939.86"
,IN,AR,30328599,1005,100,,Invoice,,,,,,25/10/2018,25/10/2018,0.00,,10.93,,"-1,077,950.79"
,IN,AR,30328619,1005,100,,Invoice,,,,,,25/10/2018,25/10/2018,0.00,,71.19,,"-1,078,021.98"
,IN,AR,30328620,1005,100,,Invoice,,,,,,25/10/2018,25/10/2018,0.00,,7.12,,"-1,078,029.10"
,IN,AR,30328636,1005,100,,Invoice,,,,,,25/10/2018,25/10/2018,0.00,,32.95,,"-1,078,062.05"
,IN,AR,30328643,1005,100,,Invoice,,,,,,25/10/2018,25/10/2018,0.00,,11.36,,"-1,078,073.41"
,IN,AR,30328673,1005,100,,Invoice,,,,,,25/10/2018,25/10/2018,0.00,,86.03,,"-1,078,159.44"
,IN,AR,30328729,1005,100,,Invoice,,,,,,25/10/2018,25/10/2018,0.00,,7.29,,"-1,078,166.73"
,IN,AR,30328737,1005,100,,Invoice,,,,,,25/10/2018,25/10/2018,0.00,,21.86,,"-1,078,188.59"
,IN,AR,30328744,1005,100,,Invoice,,,,,,25/10/2018,25/10/2018,0.00,,28.00,,"-1,078,216.59"
,IN,AR,30328783,1005,100,,Invoice,,,,,,25/10/2018,25/10/2018,0.00,,3.01,,"-1,078,219.60"
,IN,AR,30328790,1005,100,,Invoice,,,,,,25/10/2018,25/10/2018,0.00,,12.03,,"-1,078,231.63"
,IN,AR,30328858,1005,100,,Invoice,,,,,,25/10/2018,25/10/2018,0.00,,56.92,,"-1,078,288.55"
,IN,AR,30328860,1005,100,,Invoice,,,,,,25/10/2018,25/10/2018,0.00,,7.29,,"-1,078,295.84"
,IN,AR,30328875,1005,100,,Invoice,,,,,,25/10/2018,25/10/2018,0.00,,33.46,,"-1,078,329.30"
,IN,AR,30328897,1005,100,,Invoice,,,,,,25/10/2018,25/10/2018,0.00,,22.03,,"-1,078,351.33"
,IN,AR,30328922,1005,100,,Invoice,,,,,,25/10/2018,25/10/2018,0.00,,7.63,,"-1,078,358.96"
,IN,AR,30328923,1005,100,,Invoice,,,,,,25/10/2018,25/10/2018,0.00,,71.19,,"-1,078,430.15"
,IN,AR,30328941,1005,100,,Invoice,,,,,,25/10/2018,25/10/2018,0.00,,19.12,,"-1,078,449.27"
,IN,AR,30328948,1005,100,,Invoice,,,,,,25/10/2018,25/10/2018,0.00,,3.22,,"-1,078,452.49"
,IN,AR,30328955,1005,100,,Invoice,,,,,,25/10/2018,25/10/2018,0.00,,22.54,,"-1,078,475.03"
,IN,AR,30328968,1005,100,,Invoice,,,,,,25/10/2018,25/10/2018,0.00,,4.24,,"-1,078,479.27"
,IN,AR,30328992,1005,100,,Invoice,,,,,,25/10/2018,25/10/2018,0.00,,36.10,,"-1,078,515.37"
,IN,AR,30329023,1005,100,,Invoice,,,,,,25/10/2018,25/10/2018,0.00,,6.36,,"-1,078,521.73"
,IN,AR,30329068,1005,100,,Invoice,,,,,,25/10/2018,25/10/2018,0.00,,7.75,,"-1,078,529.48"
,IN,AR,30329127,1005,100,,Invoice,,,,,,25/10/2018,25/10/2018,0.00,,6.36,,"-1,078,535.84"
,IN,AR,30329159,1005,100,,Invoice,,,,,,25/10/2018,25/10/2018,0.00,,17.80,,"-1,078,553.64"
,IN,AR,30329164,1005,100,,Invoice,,,,,,25/10/2018,25/10/2018,0.00,,20.00,,"-1,078,573.64"
,IN,AR,30329177,1005,100,,Invoice,,,,,,25/10/2018,25/10/2018,0.00,,10.93,,"-1,078,584.57"
,IN,AR,30329214,1005,100,,Invoice,,,,,,25/10/2018,25/10/2018,0.00,,6.02,,"-1,078,590.59"
,IN,AR,30329269,1005,100,,Invoice,,,,,,25/10/2018,25/10/2018,0.00,,8.24,,"-1,078,598.83"
,IN,AR,30329295,1005,100,,Invoice,,,,,,25/10/2018,25/10/2018,0.00,,2.97,,"-1,078,601.80"
,IN,AR,30329296,1005,100,,Invoice,,,,,,25/10/2018,25/10/2018,0.00,,35.59,,"-1,078,637.39"
,IN,AR,30329303,1005,100,,Invoice,,,,,,25/10/2018,25/10/2018,0.00,,17.50,,"-1,078,654.89"
,IN,AR,30329364,1005,100,,Invoice,,,,,,25/10/2018,25/10/2018,0.00,,6.44,,"-1,078,661.33"
,IN,AR,30329370,1005,100,,Invoice,,,,,,25/10/2018,25/10/2018,0.00,,4.64,,"-1,078,665.97"
,IN,AR,30329373,1005,100,,Invoice,,,,,,25/10/2018,25/10/2018,0.00,,8.77,,"-1,078,674.74"
,IN,AR,30329376,1005,100,,Invoice,,,,,,25/10/2018,25/10/2018,0.00,,21.86,,"-1,078,696.60"
,IN,AR,30329382,1005,100,,Invoice,,,,,,25/10/2018,25/10/2018,0.00,,16.53,,"-1,078,713.13"
,IN,AR,30329431,1005,100,,Invoice,,,,,,25/10/2018,25/10/2018,0.00,,15.04,,"-1,078,728.17"
,IN,AR,30329436,1005,100,,Invoice,,,,,,25/10/2018,25/10/2018,0.00,,6.07,,"-1,078,734.24"
,IN,AR,30329444,1005,100,,Invoice,,,,,,25/10/2018,25/10/2018,0.00,,15.53,,"-1,078,749.77"
,IN,AR,30329463,1005,100,,Invoice,,,,,,25/10/2018,25/10/2018,0.00,,12.00,,"-1,078,761.77"
,IN,AR,30329493,1005,100,,Invoice,,,,,,25/10/2018,25/10/2018,0.00,,5.29,,"-1,078,767.06"
,IN,AR,30329511,1005,100,,Invoice,,,,,,25/10/2018,25/10/2018,0.00,,7.29,,"-1,078,774.35"
,IN,AR,30329518,1005,100,,Invoice,,,,,,25/10/2018,25/10/2018,0.00,,15.90,,"-1,078,790.25"
,IN,AR,30329521,1005,100,,Invoice,,,,,,25/10/2018,25/10/2018,0.00,,8.24,,"-1,078,798.49"
,IN,AR,30329547,1005,100,,Invoice,,,,,,25/10/2018,25/10/2018,0.00,,10.47,,"-1,078,808.96"
,IN,AR,30329610,1005,100,,Invoice,,,,,,25/10/2018,25/10/2018,0.00,,14.58,,"-1,078,823.54"
,IN,AR,30329617,1005,100,,Invoice,,,,,,25/10/2018,25/10/2018,0.00,,21.86,,"-1,078,845.40"
,IN,AR,30329627,1005,100,,Invoice,,,,,,25/10/2018,25/10/2018,0.00,,15.93,,"-1,078,861.33"
,IN,AR,30329628,1005,100,,Invoice,,,,,,25/10/2018,25/10/2018,0.00,,11.95,,"-1,078,873.28"
,IN,AR,30329629,1005,100,,Invoice,,,,,,25/10/2018,25/10/2018,0.00,,3.98,,"-1,078,877.26"
,IN,AR,30329630,1005,100,,Invoice,,,,,,25/10/2018,25/10/2018,0.00,,47.80,,"-1,078,925.06"
,IN,AR,30329649,1005,100,,Invoice,,,,,,25/10/2018,25/10/2018,0.00,,15.93,,"-1,078,940.99"
,IN,AR,30329711,1005,100,,Invoice,,,,,,25/10/2018,25/10/2018,0.00,,3.64,,"-1,078,944.63"
,IN,AR,30329754,1005,100,,Invoice,,,,,,25/10/2018,25/10/2018,0.00,,3.28,,"-1,078,947.91"
,IN,AR,30329763,1005,100,,Invoice,,,,,,25/10/2018,25/10/2018,0.00,,18.22,,"-1,078,966.13"
,IN,AR,30329773,1005,100,,Invoice,,,,,,25/10/2018,25/10/2018,0.00,,16.40,,"-1,078,982.53"
,IN,AR,30329781,1005,100,,Invoice,,,,,,25/10/2018,25/10/2018,0.00,,8.90,,"-1,078,991.43"
,IN,AR,30329782,1005,100,,Invoice,,,,,,25/10/2018,25/10/2018,0.00,,3.64,,"-1,078,995.07"
,IN,AR,30329801,1005,100,,Invoice,,,,,,25/10/2018,25/10/2018,0.00,,20.34,,"-1,079,015.41"
,IN,AR,30329808,1005,100,,Invoice,,,,,,25/10/2018,25/10/2018,0.00,,22.01,,"-1,079,037.42"
,IN,AR,30329821,1005,100,,Invoice,,,,,,25/10/2018,25/10/2018,0.00,,6.00,,"-1,079,043.42"
,IN,AR,30329825,1005,100,,Invoice,,,,,,25/10/2018,25/10/2018,0.00,,20.01,,"-1,079,063.43"
,IN,AR,30329839,1005,100,,Invoice,,,,,,25/10/2018,25/10/2018,0.00,,17.49,,"-1,079,080.92"
,IN,AR,30329885,1005,100,,Invoice,,,,,,25/10/2018,25/10/2018,0.00,,52.57,,"-1,079,133.49"
,IN,AR,30329904,1005,100,,Invoice,,,,,,25/10/2018,25/10/2018,0.00,,21.86,,"-1,079,155.35"
,IN,AR,30329927,1005,100,,Invoice,,,,,,25/10/2018,25/10/2018,0.00,,16.83,,"-1,079,172.18"
,IN,AR,30329936,1005,100,,Invoice,,,,,,25/10/2018,25/10/2018,0.00,,32.03,,"-1,079,204.21"
,IN,AR,30329971,1005,100,,Invoice,,,,,,25/10/2018,25/10/2018,0.00,,25.51,,"-1,079,229.72"
,IN,AR,30329989,1005,100,,Invoice,,,,,,25/10/2018,25/10/2018,0.00,,65.37,,"-1,079,295.09"
,IN,AR,30330014,1005,100,,Invoice,,,,,,25/10/2018,25/10/2018,0.00,,3.19,,"-1,079,298.28"
,IN,AR,30330015,1005,100,,Invoice,,,,,,25/10/2018,25/10/2018,0.00,,125.86,,"-1,079,424.14"
,IN,AR,30330016,1005,100,,Invoice,,,,,,25/10/2018,25/10/2018,0.00,,7.97,,"-1,079,432.11"
,IN,AR,30330017,1005,100,,Invoice,,,,,,25/10/2018,25/10/2018,0.00,,6.37,,"-1,079,438.48"
,IN,AR,30330018,1005,100,,Invoice,,,,,,25/10/2018,25/10/2018,0.00,,11.15,,"-1,079,449.63"
,IN,AR,30330019,1005,100,,Invoice,,,,,,25/10/2018,25/10/2018,0.00,,14.34,,"-1,079,463.97"
,IN,AR,30330020,1005,100,,Invoice,,,,,,25/10/2018,25/10/2018,0.00,,7.97,,"-1,079,471.94"
,IN,AR,30330085,1005,100,,Invoice,,,,,,25/10/2018,25/10/2018,0.00,,20.34,,"-1,079,492.28"
,IN,AR,30330120,1005,100,,Invoice,,,,,,25/10/2018,25/10/2018,0.00,,11.02,,"-1,079,503.30"
,IN,AR,30330212,1005,100,,Invoice,,,,,,25/10/2018,25/10/2018,0.00,,29.15,,"-1,079,532.45"
,IN,AR,30330235,1005,100,,Invoice,,,,,,25/10/2018,25/10/2018,0.00,,10.21,,"-1,079,542.66"
,IN,AR,30330272,1005,100,,Invoice,,,,,,25/10/2018,25/10/2018,0.00,,2.42,,"-1,079,545.08"
,IN,AR,30330277,1005,100,,Invoice,,,,,,25/10/2018,25/10/2018,0.00,,12.14,,"-1,079,557.22"
,IN,AR,30330328,1005,100,,Invoice,,,,,,25/10/2018,25/10/2018,0.00,,4.15,,"-1,079,561.37"
,IN,AR,30330329,1005,100,,Invoice,,,,,,25/10/2018,25/10/2018,0.00,,8.31,,"-1,079,569.68"
,IN,AR,30330330,1005,100,,Invoice,,,,,,25/10/2018,25/10/2018,0.00,,18.69,,"-1,079,588.37"
,IN,AR,30330331,1005,100,,Invoice,,,,,,25/10/2018,25/10/2018,0.00,,2.08,,"-1,079,590.45"
,IN,AR,30330332,1005,100,,Invoice,,,,,,25/10/2018,25/10/2018,0.00,,4.15,,"-1,079,594.60"
,IN,AR,30330333,1005,100,,Invoice,,,,,,25/10/2018,25/10/2018,0.00,,12.46,,"-1,079,607.06"
,IN,AR,30330359,1005,100,,Invoice,,,,,,25/10/2018,25/10/2018,0.00,,21.25,,"-1,079,628.31"
,IN,AR,30330378,1005,100,,Invoice,,,,,,25/10/2018,25/10/2018,0.00,,7.29,,"-1,079,635.60"
,IN,AR,30330393,1005,100,,Invoice,,,,,,25/10/2018,25/10/2018,0.00,,29.15,,"-1,079,664.75"
,IN,AR,30330415,1005,100,,Invoice,,,,,,25/10/2018,25/10/2018,0.00,,2.10,,"-1,079,666.85"
,IN,AR,30330426,1005,100,,Invoice,,,,,,25/10/2018,25/10/2018,0.00,,7.29,,"-1,079,674.14"
,IN,AR,30330437,1005,100,,Invoice,,,,,,25/10/2018,25/10/2018,0.00,,81.92,,"-1,079,756.06"
,IN,AR,30330468,1005,100,,Invoice,,,,,,25/10/2018,25/10/2018,0.00,,5.26,,"-1,079,761.32"
,IN,AR,30330502,1005,100,,Invoice,,,,,,25/10/2018,25/10/2018,0.00,,9.13,,"-1,079,770.45"
,IN,AR,30330521,1005,100,,Invoice,,,,,,25/10/2018,25/10/2018,0.00,,12.03,,"-1,079,782.48"
,IN,AR,30330526,1005,100,,Invoice,,,,,,25/10/2018,25/10/2018,0.00,,9.84,,"-1,079,792.32"
,IN,AR,30330527,1005,100,,Invoice,,,,,,25/10/2018,25/10/2018,0.00,,8.41,,"-1,079,800.73"
,IN,AR,30330530,1005,100,,Invoice,,,,,,25/10/2018,25/10/2018,0.00,,36.44,,"-1,079,837.17"
,IN,AR,30330538,1005,100,,Invoice,,,,,,25/10/2018,25/10/2018,0.00,,54.66,,"-1,079,891.83"
,IN,AR,30330549,1005,100,,Invoice,,,,,,25/10/2018,25/10/2018,0.00,,54.66,,"-1,079,946.49"
,IN,AR,30330550,1005,100,,Invoice,,,,,,25/10/2018,25/10/2018,0.00,,54.66,,"-1,080,001.15"
,IN,AR,30330570,1005,100,,Invoice,,,,,,25/10/2018,25/10/2018,0.00,,218.64,,"-1,080,219.79"
,IN,AR,30330590,1005,100,,Invoice,,,,,,25/10/2018,25/10/2018,0.00,,182.20,,"-1,080,401.99"
,IN,AR,30330601,1005,100,,Invoice,,,,,,25/10/2018,25/10/2018,0.00,,182.20,,"-1,080,584.19"
,CS,AR,32009708,1005,100,,Cash sale,,,,,,26/10/2018,26/10/2018,0.00,,18.22,,"-1,080,602.41"
,CS,AR,32009718,1005,100,,Cash sale,,,,,,26/10/2018,26/10/2018,0.00,,14.03,,"-1,080,616.44"
,CS,AR,32009734,1005,100,,Cash sale,,,,,,26/10/2018,26/10/2018,0.00,,14.24,,"-1,080,630.68"
,CS,AR,32009757,1005,100,,Cash sale,,,,,,26/10/2018,26/10/2018,0.00,,3.64,,"-1,080,634.32"
,CS,AR,32009806,1005,100,,Cash sale,,,,,,26/10/2018,26/10/2018,0.00,,12.08,,"-1,080,646.40"
,CS,AR,32009828,1005,100,,Cash sale,,,,,,26/10/2018,26/10/2018,0.00,,14.53,,"-1,080,660.93"
,CS,AR,32009833,1005,100,,Cash sale,,,,,,26/10/2018,26/10/2018,0.00,,7.29,,"-1,080,668.22"
,CS,AR,32009853,1005,100,,Cash sale,,,,,,26/10/2018,26/10/2018,0.00,,9.73,,"-1,080,677.95"
,CS,AR,32009857,1005,100,,Cash sale,,,,,,26/10/2018,26/10/2018,0.00,,3.64,,"-1,080,681.59"
,CS,AR,32009879,1005,100,,Cash sale,,,,,,26/10/2018,26/10/2018,0.00,,3.64,,"-1,080,685.23"
,CS,AR,32009935,1005,100,,Cash sale,,,,,,26/10/2018,26/10/2018,0.00,,2.58,,"-1,080,687.81"
,CS,AR,32009937,1005,100,,Cash sale,,,,,,26/10/2018,26/10/2018,0.00,,7.75,,"-1,080,695.56"
,CS,AR,32009943,1005,100,,Cash sale,,,,,,26/10/2018,26/10/2018,0.00,,17.80,,"-1,080,713.36"
,CS,AR,32009959,1005,100,,Cash sale,,,,,,26/10/2018,26/10/2018,0.00,,3.64,,"-1,080,717.00"
,CS,AR,32009966,1005,100,,Cash sale,,,,,,26/10/2018,26/10/2018,0.00,,68.69,,"-1,080,785.69"
,CS,AR,32009980,1005,100,,Cash sale,,,,,,26/10/2018,26/10/2018,0.00,,10.93,,"-1,080,796.62"
,CS,AR,32009987,1005,100,,Cash sale,,,,,,26/10/2018,26/10/2018,0.00,,3.01,,"-1,080,799.63"
,CS,AR,32009988,1005,100,,Cash sale,,,,,,26/10/2018,26/10/2018,0.00,,15.04,,"-1,080,814.67"
,CS,AR,32010009,1005,100,,Cash sale,,,,,,26/10/2018,26/10/2018,0.00,,5.17,,"-1,080,819.84"
,CS,AR,32010027,1005,100,,Cash sale,,,,,,26/10/2018,26/10/2018,0.00,,23.39,,"-1,080,843.23"
,CS,AR,32010035,1005,100,,Cash sale,,,,,,26/10/2018,26/10/2018,0.00,,6.02,,"-1,080,849.25"
,CS,AR,32010040,1005,100,,Cash sale,,,,,,26/10/2018,26/10/2018,0.00,,10.34,,"-1,080,859.59"
,CS,AR,32010047,1005,100,,Cash sale,,,,,,26/10/2018,26/10/2018,0.00,,33.09,,"-1,080,892.68"
,CS,AR,32010050,1005,100,,Cash sale,,,,,,26/10/2018,26/10/2018,0.00,,8.17,,"-1,080,900.85"
,CS,AR,32010056,1005,100,,Cash sale,,,,,,26/10/2018,26/10/2018,0.00,,15.25,,"-1,080,916.10"
,CS,AR,32010083,1005,100,,Cash sale,,,,,,26/10/2018,26/10/2018,0.00,,3.64,,"-1,080,919.74"
,CS,AR,32010087,1005,100,,Cash sale,,,,,,26/10/2018,26/10/2018,0.00,,7.29,,"-1,080,927.03"
,CS,AR,32010090,1005,100,,Cash sale,,,,,,26/10/2018,26/10/2018,0.00,,18.22,,"-1,080,945.25"
,CS,AR,32010142,1005,100,,Cash sale,,,,,,26/10/2018,26/10/2018,0.00,,25.51,,"-1,080,970.76"
,CS,AR,32010165,1005,100,,Cash sale,,,,,,26/10/2018,26/10/2018,0.00,,20.48,,"-1,080,991.24"
,CS,AR,32010193,1005,100,,Cash sale,,,,,,26/10/2018,26/10/2018,0.00,,3.64,,"-1,080,994.88"
,CS,AR,32010199,1005,100,,Cash sale,,,,,,26/10/2018,26/10/2018,0.00,,5.17,,"-1,081,000.05"
,CS,AR,32010219,1005,100,,Cash sale,,,,,,26/10/2018,26/10/2018,0.00,,3.64,,"-1,081,003.69"
,CS,AR,32010248,1005,100,,Cash sale,,,,,,26/10/2018,26/10/2018,0.00,,6.02,,"-1,081,009.71"
,CS,AR,32010261,1005,100,,Cash sale,,,,,,26/10/2018,26/10/2018,0.00,,7.29,,"-1,081,017.00"
,CS,AR,32010328,1005,100,,Cash sale,,,,,,26/10/2018,26/10/2018,0.00,,4.58,,"-1,081,021.58"
,CS,AR,32010340,1005,100,,Cash sale,,,,,,26/10/2018,26/10/2018,0.00,,6.07,,"-1,081,027.65"
,CS,AR,32010359,1005,100,,Cash sale,,,,,,26/10/2018,26/10/2018,0.00,,7.29,,"-1,081,034.94"
,CS,AR,32010360,1005,100,,Cash sale,,,,,,26/10/2018,26/10/2018,0.00,,10.93,,"-1,081,045.87"
,CS,AR,32010381,1005,100,,Cash sale,,,,,,26/10/2018,26/10/2018,0.00,,12.14,,"-1,081,058.01"
,CS,AR,32010390,1005,100,,Cash sale,,,,,,26/10/2018,26/10/2018,0.00,,7.29,,"-1,081,065.30"
,CS,AR,32010402,1005,100,,Cash sale,,,,,,26/10/2018,26/10/2018,0.00,,10.93,,"-1,081,076.23"
,CS,AR,32010414,1005,100,,Cash sale,,,,,,26/10/2018,26/10/2018,0.00,,9.10,,"-1,081,085.33"
,CS,AR,32010432,1005,100,,Cash sale,,,,,,26/10/2018,26/10/2018,0.00,,6.08,,"-1,081,091.41"
,CS,AR,32010438,1005,100,,Cash sale,,,,,,26/10/2018,26/10/2018,0.00,,25.51,,"-1,081,116.92"
,CS,AR,32010482,1005,100,,Cash sale,,,,,,26/10/2018,26/10/2018,0.00,,3.64,,"-1,081,120.56"
,CS,AR,32010484,1005,100,,Cash sale,,,,,,26/10/2018,26/10/2018,0.00,,18.22,,"-1,081,138.78"
,CS,AR,32010489,1005,100,,Cash sale,,,,,,26/10/2018,26/10/2018,0.00,,3.01,,"-1,081,141.79"
,CS,AR,32010570,1005,100,,Cash sale,,,,,,26/10/2018,26/10/2018,0.00,,7.63,,"-1,081,149.42"
,CS,AR,32010599,1005,100,,Cash sale,,,,,,26/10/2018,26/10/2018,0.00,,36.44,,"-1,081,185.86"
,CS,AR,32010617,1005,100,,Cash sale,,,,,,26/10/2018,26/10/2018,0.00,,2.97,,"-1,081,188.83"
,IN,AR,30328326,1005,100,,Invoice,,,,,,26/10/2018,26/10/2018,0.00,,5.93,,"-1,081,194.76"
,IN,AR,30328327,1005,100,,Invoice,,,,,,26/10/2018,26/10/2018,0.00,,32.63,,"-1,081,227.39"
,IN,AR,30328333,1005,100,,Invoice,,,,,,26/10/2018,26/10/2018,0.00,,32.80,,"-1,081,260.19"
,IN,AR,30328344,1005,100,,Invoice,,,,,,26/10/2018,26/10/2018,0.00,,19.58,,"-1,081,279.77"
,IN,AR,30328405,1005,100,,Invoice,,,,,,26/10/2018,26/10/2018,0.00,,18.22,,"-1,081,297.99"
,IN,AR,30328417,1005,100,,Invoice,,,,,,26/10/2018,26/10/2018,0.00,,6.08,,"-1,081,304.07"
,IN,AR,30328437,1005,100,,Invoice,,,,,,26/10/2018,26/10/2018,0.00,,19.32,,"-1,081,323.39"
,IN,AR,30328457,1005,100,,Invoice,,,,,,26/10/2018,26/10/2018,0.00,,21.14,,"-1,081,344.53"
,IN,AR,30328464,1005,100,,Invoice,,,,,,26/10/2018,26/10/2018,0.00,,7.29,,"-1,081,351.82"
,IN,AR,30328471,1005,100,,Invoice,,,,,,26/10/2018,26/10/2018,0.00,,18.37,,"-1,081,370.19"
,IN,AR,30328477,1005,100,,Invoice,,,,,,26/10/2018,26/10/2018,0.00,,73.75,,"-1,081,443.94"
,IN,AR,30328508,1005,100,,Invoice,,,,,,26/10/2018,26/10/2018,0.00,,64.00,,"-1,081,507.94"
,IN,AR,30328572,1005,100,,Invoice,,,,,,26/10/2018,26/10/2018,0.00,,26.00,,"-1,081,533.94"
,IN,AR,30328621,1005,100,,Invoice,,,,,,26/10/2018,26/10/2018,0.00,,4.75,,"-1,081,538.69"
,IN,AR,30328627,1005,100,,Invoice,,,,,,26/10/2018,26/10/2018,0.00,,10.00,,"-1,081,548.69"
,IN,AR,30328669,1005,100,,Invoice,,,,,,26/10/2018,26/10/2018,0.00,,5.82,,"-1,081,554.51"
,IN,AR,30328670,1005,100,,Invoice,,,,,,26/10/2018,26/10/2018,0.00,,9.70,,"-1,081,564.21"
,IN,AR,30328675,1005,100,,Invoice,,,,,,26/10/2018,26/10/2018,0.00,,8.39,,"-1,081,572.60"
,IN,AR,30328683,1005,100,,Invoice,,,,,,26/10/2018,26/10/2018,0.00,,36.00,,"-1,081,608.60"
,IN,AR,30328687,1005,100,,Invoice,,,,,,26/10/2018,26/10/2018,0.00,,3.64,,"-1,081,612.24"
,IN,AR,30328703,1005,100,,Invoice,,,,,,26/10/2018,26/10/2018,0.00,,32.80,,"-1,081,645.04"
,IN,AR,30328713,1005,100,,Invoice,,,,,,26/10/2018,26/10/2018,0.00,,20.69,,"-1,081,665.73"
,IN,AR,30328749,1005,100,,Invoice,,,,,,26/10/2018,26/10/2018,0.00,,5.17,,"-1,081,670.90"
,IN,AR,30328765,1005,100,,Invoice,,,,,,26/10/2018,26/10/2018,0.00,,9.59,,"-1,081,680.49"
,IN,AR,30328776,1005,100,,Invoice,,,,,,26/10/2018,26/10/2018,0.00,,14.58,,"-1,081,695.07"
,IN,AR,30328815,1005,100,,Invoice,,,,,,26/10/2018,26/10/2018,0.00,,18.05,,"-1,081,713.12"
,IN,AR,30328834,1005,100,,Invoice,,,,,,26/10/2018,26/10/2018,0.00,,32.80,,"-1,081,745.92"
,IN,AR,30328840,1005,100,,Invoice,,,,,,26/10/2018,26/10/2018,0.00,,33.60,,"-1,081,779.52"
,IN,AR,30328844,1005,100,,Invoice,,,,,,26/10/2018,26/10/2018,0.00,,4.78,,"-1,081,784.30"
,IN,AR,30328864,1005,100,,Invoice,,,,,,26/10/2018,26/10/2018,0.00,,19.28,,"-1,081,803.58"
,IN,AR,30328882,1005,100,,Invoice,,,,,,26/10/2018,26/10/2018,0.00,,12.03,,"-1,081,815.61"
,IN,AR,30328906,1005,100,,Invoice,,,,,,26/10/2018,26/10/2018,0.00,,53.32,,"-1,081,868.93"
,IN,AR,30328942,1005,100,,Invoice,,,,,,26/10/2018,26/10/2018,0.00,,4.78,,"-1,081,873.71"
,IN,AR,30328964,1005,100,,Invoice,,,,,,26/10/2018,26/10/2018,0.00,,10.93,,"-1,081,884.64"
,IN,AR,30329029,1005,100,,Invoice,,,,,,26/10/2018,26/10/2018,0.00,,4.78,,"-1,081,889.42"
,IN,AR,30329044,1005,100,,Invoice,,,,,,26/10/2018,26/10/2018,0.00,,10.17,,"-1,081,899.59"
,IN,AR,30329045,1005,100,,Invoice,,,,,,26/10/2018,26/10/2018,0.00,,5.08,,"-1,081,904.67"
,IN,AR,30329046,1005,100,,Invoice,,,,,,26/10/2018,26/10/2018,0.00,,10.17,,"-1,081,914.84"
,IN,AR,30329047,1005,100,,Invoice,,,,,,26/10/2018,26/10/2018,0.00,,2.54,,"-1,081,917.38"
,IN,AR,30329048,1005,100,,Invoice,,,,,,26/10/2018,26/10/2018,0.00,,10.17,,"-1,081,927.55"
,IN,AR,30329056,1005,100,,Invoice,,,,,,26/10/2018,26/10/2018,0.00,,5.08,,"-1,081,932.63"
,IN,AR,30329063,1005,100,,Invoice,,,,,,26/10/2018,26/10/2018,0.00,,10.93,,"-1,081,943.56"
,IN,AR,30329121,1005,100,,Invoice,,,,,,26/10/2018,26/10/2018,0.00,,15.25,,"-1,081,958.81"
,IN,AR,30329142,1005,100,,Invoice,,,,,,26/10/2018,26/10/2018,0.00,,18.22,,"-1,081,977.03"
,IN,AR,30329152,1005,100,,Invoice,,,,,,26/10/2018,26/10/2018,0.00,,7.29,,"-1,081,984.32"
,IN,AR,30329226,1005,100,,Invoice,,,,,,26/10/2018,26/10/2018,0.00,,6.36,,"-1,081,990.68"
,IN,AR,30329279,1005,100,,Invoice,,,,,,26/10/2018,26/10/2018,0.00,,16.83,,"-1,082,007.51"
,IN,AR,30329280,1005,100,,Invoice,,,,,,26/10/2018,26/10/2018,0.00,,5.61,,"-1,082,013.12"
,IN,AR,30329325,1005,100,,Invoice,,,,,,26/10/2018,26/10/2018,0.00,,4.24,,"-1,082,017.36"
,IN,AR,30329362,1005,100,,Invoice,,,,,,26/10/2018,26/10/2018,0.00,,29.15,,"-1,082,046.51"
,IN,AR,30329378,1005,100,,Invoice,,,,,,26/10/2018,26/10/2018,0.00,,21.86,,"-1,082,068.37"
,IN,AR,30329395,1005,100,,Invoice,,,,,,26/10/2018,26/10/2018,0.00,,5.17,,"-1,082,073.54"
,IN,AR,30329447,1005,100,,Invoice,,,,,,26/10/2018,26/10/2018,0.00,,12.71,,"-1,082,086.25"
,IN,AR,30329460,1005,100,,Invoice,,,,,,26/10/2018,26/10/2018,0.00,,18.05,,"-1,082,104.30"
,IN,AR,30329471,1005,100,,Invoice,,,,,,26/10/2018,26/10/2018,0.00,,64.32,,"-1,082,168.62"
,IN,AR,30329516,1005,100,,Invoice,,,,,,26/10/2018,26/10/2018,0.00,,4.85,,"-1,082,173.47"
,IN,AR,30329517,1005,100,,Invoice,,,,,,26/10/2018,26/10/2018,0.00,,5.34,,"-1,082,178.81"
,IN,AR,30329580,1005,100,,Invoice,,,,,,26/10/2018,26/10/2018,0.00,,18.22,,"-1,082,197.03"
,IN,AR,30329587,1005,100,,Invoice,,,,,,26/10/2018,26/10/2018,0.00,,5.68,,"-1,082,202.71"
,IN,AR,30329650,1005,100,,Invoice,,,,,,26/10/2018,26/10/2018,0.00,,41.82,,"-1,082,244.53"
,IN,AR,30329669,1005,100,,Invoice,,,,,,26/10/2018,26/10/2018,0.00,,42.58,,"-1,082,287.11"
,IN,AR,30329677,1005,100,,Invoice,,,,,,26/10/2018,26/10/2018,0.00,,40.00,,"-1,082,327.11"
,IN,AR,30329682,1005,100,,Invoice,,,,,,26/10/2018,26/10/2018,0.00,,26.19,,"-1,082,353.30"
,IN,AR,30329685,1005,100,,Invoice,,,,,,26/10/2018,26/10/2018,0.00,,2.97,,"-1,082,356.27"
,IN,AR,30329699,1005,100,,Invoice,,,,,,26/10/2018,26/10/2018,0.00,,22.05,,"-1,082,378.32"
,IN,AR,30329716,1005,100,,Invoice,,,,,,26/10/2018,26/10/2018,0.00,,3.01,,"-1,082,381.33"
,IN,AR,30329725,1005,100,,Invoice,,,,,,26/10/2018,26/10/2018,0.00,,15.13,,"-1,082,396.46"
,IN,AR,30329735,1005,100,,Invoice,,,,,,26/10/2018,26/10/2018,0.00,,28.03,,"-1,082,424.49"
,IN,AR,30329738,1005,100,,Invoice,,,,,,26/10/2018,26/10/2018,0.00,,10.93,,"-1,082,435.42"
,IN,AR,30329744,1005,100,,Invoice,,,,,,26/10/2018,26/10/2018,0.00,,36.78,,"-1,082,472.20"
,IN,AR,30329772,1005,100,,Invoice,,,,,,26/10/2018,26/10/2018,0.00,,23.91,,"-1,082,496.11"
,IN,AR,30329802,1005,100,,Invoice,,,,,,26/10/2018,26/10/2018,0.00,,10.17,,"-1,082,506.28"
,IN,AR,30329814,1005,100,,Invoice,,,,,,26/10/2018,26/10/2018,0.00,,10.00,,"-1,082,516.28"
,IN,AR,30329828,1005,100,,Invoice,,,,,,26/10/2018,26/10/2018,0.00,,4.00,,"-1,082,520.28"
,IN,AR,30329868,1005,100,,Invoice,,,,,,26/10/2018,26/10/2018,0.00,,32.85,,"-1,082,553.13"
,IN,AR,30329886,1005,100,,Invoice,,,,,,26/10/2018,26/10/2018,0.00,,4.20,,"-1,082,557.33"
,IN,AR,30329895,1005,100,,Invoice,,,,,,26/10/2018,26/10/2018,0.00,,4.66,,"-1,082,561.99"
,IN,AR,30329933,1005,100,,Invoice,,,,,,26/10/2018,26/10/2018,0.00,,6.89,,"-1,082,568.88"
,IN,AR,30329939,1005,100,,Invoice,,,,,,26/10/2018,26/10/2018,0.00,,11.19,,"-1,082,580.07"
,IN,AR,30329951,1005,100,,Invoice,,,,,,26/10/2018,26/10/2018,0.00,,12.14,,"-1,082,592.21"
,IN,AR,30329980,1005,100,,Invoice,,,,,,26/10/2018,26/10/2018,0.00,,17.03,,"-1,082,609.24"
,IN,AR,30329982,1005,100,,Invoice,,,,,,26/10/2018,26/10/2018,0.00,,14.49,,"-1,082,623.73"
,IN,AR,30330028,1005,100,,Invoice,,,,,,26/10/2018,26/10/2018,0.00,,93.20,,"-1,082,716.93"
,IN,AR,30330065,1005,100,,Invoice,,,,,,26/10/2018,26/10/2018,0.00,,58.98,,"-1,082,775.91"
,IN,AR,30330095,1005,100,,Invoice,,,,,,26/10/2018,26/10/2018,0.00,,20.00,,"-1,082,795.91"
,IN,AR,30330139,1005,100,,Invoice,,,,,,26/10/2018,26/10/2018,0.00,,50.42,,"-1,082,846.33"
,IN,AR,30330147,1005,100,,Invoice,,,,,,26/10/2018,26/10/2018,0.00,,29.15,,"-1,082,875.48"
,IN,AR,30330156,1005,100,,Invoice,,,,,,26/10/2018,26/10/2018,0.00,,2.92,,"-1,082,878.40"
,IN,AR,30330166,1005,100,,Invoice,,,,,,26/10/2018,26/10/2018,0.00,,8.21,,"-1,082,886.61"
,IN,AR,30330177,1005,100,,Invoice,,,,,,26/10/2018,26/10/2018,0.00,,40.25,,"-1,082,926.86"
,IN,AR,30330214,1005,100,,Invoice,,,,,,26/10/2018,26/10/2018,0.00,,11.86,,"-1,082,938.72"
,IN,AR,30330231,1005,100,,Invoice,,,,,,26/10/2018,26/10/2018,0.00,,6.13,,"-1,082,944.85"
,IN,AR,30330254,1005,100,,Invoice,,,,,,26/10/2018,26/10/2018,0.00,,7.97,,"-1,082,952.82"
,IN,AR,30330334,1005,100,,Invoice,,,,,,26/10/2018,26/10/2018,0.00,,8.31,,"-1,082,961.13"
,IN,AR,30330365,1005,100,,Invoice,,,,,,26/10/2018,26/10/2018,0.00,,7.29,,"-1,082,968.42"
,IN,AR,30330367,1005,100,,Invoice,,,,,,26/10/2018,26/10/2018,0.00,,27.03,,"-1,082,995.45"
,IN,AR,30330370,1005,100,,Invoice,,,,,,26/10/2018,26/10/2018,0.00,,7.75,,"-1,083,003.20"
,IN,AR,30330381,1005,100,,Invoice,,,,,,26/10/2018,26/10/2018,0.00,,4.07,,"-1,083,007.27"
,IN,AR,30330405,1005,100,,Invoice,,,,,,26/10/2018,26/10/2018,0.00,,5.47,,"-1,083,012.74"
,IN,AR,30330421,1005,100,,Invoice,,,,,,26/10/2018,26/10/2018,0.00,,10.93,,"-1,083,023.67"
,IN,AR,30330430,1005,100,,Invoice,,,,,,26/10/2018,26/10/2018,0.00,,3.28,,"-1,083,026.95"
,IN,AR,30330440,1005,100,,Invoice,,,,,,26/10/2018,26/10/2018,0.00,,7.29,,"-1,083,034.24"
,IN,AR,30330454,1005,100,,Invoice,,,,,,26/10/2018,26/10/2018,0.00,,29.15,,"-1,083,063.39"
,IN,AR,30330482,1005,100,,Invoice,,,,,,26/10/2018,26/10/2018,0.00,,6.36,,"-1,083,069.75"
,IN,AR,30330494,1005,100,,Invoice,,,,,,26/10/2018,26/10/2018,0.00,,5.39,,"-1,083,075.14"
,IN,AR,30330529,1005,100,,Invoice,,,,,,26/10/2018,26/10/2018,0.00,,10.93,,"-1,083,086.07"
,IN,AR,30330532,1005,100,,Invoice,,,,,,26/10/2018,26/10/2018,0.00,,7.29,,"-1,083,093.36"
,CS,AR,32010629,1005,100,,Cash sale,,,,,,26/10/2018,26/10/2018,0.00,,54.66,,"-1,083,148.02"
,IN,AR,30330569,1005,100,,Invoice,,,,,,26/10/2018,26/10/2018,0.00,,364.41,,"-1,083,512.43"
,IN,AR,30330588,1005,100,,Invoice,,,,,,26/10/2018,26/10/2018,0.00,,182.20,,"-1,083,694.63"
,IN,AR,30330621,1005,100,,Invoice,,,,,,26/10/2018,26/10/2018,0.00,,364.41,,"-1,084,059.04"
,CS,AR,32009750,1005,100,,Cash sale,,,,,,27/10/2018,27/10/2018,0.00,,6.02,,"-1,084,065.06"
,CS,AR,32009845,1005,100,,Cash sale,,,,,,27/10/2018,27/10/2018,0.00,,18.22,,"-1,084,083.28"
,CS,AR,32009870,1005,100,,Cash sale,,,,,,27/10/2018,27/10/2018,0.00,,7.29,,"-1,084,090.57"
,CS,AR,32010018,1005,100,,Cash sale,,,,,,27/10/2018,27/10/2018,0.00,,15.51,,"-1,084,106.08"
,CS,AR,32010064,1005,100,,Cash sale,,,,,,27/10/2018,27/10/2018,0.00,,7.75,,"-1,084,113.83"
,CS,AR,32010310,1005,100,,Cash sale,,,,,,27/10/2018,27/10/2018,0.00,,6.07,,"-1,084,119.90"
,IN,AR,30328509,1005,100,,Invoice,,,,,,27/10/2018,27/10/2018,0.00,,30.00,,"-1,084,149.90"
,IN,AR,30328524,1005,100,,Invoice,,,,,,27/10/2018,27/10/2018,0.00,,10.93,,"-1,084,160.83"
,IN,AR,30328674,1005,100,,Invoice,,,,,,27/10/2018,27/10/2018,0.00,,14.58,,"-1,084,175.41"
,IN,AR,30329137,1005,100,,Invoice,,,,,,27/10/2018,27/10/2018,0.00,,7.29,,"-1,084,182.70"
,IN,AR,30329541,1005,100,,Invoice,,,,,,27/10/2018,27/10/2018,0.00,,7.29,,"-1,084,189.99"
,IN,AR,30329601,1005,100,,Invoice,,,,,,27/10/2018,27/10/2018,0.00,,7.29,,"-1,084,197.28"
,IN,AR,30329732,1005,100,,Invoice,,,,,,27/10/2018,27/10/2018,0.00,,10.93,,"-1,084,208.21"
,IN,AR,30330185,1005,100,,Invoice,,,,,,27/10/2018,27/10/2018,0.00,,12.14,,"-1,084,220.35"
,IN,AR,30330400,1005,100,,Invoice,,,,,,27/10/2018,27/10/2018,0.00,,7.29,,"-1,084,227.64"
,IN,AR,30330402,1005,100,,Invoice,,,,,,27/10/2018,27/10/2018,0.00,,7.29,,"-1,084,234.93"
,IN,AR,30330459,1005,100,,Invoice,,,,,,27/10/2018,27/10/2018,0.00,,15.17,,"-1,084,250.10"
,CS,AR,32010200,1005,100,,Cash sale,,,,,,28/10/2018,28/10/2018,0.00,,29.15,,"-1,084,279.25"
,CN,AR,31019320,1005,100,,Credit Note,,,,,,29/10/2018,29/10/2018,4.66,,0.00,,"-1,084,274.59"
,CS,AR,32009719,1005,100,,Cash sale,,,,,,29/10/2018,29/10/2018,0.00,,8.42,,"-1,084,283.01"
,CS,AR,32009735,1005,100,,Cash sale,,,,,,29/10/2018,29/10/2018,0.00,,14.24,,"-1,084,297.25"
,CS,AR,32009751,1005,100,,Cash sale,,,,,,29/10/2018,29/10/2018,0.00,,3.64,,"-1,084,300.89"
,CS,AR,32009758,1005,100,,Cash sale,,,,,,29/10/2018,29/10/2018,0.00,,14.58,,"-1,084,315.47"
,CS,AR,32009760,1005,100,,Cash sale,,,,,,29/10/2018,29/10/2018,0.00,,8.42,,"-1,084,323.89"
,CS,AR,32009792,1005,100,,Cash sale,,,,,,29/10/2018,29/10/2018,0.00,,3.64,,"-1,084,327.53"
,CS,AR,32009829,1005,100,,Cash sale,,,,,,29/10/2018,29/10/2018,0.00,,14.53,,"-1,084,342.06"
,CS,AR,32009831,1005,100,,Cash sale,,,,,,29/10/2018,29/10/2018,0.00,,14.58,,"-1,084,356.64"
,CS,AR,32009854,1005,100,,Cash sale,,,,,,29/10/2018,29/10/2018,0.00,,7.78,,"-1,084,364.42"
,CS,AR,32009867,1005,100,,Cash sale,,,,,,29/10/2018,29/10/2018,0.00,,7.29,,"-1,084,371.71"
,CS,AR,32009884,1005,100,,Cash sale,,,,,,29/10/2018,29/10/2018,0.00,,7.29,,"-1,084,379.00"
,CS,AR,32009906,1005,100,,Cash sale,,,,,,29/10/2018,29/10/2018,0.00,,10.34,,"-1,084,389.34"
,CS,AR,32009926,1005,100,,Cash sale,,,,,,29/10/2018,29/10/2018,0.00,,10.93,,"-1,084,400.27"
,CS,AR,32009931,1005,100,,Cash sale,,,,,,29/10/2018,29/10/2018,0.00,,7.29,,"-1,084,407.56"
,CS,AR,32009944,1005,100,,Cash sale,,,,,,29/10/2018,29/10/2018,0.00,,7.63,,"-1,084,415.19"
,CS,AR,32009945,1005,100,,Cash sale,,,,,,29/10/2018,29/10/2018,0.00,,9.10,,"-1,084,424.29"
,CS,AR,32009972,1005,100,,Cash sale,,,,,,29/10/2018,29/10/2018,0.00,,19.24,,"-1,084,443.53"
,CS,AR,32009999,1005,100,,Cash sale,,,,,,29/10/2018,29/10/2018,0.00,,3.64,,"-1,084,447.17"
,CS,AR,32010003,1005,100,,Cash sale,,,,,,29/10/2018,29/10/2018,0.00,,7.29,,"-1,084,454.46"
,CS,AR,32010008,1005,100,,Cash sale,,,,,,29/10/2018,29/10/2018,0.00,,10.93,,"-1,084,465.39"
,CS,AR,32010016,1005,100,,Cash sale,,,,,,29/10/2018,29/10/2018,0.00,,2.54,,"-1,084,467.93"
,CS,AR,32010028,1005,100,,Cash sale,,,,,,29/10/2018,29/10/2018,0.00,,14.62,,"-1,084,482.55"
,CS,AR,32010034,1005,100,,Cash sale,,,,,,29/10/2018,29/10/2018,0.00,,5.44,,"-1,084,487.99"
,CS,AR,32010048,1005,100,,Cash sale,,,,,,29/10/2018,29/10/2018,0.00,,15.04,,"-1,084,503.03"
,CS,AR,32010077,1005,100,,Cash sale,,,,,,29/10/2018,29/10/2018,0.00,,10.93,,"-1,084,513.96"
,CS,AR,32010098,1005,100,,Cash sale,,,,,,29/10/2018,29/10/2018,0.00,,3.64,,"-1,084,517.60"
,CS,AR,32010103,1005,100,,Cash sale,,,,,,29/10/2018,29/10/2018,0.00,,10.51,,"-1,084,528.11"
,CS,AR,32010107,1005,100,,Cash sale,,,,,,29/10/2018,29/10/2018,0.00,,5.08,,"-1,084,533.19"
,CS,AR,32010130,1005,100,,Cash sale,,,,,,29/10/2018,29/10/2018,0.00,,5.17,,"-1,084,538.36"
,CS,AR,32010133,1005,100,,Cash sale,,,,,,29/10/2018,29/10/2018,0.00,,3.64,,"-1,084,542.00"
,CS,AR,32010144,1005,100,,Cash sale,,,,,,29/10/2018,29/10/2018,0.00,,7.29,,"-1,084,549.29"
,CS,AR,32010148,1005,100,,Cash sale,,,,,,29/10/2018,29/10/2018,0.00,,10.93,,"-1,084,560.22"
,CS,AR,32010153,1005,100,,Cash sale,,,,,,29/10/2018,29/10/2018,0.00,,2.16,,"-1,084,562.38"
,CS,AR,32010178,1005,100,,Cash sale,,,,,,29/10/2018,29/10/2018,0.00,,12.03,,"-1,084,574.41"
,CS,AR,32010179,1005,100,,Cash sale,,,,,,29/10/2018,29/10/2018,0.00,,29.15,,"-1,084,603.56"
,CS,AR,32010182,1005,100,,Cash sale,,,,,,29/10/2018,29/10/2018,0.00,,3.64,,"-1,084,607.20"
,CS,AR,32010197,1005,100,,Cash sale,,,,,,29/10/2018,29/10/2018,0.00,,3.20,,"-1,084,610.40"
,CS,AR,32010203,1005,100,,Cash sale,,,,,,29/10/2018,29/10/2018,0.00,,12.17,,"-1,084,622.57"
,CS,AR,32010221,1005,100,,Cash sale,,,,,,29/10/2018,29/10/2018,0.00,,7.29,,"-1,084,629.86"
,CS,AR,32010260,1005,100,,Cash sale,,,,,,29/10/2018,29/10/2018,0.00,,7.75,,"-1,084,637.61"
,CS,AR,32010299,1005,100,,Cash sale,,,,,,29/10/2018,29/10/2018,0.00,,10.93,,"-1,084,648.54"
,CS,AR,32010302,1005,100,,Cash sale,,,,,,29/10/2018,29/10/2018,0.00,,6.56,,"-1,084,655.10"
,CS,AR,32010304,1005,100,,Cash sale,,,,,,29/10/2018,29/10/2018,0.00,,9.84,,"-1,084,664.94"
,CS,AR,32010308,1005,100,,Cash sale,,,,,,29/10/2018,29/10/2018,0.00,,5.08,,"-1,084,670.02"
,CS,AR,32010329,1005,100,,Cash sale,,,,,,29/10/2018,29/10/2018,0.00,,11.44,,"-1,084,681.46"
,CS,AR,32010334,1005,100,,Cash sale,,,,,,29/10/2018,29/10/2018,0.00,,7.29,,"-1,084,688.75"
,CS,AR,32010358,1005,100,,Cash sale,,,,,,29/10/2018,29/10/2018,0.00,,9.10,,"-1,084,697.85"
,CS,AR,32010382,1005,100,,Cash sale,,,,,,29/10/2018,29/10/2018,0.00,,12.14,,"-1,084,709.99"
,CS,AR,32010403,1005,100,,Cash sale,,,,,,29/10/2018,29/10/2018,0.00,,10.93,,"-1,084,720.92"
,CS,AR,32010439,1005,100,,Cash sale,,,,,,29/10/2018,29/10/2018,0.00,,3.64,,"-1,084,724.56"
,CS,AR,32010495,1005,100,,Cash sale,,,,,,29/10/2018,29/10/2018,0.00,,3.64,,"-1,084,728.20"
,CS,AR,32010550,1005,100,,Cash sale,,,,,,29/10/2018,29/10/2018,0.00,,18.64,,"-1,084,746.84"
,CS,AR,32010568,1005,100,,Cash sale,,,,,,29/10/2018,29/10/2018,0.00,,10.93,,"-1,084,757.77"
,CS,AR,32010600,1005,100,,Cash sale,,,,,,29/10/2018,29/10/2018,0.00,,10.93,,"-1,084,768.70"
,CS,AR,32010615,1005,100,,Cash sale,,,,,,29/10/2018,29/10/2018,0.00,,10.93,,"-1,084,779.63"
,IN,AR,30328328,1005,100,,Invoice,,,,,,29/10/2018,29/10/2018,0.00,,17.80,,"-1,084,797.43"
,IN,AR,30328339,1005,100,,Invoice,,,,,,29/10/2018,29/10/2018,0.00,,14.58,,"-1,084,812.01"
,IN,AR,30328392,1005,100,,Invoice,,,,,,29/10/2018,29/10/2018,0.00,,8.10,,"-1,084,820.11"
,IN,AR,30328393,1005,100,,Invoice,,,,,,29/10/2018,29/10/2018,0.00,,4.05,,"-1,084,824.16"
,IN,AR,30328394,1005,100,,Invoice,,,,,,29/10/2018,29/10/2018,0.00,,8.10,,"-1,084,832.26"
,IN,AR,30328395,1005,100,,Invoice,,,,,,29/10/2018,29/10/2018,0.00,,10.13,,"-1,084,842.39"
,IN,AR,30328396,1005,100,,Invoice,,,,,,29/10/2018,29/10/2018,0.00,,20.25,,"-1,084,862.64"
,IN,AR,30328397,1005,100,,Invoice,,,,,,29/10/2018,29/10/2018,0.00,,8.10,,"-1,084,870.74"
,IN,AR,30328398,1005,100,,Invoice,,,,,,29/10/2018,29/10/2018,0.00,,8.10,,"-1,084,878.84"
,IN,AR,30328458,1005,100,,Invoice,,,,,,29/10/2018,29/10/2018,0.00,,76.08,,"-1,084,954.92"
,IN,AR,30328467,1005,100,,Invoice,,,,,,29/10/2018,29/10/2018,0.00,,10.93,,"-1,084,965.85"
,IN,AR,30328510,1005,100,,Invoice,,,,,,29/10/2018,29/10/2018,0.00,,90.00,,"-1,085,055.85"
,IN,AR,30328533,1005,100,,Invoice,,,,,,29/10/2018,29/10/2018,0.00,,52.00,,"-1,085,107.85"
,IN,AR,30328547,1005,100,,Invoice,,,,,,29/10/2018,29/10/2018,0.00,,59.38,,"-1,085,167.23"
,IN,AR,30328573,1005,100,,Invoice,,,,,,29/10/2018,29/10/2018,0.00,,32.00,,"-1,085,199.23"
,IN,AR,30328574,1005,100,,Invoice,,,,,,29/10/2018,29/10/2018,0.00,,20.00,,"-1,085,219.23"
,IN,AR,30328586,1005,100,,Invoice,,,,,,29/10/2018,29/10/2018,0.00,,27.54,,"-1,085,246.77"
,IN,AR,30328587,1005,100,,Invoice,,,,,,29/10/2018,29/10/2018,0.00,,8.26,,"-1,085,255.03"
,IN,AR,30328591,1005,100,,Invoice,,,,,,29/10/2018,29/10/2018,0.00,,33.05,,"-1,085,288.08"
,IN,AR,30328596,1005,100,,Invoice,,,,,,29/10/2018,29/10/2018,0.00,,13.77,,"-1,085,301.85"
,IN,AR,30328600,1005,100,,Invoice,,,,,,29/10/2018,29/10/2018,0.00,,7.29,,"-1,085,309.14"
,IN,AR,30328628,1005,100,,Invoice,,,,,,29/10/2018,29/10/2018,0.00,,12.00,,"-1,085,321.14"
,IN,AR,30328639,1005,100,,Invoice,,,,,,29/10/2018,29/10/2018,0.00,,18.22,,"-1,085,339.36"
,IN,AR,30328684,1005,100,,Invoice,,,,,,29/10/2018,29/10/2018,0.00,,34.00,,"-1,085,373.36"
,IN,AR,30328711,1005,100,,Invoice,,,,,,29/10/2018,29/10/2018,0.00,,20.93,,"-1,085,394.29"
,IN,AR,30328723,1005,100,,Invoice,,,,,,29/10/2018,29/10/2018,0.00,,36.44,,"-1,085,430.73"
,IN,AR,30328779,1005,100,,Invoice,,,,,,29/10/2018,29/10/2018,0.00,,5.25,,"-1,085,435.98"
,IN,AR,30328803,1005,100,,Invoice,,,,,,29/10/2018,29/10/2018,0.00,,2.12,,"-1,085,438.10"
,IN,AR,30328841,1005,100,,Invoice,,,,,,29/10/2018,29/10/2018,0.00,,23.26,,"-1,085,461.36"
,IN,AR,30328854,1005,100,,Invoice,,,,,,29/10/2018,29/10/2018,0.00,,10.38,,"-1,085,471.74"
,IN,AR,30328859,1005,100,,Invoice,,,,,,29/10/2018,29/10/2018,0.00,,10.35,,"-1,085,482.09"
,IN,AR,30328873,1005,100,,Invoice,,,,,,29/10/2018,29/10/2018,0.00,,7.29,,"-1,085,489.38"
,IN,AR,30328907,1005,100,,Invoice,,,,,,29/10/2018,29/10/2018,0.00,,92.29,,"-1,085,581.67"
,IN,AR,30328924,1005,100,,Invoice,,,,,,29/10/2018,29/10/2018,0.00,,78.81,,"-1,085,660.48"
,IN,AR,30328925,1005,100,,Invoice,,,,,,29/10/2018,29/10/2018,0.00,,35.59,,"-1,085,696.07"
,IN,AR,30328943,1005,100,,Invoice,,,,,,29/10/2018,29/10/2018,0.00,,23.90,,"-1,085,719.97"
,IN,AR,30328949,1005,100,,Invoice,,,,,,29/10/2018,29/10/2018,0.00,,35.42,,"-1,085,755.39"
,IN,AR,30328950,1005,100,,Invoice,,,,,,29/10/2018,29/10/2018,0.00,,12.88,,"-1,085,768.27"
,IN,AR,30328960,1005,100,,Invoice,,,,,,29/10/2018,29/10/2018,0.00,,12.03,,"-1,085,780.30"
,IN,AR,30328972,1005,100,,Invoice,,,,,,29/10/2018,29/10/2018,0.00,,2.12,,"-1,085,782.42"
,IN,AR,30328977,1005,100,,Invoice,,,,,,29/10/2018,29/10/2018,0.00,,9.03,,"-1,085,791.45"
,IN,AR,30328987,1005,100,,Invoice,,,,,,29/10/2018,29/10/2018,0.00,,8.47,,"-1,085,799.92"
,IN,AR,30329049,1005,100,,Invoice,,,,,,29/10/2018,29/10/2018,0.00,,7.63,,"-1,085,807.55"
,IN,AR,30329160,1005,100,,Invoice,,,,,,29/10/2018,29/10/2018,0.00,,25.42,,"-1,085,832.97"
,IN,AR,30329172,1005,100,,Invoice,,,,,,29/10/2018,29/10/2018,0.00,,16.27,,"-1,085,849.24"
,IN,AR,30329182,1005,100,,Invoice,,,,,,29/10/2018,29/10/2018,0.00,,8.26,,"-1,085,857.50"
,IN,AR,30329211,1005,100,,Invoice,,,,,,29/10/2018,29/10/2018,0.00,,3.64,,"-1,085,861.14"
,IN,AR,30329218,1005,100,,Invoice,,,,,,29/10/2018,29/10/2018,0.00,,10.93,,"-1,085,872.07"
,IN,AR,30329221,1005,100,,Invoice,,,,,,29/10/2018,29/10/2018,0.00,,4.24,,"-1,085,876.31"
,IN,AR,30329247,1005,100,,Invoice,,,,,,29/10/2018,29/10/2018,0.00,,11.02,,"-1,085,887.33"
,IN,AR,30329251,1005,100,,Invoice,,,,,,29/10/2018,29/10/2018,0.00,,10.93,,"-1,085,898.26"
,IN,AR,30329264,1005,100,,Invoice,,,,,,29/10/2018,29/10/2018,0.00,,15.21,,"-1,085,913.47"
,IN,AR,30329273,1005,100,,Invoice,,,,,,29/10/2018,29/10/2018,0.00,,9.19,,"-1,085,922.66"
,IN,AR,30329281,1005,100,,Invoice,,,,,,29/10/2018,29/10/2018,0.00,,19.64,,"-1,085,942.30"
,IN,AR,30329305,1005,100,,Invoice,,,,,,29/10/2018,29/10/2018,0.00,,18.22,,"-1,085,960.52"
,IN,AR,30329342,1005,100,,Invoice,,,,,,29/10/2018,29/10/2018,0.00,,63.46,,"-1,086,023.98"
,IN,AR,30329350,1005,100,,Invoice,,,,,,29/10/2018,29/10/2018,0.00,,7.29,,"-1,086,031.27"
,IN,AR,30329356,1005,100,,Invoice,,,,,,29/10/2018,29/10/2018,0.00,,6.00,,"-1,086,037.27"
,IN,AR,30329411,1005,100,,Invoice,,,,,,29/10/2018,29/10/2018,0.00,,45.97,,"-1,086,083.24"
,IN,AR,30329420,1005,100,,Invoice,,,,,,29/10/2018,29/10/2018,0.00,,4.49,,"-1,086,087.73"
,IN,AR,30329506,1005,100,,Invoice,,,,,,29/10/2018,29/10/2018,0.00,,10.93,,"-1,086,098.66"
,IN,AR,30329544,1005,100,,Invoice,,,,,,29/10/2018,29/10/2018,0.00,,14.58,,"-1,086,113.24"
,IN,AR,30329584,1005,100,,Invoice,,,,,,29/10/2018,29/10/2018,0.00,,4.29,,"-1,086,117.53"
,IN,AR,30329651,1005,100,,Invoice,,,,,,29/10/2018,29/10/2018,0.00,,1.99,,"-1,086,119.52"
,IN,AR,30329652,1005,100,,Invoice,,,,,,29/10/2018,29/10/2018,0.00,,9.95,,"-1,086,129.47"
,IN,AR,30329700,1005,100,,Invoice,,,,,,29/10/2018,29/10/2018,0.00,,24.05,,"-1,086,153.52"
,IN,AR,30329719,1005,100,,Invoice,,,,,,29/10/2018,29/10/2018,0.00,,15.18,,"-1,086,168.70"
,IN,AR,30329745,1005,100,,Invoice,,,,,,29/10/2018,29/10/2018,0.00,,31.53,,"-1,086,200.23"
,IN,AR,30329749,1005,100,,Invoice,,,,,,29/10/2018,29/10/2018,0.00,,4.58,,"-1,086,204.81"
,IN,AR,30329779,1005,100,,Invoice,,,,,,29/10/2018,29/10/2018,0.00,,18.22,,"-1,086,223.03"
,IN,AR,30329815,1005,100,,Invoice,,,,,,29/10/2018,29/10/2018,0.00,,12.00,,"-1,086,235.03"
,IN,AR,30329853,1005,100,,Invoice,,,,,,29/10/2018,29/10/2018,0.00,,49.78,,"-1,086,284.81"
,IN,AR,30329887,1005,100,,Invoice,,,,,,29/10/2018,29/10/2018,0.00,,4.20,,"-1,086,289.01"
,IN,AR,30329902,1005,100,,Invoice,,,,,,29/10/2018,29/10/2018,0.00,,14.58,,"-1,086,303.59"
,IN,AR,30329908,1005,100,,Invoice,,,,,,29/10/2018,29/10/2018,0.00,,31.41,,"-1,086,335.00"
,IN,AR,30329913,1005,100,,Invoice,,,,,,29/10/2018,29/10/2018,0.00,,193.43,,"-1,086,528.43"
,IN,AR,30329914,1005,100,,Invoice,,,,,,29/10/2018,29/10/2018,0.00,,4.66,,"-1,086,533.09"
,IN,AR,30329928,1005,100,,Invoice,,,,,,29/10/2018,29/10/2018,0.00,,19.64,,"-1,086,552.73"
,IN,AR,30329943,1005,100,,Invoice,,,,,,29/10/2018,29/10/2018,0.00,,12.85,,"-1,086,565.58"
,IN,AR,30329987,1005,100,,Invoice,,,,,,29/10/2018,29/10/2018,0.00,,37.37,,"-1,086,602.95"
,IN,AR,30330021,1005,100,,Invoice,,,,,,29/10/2018,29/10/2018,0.00,,7.97,,"-1,086,610.92"
,IN,AR,30330096,1005,100,,Invoice,,,,,,29/10/2018,29/10/2018,0.00,,12.00,,"-1,086,622.92"
,IN,AR,30330110,1005,100,,Invoice,,,,,,29/10/2018,29/10/2018,0.00,,1.88,,"-1,086,624.80"
,IN,AR,30330111,1005,100,,Invoice,,,,,,29/10/2018,29/10/2018,0.00,,7.53,,"-1,086,632.33"
,IN,AR,30330132,1005,100,,Invoice,,,,,,29/10/2018,29/10/2018,0.00,,18.22,,"-1,086,650.55"
,IN,AR,30330167,1005,100,,Invoice,,,,,,29/10/2018,29/10/2018,0.00,,8.21,,"-1,086,658.76"
,IN,AR,30330189,1005,100,,Invoice,,,,,,29/10/2018,29/10/2018,0.00,,10.93,,"-1,086,669.69"
,IN,AR,30330207,1005,100,,Invoice,,,,,,29/10/2018,29/10/2018,0.00,,10.47,,"-1,086,680.16"
,IN,AR,30330210,1005,100,,Invoice,,,,,,29/10/2018,29/10/2018,0.00,,8.77,,"-1,086,688.93"
,IN,AR,30330232,1005,100,,Invoice,,,,,,29/10/2018,29/10/2018,0.00,,4.08,,"-1,086,693.01"
,IN,AR,30330259,1005,100,,Invoice,,,,,,29/10/2018,29/10/2018,0.00,,35.08,,"-1,086,728.09"
,IN,AR,30330284,1005,100,,Invoice,,,,,,29/10/2018,29/10/2018,0.00,,4.00,,"-1,086,732.09"
,IN,AR,30330335,1005,100,,Invoice,,,,,,29/10/2018,29/10/2018,0.00,,4.15,,"-1,086,736.24"
,IN,AR,30330336,1005,100,,Invoice,,,,,,29/10/2018,29/10/2018,0.00,,4.15,,"-1,086,740.39"
,IN,AR,30330337,1005,100,,Invoice,,,,,,29/10/2018,29/10/2018,0.00,,16.61,,"-1,086,757.00"
,IN,AR,30330338,1005,100,,Invoice,,,,,,29/10/2018,29/10/2018,0.00,,4.15,,"-1,086,761.15"
,IN,AR,30330339,1005,100,,Invoice,,,,,,29/10/2018,29/10/2018,0.00,,4.15,,"-1,086,765.30"
,IN,AR,30330397,1005,100,,Invoice,,,,,,29/10/2018,29/10/2018,0.00,,1.75,,"-1,086,767.05"
,IN,AR,30330416,1005,100,,Invoice,,,,,,29/10/2018,29/10/2018,0.00,,6.31,,"-1,086,773.36"
,IN,AR,30330449,1005,100,,Invoice,,,,,,29/10/2018,29/10/2018,0.00,,69.71,,"-1,086,843.07"
,IN,AR,30330480,1005,100,,Invoice,,,,,,29/10/2018,29/10/2018,0.00,,10.93,,"-1,086,854.00"
,CS,AR,32010635,1005,100,,Cash sale,,,,,,29/10/2018,29/10/2018,0.00,,10.93,,"-1,086,864.93"
,IN,AR,30330576,1005,100,,Invoice,,,,,,29/10/2018,29/10/2018,0.00,,182.20,,"-1,087,047.13"
,IN,AR,30330614,1005,100,,Invoice,,,,,,29/10/2018,29/10/2018,0.00,,54.66,,"-1,087,101.79"
,CN,AR,31019197,1005,100,,Credit Note,,,,,,30/10/2018,30/10/2018,1.99,,0.00,,"-1,087,099.80"
,CN,AR,31019346,1005,100,,Credit Note,,,,,,30/10/2018,30/10/2018,29.15,,0.00,,"-1,087,070.65"
,CS,AR,32009743,1005,100,,Cash sale,,,,,,30/10/2018,30/10/2018,0.00,,3.64,,"-1,087,074.29"
,CS,AR,32009755,1005,100,,Cash sale,,,,,,30/10/2018,30/10/2018,0.00,,3.64,,"-1,087,077.93"
,CS,AR,32009769,1005,100,,Cash sale,,,,,,30/10/2018,30/10/2018,0.00,,14.58,,"-1,087,092.51"
,CS,AR,32009786,1005,100,,Cash sale,,,,,,30/10/2018,30/10/2018,0.00,,10.93,,"-1,087,103.44"
,CS,AR,32009810,1005,100,,Cash sale,,,,,,30/10/2018,30/10/2018,0.00,,3.01,,"-1,087,106.45"
,CS,AR,32009816,1005,100,,Cash sale,,,,,,30/10/2018,30/10/2018,0.00,,14.58,,"-1,087,121.03"
,CS,AR,32009822,1005,100,,Cash sale,,,,,,30/10/2018,30/10/2018,0.00,,3.64,,"-1,087,124.67"
,CS,AR,32009832,1005,100,,Cash sale,,,,,,30/10/2018,30/10/2018,0.00,,3.64,,"-1,087,128.31"
,CS,AR,32009875,1005,100,,Cash sale,,,,,,30/10/2018,30/10/2018,0.00,,14.58,,"-1,087,142.89"
,CS,AR,32009882,1005,100,,Cash sale,,,,,,30/10/2018,30/10/2018,0.00,,18.05,,"-1,087,160.94"
,CS,AR,32009923,1005,100,,Cash sale,,,,,,30/10/2018,30/10/2018,0.00,,4.32,,"-1,087,165.26"
,CS,AR,32009947,1005,100,,Cash sale,,,,,,30/10/2018,30/10/2018,0.00,,1.95,,"-1,087,167.21"
,CS,AR,32009949,1005,100,,Cash sale,,,,,,30/10/2018,30/10/2018,0.00,,22.37,,"-1,087,189.58"
,CS,AR,32009961,1005,100,,Cash sale,,,,,,30/10/2018,30/10/2018,0.00,,10.93,,"-1,087,200.51"
,CS,AR,32009969,1005,100,,Cash sale,,,,,,30/10/2018,30/10/2018,0.00,,5.17,,"-1,087,205.68"
,CS,AR,32009991,1005,100,,Cash sale,,,,,,30/10/2018,30/10/2018,0.00,,7.29,,"-1,087,212.97"
,CS,AR,32010001,1005,100,,Cash sale,,,,,,30/10/2018,30/10/2018,0.00,,6.43,,"-1,087,219.40"
,CS,AR,32010007,1005,100,,Cash sale,,,,,,30/10/2018,30/10/2018,0.00,,3.64,,"-1,087,223.04"
,CS,AR,32010052,1005,100,,Cash sale,,,,,,30/10/2018,30/10/2018,0.00,,18.22,,"-1,087,241.26"
,CS,AR,32010062,1005,100,,Cash sale,,,,,,30/10/2018,30/10/2018,0.00,,5.85,,"-1,087,247.11"
,CS,AR,32010074,1005,100,,Cash sale,,,,,,30/10/2018,30/10/2018,0.00,,1.95,,"-1,087,249.06"
,CS,AR,32010094,1005,100,,Cash sale,,,,,,30/10/2018,30/10/2018,0.00,,12.92,,"-1,087,261.98"
,CS,AR,32010115,1005,100,,Cash sale,,,,,,30/10/2018,30/10/2018,0.00,,7.29,,"-1,087,269.27"
,CS,AR,32010136,1005,100,,Cash sale,,,,,,30/10/2018,30/10/2018,0.00,,14.58,,"-1,087,283.85"
,CS,AR,32010139,1005,100,,Cash sale,,,,,,30/10/2018,30/10/2018,0.00,,3.64,,"-1,087,287.49"
,CS,AR,32010157,1005,100,,Cash sale,,,,,,30/10/2018,30/10/2018,0.00,,3.64,,"-1,087,291.13"
,CS,AR,32010169,1005,100,,Cash sale,,,,,,30/10/2018,30/10/2018,0.00,,7.29,,"-1,087,298.42"
,CS,AR,32010187,1005,100,,Cash sale,,,,,,30/10/2018,30/10/2018,0.00,,3.64,,"-1,087,302.06"
,CS,AR,32010232,1005,100,,Cash sale,,,,,,30/10/2018,30/10/2018,0.00,,21.86,,"-1,087,323.92"
,CS,AR,32010235,1005,100,,Cash sale,,,,,,30/10/2018,30/10/2018,0.00,,7.29,,"-1,087,331.21"
,CS,AR,32010237,1005,100,,Cash sale,,,,,,30/10/2018,30/10/2018,0.00,,10.93,,"-1,087,342.14"
,CS,AR,32010256,1005,100,,Cash sale,,,,,,30/10/2018,30/10/2018,0.00,,7.29,,"-1,087,349.43"
,CS,AR,32010273,1005,100,,Cash sale,,,,,,30/10/2018,30/10/2018,0.00,,15.25,,"-1,087,364.68"
,CS,AR,32010278,1005,100,,Cash sale,,,,,,30/10/2018,30/10/2018,0.00,,26.00,,"-1,087,390.68"
,CS,AR,32010287,1005,100,,Cash sale,,,,,,30/10/2018,30/10/2018,0.00,,7.29,,"-1,087,397.97"
,CS,AR,32010344,1005,100,,Cash sale,,,,,,30/10/2018,30/10/2018,0.00,,5.93,,"-1,087,403.90"
,CS,AR,32010364,1005,100,,Cash sale,,,,,,30/10/2018,30/10/2018,0.00,,5.50,,"-1,087,409.40"
,CS,AR,32010385,1005,100,,Cash sale,,,,,,30/10/2018,30/10/2018,0.00,,18.22,,"-1,087,427.62"
,CS,AR,32010387,1005,100,,Cash sale,,,,,,30/10/2018,30/10/2018,0.00,,10.93,,"-1,087,438.55"
,CS,AR,32010418,1005,100,,Cash sale,,,,,,30/10/2018,30/10/2018,0.00,,7.29,,"-1,087,445.84"
,CS,AR,32010436,1005,100,,Cash sale,,,,,,30/10/2018,30/10/2018,0.00,,7.29,,"-1,087,453.13"
,CS,AR,32010454,1005,100,,Cash sale,,,,,,30/10/2018,30/10/2018,0.00,,24.64,,"-1,087,477.77"
,CS,AR,32010486,1005,100,,Cash sale,,,,,,30/10/2018,30/10/2018,0.00,,7.75,,"-1,087,485.52"
,CS,AR,32010592,1005,100,,Cash sale,,,,,,30/10/2018,30/10/2018,0.00,,2.97,,"-1,087,488.49"
,CS,AR,32010603,1005,100,,Cash sale,,,,,,30/10/2018,30/10/2018,0.00,,6.42,,"-1,087,494.91"
,IN,AR,30328309,1005,100,,Invoice,,,,,,30/10/2018,30/10/2018,0.00,,6.02,,"-1,087,500.93"
,IN,AR,30328312,1005,100,,Invoice,,,,,,30/10/2018,30/10/2018,0.00,,84.54,,"-1,087,585.47"
,IN,AR,30328368,1005,100,,Invoice,,,,,,30/10/2018,30/10/2018,0.00,,60.45,,"-1,087,645.92"
,IN,AR,30328425,1005,100,,Invoice,,,,,,30/10/2018,30/10/2018,0.00,,10.51,,"-1,087,656.43"
,IN,AR,30328446,1005,100,,Invoice,,,,,,30/10/2018,30/10/2018,0.00,,3.64,,"-1,087,660.07"
,IN,AR,30328451,1005,100,,Invoice,,,,,,30/10/2018,30/10/2018,0.00,,7.00,,"-1,087,667.07"
,IN,AR,30328462,1005,100,,Invoice,,,,,,30/10/2018,30/10/2018,0.00,,5.59,,"-1,087,672.66"
,IN,AR,30328489,1005,100,,Invoice,,,,,,30/10/2018,30/10/2018,0.00,,7.97,,"-1,087,680.63"
,IN,AR,30328511,1005,100,,Invoice,,,,,,30/10/2018,30/10/2018,0.00,,52.00,,"-1,087,732.63"
,IN,AR,30328514,1005,100,,Invoice,,,,,,30/10/2018,30/10/2018,0.00,,3.64,,"-1,087,736.27"
,IN,AR,30328542,1005,100,,Invoice,,,,,,30/10/2018,30/10/2018,0.00,,3.64,,"-1,087,739.91"
,IN,AR,30328632,1005,100,,Invoice,,,,,,30/10/2018,30/10/2018,0.00,,7.29,,"-1,087,747.20"
,IN,AR,30328693,1005,100,,Invoice,,,,,,30/10/2018,30/10/2018,0.00,,13.74,,"-1,087,760.94"
,IN,AR,30328696,1005,100,,Invoice,,,,,,30/10/2018,30/10/2018,0.00,,10.93,,"-1,087,771.87"
,IN,AR,30328756,1005,100,,Invoice,,,,,,30/10/2018,30/10/2018,0.00,,35.69,,"-1,087,807.56"
,IN,AR,30328774,1005,100,,Invoice,,,,,,30/10/2018,30/10/2018,0.00,,27.97,,"-1,087,835.53"
,IN,AR,30328777,1005,100,,Invoice,,,,,,30/10/2018,30/10/2018,0.00,,10.93,,"-1,087,846.46"
,IN,AR,30328794,1005,100,,Invoice,,,,,,30/10/2018,30/10/2018,0.00,,12.71,,"-1,087,859.17"
,IN,AR,30328823,1005,100,,Invoice,,,,,,30/10/2018,30/10/2018,0.00,,6.36,,"-1,087,865.53"
,IN,AR,30328883,1005,100,,Invoice,,,,,,30/10/2018,30/10/2018,0.00,,12.03,,"-1,087,877.56"
,IN,AR,30328894,1005,100,,Invoice,,,,,,30/10/2018,30/10/2018,0.00,,7.80,,"-1,087,885.36"
,IN,AR,30328929,1005,100,,Invoice,,,,,,30/10/2018,30/10/2018,0.00,,9.43,,"-1,087,894.79"
,IN,AR,30328944,1005,100,,Invoice,,,,,,30/10/2018,30/10/2018,0.00,,2.39,,"-1,087,897.18"
,IN,AR,30328951,1005,100,,Invoice,,,,,,30/10/2018,30/10/2018,0.00,,6.44,,"-1,087,903.62"
,IN,AR,30328982,1005,100,,Invoice,,,,,,30/10/2018,30/10/2018,0.00,,27.97,,"-1,087,931.59"
,IN,AR,30329053,1005,100,,Invoice,,,,,,30/10/2018,30/10/2018,0.00,,7.29,,"-1,087,938.88"
,IN,AR,30329070,1005,100,,Invoice,,,,,,30/10/2018,30/10/2018,0.00,,7.80,,"-1,087,946.68"
,IN,AR,30329075,1005,100,,Invoice,,,,,,30/10/2018,30/10/2018,0.00,,15.25,,"-1,087,961.93"
,IN,AR,30329131,1005,100,,Invoice,,,,,,30/10/2018,30/10/2018,0.00,,7.29,,"-1,087,969.22"
,IN,AR,30329150,1005,100,,Invoice,,,,,,30/10/2018,30/10/2018,0.00,,14.24,,"-1,087,983.46"
,IN,AR,30329168,1005,100,,Invoice,,,,,,30/10/2018,30/10/2018,0.00,,3.01,,"-1,087,986.47"
,IN,AR,30329183,1005,100,,Invoice,,,,,,30/10/2018,30/10/2018,0.00,,13.22,,"-1,087,999.69"
,IN,AR,30329185,1005,100,,Invoice,,,,,,30/10/2018,30/10/2018,0.00,,2.39,,"-1,088,002.08"
,IN,AR,30329194,1005,100,,Invoice,,,,,,30/10/2018,30/10/2018,0.00,,17.80,,"-1,088,019.88"
,IN,AR,30329202,1005,100,,Invoice,,,,,,30/10/2018,30/10/2018,0.00,,10.53,,"-1,088,030.41"
,IN,AR,30329224,1005,100,,Invoice,,,,,,30/10/2018,30/10/2018,0.00,,8.47,,"-1,088,038.88"
,IN,AR,30329237,1005,100,,Invoice,,,,,,30/10/2018,30/10/2018,0.00,,6.36,,"-1,088,045.24"
,IN,AR,30329244,1005,100,,Invoice,,,,,,30/10/2018,30/10/2018,0.00,,4.24,,"-1,088,049.48"
,IN,AR,30329256,1005,100,,Invoice,,,,,,30/10/2018,30/10/2018,0.00,,3.64,,"-1,088,053.12"
,IN,AR,30329288,1005,100,,Invoice,,,,,,30/10/2018,30/10/2018,0.00,,6.36,,"-1,088,059.48"
,IN,AR,30329320,1005,100,,Invoice,,,,,,30/10/2018,30/10/2018,0.00,,10.93,,"-1,088,070.41"
,IN,AR,30329361,1005,100,,Invoice,,,,,,30/10/2018,30/10/2018,0.00,,21.05,,"-1,088,091.46"
,IN,AR,30329383,1005,100,,Invoice,,,,,,30/10/2018,30/10/2018,0.00,,8.26,,"-1,088,099.72"
,IN,AR,30329388,1005,100,,Invoice,,,,,,30/10/2018,30/10/2018,0.00,,5.59,,"-1,088,105.31"
,IN,AR,30329400,1005,100,,Invoice,,,,,,30/10/2018,30/10/2018,0.00,,5.86,,"-1,088,111.17"
,IN,AR,30329451,1005,100,,Invoice,,,,,,30/10/2018,30/10/2018,0.00,,7.29,,"-1,088,118.46"
,IN,AR,30329456,1005,100,,Invoice,,,,,,30/10/2018,30/10/2018,0.00,,25.73,,"-1,088,144.19"
,IN,AR,30329464,1005,100,,Invoice,,,,,,30/10/2018,30/10/2018,0.00,,18.22,,"-1,088,162.41"
,IN,AR,30329466,1005,100,,Invoice,,,,,,30/10/2018,30/10/2018,0.00,,3.76,,"-1,088,166.17"
,IN,AR,30329472,1005,100,,Invoice,,,,,,30/10/2018,30/10/2018,0.00,,21.44,,"-1,088,187.61"
,IN,AR,30329494,1005,100,,Invoice,,,,,,30/10/2018,30/10/2018,0.00,,3.53,,"-1,088,191.14"
,IN,AR,30329526,1005,100,,Invoice,,,,,,30/10/2018,30/10/2018,0.00,,82.63,,"-1,088,273.77"
,IN,AR,30329534,1005,100,,Invoice,,,,,,30/10/2018,30/10/2018,0.00,,3.64,,"-1,088,277.41"
,IN,AR,30329653,1005,100,,Invoice,,,,,,30/10/2018,30/10/2018,0.00,,13.93,,"-1,088,291.34"
,IN,AR,30329654,1005,100,,Invoice,,,,,,30/10/2018,30/10/2018,0.00,,5.97,,"-1,088,297.31"
,IN,AR,30329655,1005,100,,Invoice,,,,,,30/10/2018,30/10/2018,0.00,,153.22,,"-1,088,450.53"
,IN,AR,30329656,1005,100,,Invoice,,,,,,30/10/2018,30/10/2018,0.00,,17.91,,"-1,088,468.44"
,IN,AR,30329657,1005,100,,Invoice,,,,,,30/10/2018,30/10/2018,0.00,,43.78,,"-1,088,512.22"
,IN,AR,30329670,1005,100,,Invoice,,,,,,30/10/2018,30/10/2018,0.00,,45.42,,"-1,088,557.64"
,IN,AR,30329717,1005,100,,Invoice,,,,,,30/10/2018,30/10/2018,0.00,,6.02,,"-1,088,563.66"
,IN,AR,30329730,1005,100,,Invoice,,,,,,30/10/2018,30/10/2018,0.00,,198.97,,"-1,088,762.63"
,IN,AR,30329755,1005,100,,Invoice,,,,,,30/10/2018,30/10/2018,0.00,,6.56,,"-1,088,769.19"
,IN,AR,30329780,1005,100,,Invoice,,,,,,30/10/2018,30/10/2018,0.00,,14.58,,"-1,088,783.77"
,IN,AR,30329803,1005,100,,Invoice,,,,,,30/10/2018,30/10/2018,0.00,,7.63,,"-1,088,791.40"
,IN,AR,30329822,1005,100,,Invoice,,,,,,30/10/2018,30/10/2018,0.00,,16.01,,"-1,088,807.41"
,IN,AR,30329834,1005,100,,Invoice,,,,,,30/10/2018,30/10/2018,0.00,,103.81,,"-1,088,911.22"
,IN,AR,30329921,1005,100,,Invoice,,,,,,30/10/2018,30/10/2018,0.00,,8.21,,"-1,088,919.43"
,IN,AR,30329947,1005,100,,Invoice,,,,,,30/10/2018,30/10/2018,0.00,,152.00,,"-1,089,071.43"
,IN,AR,30329960,1005,100,,Invoice,,,,,,30/10/2018,30/10/2018,0.00,,42.71,,"-1,089,114.14"
,IN,AR,30330027,1005,100,,Invoice,,,,,,30/10/2018,30/10/2018,0.00,,97.63,,"-1,089,211.77"
,IN,AR,30330075,1005,100,,Invoice,,,,,,30/10/2018,30/10/2018,0.00,,33.22,,"-1,089,244.99"
,IN,AR,30330076,1005,100,,Invoice,,,,,,30/10/2018,30/10/2018,0.00,,97.30,,"-1,089,342.29"
,IN,AR,30330077,1005,100,,Invoice,,,,,,30/10/2018,30/10/2018,0.00,,28.47,,"-1,089,370.76"
,IN,AR,30330086,1005,100,,Invoice,,,,,,30/10/2018,30/10/2018,0.00,,14.24,,"-1,089,385.00"
,IN,AR,30330119,1005,100,,Invoice,,,,,,30/10/2018,30/10/2018,0.00,,3.51,,"-1,089,388.51"
,IN,AR,30330124,1005,100,,Invoice,,,,,,30/10/2018,30/10/2018,0.00,,10.00,,"-1,089,398.51"
,IN,AR,30330140,1005,100,,Invoice,,,,,,30/10/2018,30/10/2018,0.00,,72.61,,"-1,089,471.12"
,IN,AR,30330142,1005,100,,Invoice,,,,,,30/10/2018,30/10/2018,0.00,,7.29,,"-1,089,478.41"
,IN,AR,30330144,1005,100,,Invoice,,,,,,30/10/2018,30/10/2018,0.00,,29.15,,"-1,089,507.56"
,IN,AR,30330152,1005,100,,Invoice,,,,,,30/10/2018,30/10/2018,0.00,,3.51,,"-1,089,511.07"
,IN,AR,30330173,1005,100,,Invoice,,,,,,30/10/2018,30/10/2018,0.00,,14.58,,"-1,089,525.65"
,IN,AR,30330187,1005,100,,Invoice,,,,,,30/10/2018,30/10/2018,0.00,,14.58,,"-1,089,540.23"
,IN,AR,30330195,1005,100,,Invoice,,,,,,30/10/2018,30/10/2018,0.00,,14.58,,"-1,089,554.81"
,IN,AR,30330196,1005,100,,Invoice,,,,,,30/10/2018,30/10/2018,0.00,,14.58,,"-1,089,569.39"
,IN,AR,30330233,1005,100,,Invoice,,,,,,30/10/2018,30/10/2018,0.00,,20.42,,"-1,089,589.81"
,IN,AR,30330246,1005,100,,Invoice,,,,,,30/10/2018,30/10/2018,0.00,,5.51,,"-1,089,595.32"
,IN,AR,30330255,1005,100,,Invoice,,,,,,30/10/2018,30/10/2018,0.00,,11.95,,"-1,089,607.27"
,IN,AR,30330268,1005,100,,Invoice,,,,,,30/10/2018,30/10/2018,0.00,,7.29,,"-1,089,614.56"
,IN,AR,30330340,1005,100,,Invoice,,,,,,30/10/2018,30/10/2018,0.00,,8.31,,"-1,089,622.87"
,IN,AR,30330348,1005,100,,Invoice,,,,,,30/10/2018,30/10/2018,0.00,,22.88,,"-1,089,645.75"
,IN,AR,30330355,1005,100,,Invoice,,,,,,30/10/2018,30/10/2018,0.00,,21.74,,"-1,089,667.49"
,IN,AR,30330358,1005,100,,Invoice,,,,,,30/10/2018,30/10/2018,0.00,,14.58,,"-1,089,682.07"
,IN,AR,30330374,1005,100,,Invoice,,,,,,30/10/2018,30/10/2018,0.00,,7.29,,"-1,089,689.36"
,IN,AR,30330382,1005,100,,Invoice,,,,,,30/10/2018,30/10/2018,0.00,,6.10,,"-1,089,695.46"
,IN,AR,30330387,1005,100,,Invoice,,,,,,30/10/2018,30/10/2018,0.00,,13.56,,"-1,089,709.02"
,IN,AR,30330438,1005,100,,Invoice,,,,,,30/10/2018,30/10/2018,0.00,,103.15,,"-1,089,812.17"
,IN,AR,30330445,1005,100,,Invoice,,,,,,30/10/2018,30/10/2018,0.00,,5.93,,"-1,089,818.10"
,IN,AR,30330531,1005,100,,Invoice,,,,,,30/10/2018,30/10/2018,0.00,,14.58,,"-1,089,832.68"
,IN,AR,30330534,1005,100,,Invoice,,,,,,30/10/2018,30/10/2018,0.00,,10.93,,"-1,089,843.61"
,IN,AR,30330536,1005,100,,Invoice,,,,,,30/10/2018,30/10/2018,0.00,,14.58,,"-1,089,858.19"
,IN,AR,30330537,1005,100,,Invoice,,,,,,30/10/2018,30/10/2018,0.00,,29.15,,"-1,089,887.34"
,IN,AR,30330568,1005,100,,Invoice,,,,,,30/10/2018,30/10/2018,0.00,,182.20,,"-1,090,069.54"
,IN,AR,30330607,1005,100,,Invoice,,,,,,30/10/2018,30/10/2018,0.00,,54.66,,"-1,090,124.20"
,IN,AR,30330623,1005,100,,Invoice,,,,,,30/10/2018,30/10/2018,0.00,,10.93,,"-1,090,135.13"
,IN,AR,30330692,1005,100,,Invoice,,,,,,30/10/2018,30/10/2018,0.00,,"1,093.22",,"-1,091,228.35"
,IN,AR,30330724,1005,100,,Invoice,,,,,,30/10/2018,30/10/2018,0.00,,10.93,,"-1,091,239.28"
,CN,AR,31019238,1005,100,,Credit Note,,,,,,31/10/2018,31/10/2018,69.73,,0.00,,"-1,091,169.55"
,CN,AR,31019267,1005,100,,Credit Note,,,,,,31/10/2018,31/10/2018,18.22,,0.00,,"-1,091,151.33"
,CN,AR,31019287,1005,100,,Credit Note,,,,,,31/10/2018,31/10/2018,652.65,,0.00,,"-1,090,498.68"
,CN,AR,31019288,1005,100,,Credit Note,,,,,,31/10/2018,31/10/2018,815.81,,0.00,,"-1,089,682.87"
,CS,AR,32009724,1005,100,,Cash sale,,,,,,31/10/2018,31/10/2018,0.00,,3.64,,"-1,089,686.51"
,CS,AR,32009728,1005,100,,Cash sale,,,,,,31/10/2018,31/10/2018,0.00,,25.08,,"-1,089,711.59"
,CS,AR,32009775,1005,100,,Cash sale,,,,,,31/10/2018,31/10/2018,0.00,,3.64,,"-1,089,715.23"
,CS,AR,32009782,1005,100,,Cash sale,,,,,,31/10/2018,31/10/2018,0.00,,10.93,,"-1,089,726.16"
,CS,AR,32009788,1005,100,,Cash sale,,,,,,31/10/2018,31/10/2018,0.00,,3.64,,"-1,089,729.80"
,CS,AR,32009801,1005,100,,Cash sale,,,,,,31/10/2018,31/10/2018,0.00,,3.64,,"-1,089,733.44"
,CS,AR,32009834,1005,100,,Cash sale,,,,,,31/10/2018,31/10/2018,0.00,,10.93,,"-1,089,744.37"
,CS,AR,32009861,1005,100,,Cash sale,,,,,,31/10/2018,31/10/2018,0.00,,8.77,,"-1,089,753.14"
,CS,AR,32009892,1005,100,,Cash sale,,,,,,31/10/2018,31/10/2018,0.00,,3.64,,"-1,089,756.78"
,CS,AR,32009897,1005,100,,Cash sale,,,,,,31/10/2018,31/10/2018,0.00,,5.86,,"-1,089,762.64"
,CS,AR,32009910,1005,100,,Cash sale,,,,,,31/10/2018,31/10/2018,0.00,,10.34,,"-1,089,772.98"
,CS,AR,32009912,1005,100,,Cash sale,,,,,,31/10/2018,31/10/2018,0.00,,14.58,,"-1,089,787.56"
,CS,AR,32009919,1005,100,,Cash sale,,,,,,31/10/2018,31/10/2018,0.00,,3.64,,"-1,089,791.20"
,CS,AR,32009927,1005,100,,Cash sale,,,,,,31/10/2018,31/10/2018,0.00,,7.29,,"-1,089,798.49"
,CS,AR,32009958,1005,100,,Cash sale,,,,,,31/10/2018,31/10/2018,0.00,,10.34,,"-1,089,808.83"
,CS,AR,32009968,1005,100,,Cash sale,,,,,,31/10/2018,31/10/2018,0.00,,31.02,,"-1,089,839.85"
,CS,AR,32009995,1005,100,,Cash sale,,,,,,31/10/2018,31/10/2018,0.00,,14.58,,"-1,089,854.43"
,CS,AR,32010017,1005,100,,Cash sale,,,,,,31/10/2018,31/10/2018,0.00,,10.17,,"-1,089,864.60"
,CS,AR,32010117,1005,100,,Cash sale,,,,,,31/10/2018,31/10/2018,0.00,,5.08,,"-1,089,869.68"
,CS,AR,32010151,1005,100,,Cash sale,,,,,,31/10/2018,31/10/2018,0.00,,7.29,,"-1,089,876.97"
,CS,AR,32010167,1005,100,,Cash sale,,,,,,31/10/2018,31/10/2018,0.00,,18.22,,"-1,089,895.19"
,CS,AR,32010210,1005,100,,Cash sale,,,,,,31/10/2018,31/10/2018,0.00,,5.34,,"-1,089,900.53"
,CS,AR,32010216,1005,100,,Cash sale,,,,,,31/10/2018,31/10/2018,0.00,,5.17,,"-1,089,905.70"
,CS,AR,32010229,1005,100,,Cash sale,,,,,,31/10/2018,31/10/2018,0.00,,18.98,,"-1,089,924.68"
,CS,AR,32010230,1005,100,,Cash sale,,,,,,31/10/2018,31/10/2018,0.00,,5.93,,"-1,089,930.61"
,CS,AR,32010233,1005,100,,Cash sale,,,,,,31/10/2018,31/10/2018,0.00,,4.88,,"-1,089,935.49"
,CS,AR,32010239,1005,100,,Cash sale,,,,,,31/10/2018,31/10/2018,0.00,,10.93,,"-1,089,946.42"
,CS,AR,32010267,1005,100,,Cash sale,,,,,,31/10/2018,31/10/2018,0.00,,3.64,,"-1,089,950.06"
,CS,AR,32010270,1005,100,,Cash sale,,,,,,31/10/2018,31/10/2018,0.00,,9.15,,"-1,089,959.21"
,CS,AR,32010290,1005,100,,Cash sale,,,,,,31/10/2018,31/10/2018,0.00,,5.51,,"-1,089,964.72"
,CS,AR,32010294,1005,100,,Cash sale,,,,,,31/10/2018,31/10/2018,0.00,,10.93,,"-1,089,975.65"
,CS,AR,32010314,1005,100,,Cash sale,,,,,,31/10/2018,31/10/2018,0.00,,5.18,,"-1,089,980.83"
,CS,AR,32010317,1005,100,,Cash sale,,,,,,31/10/2018,31/10/2018,0.00,,6.56,,"-1,089,987.39"
,CS,AR,32010319,1005,100,,Cash sale,,,,,,31/10/2018,31/10/2018,0.00,,7.29,,"-1,089,994.68"
,CS,AR,32010330,1005,100,,Cash sale,,,,,,31/10/2018,31/10/2018,0.00,,6.86,,"-1,090,001.54"
,CS,AR,32010347,1005,100,,Cash sale,,,,,,31/10/2018,31/10/2018,0.00,,7.29,,"-1,090,008.83"
,CS,AR,32010374,1005,100,,Cash sale,,,,,,31/10/2018,31/10/2018,0.00,,6.02,,"-1,090,014.85"
,CS,AR,32010404,1005,100,,Cash sale,,,,,,31/10/2018,31/10/2018,0.00,,14.58,,"-1,090,029.43"
,CS,AR,32010425,1005,100,,Cash sale,,,,,,31/10/2018,31/10/2018,0.00,,9.10,,"-1,090,038.53"
,CS,AR,32010428,1005,100,,Cash sale,,,,,,31/10/2018,31/10/2018,0.00,,3.64,,"-1,090,042.17"
,CS,AR,32010447,1005,100,,Cash sale,,,,,,31/10/2018,31/10/2018,0.00,,3.64,,"-1,090,045.81"
,CS,AR,32010451,1005,100,,Cash sale,,,,,,31/10/2018,31/10/2018,0.00,,10.93,,"-1,090,056.74"
,CS,AR,32010483,1005,100,,Cash sale,,,,,,31/10/2018,31/10/2018,0.00,,3.64,,"-1,090,060.38"
,CS,AR,32010500,1005,100,,Cash sale,,,,,,31/10/2018,31/10/2018,0.00,,5.94,,"-1,090,066.32"
,IN,AR,30328311,1005,100,,Invoice,,,,,,31/10/2018,31/10/2018,0.00,,16.31,,"-1,090,082.63"
,IN,AR,30328313,1005,100,,Invoice,,,,,,31/10/2018,31/10/2018,0.00,,169.08,,"-1,090,251.71"
,IN,AR,30328353,1005,100,,Invoice,,,,,,31/10/2018,31/10/2018,0.00,,7.29,,"-1,090,259.00"
,IN,AR,30328363,1005,100,,Invoice,,,,,,31/10/2018,31/10/2018,0.00,,7.32,,"-1,090,266.32"
,IN,AR,30328364,1005,100,,Invoice,,,,,,31/10/2018,31/10/2018,0.00,,70.78,,"-1,090,337.10"
,IN,AR,30328365,1005,100,,Invoice,,,,,,31/10/2018,31/10/2018,0.00,,29.29,,"-1,090,366.39"
,IN,AR,30328400,1005,100,,Invoice,,,,,,31/10/2018,31/10/2018,0.00,,8.14,,"-1,090,374.53"
,IN,AR,30328410,1005,100,,Invoice,,,,,,31/10/2018,31/10/2018,0.00,,14.58,,"-1,090,389.11"
,IN,AR,30328411,1005,100,,Invoice,,,,,,31/10/2018,31/10/2018,0.00,,"1,855.13",,"-1,092,244.24"
,IN,AR,30328413,1005,100,,Invoice,,,,,,31/10/2018,31/10/2018,0.00,,29.15,,"-1,092,273.39"
,IN,AR,30328426,1005,100,,Invoice,,,,,,31/10/2018,31/10/2018,0.00,,84.07,,"-1,092,357.46"
,IN,AR,30328427,1005,100,,Invoice,,,,,,31/10/2018,31/10/2018,0.00,,28.90,,"-1,092,386.36"
,IN,AR,30328431,1005,100,,Invoice,,,,,,31/10/2018,31/10/2018,0.00,,10.93,,"-1,092,397.29"
,IN,AR,30328438,1005,100,,Invoice,,,,,,31/10/2018,31/10/2018,0.00,,12.08,,"-1,092,409.37"
,IN,AR,30328447,1005,100,,Invoice,,,,,,31/10/2018,31/10/2018,0.00,,54.66,,"-1,092,464.03"
,IN,AR,30328490,1005,100,,Invoice,,,,,,31/10/2018,31/10/2018,0.00,,3.98,,"-1,092,468.01"
,IN,AR,30328512,1005,100,,Invoice,,,,,,31/10/2018,31/10/2018,0.00,,26.00,,"-1,092,494.01"
,IN,AR,30328521,1005,100,,Invoice,,,,,,31/10/2018,31/10/2018,0.00,,"1,873.73",,"-1,094,367.74"
,IN,AR,30328535,1005,100,,Invoice,,,,,,31/10/2018,31/10/2018,0.00,,10.93,,"-1,094,378.67"
,IN,AR,30328554,1005,100,,Invoice,,,,,,31/10/2018,31/10/2018,0.00,,7.29,,"-1,094,385.96"
,IN,AR,30328575,1005,100,,Invoice,,,,,,31/10/2018,31/10/2018,0.00,,22.00,,"-1,094,407.96"
,IN,AR,30328576,1005,100,,Invoice,,,,,,31/10/2018,31/10/2018,0.00,,18.22,,"-1,094,426.18"
,IN,AR,30328608,1005,100,,Invoice,,,,,,31/10/2018,31/10/2018,0.00,,34.00,,"-1,094,460.18"
,IN,AR,30328622,1005,100,,Invoice,,,,,,31/10/2018,31/10/2018,0.00,,93.22,,"-1,094,553.40"
,IN,AR,30328638,1005,100,,Invoice,,,,,,31/10/2018,31/10/2018,0.00,,54.66,,"-1,094,608.06"
,IN,AR,30328652,1005,100,,Invoice,,,,,,31/10/2018,31/10/2018,0.00,,19.10,,"-1,094,627.16"
,IN,AR,30328653,1005,100,,Invoice,,,,,,31/10/2018,31/10/2018,0.00,,8.19,,"-1,094,635.35"
,IN,AR,30328654,1005,100,,Invoice,,,,,,31/10/2018,31/10/2018,0.00,,122.80,,"-1,094,758.15"
,IN,AR,30328655,1005,100,,Invoice,,,,,,31/10/2018,31/10/2018,0.00,,65.49,,"-1,094,823.64"
,IN,AR,30328661,1005,100,,Invoice,,,,,,31/10/2018,31/10/2018,0.00,,244.05,,"-1,095,067.69"
,IN,AR,30328700,1005,100,,Invoice,,,,,,31/10/2018,31/10/2018,0.00,,3.01,,"-1,095,070.70"
,IN,AR,30328718,1005,100,,Invoice,,,,,,31/10/2018,31/10/2018,0.00,,105.30,,"-1,095,176.00"
,IN,AR,30328784,1005,100,,Invoice,,,,,,31/10/2018,31/10/2018,0.00,,"1,792.83",,"-1,096,968.83"
,IN,AR,30328785,1005,100,,Invoice,,,,,,31/10/2018,31/10/2018,0.00,,73.68,,"-1,097,042.51"
,IN,AR,30328786,1005,100,,Invoice,,,,,,31/10/2018,31/10/2018,0.00,,5.26,,"-1,097,047.77"
,IN,AR,30328787,1005,100,,Invoice,,,,,,31/10/2018,31/10/2018,0.00,,22.81,,"-1,097,070.58"
,IN,AR,30328788,1005,100,,Invoice,,,,,,31/10/2018,31/10/2018,0.00,,122.80,,"-1,097,193.38"
,IN,AR,30328799,1005,100,,Invoice,,,,,,31/10/2018,31/10/2018,0.00,,4.24,,"-1,097,197.62"
,IN,AR,30328817,1005,100,,Invoice,,,,,,31/10/2018,31/10/2018,0.00,,188.56,,"-1,097,386.18"
,IN,AR,30328821,1005,100,,Invoice,,,,,,31/10/2018,31/10/2018,0.00,,4.24,,"-1,097,390.42"
,IN,AR,30328830,1005,100,,Invoice,,,,,,31/10/2018,31/10/2018,0.00,,5.59,,"-1,097,396.01"
,IN,AR,30328863,1005,100,,Invoice,,,,,,31/10/2018,31/10/2018,0.00,,38.24,,"-1,097,434.25"
,IN,AR,30328869,1005,100,,Invoice,,,,,,31/10/2018,31/10/2018,0.00,,14.58,,"-1,097,448.83"
,IN,AR,30328887,1005,100,,Invoice,,,,,,31/10/2018,31/10/2018,0.00,,26.29,,"-1,097,475.12"
,IN,AR,30328890,1005,100,,Invoice,,,,,,31/10/2018,31/10/2018,0.00,,"1,757.36",,"-1,099,232.48"
,IN,AR,30328908,1005,100,,Invoice,,,,,,31/10/2018,31/10/2018,0.00,,69.73,,"-1,099,302.21"
,IN,AR,30328909,1005,100,,Invoice,,,,,,31/10/2018,31/10/2018,0.00,,65.63,,"-1,099,367.84"
,IN,AR,30328926,1005,100,,Invoice,,,,,,31/10/2018,31/10/2018,0.00,,76.27,,"-1,099,444.11"
,IN,AR,30328930,1005,100,,Invoice,,,,,,31/10/2018,31/10/2018,0.00,,6.43,,"-1,099,450.54"
,IN,AR,30328952,1005,100,,Invoice,,,,,,31/10/2018,31/10/2018,0.00,,12.88,,"-1,099,463.42"
,IN,AR,30328956,1005,100,,Invoice,,,,,,31/10/2018,31/10/2018,0.00,,38.64,,"-1,099,502.06"
,IN,AR,30328961,1005,100,,Invoice,,,,,,31/10/2018,31/10/2018,0.00,,11.75,,"-1,099,513.81"
,IN,AR,30328966,1005,100,,Invoice,,,,,,31/10/2018,31/10/2018,0.00,,7.29,,"-1,099,521.10"
,IN,AR,30328974,1005,100,,Invoice,,,,,,31/10/2018,31/10/2018,0.00,,20.88,,"-1,099,541.98"
,IN,AR,30328980,1005,100,,Invoice,,,,,,31/10/2018,31/10/2018,0.00,,29.15,,"-1,099,571.13"
,IN,AR,30328984,1005,100,,Invoice,,,,,,31/10/2018,31/10/2018,0.00,,7.75,,"-1,099,578.88"
,IN,AR,30328993,1005,100,,Invoice,,,,,,31/10/2018,31/10/2018,0.00,,170.16,,"-1,099,749.04"
,IN,AR,30328996,1005,100,,Invoice,,,,,,31/10/2018,31/10/2018,0.00,,229.81,,"-1,099,978.85"
,IN,AR,30329000,1005,100,,Invoice,,,,,,31/10/2018,31/10/2018,0.00,,184.05,,"-1,100,162.90"
,IN,AR,30329001,1005,100,,Invoice,,,,,,31/10/2018,31/10/2018,0.00,,43.27,,"-1,100,206.17"
,IN,AR,30329002,1005,100,,Invoice,,,,,,31/10/2018,31/10/2018,0.00,,63.15,,"-1,100,269.32"
,IN,AR,30329003,1005,100,,Invoice,,,,,,31/10/2018,31/10/2018,0.00,,243.84,,"-1,100,513.16"
,IN,AR,30329004,1005,100,,Invoice,,,,,,31/10/2018,31/10/2018,0.00,,61.40,,"-1,100,574.56"
,IN,AR,30329005,1005,100,,Invoice,,,,,,31/10/2018,31/10/2018,0.00,,9.41,,"-1,100,583.97"
,IN,AR,30329006,1005,100,,Invoice,,,,,,31/10/2018,31/10/2018,0.00,,47.03,,"-1,100,631.00"
,IN,AR,30329007,1005,100,,Invoice,,,,,,31/10/2018,31/10/2018,0.00,,63.97,,"-1,100,694.97"
,IN,AR,30329008,1005,100,,Invoice,,,,,,31/10/2018,31/10/2018,0.00,,15.05,,"-1,100,710.02"
,IN,AR,30329009,1005,100,,Invoice,,,,,,31/10/2018,31/10/2018,0.00,,37.63,,"-1,100,747.65"
,IN,AR,30329010,1005,100,,Invoice,,,,,,31/10/2018,31/10/2018,0.00,,63.97,,"-1,100,811.62"
,IN,AR,30329011,1005,100,,Invoice,,,,,,31/10/2018,31/10/2018,0.00,,22.58,,"-1,100,834.20"
,IN,AR,30329012,1005,100,,Invoice,,,,,,31/10/2018,31/10/2018,0.00,,22.58,,"-1,100,856.78"
,IN,AR,30329013,1005,100,,Invoice,,,,,,31/10/2018,31/10/2018,0.00,,9.41,,"-1,100,866.19"
,IN,AR,30329016,1005,100,,Invoice,,,,,,31/10/2018,31/10/2018,0.00,,361.37,,"-1,101,227.56"
,IN,AR,30329017,1005,100,,Invoice,,,,,,31/10/2018,31/10/2018,0.00,,66.66,,"-1,101,294.22"
,IN,AR,30329018,1005,100,,Invoice,,,,,,31/10/2018,31/10/2018,0.00,,40.35,,"-1,101,334.57"
,IN,AR,30329019,1005,100,,Invoice,,,,,,31/10/2018,31/10/2018,0.00,,24.46,,"-1,101,359.03"
,IN,AR,30329020,1005,100,,Invoice,,,,,,31/10/2018,31/10/2018,0.00,,52.63,,"-1,101,411.66"
,IN,AR,30329021,1005,100,,Invoice,,,,,,31/10/2018,31/10/2018,0.00,,28.07,,"-1,101,439.73"
,IN,AR,30329024,1005,100,,Invoice,,,,,,31/10/2018,31/10/2018,0.00,,22.81,,"-1,101,462.54"
,IN,AR,30329025,1005,100,,Invoice,,,,,,31/10/2018,31/10/2018,0.00,,28.07,,"-1,101,490.61"
,IN,AR,30329026,1005,100,,Invoice,,,,,,31/10/2018,31/10/2018,0.00,,29.82,,"-1,101,520.43"
,IN,AR,30329030,1005,100,,Invoice,,,,,,31/10/2018,31/10/2018,0.00,,5.26,,"-1,101,525.69"
,IN,AR,30329050,1005,100,,Invoice,,,,,,31/10/2018,31/10/2018,0.00,,5.08,,"-1,101,530.77"
,IN,AR,30329051,1005,100,,Invoice,,,,,,31/10/2018,31/10/2018,0.00,,24.56,,"-1,101,555.33"
,IN,AR,30329062,1005,100,,Invoice,,,,,,31/10/2018,31/10/2018,0.00,,18.39,,"-1,101,573.72"
,IN,AR,30329064,1005,100,,Invoice,,,,,,31/10/2018,31/10/2018,0.00,,342.08,,"-1,101,915.80"
,IN,AR,30329082,1005,100,,Invoice,,,,,,31/10/2018,31/10/2018,0.00,,101.92,,"-1,102,017.72"
,IN,AR,30329083,1005,100,,Invoice,,,,,,31/10/2018,31/10/2018,0.00,,1.79,,"-1,102,019.51"
,IN,AR,30329084,1005,100,,Invoice,,,,,,31/10/2018,31/10/2018,0.00,,25.03,,"-1,102,044.54"
,IN,AR,30329085,1005,100,,Invoice,,,,,,31/10/2018,31/10/2018,0.00,,64.37,,"-1,102,108.91"
,IN,AR,30329086,1005,100,,Invoice,,,,,,31/10/2018,31/10/2018,0.00,,48.28,,"-1,102,157.19"
,IN,AR,30329087,1005,100,,Invoice,,,,,,31/10/2018,31/10/2018,0.00,,51.86,,"-1,102,209.05"
,IN,AR,30329088,1005,100,,Invoice,,,,,,31/10/2018,31/10/2018,0.00,,19.67,,"-1,102,228.72"
,IN,AR,30329089,1005,100,,Invoice,,,,,,31/10/2018,31/10/2018,0.00,,32.19,,"-1,102,260.91"
,IN,AR,30329090,1005,100,,Invoice,,,,,,31/10/2018,31/10/2018,0.00,,69.74,,"-1,102,330.65"
,IN,AR,30329091,1005,100,,Invoice,,,,,,31/10/2018,31/10/2018,0.00,,346.90,,"-1,102,677.55"
,IN,AR,30329092,1005,100,,Invoice,,,,,,31/10/2018,31/10/2018,0.00,,7.15,,"-1,102,684.70"
,IN,AR,30329093,1005,100,,Invoice,,,,,,31/10/2018,31/10/2018,0.00,,12.52,,"-1,102,697.22"
,IN,AR,30329094,1005,100,,Invoice,,,,,,31/10/2018,31/10/2018,0.00,,23.25,,"-1,102,720.47"
,IN,AR,30329095,1005,100,,Invoice,,,,,,31/10/2018,31/10/2018,0.00,,8.94,,"-1,102,729.41"
,IN,AR,30329097,1005,100,,Invoice,,,,,,31/10/2018,31/10/2018,0.00,,42.92,,"-1,102,772.33"
,IN,AR,30329098,1005,100,,Invoice,,,,,,31/10/2018,31/10/2018,0.00,,92.98,,"-1,102,865.31"
,IN,AR,30329099,1005,100,,Invoice,,,,,,31/10/2018,31/10/2018,0.00,,26.82,,"-1,102,892.13"
,IN,AR,30329100,1005,100,,Invoice,,,,,,31/10/2018,31/10/2018,0.00,,14.31,,"-1,102,906.44"
,IN,AR,30329101,1005,100,,Invoice,,,,,,31/10/2018,31/10/2018,0.00,,5.36,,"-1,102,911.80"
,IN,AR,30329102,1005,100,,Invoice,,,,,,31/10/2018,31/10/2018,0.00,,41.13,,"-1,102,952.93"
,IN,AR,30329103,1005,100,,Invoice,,,,,,31/10/2018,31/10/2018,0.00,,35.76,,"-1,102,988.69"
,IN,AR,30329104,1005,100,,Invoice,,,,,,31/10/2018,31/10/2018,0.00,,14.31,,"-1,103,003.00"
,IN,AR,30329105,1005,100,,Invoice,,,,,,31/10/2018,31/10/2018,0.00,,41.13,,"-1,103,044.13"
,IN,AR,30329106,1005,100,,Invoice,,,,,,31/10/2018,31/10/2018,0.00,,8.94,,"-1,103,053.07"
,IN,AR,30329107,1005,100,,Invoice,,,,,,31/10/2018,31/10/2018,0.00,,12.52,,"-1,103,065.59"
,IN,AR,30329109,1005,100,,Invoice,,,,,,31/10/2018,31/10/2018,0.00,,138.58,,"-1,103,204.17"
,IN,AR,30329110,1005,100,,Invoice,,,,,,31/10/2018,31/10/2018,0.00,,200.15,,"-1,103,404.32"
,IN,AR,30329111,1005,100,,Invoice,,,,,,31/10/2018,31/10/2018,0.00,,91.91,,"-1,103,496.23"
,IN,AR,30329112,1005,100,,Invoice,,,,,,31/10/2018,31/10/2018,0.00,,8.17,,"-1,103,504.40"
,IN,AR,30329113,1005,100,,Invoice,,,,,,31/10/2018,31/10/2018,0.00,,14.30,,"-1,103,518.70"
,IN,AR,30329114,1005,100,,Invoice,,,,,,31/10/2018,31/10/2018,0.00,,194.03,,"-1,103,712.73"
,IN,AR,30329115,1005,100,,Invoice,,,,,,31/10/2018,31/10/2018,0.00,,53.10,,"-1,103,765.83"
,IN,AR,30329116,1005,100,,Invoice,,,,,,31/10/2018,31/10/2018,0.00,,230.79,,"-1,103,996.62"
,IN,AR,30329117,1005,100,,Invoice,,,,,,31/10/2018,31/10/2018,0.00,,6.13,,"-1,104,002.75"
,IN,AR,30329122,1005,100,,Invoice,,,,,,31/10/2018,31/10/2018,0.00,,7.29,,"-1,104,010.04"
,IN,AR,30329141,1005,100,,Invoice,,,,,,31/10/2018,31/10/2018,0.00,,5.17,,"-1,104,015.21"
,IN,AR,30329146,1005,100,,Invoice,,,,,,31/10/2018,31/10/2018,0.00,,18.17,,"-1,104,033.38"
,IN,AR,30329195,1005,100,,Invoice,,,,,,31/10/2018,31/10/2018,0.00,,5.08,,"-1,104,038.46"
,IN,AR,30329232,1005,100,,Invoice,,,,,,31/10/2018,31/10/2018,0.00,,14.58,,"-1,104,053.04"
,IN,AR,30329239,1005,100,,Invoice,,,,,,31/10/2018,31/10/2018,0.00,,71.61,,"-1,104,124.65"
,IN,AR,30329282,1005,100,,Invoice,,,,,,31/10/2018,31/10/2018,0.00,,14.03,,"-1,104,138.68"
,IN,AR,30329297,1005,100,,Invoice,,,,,,31/10/2018,31/10/2018,0.00,,38.56,,"-1,104,177.24"
,IN,AR,30329299,1005,100,,Invoice,,,,,,31/10/2018,31/10/2018,0.00,,6.86,,"-1,104,184.10"
,IN,AR,30329307,1005,100,,Invoice,,,,,,31/10/2018,31/10/2018,0.00,,"1,360.85",,"-1,105,544.95"
,IN,AR,30329309,1005,100,,Invoice,,,,,,31/10/2018,31/10/2018,0.00,,782.39,,"-1,106,327.34"
,IN,AR,30329311,1005,100,,Invoice,,,,,,31/10/2018,31/10/2018,0.00,,382.58,,"-1,106,709.92"
,IN,AR,30329312,1005,100,,Invoice,,,,,,31/10/2018,31/10/2018,0.00,,72.15,,"-1,106,782.07"
,IN,AR,30329313,1005,100,,Invoice,,,,,,31/10/2018,31/10/2018,0.00,,40.35,,"-1,106,822.42"
,IN,AR,30329321,1005,100,,Invoice,,,,,,31/10/2018,31/10/2018,0.00,,18.22,,"-1,106,840.64"
,IN,AR,30329327,1005,100,,Invoice,,,,,,31/10/2018,31/10/2018,0.00,,10.93,,"-1,106,851.57"
,IN,AR,30329337,1005,100,,Invoice,,,,,,31/10/2018,31/10/2018,0.00,,22.37,,"-1,106,873.94"
,IN,AR,30329346,1005,100,,Invoice,,,,,,31/10/2018,31/10/2018,0.00,,10.17,,"-1,106,884.11"
,IN,AR,30329347,1005,100,,Invoice,,,,,,31/10/2018,31/10/2018,0.00,,10.17,,"-1,106,894.28"
,IN,AR,30329357,1005,100,,Invoice,,,,,,31/10/2018,31/10/2018,0.00,,20.00,,"-1,106,914.28"
,IN,AR,30329367,1005,100,,Invoice,,,,,,31/10/2018,31/10/2018,0.00,,8.14,,"-1,106,922.42"
,IN,AR,30329396,1005,100,,Invoice,,,,,,31/10/2018,31/10/2018,0.00,,7.75,,"-1,106,930.17"
,IN,AR,30329407,1005,100,,Invoice,,,,,,31/10/2018,31/10/2018,0.00,,24.13,,"-1,106,954.30"
,IN,AR,30329416,1005,100,,Invoice,,,,,,31/10/2018,31/10/2018,0.00,,21.86,,"-1,106,976.16"
,IN,AR,30329421,1005,100,,Invoice,,,,,,31/10/2018,31/10/2018,0.00,,106.07,,"-1,107,082.23"
,IN,AR,30329425,1005,100,,Invoice,,,,,,31/10/2018,31/10/2018,0.00,,27.08,,"-1,107,109.31"
,IN,AR,30329457,1005,100,,Invoice,,,,,,31/10/2018,31/10/2018,0.00,,166.10,,"-1,107,275.41"
,IN,AR,30329475,1005,100,,Invoice,,,,,,31/10/2018,31/10/2018,0.00,,29.15,,"-1,107,304.56"
,IN,AR,30329495,1005,100,,Invoice,,,,,,31/10/2018,31/10/2018,0.00,,5.29,,"-1,107,309.85"
,IN,AR,30329496,1005,100,,Invoice,,,,,,31/10/2018,31/10/2018,0.00,,12.33,,"-1,107,322.18"
,IN,AR,30329500,1005,100,,Invoice,,,,,,31/10/2018,31/10/2018,0.00,,21.06,,"-1,107,343.24"
,IN,AR,30329508,1005,100,,Invoice,,,,,,31/10/2018,31/10/2018,0.00,,10.93,,"-1,107,354.17"
,IN,AR,30329538,1005,100,,Invoice,,,,,,31/10/2018,31/10/2018,0.00,,12.92,,"-1,107,367.09"
,IN,AR,30329554,1005,100,,Invoice,,,,,,31/10/2018,31/10/2018,0.00,,8.00,,"-1,107,375.09"
,IN,AR,30329562,1005,100,,Invoice,,,,,,31/10/2018,31/10/2018,0.00,,47.37,,"-1,107,422.46"
,IN,AR,30329563,1005,100,,Invoice,,,,,,31/10/2018,31/10/2018,0.00,,25.51,,"-1,107,447.97"
,IN,AR,30329573,1005,100,,Invoice,,,,,,31/10/2018,31/10/2018,0.00,,652.65,,"-1,108,100.62"
,IN,AR,30329574,1005,100,,Invoice,,,,,,31/10/2018,31/10/2018,0.00,,815.81,,"-1,108,916.43"
,IN,AR,30329575,1005,100,,Invoice,,,,,,31/10/2018,31/10/2018,0.00,,652.65,,"-1,109,569.08"
,IN,AR,30329576,1005,100,,Invoice,,,,,,31/10/2018,31/10/2018,0.00,,163.16,,"-1,109,732.24"
,IN,AR,30329590,1005,100,,Invoice,,,,,,31/10/2018,31/10/2018,0.00,,83.90,,"-1,109,816.14"
,IN,AR,30329591,1005,100,,Invoice,,,,,,31/10/2018,31/10/2018,0.00,,27.97,,"-1,109,844.11"
,IN,AR,30329592,1005,100,,Invoice,,,,,,31/10/2018,31/10/2018,0.00,,55.93,,"-1,109,900.04"
,IN,AR,30329593,1005,100,,Invoice,,,,,,31/10/2018,31/10/2018,0.00,,18.64,,"-1,109,918.68"
,IN,AR,30329594,1005,100,,Invoice,,,,,,31/10/2018,31/10/2018,0.00,,41.95,,"-1,109,960.63"
,IN,AR,30329595,1005,100,,Invoice,,,,,,31/10/2018,31/10/2018,0.00,,62.92,,"-1,110,023.55"
,IN,AR,30329596,1005,100,,Invoice,,,,,,31/10/2018,31/10/2018,0.00,,37.29,,"-1,110,060.84"
,IN,AR,30329597,1005,100,,Invoice,,,,,,31/10/2018,31/10/2018,0.00,,9.32,,"-1,110,070.16"
,IN,AR,30329598,1005,100,,Invoice,,,,,,31/10/2018,31/10/2018,0.00,,69.92,,"-1,110,140.08"
,IN,AR,30329599,1005,100,,Invoice,,,,,,31/10/2018,31/10/2018,0.00,,27.97,,"-1,110,168.05"
,IN,AR,30329602,1005,100,,Invoice,,,,,,31/10/2018,31/10/2018,0.00,,852.29,,"-1,111,020.34"
,IN,AR,30329614,1005,100,,Invoice,,,,,,31/10/2018,31/10/2018,0.00,,10.17,,"-1,111,030.51"
,IN,AR,30329615,1005,100,,Invoice,,,,,,31/10/2018,31/10/2018,0.00,,10.93,,"-1,111,041.44"
,IN,AR,30329631,1005,100,,Invoice,,,,,,31/10/2018,31/10/2018,0.00,,11.95,,"-1,111,053.39"
,IN,AR,30329658,1005,100,,Invoice,,,,,,31/10/2018,31/10/2018,0.00,,23.88,,"-1,111,077.27"
,IN,AR,30329661,1005,100,,Invoice,,,,,,31/10/2018,31/10/2018,0.00,,8.02,,"-1,111,085.29"
,IN,AR,30329675,1005,100,,Invoice,,,,,,31/10/2018,31/10/2018,0.00,,30.00,,"-1,111,115.29"
,IN,AR,30329701,1005,100,,Invoice,,,,,,31/10/2018,31/10/2018,0.00,,22.05,,"-1,111,137.34"
,IN,AR,30329703,1005,100,,Invoice,,,,,,31/10/2018,31/10/2018,0.00,,423.54,,"-1,111,560.88"
,IN,AR,30329708,1005,100,,Invoice,,,,,,31/10/2018,31/10/2018,0.00,,10.93,,"-1,111,571.81"
,IN,AR,30329712,1005,100,,Invoice,,,,,,31/10/2018,31/10/2018,0.00,,147.02,,"-1,111,718.83"
,IN,AR,30329756,1005,100,,Invoice,,,,,,31/10/2018,31/10/2018,0.00,,349.21,,"-1,112,068.04"
,IN,AR,30329760,1005,100,,Invoice,,,,,,31/10/2018,31/10/2018,0.00,,10.19,,"-1,112,078.23"
,IN,AR,30329769,1005,100,,Invoice,,,,,,31/10/2018,31/10/2018,0.00,,36.22,,"-1,112,114.45"
,IN,AR,30329804,1005,100,,Invoice,,,,,,31/10/2018,31/10/2018,0.00,,7.63,,"-1,112,122.08"
,IN,AR,30329805,1005,100,,Invoice,,,,,,31/10/2018,31/10/2018,0.00,,7.63,,"-1,112,129.71"
,IN,AR,30329846,1005,100,,Invoice,,,,,,31/10/2018,31/10/2018,0.00,,39.75,,"-1,112,169.46"
,IN,AR,30329854,1005,100,,Invoice,,,,,,31/10/2018,31/10/2018,0.00,,6.03,,"-1,112,175.49"
,IN,AR,30329855,1005,100,,Invoice,,,,,,31/10/2018,31/10/2018,0.00,,30.17,,"-1,112,205.66"
,IN,AR,30329862,1005,100,,Invoice,,,,,,31/10/2018,31/10/2018,0.00,,2.92,,"-1,112,208.58"
,IN,AR,30329865,1005,100,,Invoice,,,,,,31/10/2018,31/10/2018,0.00,,109.28,,"-1,112,317.86"
,IN,AR,30329888,1005,100,,Invoice,,,,,,31/10/2018,31/10/2018,0.00,,16.82,,"-1,112,334.68"
,IN,AR,30329889,1005,100,,Invoice,,,,,,31/10/2018,31/10/2018,0.00,,27.33,,"-1,112,362.01"
,IN,AR,30329892,1005,100,,Invoice,,,,,,31/10/2018,31/10/2018,0.00,,27.41,,"-1,112,389.42"
,IN,AR,30329896,1005,100,,Invoice,,,,,,31/10/2018,31/10/2018,0.00,,4.66,,"-1,112,394.08"
,IN,AR,30329915,1005,100,,Invoice,,,,,,31/10/2018,31/10/2018,0.00,,27.97,,"-1,112,422.05"
,IN,AR,30329940,1005,100,,Invoice,,,,,,31/10/2018,31/10/2018,0.00,,13.98,,"-1,112,436.03"
,IN,AR,30330022,1005,100,,Invoice,,,,,,31/10/2018,31/10/2018,0.00,,6.37,,"-1,112,442.40"
,IN,AR,30330023,1005,100,,Invoice,,,,,,31/10/2018,31/10/2018,0.00,,31.86,,"-1,112,474.26"
,IN,AR,30330029,1005,100,,Invoice,,,,,,31/10/2018,31/10/2018,0.00,,742.63,,"-1,113,216.89"
,IN,AR,30330030,1005,100,,Invoice,,,,,,31/10/2018,31/10/2018,0.00,,9.75,,"-1,113,226.64"
,IN,AR,30330031,1005,100,,Invoice,,,,,,31/10/2018,31/10/2018,0.00,,15.59,,"-1,113,242.23"
,IN,AR,30330032,1005,100,,Invoice,,,,,,31/10/2018,31/10/2018,0.00,,31.19,,"-1,113,273.42"
,IN,AR,30330033,1005,100,,Invoice,,,,,,31/10/2018,31/10/2018,0.00,,15.59,,"-1,113,289.01"
,IN,AR,30330034,1005,100,,Invoice,,,,,,31/10/2018,31/10/2018,0.00,,25.34,,"-1,113,314.35"
,IN,AR,30330035,1005,100,,Invoice,,,,,,31/10/2018,31/10/2018,0.00,,15.59,,"-1,113,329.94"
,IN,AR,30330036,1005,100,,Invoice,,,,,,31/10/2018,31/10/2018,0.00,,21.44,,"-1,113,351.38"
,IN,AR,30330037,1005,100,,Invoice,,,,,,31/10/2018,31/10/2018,0.00,,40.93,,"-1,113,392.31"
,IN,AR,30330038,1005,100,,Invoice,,,,,,31/10/2018,31/10/2018,0.00,,66.27,,"-1,113,458.58"
,IN,AR,30330039,1005,100,,Invoice,,,,,,31/10/2018,31/10/2018,0.00,,29.24,,"-1,113,487.82"
,IN,AR,30330040,1005,100,,Invoice,,,,,,31/10/2018,31/10/2018,0.00,,29.24,,"-1,113,517.06"
,IN,AR,30330041,1005,100,,Invoice,,,,,,31/10/2018,31/10/2018,0.00,,77.97,,"-1,113,595.03"
,IN,AR,30330042,1005,100,,Invoice,,,,,,31/10/2018,31/10/2018,0.00,,15.59,,"-1,113,610.62"
,IN,AR,30330043,1005,100,,Invoice,,,,,,31/10/2018,31/10/2018,0.00,,23.39,,"-1,113,634.01"
,IN,AR,30330044,1005,100,,Invoice,,,,,,31/10/2018,31/10/2018,0.00,,15.59,,"-1,113,649.60"
,IN,AR,30330045,1005,100,,Invoice,,,,,,31/10/2018,31/10/2018,0.00,,13.64,,"-1,113,663.24"
,IN,AR,30330046,1005,100,,Invoice,,,,,,31/10/2018,31/10/2018,0.00,,7.80,,"-1,113,671.04"
,IN,AR,30330047,1005,100,,Invoice,,,,,,31/10/2018,31/10/2018,0.00,,19.49,,"-1,113,690.53"
,IN,AR,30330048,1005,100,,Invoice,,,,,,31/10/2018,31/10/2018,0.00,,17.54,,"-1,113,708.07"
,IN,AR,30330049,1005,100,,Invoice,,,,,,31/10/2018,31/10/2018,0.00,,734.83,,"-1,114,442.90"
,IN,AR,30330050,1005,100,,Invoice,,,,,,31/10/2018,31/10/2018,0.00,,40.93,,"-1,114,483.83"
,IN,AR,30330051,1005,100,,Invoice,,,,,,31/10/2018,31/10/2018,0.00,,15.59,,"-1,114,499.42"
,IN,AR,30330052,1005,100,,Invoice,,,,,,31/10/2018,31/10/2018,0.00,,730.93,,"-1,115,230.35"
,IN,AR,30330053,1005,100,,Invoice,,,,,,31/10/2018,31/10/2018,0.00,,13.64,,"-1,115,243.99"
,IN,AR,30330054,1005,100,,Invoice,,,,,,31/10/2018,31/10/2018,0.00,,15.59,,"-1,115,259.58"
,IN,AR,30330055,1005,100,,Invoice,,,,,,31/10/2018,31/10/2018,0.00,,13.64,,"-1,115,273.22"
,IN,AR,30330056,1005,100,,Invoice,,,,,,31/10/2018,31/10/2018,0.00,,5.85,,"-1,115,279.07"
,IN,AR,30330057,1005,100,,Invoice,,,,,,31/10/2018,31/10/2018,0.00,,40.93,,"-1,115,320.00"
,IN,AR,30330058,1005,100,,Invoice,,,,,,31/10/2018,31/10/2018,0.00,,68.22,,"-1,115,388.22"
,IN,AR,30330059,1005,100,,Invoice,,,,,,31/10/2018,31/10/2018,0.00,,23.39,,"-1,115,411.61"
,IN,AR,30330060,1005,100,,Invoice,,,,,,31/10/2018,31/10/2018,0.00,,9.75,,"-1,115,421.36"
,IN,AR,30330099,1005,100,,Invoice,,,,,,31/10/2018,31/10/2018,0.00,,18.81,,"-1,115,440.17"
,IN,AR,30330100,1005,100,,Invoice,,,,,,31/10/2018,31/10/2018,0.00,,13.17,,"-1,115,453.34"
,IN,AR,30330101,1005,100,,Invoice,,,,,,31/10/2018,31/10/2018,0.00,,16.93,,"-1,115,470.27"
,IN,AR,30330102,1005,100,,Invoice,,,,,,31/10/2018,31/10/2018,0.00,,13.17,,"-1,115,483.44"
,IN,AR,30330103,1005,100,,Invoice,,,,,,31/10/2018,31/10/2018,0.00,,5.64,,"-1,115,489.08"
,IN,AR,30330115,1005,100,,Invoice,,,,,,31/10/2018,31/10/2018,0.00,,5.26,,"-1,115,494.34"
,IN,AR,30330143,1005,100,,Invoice,,,,,,31/10/2018,31/10/2018,0.00,,29.15,,"-1,115,523.49"
,IN,AR,30330145,1005,100,,Invoice,,,,,,31/10/2018,31/10/2018,0.00,,682.40,,"-1,116,205.89"
,IN,AR,30330153,1005,100,,Invoice,,,,,,31/10/2018,31/10/2018,0.00,,3.64,,"-1,116,209.53"
,IN,AR,30330158,1005,100,,Invoice,,,,,,31/10/2018,31/10/2018,0.00,,54.66,,"-1,116,264.19"
,IN,AR,30330183,1005,100,,Invoice,,,,,,31/10/2018,31/10/2018,0.00,,9.41,,"-1,116,273.60"
,IN,AR,30330190,1005,100,,Invoice,,,,,,31/10/2018,31/10/2018,0.00,,382.69,,"-1,116,656.29"
,IN,AR,30330191,1005,100,,Invoice,,,,,,31/10/2018,31/10/2018,0.00,,270.43,,"-1,116,926.72"
,IN,AR,30330197,1005,100,,Invoice,,,,,,31/10/2018,31/10/2018,0.00,,172.50,,"-1,117,099.22"
,IN,AR,30330198,1005,100,,Invoice,,,,,,31/10/2018,31/10/2018,0.00,,250.00,,"-1,117,349.22"
,IN,AR,30330199,1005,100,,Invoice,,,,,,31/10/2018,31/10/2018,0.00,,345.00,,"-1,117,694.22"
,IN,AR,30330220,1005,100,,Invoice,,,,,,31/10/2018,31/10/2018,0.00,,22.37,,"-1,117,716.59"
,IN,AR,30330236,1005,100,,Invoice,,,,,,31/10/2018,31/10/2018,0.00,,12.25,,"-1,117,728.84"
,IN,AR,30330243,1005,100,,Invoice,,,,,,31/10/2018,31/10/2018,0.00,,10.99,,"-1,117,739.83"
,IN,AR,30330260,1005,100,,Invoice,,,,,,31/10/2018,31/10/2018,0.00,,60.22,,"-1,117,800.05"
,IN,AR,30330261,1005,100,,Invoice,,,,,,31/10/2018,31/10/2018,0.00,,27.37,,"-1,117,827.42"
,IN,AR,30330262,1005,100,,Invoice,,,,,,31/10/2018,31/10/2018,0.00,,13.69,,"-1,117,841.11"
,IN,AR,30330263,1005,100,,Invoice,,,,,,31/10/2018,31/10/2018,0.00,,5.47,,"-1,117,846.58"
,IN,AR,30330267,1005,100,,Invoice,,,,,,31/10/2018,31/10/2018,0.00,,16.02,,"-1,117,862.60"
,IN,AR,30330341,1005,100,,Invoice,,,,,,31/10/2018,31/10/2018,0.00,,64.36,,"-1,117,926.96"
,IN,AR,30330342,1005,100,,Invoice,,,,,,31/10/2018,31/10/2018,0.00,,12.46,,"-1,117,939.42"
,IN,AR,30330343,1005,100,,Invoice,,,,,,31/10/2018,31/10/2018,0.00,,4.15,,"-1,117,943.57"
,IN,AR,30330344,1005,100,,Invoice,,,,,,31/10/2018,31/10/2018,0.00,,103.81,,"-1,118,047.38"
,IN,AR,30330350,1005,100,,Invoice,,,,,,31/10/2018,31/10/2018,0.00,,2.54,,"-1,118,049.92"
,IN,AR,30330364,1005,100,,Invoice,,,,,,31/10/2018,31/10/2018,0.00,,24.27,,"-1,118,074.19"
,IN,AR,30330377,1005,100,,Invoice,,,,,,31/10/2018,31/10/2018,0.00,,6.56,,"-1,118,080.75"
,IN,AR,30330391,1005,100,,Invoice,,,,,,31/10/2018,31/10/2018,0.00,,36.44,,"-1,118,117.19"
,IN,AR,30330398,1005,100,,Invoice,,,,,,31/10/2018,31/10/2018,0.00,,310.01,,"-1,118,427.20"
,IN,AR,30330418,1005,100,,Invoice,,,,,,31/10/2018,31/10/2018,0.00,,29.15,,"-1,118,456.35"
,IN,AR,30330425,1005,100,,Invoice,,,,,,31/10/2018,31/10/2018,0.00,,27.97,,"-1,118,484.32"
,IN,AR,30330427,1005,100,,Invoice,,,,,,31/10/2018,31/10/2018,0.00,,14.58,,"-1,118,498.90"
,IN,AR,30330441,1005,100,,Invoice,,,,,,31/10/2018,31/10/2018,0.00,,7.29,,"-1,118,506.19"
,IN,AR,30330474,1005,100,,Invoice,,,,,,31/10/2018,31/10/2018,0.00,,3.64,,"-1,118,509.83"
,IN,AR,30330495,1005,100,,Invoice,,,,,,31/10/2018,31/10/2018,0.00,,10.78,,"-1,118,520.61"
,IN,AR,30330543,1005,100,,Invoice,,,,,,31/10/2018,31/10/2018,0.00,,182.20,,"-1,118,702.81"
,IN,AR,30330545,1005,100,,Invoice,,,,,,31/10/2018,31/10/2018,0.00,,"1,093.22",,"-1,119,796.03"
,IN,AR,30330548,1005,100,,Invoice,,,,,,31/10/2018,31/10/2018,0.00,,"1,093.22",,"-1,120,889.25"
,IN,AR,30330553,1005,100,,Invoice,,,,,,31/10/2018,31/10/2018,0.00,,182.20,,"-1,121,071.45"
,IN,AR,30330555,1005,100,,Invoice,,,,,,31/10/2018,31/10/2018,0.00,,364.41,,"-1,121,435.86"
,IN,AR,30330556,1005,100,,Invoice,,,,,,31/10/2018,31/10/2018,0.00,,182.20,,"-1,121,618.06"
,IN,AR,30330557,1005,100,,Invoice,,,,,,31/10/2018,31/10/2018,0.00,,182.20,,"-1,121,800.26"
,IN,AR,30330559,1005,100,,Invoice,,,,,,31/10/2018,31/10/2018,0.00,,54.66,,"-1,121,854.92"
,IN,AR,30330561,1005,100,,Invoice,,,,,,31/10/2018,31/10/2018,0.00,,364.41,,"-1,122,219.33"
,IN,AR,30330562,1005,100,,Invoice,,,,,,31/10/2018,31/10/2018,0.00,,364.41,,"-1,122,583.74"
,IN,AR,30330563,1005,100,,Invoice,,,,,,31/10/2018,31/10/2018,0.00,,364.41,,"-1,122,948.15"
,IN,AR,30330566,1005,100,,Invoice,,,,,,31/10/2018,31/10/2018,0.00,,182.20,,"-1,123,130.35"
,IN,AR,30330573,1005,100,,Invoice,,,,,,31/10/2018,31/10/2018,0.00,,364.41,,"-1,123,494.76"
,IN,AR,30330584,1005,100,,Invoice,,,,,,31/10/2018,31/10/2018,0.00,,364.41,,"-1,123,859.17"
,IN,AR,30330585,1005,100,,Invoice,,,,,,31/10/2018,31/10/2018,0.00,,364.41,,"-1,124,223.58"
,IN,AR,30330587,1005,100,,Invoice,,,,,,31/10/2018,31/10/2018,0.00,,364.41,,"-1,124,587.99"
,IN,AR,30330589,1005,100,,Invoice,,,,,,31/10/2018,31/10/2018,0.00,,54.66,,"-1,124,642.65"
,IN,AR,30330595,1005,100,,Invoice,,,,,,31/10/2018,31/10/2018,0.00,,364.41,,"-1,125,007.06"
,IN,AR,30330598,1005,100,,Invoice,,,,,,31/10/2018,31/10/2018,0.00,,54.66,,"-1,125,061.72"
,IN,AR,30330602,1005,100,,Invoice,,,,,,31/10/2018,31/10/2018,0.00,,364.41,,"-1,125,426.13"
,IN,AR,30330604,1005,100,,Invoice,,,,,,31/10/2018,31/10/2018,0.00,,364.41,,"-1,125,790.54"
,IN,AR,30330606,1005,100,,Invoice,,,,,,31/10/2018,31/10/2018,0.00,,54.66,,"-1,125,845.20"
,IN,AR,30330611,1005,100,,Invoice,,,,,,31/10/2018,31/10/2018,0.00,,54.66,,"-1,125,899.86"
,IN,AR,30330613,1005,100,,Invoice,,,,,,31/10/2018,31/10/2018,0.00,,364.41,,"-1,126,264.27"
,IN,AR,30330619,1005,100,,Invoice,,,,,,31/10/2018,31/10/2018,0.00,,54.66,,"-1,126,318.93"
,IN,AR,30330620,1005,100,,Invoice,,,,,,31/10/2018,31/10/2018,0.00,,182.20,,"-1,126,501.13"
,IN,AR,30330624,1005,100,,Invoice,,,,,,31/10/2018,31/10/2018,0.00,,364.41,,"-1,126,865.54"
,IN,AR,30330625,1005,100,,Invoice,,,,,,31/10/2018,31/10/2018,0.00,,54.66,,"-1,126,920.20"
,IN,AR,30330626,1005,100,,Invoice,,,,,,31/10/2018,31/10/2018,0.00,,364.41,,"-1,127,284.61"
,IN,AR,30330628,1005,100,,Invoice,,,,,,31/10/2018,31/10/2018,0.00,,364.41,,"-1,127,649.02"
,IN,AR,30330694,1005,100,,Invoice,,,,,,31/10/2018,31/10/2018,0.00,,182.20,,"-1,127,831.22"
,IN,AR,30330700,1005,100,,Invoice,,,,,,31/10/2018,31/10/2018,0.00,,54.66,,"-1,127,885.88"
,IN,AR,30330702,1005,100,,Invoice,,,,,,31/10/2018,31/10/2018,0.00,,54.66,,"-1,127,940.54"
,IN,AR,30330707,1005,100,,Invoice,,,,,,31/10/2018,31/10/2018,0.00,,54.66,,"-1,127,995.20"
,CR,AR,33000299,1005,100,,Cash Return,,,,,,01/11/2018,01/11/2018,21.86,,0.00,,"-1,127,973.34"
,CS,AR,32010637,1005,100,,Cash sale,,,,,,01/11/2018,01/11/2018,0.00,,12.03,,"-1,127,985.37"
,CS,AR,32010639,1005,100,,Cash sale,,,,,,01/11/2018,01/11/2018,0.00,,21.86,,"-1,128,007.23"
,CS,AR,32010644,1005,100,,Cash sale,,,,,,01/11/2018,01/11/2018,0.00,,9.49,,"-1,128,016.72"
,CS,AR,32010652,1005,100,,Cash sale,,,,,,01/11/2018,01/11/2018,0.00,,3.64,,"-1,128,020.36"
,CS,AR,32010687,1005,100,,Cash sale,,,,,,01/11/2018,01/11/2018,0.00,,3.64,,"-1,128,024.00"
,CS,AR,32010700,1005,100,,Cash sale,,,,,,01/11/2018,01/11/2018,0.00,,18.22,,"-1,128,042.22"
,CS,AR,32010710,1005,100,,Cash sale,,,,,,01/11/2018,01/11/2018,0.00,,7.29,,"-1,128,049.51"
,CS,AR,32010712,1005,100,,Cash sale,,,,,,01/11/2018,01/11/2018,0.00,,3.64,,"-1,128,053.15"
,CS,AR,32010734,1005,100,,Cash sale,,,,,,01/11/2018,01/11/2018,0.00,,7.75,,"-1,128,060.90"
,CS,AR,32010775,1005,100,,Cash sale,,,,,,01/11/2018,01/11/2018,0.00,,3.43,,"-1,128,064.33"
,CS,AR,32010781,1005,100,,Cash sale,,,,,,01/11/2018,01/11/2018,0.00,,2.58,,"-1,128,066.91"
,CS,AR,32010807,1005,100,,Cash sale,,,,,,01/11/2018,01/11/2018,0.00,,16.78,,"-1,128,083.69"
,CS,AR,32010819,1005,100,,Cash sale,,,,,,01/11/2018,01/11/2018,0.00,,10.93,,"-1,128,094.62"
,CS,AR,32010823,1005,100,,Cash sale,,,,,,01/11/2018,01/11/2018,0.00,,6.44,,"-1,128,101.06"
,CS,AR,32010828,1005,100,,Cash sale,,,,,,01/11/2018,01/11/2018,0.00,,7.29,,"-1,128,108.35"
,CS,AR,32010829,1005,100,,Cash sale,,,,,,01/11/2018,01/11/2018,0.00,,7.29,,"-1,128,115.64"
,CS,AR,32010845,1005,100,,Cash sale,,,,,,01/11/2018,01/11/2018,0.00,,7.29,,"-1,128,122.93"
,CS,AR,32010849,1005,100,,Cash sale,,,,,,01/11/2018,01/11/2018,0.00,,10.93,,"-1,128,133.86"
,CS,AR,32010854,1005,100,,Cash sale,,,,,,01/11/2018,01/11/2018,0.00,,11.19,,"-1,128,145.05"
,CS,AR,32010857,1005,100,,Cash sale,,,,,,01/11/2018,01/11/2018,0.00,,7.29,,"-1,128,152.34"
,CS,AR,32010862,1005,100,,Cash sale,,,,,,01/11/2018,01/11/2018,0.00,,7.29,,"-1,128,159.63"
,CS,AR,32010885,1005,100,,Cash sale,,,,,,01/11/2018,01/11/2018,0.00,,2.97,,"-1,128,162.60"
,CS,AR,32010931,1005,100,,Cash sale,,,,,,01/11/2018,01/11/2018,0.00,,10.93,,"-1,128,173.53"
,CS,AR,32010937,1005,100,,Cash sale,,,,,,01/11/2018,01/11/2018,0.00,,29.15,,"-1,128,202.68"
,CS,AR,32010950,1005,100,,Cash sale,,,,,,01/11/2018,01/11/2018,0.00,,10.93,,"-1,128,213.61"
,CS,AR,32010952,1005,100,,Cash sale,,,,,,01/11/2018,01/11/2018,0.00,,7.29,,"-1,128,220.90"
,CS,AR,32010953,1005,100,,Cash sale,,,,,,01/11/2018,01/11/2018,0.00,,7.29,,"-1,128,228.19"
,CS,AR,32010957,1005,100,,Cash sale,,,,,,01/11/2018,01/11/2018,0.00,,6.56,,"-1,128,234.75"
,CS,AR,32010991,1005,100,,Cash sale,,,,,,01/11/2018,01/11/2018,0.00,,7.29,,"-1,128,242.04"
,CS,AR,32010997,1005,100,,Cash sale,,,,,,01/11/2018,01/11/2018,0.00,,7.29,,"-1,128,249.33"
,CS,AR,32011008,1005,100,,Cash sale,,,,,,01/11/2018,01/11/2018,0.00,,3.64,,"-1,128,252.97"
,CS,AR,32011010,1005,100,,Cash sale,,,,,,01/11/2018,01/11/2018,0.00,,2.54,,"-1,128,255.51"
,CS,AR,32011011,1005,100,,Cash sale,,,,,,01/11/2018,01/11/2018,0.00,,2.97,,"-1,128,258.48"
,CS,AR,32011015,1005,100,,Cash sale,,,,,,01/11/2018,01/11/2018,0.00,,3.64,,"-1,128,262.12"
,IN,AR,30330739,1005,100,,Invoice,,,,,,01/11/2018,01/11/2018,0.00,,21.86,,"-1,128,283.98"
,IN,AR,30330744,1005,100,,Invoice,,,,,,01/11/2018,01/11/2018,0.00,,21.86,,"-1,128,305.84"
,IN,AR,30330751,1005,100,,Invoice,,,,,,01/11/2018,01/11/2018,0.00,,21.86,,"-1,128,327.70"
,IN,AR,30330752,1005,100,,Invoice,,,,,,01/11/2018,01/11/2018,0.00,,10.93,,"-1,128,338.63"
,IN,AR,30330783,1005,100,,Invoice,,,,,,01/11/2018,01/11/2018,0.00,,3.64,,"-1,128,342.27"
,IN,AR,30330796,1005,100,,Invoice,,,,,,01/11/2018,01/11/2018,0.00,,98.39,,"-1,128,440.66"
,IN,AR,30330805,1005,100,,Invoice,,,,,,01/11/2018,01/11/2018,0.00,,1.99,,"-1,128,442.65"
,IN,AR,30330810,1005,100,,Invoice,,,,,,01/11/2018,01/11/2018,0.00,,26.00,,"-1,128,468.65"
,IN,AR,30330818,1005,100,,Invoice,,,,,,01/11/2018,01/11/2018,0.00,,3.64,,"-1,128,472.29"
,IN,AR,30330819,1005,100,,Invoice,,,,,,01/11/2018,01/11/2018,0.00,,10.93,,"-1,128,483.22"
,IN,AR,30330835,1005,100,,Invoice,,,,,,01/11/2018,01/11/2018,0.00,,3.64,,"-1,128,486.86"
,IN,AR,30330865,1005,100,,Invoice,,,,,,01/11/2018,01/11/2018,0.00,,18.98,,"-1,128,505.84"
,IN,AR,30330866,1005,100,,Invoice,,,,,,01/11/2018,01/11/2018,0.00,,71.19,,"-1,128,577.03"
,IN,AR,30330879,1005,100,,Invoice,,,,,,01/11/2018,01/11/2018,0.00,,35.69,,"-1,128,612.72"
,IN,AR,30330884,1005,100,,Invoice,,,,,,01/11/2018,01/11/2018,0.00,,17.03,,"-1,128,629.75"
,IN,AR,30330928,1005,100,,Invoice,,,,,,01/11/2018,01/11/2018,0.00,,21.86,,"-1,128,651.61"
,IN,AR,30330932,1005,100,,Invoice,,,,,,01/11/2018,01/11/2018,0.00,,14.58,,"-1,128,666.19"
,IN,AR,30330933,1005,100,,Invoice,,,,,,01/11/2018,01/11/2018,0.00,,24.50,,"-1,128,690.69"
,IN,AR,30330940,1005,100,,Invoice,,,,,,01/11/2018,01/11/2018,0.00,,15.51,,"-1,128,706.20"
,IN,AR,30330942,1005,100,,Invoice,,,,,,01/11/2018,01/11/2018,0.00,,6.02,,"-1,128,712.22"
,IN,AR,30330946,1005,100,,Invoice,,,,,,01/11/2018,01/11/2018,0.00,,7.19,,"-1,128,719.41"
,IN,AR,30330999,1005,100,,Invoice,,,,,,01/11/2018,01/11/2018,0.00,,9.56,,"-1,128,728.97"
,IN,AR,30331010,1005,100,,Invoice,,,,,,01/11/2018,01/11/2018,0.00,,23.73,,"-1,128,752.70"
,IN,AR,30331018,1005,100,,Invoice,,,,,,01/11/2018,01/11/2018,0.00,,5.08,,"-1,128,757.78"
,IN,AR,30331027,1005,100,,Invoice,,,,,,01/11/2018,01/11/2018,0.00,,23.90,,"-1,128,781.68"
,IN,AR,30331035,1005,100,,Invoice,,,,,,01/11/2018,01/11/2018,0.00,,6.44,,"-1,128,788.12"
,IN,AR,30331071,1005,100,,Invoice,,,,,,01/11/2018,01/11/2018,0.00,,5.17,,"-1,128,793.29"
,IN,AR,30331074,1005,100,,Invoice,,,,,,01/11/2018,01/11/2018,0.00,,6.48,,"-1,128,799.77"
,IN,AR,30331075,1005,100,,Invoice,,,,,,01/11/2018,01/11/2018,0.00,,14.58,,"-1,128,814.35"
,IN,AR,30331080,1005,100,,Invoice,,,,,,01/11/2018,01/11/2018,0.00,,8.47,,"-1,128,822.82"
,IN,AR,30331091,1005,100,,Invoice,,,,,,01/11/2018,01/11/2018,0.00,,17.80,,"-1,128,840.62"
,IN,AR,30331097,1005,100,,Invoice,,,,,,01/11/2018,01/11/2018,0.00,,20.00,,"-1,128,860.62"
,IN,AR,30331133,1005,100,,Invoice,,,,,,01/11/2018,01/11/2018,0.00,,16.47,,"-1,128,877.09"
,IN,AR,30331143,1005,100,,Invoice,,,,,,01/11/2018,01/11/2018,0.00,,32.63,,"-1,128,909.72"
,IN,AR,30331147,1005,100,,Invoice,,,,,,01/11/2018,01/11/2018,0.00,,10.50,,"-1,128,920.22"
,IN,AR,30331149,1005,100,,Invoice,,,,,,01/11/2018,01/11/2018,0.00,,8.39,,"-1,128,928.61"
,IN,AR,30331168,1005,100,,Invoice,,,,,,01/11/2018,01/11/2018,0.00,,10.93,,"-1,128,939.54"
,IN,AR,30331173,1005,100,,Invoice,,,,,,01/11/2018,01/11/2018,0.00,,6.97,,"-1,128,946.51"
,IN,AR,30331175,1005,100,,Invoice,,,,,,01/11/2018,01/11/2018,0.00,,8.77,,"-1,128,955.28"
,IN,AR,30331180,1005,100,,Invoice,,,,,,01/11/2018,01/11/2018,0.00,,27.54,,"-1,128,982.82"
,IN,AR,30331189,1005,100,,Invoice,,,,,,01/11/2018,01/11/2018,0.00,,11.36,,"-1,128,994.18"
,IN,AR,30331201,1005,100,,Invoice,,,,,,01/11/2018,01/11/2018,0.00,,12.03,,"-1,129,006.21"
,IN,AR,30331203,1005,100,,Invoice,,,,,,01/11/2018,01/11/2018,0.00,,6.07,,"-1,129,012.28"
,IN,AR,30331209,1005,100,,Invoice,,,,,,01/11/2018,01/11/2018,0.00,,19.41,,"-1,129,031.69"
,IN,AR,30331218,1005,100,,Invoice,,,,,,01/11/2018,01/11/2018,0.00,,15.04,,"-1,129,046.73"
,IN,AR,30331219,1005,100,,Invoice,,,,,,01/11/2018,01/11/2018,0.00,,6.00,,"-1,129,052.73"
,IN,AR,30331256,1005,100,,Invoice,,,,,,01/11/2018,01/11/2018,0.00,,15.71,,"-1,129,068.44"
,IN,AR,30331258,1005,100,,Invoice,,,,,,01/11/2018,01/11/2018,0.00,,8.78,,"-1,129,077.22"
,IN,AR,30331276,1005,100,,Invoice,,,,,,01/11/2018,01/11/2018,0.00,,10.93,,"-1,129,088.15"
,IN,AR,30331285,1005,100,,Invoice,,,,,,01/11/2018,01/11/2018,0.00,,19.92,,"-1,129,108.07"
,IN,AR,30331286,1005,100,,Invoice,,,,,,01/11/2018,01/11/2018,0.00,,5.97,,"-1,129,114.04"
,IN,AR,30331287,1005,100,,Invoice,,,,,,01/11/2018,01/11/2018,0.00,,7.97,,"-1,129,122.01"
,IN,AR,30331288,1005,100,,Invoice,,,,,,01/11/2018,01/11/2018,0.00,,55.76,,"-1,129,177.77"
,IN,AR,30331293,1005,100,,Invoice,,,,,,01/11/2018,01/11/2018,0.00,,33.83,,"-1,129,211.60"
,IN,AR,30331334,1005,100,,Invoice,,,,,,01/11/2018,01/11/2018,0.00,,3.64,,"-1,129,215.24"
,IN,AR,30331368,1005,100,,Invoice,,,,,,01/11/2018,01/11/2018,0.00,,25.42,,"-1,129,240.66"
,IN,AR,30331374,1005,100,,Invoice,,,,,,01/11/2018,01/11/2018,0.00,,16.01,,"-1,129,256.67"
,IN,AR,30331380,1005,100,,Invoice,,,,,,01/11/2018,01/11/2018,0.00,,6.00,,"-1,129,262.67"
,IN,AR,30331383,1005,100,,Invoice,,,,,,01/11/2018,01/11/2018,0.00,,22.01,,"-1,129,284.68"
,IN,AR,30331391,1005,100,,Invoice,,,,,,01/11/2018,01/11/2018,0.00,,11.66,,"-1,129,296.34"
,IN,AR,30331392,1005,100,,Invoice,,,,,,01/11/2018,01/11/2018,0.00,,14.58,,"-1,129,310.92"
,IN,AR,30331397,1005,100,,Invoice,,,,,,01/11/2018,01/11/2018,0.00,,54.66,,"-1,129,365.58"
,IN,AR,30331407,1005,100,,Invoice,,,,,,01/11/2018,01/11/2018,0.00,,3.64,,"-1,129,369.22"
,IN,AR,30331419,1005,100,,Invoice,,,,,,01/11/2018,01/11/2018,0.00,,3.64,,"-1,129,372.86"
,IN,AR,30331424,1005,100,,Invoice,,,,,,01/11/2018,01/11/2018,0.00,,43.73,,"-1,129,416.59"
,IN,AR,30331433,1005,100,,Invoice,,,,,,01/11/2018,01/11/2018,0.00,,19.64,,"-1,129,436.23"
,IN,AR,30331439,1005,100,,Invoice,,,,,,01/11/2018,01/11/2018,0.00,,27.46,,"-1,129,463.69"
,IN,AR,30331445,1005,100,,Invoice,,,,,,01/11/2018,01/11/2018,0.00,,12.14,,"-1,129,475.83"
,IN,AR,30331478,1005,100,,Invoice,,,,,,01/11/2018,01/11/2018,0.00,,81.15,,"-1,129,556.98"
,IN,AR,30331480,1005,100,,Invoice,,,,,,01/11/2018,01/11/2018,0.00,,12.75,,"-1,129,569.73"
,IN,AR,30331481,1005,100,,Invoice,,,,,,01/11/2018,01/11/2018,0.00,,105.15,,"-1,129,674.88"
,IN,AR,30331482,1005,100,,Invoice,,,,,,01/11/2018,01/11/2018,0.00,,7.97,,"-1,129,682.85"
,IN,AR,30331483,1005,100,,Invoice,,,,,,01/11/2018,01/11/2018,0.00,,6.37,,"-1,129,689.22"
,IN,AR,30331484,1005,100,,Invoice,,,,,,01/11/2018,01/11/2018,0.00,,15.93,,"-1,129,705.15"
,IN,AR,30331485,1005,100,,Invoice,,,,,,01/11/2018,01/11/2018,0.00,,11.15,,"-1,129,716.30"
,IN,AR,30331499,1005,100,,Invoice,,,,,,01/11/2018,01/11/2018,0.00,,24.41,,"-1,129,740.71"
,IN,AR,30331544,1005,100,,Invoice,,,,,,01/11/2018,01/11/2018,0.00,,11.66,,"-1,129,752.37"
,IN,AR,30331545,1005,100,,Invoice,,,,,,01/11/2018,01/11/2018,0.00,,5.49,,"-1,129,757.86"
,IN,AR,30331558,1005,100,,Invoice,,,,,,01/11/2018,01/11/2018,0.00,,18.20,,"-1,129,776.06"
,IN,AR,30331565,1005,100,,Invoice,,,,,,01/11/2018,01/11/2018,0.00,,5.86,,"-1,129,781.92"
,IN,AR,30331576,1005,100,,Invoice,,,,,,01/11/2018,01/11/2018,0.00,,8.17,,"-1,129,790.09"
,IN,AR,30331581,1005,100,,Invoice,,,,,,01/11/2018,01/11/2018,0.00,,25.51,,"-1,129,815.60"
,IN,AR,30331585,1005,100,,Invoice,,,,,,01/11/2018,01/11/2018,0.00,,10.35,,"-1,129,825.95"
,IN,AR,30331593,1005,100,,Invoice,,,,,,01/11/2018,01/11/2018,0.00,,2.42,,"-1,129,828.37"
,IN,AR,30331595,1005,100,,Invoice,,,,,,01/11/2018,01/11/2018,0.00,,15.18,,"-1,129,843.55"
,IN,AR,30331601,1005,100,,Invoice,,,,,,01/11/2018,01/11/2018,0.00,,2.08,,"-1,129,845.63"
,IN,AR,30331602,1005,100,,Invoice,,,,,,01/11/2018,01/11/2018,0.00,,12.46,,"-1,129,858.09"
,IN,AR,30331603,1005,100,,Invoice,,,,,,01/11/2018,01/11/2018,0.00,,22.84,,"-1,129,880.93"
,IN,AR,30331604,1005,100,,Invoice,,,,,,01/11/2018,01/11/2018,0.00,,2.08,,"-1,129,883.01"
,IN,AR,30331605,1005,100,,Invoice,,,,,,01/11/2018,01/11/2018,0.00,,4.15,,"-1,129,887.16"
,IN,AR,30331606,1005,100,,Invoice,,,,,,01/11/2018,01/11/2018,0.00,,10.38,,"-1,129,897.54"
,IN,AR,30331655,1005,100,,Invoice,,,,,,01/11/2018,01/11/2018,0.00,,4.20,,"-1,129,901.74"
,IN,AR,30331662,1005,100,,Invoice,,,,,,01/11/2018,01/11/2018,0.00,,94.05,,"-1,129,995.79"
,IN,AR,30331679,1005,100,,Invoice,,,,,,01/11/2018,01/11/2018,0.00,,5.26,,"-1,130,001.05"
,IN,AR,30331693,1005,100,,Invoice,,,,,,01/11/2018,01/11/2018,0.00,,6.08,,"-1,130,007.13"
,IN,AR,30331700,1005,100,,Invoice,,,,,,01/11/2018,01/11/2018,0.00,,14.44,,"-1,130,021.57"
,CS,AR,32010647,1005,100,,Cash sale,,,,,,02/11/2018,02/11/2018,0.00,,16.61,,"-1,130,038.18"
,CS,AR,32010663,1005,100,,Cash sale,,,,,,02/11/2018,02/11/2018,0.00,,7.29,,"-1,130,045.47"
,CS,AR,32010673,1005,100,,Cash sale,,,,,,02/11/2018,02/11/2018,0.00,,14.58,,"-1,130,060.05"
,CS,AR,32010674,1005,100,,Cash sale,,,,,,02/11/2018,02/11/2018,0.00,,9.66,,"-1,130,069.71"
,CS,AR,32010681,1005,100,,Cash sale,,,,,,02/11/2018,02/11/2018,0.00,,7.29,,"-1,130,077.00"
,CS,AR,32010683,1005,100,,Cash sale,,,,,,02/11/2018,02/11/2018,0.00,,14.53,,"-1,130,091.53"
,CS,AR,32010688,1005,100,,Cash sale,,,,,,02/11/2018,02/11/2018,0.00,,3.64,,"-1,130,095.17"
,CS,AR,32010691,1005,100,,Cash sale,,,,,,02/11/2018,02/11/2018,0.00,,9.73,,"-1,130,104.90"
,CS,AR,32010695,1005,100,,Cash sale,,,,,,02/11/2018,02/11/2018,0.00,,3.64,,"-1,130,108.54"
,CS,AR,32010708,1005,100,,Cash sale,,,,,,02/11/2018,02/11/2018,0.00,,7.29,,"-1,130,115.83"
,CS,AR,32010715,1005,100,,Cash sale,,,,,,02/11/2018,02/11/2018,0.00,,18.22,,"-1,130,134.05"
,CS,AR,32010726,1005,100,,Cash sale,,,,,,02/11/2018,02/11/2018,0.00,,18.22,,"-1,130,152.27"
,CS,AR,32010728,1005,100,,Cash sale,,,,,,02/11/2018,02/11/2018,0.00,,2.58,,"-1,130,154.85"
,CS,AR,32010731,1005,100,,Cash sale,,,,,,02/11/2018,02/11/2018,0.00,,12.71,,"-1,130,167.56"
,CS,AR,32010738,1005,100,,Cash sale,,,,,,02/11/2018,02/11/2018,0.00,,3.64,,"-1,130,171.20"
,CS,AR,32010741,1005,100,,Cash sale,,,,,,02/11/2018,02/11/2018,0.00,,41.21,,"-1,130,212.41"
,CS,AR,32010747,1005,100,,Cash sale,,,,,,02/11/2018,02/11/2018,0.00,,7.29,,"-1,130,219.70"
,CS,AR,32010748,1005,100,,Cash sale,,,,,,02/11/2018,02/11/2018,0.00,,6.02,,"-1,130,225.72"
,CS,AR,32010751,1005,100,,Cash sale,,,,,,02/11/2018,02/11/2018,0.00,,10.93,,"-1,130,236.65"
,CS,AR,32010755,1005,100,,Cash sale,,,,,,02/11/2018,02/11/2018,0.00,,60.17,,"-1,130,296.82"
,CS,AR,32010760,1005,100,,Cash sale,,,,,,02/11/2018,02/11/2018,0.00,,14.62,,"-1,130,311.44"
,CS,AR,32010771,1005,100,,Cash sale,,,,,,02/11/2018,02/11/2018,0.00,,30.08,,"-1,130,341.52"
,CS,AR,32010776,1005,100,,Cash sale,,,,,,02/11/2018,02/11/2018,0.00,,12.71,,"-1,130,354.23"
,CS,AR,32010797,1005,100,,Cash sale,,,,,,02/11/2018,02/11/2018,0.00,,7.29,,"-1,130,361.52"
,CS,AR,32010798,1005,100,,Cash sale,,,,,,02/11/2018,02/11/2018,0.00,,105.30,,"-1,130,466.82"
,CS,AR,32010812,1005,100,,Cash sale,,,,,,02/11/2018,02/11/2018,0.00,,18.22,,"-1,130,485.04"
,CS,AR,32010814,1005,100,,Cash sale,,,,,,02/11/2018,02/11/2018,0.00,,25.51,,"-1,130,510.55"
,CS,AR,32010821,1005,100,,Cash sale,,,,,,02/11/2018,02/11/2018,0.00,,7.29,,"-1,130,517.84"
,CS,AR,32010825,1005,100,,Cash sale,,,,,,02/11/2018,02/11/2018,0.00,,14.63,,"-1,130,532.47"
,CS,AR,32010833,1005,100,,Cash sale,,,,,,02/11/2018,02/11/2018,0.00,,14.58,,"-1,130,547.05"
,CS,AR,32010834,1005,100,,Cash sale,,,,,,02/11/2018,02/11/2018,0.00,,14.58,,"-1,130,561.63"
,CS,AR,32010839,1005,100,,Cash sale,,,,,,02/11/2018,02/11/2018,0.00,,3.64,,"-1,130,565.27"
,CS,AR,32010842,1005,100,,Cash sale,,,,,,02/11/2018,02/11/2018,0.00,,2.58,,"-1,130,567.85"
,CS,AR,32010847,1005,100,,Cash sale,,,,,,02/11/2018,02/11/2018,0.00,,11.12,,"-1,130,578.97"
,CS,AR,32010855,1005,100,,Cash sale,,,,,,02/11/2018,02/11/2018,0.00,,7.29,,"-1,130,586.26"
,CS,AR,32010860,1005,100,,Cash sale,,,,,,02/11/2018,02/11/2018,0.00,,14.58,,"-1,130,600.84"
,CS,AR,32010863,1005,100,,Cash sale,,,,,,02/11/2018,02/11/2018,0.00,,27.97,,"-1,130,628.81"
,CS,AR,32010867,1005,100,,Cash sale,,,,,,02/11/2018,02/11/2018,0.00,,10.93,,"-1,130,639.74"
,CS,AR,32010872,1005,100,,Cash sale,,,,,,02/11/2018,02/11/2018,0.00,,4.08,,"-1,130,643.82"
,CS,AR,32010883,1005,100,,Cash sale,,,,,,02/11/2018,02/11/2018,0.00,,7.63,,"-1,130,651.45"
,CS,AR,32010888,1005,100,,Cash sale,,,,,,02/11/2018,02/11/2018,0.00,,13.12,,"-1,130,664.57"
,CS,AR,32010895,1005,100,,Cash sale,,,,,,02/11/2018,02/11/2018,0.00,,4.58,,"-1,130,669.15"
,CS,AR,32010916,1005,100,,Cash sale,,,,,,02/11/2018,02/11/2018,0.00,,18.22,,"-1,130,687.37"
,CS,AR,32010918,1005,100,,Cash sale,,,,,,02/11/2018,02/11/2018,0.00,,48.57,,"-1,130,735.94"
,CS,AR,32010922,1005,100,,Cash sale,,,,,,02/11/2018,02/11/2018,0.00,,15.18,,"-1,130,751.12"
,CS,AR,32010926,1005,100,,Cash sale,,,,,,02/11/2018,02/11/2018,0.00,,10.93,,"-1,130,762.05"
,CS,AR,32010932,1005,100,,Cash sale,,,,,,02/11/2018,02/11/2018,0.00,,3.64,,"-1,130,765.69"
,CS,AR,32010933,1005,100,,Cash sale,,,,,,02/11/2018,02/11/2018,0.00,,12.14,,"-1,130,777.83"
,CS,AR,32010935,1005,100,,Cash sale,,,,,,02/11/2018,02/11/2018,0.00,,9.15,,"-1,130,786.98"
,CS,AR,32010942,1005,100,,Cash sale,,,,,,02/11/2018,02/11/2018,0.00,,6.08,,"-1,130,793.06"
,CS,AR,32010945,1005,100,,Cash sale,,,,,,02/11/2018,02/11/2018,0.00,,14.58,,"-1,130,807.64"
,CS,AR,32010955,1005,100,,Cash sale,,,,,,02/11/2018,02/11/2018,0.00,,3.64,,"-1,130,811.28"
,CS,AR,32010968,1005,100,,Cash sale,,,,,,02/11/2018,02/11/2018,0.00,,2.97,,"-1,130,814.25"
,CS,AR,32010970,1005,100,,Cash sale,,,,,,02/11/2018,02/11/2018,0.00,,7.29,,"-1,130,821.54"
,CS,AR,32010971,1005,100,,Cash sale,,,,,,02/11/2018,02/11/2018,0.00,,7.29,,"-1,130,828.83"
,CS,AR,32010999,1005,100,,Cash sale,,,,,,02/11/2018,02/11/2018,0.00,,18.22,,"-1,130,847.05"
,CS,AR,32011003,1005,100,,Cash sale,,,,,,02/11/2018,02/11/2018,0.00,,9.84,,"-1,130,856.89"
,CS,AR,32011013,1005,100,,Cash sale,,,,,,02/11/2018,02/11/2018,0.00,,5.93,,"-1,130,862.82"
,IN,AR,30330730,1005,100,,Invoice,,,,,,02/11/2018,02/11/2018,0.00,,56.36,,"-1,130,919.18"
,IN,AR,30330731,1005,100,,Invoice,,,,,,02/11/2018,02/11/2018,0.00,,5.93,,"-1,130,925.11"
,IN,AR,30330737,1005,100,,Invoice,,,,,,02/11/2018,02/11/2018,0.00,,29.15,,"-1,130,954.26"
,IN,AR,30330748,1005,100,,Invoice,,,,,,02/11/2018,02/11/2018,0.00,,13.98,,"-1,130,968.24"
,IN,AR,30330755,1005,100,,Invoice,,,,,,02/11/2018,02/11/2018,0.00,,3.64,,"-1,130,971.88"
,IN,AR,30330766,1005,100,,Invoice,,,,,,02/11/2018,02/11/2018,0.00,,10.93,,"-1,130,982.81"
,IN,AR,30330771,1005,100,,Invoice,,,,,,02/11/2018,02/11/2018,0.00,,6.08,,"-1,130,988.89"
,IN,AR,30330779,1005,100,,Invoice,,,,,,02/11/2018,02/11/2018,0.00,,7.25,,"-1,130,996.14"
,IN,AR,30330787,1005,100,,Invoice,,,,,,02/11/2018,02/11/2018,0.00,,14.58,,"-1,131,010.72"
,IN,AR,30330788,1005,100,,Invoice,,,,,,02/11/2018,02/11/2018,0.00,,80.31,,"-1,131,091.03"
,IN,AR,30330799,1005,100,,Invoice,,,,,,02/11/2018,02/11/2018,0.00,,11.48,,"-1,131,102.51"
,IN,AR,30330801,1005,100,,Invoice,,,,,,02/11/2018,02/11/2018,0.00,,89.27,,"-1,131,191.78"
,IN,AR,30330806,1005,100,,Invoice,,,,,,02/11/2018,02/11/2018,0.00,,5.97,,"-1,131,197.75"
,IN,AR,30330811,1005,100,,Invoice,,,,,,02/11/2018,02/11/2018,0.00,,62.00,,"-1,131,259.75"
,IN,AR,30330821,1005,100,,Invoice,,,,,,02/11/2018,02/11/2018,0.00,,52.00,,"-1,131,311.75"
,IN,AR,30330839,1005,100,,Invoice,,,,,,02/11/2018,02/11/2018,0.00,,20.00,,"-1,131,331.75"
,IN,AR,30330853,1005,100,,Invoice,,,,,,02/11/2018,02/11/2018,0.00,,7.29,,"-1,131,339.04"
,IN,AR,30330867,1005,100,,Invoice,,,,,,02/11/2018,02/11/2018,0.00,,7.12,,"-1,131,346.16"
,IN,AR,30330871,1005,100,,Invoice,,,,,,02/11/2018,02/11/2018,0.00,,18.00,,"-1,131,364.16"
,IN,AR,30330901,1005,100,,Invoice,,,,,,02/11/2018,02/11/2018,0.00,,5.82,,"-1,131,369.98"
,IN,AR,30330902,1005,100,,Invoice,,,,,,02/11/2018,02/11/2018,0.00,,9.70,,"-1,131,379.68"
,IN,AR,30330907,1005,100,,Invoice,,,,,,02/11/2018,02/11/2018,0.00,,38.00,,"-1,131,417.68"
,IN,AR,30330911,1005,100,,Invoice,,,,,,02/11/2018,02/11/2018,0.00,,3.64,,"-1,131,421.32"
,IN,AR,30330915,1005,100,,Invoice,,,,,,02/11/2018,02/11/2018,0.00,,29.15,,"-1,131,450.47"
,IN,AR,30330917,1005,100,,Invoice,,,,,,02/11/2018,02/11/2018,0.00,,8.39,,"-1,131,458.86"
,IN,AR,30330921,1005,100,,Invoice,,,,,,02/11/2018,02/11/2018,0.00,,31.05,,"-1,131,489.91"
,IN,AR,30330930,1005,100,,Invoice,,,,,,02/11/2018,02/11/2018,0.00,,23.26,,"-1,131,513.17"
,IN,AR,30330934,1005,100,,Invoice,,,,,,02/11/2018,02/11/2018,0.00,,14.00,,"-1,131,527.17"
,IN,AR,30330947,1005,100,,Invoice,,,,,,02/11/2018,02/11/2018,0.00,,7.19,,"-1,131,534.36"
,IN,AR,30330951,1005,100,,Invoice,,,,,,02/11/2018,02/11/2018,0.00,,20.67,,"-1,131,555.03"
,IN,AR,30330954,1005,100,,Invoice,,,,,,02/11/2018,02/11/2018,0.00,,10.93,,"-1,131,565.96"
,IN,AR,30330957,1005,100,,Invoice,,,,,,02/11/2018,02/11/2018,0.00,,22.88,,"-1,131,588.84"
,IN,AR,30330964,1005,100,,Invoice,,,,,,02/11/2018,02/11/2018,0.00,,26.44,,"-1,131,615.28"
,IN,AR,30330965,1005,100,,Invoice,,,,,,02/11/2018,02/11/2018,0.00,,10.17,,"-1,131,625.45"
,IN,AR,30330981,1005,100,,Invoice,,,,,,02/11/2018,02/11/2018,0.00,,23.26,,"-1,131,648.71"
,IN,AR,30330985,1005,100,,Invoice,,,,,,02/11/2018,02/11/2018,0.00,,4.78,,"-1,131,653.49"
,IN,AR,30331002,1005,100,,Invoice,,,,,,02/11/2018,02/11/2018,0.00,,9.03,,"-1,131,662.52"
,IN,AR,30331012,1005,100,,Invoice,,,,,,02/11/2018,02/11/2018,0.00,,57.42,,"-1,131,719.94"
,IN,AR,30331017,1005,100,,Invoice,,,,,,02/11/2018,02/11/2018,0.00,,28.05,,"-1,131,747.99"
,IN,AR,30331019,1005,100,,Invoice,,,,,,02/11/2018,02/11/2018,0.00,,86.44,,"-1,131,834.43"
,IN,AR,30331039,1005,100,,Invoice,,,,,,02/11/2018,02/11/2018,0.00,,6.02,,"-1,131,840.45"
,IN,AR,30331055,1005,100,,Invoice,,,,,,02/11/2018,02/11/2018,0.00,,2.54,,"-1,131,842.99"
,IN,AR,30331056,1005,100,,Invoice,,,,,,02/11/2018,02/11/2018,0.00,,5.08,,"-1,131,848.07"
,IN,AR,30331057,1005,100,,Invoice,,,,,,02/11/2018,02/11/2018,0.00,,10.17,,"-1,131,858.24"
,IN,AR,30331058,1005,100,,Invoice,,,,,,02/11/2018,02/11/2018,0.00,,5.08,,"-1,131,863.32"
,IN,AR,30331066,1005,100,,Invoice,,,,,,02/11/2018,02/11/2018,0.00,,5.08,,"-1,131,868.40"
,IN,AR,30331078,1005,100,,Invoice,,,,,,02/11/2018,02/11/2018,0.00,,15.25,,"-1,131,883.65"
,IN,AR,30331081,1005,100,,Invoice,,,,,,02/11/2018,02/11/2018,0.00,,14.83,,"-1,131,898.48"
,IN,AR,30331085,1005,100,,Invoice,,,,,,02/11/2018,02/11/2018,0.00,,14.58,,"-1,131,913.06"
,IN,AR,30331100,1005,100,,Invoice,,,,,,02/11/2018,02/11/2018,0.00,,6.10,,"-1,131,919.16"
,IN,AR,30331121,1005,100,,Invoice,,,,,,02/11/2018,02/11/2018,0.00,,2.12,,"-1,131,921.28"
,IN,AR,30331131,1005,100,,Invoice,,,,,,02/11/2018,02/11/2018,0.00,,14.58,,"-1,131,935.86"
,IN,AR,30331137,1005,100,,Invoice,,,,,,02/11/2018,02/11/2018,0.00,,5.61,,"-1,131,941.47"
,IN,AR,30331150,1005,100,,Invoice,,,,,,02/11/2018,02/11/2018,0.00,,7.29,,"-1,131,948.76"
,IN,AR,30331159,1005,100,,Invoice,,,,,,02/11/2018,02/11/2018,0.00,,10.93,,"-1,131,959.69"
,IN,AR,30331184,1005,100,,Invoice,,,,,,02/11/2018,02/11/2018,0.00,,5.17,,"-1,131,964.86"
,IN,AR,30331213,1005,100,,Invoice,,,,,,02/11/2018,02/11/2018,0.00,,6.53,,"-1,131,971.39"
,IN,AR,30331228,1005,100,,Invoice,,,,,,02/11/2018,02/11/2018,0.00,,13.14,,"-1,131,984.53"
,IN,AR,30331230,1005,100,,Invoice,,,,,,02/11/2018,02/11/2018,0.00,,1.76,,"-1,131,986.29"
,IN,AR,30331231,1005,100,,Invoice,,,,,,02/11/2018,02/11/2018,0.00,,3.53,,"-1,131,989.82"
,IN,AR,30331244,1005,100,,Invoice,,,,,,02/11/2018,02/11/2018,0.00,,2.42,,"-1,131,992.24"
,IN,AR,30331255,1005,100,,Invoice,,,,,,02/11/2018,02/11/2018,0.00,,29.15,,"-1,132,021.39"
,IN,AR,30331270,1005,100,,Invoice,,,,,,02/11/2018,02/11/2018,0.00,,2.84,,"-1,132,024.23"
,IN,AR,30331281,1005,100,,Invoice,,,,,,02/11/2018,02/11/2018,0.00,,35.08,,"-1,132,059.31"
,IN,AR,30331294,1005,100,,Invoice,,,,,,02/11/2018,02/11/2018,0.00,,5.97,,"-1,132,065.28"
,IN,AR,30331295,1005,100,,Invoice,,,,,,02/11/2018,02/11/2018,0.00,,43.78,,"-1,132,109.06"
,IN,AR,30331307,1005,100,,Invoice,,,,,,02/11/2018,02/11/2018,0.00,,48.26,,"-1,132,157.32"
,IN,AR,30331311,1005,100,,Invoice,,,,,,02/11/2018,02/11/2018,0.00,,34.00,,"-1,132,191.32"
,IN,AR,30331314,1005,100,,Invoice,,,,,,02/11/2018,02/11/2018,0.00,,28.81,,"-1,132,220.13"
,IN,AR,30331318,1005,100,,Invoice,,,,,,02/11/2018,02/11/2018,0.00,,5.93,,"-1,132,226.06"
,IN,AR,30331323,1005,100,,Invoice,,,,,,02/11/2018,02/11/2018,0.00,,28.06,,"-1,132,254.12"
,IN,AR,30331338,1005,100,,Invoice,,,,,,02/11/2018,02/11/2018,0.00,,3.64,,"-1,132,257.76"
,IN,AR,30331339,1005,100,,Invoice,,,,,,02/11/2018,02/11/2018,0.00,,36.74,,"-1,132,294.50"
,IN,AR,30331347,1005,100,,Invoice,,,,,,02/11/2018,02/11/2018,0.00,,14.58,,"-1,132,309.08"
,IN,AR,30331349,1005,100,,Invoice,,,,,,02/11/2018,02/11/2018,0.00,,39.41,,"-1,132,348.49"
,IN,AR,30331356,1005,100,,Invoice,,,,,,02/11/2018,02/11/2018,0.00,,2.54,,"-1,132,351.03"
,IN,AR,30331363,1005,100,,Invoice,,,,,,02/11/2018,02/11/2018,0.00,,21.52,,"-1,132,372.55"
,IN,AR,30331369,1005,100,,Invoice,,,,,,02/11/2018,02/11/2018,0.00,,17.80,,"-1,132,390.35"
,IN,AR,30331376,1005,100,,Invoice,,,,,,02/11/2018,02/11/2018,0.00,,6.00,,"-1,132,396.35"
,IN,AR,30331386,1005,100,,Invoice,,,,,,02/11/2018,02/11/2018,0.00,,16.01,,"-1,132,412.36"
,IN,AR,30331408,1005,100,,Invoice,,,,,,02/11/2018,02/11/2018,0.00,,27.37,,"-1,132,439.73"
,IN,AR,30331410,1005,100,,Invoice,,,,,,02/11/2018,02/11/2018,0.00,,12.62,,"-1,132,452.35"
,IN,AR,30331411,1005,100,,Invoice,,,,,,02/11/2018,02/11/2018,0.00,,50.47,,"-1,132,502.82"
,IN,AR,30331428,1005,100,,Invoice,,,,,,02/11/2018,02/11/2018,0.00,,7.29,,"-1,132,510.11"
,IN,AR,30331437,1005,100,,Invoice,,,,,,02/11/2018,02/11/2018,0.00,,11.48,,"-1,132,521.59"
,IN,AR,30331442,1005,100,,Invoice,,,,,,02/11/2018,02/11/2018,0.00,,14.58,,"-1,132,536.17"
,IN,AR,30331444,1005,100,,Invoice,,,,,,02/11/2018,02/11/2018,0.00,,24.98,,"-1,132,561.15"
,IN,AR,30331468,1005,100,,Invoice,,,,,,02/11/2018,02/11/2018,0.00,,18.22,,"-1,132,579.37"
,IN,AR,30331472,1005,100,,Invoice,,,,,,02/11/2018,02/11/2018,0.00,,8.52,,"-1,132,587.89"
,IN,AR,30331473,1005,100,,Invoice,,,,,,02/11/2018,02/11/2018,0.00,,9.66,,"-1,132,597.55"
,IN,AR,30331519,1005,100,,Invoice,,,,,,02/11/2018,02/11/2018,0.00,,8.00,,"-1,132,605.55"
,IN,AR,30331535,1005,100,,Invoice,,,,,,02/11/2018,02/11/2018,0.00,,46.39,,"-1,132,651.94"
,IN,AR,30331539,1005,100,,Invoice,,,,,,02/11/2018,02/11/2018,0.00,,18.22,,"-1,132,670.16"
,IN,AR,30331542,1005,100,,Invoice,,,,,,02/11/2018,02/11/2018,0.00,,5.83,,"-1,132,675.99"
,IN,AR,30331546,1005,100,,Invoice,,,,,,02/11/2018,02/11/2018,0.00,,10.95,,"-1,132,686.94"
,IN,AR,30331564,1005,100,,Invoice,,,,,,02/11/2018,02/11/2018,0.00,,14.58,,"-1,132,701.52"
,IN,AR,30331571,1005,100,,Invoice,,,,,,02/11/2018,02/11/2018,0.00,,10.21,,"-1,132,711.73"
,IN,AR,30331582,1005,100,,Invoice,,,,,,02/11/2018,02/11/2018,0.00,,18.22,,"-1,132,729.95"
,IN,AR,30331588,1005,100,,Invoice,,,,,,02/11/2018,02/11/2018,0.00,,5.97,,"-1,132,735.92"
,IN,AR,30331632,1005,100,,Invoice,,,,,,02/11/2018,02/11/2018,0.00,,15.51,,"-1,132,751.43"
,IN,AR,30331635,1005,100,,Invoice,,,,,,02/11/2018,02/11/2018,0.00,,61.95,,"-1,132,813.38"
,IN,AR,30331645,1005,100,,Invoice,,,,,,02/11/2018,02/11/2018,0.00,,10.93,,"-1,132,824.31"
,IN,AR,30331663,1005,100,,Invoice,,,,,,02/11/2018,02/11/2018,0.00,,54.61,,"-1,132,878.92"
,IN,AR,30331675,1005,100,,Invoice,,,,,,02/11/2018,02/11/2018,0.00,,9.10,,"-1,132,888.02"
,IN,AR,30331697,1005,100,,Invoice,,,,,,02/11/2018,02/11/2018,0.00,,10.93,,"-1,132,898.95"
,IN,AR,30331703,1005,100,,Invoice,,,,,,02/11/2018,02/11/2018,0.00,,36.44,,"-1,132,935.39"
,IN,AR,30331961,1005,100,,Invoice,,,,,,02/11/2018,02/11/2018,0.00,,30.51,,"-1,132,965.90"
,CS,AR,32012523,1005,100,,Cash sale,,,,,,02/11/2018,02/11/2018,0.00,,7.29,,"-1,132,973.19"
,CS,AR,32010736,1005,100,,Cash sale,,,,,,03/11/2018,03/11/2018,0.00,,14.58,,"-1,132,987.77"
,CS,AR,32010761,1005,100,,Cash sale,,,,,,03/11/2018,03/11/2018,0.00,,5.85,,"-1,132,993.62"
,CS,AR,32010816,1005,100,,Cash sale,,,,,,03/11/2018,03/11/2018,0.00,,29.15,,"-1,133,022.77"
,CS,AR,32010919,1005,100,,Cash sale,,,,,,03/11/2018,03/11/2018,0.00,,21.86,,"-1,133,044.63"
,IN,AR,30330802,1005,100,,Invoice,,,,,,03/11/2018,03/11/2018,0.00,,5.82,,"-1,133,050.45"
,IN,AR,30330890,1005,100,,Invoice,,,,,,03/11/2018,03/11/2018,0.00,,780.96,,"-1,133,831.41"
,IN,AR,30331681,1005,100,,Invoice,,,,,,03/11/2018,03/11/2018,0.00,,7.29,,"-1,133,838.70"
,IN,AR,30331683,1005,100,,Invoice,,,,,,03/11/2018,03/11/2018,0.00,,54.66,,"-1,133,893.36"
,IN,AR,30331708,1005,100,,Invoice,,,,,,03/11/2018,03/11/2018,0.00,,18.22,,"-1,133,911.58"
,CN,AR,31019424,1005,100,,Credit Note,,,,,,05/11/2018,05/11/2018,183.05,,0.00,,"-1,133,728.53"
,CN,AR,31019465,1005,100,,Credit Note,,,,,,05/11/2018,05/11/2018,10.93,,0.00,,"-1,133,717.60"
,CS,AR,32010641,1005,100,,Cash sale,,,,,,05/11/2018,05/11/2018,0.00,,11.22,,"-1,133,728.82"
,CS,AR,32010667,1005,100,,Cash sale,,,,,,05/11/2018,05/11/2018,0.00,,3.64,,"-1,133,732.46"
,CS,AR,32010671,1005,100,,Cash sale,,,,,,05/11/2018,05/11/2018,0.00,,54.15,,"-1,133,786.61"
,CS,AR,32010684,1005,100,,Cash sale,,,,,,05/11/2018,05/11/2018,0.00,,16.61,,"-1,133,803.22"
,CS,AR,32010692,1005,100,,Cash sale,,,,,,05/11/2018,05/11/2018,0.00,,7.78,,"-1,133,811.00"
,CS,AR,32010716,1005,100,,Cash sale,,,,,,05/11/2018,05/11/2018,0.00,,7.29,,"-1,133,818.29"
,CS,AR,32010717,1005,100,,Cash sale,,,,,,05/11/2018,05/11/2018,0.00,,10.34,,"-1,133,828.63"
,CS,AR,32010724,1005,100,,Cash sale,,,,,,05/11/2018,05/11/2018,0.00,,7.29,,"-1,133,835.92"
,CS,AR,32010732,1005,100,,Cash sale,,,,,,05/11/2018,05/11/2018,0.00,,10.17,,"-1,133,846.09"
,CS,AR,32010744,1005,100,,Cash sale,,,,,,05/11/2018,05/11/2018,0.00,,16.48,,"-1,133,862.57"
,CS,AR,32010753,1005,100,,Cash sale,,,,,,05/11/2018,05/11/2018,0.00,,7.29,,"-1,133,869.86"
,CS,AR,32010762,1005,100,,Cash sale,,,,,,05/11/2018,05/11/2018,0.00,,23.39,,"-1,133,893.25"
,CS,AR,32010765,1005,100,,Cash sale,,,,,,05/11/2018,05/11/2018,0.00,,5.44,,"-1,133,898.69"
,CS,AR,32010772,1005,100,,Cash sale,,,,,,05/11/2018,05/11/2018,0.00,,27.08,,"-1,133,925.77"
,CS,AR,32010786,1005,100,,Cash sale,,,,,,05/11/2018,05/11/2018,0.00,,3.64,,"-1,133,929.41"
,CS,AR,32010800,1005,100,,Cash sale,,,,,,05/11/2018,05/11/2018,0.00,,2.54,,"-1,133,931.95"
,CS,AR,32010811,1005,100,,Cash sale,,,,,,05/11/2018,05/11/2018,0.00,,7.75,,"-1,133,939.70"
,CS,AR,32010817,1005,100,,Cash sale,,,,,,05/11/2018,05/11/2018,0.00,,7.29,,"-1,133,946.99"
,CS,AR,32010822,1005,100,,Cash sale,,,,,,05/11/2018,05/11/2018,0.00,,10.93,,"-1,133,957.92"
,CS,AR,32010841,1005,100,,Cash sale,,,,,,05/11/2018,05/11/2018,0.00,,3.20,,"-1,133,961.12"
,CS,AR,32010844,1005,100,,Cash sale,,,,,,05/11/2018,05/11/2018,0.00,,6.08,,"-1,133,967.20"
,CS,AR,32010853,1005,100,,Cash sale,,,,,,05/11/2018,05/11/2018,0.00,,24.03,,"-1,133,991.23"
,CS,AR,32010856,1005,100,,Cash sale,,,,,,05/11/2018,05/11/2018,0.00,,7.29,,"-1,133,998.52"
,CS,AR,32010864,1005,100,,Cash sale,,,,,,05/11/2018,05/11/2018,0.00,,12.71,,"-1,134,011.23"
,CS,AR,32010869,1005,100,,Cash sale,,,,,,05/11/2018,05/11/2018,0.00,,6.53,,"-1,134,017.76"
,CS,AR,32010871,1005,100,,Cash sale,,,,,,05/11/2018,05/11/2018,0.00,,14.58,,"-1,134,032.34"
,CS,AR,32010874,1005,100,,Cash sale,,,,,,05/11/2018,05/11/2018,0.00,,2.58,,"-1,134,034.92"
,CS,AR,32010881,1005,100,,Cash sale,,,,,,05/11/2018,05/11/2018,0.00,,15.17,,"-1,134,050.09"
,CS,AR,32010896,1005,100,,Cash sale,,,,,,05/11/2018,05/11/2018,0.00,,11.44,,"-1,134,061.53"
,CS,AR,32010910,1005,100,,Cash sale,,,,,,05/11/2018,05/11/2018,0.00,,10.17,,"-1,134,071.70"
,CS,AR,32010923,1005,100,,Cash sale,,,,,,05/11/2018,05/11/2018,0.00,,9.11,,"-1,134,080.81"
,CS,AR,32010927,1005,100,,Cash sale,,,,,,05/11/2018,05/11/2018,0.00,,10.93,,"-1,134,091.74"
,CS,AR,32010939,1005,100,,Cash sale,,,,,,05/11/2018,05/11/2018,0.00,,14.58,,"-1,134,106.32"
,CS,AR,32010944,1005,100,,Cash sale,,,,,,05/11/2018,05/11/2018,0.00,,10.93,,"-1,134,117.25"
,CS,AR,32010946,1005,100,,Cash sale,,,,,,05/11/2018,05/11/2018,0.00,,3.64,,"-1,134,120.89"
,CS,AR,32010960,1005,100,,Cash sale,,,,,,05/11/2018,05/11/2018,0.00,,10.93,,"-1,134,131.82"
,CS,AR,32010966,1005,100,,Cash sale,,,,,,05/11/2018,05/11/2018,0.00,,3.64,,"-1,134,135.46"
,CS,AR,32010989,1005,100,,Cash sale,,,,,,05/11/2018,05/11/2018,0.00,,9.10,,"-1,134,144.56"
,CS,AR,32011001,1005,100,,Cash sale,,,,,,05/11/2018,05/11/2018,0.00,,10.93,,"-1,134,155.49"
,CS,AR,32011004,1005,100,,Cash sale,,,,,,05/11/2018,05/11/2018,0.00,,5.17,,"-1,134,160.66"
,CS,AR,32011007,1005,100,,Cash sale,,,,,,05/11/2018,05/11/2018,0.00,,14.58,,"-1,134,175.24"
,IN,AR,30330732,1005,100,,Invoice,,,,,,05/11/2018,05/11/2018,0.00,,74.15,,"-1,134,249.39"
,IN,AR,30330741,1005,100,,Invoice,,,,,,05/11/2018,05/11/2018,0.00,,36.44,,"-1,134,285.83"
,IN,AR,30330756,1005,100,,Invoice,,,,,,05/11/2018,05/11/2018,0.00,,6.08,,"-1,134,291.91"
,IN,AR,30330757,1005,100,,Invoice,,,,,,05/11/2018,05/11/2018,0.00,,8.10,,"-1,134,300.01"
,IN,AR,30330758,1005,100,,Invoice,,,,,,05/11/2018,05/11/2018,0.00,,2.03,,"-1,134,302.04"
,IN,AR,30330759,1005,100,,Invoice,,,,,,05/11/2018,05/11/2018,0.00,,6.08,,"-1,134,308.12"
,IN,AR,30330760,1005,100,,Invoice,,,,,,05/11/2018,05/11/2018,0.00,,22.28,,"-1,134,330.40"
,IN,AR,30330761,1005,100,,Invoice,,,,,,05/11/2018,05/11/2018,0.00,,16.20,,"-1,134,346.60"
,IN,AR,30330762,1005,100,,Invoice,,,,,,05/11/2018,05/11/2018,0.00,,2.03,,"-1,134,348.63"
,IN,AR,30330764,1005,100,,Invoice,,,,,,05/11/2018,05/11/2018,0.00,,11.86,,"-1,134,360.49"
,IN,AR,30330777,1005,100,,Invoice,,,,,,05/11/2018,05/11/2018,0.00,,7.29,,"-1,134,367.78"
,IN,AR,30330778,1005,100,,Invoice,,,,,,05/11/2018,05/11/2018,0.00,,7.29,,"-1,134,375.07"
,IN,AR,30330789,1005,100,,Invoice,,,,,,05/11/2018,05/11/2018,0.00,,21.14,,"-1,134,396.21"
,IN,AR,30330791,1005,100,,Invoice,,,,,,05/11/2018,05/11/2018,0.00,,3.64,,"-1,134,399.85"
,IN,AR,30330812,1005,100,,Invoice,,,,,,05/11/2018,05/11/2018,0.00,,84.00,,"-1,134,483.85"
,IN,AR,30330817,1005,100,,Invoice,,,,,,05/11/2018,05/11/2018,0.00,,19.28,,"-1,134,503.13"
,IN,AR,30330822,1005,100,,Invoice,,,,,,05/11/2018,05/11/2018,0.00,,48.00,,"-1,134,551.13"
,IN,AR,30330828,1005,100,,Invoice,,,,,,05/11/2018,05/11/2018,0.00,,65.75,,"-1,134,616.88"
,IN,AR,30330837,1005,100,,Invoice,,,,,,05/11/2018,05/11/2018,0.00,,3.64,,"-1,134,620.52"
,IN,AR,30330840,1005,100,,Invoice,,,,,,05/11/2018,05/11/2018,0.00,,40.00,,"-1,134,660.52"
,IN,AR,30330841,1005,100,,Invoice,,,,,,05/11/2018,05/11/2018,0.00,,26.00,,"-1,134,686.52"
,IN,AR,30330852,1005,100,,Invoice,,,,,,05/11/2018,05/11/2018,0.00,,2.75,,"-1,134,689.27"
,IN,AR,30330854,1005,100,,Invoice,,,,,,05/11/2018,05/11/2018,0.00,,35.59,,"-1,134,724.86"
,IN,AR,30330856,1005,100,,Invoice,,,,,,05/11/2018,05/11/2018,0.00,,11.02,,"-1,134,735.88"
,IN,AR,30330864,1005,100,,Invoice,,,,,,05/11/2018,05/11/2018,0.00,,11.69,,"-1,134,747.57"
,IN,AR,30330872,1005,100,,Invoice,,,,,,05/11/2018,05/11/2018,0.00,,20.00,,"-1,134,767.57"
,IN,AR,30330876,1005,100,,Invoice,,,,,,05/11/2018,05/11/2018,0.00,,10.93,,"-1,134,778.50"
,IN,AR,30330886,1005,100,,Invoice,,,,,,05/11/2018,05/11/2018,0.00,,141.90,,"-1,134,920.40"
,IN,AR,30330908,1005,100,,Invoice,,,,,,05/11/2018,05/11/2018,0.00,,36.00,,"-1,134,956.40"
,IN,AR,30330919,1005,100,,Invoice,,,,,,05/11/2018,05/11/2018,0.00,,16.10,,"-1,134,972.50"
,IN,AR,30330924,1005,100,,Invoice,,,,,,05/11/2018,05/11/2018,0.00,,36.44,,"-1,135,008.94"
,IN,AR,30330952,1005,100,,Invoice,,,,,,05/11/2018,05/11/2018,0.00,,6.89,,"-1,135,015.83"
,IN,AR,30330953,1005,100,,Invoice,,,,,,05/11/2018,05/11/2018,0.00,,54.66,,"-1,135,070.49"
,IN,AR,30330966,1005,100,,Invoice,,,,,,05/11/2018,05/11/2018,0.00,,183.05,,"-1,135,253.54"
,IN,AR,30330967,1005,100,,Invoice,,,,,,05/11/2018,05/11/2018,0.00,,132.20,,"-1,135,385.74"
,IN,AR,30330968,1005,100,,Invoice,,,,,,05/11/2018,05/11/2018,0.00,,50.85,,"-1,135,436.59"
,IN,AR,30330979,1005,100,,Invoice,,,,,,05/11/2018,05/11/2018,0.00,,8.47,,"-1,135,445.06"
,IN,AR,30330982,1005,100,,Invoice,,,,,,05/11/2018,05/11/2018,0.00,,20.68,,"-1,135,465.74"
,IN,AR,30330993,1005,100,,Invoice,,,,,,05/11/2018,05/11/2018,0.00,,8.90,,"-1,135,474.64"
,IN,AR,30330995,1005,100,,Invoice,,,,,,05/11/2018,05/11/2018,0.00,,2.58,,"-1,135,477.22"
,IN,AR,30330998,1005,100,,Invoice,,,,,,05/11/2018,05/11/2018,0.00,,7.29,,"-1,135,484.51"
,IN,AR,30331013,1005,100,,Invoice,,,,,,05/11/2018,05/11/2018,0.00,,84.08,,"-1,135,568.59"
,IN,AR,30331020,1005,100,,Invoice,,,,,,05/11/2018,05/11/2018,0.00,,157.63,,"-1,135,726.22"
,IN,AR,30331021,1005,100,,Invoice,,,,,,05/11/2018,05/11/2018,0.00,,50.85,,"-1,135,777.07"
,IN,AR,30331028,1005,100,,Invoice,,,,,,05/11/2018,05/11/2018,0.00,,9.56,,"-1,135,786.63"
,IN,AR,30331029,1005,100,,Invoice,,,,,,05/11/2018,05/11/2018,0.00,,26.29,,"-1,135,812.92"
,IN,AR,30331033,1005,100,,Invoice,,,,,,05/11/2018,05/11/2018,0.00,,19.32,,"-1,135,832.24"
,IN,AR,30331037,1005,100,,Invoice,,,,,,05/11/2018,05/11/2018,0.00,,12.03,,"-1,135,844.27"
,IN,AR,30331043,1005,100,,Invoice,,,,,,05/11/2018,05/11/2018,0.00,,1.95,,"-1,135,846.22"
,IN,AR,30331044,1005,100,,Invoice,,,,,,05/11/2018,05/11/2018,0.00,,8.26,,"-1,135,854.48"
,IN,AR,30331048,1005,100,,Invoice,,,,,,05/11/2018,05/11/2018,0.00,,6.02,,"-1,135,860.50"
,IN,AR,30331050,1005,100,,Invoice,,,,,,05/11/2018,05/11/2018,0.00,,5.76,,"-1,135,866.26"
,IN,AR,30331059,1005,100,,Invoice,,,,,,05/11/2018,05/11/2018,0.00,,10.17,,"-1,135,876.43"
,IN,AR,30331076,1005,100,,Invoice,,,,,,05/11/2018,05/11/2018,0.00,,10.93,,"-1,135,887.36"
,IN,AR,30331084,1005,100,,Invoice,,,,,,05/11/2018,05/11/2018,0.00,,9.56,,"-1,135,896.92"
,IN,AR,30331092,1005,100,,Invoice,,,,,,05/11/2018,05/11/2018,0.00,,22.88,,"-1,135,919.80"
,IN,AR,30331106,1005,100,,Invoice,,,,,,05/11/2018,05/11/2018,0.00,,10.93,,"-1,135,930.73"
,IN,AR,30331112,1005,100,,Invoice,,,,,,05/11/2018,05/11/2018,0.00,,3.64,,"-1,135,934.37"
,IN,AR,30331115,1005,100,,Invoice,,,,,,05/11/2018,05/11/2018,0.00,,10.93,,"-1,135,945.30"
,IN,AR,30331118,1005,100,,Invoice,,,,,,05/11/2018,05/11/2018,0.00,,2.12,,"-1,135,947.42"
,IN,AR,30331126,1005,100,,Invoice,,,,,,05/11/2018,05/11/2018,0.00,,5.51,,"-1,135,952.93"
,IN,AR,30331127,1005,100,,Invoice,,,,,,05/11/2018,05/11/2018,0.00,,7.29,,"-1,135,960.22"
,IN,AR,30331132,1005,100,,Invoice,,,,,,05/11/2018,05/11/2018,0.00,,8.17,,"-1,135,968.39"
,IN,AR,30331135,1005,100,,Invoice,,,,,,05/11/2018,05/11/2018,0.00,,4.59,,"-1,135,972.98"
,IN,AR,30331138,1005,100,,Invoice,,,,,,05/11/2018,05/11/2018,0.00,,11.22,,"-1,135,984.20"
,IN,AR,30331142,1005,100,,Invoice,,,,,,05/11/2018,05/11/2018,0.00,,10.51,,"-1,135,994.71"
,IN,AR,30331157,1005,100,,Invoice,,,,,,05/11/2018,05/11/2018,0.00,,2.92,,"-1,135,997.63"
,IN,AR,30331162,1005,100,,Invoice,,,,,,05/11/2018,05/11/2018,0.00,,6.36,,"-1,136,003.99"
,IN,AR,30331164,1005,100,,Invoice,,,,,,05/11/2018,05/11/2018,0.00,,31.73,,"-1,136,035.72"
,IN,AR,30331169,1005,100,,Invoice,,,,,,05/11/2018,05/11/2018,0.00,,22.00,,"-1,136,057.72"
,IN,AR,30331191,1005,100,,Invoice,,,,,,05/11/2018,05/11/2018,0.00,,39.40,,"-1,136,097.12"
,IN,AR,30331196,1005,100,,Invoice,,,,,,05/11/2018,05/11/2018,0.00,,4.49,,"-1,136,101.61"
,IN,AR,30331205,1005,100,,Invoice,,,,,,05/11/2018,05/11/2018,0.00,,5.49,,"-1,136,107.10"
,IN,AR,30331227,1005,100,,Invoice,,,,,,05/11/2018,05/11/2018,0.00,,51.02,,"-1,136,158.12"
,IN,AR,30331232,1005,100,,Invoice,,,,,,05/11/2018,05/11/2018,0.00,,10.57,,"-1,136,168.69"
,IN,AR,30331251,1005,100,,Invoice,,,,,,05/11/2018,05/11/2018,0.00,,29.15,,"-1,136,197.84"
,IN,AR,30331268,1005,100,,Invoice,,,,,,05/11/2018,05/11/2018,0.00,,4.29,,"-1,136,202.13"
,IN,AR,30331296,1005,100,,Invoice,,,,,,05/11/2018,05/11/2018,0.00,,5.97,,"-1,136,208.10"
,IN,AR,30331316,1005,100,,Invoice,,,,,,05/11/2018,05/11/2018,0.00,,6.43,,"-1,136,214.53"
,IN,AR,30331324,1005,100,,Invoice,,,,,,05/11/2018,05/11/2018,0.00,,20.04,,"-1,136,234.57"
,IN,AR,30331350,1005,100,,Invoice,,,,,,05/11/2018,05/11/2018,0.00,,31.53,,"-1,136,266.10"
,IN,AR,30331353,1005,100,,Invoice,,,,,,05/11/2018,05/11/2018,0.00,,4.58,,"-1,136,270.68"
,IN,AR,30331377,1005,100,,Invoice,,,,,,05/11/2018,05/11/2018,0.00,,12.00,,"-1,136,282.68"
,IN,AR,30331396,1005,100,,Invoice,,,,,,05/11/2018,05/11/2018,0.00,,6.07,,"-1,136,288.75"
,IN,AR,30331399,1005,100,,Invoice,,,,,,05/11/2018,05/11/2018,0.00,,66.37,,"-1,136,355.12"
,IN,AR,30331404,1005,100,,Invoice,,,,,,05/11/2018,05/11/2018,0.00,,32.80,,"-1,136,387.92"
,IN,AR,30331412,1005,100,,Invoice,,,,,,05/11/2018,05/11/2018,0.00,,8.41,,"-1,136,396.33"
,IN,AR,30331421,1005,100,,Invoice,,,,,,05/11/2018,05/11/2018,0.00,,14.58,,"-1,136,410.91"
,IN,AR,30331425,1005,100,,Invoice,,,,,,05/11/2018,05/11/2018,0.00,,11.66,,"-1,136,422.57"
,IN,AR,30331429,1005,100,,Invoice,,,,,,05/11/2018,05/11/2018,0.00,,31.41,,"-1,136,453.98"
,IN,AR,30331431,1005,100,,Invoice,,,,,,05/11/2018,05/11/2018,0.00,,170.13,,"-1,136,624.11"
,IN,AR,30331434,1005,100,,Invoice,,,,,,05/11/2018,05/11/2018,0.00,,19.64,,"-1,136,643.75"
,IN,AR,30331436,1005,100,,Invoice,,,,,,05/11/2018,05/11/2018,0.00,,17.80,,"-1,136,661.55"
,IN,AR,30331475,1005,100,,Invoice,,,,,,05/11/2018,05/11/2018,0.00,,20.41,,"-1,136,681.96"
,IN,AR,30331476,1005,100,,Invoice,,,,,,05/11/2018,05/11/2018,0.00,,26.69,,"-1,136,708.65"
,IN,AR,30331495,1005,100,,Invoice,,,,,,05/11/2018,05/11/2018,0.00,,10.93,,"-1,136,719.58"
,IN,AR,30331520,1005,100,,Invoice,,,,,,05/11/2018,05/11/2018,0.00,,10.00,,"-1,136,729.58"
,IN,AR,30331523,1005,100,,Invoice,,,,,,05/11/2018,05/11/2018,0.00,,3.76,,"-1,136,733.34"
,IN,AR,30331528,1005,100,,Invoice,,,,,,05/11/2018,05/11/2018,0.00,,8.26,,"-1,136,741.60"
,IN,AR,30331547,1005,100,,Invoice,,,,,,05/11/2018,05/11/2018,0.00,,10.95,,"-1,136,752.55"
,IN,AR,30331561,1005,100,,Invoice,,,,,,05/11/2018,05/11/2018,0.00,,21.86,,"-1,136,774.41"
,IN,AR,30331572,1005,100,,Invoice,,,,,,05/11/2018,05/11/2018,0.00,,6.13,,"-1,136,780.54"
,IN,AR,30331591,1005,100,,Invoice,,,,,,05/11/2018,05/11/2018,0.00,,40.93,,"-1,136,821.47"
,IN,AR,30331598,1005,100,,Invoice,,,,,,05/11/2018,05/11/2018,0.00,,2.00,,"-1,136,823.47"
,IN,AR,30331599,1005,100,,Invoice,,,,,,05/11/2018,05/11/2018,0.00,,2.00,,"-1,136,825.47"
,IN,AR,30331607,1005,100,,Invoice,,,,,,05/11/2018,05/11/2018,0.00,,2.08,,"-1,136,827.55"
,IN,AR,30331608,1005,100,,Invoice,,,,,,05/11/2018,05/11/2018,0.00,,20.76,,"-1,136,848.31"
,IN,AR,30331609,1005,100,,Invoice,,,,,,05/11/2018,05/11/2018,0.00,,8.31,,"-1,136,856.62"
,IN,AR,30331610,1005,100,,Invoice,,,,,,05/11/2018,05/11/2018,0.00,,4.15,,"-1,136,860.77"
,IN,AR,30331611,1005,100,,Invoice,,,,,,05/11/2018,05/11/2018,0.00,,4.15,,"-1,136,864.92"
,IN,AR,30331612,1005,100,,Invoice,,,,,,05/11/2018,05/11/2018,0.00,,2.08,,"-1,136,867.00"
,IN,AR,30331625,1005,100,,Invoice,,,,,,05/11/2018,05/11/2018,0.00,,6.56,,"-1,136,873.56"
,IN,AR,30331631,1005,100,,Invoice,,,,,,05/11/2018,05/11/2018,0.00,,11.65,,"-1,136,885.21"
,IN,AR,30331643,1005,100,,Invoice,,,,,,05/11/2018,05/11/2018,0.00,,29.15,,"-1,136,914.36"
,IN,AR,30331647,1005,100,,Invoice,,,,,,05/11/2018,05/11/2018,0.00,,29.15,,"-1,136,943.51"
,IN,AR,30331648,1005,100,,Invoice,,,,,,05/11/2018,05/11/2018,0.00,,3.51,,"-1,136,947.02"
,IN,AR,30331656,1005,100,,Invoice,,,,,,05/11/2018,05/11/2018,0.00,,27.33,,"-1,136,974.35"
,IN,AR,30331670,1005,100,,Invoice,,,,,,05/11/2018,05/11/2018,0.00,,69.71,,"-1,137,044.06"
,IN,AR,30331686,1005,100,,Invoice,,,,,,05/11/2018,05/11/2018,0.00,,29.15,,"-1,137,073.21"
,IN,AR,30331710,1005,100,,Invoice,,,,,,05/11/2018,05/11/2018,0.00,,10.93,,"-1,137,084.14"
,IN,AR,30331711,1005,100,,Invoice,,,,,,05/11/2018,05/11/2018,0.00,,7.29,,"-1,137,091.43"
,IN,AR,30331713,1005,100,,Invoice,,,,,,05/11/2018,05/11/2018,0.00,,10.93,,"-1,137,102.36"
,IN,AR,30331714,1005,100,,Invoice,,,,,,05/11/2018,05/11/2018,0.00,,455.51,,"-1,137,557.87"
,CN,AR,31019451,1005,100,,Credit Note,,,,,,06/11/2018,06/11/2018,11.26,,0.00,,"-1,137,546.61"
,CS,AR,32010653,1005,100,,Cash sale,,,,,,06/11/2018,06/11/2018,0.00,,3.64,,"-1,137,550.25"
,CS,AR,32010654,1005,100,,Cash sale,,,,,,06/11/2018,06/11/2018,0.00,,2.81,,"-1,137,553.06"
,CS,AR,32010656,1005,100,,Cash sale,,,,,,06/11/2018,06/11/2018,0.00,,7.29,,"-1,137,560.35"
,CS,AR,32010657,1005,100,,Cash sale,,,,,,06/11/2018,06/11/2018,0.00,,7.29,,"-1,137,567.64"
,CS,AR,32010658,1005,100,,Cash sale,,,,,,06/11/2018,06/11/2018,0.00,,3.64,,"-1,137,571.28"
,CS,AR,32010659,1005,100,,Cash sale,,,,,,06/11/2018,06/11/2018,0.00,,7.29,,"-1,137,578.57"
,CS,AR,32010665,1005,100,,Cash sale,,,,,,06/11/2018,06/11/2018,0.00,,7.29,,"-1,137,585.86"
,CS,AR,32010670,1005,100,,Cash sale,,,,,,06/11/2018,06/11/2018,0.00,,10.93,,"-1,137,596.79"
,CS,AR,32010676,1005,100,,Cash sale,,,,,,06/11/2018,06/11/2018,0.00,,3.01,,"-1,137,599.80"
,CS,AR,32010678,1005,100,,Cash sale,,,,,,06/11/2018,06/11/2018,0.00,,10.93,,"-1,137,610.73"
,CS,AR,32010701,1005,100,,Cash sale,,,,,,06/11/2018,06/11/2018,0.00,,14.58,,"-1,137,625.31"
,CS,AR,32010702,1005,100,,Cash sale,,,,,,06/11/2018,06/11/2018,0.00,,12.92,,"-1,137,638.23"
,CS,AR,32010714,1005,100,,Cash sale,,,,,,06/11/2018,06/11/2018,0.00,,18.22,,"-1,137,656.45"
,CS,AR,32010721,1005,100,,Cash sale,,,,,,06/11/2018,06/11/2018,0.00,,10.93,,"-1,137,667.38"
,CS,AR,32010722,1005,100,,Cash sale,,,,,,06/11/2018,06/11/2018,0.00,,2.16,,"-1,137,669.54"
,CS,AR,32010733,1005,100,,Cash sale,,,,,,06/11/2018,06/11/2018,0.00,,1.95,,"-1,137,671.49"
,CS,AR,32010769,1005,100,,Cash sale,,,,,,06/11/2018,06/11/2018,0.00,,5.85,,"-1,137,677.34"
,CS,AR,32010779,1005,100,,Cash sale,,,,,,06/11/2018,06/11/2018,0.00,,5.85,,"-1,137,683.19"
,CS,AR,32010784,1005,100,,Cash sale,,,,,,06/11/2018,06/11/2018,0.00,,7.29,,"-1,137,690.48"
,CS,AR,32010785,1005,100,,Cash sale,,,,,,06/11/2018,06/11/2018,0.00,,2.39,,"-1,137,692.87"
,CS,AR,32010788,1005,100,,Cash sale,,,,,,06/11/2018,06/11/2018,0.00,,7.29,,"-1,137,700.16"
,CS,AR,32010794,1005,100,,Cash sale,,,,,,06/11/2018,06/11/2018,0.00,,7.75,,"-1,137,707.91"
,CS,AR,32010803,1005,100,,Cash sale,,,,,,06/11/2018,06/11/2018,0.00,,12.92,,"-1,137,720.83"
,CS,AR,32010804,1005,100,,Cash sale,,,,,,06/11/2018,06/11/2018,0.00,,11.69,,"-1,137,732.52"
,CS,AR,32010805,1005,100,,Cash sale,,,,,,06/11/2018,06/11/2018,0.00,,7.29,,"-1,137,739.81"
,CS,AR,32010809,1005,100,,Cash sale,,,,,,06/11/2018,06/11/2018,0.00,,3.64,,"-1,137,743.45"
,CS,AR,32010836,1005,100,,Cash sale,,,,,,06/11/2018,06/11/2018,0.00,,10.34,,"-1,137,753.79"
,CS,AR,32010837,1005,100,,Cash sale,,,,,,06/11/2018,06/11/2018,0.00,,3.64,,"-1,137,757.43"
,CS,AR,32010852,1005,100,,Cash sale,,,,,,06/11/2018,06/11/2018,0.00,,21.86,,"-1,137,779.29"
,CS,AR,32010870,1005,100,,Cash sale,,,,,,06/11/2018,06/11/2018,0.00,,5.17,,"-1,137,784.46"
,CS,AR,32010877,1005,100,,Cash sale,,,,,,06/11/2018,06/11/2018,0.00,,30.51,,"-1,137,814.97"
,CS,AR,32010878,1005,100,,Cash sale,,,,,,06/11/2018,06/11/2018,0.00,,34.00,,"-1,137,848.97"
,CS,AR,32010893,1005,100,,Cash sale,,,,,,06/11/2018,06/11/2018,0.00,,10.93,,"-1,137,859.90"
,CS,AR,32010914,1005,100,,Cash sale,,,,,,06/11/2018,06/11/2018,0.00,,5.50,,"-1,137,865.40"
,CS,AR,32010925,1005,100,,Cash sale,,,,,,06/11/2018,06/11/2018,0.00,,5.47,,"-1,137,870.87"
,CS,AR,32010949,1005,100,,Cash sale,,,,,,06/11/2018,06/11/2018,0.00,,10.93,,"-1,137,881.80"
,CS,AR,32010988,1005,100,,Cash sale,,,,,,06/11/2018,06/11/2018,0.00,,6.19,,"-1,137,887.99"
,CS,AR,32010992,1005,100,,Cash sale,,,,,,06/11/2018,06/11/2018,0.00,,7.29,,"-1,137,895.28"
,CS,AR,32010995,1005,100,,Cash sale,,,,,,06/11/2018,06/11/2018,0.00,,3.64,,"-1,137,898.92"
,CS,AR,32011006,1005,100,,Cash sale,,,,,,06/11/2018,06/11/2018,0.00,,14.58,,"-1,137,913.50"
,CS,AR,32011016,1005,100,,Cash sale,,,,,,06/11/2018,06/11/2018,0.00,,18.22,,"-1,137,931.72"
,IN,AR,30330725,1005,100,,Invoice,,,,,,06/11/2018,06/11/2018,0.00,,3.01,,"-1,137,934.73"
,IN,AR,30330729,1005,100,,Invoice,,,,,,06/11/2018,06/11/2018,0.00,,"1,093.22",,"-1,139,027.95"
,IN,AR,30330733,1005,100,,Invoice,,,,,,06/11/2018,06/11/2018,0.00,,50.42,,"-1,139,078.37"
,IN,AR,30330786,1005,100,,Invoice,,,,,,06/11/2018,06/11/2018,0.00,,7.00,,"-1,139,085.37"
,IN,AR,30330793,1005,100,,Invoice,,,,,,06/11/2018,06/11/2018,0.00,,3.64,,"-1,139,089.01"
,IN,AR,30330807,1005,100,,Invoice,,,,,,06/11/2018,06/11/2018,0.00,,3.98,,"-1,139,092.99"
,IN,AR,30330813,1005,100,,Invoice,,,,,,06/11/2018,06/11/2018,0.00,,34.00,,"-1,139,126.99"
,IN,AR,30330826,1005,100,,Invoice,,,,,,06/11/2018,06/11/2018,0.00,,3.64,,"-1,139,130.63"
,IN,AR,30330827,1005,100,,Invoice,,,,,,06/11/2018,06/11/2018,0.00,,7.29,,"-1,139,137.92"
,IN,AR,30330863,1005,100,,Invoice,,,,,,06/11/2018,06/11/2018,0.00,,182.20,,"-1,139,320.12"
,IN,AR,30330877,1005,100,,Invoice,,,,,,06/11/2018,06/11/2018,0.00,,3.64,,"-1,139,323.76"
,IN,AR,30330883,1005,100,,Invoice,,,,,,06/11/2018,06/11/2018,0.00,,"1,093.22",,"-1,140,416.98"
,IN,AR,30330905,1005,100,,Invoice,,,,,,06/11/2018,06/11/2018,0.00,,100.37,,"-1,140,517.35"
,IN,AR,30330914,1005,100,,Invoice,,,,,,06/11/2018,06/11/2018,0.00,,24.73,,"-1,140,542.08"
,IN,AR,30330939,1005,100,,Invoice,,,,,,06/11/2018,06/11/2018,0.00,,54.66,,"-1,140,596.74"
,IN,AR,30330941,1005,100,,Invoice,,,,,,06/11/2018,06/11/2018,0.00,,11.61,,"-1,140,608.35"
,IN,AR,30330944,1005,100,,Invoice,,,,,,06/11/2018,06/11/2018,0.00,,29.15,,"-1,140,637.50"
,IN,AR,30330959,1005,100,,Invoice,,,,,,06/11/2018,06/11/2018,0.00,,12.71,,"-1,140,650.21"
,IN,AR,30330963,1005,100,,Invoice,,,,,,06/11/2018,06/11/2018,0.00,,7.29,,"-1,140,657.50"
,IN,AR,30330974,1005,100,,Invoice,,,,,,06/11/2018,06/11/2018,0.00,,29.15,,"-1,140,686.65"
,IN,AR,30330975,1005,100,,Invoice,,,,,,06/11/2018,06/11/2018,0.00,,6.36,,"-1,140,693.01"
,IN,AR,30330987,1005,100,,Invoice,,,,,,06/11/2018,06/11/2018,0.00,,364.41,,"-1,141,057.42"
,IN,AR,30331001,1005,100,,Invoice,,,,,,06/11/2018,06/11/2018,0.00,,2.84,,"-1,141,060.26"
,IN,AR,30331003,1005,100,,Invoice,,,,,,06/11/2018,06/11/2018,0.00,,9.03,,"-1,141,069.29"
,IN,AR,30331009,1005,100,,Invoice,,,,,,06/11/2018,06/11/2018,0.00,,3.90,,"-1,141,073.19"
,IN,AR,30331026,1005,100,,Invoice,,,,,,06/11/2018,06/11/2018,0.00,,10.93,,"-1,141,084.12"
,IN,AR,30331077,1005,100,,Invoice,,,,,,06/11/2018,06/11/2018,0.00,,10.81,,"-1,141,094.93"
,IN,AR,30331083,1005,100,,Invoice,,,,,,06/11/2018,06/11/2018,0.00,,3.64,,"-1,141,098.57"
,IN,AR,30331089,1005,100,,Invoice,,,,,,06/11/2018,06/11/2018,0.00,,26.69,,"-1,141,125.26"
,IN,AR,30331099,1005,100,,Invoice,,,,,,06/11/2018,06/11/2018,0.00,,3.01,,"-1,141,128.27"
,IN,AR,30331104,1005,100,,Invoice,,,,,,06/11/2018,06/11/2018,0.00,,11.57,,"-1,141,139.84"
,IN,AR,30331107,1005,100,,Invoice,,,,,,06/11/2018,06/11/2018,0.00,,10.93,,"-1,141,150.77"
,IN,AR,30331108,1005,100,,Invoice,,,,,,06/11/2018,06/11/2018,0.00,,12.71,,"-1,141,163.48"
,IN,AR,30331109,1005,100,,Invoice,,,,,,06/11/2018,06/11/2018,0.00,,3.90,,"-1,141,167.38"
,IN,AR,30331110,1005,100,,Invoice,,,,,,06/11/2018,06/11/2018,0.00,,14.03,,"-1,141,181.41"
,IN,AR,30331119,1005,100,,Invoice,,,,,,06/11/2018,06/11/2018,0.00,,12.71,,"-1,141,194.12"
,IN,AR,30331125,1005,100,,Invoice,,,,,,06/11/2018,06/11/2018,0.00,,2.12,,"-1,141,196.24"
,IN,AR,30331129,1005,100,,Invoice,,,,,,06/11/2018,06/11/2018,0.00,,3.64,,"-1,141,199.88"
,IN,AR,30331141,1005,100,,Invoice,,,,,,06/11/2018,06/11/2018,0.00,,16.95,,"-1,141,216.83"
,IN,AR,30331158,1005,100,,Invoice,,,,,,06/11/2018,06/11/2018,0.00,,5.85,,"-1,141,222.68"
,IN,AR,30331172,1005,100,,Invoice,,,,,,06/11/2018,06/11/2018,0.00,,17.54,,"-1,141,240.22"
,IN,AR,30331178,1005,100,,Invoice,,,,,,06/11/2018,06/11/2018,0.00,,10.93,,"-1,141,251.15"
,IN,AR,30331182,1005,100,,Invoice,,,,,,06/11/2018,06/11/2018,0.00,,8.39,,"-1,141,259.54"
,IN,AR,30331185,1005,100,,Invoice,,,,,,06/11/2018,06/11/2018,0.00,,5.17,,"-1,141,264.71"
,IN,AR,30331187,1005,100,,Invoice,,,,,,06/11/2018,06/11/2018,0.00,,5.86,,"-1,141,270.57"
,IN,AR,30331214,1005,100,,Invoice,,,,,,06/11/2018,06/11/2018,0.00,,7.29,,"-1,141,277.86"
,IN,AR,30331217,1005,100,,Invoice,,,,,,06/11/2018,06/11/2018,0.00,,21.44,,"-1,141,299.30"
,IN,AR,30331223,1005,100,,Invoice,,,,,,06/11/2018,06/11/2018,0.00,,1.88,,"-1,141,301.18"
,IN,AR,30331224,1005,100,,Invoice,,,,,,06/11/2018,06/11/2018,0.00,,32.16,,"-1,141,333.34"
,IN,AR,30331229,1005,100,,Invoice,,,,,,06/11/2018,06/11/2018,0.00,,54.66,,"-1,141,388.00"
,IN,AR,30331233,1005,100,,Invoice,,,,,,06/11/2018,06/11/2018,0.00,,5.29,,"-1,141,393.29"
,IN,AR,30331250,1005,100,,Invoice,,,,,,06/11/2018,06/11/2018,0.00,,2.58,,"-1,141,395.87"
,IN,AR,30331253,1005,100,,Invoice,,,,,,06/11/2018,06/11/2018,0.00,,19.16,,"-1,141,415.03"
,IN,AR,30331262,1005,100,,Invoice,,,,,,06/11/2018,06/11/2018,0.00,,54.66,,"-1,141,469.69"
,IN,AR,30331275,1005,100,,Invoice,,,,,,06/11/2018,06/11/2018,0.00,,11.25,,"-1,141,480.94"
,IN,AR,30331297,1005,100,,Invoice,,,,,,06/11/2018,06/11/2018,0.00,,222.86,,"-1,141,703.80"
,IN,AR,30331298,1005,100,,Invoice,,,,,,06/11/2018,06/11/2018,0.00,,93.53,,"-1,141,797.33"
,IN,AR,30331299,1005,100,,Invoice,,,,,,06/11/2018,06/11/2018,0.00,,5.97,,"-1,141,803.30"
,IN,AR,30331300,1005,100,,Invoice,,,,,,06/11/2018,06/11/2018,0.00,,3.98,,"-1,141,807.28"
,IN,AR,30331301,1005,100,,Invoice,,,,,,06/11/2018,06/11/2018,0.00,,13.93,,"-1,141,821.21"
,IN,AR,30331308,1005,100,,Invoice,,,,,,06/11/2018,06/11/2018,0.00,,39.75,,"-1,141,860.96"
,IN,AR,30331336,1005,100,,Invoice,,,,,,06/11/2018,06/11/2018,0.00,,6.02,,"-1,141,866.98"
,IN,AR,30331342,1005,100,,Invoice,,,,,,06/11/2018,06/11/2018,0.00,,198.97,,"-1,142,065.95"
,IN,AR,30331346,1005,100,,Invoice,,,,,,06/11/2018,06/11/2018,0.00,,54.66,,"-1,142,120.61"
,IN,AR,30331355,1005,100,,Invoice,,,,,,06/11/2018,06/11/2018,0.00,,29.15,,"-1,142,149.76"
,IN,AR,30331367,1005,100,,Invoice,,,,,,06/11/2018,06/11/2018,0.00,,7.29,,"-1,142,157.05"
,IN,AR,30331370,1005,100,,Invoice,,,,,,06/11/2018,06/11/2018,0.00,,2.54,,"-1,142,159.59"
,IN,AR,30331381,1005,100,,Invoice,,,,,,06/11/2018,06/11/2018,0.00,,16.01,,"-1,142,175.60"
,IN,AR,30331443,1005,100,,Invoice,,,,,,06/11/2018,06/11/2018,0.00,,134.00,,"-1,142,309.60"
,IN,AR,30331456,1005,100,,Invoice,,,,,,06/11/2018,06/11/2018,0.00,,37.97,,"-1,142,347.57"
,IN,AR,30331465,1005,100,,Invoice,,,,,,06/11/2018,06/11/2018,0.00,,7.29,,"-1,142,354.86"
,IN,AR,30331467,1005,100,,Invoice,,,,,,06/11/2018,06/11/2018,0.00,,29.15,,"-1,142,384.01"
,IN,AR,30331494,1005,100,,Invoice,,,,,,06/11/2018,06/11/2018,0.00,,108.47,,"-1,142,492.48"
,IN,AR,30331496,1005,100,,Invoice,,,,,,06/11/2018,06/11/2018,0.00,,28.47,,"-1,142,520.95"
,IN,AR,30331497,1005,100,,Invoice,,,,,,06/11/2018,06/11/2018,0.00,,102.04,,"-1,142,622.99"
,IN,AR,30331498,1005,100,,Invoice,,,,,,06/11/2018,06/11/2018,0.00,,9.49,,"-1,142,632.48"
,IN,AR,30331506,1005,100,,Invoice,,,,,,06/11/2018,06/11/2018,0.00,,14.24,,"-1,142,646.72"
,IN,AR,30331527,1005,100,,Invoice,,,,,,06/11/2018,06/11/2018,0.00,,3.51,,"-1,142,650.23"
,IN,AR,30331529,1005,100,,Invoice,,,,,,06/11/2018,06/11/2018,0.00,,8.00,,"-1,142,658.23"
,IN,AR,30331531,1005,100,,Invoice,,,,,,06/11/2018,06/11/2018,0.00,,11.86,,"-1,142,670.09"
,IN,AR,30331534,1005,100,,Invoice,,,,,,06/11/2018,06/11/2018,0.00,,29.15,,"-1,142,699.24"
,IN,AR,30331536,1005,100,,Invoice,,,,,,06/11/2018,06/11/2018,0.00,,82.69,,"-1,142,781.93"
,IN,AR,30331540,1005,100,,Invoice,,,,,,06/11/2018,06/11/2018,0.00,,10.93,,"-1,142,792.86"
,IN,AR,30331541,1005,100,,Invoice,,,,,,06/11/2018,06/11/2018,0.00,,7.02,,"-1,142,799.88"
,IN,AR,30331550,1005,100,,Invoice,,,,,,06/11/2018,06/11/2018,0.00,,182.20,,"-1,142,982.08"
,IN,AR,30331554,1005,100,,Invoice,,,,,,06/11/2018,06/11/2018,0.00,,8.75,,"-1,142,990.83"
,IN,AR,30331573,1005,100,,Invoice,,,,,,06/11/2018,06/11/2018,0.00,,36.76,,"-1,143,027.59"
,IN,AR,30331579,1005,100,,Invoice,,,,,,06/11/2018,06/11/2018,0.00,,54.66,,"-1,143,082.25"
,IN,AR,30331583,1005,100,,Invoice,,,,,,06/11/2018,06/11/2018,0.00,,10.93,,"-1,143,093.18"
,IN,AR,30331586,1005,100,,Invoice,,,,,,06/11/2018,06/11/2018,0.00,,8.39,,"-1,143,101.57"
,IN,AR,30331589,1005,100,,Invoice,,,,,,06/11/2018,06/11/2018,0.00,,7.97,,"-1,143,109.54"
,IN,AR,30331597,1005,100,,Invoice,,,,,,06/11/2018,06/11/2018,0.00,,29.15,,"-1,143,138.69"
,IN,AR,30331600,1005,100,,Invoice,,,,,,06/11/2018,06/11/2018,0.00,,54.66,,"-1,143,193.35"
,IN,AR,30331613,1005,100,,Invoice,,,,,,06/11/2018,06/11/2018,0.00,,4.15,,"-1,143,197.50"
,IN,AR,30331614,1005,100,,Invoice,,,,,,06/11/2018,06/11/2018,0.00,,16.61,,"-1,143,214.11"
,IN,AR,30331624,1005,100,,Invoice,,,,,,06/11/2018,06/11/2018,0.00,,30.51,,"-1,143,244.62"
,IN,AR,30331627,1005,100,,Invoice,,,,,,06/11/2018,06/11/2018,0.00,,16.91,,"-1,143,261.53"
,IN,AR,30331640,1005,100,,Invoice,,,,,,06/11/2018,06/11/2018,0.00,,18.22,,"-1,143,279.75"
,IN,AR,30331641,1005,100,,Invoice,,,,,,06/11/2018,06/11/2018,0.00,,12.71,,"-1,143,292.46"
,IN,AR,30331642,1005,100,,Invoice,,,,,,06/11/2018,06/11/2018,0.00,,10.17,,"-1,143,302.63"
,IN,AR,30331665,1005,100,,Invoice,,,,,,06/11/2018,06/11/2018,0.00,,136.53,,"-1,143,439.16"
,IN,AR,30331668,1005,100,,Invoice,,,,,,06/11/2018,06/11/2018,0.00,,5.93,,"-1,143,445.09"
,IN,AR,30331669,1005,100,,Invoice,,,,,,06/11/2018,06/11/2018,0.00,,2.97,,"-1,143,448.06"
,IN,AR,30331673,1005,100,,Invoice,,,,,,06/11/2018,06/11/2018,0.00,,7.29,,"-1,143,455.35"
,IN,AR,30331676,1005,100,,Invoice,,,,,,06/11/2018,06/11/2018,0.00,,9.10,,"-1,143,464.45"
,IN,AR,30331682,1005,100,,Invoice,,,,,,06/11/2018,06/11/2018,0.00,,10.93,,"-1,143,475.38"
,IN,AR,30331699,1005,100,,Invoice,,,,,,06/11/2018,06/11/2018,0.00,,8.21,,"-1,143,483.59"
,IN,AR,30331706,1005,100,,Invoice,,,,,,06/11/2018,06/11/2018,0.00,,7.29,,"-1,143,490.88"
,IN,AR,30331716,1005,100,,Invoice,,,,,,06/11/2018,06/11/2018,0.00,,10.93,,"-1,143,501.81"
,IN,AR,30331717,1005,100,,Invoice,,,,,,06/11/2018,06/11/2018,0.00,,182.20,,"-1,143,684.01"
,CS,AR,32010642,1005,100,,Cash sale,,,,,,07/11/2018,07/11/2018,0.00,,8.42,,"-1,143,692.43"
,CS,AR,32010646,1005,100,,Cash sale,,,,,,07/11/2018,07/11/2018,0.00,,32.61,,"-1,143,725.04"
,CS,AR,32010660,1005,100,,Cash sale,,,,,,07/11/2018,07/11/2018,0.00,,3.64,,"-1,143,728.68"
,CS,AR,32010669,1005,100,,Cash sale,,,,,,07/11/2018,07/11/2018,0.00,,3.64,,"-1,143,732.32"
,CS,AR,32010679,1005,100,,Cash sale,,,,,,07/11/2018,07/11/2018,0.00,,3.64,,"-1,143,735.96"
,CS,AR,32010690,1005,100,,Cash sale,,,,,,07/11/2018,07/11/2018,0.00,,9.03,,"-1,143,744.99"
,CS,AR,32010709,1005,100,,Cash sale,,,,,,07/11/2018,07/11/2018,0.00,,5.86,,"-1,143,750.85"
,CS,AR,32010737,1005,100,,Cash sale,,,,,,07/11/2018,07/11/2018,0.00,,10.34,,"-1,143,761.19"
,CS,AR,32010740,1005,100,,Cash sale,,,,,,07/11/2018,07/11/2018,0.00,,41.36,,"-1,143,802.55"
,CS,AR,32010745,1005,100,,Cash sale,,,,,,07/11/2018,07/11/2018,0.00,,27.08,,"-1,143,829.63"
,CS,AR,32010746,1005,100,,Cash sale,,,,,,07/11/2018,07/11/2018,0.00,,10.72,,"-1,143,840.35"
,CS,AR,32010752,1005,100,,Cash sale,,,,,,07/11/2018,07/11/2018,0.00,,18.22,,"-1,143,858.57"
,CS,AR,32010756,1005,100,,Cash sale,,,,,,07/11/2018,07/11/2018,0.00,,21.06,,"-1,143,879.63"
,CS,AR,32010757,1005,100,,Cash sale,,,,,,07/11/2018,07/11/2018,0.00,,7.63,,"-1,143,887.26"
,CS,AR,32010780,1005,100,,Cash sale,,,,,,07/11/2018,07/11/2018,0.00,,7.75,,"-1,143,895.01"
,CS,AR,32010792,1005,100,,Cash sale,,,,,,07/11/2018,07/11/2018,0.00,,10.93,,"-1,143,905.94"
,CS,AR,32010806,1005,100,,Cash sale,,,,,,07/11/2018,07/11/2018,0.00,,18.22,,"-1,143,924.16"
,CS,AR,32010810,1005,100,,Cash sale,,,,,,07/11/2018,07/11/2018,0.00,,29.15,,"-1,143,953.31"
,CS,AR,32010813,1005,100,,Cash sale,,,,,,07/11/2018,07/11/2018,0.00,,7.29,,"-1,143,960.60"
,CS,AR,32010858,1005,100,,Cash sale,,,,,,07/11/2018,07/11/2018,0.00,,21.36,,"-1,143,981.96"
,CS,AR,32010859,1005,100,,Cash sale,,,,,,07/11/2018,07/11/2018,0.00,,2.44,,"-1,143,984.40"
,CS,AR,32010868,1005,100,,Cash sale,,,,,,07/11/2018,07/11/2018,0.00,,10.93,,"-1,143,995.33"
,CS,AR,32010876,1005,100,,Cash sale,,,,,,07/11/2018,07/11/2018,0.00,,10.93,,"-1,144,006.26"
,CS,AR,32010882,1005,100,,Cash sale,,,,,,07/11/2018,07/11/2018,0.00,,3.64,,"-1,144,009.90"
,CS,AR,32010884,1005,100,,Cash sale,,,,,,07/11/2018,07/11/2018,0.00,,5.51,,"-1,144,015.41"
,CS,AR,32010886,1005,100,,Cash sale,,,,,,07/11/2018,07/11/2018,0.00,,6.07,,"-1,144,021.48"
,CS,AR,32010897,1005,100,,Cash sale,,,,,,07/11/2018,07/11/2018,0.00,,9.15,,"-1,144,030.63"
,CS,AR,32010900,1005,100,,Cash sale,,,,,,07/11/2018,07/11/2018,0.00,,25.51,,"-1,144,056.14"
,CS,AR,32010902,1005,100,,Cash sale,,,,,,07/11/2018,07/11/2018,0.00,,10.93,,"-1,144,067.07"
,CS,AR,32010903,1005,100,,Cash sale,,,,,,07/11/2018,07/11/2018,0.00,,14.58,,"-1,144,081.65"
,CS,AR,32010920,1005,100,,Cash sale,,,,,,07/11/2018,07/11/2018,0.00,,9.03,,"-1,144,090.68"
,CS,AR,32010921,1005,100,,Cash sale,,,,,,07/11/2018,07/11/2018,0.00,,25.51,,"-1,144,116.19"
,CS,AR,32010928,1005,100,,Cash sale,,,,,,07/11/2018,07/11/2018,0.00,,14.58,,"-1,144,130.77"
,CS,AR,32010941,1005,100,,Cash sale,,,,,,07/11/2018,07/11/2018,0.00,,7.29,,"-1,144,138.06"
,CS,AR,32010958,1005,100,,Cash sale,,,,,,07/11/2018,07/11/2018,0.00,,10.99,,"-1,144,149.05"
,CS,AR,32010961,1005,100,,Cash sale,,,,,,07/11/2018,07/11/2018,0.00,,3.64,,"-1,144,152.69"
,CS,AR,32010964,1005,100,,Cash sale,,,,,,07/11/2018,07/11/2018,0.00,,4.58,,"-1,144,157.27"
,CS,AR,32010996,1005,100,,Cash sale,,,,,,07/11/2018,07/11/2018,0.00,,7.29,,"-1,144,164.56"
,CS,AR,32011000,1005,100,,Cash sale,,,,,,07/11/2018,07/11/2018,0.00,,14.58,,"-1,144,179.14"
,CS,AR,32011017,1005,100,,Cash sale,,,,,,07/11/2018,07/11/2018,0.00,,3.64,,"-1,144,182.78"
,IN,AR,30330734,1005,100,,Invoice,,,,,,07/11/2018,07/11/2018,0.00,,47.46,,"-1,144,230.24"
,IN,AR,30330740,1005,100,,Invoice,,,,,,07/11/2018,07/11/2018,0.00,,7.29,,"-1,144,237.53"
,IN,AR,30330753,1005,100,,Invoice,,,,,,07/11/2018,07/11/2018,0.00,,17.08,,"-1,144,254.61"
,IN,AR,30330754,1005,100,,Invoice,,,,,,07/11/2018,07/11/2018,0.00,,73.22,,"-1,144,327.83"
,IN,AR,30330768,1005,100,,Invoice,,,,,,07/11/2018,07/11/2018,0.00,,7.29,,"-1,144,335.12"
,IN,AR,30330770,1005,100,,Invoice,,,,,,07/11/2018,07/11/2018,0.00,,31.86,,"-1,144,366.98"
,IN,AR,30330774,1005,100,,Invoice,,,,,,07/11/2018,07/11/2018,0.00,,28.90,,"-1,144,395.88"
,IN,AR,30330775,1005,100,,Invoice,,,,,,07/11/2018,07/11/2018,0.00,,86.69,,"-1,144,482.57"
,IN,AR,30330776,1005,100,,Invoice,,,,,,07/11/2018,07/11/2018,0.00,,7.29,,"-1,144,489.86"
,IN,AR,30330780,1005,100,,Invoice,,,,,,07/11/2018,07/11/2018,0.00,,9.66,,"-1,144,499.52"
,IN,AR,30330808,1005,100,,Invoice,,,,,,07/11/2018,07/11/2018,0.00,,3.98,,"-1,144,503.50"
,IN,AR,30330834,1005,100,,Invoice,,,,,,07/11/2018,07/11/2018,0.00,,3.64,,"-1,144,507.14"
,IN,AR,30330842,1005,100,,Invoice,,,,,,07/11/2018,07/11/2018,0.00,,40.00,,"-1,144,547.14"
,IN,AR,30330843,1005,100,,Invoice,,,,,,07/11/2018,07/11/2018,0.00,,20.00,,"-1,144,567.14"
,IN,AR,30330860,1005,100,,Invoice,,,,,,07/11/2018,07/11/2018,0.00,,32.00,,"-1,144,599.14"
,IN,AR,30330887,1005,100,,Invoice,,,,,,07/11/2018,07/11/2018,0.00,,49.12,,"-1,144,648.26"
,IN,AR,30330888,1005,100,,Invoice,,,,,,07/11/2018,07/11/2018,0.00,,19.10,,"-1,144,667.36"
,IN,AR,30330923,1005,100,,Invoice,,,,,,07/11/2018,07/11/2018,0.00,,21.22,,"-1,144,688.58"
,IN,AR,30330926,1005,100,,Invoice,,,,,,07/11/2018,07/11/2018,0.00,,14.58,,"-1,144,703.16"
,IN,AR,30330935,1005,100,,Invoice,,,,,,07/11/2018,07/11/2018,0.00,,10.50,,"-1,144,713.66"
,IN,AR,30330958,1005,100,,Invoice,,,,,,07/11/2018,07/11/2018,0.00,,22.88,,"-1,144,736.54"
,IN,AR,30330960,1005,100,,Invoice,,,,,,07/11/2018,07/11/2018,0.00,,4.24,,"-1,144,740.78"
,IN,AR,30330961,1005,100,,Invoice,,,,,,07/11/2018,07/11/2018,0.00,,2.12,,"-1,144,742.90"
,IN,AR,30330971,1005,100,,Invoice,,,,,,07/11/2018,07/11/2018,0.00,,2.12,,"-1,144,745.02"
,IN,AR,30330977,1005,100,,Invoice,,,,,,07/11/2018,07/11/2018,0.00,,5.59,,"-1,144,750.61"
,IN,AR,30330996,1005,100,,Invoice,,,,,,07/11/2018,07/11/2018,0.00,,11.95,,"-1,144,762.56"
,IN,AR,30330997,1005,100,,Invoice,,,,,,07/11/2018,07/11/2018,0.00,,14.58,,"-1,144,777.14"
,IN,AR,30331006,1005,100,,Invoice,,,,,,07/11/2018,07/11/2018,0.00,,33.46,,"-1,144,810.60"
,IN,AR,30331014,1005,100,,Invoice,,,,,,07/11/2018,07/11/2018,0.00,,47.17,,"-1,144,857.77"
,IN,AR,30331022,1005,100,,Invoice,,,,,,07/11/2018,07/11/2018,0.00,,129.66,,"-1,144,987.43"
,IN,AR,30331025,1005,100,,Invoice,,,,,,07/11/2018,07/11/2018,0.00,,32.80,,"-1,145,020.23"
,IN,AR,30331049,1005,100,,Invoice,,,,,,07/11/2018,07/11/2018,0.00,,186.06,,"-1,145,206.29"
,IN,AR,30331051,1005,100,,Invoice,,,,,,07/11/2018,07/11/2018,0.00,,5.08,,"-1,145,211.37"
,IN,AR,30331068,1005,100,,Invoice,,,,,,07/11/2018,07/11/2018,0.00,,3.19,,"-1,145,214.56"
,IN,AR,30331069,1005,100,,Invoice,,,,,,07/11/2018,07/11/2018,0.00,,23.91,,"-1,145,238.47"
,IN,AR,30331073,1005,100,,Invoice,,,,,,07/11/2018,07/11/2018,0.00,,12.71,,"-1,145,251.18"
,IN,AR,30331087,1005,100,,Invoice,,,,,,07/11/2018,07/11/2018,0.00,,2.58,,"-1,145,253.76"
,IN,AR,30331088,1005,100,,Invoice,,,,,,07/11/2018,07/11/2018,0.00,,18.17,,"-1,145,271.93"
,IN,AR,30331096,1005,100,,Invoice,,,,,,07/11/2018,07/11/2018,0.00,,11.70,,"-1,145,283.63"
,IN,AR,30331120,1005,100,,Invoice,,,,,,07/11/2018,07/11/2018,0.00,,6.36,,"-1,145,289.99"
,IN,AR,30331124,1005,100,,Invoice,,,,,,07/11/2018,07/11/2018,0.00,,14.58,,"-1,145,304.57"
,IN,AR,30331144,1005,100,,Invoice,,,,,,07/11/2018,07/11/2018,0.00,,20.76,,"-1,145,325.33"
,IN,AR,30331154,1005,100,,Invoice,,,,,,07/11/2018,07/11/2018,0.00,,3.76,,"-1,145,329.09"
,IN,AR,30331156,1005,100,,Invoice,,,,,,07/11/2018,07/11/2018,0.00,,5.17,,"-1,145,334.26"
,IN,AR,30331161,1005,100,,Invoice,,,,,,07/11/2018,07/11/2018,0.00,,18.22,,"-1,145,352.48"
,IN,AR,30331163,1005,100,,Invoice,,,,,,07/11/2018,07/11/2018,0.00,,30.76,,"-1,145,383.24"
,IN,AR,30331166,1005,100,,Invoice,,,,,,07/11/2018,07/11/2018,0.00,,7.29,,"-1,145,390.53"
,IN,AR,30331167,1005,100,,Invoice,,,,,,07/11/2018,07/11/2018,0.00,,10.17,,"-1,145,400.70"
,IN,AR,30331186,1005,100,,Invoice,,,,,,07/11/2018,07/11/2018,0.00,,5.17,,"-1,145,405.87"
,IN,AR,30331190,1005,100,,Invoice,,,,,,07/11/2018,07/11/2018,0.00,,22.27,,"-1,145,428.14"
,IN,AR,30331198,1005,100,,Invoice,,,,,,07/11/2018,07/11/2018,0.00,,24.07,,"-1,145,452.21"
,IN,AR,30331204,1005,100,,Invoice,,,,,,07/11/2018,07/11/2018,0.00,,29.15,,"-1,145,481.36"
,IN,AR,30331216,1005,100,,Invoice,,,,,,07/11/2018,07/11/2018,0.00,,36.91,,"-1,145,518.27"
,IN,AR,30331234,1005,100,,Invoice,,,,,,07/11/2018,07/11/2018,0.00,,1.76,,"-1,145,520.03"
,IN,AR,30331238,1005,100,,Invoice,,,,,,07/11/2018,07/11/2018,0.00,,12.03,,"-1,145,532.06"
,IN,AR,30331254,1005,100,,Invoice,,,,,,07/11/2018,07/11/2018,0.00,,7.75,,"-1,145,539.81"
,IN,AR,30331259,1005,100,,Invoice,,,,,,07/11/2018,07/11/2018,0.00,,14.00,,"-1,145,553.81"
,IN,AR,30331260,1005,100,,Invoice,,,,,,07/11/2018,07/11/2018,0.00,,32.80,,"-1,145,586.61"
,IN,AR,30331261,1005,100,,Invoice,,,,,,07/11/2018,07/11/2018,0.00,,21.86,,"-1,145,608.47"
,IN,AR,30331279,1005,100,,Invoice,,,,,,07/11/2018,07/11/2018,0.00,,17.80,,"-1,145,626.27"
,IN,AR,30331283,1005,100,,Invoice,,,,,,07/11/2018,07/11/2018,0.00,,3.64,,"-1,145,629.91"
,IN,AR,30331305,1005,100,,Invoice,,,,,,07/11/2018,07/11/2018,0.00,,6.02,,"-1,145,635.93"
,IN,AR,30331306,1005,100,,Invoice,,,,,,07/11/2018,07/11/2018,0.00,,9.74,,"-1,145,645.67"
,IN,AR,30331310,1005,100,,Invoice,,,,,,07/11/2018,07/11/2018,0.00,,20.00,,"-1,145,665.67"
,IN,AR,30331320,1005,100,,Invoice,,,,,,07/11/2018,07/11/2018,0.00,,60.57,,"-1,145,726.24"
,IN,AR,30331321,1005,100,,Invoice,,,,,,07/11/2018,07/11/2018,0.00,,72.15,,"-1,145,798.39"
,IN,AR,30331328,1005,100,,Invoice,,,,,,07/11/2018,07/11/2018,0.00,,10.93,,"-1,145,809.32"
,IN,AR,30331330,1005,100,,Invoice,,,,,,07/11/2018,07/11/2018,0.00,,69.41,,"-1,145,878.73"
,IN,AR,30331340,1005,100,,Invoice,,,,,,07/11/2018,07/11/2018,0.00,,25.93,,"-1,145,904.66"
,IN,AR,30331343,1005,100,,Invoice,,,,,,07/11/2018,07/11/2018,0.00,,7.29,,"-1,145,911.95"
,IN,AR,30331359,1005,100,,Invoice,,,,,,07/11/2018,07/11/2018,0.00,,7.64,,"-1,145,919.59"
,IN,AR,30331361,1005,100,,Invoice,,,,,,07/11/2018,07/11/2018,0.00,,9.84,,"-1,145,929.43"
,IN,AR,30331362,1005,100,,Invoice,,,,,,07/11/2018,07/11/2018,0.00,,33.63,,"-1,145,963.06"
,IN,AR,30331371,1005,100,,Invoice,,,,,,07/11/2018,07/11/2018,0.00,,2.54,,"-1,145,965.60"
,IN,AR,30331398,1005,100,,Invoice,,,,,,07/11/2018,07/11/2018,0.00,,39.75,,"-1,146,005.35"
,IN,AR,30331400,1005,100,,Invoice,,,,,,07/11/2018,07/11/2018,0.00,,4.53,,"-1,146,009.88"
,IN,AR,30331403,1005,100,,Invoice,,,,,,07/11/2018,07/11/2018,0.00,,2.92,,"-1,146,012.80"
,IN,AR,30331413,1005,100,,Invoice,,,,,,07/11/2018,07/11/2018,0.00,,25.23,,"-1,146,038.03"
,IN,AR,30331414,1005,100,,Invoice,,,,,,07/11/2018,07/11/2018,0.00,,21.03,,"-1,146,059.06"
,IN,AR,30331415,1005,100,,Invoice,,,,,,07/11/2018,07/11/2018,0.00,,8.41,,"-1,146,067.47"
,IN,AR,30331420,1005,100,,Invoice,,,,,,07/11/2018,07/11/2018,0.00,,24.92,,"-1,146,092.39"
,IN,AR,30331441,1005,100,,Invoice,,,,,,07/11/2018,07/11/2018,0.00,,9.64,,"-1,146,102.03"
,IN,AR,30331447,1005,100,,Invoice,,,,,,07/11/2018,07/11/2018,0.00,,5.08,,"-1,146,107.11"
,IN,AR,30331466,1005,100,,Invoice,,,,,,07/11/2018,07/11/2018,0.00,,10.93,,"-1,146,118.04"
,IN,AR,30331486,1005,100,,Invoice,,,,,,07/11/2018,07/11/2018,0.00,,6.37,,"-1,146,124.41"
,IN,AR,30331487,1005,100,,Invoice,,,,,,07/11/2018,07/11/2018,0.00,,31.86,,"-1,146,156.27"
,IN,AR,30331526,1005,100,,Invoice,,,,,,07/11/2018,07/11/2018,0.00,,5.26,,"-1,146,161.53"
,IN,AR,30331533,1005,100,,Invoice,,,,,,07/11/2018,07/11/2018,0.00,,14.19,,"-1,146,175.72"
,IN,AR,30331552,1005,100,,Invoice,,,,,,07/11/2018,07/11/2018,0.00,,14.83,,"-1,146,190.55"
,IN,AR,30331555,1005,100,,Invoice,,,,,,07/11/2018,07/11/2018,0.00,,10.59,,"-1,146,201.14"
,IN,AR,30331557,1005,100,,Invoice,,,,,,07/11/2018,07/11/2018,0.00,,9.41,,"-1,146,210.55"
,IN,AR,30331569,1005,100,,Invoice,,,,,,07/11/2018,07/11/2018,0.00,,16.78,,"-1,146,227.33"
,IN,AR,30331578,1005,100,,Invoice,,,,,,07/11/2018,07/11/2018,0.00,,29.15,,"-1,146,256.48"
,IN,AR,30331592,1005,100,,Invoice,,,,,,07/11/2018,07/11/2018,0.00,,11.66,,"-1,146,268.14"
,IN,AR,30331615,1005,100,,Invoice,,,,,,07/11/2018,07/11/2018,0.00,,70.59,,"-1,146,338.73"
,IN,AR,30331616,1005,100,,Invoice,,,,,,07/11/2018,07/11/2018,0.00,,37.37,,"-1,146,376.10"
,IN,AR,30331617,1005,100,,Invoice,,,,,,07/11/2018,07/11/2018,0.00,,10.38,,"-1,146,386.48"
,IN,AR,30331629,1005,100,,Invoice,,,,,,07/11/2018,07/11/2018,0.00,,24.27,,"-1,146,410.75"
,IN,AR,30331630,1005,100,,Invoice,,,,,,07/11/2018,07/11/2018,0.00,,27.31,,"-1,146,438.06"
,IN,AR,30331644,1005,100,,Invoice,,,,,,07/11/2018,07/11/2018,0.00,,40.08,,"-1,146,478.14"
,IN,AR,30331659,1005,100,,Invoice,,,,,,07/11/2018,07/11/2018,0.00,,27.97,,"-1,146,506.11"
,IN,AR,30331678,1005,100,,Invoice,,,,,,07/11/2018,07/11/2018,0.00,,54.66,,"-1,146,560.77"
,IN,AR,30331688,1005,100,,Invoice,,,,,,07/11/2018,07/11/2018,0.00,,7.19,,"-1,146,567.96"
,IN,AR,30331692,1005,100,,Invoice,,,,,,07/11/2018,07/11/2018,0.00,,10.93,,"-1,146,578.89"
,IN,AR,30331695,1005,100,,Invoice,,,,,,07/11/2018,07/11/2018,0.00,,14.58,,"-1,146,593.47"
,IN,AR,30331719,1005,100,,Invoice,,,,,,07/11/2018,07/11/2018,0.00,,72.88,,"-1,146,666.35"
,IN,AR,30331720,1005,100,,Invoice,,,,,,07/11/2018,07/11/2018,0.00,,419.07,,"-1,147,085.42"
,CS,AR,32010638,1005,100,,Cash sale,,,,,,08/11/2018,08/11/2018,0.00,,18.05,,"-1,147,103.47"
,CS,AR,32010650,1005,100,,Cash sale,,,,,,08/11/2018,08/11/2018,0.00,,3.64,,"-1,147,107.11"
,CS,AR,32010651,1005,100,,Cash sale,,,,,,08/11/2018,08/11/2018,0.00,,8.52,,"-1,147,115.63"
,CS,AR,32010661,1005,100,,Cash sale,,,,,,08/11/2018,08/11/2018,0.00,,3.64,,"-1,147,119.27"
,CS,AR,32010672,1005,100,,Cash sale,,,,,,08/11/2018,08/11/2018,0.00,,14.58,,"-1,147,133.85"
,CS,AR,32010677,1005,100,,Cash sale,,,,,,08/11/2018,08/11/2018,0.00,,3.64,,"-1,147,137.49"
,CS,AR,32010707,1005,100,,Cash sale,,,,,,08/11/2018,08/11/2018,0.00,,3.01,,"-1,147,140.50"
,CS,AR,32010711,1005,100,,Cash sale,,,,,,08/11/2018,08/11/2018,0.00,,10.93,,"-1,147,151.43"
,CS,AR,32010735,1005,100,,Cash sale,,,,,,08/11/2018,08/11/2018,0.00,,7.75,,"-1,147,159.18"
,CS,AR,32010743,1005,100,,Cash sale,,,,,,08/11/2018,08/11/2018,0.00,,14.58,,"-1,147,173.76"
,CS,AR,32010758,1005,100,,Cash sale,,,,,,08/11/2018,08/11/2018,0.00,,24.07,,"-1,147,197.83"
,CS,AR,32010789,1005,100,,Cash sale,,,,,,08/11/2018,08/11/2018,0.00,,22.03,,"-1,147,219.86"
,CS,AR,32010795,1005,100,,Cash sale,,,,,,08/11/2018,08/11/2018,0.00,,7.29,,"-1,147,227.15"
,CS,AR,32010808,1005,100,,Cash sale,,,,,,08/11/2018,08/11/2018,0.00,,41.95,,"-1,147,269.10"
,CS,AR,32010820,1005,100,,Cash sale,,,,,,08/11/2018,08/11/2018,0.00,,6.02,,"-1,147,275.12"
,CS,AR,32010824,1005,100,,Cash sale,,,,,,08/11/2018,08/11/2018,0.00,,6.44,,"-1,147,281.56"
,CS,AR,32010827,1005,100,,Cash sale,,,,,,08/11/2018,08/11/2018,0.00,,14.58,,"-1,147,296.14"
,CS,AR,32010832,1005,100,,Cash sale,,,,,,08/11/2018,08/11/2018,0.00,,12.92,,"-1,147,309.06"
,CS,AR,32010850,1005,100,,Cash sale,,,,,,08/11/2018,08/11/2018,0.00,,33.09,,"-1,147,342.15"
,CS,AR,32010851,1005,100,,Cash sale,,,,,,08/11/2018,08/11/2018,0.00,,18.05,,"-1,147,360.20"
,CS,AR,32010873,1005,100,,Cash sale,,,,,,08/11/2018,08/11/2018,0.00,,2.58,,"-1,147,362.78"
,CS,AR,32010894,1005,100,,Cash sale,,,,,,08/11/2018,08/11/2018,0.00,,3.64,,"-1,147,366.42"
,CS,AR,32010905,1005,100,,Cash sale,,,,,,08/11/2018,08/11/2018,0.00,,11.86,,"-1,147,378.28"
,CS,AR,32010907,1005,100,,Cash sale,,,,,,08/11/2018,08/11/2018,0.00,,21.86,,"-1,147,400.14"
,CS,AR,32010917,1005,100,,Cash sale,,,,,,08/11/2018,08/11/2018,0.00,,18.22,,"-1,147,418.36"
,CS,AR,32010947,1005,100,,Cash sale,,,,,,08/11/2018,08/11/2018,0.00,,14.58,,"-1,147,432.94"
,CS,AR,32010954,1005,100,,Cash sale,,,,,,08/11/2018,08/11/2018,0.00,,5.86,,"-1,147,438.80"
,CS,AR,32010956,1005,100,,Cash sale,,,,,,08/11/2018,08/11/2018,0.00,,10.93,,"-1,147,449.73"
,CS,AR,32010993,1005,100,,Cash sale,,,,,,08/11/2018,08/11/2018,0.00,,3.64,,"-1,147,453.37"
,CS,AR,32010998,1005,100,,Cash sale,,,,,,08/11/2018,08/11/2018,0.00,,7.29,,"-1,147,460.66"
,CS,AR,32011002,1005,100,,Cash sale,,,,,,08/11/2018,08/11/2018,0.00,,7.29,,"-1,147,467.95"
,CS,AR,32011009,1005,100,,Cash sale,,,,,,08/11/2018,08/11/2018,0.00,,3.64,,"-1,147,471.59"
,CS,AR,32011012,1005,100,,Cash sale,,,,,,08/11/2018,08/11/2018,0.00,,2.97,,"-1,147,474.56"
,CS,AR,32011014,1005,100,,Cash sale,,,,,,08/11/2018,08/11/2018,0.00,,6.56,,"-1,147,481.12"
,IN,AR,30330750,1005,100,,Invoice,,,,,,08/11/2018,08/11/2018,0.00,,14.58,,"-1,147,495.70"
,IN,AR,30330763,1005,100,,Invoice,,,,,,08/11/2018,08/11/2018,0.00,,12.15,,"-1,147,507.85"
,IN,AR,30330765,1005,100,,Invoice,,,,,,08/11/2018,08/11/2018,0.00,,32.54,,"-1,147,540.39"
,IN,AR,30330769,1005,100,,Invoice,,,,,,08/11/2018,08/11/2018,0.00,,182.20,,"-1,147,722.59"
,IN,AR,30330772,1005,100,,Invoice,,,,,,08/11/2018,08/11/2018,0.00,,14.58,,"-1,147,737.17"
,IN,AR,30330784,1005,100,,Invoice,,,,,,08/11/2018,08/11/2018,0.00,,10.93,,"-1,147,748.10"
,IN,AR,30330809,1005,100,,Invoice,,,,,,08/11/2018,08/11/2018,0.00,,3.98,,"-1,147,752.08"
,IN,AR,30330814,1005,100,,Invoice,,,,,,08/11/2018,08/11/2018,0.00,,72.00,,"-1,147,824.08"
,IN,AR,30330823,1005,100,,Invoice,,,,,,08/11/2018,08/11/2018,0.00,,44.00,,"-1,147,868.08"
,IN,AR,30330825,1005,100,,Invoice,,,,,,08/11/2018,08/11/2018,0.00,,364.41,,"-1,148,232.49"
,IN,AR,30330830,1005,100,,Invoice,,,,,,08/11/2018,08/11/2018,0.00,,29.15,,"-1,148,261.64"
,IN,AR,30330831,1005,100,,Invoice,,,,,,08/11/2018,08/11/2018,0.00,,3.64,,"-1,148,265.28"
,IN,AR,30330833,1005,100,,Invoice,,,,,,08/11/2018,08/11/2018,0.00,,3.64,,"-1,148,268.92"
,IN,AR,30330836,1005,100,,Invoice,,,,,,08/11/2018,08/11/2018,0.00,,182.20,,"-1,148,451.12"
,IN,AR,30330838,1005,100,,Invoice,,,,,,08/11/2018,08/11/2018,0.00,,182.20,,"-1,148,633.32"
,IN,AR,30330851,1005,100,,Invoice,,,,,,08/11/2018,08/11/2018,0.00,,7.29,,"-1,148,640.61"
,IN,AR,30330858,1005,100,,Invoice,,,,,,08/11/2018,08/11/2018,0.00,,21.86,,"-1,148,662.47"
,IN,AR,30330861,1005,100,,Invoice,,,,,,08/11/2018,08/11/2018,0.00,,546.61,,"-1,149,209.08"
,IN,AR,30330868,1005,100,,Invoice,,,,,,08/11/2018,08/11/2018,0.00,,16.61,,"-1,149,225.69"
,IN,AR,30330869,1005,100,,Invoice,,,,,,08/11/2018,08/11/2018,0.00,,71.19,,"-1,149,296.88"
,IN,AR,30330880,1005,100,,Invoice,,,,,,08/11/2018,08/11/2018,0.00,,46.68,,"-1,149,343.56"
,IN,AR,30330885,1005,100,,Invoice,,,,,,08/11/2018,08/11/2018,0.00,,14.19,,"-1,149,357.75"
,IN,AR,30330893,1005,100,,Invoice,,,,,,08/11/2018,08/11/2018,0.00,,736.22,,"-1,150,093.97"
,IN,AR,30330913,1005,100,,Invoice,,,,,,08/11/2018,08/11/2018,0.00,,14.58,,"-1,150,108.55"
,IN,AR,30330927,1005,100,,Invoice,,,,,,08/11/2018,08/11/2018,0.00,,12.75,,"-1,150,121.30"
,IN,AR,30330929,1005,100,,Invoice,,,,,,08/11/2018,08/11/2018,0.00,,14.58,,"-1,150,135.88"
,IN,AR,30330931,1005,100,,Invoice,,,,,,08/11/2018,08/11/2018,0.00,,23.26,,"-1,150,159.14"
,IN,AR,30330936,1005,100,,Invoice,,,,,,08/11/2018,08/11/2018,0.00,,24.50,,"-1,150,183.64"
,IN,AR,30330948,1005,100,,Invoice,,,,,,08/11/2018,08/11/2018,0.00,,4.80,,"-1,150,188.44"
,IN,AR,30330989,1005,100,,Invoice,,,,,,08/11/2018,08/11/2018,0.00,,179.73,,"-1,150,368.17"
,IN,AR,30330992,1005,100,,Invoice,,,,,,08/11/2018,08/11/2018,0.00,,182.20,,"-1,150,550.37"
,IN,AR,30331000,1005,100,,Invoice,,,,,,08/11/2018,08/11/2018,0.00,,14.34,,"-1,150,564.71"
,IN,AR,30331011,1005,100,,Invoice,,,,,,08/11/2018,08/11/2018,0.00,,18.64,,"-1,150,583.35"
,IN,AR,30331023,1005,100,,Invoice,,,,,,08/11/2018,08/11/2018,0.00,,10.17,,"-1,150,593.52"
,IN,AR,30331030,1005,100,,Invoice,,,,,,08/11/2018,08/11/2018,0.00,,19.12,,"-1,150,612.64"
,IN,AR,30331036,1005,100,,Invoice,,,,,,08/11/2018,08/11/2018,0.00,,22.54,,"-1,150,635.18"
,IN,AR,30331042,1005,100,,Invoice,,,,,,08/11/2018,08/11/2018,0.00,,6.36,,"-1,150,641.54"
,IN,AR,30331053,1005,100,,Invoice,,,,,,08/11/2018,08/11/2018,0.00,,6.36,,"-1,150,647.90"
,IN,AR,30331060,1005,100,,Invoice,,,,,,08/11/2018,08/11/2018,0.00,,7.63,,"-1,150,655.53"
,IN,AR,30331072,1005,100,,Invoice,,,,,,08/11/2018,08/11/2018,0.00,,5.17,,"-1,150,660.70"
,IN,AR,30331082,1005,100,,Invoice,,,,,,08/11/2018,08/11/2018,0.00,,8.47,,"-1,150,669.17"
,IN,AR,30331093,1005,100,,Invoice,,,,,,08/11/2018,08/11/2018,0.00,,20.34,,"-1,150,689.51"
,IN,AR,30331098,1005,100,,Invoice,,,,,,08/11/2018,08/11/2018,0.00,,22.50,,"-1,150,712.01"
,IN,AR,30331103,1005,100,,Invoice,,,,,,08/11/2018,08/11/2018,0.00,,7.29,,"-1,150,719.30"
,IN,AR,30331111,1005,100,,Invoice,,,,,,08/11/2018,08/11/2018,0.00,,16.48,,"-1,150,735.78"
,IN,AR,30331114,1005,100,,Invoice,,,,,,08/11/2018,08/11/2018,0.00,,12.03,,"-1,150,747.81"
,IN,AR,30331134,1005,100,,Invoice,,,,,,08/11/2018,08/11/2018,0.00,,19.22,,"-1,150,767.03"
,IN,AR,30331139,1005,100,,Invoice,,,,,,08/11/2018,08/11/2018,0.00,,28.05,,"-1,150,795.08"
,IN,AR,30331145,1005,100,,Invoice,,,,,,08/11/2018,08/11/2018,0.00,,2.97,,"-1,150,798.05"
,IN,AR,30331146,1005,100,,Invoice,,,,,,08/11/2018,08/11/2018,0.00,,35.59,,"-1,150,833.64"
,IN,AR,30331148,1005,100,,Invoice,,,,,,08/11/2018,08/11/2018,0.00,,7.00,,"-1,150,840.64"
,IN,AR,30331151,1005,100,,Invoice,,,,,,08/11/2018,08/11/2018,0.00,,25.51,,"-1,150,866.15"
,IN,AR,30331174,1005,100,,Invoice,,,,,,08/11/2018,08/11/2018,0.00,,6.97,,"-1,150,873.12"
,IN,AR,30331176,1005,100,,Invoice,,,,,,08/11/2018,08/11/2018,0.00,,8.77,,"-1,150,881.89"
,IN,AR,30331177,1005,100,,Invoice,,,,,,08/11/2018,08/11/2018,0.00,,10.93,,"-1,150,892.82"
,IN,AR,30331179,1005,100,,Invoice,,,,,,08/11/2018,08/11/2018,0.00,,10.93,,"-1,150,903.75"
,IN,AR,30331181,1005,100,,Invoice,,,,,,08/11/2018,08/11/2018,0.00,,24.79,,"-1,150,928.54"
,IN,AR,30331206,1005,100,,Invoice,,,,,,08/11/2018,08/11/2018,0.00,,5.49,,"-1,150,934.03"
,IN,AR,30331211,1005,100,,Invoice,,,,,,08/11/2018,08/11/2018,0.00,,10.17,,"-1,150,944.20"
,IN,AR,30331220,1005,100,,Invoice,,,,,,08/11/2018,08/11/2018,0.00,,8.00,,"-1,150,952.20"
,IN,AR,30331235,1005,100,,Invoice,,,,,,08/11/2018,08/11/2018,0.00,,5.29,,"-1,150,957.49"
,IN,AR,30331241,1005,100,,Invoice,,,,,,08/11/2018,08/11/2018,0.00,,10.93,,"-1,150,968.42"
,IN,AR,30331246,1005,100,,Invoice,,,,,,08/11/2018,08/11/2018,0.00,,9.08,,"-1,150,977.50"
,IN,AR,30331249,1005,100,,Invoice,,,,,,08/11/2018,08/11/2018,0.00,,5.49,,"-1,150,982.99"
,IN,AR,30331257,1005,100,,Invoice,,,,,,08/11/2018,08/11/2018,0.00,,10.47,,"-1,150,993.46"
,IN,AR,30331266,1005,100,,Invoice,,,,,,08/11/2018,08/11/2018,0.00,,29.15,,"-1,151,022.61"
,IN,AR,30331277,1005,100,,Invoice,,,,,,08/11/2018,08/11/2018,0.00,,10.93,,"-1,151,033.54"
,IN,AR,30331284,1005,100,,Invoice,,,,,,08/11/2018,08/11/2018,0.00,,18.22,,"-1,151,051.76"
,IN,AR,30331289,1005,100,,Invoice,,,,,,08/11/2018,08/11/2018,0.00,,13.94,,"-1,151,065.70"
,IN,AR,30331290,1005,100,,Invoice,,,,,,08/11/2018,08/11/2018,0.00,,21.91,,"-1,151,087.61"
,IN,AR,30331291,1005,100,,Invoice,,,,,,08/11/2018,08/11/2018,0.00,,3.98,,"-1,151,091.59"
,IN,AR,30331292,1005,100,,Invoice,,,,,,08/11/2018,08/11/2018,0.00,,31.86,,"-1,151,123.45"
,IN,AR,30331302,1005,100,,Invoice,,,,,,08/11/2018,08/11/2018,0.00,,17.91,,"-1,151,141.36"
,IN,AR,30331322,1005,100,,Invoice,,,,,,08/11/2018,08/11/2018,0.00,,11.36,,"-1,151,152.72"
,IN,AR,30331331,1005,100,,Invoice,,,,,,08/11/2018,08/11/2018,0.00,,42.71,,"-1,151,195.43"
,IN,AR,30331335,1005,100,,Invoice,,,,,,08/11/2018,08/11/2018,0.00,,3.64,,"-1,151,199.07"
,IN,AR,30331372,1005,100,,Invoice,,,,,,08/11/2018,08/11/2018,0.00,,20.34,,"-1,151,219.41"
,IN,AR,30331375,1005,100,,Invoice,,,,,,08/11/2018,08/11/2018,0.00,,20.01,,"-1,151,239.42"
,IN,AR,30331384,1005,100,,Invoice,,,,,,08/11/2018,08/11/2018,0.00,,22.01,,"-1,151,261.43"
,IN,AR,30331393,1005,100,,Invoice,,,,,,08/11/2018,08/11/2018,0.00,,20.41,,"-1,151,281.84"
,IN,AR,30331394,1005,100,,Invoice,,,,,,08/11/2018,08/11/2018,0.00,,14.58,,"-1,151,296.42"
,IN,AR,30331426,1005,100,,Invoice,,,,,,08/11/2018,08/11/2018,0.00,,40.81,,"-1,151,337.23"
,IN,AR,30331427,1005,100,,Invoice,,,,,,08/11/2018,08/11/2018,0.00,,18.22,,"-1,151,355.45"
,IN,AR,30331435,1005,100,,Invoice,,,,,,08/11/2018,08/11/2018,0.00,,14.03,,"-1,151,369.48"
,IN,AR,30331440,1005,100,,Invoice,,,,,,08/11/2018,08/11/2018,0.00,,25.17,,"-1,151,394.65"
,IN,AR,30331446,1005,100,,Invoice,,,,,,08/11/2018,08/11/2018,0.00,,15.17,,"-1,151,409.82"
,IN,AR,30331479,1005,100,,Invoice,,,,,,08/11/2018,08/11/2018,0.00,,81.15,,"-1,151,490.97"
,IN,AR,30331488,1005,100,,Invoice,,,,,,08/11/2018,08/11/2018,0.00,,127.46,,"-1,151,618.43"
,IN,AR,30331489,1005,100,,Invoice,,,,,,08/11/2018,08/11/2018,0.00,,11.15,,"-1,151,629.58"
,IN,AR,30331490,1005,100,,Invoice,,,,,,08/11/2018,08/11/2018,0.00,,9.56,,"-1,151,639.14"
,IN,AR,30331491,1005,100,,Invoice,,,,,,08/11/2018,08/11/2018,0.00,,4.78,,"-1,151,643.92"
,IN,AR,30331492,1005,100,,Invoice,,,,,,08/11/2018,08/11/2018,0.00,,3.19,,"-1,151,647.11"
,IN,AR,30331493,1005,100,,Invoice,,,,,,08/11/2018,08/11/2018,0.00,,6.37,,"-1,151,653.48"
,IN,AR,30331510,1005,100,,Invoice,,,,,,08/11/2018,08/11/2018,0.00,,24.41,,"-1,151,677.89"
,IN,AR,30331532,1005,100,,Invoice,,,,,,08/11/2018,08/11/2018,0.00,,29.15,,"-1,151,707.04"
,IN,AR,30331577,1005,100,,Invoice,,,,,,08/11/2018,08/11/2018,0.00,,4.08,,"-1,151,711.12"
,IN,AR,30331587,1005,100,,Invoice,,,,,,08/11/2018,08/11/2018,0.00,,182.20,,"-1,151,893.32"
,IN,AR,30331594,1005,100,,Invoice,,,,,,08/11/2018,08/11/2018,0.00,,2.42,,"-1,151,895.74"
,IN,AR,30331618,1005,100,,Invoice,,,,,,08/11/2018,08/11/2018,0.00,,20.76,,"-1,151,916.50"
,IN,AR,30331619,1005,100,,Invoice,,,,,,08/11/2018,08/11/2018,0.00,,4.15,,"-1,151,920.65"
,IN,AR,30331620,1005,100,,Invoice,,,,,,08/11/2018,08/11/2018,0.00,,4.15,,"-1,151,924.80"
,IN,AR,30331621,1005,100,,Invoice,,,,,,08/11/2018,08/11/2018,0.00,,4.15,,"-1,151,928.95"
,IN,AR,30331638,1005,100,,Invoice,,,,,,08/11/2018,08/11/2018,0.00,,2.03,,"-1,151,930.98"
,IN,AR,30331654,1005,100,,Invoice,,,,,,08/11/2018,08/11/2018,0.00,,7.63,,"-1,151,938.61"
,IN,AR,30331657,1005,100,,Invoice,,,,,,08/11/2018,08/11/2018,0.00,,10.52,,"-1,151,949.13"
,IN,AR,30331674,1005,100,,Invoice,,,,,,08/11/2018,08/11/2018,0.00,,182.20,,"-1,152,131.33"
,IN,AR,30331680,1005,100,,Invoice,,,,,,08/11/2018,08/11/2018,0.00,,5.26,,"-1,152,136.59"
,IN,AR,30331685,1005,100,,Invoice,,,,,,08/11/2018,08/11/2018,0.00,,12.71,,"-1,152,149.30"
,IN,AR,30331694,1005,100,,Invoice,,,,,,08/11/2018,08/11/2018,0.00,,21.30,,"-1,152,170.60"
,IN,AR,30331701,1005,100,,Invoice,,,,,,08/11/2018,08/11/2018,0.00,,12.03,,"-1,152,182.63"
,CN,AR,31019401,1005,100,,Credit Note,,,,,,09/11/2018,09/11/2018,38.56,,0.00,,"-1,152,144.07"
,CN,AR,31019405,1005,100,,Credit Note,,,,,,09/11/2018,09/11/2018,14.58,,0.00,,"-1,152,129.49"
,CN,AR,31019407,1005,100,,Credit Note,,,,,,09/11/2018,09/11/2018,10.93,,0.00,,"-1,152,118.56"
,CN,AR,31019415,1005,100,,Credit Note,,,,,,09/11/2018,09/11/2018,"2,631.63",,0.00,,"-1,149,486.93"
,CN,AR,31019416,1005,100,,Credit Note,,,,,,09/11/2018,09/11/2018,"2,934.65",,0.00,,"-1,146,552.28"
,CN,AR,31019417,1005,100,,Credit Note,,,,,,09/11/2018,09/11/2018,"3,052.61",,0.00,,"-1,143,499.67"
,CN,AR,31019418,1005,100,,Credit Note,,,,,,09/11/2018,09/11/2018,"2,997.70",,0.00,,"-1,140,501.97"
,CN,AR,31019419,1005,100,,Credit Note,,,,,,09/11/2018,09/11/2018,"3,394.27",,0.00,,"-1,137,107.70"
,CN,AR,31019420,1005,100,,Credit Note,,,,,,09/11/2018,09/11/2018,"2,973.29",,0.00,,"-1,134,134.41"
,CN,AR,31019421,1005,100,,Credit Note,,,,,,09/11/2018,09/11/2018,"2,765.85",,0.00,,"-1,131,368.56"
,CN,AR,31019453,1005,100,,Credit Note,,,,,,09/11/2018,09/11/2018,1.99,,0.00,,"-1,131,366.57"
,CN,AR,31019474,1005,100,,Credit Note,,,,,,09/11/2018,09/11/2018,5.97,,0.00,,"-1,131,360.60"
,CN,AR,31019490,1005,100,,Credit Note,,,,,,09/11/2018,09/11/2018,65.59,,0.00,,"-1,131,295.01"
,CR,AR,33000303,1005,100,,Cash Return,,,,,,09/11/2018,09/11/2018,9.03,,0.00,,"-1,131,285.98"
,CR,AR,33000306,1005,100,,Cash Return,,,,,,09/11/2018,09/11/2018,5.97,,0.00,,"-1,131,280.01"
,CS,AR,32010636,1005,100,,Cash sale,,,,,,09/11/2018,09/11/2018,0.00,,18.22,,"-1,131,298.23"
,CS,AR,32010643,1005,100,,Cash sale,,,,,,09/11/2018,09/11/2018,0.00,,5.61,,"-1,131,303.84"
,CS,AR,32010648,1005,100,,Cash sale,,,,,,09/11/2018,09/11/2018,0.00,,11.86,,"-1,131,315.70"
,CS,AR,32010675,1005,100,,Cash sale,,,,,,09/11/2018,09/11/2018,0.00,,9.66,,"-1,131,325.36"
,CS,AR,32010685,1005,100,,Cash sale,,,,,,09/11/2018,09/11/2018,0.00,,12.46,,"-1,131,337.82"
,CS,AR,32010689,1005,100,,Cash sale,,,,,,09/11/2018,09/11/2018,0.00,,3.64,,"-1,131,341.46"
,CS,AR,32010693,1005,100,,Cash sale,,,,,,09/11/2018,09/11/2018,0.00,,5.84,,"-1,131,347.30"
,CS,AR,32010696,1005,100,,Cash sale,,,,,,09/11/2018,09/11/2018,0.00,,3.64,,"-1,131,350.94"
,CS,AR,32010698,1005,100,,Cash sale,,,,,,09/11/2018,09/11/2018,0.00,,3.64,,"-1,131,354.58"
,CS,AR,32010705,1005,100,,Cash sale,,,,,,09/11/2018,09/11/2018,0.00,,10.93,,"-1,131,365.51"
,CS,AR,32010719,1005,100,,Cash sale,,,,,,09/11/2018,09/11/2018,0.00,,3.64,,"-1,131,369.15"
,CS,AR,32010720,1005,100,,Cash sale,,,,,,09/11/2018,09/11/2018,0.00,,15.51,,"-1,131,384.66"
,CS,AR,32010727,1005,100,,Cash sale,,,,,,09/11/2018,09/11/2018,0.00,,10.93,,"-1,131,395.59"
,CS,AR,32010729,1005,100,,Cash sale,,,,,,09/11/2018,09/11/2018,0.00,,2.58,,"-1,131,398.17"
,CS,AR,32010739,1005,100,,Cash sale,,,,,,09/11/2018,09/11/2018,0.00,,3.64,,"-1,131,401.81"
,CS,AR,32010742,1005,100,,Cash sale,,,,,,09/11/2018,09/11/2018,0.00,,74.19,,"-1,131,476.00"
,CS,AR,32010749,1005,100,,Cash sale,,,,,,09/11/2018,09/11/2018,0.00,,9.03,,"-1,131,485.03"
,CS,AR,32010750,1005,100,,Cash sale,,,,,,09/11/2018,09/11/2018,0.00,,3.64,,"-1,131,488.67"
,CS,AR,32010763,1005,100,,Cash sale,,,,,,09/11/2018,09/11/2018,0.00,,20.47,,"-1,131,509.14"
,CS,AR,32010768,1005,100,,Cash sale,,,,,,09/11/2018,09/11/2018,0.00,,6.02,,"-1,131,515.16"
,CS,AR,32010773,1005,100,,Cash sale,,,,,,09/11/2018,09/11/2018,0.00,,27.08,,"-1,131,542.24"
,CS,AR,32010777,1005,100,,Cash sale,,,,,,09/11/2018,09/11/2018,0.00,,10.17,,"-1,131,552.41"
,CS,AR,32010782,1005,100,,Cash sale,,,,,,09/11/2018,09/11/2018,0.00,,5.17,,"-1,131,557.58"
,CS,AR,32010790,1005,100,,Cash sale,,,,,,09/11/2018,09/11/2018,0.00,,10.93,,"-1,131,568.51"
,CS,AR,32010793,1005,100,,Cash sale,,,,,,09/11/2018,09/11/2018,0.00,,7.29,,"-1,131,575.80"
,CS,AR,32010799,1005,100,,Cash sale,,,,,,09/11/2018,09/11/2018,0.00,,14.58,,"-1,131,590.38"
,CS,AR,32010802,1005,100,,Cash sale,,,,,,09/11/2018,09/11/2018,0.00,,3.64,,"-1,131,594.02"
,CS,AR,32010815,1005,100,,Cash sale,,,,,,09/11/2018,09/11/2018,0.00,,18.22,,"-1,131,612.24"
,CS,AR,32010826,1005,100,,Cash sale,,,,,,09/11/2018,09/11/2018,0.00,,11.70,,"-1,131,623.94"
,CS,AR,32010830,1005,100,,Cash sale,,,,,,09/11/2018,09/11/2018,0.00,,10.93,,"-1,131,634.87"
,CS,AR,32010838,1005,100,,Cash sale,,,,,,09/11/2018,09/11/2018,0.00,,5.17,,"-1,131,640.04"
,CS,AR,32010840,1005,100,,Cash sale,,,,,,09/11/2018,09/11/2018,0.00,,3.64,,"-1,131,643.68"
,CS,AR,32010843,1005,100,,Cash sale,,,,,,09/11/2018,09/11/2018,0.00,,2.58,,"-1,131,646.26"
,CS,AR,32010848,1005,100,,Cash sale,,,,,,09/11/2018,09/11/2018,0.00,,8.34,,"-1,131,654.60"
,CS,AR,32010865,1005,100,,Cash sale,,,,,,09/11/2018,09/11/2018,0.00,,6.02,,"-1,131,660.62"
,CS,AR,32010875,1005,100,,Cash sale,,,,,,09/11/2018,09/11/2018,0.00,,22.88,,"-1,131,683.50"
,CS,AR,32010880,1005,100,,Cash sale,,,,,,09/11/2018,09/11/2018,0.00,,3.64,,"-1,131,687.14"
,CS,AR,32010890,1005,100,,Cash sale,,,,,,09/11/2018,09/11/2018,0.00,,2.54,,"-1,131,689.68"
,CS,AR,32010891,1005,100,,Cash sale,,,,,,09/11/2018,09/11/2018,0.00,,12.71,,"-1,131,702.39"
,CS,AR,32010892,1005,100,,Cash sale,,,,,,09/11/2018,09/11/2018,0.00,,7.63,,"-1,131,710.02"
,CS,AR,32010898,1005,100,,Cash sale,,,,,,09/11/2018,09/11/2018,0.00,,6.86,,"-1,131,716.88"
,CS,AR,32010911,1005,100,,Cash sale,,,,,,09/11/2018,09/11/2018,0.00,,10.17,,"-1,131,727.05"
,CS,AR,32010912,1005,100,,Cash sale,,,,,,09/11/2018,09/11/2018,0.00,,7.29,,"-1,131,734.34"
,CS,AR,32010915,1005,100,,Cash sale,,,,,,09/11/2018,09/11/2018,0.00,,18.22,,"-1,131,752.56"
,CS,AR,32010929,1005,100,,Cash sale,,,,,,09/11/2018,09/11/2018,0.00,,10.93,,"-1,131,763.49"
,CS,AR,32010930,1005,100,,Cash sale,,,,,,09/11/2018,09/11/2018,0.00,,5.08,,"-1,131,768.57"
,CS,AR,32010934,1005,100,,Cash sale,,,,,,09/11/2018,09/11/2018,0.00,,9.10,,"-1,131,777.67"
,CS,AR,32010936,1005,100,,Cash sale,,,,,,09/11/2018,09/11/2018,0.00,,12.20,,"-1,131,789.87"
,CS,AR,32010938,1005,100,,Cash sale,,,,,,09/11/2018,09/11/2018,0.00,,18.22,,"-1,131,808.09"
,CS,AR,32010940,1005,100,,Cash sale,,,,,,09/11/2018,09/11/2018,0.00,,7.29,,"-1,131,815.38"
,CS,AR,32010943,1005,100,,Cash sale,,,,,,09/11/2018,09/11/2018,0.00,,6.08,,"-1,131,821.46"
,CS,AR,32010962,1005,100,,Cash sale,,,,,,09/11/2018,09/11/2018,0.00,,3.64,,"-1,131,825.10"
,CS,AR,32010963,1005,100,,Cash sale,,,,,,09/11/2018,09/11/2018,0.00,,5.97,,"-1,131,831.07"
,CS,AR,32010965,1005,100,,Cash sale,,,,,,09/11/2018,09/11/2018,0.00,,6.02,,"-1,131,837.09"
,CS,AR,32010969,1005,100,,Cash sale,,,,,,09/11/2018,09/11/2018,0.00,,5.94,,"-1,131,843.03"
,CS,AR,32010987,1005,100,,Cash sale,,,,,,09/11/2018,09/11/2018,0.00,,9.32,,"-1,131,852.35"
,IN,AR,30330735,1005,100,,Invoice,,,,,,09/11/2018,09/11/2018,0.00,,38.56,,"-1,131,890.91"
,IN,AR,30330736,1005,100,,Invoice,,,,,,09/11/2018,09/11/2018,0.00,,38.56,,"-1,131,929.47"
,IN,AR,30330738,1005,100,,Invoice,,,,,,09/11/2018,09/11/2018,0.00,,7.29,,"-1,131,936.76"
,IN,AR,30330743,1005,100,,Invoice,,,,,,09/11/2018,09/11/2018,0.00,,364.41,,"-1,132,301.17"
,IN,AR,30330747,1005,100,,Invoice,,,,,,09/11/2018,09/11/2018,0.00,,182.20,,"-1,132,483.37"
,IN,AR,30330749,1005,100,,Invoice,,,,,,09/11/2018,09/11/2018,0.00,,11.19,,"-1,132,494.56"
,IN,AR,30330767,1005,100,,Invoice,,,,,,09/11/2018,09/11/2018,0.00,,14.58,,"-1,132,509.14"
,IN,AR,30330773,1005,100,,Invoice,,,,,,09/11/2018,09/11/2018,0.00,,14.58,,"-1,132,523.72"
,IN,AR,30330781,1005,100,,Invoice,,,,,,09/11/2018,09/11/2018,0.00,,12.08,,"-1,132,535.80"
,IN,AR,30330782,1005,100,,Invoice,,,,,,09/11/2018,09/11/2018,0.00,,54.66,,"-1,132,590.46"
,IN,AR,30330785,1005,100,,Invoice,,,,,,09/11/2018,09/11/2018,0.00,,3.64,,"-1,132,594.10"
,IN,AR,30330794,1005,100,,Invoice,,,,,,09/11/2018,09/11/2018,0.00,,10.93,,"-1,132,605.03"
,IN,AR,30330797,1005,100,,Invoice,,,,,,09/11/2018,09/11/2018,0.00,,10.93,,"-1,132,615.96"
,IN,AR,30330798,1005,100,,Invoice,,,,,,09/11/2018,09/11/2018,0.00,,105.68,,"-1,132,721.64"
,IN,AR,30330800,1005,100,,Invoice,,,,,,09/11/2018,09/11/2018,0.00,,6.89,,"-1,132,728.53"
,IN,AR,30330804,1005,100,,Invoice,,,,,,09/11/2018,09/11/2018,0.00,,87.33,,"-1,132,815.86"
,IN,AR,30330815,1005,100,,Invoice,,,,,,09/11/2018,09/11/2018,0.00,,58.00,,"-1,132,873.86"
,IN,AR,30330820,1005,100,,Invoice,,,,,,09/11/2018,09/11/2018,0.00,,14.58,,"-1,132,888.44"
,IN,AR,30330844,1005,100,,Invoice,,,,,,09/11/2018,09/11/2018,0.00,,22.00,,"-1,132,910.44"
,IN,AR,30330847,1005,100,,Invoice,,,,,,09/11/2018,09/11/2018,0.00,,3.64,,"-1,132,914.08"
,IN,AR,30330848,1005,100,,Invoice,,,,,,09/11/2018,09/11/2018,0.00,,182.20,,"-1,133,096.28"
,IN,AR,30330850,1005,100,,Invoice,,,,,,09/11/2018,09/11/2018,0.00,,182.20,,"-1,133,278.48"
,IN,AR,30330857,1005,100,,Invoice,,,,,,09/11/2018,09/11/2018,0.00,,54.66,,"-1,133,333.14"
,IN,AR,30330859,1005,100,,Invoice,,,,,,09/11/2018,09/11/2018,0.00,,182.20,,"-1,133,515.34"
,IN,AR,30330870,1005,100,,Invoice,,,,,,09/11/2018,09/11/2018,0.00,,7.12,,"-1,133,522.46"
,IN,AR,30330873,1005,100,,Invoice,,,,,,09/11/2018,09/11/2018,0.00,,20.00,,"-1,133,542.46"
,IN,AR,30330875,1005,100,,Invoice,,,,,,09/11/2018,09/11/2018,0.00,,364.41,,"-1,133,906.87"
,IN,AR,30330878,1005,100,,Invoice,,,,,,09/11/2018,09/11/2018,0.00,,54.66,,"-1,133,961.53"
,IN,AR,30330903,1005,100,,Invoice,,,,,,09/11/2018,09/11/2018,0.00,,5.82,,"-1,133,967.35"
,IN,AR,30330904,1005,100,,Invoice,,,,,,09/11/2018,09/11/2018,0.00,,13.58,,"-1,133,980.93"
,IN,AR,30330906,1005,100,,Invoice,,,,,,09/11/2018,09/11/2018,0.00,,7.29,,"-1,133,988.22"
,IN,AR,30330909,1005,100,,Invoice,,,,,,09/11/2018,09/11/2018,0.00,,36.00,,"-1,134,024.22"
,IN,AR,30330912,1005,100,,Invoice,,,,,,09/11/2018,09/11/2018,0.00,,3.64,,"-1,134,027.86"
,IN,AR,30330916,1005,100,,Invoice,,,,,,09/11/2018,09/11/2018,0.00,,29.15,,"-1,134,057.01"
,IN,AR,30330918,1005,100,,Invoice,,,,,,09/11/2018,09/11/2018,0.00,,8.39,,"-1,134,065.40"
,IN,AR,30330922,1005,100,,Invoice,,,,,,09/11/2018,09/11/2018,0.00,,33.64,,"-1,134,099.04"
,IN,AR,30330938,1005,100,,Invoice,,,,,,09/11/2018,09/11/2018,0.00,,10.34,,"-1,134,109.38"
,IN,AR,30330945,1005,100,,Invoice,,,,,,09/11/2018,09/11/2018,0.00,,54.66,,"-1,134,164.04"
,IN,AR,30330949,1005,100,,Invoice,,,,,,09/11/2018,09/11/2018,0.00,,9.59,,"-1,134,173.63"
,IN,AR,30330955,1005,100,,Invoice,,,,,,09/11/2018,09/11/2018,0.00,,3.64,,"-1,134,177.27"
,IN,AR,30330972,1005,100,,Invoice,,,,,,09/11/2018,09/11/2018,0.00,,54.66,,"-1,134,231.93"
,IN,AR,30330973,1005,100,,Invoice,,,,,,09/11/2018,09/11/2018,0.00,,182.20,,"-1,134,414.13"
,IN,AR,30330976,1005,100,,Invoice,,,,,,09/11/2018,09/11/2018,0.00,,54.66,,"-1,134,468.79"
,IN,AR,30330980,1005,100,,Invoice,,,,,,09/11/2018,09/11/2018,0.00,,91.10,,"-1,134,559.89"
,IN,AR,30330983,1005,100,,Invoice,,,,,,09/11/2018,09/11/2018,0.00,,20.68,,"-1,134,580.57"
,IN,AR,30330986,1005,100,,Invoice,,,,,,09/11/2018,09/11/2018,0.00,,7.17,,"-1,134,587.74"
,IN,AR,30330991,1005,100,,Invoice,,,,,,09/11/2018,09/11/2018,0.00,,182.20,,"-1,134,769.94"
,IN,AR,30331004,1005,100,,Invoice,,,,,,09/11/2018,09/11/2018,0.00,,6.02,,"-1,134,775.96"
,IN,AR,30331007,1005,100,,Invoice,,,,,,09/11/2018,09/11/2018,0.00,,"1,093.22",,"-1,135,869.18"
,IN,AR,30331008,1005,100,,Invoice,,,,,,09/11/2018,09/11/2018,0.00,,408.14,,"-1,136,277.32"
,IN,AR,30331015,1005,100,,Invoice,,,,,,09/11/2018,09/11/2018,0.00,,63.58,,"-1,136,340.90"
,IN,AR,30331031,1005,100,,Invoice,,,,,,09/11/2018,09/11/2018,0.00,,4.78,,"-1,136,345.68"
,IN,AR,30331040,1005,100,,Invoice,,,,,,09/11/2018,09/11/2018,0.00,,9.03,,"-1,136,354.71"
,IN,AR,30331041,1005,100,,Invoice,,,,,,09/11/2018,09/11/2018,0.00,,7.29,,"-1,136,362.00"
,IN,AR,30331045,1005,100,,Invoice,,,,,,09/11/2018,09/11/2018,0.00,,15.04,,"-1,136,377.04"
,IN,AR,30331052,1005,100,,Invoice,,,,,,09/11/2018,09/11/2018,0.00,,29.15,,"-1,136,406.19"
,IN,AR,30331061,1005,100,,Invoice,,,,,,09/11/2018,09/11/2018,0.00,,2.54,,"-1,136,408.73"
,IN,AR,30331062,1005,100,,Invoice,,,,,,09/11/2018,09/11/2018,0.00,,7.63,,"-1,136,416.36"
,IN,AR,30331063,1005,100,,Invoice,,,,,,09/11/2018,09/11/2018,0.00,,10.17,,"-1,136,426.53"
,IN,AR,30331064,1005,100,,Invoice,,,,,,09/11/2018,09/11/2018,0.00,,2.54,,"-1,136,429.07"
,IN,AR,30331067,1005,100,,Invoice,,,,,,09/11/2018,09/11/2018,0.00,,2.54,,"-1,136,431.61"
,IN,AR,30331070,1005,100,,Invoice,,,,,,09/11/2018,09/11/2018,0.00,,29.15,,"-1,136,460.76"
,IN,AR,30331079,1005,100,,Invoice,,,,,,09/11/2018,09/11/2018,0.00,,15.25,,"-1,136,476.01"
,IN,AR,30331086,1005,100,,Invoice,,,,,,09/11/2018,09/11/2018,0.00,,7.29,,"-1,136,483.30"
,IN,AR,30331090,1005,100,,Invoice,,,,,,09/11/2018,09/11/2018,0.00,,10.93,,"-1,136,494.23"
,IN,AR,30331095,1005,100,,Invoice,,,,,,09/11/2018,09/11/2018,0.00,,29.15,,"-1,136,523.38"
,IN,AR,30331101,1005,100,,Invoice,,,,,,09/11/2018,09/11/2018,0.00,,3.64,,"-1,136,527.02"
,IN,AR,30331102,1005,100,,Invoice,,,,,,09/11/2018,09/11/2018,0.00,,29.15,,"-1,136,556.17"
,IN,AR,30331105,1005,100,,Invoice,,,,,,09/11/2018,09/11/2018,0.00,,1.65,,"-1,136,557.82"
,IN,AR,30331122,1005,100,,Invoice,,,,,,09/11/2018,09/11/2018,0.00,,4.24,,"-1,136,562.06"
,IN,AR,30331130,1005,100,,Invoice,,,,,,09/11/2018,09/11/2018,0.00,,54.66,,"-1,136,616.72"
,IN,AR,30331152,1005,100,,Invoice,,,,,,09/11/2018,09/11/2018,0.00,,12.88,,"-1,136,629.60"
,IN,AR,30331155,1005,100,,Invoice,,,,,,09/11/2018,09/11/2018,0.00,,29.15,,"-1,136,658.75"
,IN,AR,30331160,1005,100,,Invoice,,,,,,09/11/2018,09/11/2018,0.00,,4.24,,"-1,136,662.99"
,IN,AR,30331170,1005,100,,Invoice,,,,,,09/11/2018,09/11/2018,0.00,,24.00,,"-1,136,686.99"
,IN,AR,30331183,1005,100,,Invoice,,,,,,09/11/2018,09/11/2018,0.00,,54.66,,"-1,136,741.65"
,IN,AR,30331188,1005,100,,Invoice,,,,,,09/11/2018,09/11/2018,0.00,,364.41,,"-1,137,106.06"
,IN,AR,30331194,1005,100,,Invoice,,,,,,09/11/2018,09/11/2018,0.00,,21.86,,"-1,137,127.92"
,IN,AR,30331202,1005,100,,Invoice,,,,,,09/11/2018,09/11/2018,0.00,,54.66,,"-1,137,182.58"
,IN,AR,30331207,1005,100,,Invoice,,,,,,09/11/2018,09/11/2018,0.00,,54.66,,"-1,137,237.24"
,IN,AR,30331212,1005,100,,Invoice,,,,,,09/11/2018,09/11/2018,0.00,,54.66,,"-1,137,291.90"
,IN,AR,30331215,1005,100,,Invoice,,,,,,09/11/2018,09/11/2018,0.00,,182.20,,"-1,137,474.10"
,IN,AR,30331222,1005,100,,Invoice,,,,,,09/11/2018,09/11/2018,0.00,,419.07,,"-1,137,893.17"
,IN,AR,30331225,1005,100,,Invoice,,,,,,09/11/2018,09/11/2018,0.00,,53.60,,"-1,137,946.77"
,IN,AR,30331236,1005,100,,Invoice,,,,,,09/11/2018,09/11/2018,0.00,,1.76,,"-1,137,948.53"
,IN,AR,30331245,1005,100,,Invoice,,,,,,09/11/2018,09/11/2018,0.00,,4.85,,"-1,137,953.38"
,IN,AR,30331252,1005,100,,Invoice,,,,,,09/11/2018,09/11/2018,0.00,,54.66,,"-1,138,008.04"
,IN,AR,30331263,1005,100,,Invoice,,,,,,09/11/2018,09/11/2018,0.00,,54.66,,"-1,138,062.70"
,IN,AR,30331264,1005,100,,Invoice,,,,,,09/11/2018,09/11/2018,0.00,,29.15,,"-1,138,091.85"
,IN,AR,30331265,1005,100,,Invoice,,,,,,09/11/2018,09/11/2018,0.00,,54.66,,"-1,138,146.51"
,IN,AR,30331272,1005,100,,Invoice,,,,,,09/11/2018,09/11/2018,0.00,,21.86,,"-1,138,168.37"
,IN,AR,30331280,1005,100,,Invoice,,,,,,09/11/2018,09/11/2018,0.00,,3.64,,"-1,138,172.01"
,IN,AR,30331303,1005,100,,Invoice,,,,,,09/11/2018,09/11/2018,0.00,,33.83,,"-1,138,205.84"
,IN,AR,30331309,1005,100,,Invoice,,,,,,09/11/2018,09/11/2018,0.00,,36.91,,"-1,138,242.75"
,IN,AR,30331312,1005,100,,Invoice,,,,,,09/11/2018,09/11/2018,0.00,,40.00,,"-1,138,282.75"
,IN,AR,30331313,1005,100,,Invoice,,,,,,09/11/2018,09/11/2018,0.00,,182.20,,"-1,138,464.95"
,IN,AR,30331315,1005,100,,Invoice,,,,,,09/11/2018,09/11/2018,0.00,,28.81,,"-1,138,493.76"
,IN,AR,30331317,1005,100,,Invoice,,,,,,09/11/2018,09/11/2018,0.00,,54.66,,"-1,138,548.42"
,IN,AR,30331319,1005,100,,Invoice,,,,,,09/11/2018,09/11/2018,0.00,,8.90,,"-1,138,557.32"
,IN,AR,30331325,1005,100,,Invoice,,,,,,09/11/2018,09/11/2018,0.00,,36.08,,"-1,138,593.40"
,IN,AR,30331332,1005,100,,Invoice,,,,,,09/11/2018,09/11/2018,0.00,,8.21,,"-1,138,601.61"
,IN,AR,30331333,1005,100,,Invoice,,,,,,09/11/2018,09/11/2018,0.00,,182.20,,"-1,138,783.81"
,IN,AR,30331337,1005,100,,Invoice,,,,,,09/11/2018,09/11/2018,0.00,,3.01,,"-1,138,786.82"
,IN,AR,30331341,1005,100,,Invoice,,,,,,09/11/2018,09/11/2018,0.00,,6.48,,"-1,138,793.30"
,IN,AR,30331345,1005,100,,Invoice,,,,,,09/11/2018,09/11/2018,0.00,,54.66,,"-1,138,847.96"
,IN,AR,30331348,1005,100,,Invoice,,,,,,09/11/2018,09/11/2018,0.00,,10.93,,"-1,138,858.89"
,IN,AR,30331351,1005,100,,Invoice,,,,,,09/11/2018,09/11/2018,0.00,,31.53,,"-1,138,890.42"
,IN,AR,30331360,1005,100,,Invoice,,,,,,09/11/2018,09/11/2018,0.00,,18.22,,"-1,138,908.64"
,IN,AR,30331364,1005,100,,Invoice,,,,,,09/11/2018,09/11/2018,0.00,,16.74,,"-1,138,925.38"
,IN,AR,30331365,1005,100,,Invoice,,,,,,09/11/2018,09/11/2018,0.00,,18.22,,"-1,138,943.60"
,IN,AR,30331373,1005,100,,Invoice,,,,,,09/11/2018,09/11/2018,0.00,,15.25,,"-1,138,958.85"
,IN,AR,30331378,1005,100,,Invoice,,,,,,09/11/2018,09/11/2018,0.00,,8.00,,"-1,138,966.85"
,IN,AR,30331382,1005,100,,Invoice,,,,,,09/11/2018,09/11/2018,0.00,,4.00,,"-1,138,970.85"
,IN,AR,30331385,1005,100,,Invoice,,,,,,09/11/2018,09/11/2018,0.00,,12.00,,"-1,138,982.85"
,IN,AR,30331390,1005,100,,Invoice,,,,,,09/11/2018,09/11/2018,0.00,,54.66,,"-1,139,037.51"
,IN,AR,30331395,1005,100,,Invoice,,,,,,09/11/2018,09/11/2018,0.00,,17.49,,"-1,139,055.00"
,IN,AR,30331405,1005,100,,Invoice,,,,,,09/11/2018,09/11/2018,0.00,,"1,093.22",,"-1,140,148.22"
,IN,AR,30331406,1005,100,,Invoice,,,,,,09/11/2018,09/11/2018,0.00,,182.20,,"-1,140,330.42"
,IN,AR,30331409,1005,100,,Invoice,,,,,,09/11/2018,09/11/2018,0.00,,24.64,,"-1,140,355.06"
,IN,AR,30331416,1005,100,,Invoice,,,,,,09/11/2018,09/11/2018,0.00,,37.85,,"-1,140,392.91"
,IN,AR,30331423,1005,100,,Invoice,,,,,,09/11/2018,09/11/2018,0.00,,10.93,,"-1,140,403.84"
,IN,AR,30331438,1005,100,,Invoice,,,,,,09/11/2018,09/11/2018,0.00,,13.78,,"-1,140,417.62"
,IN,AR,30331448,1005,100,,Invoice,,,,,,09/11/2018,09/11/2018,0.00,,12.00,,"-1,140,429.62"
,IN,AR,30331449,1005,100,,Invoice,,,,,,09/11/2018,09/11/2018,0.00,,10.38,,"-1,140,440.00"
,IN,AR,30331451,1005,100,,Invoice,,,,,,09/11/2018,09/11/2018,0.00,,54.66,,"-1,140,494.66"
,IN,AR,30331464,1005,100,,Invoice,,,,,,09/11/2018,09/11/2018,0.00,,9.84,,"-1,140,504.50"
,IN,AR,30331469,1005,100,,Invoice,,,,,,09/11/2018,09/11/2018,0.00,,10.93,,"-1,140,515.43"
,IN,AR,30331470,1005,100,,Invoice,,,,,,09/11/2018,09/11/2018,0.00,,29.15,,"-1,140,544.58"
,IN,AR,30331474,1005,100,,Invoice,,,,,,09/11/2018,09/11/2018,0.00,,4.83,,"-1,140,549.41"
,IN,AR,30331518,1005,100,,Invoice,,,,,,09/11/2018,09/11/2018,0.00,,54.66,,"-1,140,604.07"
,IN,AR,30331521,1005,100,,Invoice,,,,,,09/11/2018,09/11/2018,0.00,,6.00,,"-1,140,610.07"
,IN,AR,30331522,1005,100,,Invoice,,,,,,09/11/2018,09/11/2018,0.00,,29.15,,"-1,140,639.22"
,IN,AR,30331537,1005,100,,Invoice,,,,,,09/11/2018,09/11/2018,0.00,,182.20,,"-1,140,821.42"
,IN,AR,30331543,1005,100,,Invoice,,,,,,09/11/2018,09/11/2018,0.00,,5.83,,"-1,140,827.25"
,IN,AR,30331548,1005,100,,Invoice,,,,,,09/11/2018,09/11/2018,0.00,,8.21,,"-1,140,835.46"
,IN,AR,30331551,1005,100,,Invoice,,,,,,09/11/2018,09/11/2018,0.00,,29.15,,"-1,140,864.61"
,IN,AR,30331553,1005,100,,Invoice,,,,,,09/11/2018,09/11/2018,0.00,,10.93,,"-1,140,875.54"
,IN,AR,30331556,1005,100,,Invoice,,,,,,09/11/2018,09/11/2018,0.00,,74.15,,"-1,140,949.69"
,IN,AR,30331559,1005,100,,Invoice,,,,,,09/11/2018,09/11/2018,0.00,,182.20,,"-1,141,131.89"
,IN,AR,30331563,1005,100,,Invoice,,,,,,09/11/2018,09/11/2018,0.00,,97.36,,"-1,141,229.25"
,IN,AR,30331566,1005,100,,Invoice,,,,,,09/11/2018,09/11/2018,0.00,,3.64,,"-1,141,232.89"
,IN,AR,30331568,1005,100,,Invoice,,,,,,09/11/2018,09/11/2018,0.00,,29.15,,"-1,141,262.04"
,IN,AR,30331574,1005,100,,Invoice,,,,,,09/11/2018,09/11/2018,0.00,,10.21,,"-1,141,272.25"
,IN,AR,30331584,1005,100,,Invoice,,,,,,09/11/2018,09/11/2018,0.00,,54.66,,"-1,141,326.91"
,IN,AR,30331590,1005,100,,Invoice,,,,,,09/11/2018,09/11/2018,0.00,,5.97,,"-1,141,332.88"
,IN,AR,30331596,1005,100,,Invoice,,,,,,09/11/2018,09/11/2018,0.00,,12.14,,"-1,141,345.02"
,IN,AR,30331633,1005,100,,Invoice,,,,,,09/11/2018,09/11/2018,0.00,,9.31,,"-1,141,354.33"
,IN,AR,30331639,1005,100,,Invoice,,,,,,09/11/2018,09/11/2018,0.00,,4.07,,"-1,141,358.40"
,IN,AR,30331646,1005,100,,Invoice,,,,,,09/11/2018,09/11/2018,0.00,,182.20,,"-1,141,540.60"
,IN,AR,30331650,1005,100,,Invoice,,,,,,09/11/2018,09/11/2018,0.00,,7.29,,"-1,141,547.89"
,IN,AR,30331653,1005,100,,Invoice,,,,,,09/11/2018,09/11/2018,0.00,,29.15,,"-1,141,577.04"
,IN,AR,30331661,1005,100,,Invoice,,,,,,09/11/2018,09/11/2018,0.00,,29.15,,"-1,141,606.19"
,IN,AR,30331666,1005,100,,Invoice,,,,,,09/11/2018,09/11/2018,0.00,,103.15,,"-1,141,709.34"
,IN,AR,30331672,1005,100,,Invoice,,,,,,09/11/2018,09/11/2018,0.00,,29.15,,"-1,141,738.49"
,IN,AR,30331677,1005,100,,Invoice,,,,,,09/11/2018,09/11/2018,0.00,,29.15,,"-1,141,767.64"
,IN,AR,30331687,1005,100,,Invoice,,,,,,09/11/2018,09/11/2018,0.00,,7.29,,"-1,141,774.93"
,IN,AR,30331689,1005,100,,Invoice,,,,,,09/11/2018,09/11/2018,0.00,,8.98,,"-1,141,783.91"
,IN,AR,30331698,1005,100,,Invoice,,,,,,09/11/2018,09/11/2018,0.00,,3.64,,"-1,141,787.55"
,IN,AR,30331704,1005,100,,Invoice,,,,,,09/11/2018,09/11/2018,0.00,,65.59,,"-1,141,853.14"
,IN,AR,30331705,1005,100,,Invoice,,,,,,09/11/2018,09/11/2018,0.00,,65.59,,"-1,141,918.73"
,IN,AR,30331723,1005,100,,Invoice,,,,,,09/11/2018,09/11/2018,0.00,,3.64,,"-1,141,922.37"
,IN,AR,30332774,1005,100,,Invoice,,,,,,09/11/2018,09/11/2018,0.00,,182.20,,"-1,142,104.57"
,IN,AR,30333354,1005,100,,Invoice,,,,,,09/11/2018,09/11/2018,0.00,,6.36,,"-1,142,110.93"
,CS,AR,32010662,1005,100,,Cash sale,,,,,,10/11/2018,10/11/2018,0.00,,10.93,,"-1,142,121.86"
,CS,AR,32010666,1005,100,,Cash sale,,,,,,10/11/2018,10/11/2018,0.00,,7.29,,"-1,142,129.15"
,CS,AR,32010704,1005,100,,Cash sale,,,,,,10/11/2018,10/11/2018,0.00,,7.29,,"-1,142,136.44"
,CS,AR,32010706,1005,100,,Cash sale,,,,,,10/11/2018,10/11/2018,0.00,,14.58,,"-1,142,151.02"
,CS,AR,32010759,1005,100,,Cash sale,,,,,,10/11/2018,10/11/2018,0.00,,7.75,,"-1,142,158.77"
,CS,AR,32010783,1005,100,,Cash sale,,,,,,10/11/2018,10/11/2018,0.00,,7.29,,"-1,142,166.06"
,CS,AR,32010791,1005,100,,Cash sale,,,,,,10/11/2018,10/11/2018,0.00,,3.64,,"-1,142,169.70"
,CS,AR,32010861,1005,100,,Cash sale,,,,,,10/11/2018,10/11/2018,0.00,,10.93,,"-1,142,180.63"
,CS,AR,32010904,1005,100,,Cash sale,,,,,,10/11/2018,10/11/2018,0.00,,10.93,,"-1,142,191.56"
,CS,AR,32010951,1005,100,,Cash sale,,,,,,10/11/2018,10/11/2018,0.00,,10.93,,"-1,142,202.49"
,CS,AR,32010959,1005,100,,Cash sale,,,,,,10/11/2018,10/11/2018,0.00,,10.93,,"-1,142,213.42"
,CS,AR,32010994,1005,100,,Cash sale,,,,,,10/11/2018,10/11/2018,0.00,,10.93,,"-1,142,224.35"
,IN,AR,30330790,1005,100,,Invoice,,,,,,10/11/2018,10/11/2018,0.00,,84.54,,"-1,142,308.89"
,IN,AR,30330816,1005,100,,Invoice,,,,,,10/11/2018,10/11/2018,0.00,,32.00,,"-1,142,340.89"
,IN,AR,30330937,1005,100,,Invoice,,,,,,10/11/2018,10/11/2018,0.00,,25.51,,"-1,142,366.40"
,IN,AR,30330969,1005,100,,Invoice,,,,,,10/11/2018,10/11/2018,0.00,,50.85,,"-1,142,417.25"
,IN,AR,30331242,1005,100,,Invoice,,,,,,10/11/2018,10/11/2018,0.00,,14.58,,"-1,142,431.83"
,IN,AR,30331278,1005,100,,Invoice,,,,,,10/11/2018,10/11/2018,0.00,,14.58,,"-1,142,446.41"
,IN,AR,30331282,1005,100,,Invoice,,,,,,10/11/2018,10/11/2018,0.00,,8.77,,"-1,142,455.18"
,IN,AR,30331358,1005,100,,Invoice,,,,,,10/11/2018,10/11/2018,0.00,,16.40,,"-1,142,471.58"
,IN,AR,30331422,1005,100,,Invoice,,,,,,10/11/2018,10/11/2018,0.00,,9.32,,"-1,142,480.90"
,IN,AR,30331530,1005,100,,Invoice,,,,,,10/11/2018,10/11/2018,0.00,,14.58,,"-1,142,495.48"
,IN,AR,30331651,1005,100,,Invoice,,,,,,10/11/2018,10/11/2018,0.00,,7.29,,"-1,142,502.77"
,IN,AR,30331660,1005,100,,Invoice,,,,,,10/11/2018,10/11/2018,0.00,,10.93,,"-1,142,513.70"
,IN,AR,30331667,1005,100,,Invoice,,,,,,10/11/2018,10/11/2018,0.00,,7.29,,"-1,142,520.99"
,CS,AR,32010866,1005,100,,Cash sale,,,,,,11/11/2018,11/11/2018,0.00,,29.15,,"-1,142,550.14"
,CN,AR,31019408,1005,100,,Credit Note,,,,,,12/11/2018,12/11/2018,54.66,,0.00,,"-1,142,495.48"
,CS,AR,32010649,1005,100,,Cash sale,,,,,,12/11/2018,12/11/2018,0.00,,9.49,,"-1,142,504.97"
,CS,AR,32010655,1005,100,,Cash sale,,,,,,12/11/2018,12/11/2018,0.00,,8.42,,"-1,142,513.39"
,CS,AR,32010668,1005,100,,Cash sale,,,,,,12/11/2018,12/11/2018,0.00,,3.64,,"-1,142,517.03"
,CS,AR,32010680,1005,100,,Cash sale,,,,,,12/11/2018,12/11/2018,0.00,,7.29,,"-1,142,524.32"
,CS,AR,32010686,1005,100,,Cash sale,,,,,,12/11/2018,12/11/2018,0.00,,14.53,,"-1,142,538.85"
,CS,AR,32010694,1005,100,,Cash sale,,,,,,12/11/2018,12/11/2018,0.00,,5.84,,"-1,142,544.69"
,CS,AR,32010697,1005,100,,Cash sale,,,,,,12/11/2018,12/11/2018,0.00,,8.77,,"-1,142,553.46"
,CS,AR,32010699,1005,100,,Cash sale,,,,,,12/11/2018,12/11/2018,0.00,,10.93,,"-1,142,564.39"
,CS,AR,32010713,1005,100,,Cash sale,,,,,,12/11/2018,12/11/2018,0.00,,7.29,,"-1,142,571.68"
,CS,AR,32010718,1005,100,,Cash sale,,,,,,12/11/2018,12/11/2018,0.00,,10.34,,"-1,142,582.02"
,CS,AR,32010723,1005,100,,Cash sale,,,,,,12/11/2018,12/11/2018,0.00,,7.29,,"-1,142,589.31"
,CS,AR,32010725,1005,100,,Cash sale,,,,,,12/11/2018,12/11/2018,0.00,,3.64,,"-1,142,592.95"
,CS,AR,32010754,1005,100,,Cash sale,,,,,,12/11/2018,12/11/2018,0.00,,18.22,,"-1,142,611.17"
,CS,AR,32010764,1005,100,,Cash sale,,,,,,12/11/2018,12/11/2018,0.00,,20.47,,"-1,142,631.64"
,CS,AR,32010766,1005,100,,Cash sale,,,,,,12/11/2018,12/11/2018,0.00,,8.16,,"-1,142,639.80"
,CS,AR,32010767,1005,100,,Cash sale,,,,,,12/11/2018,12/11/2018,0.00,,3.64,,"-1,142,643.44"
,CS,AR,32010770,1005,100,,Cash sale,,,,,,12/11/2018,12/11/2018,0.00,,9.49,,"-1,142,652.93"
,CS,AR,32010774,1005,100,,Cash sale,,,,,,12/11/2018,12/11/2018,0.00,,12.03,,"-1,142,664.96"
,CS,AR,32010778,1005,100,,Cash sale,,,,,,12/11/2018,12/11/2018,0.00,,7.29,,"-1,142,672.25"
,CS,AR,32010787,1005,100,,Cash sale,,,,,,12/11/2018,12/11/2018,0.00,,7.29,,"-1,142,679.54"
,CS,AR,32010796,1005,100,,Cash sale,,,,,,12/11/2018,12/11/2018,0.00,,3.64,,"-1,142,683.18"
,CS,AR,32010801,1005,100,,Cash sale,,,,,,12/11/2018,12/11/2018,0.00,,2.54,,"-1,142,685.72"
,CS,AR,32010818,1005,100,,Cash sale,,,,,,12/11/2018,12/11/2018,0.00,,10.93,,"-1,142,696.65"
,CS,AR,32010831,1005,100,,Cash sale,,,,,,12/11/2018,12/11/2018,0.00,,7.29,,"-1,142,703.94"
,CS,AR,32010835,1005,100,,Cash sale,,,,,,12/11/2018,12/11/2018,0.00,,3.64,,"-1,142,707.58"
,CS,AR,32010879,1005,100,,Cash sale,,,,,,12/11/2018,12/11/2018,0.00,,32.00,,"-1,142,739.58"
,CS,AR,32010887,1005,100,,Cash sale,,,,,,12/11/2018,12/11/2018,0.00,,6.56,,"-1,142,746.14"
,CS,AR,32010889,1005,100,,Cash sale,,,,,,12/11/2018,12/11/2018,0.00,,3.64,,"-1,142,749.78"
,CS,AR,32010899,1005,100,,Cash sale,,,,,,12/11/2018,12/11/2018,0.00,,9.15,,"-1,142,758.93"
,CS,AR,32010901,1005,100,,Cash sale,,,,,,12/11/2018,12/11/2018,0.00,,14.58,,"-1,142,773.51"
,CS,AR,32010913,1005,100,,Cash sale,,,,,,12/11/2018,12/11/2018,0.00,,9.10,,"-1,142,782.61"
,CS,AR,32010924,1005,100,,Cash sale,,,,,,12/11/2018,12/11/2018,0.00,,18.21,,"-1,142,800.82"
,CS,AR,32010948,1005,100,,Cash sale,,,,,,12/11/2018,12/11/2018,0.00,,9.84,,"-1,142,810.66"
,CS,AR,32010967,1005,100,,Cash sale,,,,,,12/11/2018,12/11/2018,0.00,,3.64,,"-1,142,814.30"
,CS,AR,32010990,1005,100,,Cash sale,,,,,,12/11/2018,12/11/2018,0.00,,7.29,,"-1,142,821.59"
,IN,AR,30330742,1005,100,,Invoice,,,,,,12/11/2018,12/11/2018,0.00,,14.58,,"-1,142,836.17"
,IN,AR,30330792,1005,100,,Invoice,,,,,,12/11/2018,12/11/2018,0.00,,14.58,,"-1,142,850.75"
,IN,AR,30330795,1005,100,,Invoice,,,,,,12/11/2018,12/11/2018,0.00,,10.93,,"-1,142,861.68"
,IN,AR,30330824,1005,100,,Invoice,,,,,,12/11/2018,12/11/2018,0.00,,48.00,,"-1,142,909.68"
,IN,AR,30330829,1005,100,,Invoice,,,,,,12/11/2018,12/11/2018,0.00,,61.51,,"-1,142,971.19"
,IN,AR,30330845,1005,100,,Invoice,,,,,,12/11/2018,12/11/2018,0.00,,20.00,,"-1,142,991.19"
,IN,AR,30330846,1005,100,,Invoice,,,,,,12/11/2018,12/11/2018,0.00,,10.00,,"-1,143,001.19"
,IN,AR,30330855,1005,100,,Invoice,,,,,,12/11/2018,12/11/2018,0.00,,20.34,,"-1,143,021.53"
,IN,AR,30330874,1005,100,,Invoice,,,,,,12/11/2018,12/11/2018,0.00,,20.00,,"-1,143,041.53"
,IN,AR,30330910,1005,100,,Invoice,,,,,,12/11/2018,12/11/2018,0.00,,26.00,,"-1,143,067.53"
,IN,AR,30330920,1005,100,,Invoice,,,,,,12/11/2018,12/11/2018,0.00,,12.88,,"-1,143,080.41"
,IN,AR,30330925,1005,100,,Invoice,,,,,,12/11/2018,12/11/2018,0.00,,32.80,,"-1,143,113.21"
,IN,AR,30330962,1005,100,,Invoice,,,,,,12/11/2018,12/11/2018,0.00,,4.24,,"-1,143,117.45"
,IN,AR,30330970,1005,100,,Invoice,,,,,,12/11/2018,12/11/2018,0.00,,20.34,,"-1,143,137.79"
,IN,AR,30330978,1005,100,,Invoice,,,,,,12/11/2018,12/11/2018,0.00,,5.59,,"-1,143,143.38"
,IN,AR,30330984,1005,100,,Invoice,,,,,,12/11/2018,12/11/2018,0.00,,18.09,,"-1,143,161.47"
,IN,AR,30330994,1005,100,,Invoice,,,,,,12/11/2018,12/11/2018,0.00,,13.35,,"-1,143,174.82"
,IN,AR,30331016,1005,100,,Invoice,,,,,,12/11/2018,12/11/2018,0.00,,90.24,,"-1,143,265.06"
,IN,AR,30331024,1005,100,,Invoice,,,,,,12/11/2018,12/11/2018,0.00,,38.14,,"-1,143,303.20"
,IN,AR,30331032,1005,100,,Invoice,,,,,,12/11/2018,12/11/2018,0.00,,21.51,,"-1,143,324.71"
,IN,AR,30331034,1005,100,,Invoice,,,,,,12/11/2018,12/11/2018,0.00,,25.76,,"-1,143,350.47"
,IN,AR,30331038,1005,100,,Invoice,,,,,,12/11/2018,12/11/2018,0.00,,9.03,,"-1,143,359.50"
,IN,AR,30331046,1005,100,,Invoice,,,,,,12/11/2018,12/11/2018,0.00,,75.00,,"-1,143,434.50"
,IN,AR,30331047,1005,100,,Invoice,,,,,,12/11/2018,12/11/2018,0.00,,6.36,,"-1,143,440.86"
,IN,AR,30331054,1005,100,,Invoice,,,,,,12/11/2018,12/11/2018,0.00,,4.78,,"-1,143,445.64"
,IN,AR,30331065,1005,100,,Invoice,,,,,,12/11/2018,12/11/2018,0.00,,7.63,,"-1,143,453.27"
,IN,AR,30331094,1005,100,,Invoice,,,,,,12/11/2018,12/11/2018,0.00,,17.80,,"-1,143,471.07"
,IN,AR,30331113,1005,100,,Invoice,,,,,,12/11/2018,12/11/2018,0.00,,3.64,,"-1,143,474.71"
,IN,AR,30331116,1005,100,,Invoice,,,,,,12/11/2018,12/11/2018,0.00,,10.93,,"-1,143,485.64"
,IN,AR,30331128,1005,100,,Invoice,,,,,,12/11/2018,12/11/2018,0.00,,7.29,,"-1,143,492.93"
,IN,AR,30331136,1005,100,,Invoice,,,,,,12/11/2018,12/11/2018,0.00,,11.48,,"-1,143,504.41"
,IN,AR,30331140,1005,100,,Invoice,,,,,,12/11/2018,12/11/2018,0.00,,25.25,,"-1,143,529.66"
,IN,AR,30331165,1005,100,,Invoice,,,,,,12/11/2018,12/11/2018,0.00,,75.66,,"-1,143,605.32"
,IN,AR,30331171,1005,100,,Invoice,,,,,,12/11/2018,12/11/2018,0.00,,4.00,,"-1,143,609.32"
,IN,AR,30331192,1005,100,,Invoice,,,,,,12/11/2018,12/11/2018,0.00,,42.69,,"-1,143,652.01"
,IN,AR,30331197,1005,100,,Invoice,,,,,,12/11/2018,12/11/2018,0.00,,4.49,,"-1,143,656.50"
,IN,AR,30331200,1005,100,,Invoice,,,,,,12/11/2018,12/11/2018,0.00,,14.58,,"-1,143,671.08"
,IN,AR,30331210,1005,100,,Invoice,,,,,,12/11/2018,12/11/2018,0.00,,19.41,,"-1,143,690.49"
,IN,AR,30331221,1005,100,,Invoice,,,,,,12/11/2018,12/11/2018,0.00,,13.14,,"-1,143,703.63"
,IN,AR,30331237,1005,100,,Invoice,,,,,,12/11/2018,12/11/2018,0.00,,5.29,,"-1,143,708.92"
,IN,AR,30331240,1005,100,,Invoice,,,,,,12/11/2018,12/11/2018,0.00,,14.58,,"-1,143,723.50"
,IN,AR,30331243,1005,100,,Invoice,,,,,,12/11/2018,12/11/2018,0.00,,7.29,,"-1,143,730.79"
,IN,AR,30331247,1005,100,,Invoice,,,,,,12/11/2018,12/11/2018,0.00,,54.66,,"-1,143,785.45"
,IN,AR,30331248,1005,100,,Invoice,,,,,,12/11/2018,12/11/2018,0.00,,25.32,,"-1,143,810.77"
,IN,AR,30331269,1005,100,,Invoice,,,,,,12/11/2018,12/11/2018,0.00,,4.29,,"-1,143,815.06"
,IN,AR,30331271,1005,100,,Invoice,,,,,,12/11/2018,12/11/2018,0.00,,2.84,,"-1,143,817.90"
,IN,AR,30331304,1005,100,,Invoice,,,,,,12/11/2018,12/11/2018,0.00,,1.99,,"-1,143,819.89"
,IN,AR,30331326,1005,100,,Invoice,,,,,,12/11/2018,12/11/2018,0.00,,20.04,,"-1,143,839.93"
,IN,AR,30331327,1005,100,,Invoice,,,,,,12/11/2018,12/11/2018,0.00,,10.93,,"-1,143,850.86"
,IN,AR,30331329,1005,100,,Invoice,,,,,,12/11/2018,12/11/2018,0.00,,18.22,,"-1,143,869.08"
,IN,AR,30331344,1005,100,,Invoice,,,,,,12/11/2018,12/11/2018,0.00,,6.56,,"-1,143,875.64"
,IN,AR,30331352,1005,100,,Invoice,,,,,,12/11/2018,12/11/2018,0.00,,26.27,,"-1,143,901.91"
,IN,AR,30331354,1005,100,,Invoice,,,,,,12/11/2018,12/11/2018,0.00,,4.58,,"-1,143,906.49"
,IN,AR,30331366,1005,100,,Invoice,,,,,,12/11/2018,12/11/2018,0.00,,10.93,,"-1,143,917.42"
,IN,AR,30331379,1005,100,,Invoice,,,,,,12/11/2018,12/11/2018,0.00,,4.00,,"-1,143,921.42"
,IN,AR,30331387,1005,100,,Invoice,,,,,,12/11/2018,12/11/2018,0.00,,12.00,,"-1,143,933.42"
,IN,AR,30331401,1005,100,,Invoice,,,,,,12/11/2018,12/11/2018,0.00,,48.27,,"-1,143,981.69"
,IN,AR,30331417,1005,100,,Invoice,,,,,,12/11/2018,12/11/2018,0.00,,4.20,,"-1,143,985.89"
,IN,AR,30331418,1005,100,,Invoice,,,,,,12/11/2018,12/11/2018,0.00,,8.41,,"-1,143,994.30"
,IN,AR,30331430,1005,100,,Invoice,,,,,,12/11/2018,12/11/2018,0.00,,26.58,,"-1,144,020.88"
,IN,AR,30331432,1005,100,,Invoice,,,,,,12/11/2018,12/11/2018,0.00,,209.75,,"-1,144,230.63"
,IN,AR,30331477,1005,100,,Invoice,,,,,,12/11/2018,12/11/2018,0.00,,32.03,,"-1,144,262.66"
,IN,AR,30331524,1005,100,,Invoice,,,,,,12/11/2018,12/11/2018,0.00,,1.88,,"-1,144,264.54"
,IN,AR,30331525,1005,100,,Invoice,,,,,,12/11/2018,12/11/2018,0.00,,9.41,,"-1,144,273.95"
,IN,AR,30331549,1005,100,,Invoice,,,,,,12/11/2018,12/11/2018,0.00,,8.21,,"-1,144,282.16"
,IN,AR,30331567,1005,100,,Invoice,,,,,,12/11/2018,12/11/2018,0.00,,13.09,,"-1,144,295.25"
,IN,AR,30331575,1005,100,,Invoice,,,,,,12/11/2018,12/11/2018,0.00,,4.08,,"-1,144,299.33"
,IN,AR,30331622,1005,100,,Invoice,,,,,,12/11/2018,12/11/2018,0.00,,4.15,,"-1,144,303.48"
,IN,AR,30331636,1005,100,,Invoice,,,,,,12/11/2018,12/11/2018,0.00,,3.28,,"-1,144,306.76"
,IN,AR,30331649,1005,100,,Invoice,,,,,,12/11/2018,12/11/2018,0.00,,1.75,,"-1,144,308.51"
,IN,AR,30331658,1005,100,,Invoice,,,,,,12/11/2018,12/11/2018,0.00,,8.41,,"-1,144,316.92"
,IN,AR,30331671,1005,100,,Invoice,,,,,,12/11/2018,12/11/2018,0.00,,63.74,,"-1,144,380.66"
,IN,AR,30331712,1005,100,,Invoice,,,,,,12/11/2018,12/11/2018,0.00,,29.15,,"-1,144,409.81"
,CN,AR,31019570,1005,100,,Credit Note,,,,,,12/11/2018,12/11/2018,18.22,,0.00,,"-1,144,391.59"
,CR,AR,33000318,1005,100,,Cash Return,,,,,,12/11/2018,12/11/2018,7.29,,0.00,,"-1,144,384.30"
,CS,AR,32011100,1005,100,,Cash sale,,,,,,12/11/2018,12/11/2018,0.00,,7.29,,"-1,144,391.59"
,CS,AR,32011188,1005,100,,Cash sale,,,,,,12/11/2018,12/11/2018,0.00,,25.42,,"-1,144,417.01"
,CS,AR,32011228,1005,100,,Cash sale,,,,,,12/11/2018,12/11/2018,0.00,,10.93,,"-1,144,427.94"
,CS,AR,32011276,1005,100,,Cash sale,,,,,,12/11/2018,12/11/2018,0.00,,6.48,,"-1,144,434.42"
,CS,AR,32011338,1005,100,,Cash sale,,,,,,12/11/2018,12/11/2018,0.00,,3.64,,"-1,144,438.06"
,CS,AR,32011416,1005,100,,Cash sale,,,,,,12/11/2018,12/11/2018,0.00,,12.71,,"-1,144,450.77"
,CS,AR,32011517,1005,100,,Cash sale,,,,,,12/11/2018,12/11/2018,0.00,,3.64,,"-1,144,454.41"
,CS,AR,32011552,1005,100,,Cash sale,,,,,,12/11/2018,12/11/2018,0.00,,29.15,,"-1,144,483.56"
,IN,AR,30331854,1005,100,,Invoice,,,,,,12/11/2018,12/11/2018,0.00,,98.00,,"-1,144,581.56"
,IN,AR,30331953,1005,100,,Invoice,,,,,,12/11/2018,12/11/2018,0.00,,27.29,,"-1,144,608.85"
,IN,AR,30331954,1005,100,,Invoice,,,,,,12/11/2018,12/11/2018,0.00,,87.32,,"-1,144,696.17"
,IN,AR,30331955,1005,100,,Invoice,,,,,,12/11/2018,12/11/2018,0.00,,13.64,,"-1,144,709.81"
,IN,AR,30332034,1005,100,,Invoice,,,,,,12/11/2018,12/11/2018,0.00,,7.75,,"-1,144,717.56"
,IN,AR,30332052,1005,100,,Invoice,,,,,,12/11/2018,12/11/2018,0.00,,11.48,,"-1,144,729.04"
,IN,AR,30332077,1005,100,,Invoice,,,,,,12/11/2018,12/11/2018,0.00,,18.31,,"-1,144,747.35"
,IN,AR,30332119,1005,100,,Invoice,,,,,,12/11/2018,12/11/2018,0.00,,22.37,,"-1,144,769.72"
,IN,AR,30332191,1005,100,,Invoice,,,,,,12/11/2018,12/11/2018,0.00,,7.29,,"-1,144,777.01"
,IN,AR,30332291,1005,100,,Invoice,,,,,,12/11/2018,12/11/2018,0.00,,26.44,,"-1,144,803.45"
,IN,AR,30332343,1005,100,,Invoice,,,,,,12/11/2018,12/11/2018,0.00,,3.64,,"-1,144,807.09"
,IN,AR,30332439,1005,100,,Invoice,,,,,,12/11/2018,12/11/2018,0.00,,6.02,,"-1,144,813.11"
,IN,AR,30332674,1005,100,,Invoice,,,,,,12/11/2018,12/11/2018,0.00,,18.22,,"-1,144,831.33"
,IN,AR,30332675,1005,100,,Invoice,,,,,,12/11/2018,12/11/2018,0.00,,21.86,,"-1,144,853.19"
,IN,AR,30332840,1005,100,,Invoice,,,,,,12/11/2018,12/11/2018,0.00,,19.12,,"-1,144,872.31"
,IN,AR,30332870,1005,100,,Invoice,,,,,,12/11/2018,12/11/2018,0.00,,25.51,,"-1,144,897.82"
,IN,AR,30333008,1005,100,,Invoice,,,,,,12/11/2018,12/11/2018,0.00,,11.95,,"-1,144,909.77"
,IN,AR,30333017,1005,100,,Invoice,,,,,,12/11/2018,12/11/2018,0.00,,17.54,,"-1,144,927.31"
,IN,AR,30333032,1005,100,,Invoice,,,,,,12/11/2018,12/11/2018,0.00,,6.23,,"-1,144,933.54"
,IN,AR,30333102,1005,100,,Invoice,,,,,,12/11/2018,12/11/2018,0.00,,7.29,,"-1,144,940.83"
,CN,AR,31019502,1005,100,,Credit Note,,,,,,13/11/2018,13/11/2018,40.08,,0.00,,"-1,144,900.75"
,CN,AR,31019552,1005,100,,Credit Note,,,,,,13/11/2018,13/11/2018,32.15,,0.00,,"-1,144,868.60"
,CN,AR,31019620,1005,100,,Credit Note,,,,,,13/11/2018,13/11/2018,3.64,,0.00,,"-1,144,864.96"
,CS,AR,32011048,1005,100,,Cash sale,,,,,,13/11/2018,13/11/2018,0.00,,7.29,,"-1,144,872.25"
,CS,AR,32011071,1005,100,,Cash sale,,,,,,13/11/2018,13/11/2018,0.00,,21.86,,"-1,144,894.11"
,CS,AR,32011085,1005,100,,Cash sale,,,,,,13/11/2018,13/11/2018,0.00,,6.02,,"-1,144,900.13"
,CS,AR,32011090,1005,100,,Cash sale,,,,,,13/11/2018,13/11/2018,0.00,,10.93,,"-1,144,911.06"
,CS,AR,32011108,1005,100,,Cash sale,,,,,,13/11/2018,13/11/2018,0.00,,3.64,,"-1,144,914.70"
,CS,AR,32011136,1005,100,,Cash sale,,,,,,13/11/2018,13/11/2018,0.00,,14.58,,"-1,144,929.28"
,CS,AR,32011174,1005,100,,Cash sale,,,,,,13/11/2018,13/11/2018,0.00,,3.64,,"-1,144,932.92"
,CS,AR,32011180,1005,100,,Cash sale,,,,,,13/11/2018,13/11/2018,0.00,,6.48,,"-1,144,939.40"
,CS,AR,32011187,1005,100,,Cash sale,,,,,,13/11/2018,13/11/2018,0.00,,5.17,,"-1,144,944.57"
,CS,AR,32011198,1005,100,,Cash sale,,,,,,13/11/2018,13/11/2018,0.00,,2.84,,"-1,144,947.41"
,CS,AR,32011206,1005,100,,Cash sale,,,,,,13/11/2018,13/11/2018,0.00,,7.29,,"-1,144,954.70"
,CS,AR,32011233,1005,100,,Cash sale,,,,,,13/11/2018,13/11/2018,0.00,,3.64,,"-1,144,958.34"
,CS,AR,32011234,1005,100,,Cash sale,,,,,,13/11/2018,13/11/2018,0.00,,10.93,,"-1,144,969.27"
,CS,AR,32011239,1005,100,,Cash sale,,,,,,13/11/2018,13/11/2018,0.00,,8.58,,"-1,144,977.85"
,CS,AR,32011242,1005,100,,Cash sale,,,,,,13/11/2018,13/11/2018,0.00,,5.17,,"-1,144,983.02"
,CS,AR,32011250,1005,100,,Cash sale,,,,,,13/11/2018,13/11/2018,0.00,,4.49,,"-1,144,987.51"
,CS,AR,32011262,1005,100,,Cash sale,,,,,,13/11/2018,13/11/2018,0.00,,5.85,,"-1,144,993.36"
,CS,AR,32011274,1005,100,,Cash sale,,,,,,13/11/2018,13/11/2018,0.00,,7.29,,"-1,145,000.65"
,CS,AR,32011277,1005,100,,Cash sale,,,,,,13/11/2018,13/11/2018,0.00,,7.80,,"-1,145,008.45"
,CS,AR,32011295,1005,100,,Cash sale,,,,,,13/11/2018,13/11/2018,0.00,,12.71,,"-1,145,021.16"
,CS,AR,32011304,1005,100,,Cash sale,,,,,,13/11/2018,13/11/2018,0.00,,10.34,,"-1,145,031.50"
,CS,AR,32011317,1005,100,,Cash sale,,,,,,13/11/2018,13/11/2018,0.00,,5.17,,"-1,145,036.67"
,CS,AR,32011325,1005,100,,Cash sale,,,,,,13/11/2018,13/11/2018,0.00,,10.93,,"-1,145,047.60"
,CS,AR,32011327,1005,100,,Cash sale,,,,,,13/11/2018,13/11/2018,0.00,,7.63,,"-1,145,055.23"
,CS,AR,32011334,1005,100,,Cash sale,,,,,,13/11/2018,13/11/2018,0.00,,3.64,,"-1,145,058.87"
,CS,AR,32011335,1005,100,,Cash sale,,,,,,13/11/2018,13/11/2018,0.00,,10.93,,"-1,145,069.80"
,CS,AR,32011347,1005,100,,Cash sale,,,,,,13/11/2018,13/11/2018,0.00,,3.64,,"-1,145,073.44"
,CS,AR,32011363,1005,100,,Cash sale,,,,,,13/11/2018,13/11/2018,0.00,,7.29,,"-1,145,080.73"
,CS,AR,32011369,1005,100,,Cash sale,,,,,,13/11/2018,13/11/2018,0.00,,5.17,,"-1,145,085.90"
,CS,AR,32011372,1005,100,,Cash sale,,,,,,13/11/2018,13/11/2018,0.00,,12.88,,"-1,145,098.78"
,CS,AR,32011373,1005,100,,Cash sale,,,,,,13/11/2018,13/11/2018,0.00,,7.29,,"-1,145,106.07"
,CS,AR,32011409,1005,100,,Cash sale,,,,,,13/11/2018,13/11/2018,0.00,,10.95,,"-1,145,117.02"
,CS,AR,32011410,1005,100,,Cash sale,,,,,,13/11/2018,13/11/2018,0.00,,10.93,,"-1,145,127.95"
,CS,AR,32011414,1005,100,,Cash sale,,,,,,13/11/2018,13/11/2018,0.00,,29.15,,"-1,145,157.10"
,CS,AR,32011428,1005,100,,Cash sale,,,,,,13/11/2018,13/11/2018,0.00,,29.15,,"-1,145,186.25"
,CS,AR,32011440,1005,100,,Cash sale,,,,,,13/11/2018,13/11/2018,0.00,,15.25,,"-1,145,201.50"
,CS,AR,32011446,1005,100,,Cash sale,,,,,,13/11/2018,13/11/2018,0.00,,7.29,,"-1,145,208.79"
,CS,AR,32011453,1005,100,,Cash sale,,,,,,13/11/2018,13/11/2018,0.00,,10.93,,"-1,145,219.72"
,CS,AR,32011489,1005,100,,Cash sale,,,,,,13/11/2018,13/11/2018,0.00,,5.50,,"-1,145,225.22"
,CS,AR,32011492,1005,100,,Cash sale,,,,,,13/11/2018,13/11/2018,0.00,,14.58,,"-1,145,239.80"
,CS,AR,32011503,1005,100,,Cash sale,,,,,,13/11/2018,13/11/2018,0.00,,7.29,,"-1,145,247.09"
,CS,AR,32011525,1005,100,,Cash sale,,,,,,13/11/2018,13/11/2018,0.00,,10.93,,"-1,145,258.02"
,CS,AR,32011541,1005,100,,Cash sale,,,,,,13/11/2018,13/11/2018,0.00,,7.29,,"-1,145,265.31"
,CS,AR,32011547,1005,100,,Cash sale,,,,,,13/11/2018,13/11/2018,0.00,,10.93,,"-1,145,276.24"
,CS,AR,32011550,1005,100,,Cash sale,,,,,,13/11/2018,13/11/2018,0.00,,16.42,,"-1,145,292.66"
,CS,AR,32011580,1005,100,,Cash sale,,,,,,13/11/2018,13/11/2018,0.00,,7.75,,"-1,145,300.41"
,CS,AR,32011628,1005,100,,Cash sale,,,,,,13/11/2018,13/11/2018,0.00,,3.64,,"-1,145,304.05"
,CS,AR,32011637,1005,100,,Cash sale,,,,,,13/11/2018,13/11/2018,0.00,,3.64,,"-1,145,307.69"
,CS,AR,32011650,1005,100,,Cash sale,,,,,,13/11/2018,13/11/2018,0.00,,2.97,,"-1,145,310.66"
,CS,AR,32011652,1005,100,,Cash sale,,,,,,13/11/2018,13/11/2018,0.00,,3.64,,"-1,145,314.30"
,CS,AR,32011666,1005,100,,Cash sale,,,,,,13/11/2018,13/11/2018,0.00,,14.58,,"-1,145,328.88"
,IN,AR,30331728,1005,100,,Invoice,,,,,,13/11/2018,13/11/2018,0.00,,6.02,,"-1,145,334.90"
,IN,AR,30331766,1005,100,,Invoice,,,,,,13/11/2018,13/11/2018,0.00,,43.97,,"-1,145,378.87"
,IN,AR,30331820,1005,100,,Invoice,,,,,,13/11/2018,13/11/2018,0.00,,7.00,,"-1,145,385.87"
,IN,AR,30331831,1005,100,,Invoice,,,,,,13/11/2018,13/11/2018,0.00,,18.22,,"-1,145,404.09"
,IN,AR,30331846,1005,100,,Invoice,,,,,,13/11/2018,13/11/2018,0.00,,5.97,,"-1,145,410.06"
,IN,AR,30331855,1005,100,,Invoice,,,,,,13/11/2018,13/11/2018,0.00,,8.00,,"-1,145,418.06"
,IN,AR,30331870,1005,100,,Invoice,,,,,,13/11/2018,13/11/2018,0.00,,10.93,,"-1,145,428.99"
,IN,AR,30331874,1005,100,,Invoice,,,,,,13/11/2018,13/11/2018,0.00,,40.08,,"-1,145,469.07"
,IN,AR,30331885,1005,100,,Invoice,,,,,,13/11/2018,13/11/2018,0.00,,10.93,,"-1,145,480.00"
,IN,AR,30331891,1005,100,,Invoice,,,,,,13/11/2018,13/11/2018,0.00,,54.66,,"-1,145,534.66"
,IN,AR,30331928,1005,100,,Invoice,,,,,,13/11/2018,13/11/2018,0.00,,10.93,,"-1,145,545.59"
,IN,AR,30331947,1005,100,,Invoice,,,,,,13/11/2018,13/11/2018,0.00,,21.86,,"-1,145,567.45"
,IN,AR,30331967,1005,100,,Invoice,,,,,,13/11/2018,13/11/2018,0.00,,7.76,,"-1,145,575.21"
,IN,AR,30331986,1005,100,,Invoice,,,,,,13/11/2018,13/11/2018,0.00,,24.73,,"-1,145,599.94"
,IN,AR,30331989,1005,100,,Invoice,,,,,,13/11/2018,13/11/2018,0.00,,7.29,,"-1,145,607.23"
,IN,AR,30332038,1005,100,,Invoice,,,,,,13/11/2018,13/11/2018,0.00,,21.97,,"-1,145,629.20"
,IN,AR,30332069,1005,100,,Invoice,,,,,,13/11/2018,13/11/2018,0.00,,6.36,,"-1,145,635.56"
,IN,AR,30332078,1005,100,,Invoice,,,,,,13/11/2018,13/11/2018,0.00,,56.95,,"-1,145,692.51"
,IN,AR,30332087,1005,100,,Invoice,,,,,,13/11/2018,13/11/2018,0.00,,10.59,,"-1,145,703.10"
,IN,AR,30332128,1005,100,,Invoice,,,,,,13/11/2018,13/11/2018,0.00,,12.03,,"-1,145,715.13"
,IN,AR,30332137,1005,100,,Invoice,,,,,,13/11/2018,13/11/2018,0.00,,5.85,,"-1,145,720.98"
,IN,AR,30332154,1005,100,,Invoice,,,,,,13/11/2018,13/11/2018,0.00,,5.17,,"-1,145,726.15"
,IN,AR,30332156,1005,100,,Invoice,,,,,,13/11/2018,13/11/2018,0.00,,4.78,,"-1,145,730.93"
,IN,AR,30332176,1005,100,,Invoice,,,,,,13/11/2018,13/11/2018,0.00,,54.66,,"-1,145,785.59"
,IN,AR,30332243,1005,100,,Invoice,,,,,,13/11/2018,13/11/2018,0.00,,20.34,,"-1,145,805.93"
,IN,AR,30332277,1005,100,,Invoice,,,,,,13/11/2018,13/11/2018,0.00,,19.58,,"-1,145,825.51"
,IN,AR,30332289,1005,100,,Invoice,,,,,,13/11/2018,13/11/2018,0.00,,3.01,,"-1,145,828.52"
,IN,AR,30332301,1005,100,,Invoice,,,,,,13/11/2018,13/11/2018,0.00,,6.61,,"-1,145,835.13"
,IN,AR,30332305,1005,100,,Invoice,,,,,,13/11/2018,13/11/2018,0.00,,2.39,,"-1,145,837.52"
,IN,AR,30332307,1005,100,,Invoice,,,,,,13/11/2018,13/11/2018,0.00,,15.25,,"-1,145,852.77"
,IN,AR,30332311,1005,100,,Invoice,,,,,,13/11/2018,13/11/2018,0.00,,54.66,,"-1,145,907.43"
,IN,AR,30332312,1005,100,,Invoice,,,,,,13/11/2018,13/11/2018,0.00,,12.28,,"-1,145,919.71"
,IN,AR,30332328,1005,100,,Invoice,,,,,,13/11/2018,13/11/2018,0.00,,4.24,,"-1,145,923.95"
,IN,AR,30332331,1005,100,,Invoice,,,,,,13/11/2018,13/11/2018,0.00,,4.29,,"-1,145,928.24"
,IN,AR,30332337,1005,100,,Invoice,,,,,,13/11/2018,13/11/2018,0.00,,7.29,,"-1,145,935.53"
,IN,AR,30332355,1005,100,,Invoice,,,,,,13/11/2018,13/11/2018,0.00,,6.36,,"-1,145,941.89"
,IN,AR,30332400,1005,100,,Invoice,,,,,,13/11/2018,13/11/2018,0.00,,24.56,,"-1,145,966.45"
,IN,AR,30332414,1005,100,,Invoice,,,,,,13/11/2018,13/11/2018,0.00,,11.02,,"-1,145,977.47"
,IN,AR,30332419,1005,100,,Invoice,,,,,,13/11/2018,13/11/2018,0.00,,5.59,,"-1,145,983.06"
,IN,AR,30332427,1005,100,,Invoice,,,,,,13/11/2018,13/11/2018,0.00,,5.86,,"-1,145,988.92"
,IN,AR,30332455,1005,100,,Invoice,,,,,,13/11/2018,13/11/2018,0.00,,5.86,,"-1,145,994.78"
,IN,AR,30332469,1005,100,,Invoice,,,,,,13/11/2018,13/11/2018,0.00,,7.29,,"-1,146,002.07"
,IN,AR,30332474,1005,100,,Invoice,,,,,,13/11/2018,13/11/2018,0.00,,10.72,,"-1,146,012.79"
,IN,AR,30332480,1005,100,,Invoice,,,,,,13/11/2018,13/11/2018,0.00,,25.73,,"-1,146,038.52"
,IN,AR,30332487,1005,100,,Invoice,,,,,,13/11/2018,13/11/2018,0.00,,3.53,,"-1,146,042.05"
,IN,AR,30332515,1005,100,,Invoice,,,,,,13/11/2018,13/11/2018,0.00,,5.17,,"-1,146,047.22"
,IN,AR,30332518,1005,100,,Invoice,,,,,,13/11/2018,13/11/2018,0.00,,52.97,,"-1,146,100.19"
,IN,AR,30332520,1005,100,,Invoice,,,,,,13/11/2018,13/11/2018,0.00,,13.69,,"-1,146,113.88"
,IN,AR,30332524,1005,100,,Invoice,,,,,,13/11/2018,13/11/2018,0.00,,10.93,,"-1,146,124.81"
,IN,AR,30332536,1005,100,,Invoice,,,,,,13/11/2018,13/11/2018,0.00,,8.78,,"-1,146,133.59"
,IN,AR,30332577,1005,100,,Invoice,,,,,,13/11/2018,13/11/2018,0.00,,13.93,,"-1,146,147.52"
,IN,AR,30332578,1005,100,,Invoice,,,,,,13/11/2018,13/11/2018,0.00,,11.94,,"-1,146,159.46"
,IN,AR,30332598,1005,100,,Invoice,,,,,,13/11/2018,13/11/2018,0.00,,36.91,,"-1,146,196.37"
,IN,AR,30332631,1005,100,,Invoice,,,,,,13/11/2018,13/11/2018,0.00,,3.01,,"-1,146,199.38"
,IN,AR,30332638,1005,100,,Invoice,,,,,,13/11/2018,13/11/2018,0.00,,191.31,,"-1,146,390.69"
,IN,AR,30332681,1005,100,,Invoice,,,,,,13/11/2018,13/11/2018,0.00,,5.08,,"-1,146,395.77"
,IN,AR,30332702,1005,100,,Invoice,,,,,,13/11/2018,13/11/2018,0.00,,18.01,,"-1,146,413.78"
,IN,AR,30332731,1005,100,,Invoice,,,,,,13/11/2018,13/11/2018,0.00,,18.22,,"-1,146,432.00"
,IN,AR,30332749,1005,100,,Invoice,,,,,,13/11/2018,13/11/2018,0.00,,3.64,,"-1,146,435.64"
,IN,AR,30332757,1005,100,,Invoice,,,,,,13/11/2018,13/11/2018,0.00,,11.66,,"-1,146,447.30"
,IN,AR,30332790,1005,100,,Invoice,,,,,,13/11/2018,13/11/2018,0.00,,120.00,,"-1,146,567.30"
,IN,AR,30332803,1005,100,,Invoice,,,,,,13/11/2018,13/11/2018,0.00,,30.85,,"-1,146,598.15"
,IN,AR,30332829,1005,100,,Invoice,,,,,,13/11/2018,13/11/2018,0.00,,5.08,,"-1,146,603.23"
,IN,AR,30332862,1005,100,,Invoice,,,,,,13/11/2018,13/11/2018,0.00,,97.63,,"-1,146,700.86"
,IN,AR,30332873,1005,100,,Invoice,,,,,,13/11/2018,13/11/2018,0.00,,35.59,,"-1,146,736.45"
,IN,AR,30332874,1005,100,,Invoice,,,,,,13/11/2018,13/11/2018,0.00,,47.46,,"-1,146,783.91"
,IN,AR,30332875,1005,100,,Invoice,,,,,,13/11/2018,13/11/2018,0.00,,75.94,,"-1,146,859.85"
,IN,AR,30332883,1005,100,,Invoice,,,,,,13/11/2018,13/11/2018,0.00,,16.27,,"-1,146,876.12"
,IN,AR,30332918,1005,100,,Invoice,,,,,,13/11/2018,13/11/2018,0.00,,3.76,,"-1,146,879.88"
,IN,AR,30332919,1005,100,,Invoice,,,,,,13/11/2018,13/11/2018,0.00,,5.64,,"-1,146,885.52"
,IN,AR,30332926,1005,100,,Invoice,,,,,,13/11/2018,13/11/2018,0.00,,3.51,,"-1,146,889.03"
,IN,AR,30332930,1005,100,,Invoice,,,,,,13/11/2018,13/11/2018,0.00,,12.00,,"-1,146,901.03"
,IN,AR,30332939,1005,100,,Invoice,,,,,,13/11/2018,13/11/2018,0.00,,121.02,,"-1,147,022.05"
,IN,AR,30332942,1005,100,,Invoice,,,,,,13/11/2018,13/11/2018,0.00,,7.29,,"-1,147,029.34"
,IN,AR,30332946,1005,100,,Invoice,,,,,,13/11/2018,13/11/2018,0.00,,7.02,,"-1,147,036.36"
,IN,AR,30332984,1005,100,,Invoice,,,,,,13/11/2018,13/11/2018,0.00,,20.42,,"-1,147,056.78"
,IN,AR,30332985,1005,100,,Invoice,,,,,,13/11/2018,13/11/2018,0.00,,51.06,,"-1,147,107.84"
,IN,AR,30333033,1005,100,,Invoice,,,,,,13/11/2018,13/11/2018,0.00,,4.15,,"-1,147,111.99"
,IN,AR,30333034,1005,100,,Invoice,,,,,,13/11/2018,13/11/2018,0.00,,14.53,,"-1,147,126.52"
,IN,AR,30333035,1005,100,,Invoice,,,,,,13/11/2018,13/11/2018,0.00,,4.15,,"-1,147,130.67"
,IN,AR,30333082,1005,100,,Invoice,,,,,,13/11/2018,13/11/2018,0.00,,14.49,,"-1,147,145.16"
,IN,AR,30333112,1005,100,,Invoice,,,,,,13/11/2018,13/11/2018,0.00,,10.17,,"-1,147,155.33"
,IN,AR,30333143,1005,100,,Invoice,,,,,,13/11/2018,13/11/2018,0.00,,109.22,,"-1,147,264.55"
,IN,AR,30333162,1005,100,,Invoice,,,,,,13/11/2018,13/11/2018,0.00,,10.93,,"-1,147,275.48"
,IN,AR,30333169,1005,100,,Invoice,,,,,,13/11/2018,13/11/2018,0.00,,29.15,,"-1,147,304.63"
,IN,AR,30333190,1005,100,,Invoice,,,,,,13/11/2018,13/11/2018,0.00,,54.66,,"-1,147,359.29"
,IN,AR,30333193,1005,100,,Invoice,,,,,,13/11/2018,13/11/2018,0.00,,5.47,,"-1,147,364.76"
,CN,AR,31019519,1005,100,,Credit Note,,,,,,14/11/2018,14/11/2018,18.31,,0.00,,"-1,147,346.45"
,CS,AR,32011024,1005,100,,Cash sale,,,,,,14/11/2018,14/11/2018,0.00,,11.22,,"-1,147,357.67"
,CS,AR,32011031,1005,100,,Cash sale,,,,,,14/11/2018,14/11/2018,0.00,,30.10,,"-1,147,387.77"
,CS,AR,32011060,1005,100,,Cash sale,,,,,,14/11/2018,14/11/2018,0.00,,3.64,,"-1,147,391.41"
,CS,AR,32011079,1005,100,,Cash sale,,,,,,14/11/2018,14/11/2018,0.00,,3.64,,"-1,147,395.05"
,CS,AR,32011098,1005,100,,Cash sale,,,,,,14/11/2018,14/11/2018,0.00,,10.93,,"-1,147,405.98"
,CS,AR,32011114,1005,100,,Cash sale,,,,,,14/11/2018,14/11/2018,0.00,,7.29,,"-1,147,413.27"
,CS,AR,32011128,1005,100,,Cash sale,,,,,,14/11/2018,14/11/2018,0.00,,7.29,,"-1,147,420.56"
,CS,AR,32011156,1005,100,,Cash sale,,,,,,14/11/2018,14/11/2018,0.00,,2.92,,"-1,147,423.48"
,CS,AR,32011164,1005,100,,Cash sale,,,,,,14/11/2018,14/11/2018,0.00,,7.29,,"-1,147,430.77"
,CS,AR,32011169,1005,100,,Cash sale,,,,,,14/11/2018,14/11/2018,0.00,,10.34,,"-1,147,441.11"
,CS,AR,32011172,1005,100,,Cash sale,,,,,,14/11/2018,14/11/2018,0.00,,7.29,,"-1,147,448.40"
,CS,AR,32011197,1005,100,,Cash sale,,,,,,14/11/2018,14/11/2018,0.00,,14.58,,"-1,147,462.98"
,CS,AR,32011201,1005,100,,Cash sale,,,,,,14/11/2018,14/11/2018,0.00,,10.34,,"-1,147,473.32"
,CS,AR,32011213,1005,100,,Cash sale,,,,,,14/11/2018,14/11/2018,0.00,,3.64,,"-1,147,476.96"
,CS,AR,32011222,1005,100,,Cash sale,,,,,,14/11/2018,14/11/2018,0.00,,6.43,,"-1,147,483.39"
,CS,AR,32011236,1005,100,,Cash sale,,,,,,14/11/2018,14/11/2018,0.00,,10.93,,"-1,147,494.32"
,CS,AR,32011244,1005,100,,Cash sale,,,,,,14/11/2018,14/11/2018,0.00,,3.64,,"-1,147,497.96"
,CS,AR,32011328,1005,100,,Cash sale,,,,,,14/11/2018,14/11/2018,0.00,,5.08,,"-1,147,503.04"
,CS,AR,32011340,1005,100,,Cash sale,,,,,,14/11/2018,14/11/2018,0.00,,18.22,,"-1,147,521.26"
,CS,AR,32011349,1005,100,,Cash sale,,,,,,14/11/2018,14/11/2018,0.00,,10.93,,"-1,147,532.19"
,CS,AR,32011403,1005,100,,Cash sale,,,,,,14/11/2018,14/11/2018,0.00,,16.61,,"-1,147,548.80"
,CS,AR,32011407,1005,100,,Cash sale,,,,,,14/11/2018,14/11/2018,0.00,,3.64,,"-1,147,552.44"
,CS,AR,32011412,1005,100,,Cash sale,,,,,,14/11/2018,14/11/2018,0.00,,7.29,,"-1,147,559.73"
,CS,AR,32011435,1005,100,,Cash sale,,,,,,14/11/2018,14/11/2018,0.00,,3.64,,"-1,147,563.37"
,CS,AR,32011438,1005,100,,Cash sale,,,,,,14/11/2018,14/11/2018,0.00,,2.29,,"-1,147,565.66"
,CS,AR,32011466,1005,100,,Cash sale,,,,,,14/11/2018,14/11/2018,0.00,,9.15,,"-1,147,574.81"
,CS,AR,32011481,1005,100,,Cash sale,,,,,,14/11/2018,14/11/2018,0.00,,7.29,,"-1,147,582.10"
,CS,AR,32011496,1005,100,,Cash sale,,,,,,14/11/2018,14/11/2018,0.00,,9.03,,"-1,147,591.13"
,CS,AR,32011533,1005,100,,Cash sale,,,,,,14/11/2018,14/11/2018,0.00,,12.14,,"-1,147,603.27"
,CS,AR,32011545,1005,100,,Cash sale,,,,,,14/11/2018,14/11/2018,0.00,,9.84,,"-1,147,613.11"
,CS,AR,32011555,1005,100,,Cash sale,,,,,,14/11/2018,14/11/2018,0.00,,7.29,,"-1,147,620.40"
,CS,AR,32011567,1005,100,,Cash sale,,,,,,14/11/2018,14/11/2018,0.00,,13.74,,"-1,147,634.14"
,CS,AR,32011570,1005,100,,Cash sale,,,,,,14/11/2018,14/11/2018,0.00,,3.64,,"-1,147,637.78"
,CS,AR,32011634,1005,100,,Cash sale,,,,,,14/11/2018,14/11/2018,0.00,,10.93,,"-1,147,648.71"
,CS,AR,32011662,1005,100,,Cash sale,,,,,,14/11/2018,14/11/2018,0.00,,5.93,,"-1,147,654.64"
,CS,AR,32011672,1005,100,,Cash sale,,,,,,14/11/2018,14/11/2018,0.00,,29.15,,"-1,147,683.79"
,IN,AR,30331733,1005,100,,Invoice,,,,,,14/11/2018,14/11/2018,0.00,,71.19,,"-1,147,754.98"
,IN,AR,30331755,1005,100,,Invoice,,,,,,14/11/2018,14/11/2018,0.00,,14.58,,"-1,147,769.56"
,IN,AR,30331760,1005,100,,Invoice,,,,,,14/11/2018,14/11/2018,0.00,,21.97,,"-1,147,791.53"
,IN,AR,30331761,1005,100,,Invoice,,,,,,14/11/2018,14/11/2018,0.00,,58.58,,"-1,147,850.11"
,IN,AR,30331782,1005,100,,Invoice,,,,,,14/11/2018,14/11/2018,0.00,,16.27,,"-1,147,866.38"
,IN,AR,30331788,1005,100,,Invoice,,,,,,14/11/2018,14/11/2018,0.00,,5.68,,"-1,147,872.06"
,IN,AR,30331790,1005,100,,Invoice,,,,,,14/11/2018,14/11/2018,0.00,,10.93,,"-1,147,882.99"
,IN,AR,30331796,1005,100,,Invoice,,,,,,14/11/2018,14/11/2018,0.00,,91.10,,"-1,147,974.09"
,IN,AR,30331797,1005,100,,Invoice,,,,,,14/11/2018,14/11/2018,0.00,,14.58,,"-1,147,988.67"
,IN,AR,30331799,1005,100,,Invoice,,,,,,14/11/2018,14/11/2018,0.00,,68.31,,"-1,148,056.98"
,IN,AR,30331800,1005,100,,Invoice,,,,,,14/11/2018,14/11/2018,0.00,,26.27,,"-1,148,083.25"
,IN,AR,30331808,1005,100,,Invoice,,,,,,14/11/2018,14/11/2018,0.00,,10.93,,"-1,148,094.18"
,IN,AR,30331811,1005,100,,Invoice,,,,,,14/11/2018,14/11/2018,0.00,,16.91,,"-1,148,111.09"
,IN,AR,30331847,1005,100,,Invoice,,,,,,14/11/2018,14/11/2018,0.00,,3.98,,"-1,148,115.07"
,IN,AR,30331856,1005,100,,Invoice,,,,,,14/11/2018,14/11/2018,0.00,,72.00,,"-1,148,187.07"
,IN,AR,30331882,1005,100,,Invoice,,,,,,14/11/2018,14/11/2018,0.00,,7.29,,"-1,148,194.36"
,IN,AR,30331896,1005,100,,Invoice,,,,,,14/11/2018,14/11/2018,0.00,,10.93,,"-1,148,205.29"
,IN,AR,30331898,1005,100,,Invoice,,,,,,14/11/2018,14/11/2018,0.00,,7.29,,"-1,148,212.58"
,IN,AR,30331905,1005,100,,Invoice,,,,,,14/11/2018,14/11/2018,0.00,,42.00,,"-1,148,254.58"
,IN,AR,30331906,1005,100,,Invoice,,,,,,14/11/2018,14/11/2018,0.00,,6.00,,"-1,148,260.58"
,IN,AR,30331929,1005,100,,Invoice,,,,,,14/11/2018,14/11/2018,0.00,,24.00,,"-1,148,284.58"
,IN,AR,30331945,1005,100,,Invoice,,,,,,14/11/2018,14/11/2018,0.00,,3.64,,"-1,148,288.22"
,IN,AR,30331956,1005,100,,Invoice,,,,,,14/11/2018,14/11/2018,0.00,,79.14,,"-1,148,367.36"
,IN,AR,30331960,1005,100,,Invoice,,,,,,14/11/2018,14/11/2018,0.00,,182.20,,"-1,148,549.56"
,IN,AR,30331991,1005,100,,Invoice,,,,,,14/11/2018,14/11/2018,0.00,,12.03,,"-1,148,561.59"
,IN,AR,30332004,1005,100,,Invoice,,,,,,14/11/2018,14/11/2018,0.00,,23.87,,"-1,148,585.46"
,IN,AR,30332017,1005,100,,Invoice,,,,,,14/11/2018,14/11/2018,0.00,,9.56,,"-1,148,595.02"
,IN,AR,30332063,1005,100,,Invoice,,,,,,14/11/2018,14/11/2018,0.00,,30.51,,"-1,148,625.53"
,IN,AR,30332073,1005,100,,Invoice,,,,,,14/11/2018,14/11/2018,0.00,,4.24,,"-1,148,629.77"
,IN,AR,30332079,1005,100,,Invoice,,,,,,14/11/2018,14/11/2018,0.00,,36.61,,"-1,148,666.38"
,IN,AR,30332084,1005,100,,Invoice,,,,,,14/11/2018,14/11/2018,0.00,,4.24,,"-1,148,670.62"
,IN,AR,30332089,1005,100,,Invoice,,,,,,14/11/2018,14/11/2018,0.00,,5.59,,"-1,148,676.21"
,IN,AR,30332110,1005,100,,Invoice,,,,,,14/11/2018,14/11/2018,0.00,,7.76,,"-1,148,683.97"
,IN,AR,30332118,1005,100,,Invoice,,,,,,14/11/2018,14/11/2018,0.00,,1.95,,"-1,148,685.92"
,IN,AR,30332121,1005,100,,Invoice,,,,,,14/11/2018,14/11/2018,0.00,,14.58,,"-1,148,700.50"
,IN,AR,30332133,1005,100,,Invoice,,,,,,14/11/2018,14/11/2018,0.00,,16.73,,"-1,148,717.23"
,IN,AR,30332140,1005,100,,Invoice,,,,,,14/11/2018,14/11/2018,0.00,,82.03,,"-1,148,799.26"
,IN,AR,30332183,1005,100,,Invoice,,,,,,14/11/2018,14/11/2018,0.00,,10.93,,"-1,148,810.19"
,IN,AR,30332195,1005,100,,Invoice,,,,,,14/11/2018,14/11/2018,0.00,,5.17,,"-1,148,815.36"
,IN,AR,30332202,1005,100,,Invoice,,,,,,14/11/2018,14/11/2018,0.00,,144.04,,"-1,148,959.40"
,IN,AR,30332205,1005,100,,Invoice,,,,,,14/11/2018,14/11/2018,0.00,,2.54,,"-1,148,961.94"
,IN,AR,30332206,1005,100,,Invoice,,,,,,14/11/2018,14/11/2018,0.00,,2.54,,"-1,148,964.48"
,IN,AR,30332213,1005,100,,Invoice,,,,,,14/11/2018,14/11/2018,0.00,,5.08,,"-1,148,969.56"
,IN,AR,30332232,1005,100,,Invoice,,,,,,14/11/2018,14/11/2018,0.00,,7.97,,"-1,148,977.53"
,IN,AR,30332235,1005,100,,Invoice,,,,,,14/11/2018,14/11/2018,0.00,,18.39,,"-1,148,995.92"
,IN,AR,30332247,1005,100,,Invoice,,,,,,14/11/2018,14/11/2018,0.00,,14.58,,"-1,149,010.50"
,IN,AR,30332267,1005,100,,Invoice,,,,,,14/11/2018,14/11/2018,0.00,,8.47,,"-1,149,018.97"
,IN,AR,30332271,1005,100,,Invoice,,,,,,14/11/2018,14/11/2018,0.00,,2.58,,"-1,149,021.55"
,IN,AR,30332274,1005,100,,Invoice,,,,,,14/11/2018,14/11/2018,0.00,,18.17,,"-1,149,039.72"
,IN,AR,30332292,1005,100,,Invoice,,,,,,14/11/2018,14/11/2018,0.00,,18.31,,"-1,149,058.03"
,IN,AR,30332325,1005,100,,Invoice,,,,,,14/11/2018,14/11/2018,0.00,,10.93,,"-1,149,068.96"
,IN,AR,30332357,1005,100,,Invoice,,,,,,14/11/2018,14/11/2018,0.00,,20.76,,"-1,149,089.72"
,IN,AR,30332366,1005,100,,Invoice,,,,,,14/11/2018,14/11/2018,0.00,,182.20,,"-1,149,271.92"
,IN,AR,30332368,1005,100,,Invoice,,,,,,14/11/2018,14/11/2018,0.00,,11.19,,"-1,149,283.11"
,IN,AR,30332374,1005,100,,Invoice,,,,,,14/11/2018,14/11/2018,0.00,,7.75,,"-1,149,290.86"
,IN,AR,30332384,1005,100,,Invoice,,,,,,14/11/2018,14/11/2018,0.00,,19.58,,"-1,149,310.44"
,IN,AR,30332391,1005,100,,Invoice,,,,,,14/11/2018,14/11/2018,0.00,,10.17,,"-1,149,320.61"
,IN,AR,30332397,1005,100,,Invoice,,,,,,14/11/2018,14/11/2018,0.00,,34.00,,"-1,149,354.61"
,IN,AR,30332423,1005,100,,Invoice,,,,,,14/11/2018,14/11/2018,0.00,,2.58,,"-1,149,357.19"
,IN,AR,30332433,1005,100,,Invoice,,,,,,14/11/2018,14/11/2018,0.00,,11.14,,"-1,149,368.33"
,IN,AR,30332438,1005,100,,Invoice,,,,,,14/11/2018,14/11/2018,0.00,,364.41,,"-1,149,732.74"
,IN,AR,30332442,1005,100,,Invoice,,,,,,14/11/2018,14/11/2018,0.00,,7.29,,"-1,149,740.03"
,IN,AR,30332446,1005,100,,Invoice,,,,,,14/11/2018,14/11/2018,0.00,,27.08,,"-1,149,767.11"
,IN,AR,30332456,1005,100,,Invoice,,,,,,14/11/2018,14/11/2018,0.00,,14.63,,"-1,149,781.74"
,IN,AR,30332460,1005,100,,Invoice,,,,,,14/11/2018,14/11/2018,0.00,,33.22,,"-1,149,814.96"
,IN,AR,30332488,1005,100,,Invoice,,,,,,14/11/2018,14/11/2018,0.00,,3.53,,"-1,149,818.49"
,IN,AR,30332489,1005,100,,Invoice,,,,,,14/11/2018,14/11/2018,0.00,,15.86,,"-1,149,834.35"
,IN,AR,30332500,1005,100,,Invoice,,,,,,14/11/2018,14/11/2018,0.00,,12.03,,"-1,149,846.38"
,IN,AR,30332527,1005,100,,Invoice,,,,,,14/11/2018,14/11/2018,0.00,,7.75,,"-1,149,854.13"
,IN,AR,30332531,1005,100,,Invoice,,,,,,14/11/2018,14/11/2018,0.00,,10.93,,"-1,149,865.06"
,IN,AR,30332540,1005,100,,Invoice,,,,,,14/11/2018,14/11/2018,0.00,,8.00,,"-1,149,873.06"
,IN,AR,30332543,1005,100,,Invoice,,,,,,14/11/2018,14/11/2018,0.00,,29.15,,"-1,149,902.21"
,IN,AR,30332544,1005,100,,Invoice,,,,,,14/11/2018,14/11/2018,0.00,,18.22,,"-1,149,920.43"
,IN,AR,30332561,1005,100,,Invoice,,,,,,14/11/2018,14/11/2018,0.00,,12.71,,"-1,149,933.14"
,IN,AR,30332566,1005,100,,Invoice,,,,,,14/11/2018,14/11/2018,0.00,,54.66,,"-1,149,987.80"
,IN,AR,30332579,1005,100,,Invoice,,,,,,14/11/2018,14/11/2018,0.00,,11.94,,"-1,149,999.74"
,IN,AR,30332594,1005,100,,Invoice,,,,,,14/11/2018,14/11/2018,0.00,,4.01,,"-1,150,003.75"
,IN,AR,30332605,1005,100,,Invoice,,,,,,14/11/2018,14/11/2018,0.00,,34.00,,"-1,150,037.75"
,IN,AR,30332625,1005,100,,Invoice,,,,,,14/11/2018,14/11/2018,0.00,,10.93,,"-1,150,048.68"
,IN,AR,30332661,1005,100,,Invoice,,,,,,14/11/2018,14/11/2018,0.00,,7.64,,"-1,150,056.32"
,IN,AR,30332667,1005,100,,Invoice,,,,,,14/11/2018,14/11/2018,0.00,,38.81,,"-1,150,095.13"
,IN,AR,30332682,1005,100,,Invoice,,,,,,14/11/2018,14/11/2018,0.00,,7.63,,"-1,150,102.76"
,IN,AR,30332709,1005,100,,Invoice,,,,,,14/11/2018,14/11/2018,0.00,,10.00,,"-1,150,112.76"
,IN,AR,30332714,1005,100,,Invoice,,,,,,14/11/2018,14/11/2018,0.00,,11.66,,"-1,150,124.42"
,IN,AR,30332715,1005,100,,Invoice,,,,,,14/11/2018,14/11/2018,0.00,,5.83,,"-1,150,130.25"
,IN,AR,30332721,1005,100,,Invoice,,,,,,14/11/2018,14/11/2018,0.00,,79.49,,"-1,150,209.74"
,IN,AR,30332723,1005,100,,Invoice,,,,,,14/11/2018,14/11/2018,0.00,,6.03,,"-1,150,215.77"
,IN,AR,30332727,1005,100,,Invoice,,,,,,14/11/2018,14/11/2018,0.00,,2.92,,"-1,150,218.69"
,IN,AR,30332735,1005,100,,Invoice,,,,,,14/11/2018,14/11/2018,0.00,,25.23,,"-1,150,243.92"
,IN,AR,30332750,1005,100,,Invoice,,,,,,14/11/2018,14/11/2018,0.00,,22.42,,"-1,150,266.34"
,IN,AR,30332753,1005,100,,Invoice,,,,,,14/11/2018,14/11/2018,0.00,,4.66,,"-1,150,271.00"
,IN,AR,30332782,1005,100,,Invoice,,,,,,14/11/2018,14/11/2018,0.00,,5.47,,"-1,150,276.47"
,IN,AR,30332786,1005,100,,Invoice,,,,,,14/11/2018,14/11/2018,0.00,,9.64,,"-1,150,286.11"
,IN,AR,30332796,1005,100,,Invoice,,,,,,14/11/2018,14/11/2018,0.00,,7.29,,"-1,150,293.40"
,IN,AR,30332799,1005,100,,Invoice,,,,,,14/11/2018,14/11/2018,0.00,,14.58,,"-1,150,307.98"
,IN,AR,30332821,1005,100,,Invoice,,,,,,14/11/2018,14/11/2018,0.00,,182.20,,"-1,150,490.18"
,IN,AR,30332834,1005,100,,Invoice,,,,,,14/11/2018,14/11/2018,0.00,,54.66,,"-1,150,544.84"
,IN,AR,30332839,1005,100,,Invoice,,,,,,14/11/2018,14/11/2018,0.00,,7.29,,"-1,150,552.13"
,IN,AR,30332841,1005,100,,Invoice,,,,,,14/11/2018,14/11/2018,0.00,,6.37,,"-1,150,558.50"
,IN,AR,30332923,1005,100,,Invoice,,,,,,14/11/2018,14/11/2018,0.00,,5.26,,"-1,150,563.76"
,IN,AR,30332938,1005,100,,Invoice,,,,,,14/11/2018,14/11/2018,0.00,,29.15,,"-1,150,592.91"
,IN,AR,30332952,1005,100,,Invoice,,,,,,14/11/2018,14/11/2018,0.00,,9.84,,"-1,150,602.75"
,IN,AR,30332959,1005,100,,Invoice,,,,,,14/11/2018,14/11/2018,0.00,,29.15,,"-1,150,631.90"
,IN,AR,30332979,1005,100,,Invoice,,,,,,14/11/2018,14/11/2018,0.00,,54.66,,"-1,150,686.56"
,IN,AR,30332996,1005,100,,Invoice,,,,,,14/11/2018,14/11/2018,0.00,,182.20,,"-1,150,868.76"
,IN,AR,30333004,1005,100,,Invoice,,,,,,14/11/2018,14/11/2018,0.00,,182.20,,"-1,151,050.96"
,IN,AR,30333009,1005,100,,Invoice,,,,,,14/11/2018,14/11/2018,0.00,,3.98,,"-1,151,054.94"
,IN,AR,30333016,1005,100,,Invoice,,,,,,14/11/2018,14/11/2018,0.00,,54.66,,"-1,151,109.60"
,IN,AR,30333020,1005,100,,Invoice,,,,,,14/11/2018,14/11/2018,0.00,,16.02,,"-1,151,125.62"
,IN,AR,30333028,1005,100,,Invoice,,,,,,14/11/2018,14/11/2018,0.00,,10.93,,"-1,151,136.55"
,IN,AR,30333036,1005,100,,Invoice,,,,,,14/11/2018,14/11/2018,0.00,,43.60,,"-1,151,180.15"
,IN,AR,30333037,1005,100,,Invoice,,,,,,14/11/2018,14/11/2018,0.00,,16.61,,"-1,151,196.76"
,IN,AR,30333038,1005,100,,Invoice,,,,,,14/11/2018,14/11/2018,0.00,,24.92,,"-1,151,221.68"
,IN,AR,30333039,1005,100,,Invoice,,,,,,14/11/2018,14/11/2018,0.00,,6.23,,"-1,151,227.91"
,IN,AR,30333088,1005,100,,Invoice,,,,,,14/11/2018,14/11/2018,0.00,,24.27,,"-1,151,252.18"
,IN,AR,30333104,1005,100,,Invoice,,,,,,14/11/2018,14/11/2018,0.00,,54.66,,"-1,151,306.84"
,IN,AR,30333115,1005,100,,Invoice,,,,,,14/11/2018,14/11/2018,0.00,,40.08,,"-1,151,346.92"
,IN,AR,30333121,1005,100,,Invoice,,,,,,14/11/2018,14/11/2018,0.00,,54.66,,"-1,151,401.58"
,IN,AR,30333124,1005,100,,Invoice,,,,,,14/11/2018,14/11/2018,0.00,,29.15,,"-1,151,430.73"
,IN,AR,30333138,1005,100,,Invoice,,,,,,14/11/2018,14/11/2018,0.00,,27.97,,"-1,151,458.70"
,IN,AR,30333142,1005,100,,Invoice,,,,,,14/11/2018,14/11/2018,0.00,,38.81,,"-1,151,497.51"
,IN,AR,30333150,1005,100,,Invoice,,,,,,14/11/2018,14/11/2018,0.00,,29.15,,"-1,151,526.66"
,IN,AR,30333152,1005,100,,Invoice,,,,,,14/11/2018,14/11/2018,0.00,,7.29,,"-1,151,533.95"
,IN,AR,30333165,1005,100,,Invoice,,,,,,14/11/2018,14/11/2018,0.00,,18.20,,"-1,151,552.15"
,IN,AR,30333181,1005,100,,Invoice,,,,,,14/11/2018,14/11/2018,0.00,,12.58,,"-1,151,564.73"
,IN,AR,30333211,1005,100,,Invoice,,,,,,14/11/2018,14/11/2018,0.00,,10.93,,"-1,151,575.66"
,IN,AR,30333213,1005,100,,Invoice,,,,,,14/11/2018,14/11/2018,0.00,,3.64,,"-1,151,579.30"
,IN,AR,30333216,1005,100,,Invoice,,,,,,14/11/2018,14/11/2018,0.00,,54.66,,"-1,151,633.96"
,CS,AR,32011021,1005,100,,Cash sale,,,,,,15/11/2018,15/11/2018,0.00,,6.02,,"-1,151,639.98"
,CS,AR,32011023,1005,100,,Cash sale,,,,,,15/11/2018,15/11/2018,0.00,,21.86,,"-1,151,661.84"
,CS,AR,32011030,1005,100,,Cash sale,,,,,,15/11/2018,15/11/2018,0.00,,28.47,,"-1,151,690.31"
,CS,AR,32011039,1005,100,,Cash sale,,,,,,15/11/2018,15/11/2018,0.00,,3.64,,"-1,151,693.95"
,CS,AR,32011044,1005,100,,Cash sale,,,,,,15/11/2018,15/11/2018,0.00,,3.64,,"-1,151,697.59"
,CS,AR,32011069,1005,100,,Cash sale,,,,,,15/11/2018,15/11/2018,0.00,,36.44,,"-1,151,734.03"
,CS,AR,32011074,1005,100,,Cash sale,,,,,,15/11/2018,15/11/2018,0.00,,7.29,,"-1,151,741.32"
,CS,AR,32011077,1005,100,,Cash sale,,,,,,15/11/2018,15/11/2018,0.00,,3.64,,"-1,151,744.96"
,CS,AR,32011081,1005,100,,Cash sale,,,,,,15/11/2018,15/11/2018,0.00,,3.64,,"-1,151,748.60"
,CS,AR,32011117,1005,100,,Cash sale,,,,,,15/11/2018,15/11/2018,0.00,,3.64,,"-1,151,752.24"
,CS,AR,32011132,1005,100,,Cash sale,,,,,,15/11/2018,15/11/2018,0.00,,7.29,,"-1,151,759.53"
,CS,AR,32011142,1005,100,,Cash sale,,,,,,15/11/2018,15/11/2018,0.00,,7.29,,"-1,151,766.82"
,CS,AR,32011150,1005,100,,Cash sale,,,,,,15/11/2018,15/11/2018,0.00,,7.29,,"-1,151,774.11"
,CS,AR,32011159,1005,100,,Cash sale,,,,,,15/11/2018,15/11/2018,0.00,,7.29,,"-1,151,781.40"
,CS,AR,32011195,1005,100,,Cash sale,,,,,,15/11/2018,15/11/2018,0.00,,5.17,,"-1,151,786.57"
,CS,AR,32011270,1005,100,,Cash sale,,,,,,15/11/2018,15/11/2018,0.00,,3.43,,"-1,151,790.00"
,CS,AR,32011271,1005,100,,Cash sale,,,,,,15/11/2018,15/11/2018,0.00,,16.78,,"-1,151,806.78"
,CS,AR,32011282,1005,100,,Cash sale,,,,,,15/11/2018,15/11/2018,0.00,,7.29,,"-1,151,814.07"
,CS,AR,32011302,1005,100,,Cash sale,,,,,,15/11/2018,15/11/2018,0.00,,7.29,,"-1,151,821.36"
,CS,AR,32011308,1005,100,,Cash sale,,,,,,15/11/2018,15/11/2018,0.00,,3.64,,"-1,151,825.00"
,CS,AR,32011332,1005,100,,Cash sale,,,,,,15/11/2018,15/11/2018,0.00,,30.76,,"-1,151,855.76"
,CS,AR,32011367,1005,100,,Cash sale,,,,,,15/11/2018,15/11/2018,0.00,,5.17,,"-1,151,860.93"
,CS,AR,32011383,1005,100,,Cash sale,,,,,,15/11/2018,15/11/2018,0.00,,7.29,,"-1,151,868.22"
,CS,AR,32011389,1005,100,,Cash sale,,,,,,15/11/2018,15/11/2018,0.00,,8.02,,"-1,151,876.24"
,CS,AR,32011394,1005,100,,Cash sale,,,,,,15/11/2018,15/11/2018,0.00,,10.93,,"-1,151,887.17"
,CS,AR,32011395,1005,100,,Cash sale,,,,,,15/11/2018,15/11/2018,0.00,,16.78,,"-1,151,903.95"
,CS,AR,32011401,1005,100,,Cash sale,,,,,,15/11/2018,15/11/2018,0.00,,7.29,,"-1,151,911.24"
,CS,AR,32011413,1005,100,,Cash sale,,,,,,15/11/2018,15/11/2018,0.00,,7.29,,"-1,151,918.53"
,CS,AR,32011443,1005,100,,Cash sale,,,,,,15/11/2018,15/11/2018,0.00,,12.00,,"-1,151,930.53"
,CS,AR,32011451,1005,100,,Cash sale,,,,,,15/11/2018,15/11/2018,0.00,,8.90,,"-1,151,939.43"
,CS,AR,32011463,1005,100,,Cash sale,,,,,,15/11/2018,15/11/2018,0.00,,3.64,,"-1,151,943.07"
,CS,AR,32011478,1005,100,,Cash sale,,,,,,15/11/2018,15/11/2018,0.00,,10.93,,"-1,151,954.00"
,CS,AR,32011558,1005,100,,Cash sale,,,,,,15/11/2018,15/11/2018,0.00,,5.86,,"-1,151,959.86"
,CS,AR,32011629,1005,100,,Cash sale,,,,,,15/11/2018,15/11/2018,0.00,,3.64,,"-1,151,963.50"
,CS,AR,32011649,1005,100,,Cash sale,,,,,,15/11/2018,15/11/2018,0.00,,3.64,,"-1,151,967.14"
,CS,AR,32011654,1005,100,,Cash sale,,,,,,15/11/2018,15/11/2018,0.00,,7.29,,"-1,151,974.43"
,CS,AR,32011674,1005,100,,Cash sale,,,,,,15/11/2018,15/11/2018,0.00,,10.93,,"-1,151,985.36"
,IN,AR,30331747,1005,100,,Invoice,,,,,,15/11/2018,15/11/2018,0.00,,3.64,,"-1,151,989.00"
,IN,AR,30331758,1005,100,,Invoice,,,,,,15/11/2018,15/11/2018,0.00,,7.29,,"-1,151,996.29"
,IN,AR,30331794,1005,100,,Invoice,,,,,,15/11/2018,15/11/2018,0.00,,3.64,,"-1,151,999.93"
,IN,AR,30331848,1005,100,,Invoice,,,,,,15/11/2018,15/11/2018,0.00,,1.99,,"-1,152,001.92"
,IN,AR,30331857,1005,100,,Invoice,,,,,,15/11/2018,15/11/2018,0.00,,40.00,,"-1,152,041.92"
,IN,AR,30331878,1005,100,,Invoice,,,,,,15/11/2018,15/11/2018,0.00,,40.00,,"-1,152,081.92"
,IN,AR,30331895,1005,100,,Invoice,,,,,,15/11/2018,15/11/2018,0.00,,3.64,,"-1,152,085.56"
,IN,AR,30331897,1005,100,,Invoice,,,,,,15/11/2018,15/11/2018,0.00,,54.66,,"-1,152,140.22"
,IN,AR,30331899,1005,100,,Invoice,,,,,,15/11/2018,15/11/2018,0.00,,7.29,,"-1,152,147.51"
,IN,AR,30331918,1005,100,,Invoice,,,,,,15/11/2018,15/11/2018,0.00,,3.64,,"-1,152,151.15"
,IN,AR,30331933,1005,100,,Invoice,,,,,,15/11/2018,15/11/2018,0.00,,14.24,,"-1,152,165.39"
,IN,AR,30331934,1005,100,,Invoice,,,,,,15/11/2018,15/11/2018,0.00,,80.68,,"-1,152,246.07"
,IN,AR,30331951,1005,100,,Invoice,,,,,,15/11/2018,15/11/2018,0.00,,17.03,,"-1,152,263.10"
,IN,AR,30332018,1005,100,,Invoice,,,,,,15/11/2018,15/11/2018,0.00,,6.37,,"-1,152,269.47"
,IN,AR,30332025,1005,100,,Invoice,,,,,,15/11/2018,15/11/2018,0.00,,20.68,,"-1,152,290.15"
,IN,AR,30332029,1005,100,,Invoice,,,,,,15/11/2018,15/11/2018,0.00,,31.50,,"-1,152,321.65"
,IN,AR,30332039,1005,100,,Invoice,,,,,,15/11/2018,15/11/2018,0.00,,16.47,,"-1,152,338.12"
,IN,AR,30332060,1005,100,,Invoice,,,,,,15/11/2018,15/11/2018,0.00,,3.64,,"-1,152,341.76"
,IN,AR,30332105,1005,100,,Invoice,,,,,,15/11/2018,15/11/2018,0.00,,7.29,,"-1,152,349.05"
,IN,AR,30332111,1005,100,,Invoice,,,,,,15/11/2018,15/11/2018,0.00,,31.05,,"-1,152,380.10"
,IN,AR,30332126,1005,100,,Invoice,,,,,,15/11/2018,15/11/2018,0.00,,23.90,,"-1,152,404.00"
,IN,AR,30332138,1005,100,,Invoice,,,,,,15/11/2018,15/11/2018,0.00,,27.12,,"-1,152,431.12"
,IN,AR,30332149,1005,100,,Invoice,,,,,,15/11/2018,15/11/2018,0.00,,7.63,,"-1,152,438.75"
,IN,AR,30332150,1005,100,,Invoice,,,,,,15/11/2018,15/11/2018,0.00,,99.15,,"-1,152,537.90"
,IN,AR,30332157,1005,100,,Invoice,,,,,,15/11/2018,15/11/2018,0.00,,23.90,,"-1,152,561.80"
,IN,AR,30332174,1005,100,,Invoice,,,,,,15/11/2018,15/11/2018,0.00,,16.10,,"-1,152,577.90"
,IN,AR,30332214,1005,100,,Invoice,,,,,,15/11/2018,15/11/2018,0.00,,5.08,,"-1,152,582.98"
,IN,AR,30332238,1005,100,,Invoice,,,,,,15/11/2018,15/11/2018,0.00,,2.58,,"-1,152,585.56"
,IN,AR,30332261,1005,100,,Invoice,,,,,,15/11/2018,15/11/2018,0.00,,17.80,,"-1,152,603.36"
,IN,AR,30332282,1005,100,,Invoice,,,,,,15/11/2018,15/11/2018,0.00,,15.25,,"-1,152,618.61"
,IN,AR,30332287,1005,100,,Invoice,,,,,,15/11/2018,15/11/2018,0.00,,20.00,,"-1,152,638.61"
,IN,AR,30332299,1005,100,,Invoice,,,,,,15/11/2018,15/11/2018,0.00,,3.64,,"-1,152,642.25"
,IN,AR,30332310,1005,100,,Invoice,,,,,,15/11/2018,15/11/2018,0.00,,7.29,,"-1,152,649.54"
,IN,AR,30332319,1005,100,,Invoice,,,,,,15/11/2018,15/11/2018,0.00,,3.01,,"-1,152,652.55"
,IN,AR,30332358,1005,100,,Invoice,,,,,,15/11/2018,15/11/2018,0.00,,2.97,,"-1,152,655.52"
,IN,AR,30332359,1005,100,,Invoice,,,,,,15/11/2018,15/11/2018,0.00,,20.76,,"-1,152,676.28"
,IN,AR,30332363,1005,100,,Invoice,,,,,,15/11/2018,15/11/2018,0.00,,10.50,,"-1,152,686.78"
,IN,AR,30332407,1005,100,,Invoice,,,,,,15/11/2018,15/11/2018,0.00,,9.29,,"-1,152,696.07"
,IN,AR,30332409,1005,100,,Invoice,,,,,,15/11/2018,15/11/2018,0.00,,8.77,,"-1,152,704.84"
,IN,AR,30332413,1005,100,,Invoice,,,,,,15/11/2018,15/11/2018,0.00,,10.93,,"-1,152,715.77"
,IN,AR,30332415,1005,100,,Invoice,,,,,,15/11/2018,15/11/2018,0.00,,27.54,,"-1,152,743.31"
,IN,AR,30332430,1005,100,,Invoice,,,,,,15/11/2018,15/11/2018,0.00,,11.36,,"-1,152,754.67"
,IN,AR,30332450,1005,100,,Invoice,,,,,,15/11/2018,15/11/2018,0.00,,24.07,,"-1,152,778.74"
,IN,AR,30332457,1005,100,,Invoice,,,,,,15/11/2018,15/11/2018,0.00,,9.10,,"-1,152,787.84"
,IN,AR,30332464,1005,100,,Invoice,,,,,,15/11/2018,15/11/2018,0.00,,7.63,,"-1,152,795.47"
,IN,AR,30332476,1005,100,,Invoice,,,,,,15/11/2018,15/11/2018,0.00,,15.04,,"-1,152,810.51"
,IN,AR,30332477,1005,100,,Invoice,,,,,,15/11/2018,15/11/2018,0.00,,8.00,,"-1,152,818.51"
,IN,AR,30332486,1005,100,,Invoice,,,,,,15/11/2018,15/11/2018,0.00,,29.15,,"-1,152,847.66"
,IN,AR,30332490,1005,100,,Invoice,,,,,,15/11/2018,15/11/2018,0.00,,3.53,,"-1,152,851.19"
,IN,AR,30332510,1005,100,,Invoice,,,,,,15/11/2018,15/11/2018,0.00,,4.54,,"-1,152,855.73"
,IN,AR,30332534,1005,100,,Invoice,,,,,,15/11/2018,15/11/2018,0.00,,15.71,,"-1,152,871.44"
,IN,AR,30332537,1005,100,,Invoice,,,,,,15/11/2018,15/11/2018,0.00,,2.92,,"-1,152,874.36"
,IN,AR,30332557,1005,100,,Invoice,,,,,,15/11/2018,15/11/2018,0.00,,2.58,,"-1,152,876.94"
,IN,AR,30332558,1005,100,,Invoice,,,,,,15/11/2018,15/11/2018,0.00,,7.29,,"-1,152,884.23"
,IN,AR,30332568,1005,100,,Invoice,,,,,,15/11/2018,15/11/2018,0.00,,9.84,,"-1,152,894.07"
,IN,AR,30332569,1005,100,,Invoice,,,,,,15/11/2018,15/11/2018,0.00,,15.93,,"-1,152,910.00"
,IN,AR,30332570,1005,100,,Invoice,,,,,,15/11/2018,15/11/2018,0.00,,3.98,,"-1,152,913.98"
,IN,AR,30332571,1005,100,,Invoice,,,,,,15/11/2018,15/11/2018,0.00,,3.98,,"-1,152,917.96"
,IN,AR,30332572,1005,100,,Invoice,,,,,,15/11/2018,15/11/2018,0.00,,41.82,,"-1,152,959.78"
,IN,AR,30332580,1005,100,,Invoice,,,,,,15/11/2018,15/11/2018,0.00,,7.96,,"-1,152,967.74"
,IN,AR,30332618,1005,100,,Invoice,,,,,,15/11/2018,15/11/2018,0.00,,60.57,,"-1,153,028.31"
,IN,AR,30332629,1005,100,,Invoice,,,,,,15/11/2018,15/11/2018,0.00,,3.64,,"-1,153,031.95"
,IN,AR,30332655,1005,100,,Invoice,,,,,,15/11/2018,15/11/2018,0.00,,14.58,,"-1,153,046.53"
,IN,AR,30332683,1005,100,,Invoice,,,,,,15/11/2018,15/11/2018,0.00,,20.34,,"-1,153,066.87"
,IN,AR,30332695,1005,100,,Invoice,,,,,,15/11/2018,15/11/2018,0.00,,24.01,,"-1,153,090.88"
,IN,AR,30332703,1005,100,,Invoice,,,,,,15/11/2018,15/11/2018,0.00,,2.00,,"-1,153,092.88"
,IN,AR,30332706,1005,100,,Invoice,,,,,,15/11/2018,15/11/2018,0.00,,28.01,,"-1,153,120.89"
,IN,AR,30332716,1005,100,,Invoice,,,,,,15/11/2018,15/11/2018,0.00,,8.75,,"-1,153,129.64"
,IN,AR,30332717,1005,100,,Invoice,,,,,,15/11/2018,15/11/2018,0.00,,11.66,,"-1,153,141.30"
,IN,AR,30332768,1005,100,,Invoice,,,,,,15/11/2018,15/11/2018,0.00,,11.22,,"-1,153,152.52"
,IN,AR,30332780,1005,100,,Invoice,,,,,,15/11/2018,15/11/2018,0.00,,29.75,,"-1,153,182.27"
,IN,AR,30332783,1005,100,,Invoice,,,,,,15/11/2018,15/11/2018,0.00,,14.19,,"-1,153,196.46"
,IN,AR,30332794,1005,100,,Invoice,,,,,,15/11/2018,15/11/2018,0.00,,12.14,,"-1,153,208.60"
,IN,AR,30332797,1005,100,,Invoice,,,,,,15/11/2018,15/11/2018,0.00,,12.00,,"-1,153,220.60"
,IN,AR,30332838,1005,100,,Invoice,,,,,,15/11/2018,15/11/2018,0.00,,81.15,,"-1,153,301.75"
,IN,AR,30332842,1005,100,,Invoice,,,,,,15/11/2018,15/11/2018,0.00,,9.56,,"-1,153,311.31"
,IN,AR,30332843,1005,100,,Invoice,,,,,,15/11/2018,15/11/2018,0.00,,22.31,,"-1,153,333.62"
,IN,AR,30332844,1005,100,,Invoice,,,,,,15/11/2018,15/11/2018,0.00,,103.56,,"-1,153,437.18"
,IN,AR,30332845,1005,100,,Invoice,,,,,,15/11/2018,15/11/2018,0.00,,11.15,,"-1,153,448.33"
,IN,AR,30332846,1005,100,,Invoice,,,,,,15/11/2018,15/11/2018,0.00,,7.97,,"-1,153,456.30"
,IN,AR,30332847,1005,100,,Invoice,,,,,,15/11/2018,15/11/2018,0.00,,17.53,,"-1,153,473.83"
,IN,AR,30332886,1005,100,,Invoice,,,,,,15/11/2018,15/11/2018,0.00,,22.37,,"-1,153,496.20"
,IN,AR,30332949,1005,100,,Invoice,,,,,,15/11/2018,15/11/2018,0.00,,3.64,,"-1,153,499.84"
,IN,AR,30332953,1005,100,,Invoice,,,,,,15/11/2018,15/11/2018,0.00,,8.25,,"-1,153,508.09"
,IN,AR,30332967,1005,100,,Invoice,,,,,,15/11/2018,15/11/2018,0.00,,10.93,,"-1,153,519.02"
,IN,AR,30332992,1005,100,,Invoice,,,,,,15/11/2018,15/11/2018,0.00,,4.08,,"-1,153,523.10"
,IN,AR,30333023,1005,100,,Invoice,,,,,,15/11/2018,15/11/2018,0.00,,2.42,,"-1,153,525.52"
,IN,AR,30333025,1005,100,,Invoice,,,,,,15/11/2018,15/11/2018,0.00,,12.14,,"-1,153,537.66"
,IN,AR,30333027,1005,100,,Invoice,,,,,,15/11/2018,15/11/2018,0.00,,10.93,,"-1,153,548.59"
,IN,AR,30333040,1005,100,,Invoice,,,,,,15/11/2018,15/11/2018,0.00,,2.08,,"-1,153,550.67"
,IN,AR,30333041,1005,100,,Invoice,,,,,,15/11/2018,15/11/2018,0.00,,12.46,,"-1,153,563.13"
,IN,AR,30333092,1005,100,,Invoice,,,,,,15/11/2018,15/11/2018,0.00,,21.86,,"-1,153,584.99"
,IN,AR,30333100,1005,100,,Invoice,,,,,,15/11/2018,15/11/2018,0.00,,7.29,,"-1,153,592.28"
,IN,AR,30333130,1005,100,,Invoice,,,,,,15/11/2018,15/11/2018,0.00,,8.41,,"-1,153,600.69"
,IN,AR,30333144,1005,100,,Invoice,,,,,,15/11/2018,15/11/2018,0.00,,72.81,,"-1,153,673.50"
,IN,AR,30333158,1005,100,,Invoice,,,,,,15/11/2018,15/11/2018,0.00,,3.64,,"-1,153,677.14"
,IN,AR,30333170,1005,100,,Invoice,,,,,,15/11/2018,15/11/2018,0.00,,5.26,,"-1,153,682.40"
,IN,AR,30333173,1005,100,,Invoice,,,,,,15/11/2018,15/11/2018,0.00,,29.15,,"-1,153,711.55"
,IN,AR,30333187,1005,100,,Invoice,,,,,,15/11/2018,15/11/2018,0.00,,6.08,,"-1,153,717.63"
,IN,AR,30333196,1005,100,,Invoice,,,,,,15/11/2018,15/11/2018,0.00,,28.88,,"-1,153,746.51"
,CN,AR,31019513,1005,100,,Credit Note,,,,,,16/11/2018,16/11/2018,3.64,,0.00,,"-1,153,742.87"
,CN,AR,31019604,1005,100,,Credit Note,,,,,,16/11/2018,16/11/2018,3.28,,0.00,,"-1,153,739.59"
,CR,AR,33000314,1005,100,,Cash Return,,,,,,16/11/2018,16/11/2018,10.93,,0.00,,"-1,153,728.66"
,CS,AR,32011034,1005,100,,Cash sale,,,,,,16/11/2018,16/11/2018,0.00,,11.86,,"-1,153,740.52"
,CS,AR,32011041,1005,100,,Cash sale,,,,,,16/11/2018,16/11/2018,0.00,,3.04,,"-1,153,743.56"
,CS,AR,32011046,1005,100,,Cash sale,,,,,,16/11/2018,16/11/2018,0.00,,14.58,,"-1,153,758.14"
,CS,AR,32011065,1005,100,,Cash sale,,,,,,16/11/2018,16/11/2018,0.00,,3.64,,"-1,153,761.78"
,CS,AR,32011082,1005,100,,Cash sale,,,,,,16/11/2018,16/11/2018,0.00,,7.25,,"-1,153,769.03"
,CS,AR,32011088,1005,100,,Cash sale,,,,,,16/11/2018,16/11/2018,0.00,,10.93,,"-1,153,779.96"
,CS,AR,32011095,1005,100,,Cash sale,,,,,,16/11/2018,16/11/2018,0.00,,7.29,,"-1,153,787.25"
,CS,AR,32011101,1005,100,,Cash sale,,,,,,16/11/2018,16/11/2018,0.00,,10.93,,"-1,153,798.18"
,CS,AR,32011103,1005,100,,Cash sale,,,,,,16/11/2018,16/11/2018,0.00,,16.61,,"-1,153,814.79"
,CS,AR,32011118,1005,100,,Cash sale,,,,,,16/11/2018,16/11/2018,0.00,,5.84,,"-1,153,820.63"
,CS,AR,32011123,1005,100,,Cash sale,,,,,,16/11/2018,16/11/2018,0.00,,3.64,,"-1,153,824.27"
,CS,AR,32011134,1005,100,,Cash sale,,,,,,16/11/2018,16/11/2018,0.00,,21.86,,"-1,153,846.13"
,CS,AR,32011140,1005,100,,Cash sale,,,,,,16/11/2018,16/11/2018,0.00,,8.39,,"-1,153,854.52"
,CS,AR,32011146,1005,100,,Cash sale,,,,,,16/11/2018,16/11/2018,0.00,,33.64,,"-1,153,888.16"
,CS,AR,32011155,1005,100,,Cash sale,,,,,,16/11/2018,16/11/2018,0.00,,3.64,,"-1,153,891.80"
,CS,AR,32011166,1005,100,,Cash sale,,,,,,16/11/2018,16/11/2018,0.00,,10.93,,"-1,153,902.73"
,CS,AR,32011185,1005,100,,Cash sale,,,,,,16/11/2018,16/11/2018,0.00,,14.58,,"-1,153,917.31"
,CS,AR,32011186,1005,100,,Cash sale,,,,,,16/11/2018,16/11/2018,0.00,,5.17,,"-1,153,922.48"
,CS,AR,32011189,1005,100,,Cash sale,,,,,,16/11/2018,16/11/2018,0.00,,10.17,,"-1,153,932.65"
,CS,AR,32011204,1005,100,,Cash sale,,,,,,16/11/2018,16/11/2018,0.00,,3.64,,"-1,153,936.29"
,CS,AR,32011210,1005,100,,Cash sale,,,,,,16/11/2018,16/11/2018,0.00,,19.24,,"-1,153,955.53"
,CS,AR,32011218,1005,100,,Cash sale,,,,,,16/11/2018,16/11/2018,0.00,,10.99,,"-1,153,966.52"
,CS,AR,32011226,1005,100,,Cash sale,,,,,,16/11/2018,16/11/2018,0.00,,7.29,,"-1,153,973.81"
,CS,AR,32011230,1005,100,,Cash sale,,,,,,16/11/2018,16/11/2018,0.00,,6.02,,"-1,153,979.83"
,CS,AR,32011231,1005,100,,Cash sale,,,,,,16/11/2018,16/11/2018,0.00,,9.03,,"-1,153,988.86"
,CS,AR,32011247,1005,100,,Cash sale,,,,,,16/11/2018,16/11/2018,0.00,,10.17,,"-1,153,999.03"
,CS,AR,32011251,1005,100,,Cash sale,,,,,,16/11/2018,16/11/2018,0.00,,17.54,,"-1,154,016.57"
,CS,AR,32011256,1005,100,,Cash sale,,,,,,16/11/2018,16/11/2018,0.00,,6.74,,"-1,154,023.31"
,CS,AR,32011265,1005,100,,Cash sale,,,,,,16/11/2018,16/11/2018,0.00,,18.05,,"-1,154,041.36"
,CS,AR,32011291,1005,100,,Cash sale,,,,,,16/11/2018,16/11/2018,0.00,,3.64,,"-1,154,045.00"
,CS,AR,32011300,1005,100,,Cash sale,,,,,,16/11/2018,16/11/2018,0.00,,20.34,,"-1,154,065.34"
,CS,AR,32011301,1005,100,,Cash sale,,,,,,16/11/2018,16/11/2018,0.00,,7.29,,"-1,154,072.63"
,CS,AR,32011330,1005,100,,Cash sale,,,,,,16/11/2018,16/11/2018,0.00,,14.58,,"-1,154,087.21"
,CS,AR,32011345,1005,100,,Cash sale,,,,,,16/11/2018,16/11/2018,0.00,,10.93,,"-1,154,098.14"
,CS,AR,32011359,1005,100,,Cash sale,,,,,,16/11/2018,16/11/2018,0.00,,11.70,,"-1,154,109.84"
,CS,AR,32011379,1005,100,,Cash sale,,,,,,16/11/2018,16/11/2018,0.00,,7.75,,"-1,154,117.59"
,CS,AR,32011385,1005,100,,Cash sale,,,,,,16/11/2018,16/11/2018,0.00,,5.56,,"-1,154,123.15"
,CS,AR,32011396,1005,100,,Cash sale,,,,,,16/11/2018,16/11/2018,0.00,,10.93,,"-1,154,134.08"
,CS,AR,32011421,1005,100,,Cash sale,,,,,,16/11/2018,16/11/2018,0.00,,6.53,,"-1,154,140.61"
,CS,AR,32011427,1005,100,,Cash sale,,,,,,16/11/2018,16/11/2018,0.00,,4.08,,"-1,154,144.69"
,CS,AR,32011430,1005,100,,Cash sale,,,,,,16/11/2018,16/11/2018,0.00,,3.64,,"-1,154,148.33"
,CS,AR,32011434,1005,100,,Cash sale,,,,,,16/11/2018,16/11/2018,0.00,,7.29,,"-1,154,155.62"
,CS,AR,32011457,1005,100,,Cash sale,,,,,,16/11/2018,16/11/2018,0.00,,2.54,,"-1,154,158.16"
,CS,AR,32011467,1005,100,,Cash sale,,,,,,16/11/2018,16/11/2018,0.00,,4.58,,"-1,154,162.74"
,CS,AR,32011483,1005,100,,Cash sale,,,,,,16/11/2018,16/11/2018,0.00,,10.93,,"-1,154,173.67"
,CS,AR,32011484,1005,100,,Cash sale,,,,,,16/11/2018,16/11/2018,0.00,,12.71,,"-1,154,186.38"
,CS,AR,32011495,1005,100,,Cash sale,,,,,,16/11/2018,16/11/2018,0.00,,51.60,,"-1,154,237.98"
,CS,AR,32011508,1005,100,,Cash sale,,,,,,16/11/2018,16/11/2018,0.00,,10.93,,"-1,154,248.91"
,CS,AR,32011515,1005,100,,Cash sale,,,,,,16/11/2018,16/11/2018,0.00,,5.08,,"-1,154,253.99"
,CS,AR,32011519,1005,100,,Cash sale,,,,,,16/11/2018,16/11/2018,0.00,,9.10,,"-1,154,263.09"
,CS,AR,32011522,1005,100,,Cash sale,,,,,,16/11/2018,16/11/2018,0.00,,9.15,,"-1,154,272.24"
,CS,AR,32011527,1005,100,,Cash sale,,,,,,16/11/2018,16/11/2018,0.00,,10.93,,"-1,154,283.17"
,CS,AR,32011529,1005,100,,Cash sale,,,,,,16/11/2018,16/11/2018,0.00,,4.15,,"-1,154,287.32"
,CS,AR,32011531,1005,100,,Cash sale,,,,,,16/11/2018,16/11/2018,0.00,,29.15,,"-1,154,316.47"
,CS,AR,32011532,1005,100,,Cash sale,,,,,,16/11/2018,16/11/2018,0.00,,10.93,,"-1,154,327.40"
,CS,AR,32011537,1005,100,,Cash sale,,,,,,16/11/2018,16/11/2018,0.00,,9.13,,"-1,154,336.53"
,CS,AR,32011542,1005,100,,Cash sale,,,,,,16/11/2018,16/11/2018,0.00,,18.22,,"-1,154,354.75"
,CS,AR,32011565,1005,100,,Cash sale,,,,,,16/11/2018,16/11/2018,0.00,,6.56,,"-1,154,361.31"
,CS,AR,32011571,1005,100,,Cash sale,,,,,,16/11/2018,16/11/2018,0.00,,3.64,,"-1,154,364.95"
,CS,AR,32011585,1005,100,,Cash sale,,,,,,16/11/2018,16/11/2018,0.00,,2.97,,"-1,154,367.92"
,CS,AR,32011587,1005,100,,Cash sale,,,,,,16/11/2018,16/11/2018,0.00,,10.93,,"-1,154,378.85"
,CS,AR,32011625,1005,100,,Cash sale,,,,,,16/11/2018,16/11/2018,0.00,,3.03,,"-1,154,381.88"
,CS,AR,32011641,1005,100,,Cash sale,,,,,,16/11/2018,16/11/2018,0.00,,10.93,,"-1,154,392.81"
,CS,AR,32011642,1005,100,,Cash sale,,,,,,16/11/2018,16/11/2018,0.00,,10.93,,"-1,154,403.74"
,CS,AR,32011646,1005,100,,Cash sale,,,,,,16/11/2018,16/11/2018,0.00,,3.64,,"-1,154,407.38"
,CS,AR,32011659,1005,100,,Cash sale,,,,,,16/11/2018,16/11/2018,0.00,,6.42,,"-1,154,413.80"
,IN,AR,30331727,1005,100,,Invoice,,,,,,16/11/2018,16/11/2018,0.00,,7.29,,"-1,154,421.09"
,IN,AR,30331734,1005,100,,Invoice,,,,,,16/11/2018,16/11/2018,0.00,,5.93,,"-1,154,427.02"
,IN,AR,30331735,1005,100,,Invoice,,,,,,16/11/2018,16/11/2018,0.00,,11.86,,"-1,154,438.88"
,IN,AR,30331744,1005,100,,Invoice,,,,,,16/11/2018,16/11/2018,0.00,,21.86,,"-1,154,460.74"
,IN,AR,30331752,1005,100,,Invoice,,,,,,16/11/2018,16/11/2018,0.00,,13.98,,"-1,154,474.72"
,IN,AR,30331785,1005,100,,Invoice,,,,,,16/11/2018,16/11/2018,0.00,,21.86,,"-1,154,496.58"
,IN,AR,30331823,1005,100,,Invoice,,,,,,16/11/2018,16/11/2018,0.00,,3.64,,"-1,154,500.22"
,IN,AR,30331826,1005,100,,Invoice,,,,,,16/11/2018,16/11/2018,0.00,,46.50,,"-1,154,546.72"
,IN,AR,30331836,1005,100,,Invoice,,,,,,16/11/2018,16/11/2018,0.00,,40.04,,"-1,154,586.76"
,IN,AR,30331838,1005,100,,Invoice,,,,,,16/11/2018,16/11/2018,0.00,,9.19,,"-1,154,595.95"
,IN,AR,30331841,1005,100,,Invoice,,,,,,16/11/2018,16/11/2018,0.00,,60.16,,"-1,154,656.11"
,IN,AR,30331849,1005,100,,Invoice,,,,,,16/11/2018,16/11/2018,0.00,,9.96,,"-1,154,666.07"
,IN,AR,30331858,1005,100,,Invoice,,,,,,16/11/2018,16/11/2018,0.00,,78.00,,"-1,154,744.07"
,IN,AR,30331871,1005,100,,Invoice,,,,,,16/11/2018,16/11/2018,0.00,,13.77,,"-1,154,757.84"
,IN,AR,30331907,1005,100,,Invoice,,,,,,16/11/2018,16/11/2018,0.00,,30.00,,"-1,154,787.84"
,IN,AR,30331935,1005,100,,Invoice,,,,,,16/11/2018,16/11/2018,0.00,,4.75,,"-1,154,792.59"
,IN,AR,30331940,1005,100,,Invoice,,,,,,16/11/2018,16/11/2018,0.00,,4.00,,"-1,154,796.59"
,IN,AR,30331963,1005,100,,Invoice,,,,,,16/11/2018,16/11/2018,0.00,,650.81,,"-1,155,447.40"
,IN,AR,30331968,1005,100,,Invoice,,,,,,16/11/2018,16/11/2018,0.00,,3.88,,"-1,155,451.28"
,IN,AR,30331969,1005,100,,Invoice,,,,,,16/11/2018,16/11/2018,0.00,,9.70,,"-1,155,460.98"
,IN,AR,30331978,1005,100,,Invoice,,,,,,16/11/2018,16/11/2018,0.00,,34.00,,"-1,155,494.98"
,IN,AR,30331983,1005,100,,Invoice,,,,,,16/11/2018,16/11/2018,0.00,,3.64,,"-1,155,498.62"
,IN,AR,30331993,1005,100,,Invoice,,,,,,16/11/2018,16/11/2018,0.00,,29.15,,"-1,155,527.77"
,IN,AR,30331997,1005,100,,Invoice,,,,,,16/11/2018,16/11/2018,0.00,,11.19,,"-1,155,538.96"
,IN,AR,30332019,1005,100,,Invoice,,,,,,16/11/2018,16/11/2018,0.00,,11.15,,"-1,155,550.11"
,IN,AR,30332032,1005,100,,Invoice,,,,,,16/11/2018,16/11/2018,0.00,,5.17,,"-1,155,555.28"
,IN,AR,30332047,1005,100,,Invoice,,,,,,16/11/2018,16/11/2018,0.00,,19.19,,"-1,155,574.47"
,IN,AR,30332048,1005,100,,Invoice,,,,,,16/11/2018,16/11/2018,0.00,,7.19,,"-1,155,581.66"
,IN,AR,30332057,1005,100,,Invoice,,,,,,16/11/2018,16/11/2018,0.00,,7.29,,"-1,155,588.95"
,IN,AR,30332096,1005,100,,Invoice,,,,,,16/11/2018,16/11/2018,0.00,,18.09,,"-1,155,607.04"
,IN,AR,30332101,1005,100,,Invoice,,,,,,16/11/2018,16/11/2018,0.00,,4.78,,"-1,155,611.82"
,IN,AR,30332117,1005,100,,Invoice,,,,,,16/11/2018,16/11/2018,0.00,,16.53,,"-1,155,628.35"
,IN,AR,30332141,1005,100,,Invoice,,,,,,16/11/2018,16/11/2018,0.00,,55.37,,"-1,155,683.72"
,IN,AR,30332158,1005,100,,Invoice,,,,,,16/11/2018,16/11/2018,0.00,,26.29,,"-1,155,710.01"
,IN,AR,30332200,1005,100,,Invoice,,,,,,16/11/2018,16/11/2018,0.00,,16.95,,"-1,155,726.96"
,IN,AR,30332211,1005,100,,Invoice,,,,,,16/11/2018,16/11/2018,0.00,,2.39,,"-1,155,729.35"
,IN,AR,30332215,1005,100,,Invoice,,,,,,16/11/2018,16/11/2018,0.00,,5.08,,"-1,155,734.43"
,IN,AR,30332216,1005,100,,Invoice,,,,,,16/11/2018,16/11/2018,0.00,,7.63,,"-1,155,742.06"
,IN,AR,30332217,1005,100,,Invoice,,,,,,16/11/2018,16/11/2018,0.00,,5.08,,"-1,155,747.14"
,IN,AR,30332218,1005,100,,Invoice,,,,,,16/11/2018,16/11/2018,0.00,,2.54,,"-1,155,749.68"
,IN,AR,30332228,1005,100,,Invoice,,,,,,16/11/2018,16/11/2018,0.00,,5.08,,"-1,155,754.76"
,IN,AR,30332246,1005,100,,Invoice,,,,,,16/11/2018,16/11/2018,0.00,,2.16,,"-1,155,756.92"
,IN,AR,30332258,1005,100,,Invoice,,,,,,16/11/2018,16/11/2018,0.00,,15.25,,"-1,155,772.17"
,IN,AR,30332264,1005,100,,Invoice,,,,,,16/11/2018,16/11/2018,0.00,,4.24,,"-1,155,776.41"
,IN,AR,30332302,1005,100,,Invoice,,,,,,16/11/2018,16/11/2018,0.00,,6.61,,"-1,155,783.02"
,IN,AR,30332316,1005,100,,Invoice,,,,,,16/11/2018,16/11/2018,0.00,,16.48,,"-1,155,799.50"
,IN,AR,30332324,1005,100,,Invoice,,,,,,16/11/2018,16/11/2018,0.00,,4.24,,"-1,155,803.74"
,IN,AR,30332338,1005,100,,Invoice,,,,,,16/11/2018,16/11/2018,0.00,,14.58,,"-1,155,818.32"
,IN,AR,30332347,1005,100,,Invoice,,,,,,16/11/2018,16/11/2018,0.00,,25.25,,"-1,155,843.57"
,IN,AR,30332378,1005,100,,Invoice,,,,,,16/11/2018,16/11/2018,0.00,,2.12,,"-1,155,845.69"
,IN,AR,30332394,1005,100,,Invoice,,,,,,16/11/2018,16/11/2018,0.00,,7.29,,"-1,155,852.98"
,IN,AR,30332462,1005,100,,Invoice,,,,,,16/11/2018,16/11/2018,0.00,,3.88,,"-1,155,856.86"
,IN,AR,30332491,1005,100,,Invoice,,,,,,16/11/2018,16/11/2018,0.00,,8.81,,"-1,155,865.67"
,IN,AR,30332581,1005,100,,Invoice,,,,,,16/11/2018,16/11/2018,0.00,,17.91,,"-1,155,883.58"
,IN,AR,30332599,1005,100,,Invoice,,,,,,16/11/2018,16/11/2018,0.00,,62.46,,"-1,155,946.04"
,IN,AR,30332608,1005,100,,Invoice,,,,,,16/11/2018,16/11/2018,0.00,,26.00,,"-1,155,972.04"
,IN,AR,30332611,1005,100,,Invoice,,,,,,16/11/2018,16/11/2018,0.00,,23.57,,"-1,155,995.61"
,IN,AR,30332615,1005,100,,Invoice,,,,,,16/11/2018,16/11/2018,0.00,,5.93,,"-1,156,001.54"
,IN,AR,30332622,1005,100,,Invoice,,,,,,16/11/2018,16/11/2018,0.00,,56.12,,"-1,156,057.66"
,IN,AR,30332635,1005,100,,Invoice,,,,,,16/11/2018,16/11/2018,0.00,,32.42,,"-1,156,090.08"
,IN,AR,30332642,1005,100,,Invoice,,,,,,16/11/2018,16/11/2018,0.00,,14.58,,"-1,156,104.66"
,IN,AR,30332644,1005,100,,Invoice,,,,,,16/11/2018,16/11/2018,0.00,,7.29,,"-1,156,111.95"
,IN,AR,30332648,1005,100,,Invoice,,,,,,16/11/2018,16/11/2018,0.00,,26.27,,"-1,156,138.22"
,IN,AR,30332664,1005,100,,Invoice,,,,,,16/11/2018,16/11/2018,0.00,,9.84,,"-1,156,148.06"
,IN,AR,30332665,1005,100,,Invoice,,,,,,16/11/2018,16/11/2018,0.00,,10.93,,"-1,156,158.99"
,IN,AR,30332670,1005,100,,Invoice,,,,,,16/11/2018,16/11/2018,0.00,,14.34,,"-1,156,173.33"
,IN,AR,30332684,1005,100,,Invoice,,,,,,16/11/2018,16/11/2018,0.00,,5.08,,"-1,156,178.41"
,IN,AR,30332697,1005,100,,Invoice,,,,,,16/11/2018,16/11/2018,0.00,,8.00,,"-1,156,186.41"
,IN,AR,30332732,1005,100,,Invoice,,,,,,16/11/2018,16/11/2018,0.00,,35.58,,"-1,156,221.99"
,IN,AR,30332736,1005,100,,Invoice,,,,,,16/11/2018,16/11/2018,0.00,,10.52,,"-1,156,232.51"
,IN,AR,30332737,1005,100,,Invoice,,,,,,16/11/2018,16/11/2018,0.00,,33.64,,"-1,156,266.15"
,IN,AR,30332762,1005,100,,Invoice,,,,,,16/11/2018,16/11/2018,0.00,,10.93,,"-1,156,277.08"
,IN,AR,30332776,1005,100,,Invoice,,,,,,16/11/2018,16/11/2018,0.00,,13.78,,"-1,156,290.86"
,IN,AR,30332779,1005,100,,Invoice,,,,,,16/11/2018,16/11/2018,0.00,,7.29,,"-1,156,298.15"
,IN,AR,30332789,1005,100,,Invoice,,,,,,16/11/2018,16/11/2018,0.00,,14.58,,"-1,156,312.73"
,IN,AR,30332826,1005,100,,Invoice,,,,,,16/11/2018,16/11/2018,0.00,,7.29,,"-1,156,320.02"
,IN,AR,30332831,1005,100,,Invoice,,,,,,16/11/2018,16/11/2018,0.00,,22.71,,"-1,156,342.73"
,IN,AR,30332871,1005,100,,Invoice,,,,,,16/11/2018,16/11/2018,0.00,,61.44,,"-1,156,404.17"
,IN,AR,30332912,1005,100,,Invoice,,,,,,16/11/2018,16/11/2018,0.00,,12.00,,"-1,156,416.17"
,IN,AR,30332954,1005,100,,Invoice,,,,,,16/11/2018,16/11/2018,0.00,,10.95,,"-1,156,427.12"
,IN,AR,30332960,1005,100,,Invoice,,,,,,16/11/2018,16/11/2018,0.00,,33.90,,"-1,156,461.02"
,IN,AR,30332973,1005,100,,Invoice,,,,,,16/11/2018,16/11/2018,0.00,,3.64,,"-1,156,464.66"
,IN,AR,30332986,1005,100,,Invoice,,,,,,16/11/2018,16/11/2018,0.00,,10.21,,"-1,156,474.87"
,IN,AR,30333010,1005,100,,Invoice,,,,,,16/11/2018,16/11/2018,0.00,,7.97,,"-1,156,482.84"
,IN,AR,30333029,1005,100,,Invoice,,,,,,16/11/2018,16/11/2018,0.00,,4.00,,"-1,156,486.84"
,IN,AR,30333030,1005,100,,Invoice,,,,,,16/11/2018,16/11/2018,0.00,,4.00,,"-1,156,490.84"
,IN,AR,30333042,1005,100,,Invoice,,,,,,16/11/2018,16/11/2018,0.00,,14.53,,"-1,156,505.37"
,IN,AR,30333043,1005,100,,Invoice,,,,,,16/11/2018,16/11/2018,0.00,,12.46,,"-1,156,517.83"
,IN,AR,30333090,1005,100,,Invoice,,,,,,16/11/2018,16/11/2018,0.00,,7.29,,"-1,156,525.12"
,IN,AR,30333091,1005,100,,Invoice,,,,,,16/11/2018,16/11/2018,0.00,,44.24,,"-1,156,569.36"
,IN,AR,30333096,1005,100,,Invoice,,,,,,16/11/2018,16/11/2018,0.00,,13.96,,"-1,156,583.32"
,IN,AR,30333107,1005,100,,Invoice,,,,,,16/11/2018,16/11/2018,0.00,,29.15,,"-1,156,612.47"
,IN,AR,30333118,1005,100,,Invoice,,,,,,16/11/2018,16/11/2018,0.00,,14.58,,"-1,156,627.05"
,IN,AR,30333129,1005,100,,Invoice,,,,,,16/11/2018,16/11/2018,0.00,,29.15,,"-1,156,656.20"
,IN,AR,30333134,1005,100,,Invoice,,,,,,16/11/2018,16/11/2018,0.00,,10.93,,"-1,156,667.13"
,IN,AR,30333135,1005,100,,Invoice,,,,,,16/11/2018,16/11/2018,0.00,,10.93,,"-1,156,678.06"
,IN,AR,30333136,1005,100,,Invoice,,,,,,16/11/2018,16/11/2018,0.00,,10.93,,"-1,156,688.99"
,IN,AR,30333182,1005,100,,Invoice,,,,,,16/11/2018,16/11/2018,0.00,,1.80,,"-1,156,690.79"
,IN,AR,30333215,1005,100,,Invoice,,,,,,16/11/2018,16/11/2018,0.00,,54.66,,"-1,156,745.45"
,IN,AR,30333218,1005,100,,Invoice,,,,,,16/11/2018,16/11/2018,0.00,,3.64,,"-1,156,749.09"
,IN,AR,30333220,1005,100,,Invoice,,,,,,16/11/2018,16/11/2018,0.00,,3.64,,"-1,156,752.73"
,CS,AR,32011116,1005,100,,Cash sale,,,,,,17/11/2018,17/11/2018,0.00,,21.86,,"-1,156,774.59"
,CS,AR,32011243,1005,100,,Cash sale,,,,,,17/11/2018,17/11/2018,0.00,,60.17,,"-1,156,834.76"
,CS,AR,32011424,1005,100,,Cash sale,,,,,,17/11/2018,17/11/2018,0.00,,18.22,,"-1,156,852.98"
,CS,AR,32011540,1005,100,,Cash sale,,,,,,17/11/2018,17/11/2018,0.00,,18.22,,"-1,156,871.20"
,IN,AR,30331806,1005,100,,Invoice,,,,,,17/11/2018,17/11/2018,0.00,,6.02,,"-1,156,877.22"
,IN,AR,30331859,1005,100,,Invoice,,,,,,17/11/2018,17/11/2018,0.00,,34.00,,"-1,156,911.22"
,IN,AR,30331888,1005,100,,Invoice,,,,,,17/11/2018,17/11/2018,0.00,,10.93,,"-1,156,922.15"
,IN,AR,30331975,1005,100,,Invoice,,,,,,17/11/2018,17/11/2018,0.00,,105.15,,"-1,157,027.30"
,IN,AR,30331977,1005,100,,Invoice,,,,,,17/11/2018,17/11/2018,0.00,,7.29,,"-1,157,034.59"
,IN,AR,30332023,1005,100,,Invoice,,,,,,17/11/2018,17/11/2018,0.00,,21.86,,"-1,157,056.45"
,IN,AR,30332165,1005,100,,Invoice,,,,,,17/11/2018,17/11/2018,0.00,,3.64,,"-1,157,060.09"
,IN,AR,30332269,1005,100,,Invoice,,,,,,17/11/2018,17/11/2018,0.00,,7.75,,"-1,157,067.84"
,IN,AR,30332270,1005,100,,Invoice,,,,,,17/11/2018,17/11/2018,0.00,,7.29,,"-1,157,075.13"
,IN,AR,30332273,1005,100,,Invoice,,,,,,17/11/2018,17/11/2018,0.00,,10.93,,"-1,157,086.06"
,IN,AR,30332369,1005,100,,Invoice,,,,,,17/11/2018,17/11/2018,0.00,,14.58,,"-1,157,100.64"
,IN,AR,30332526,1005,100,,Invoice,,,,,,17/11/2018,17/11/2018,0.00,,7.29,,"-1,157,107.93"
,IN,AR,30332848,1005,100,,Invoice,,,,,,17/11/2018,17/11/2018,0.00,,12.75,,"-1,157,120.68"
,IN,AR,30333108,1005,100,,Invoice,,,,,,17/11/2018,17/11/2018,0.00,,14.58,,"-1,157,135.26"
,IN,AR,30333109,1005,100,,Invoice,,,,,,17/11/2018,17/11/2018,0.00,,10.93,,"-1,157,146.19"
,IN,AR,30333222,1005,100,,Invoice,,,,,,17/11/2018,17/11/2018,0.00,,7.29,,"-1,157,153.48"
,CS,AR,32011579,1005,100,,Cash sale,,,,,,18/11/2018,18/11/2018,0.00,,54.66,,"-1,157,208.14"
,CS,AR,32011025,1005,100,,Cash sale,,,,,,19/11/2018,19/11/2018,0.00,,8.42,,"-1,157,216.56"
,CS,AR,32011035,1005,100,,Cash sale,,,,,,19/11/2018,19/11/2018,0.00,,7.12,,"-1,157,223.68"
,CS,AR,32011051,1005,100,,Cash sale,,,,,,19/11/2018,19/11/2018,0.00,,14.58,,"-1,157,238.26"
,CS,AR,32011053,1005,100,,Cash sale,,,,,,19/11/2018,19/11/2018,0.00,,10.93,,"-1,157,249.19"
,CS,AR,32011055,1005,100,,Cash sale,,,,,,19/11/2018,19/11/2018,0.00,,7.29,,"-1,157,256.48"
,CS,AR,32011076,1005,100,,Cash sale,,,,,,19/11/2018,19/11/2018,0.00,,3.64,,"-1,157,260.12"
,CS,AR,32011104,1005,100,,Cash sale,,,,,,19/11/2018,19/11/2018,0.00,,12.46,,"-1,157,272.58"
,CS,AR,32011119,1005,100,,Cash sale,,,,,,19/11/2018,19/11/2018,0.00,,7.78,,"-1,157,280.36"
,CS,AR,32011125,1005,100,,Cash sale,,,,,,19/11/2018,19/11/2018,0.00,,5.85,,"-1,157,286.21"
,CS,AR,32011127,1005,100,,Cash sale,,,,,,19/11/2018,19/11/2018,0.00,,7.29,,"-1,157,293.50"
,CS,AR,32011145,1005,100,,Cash sale,,,,,,19/11/2018,19/11/2018,0.00,,7.29,,"-1,157,300.79"
,CS,AR,32011161,1005,100,,Cash sale,,,,,,19/11/2018,19/11/2018,0.00,,3.64,,"-1,157,304.43"
,CS,AR,32011167,1005,100,,Cash sale,,,,,,19/11/2018,19/11/2018,0.00,,10.34,,"-1,157,314.77"
,CS,AR,32011184,1005,100,,Cash sale,,,,,,19/11/2018,19/11/2018,0.00,,7.29,,"-1,157,322.06"
,CS,AR,32011190,1005,100,,Cash sale,,,,,,19/11/2018,19/11/2018,0.00,,10.17,,"-1,157,332.23"
,CS,AR,32011208,1005,100,,Cash sale,,,,,,19/11/2018,19/11/2018,0.00,,15.51,,"-1,157,347.74"
,CS,AR,32011219,1005,100,,Cash sale,,,,,,19/11/2018,19/11/2018,0.00,,8.25,,"-1,157,355.99"
,CS,AR,32011225,1005,100,,Cash sale,,,,,,19/11/2018,19/11/2018,0.00,,7.29,,"-1,157,363.28"
,CS,AR,32011232,1005,100,,Cash sale,,,,,,19/11/2018,19/11/2018,0.00,,1.95,,"-1,157,365.23"
,CS,AR,32011252,1005,100,,Cash sale,,,,,,19/11/2018,19/11/2018,0.00,,20.47,,"-1,157,385.70"
,CS,AR,32011258,1005,100,,Cash sale,,,,,,19/11/2018,19/11/2018,0.00,,8.16,,"-1,157,393.86"
,CS,AR,32011266,1005,100,,Cash sale,,,,,,19/11/2018,19/11/2018,0.00,,15.04,,"-1,157,408.90"
,CS,AR,32011280,1005,100,,Cash sale,,,,,,19/11/2018,19/11/2018,0.00,,8.39,,"-1,157,417.29"
,CS,AR,32011287,1005,100,,Cash sale,,,,,,19/11/2018,19/11/2018,0.00,,3.64,,"-1,157,420.93"
,CS,AR,32011309,1005,100,,Cash sale,,,,,,19/11/2018,19/11/2018,0.00,,3.64,,"-1,157,424.57"
,CS,AR,32011314,1005,100,,Cash sale,,,,,,19/11/2018,19/11/2018,0.00,,23.64,,"-1,157,448.21"
,CS,AR,32011315,1005,100,,Cash sale,,,,,,19/11/2018,19/11/2018,0.00,,2.54,,"-1,157,450.75"
,CS,AR,32011336,1005,100,,Cash sale,,,,,,19/11/2018,19/11/2018,0.00,,5.17,,"-1,157,455.92"
,CS,AR,32011339,1005,100,,Cash sale,,,,,,19/11/2018,19/11/2018,0.00,,5.85,,"-1,157,461.77"
,CS,AR,32011351,1005,100,,Cash sale,,,,,,19/11/2018,19/11/2018,0.00,,54.66,,"-1,157,516.43"
,CS,AR,32011352,1005,100,,Cash sale,,,,,,19/11/2018,19/11/2018,0.00,,7.29,,"-1,157,523.72"
,CS,AR,32011362,1005,100,,Cash sale,,,,,,19/11/2018,19/11/2018,0.00,,7.29,,"-1,157,531.01"
,CS,AR,32011370,1005,100,,Cash sale,,,,,,19/11/2018,19/11/2018,0.00,,27.77,,"-1,157,558.78"
,CS,AR,32011399,1005,100,,Cash sale,,,,,,19/11/2018,19/11/2018,0.00,,7.29,,"-1,157,566.07"
,CS,AR,32011417,1005,100,,Cash sale,,,,,,19/11/2018,19/11/2018,0.00,,17.80,,"-1,157,583.87"
,CS,AR,32011425,1005,100,,Cash sale,,,,,,19/11/2018,19/11/2018,0.00,,7.29,,"-1,157,591.16"
,CS,AR,32011429,1005,100,,Cash sale,,,,,,19/11/2018,19/11/2018,0.00,,7.75,,"-1,157,598.91"
,CS,AR,32011437,1005,100,,Cash sale,,,,,,19/11/2018,19/11/2018,0.00,,364.41,,"-1,157,963.32"
,CS,AR,32011455,1005,100,,Cash sale,,,,,,19/11/2018,19/11/2018,0.00,,6.56,,"-1,157,969.88"
,CS,AR,32011468,1005,100,,Cash sale,,,,,,19/11/2018,19/11/2018,0.00,,11.44,,"-1,157,981.32"
,CS,AR,32011475,1005,100,,Cash sale,,,,,,19/11/2018,19/11/2018,0.00,,10.93,,"-1,157,992.25"
,CS,AR,32011486,1005,100,,Cash sale,,,,,,19/11/2018,19/11/2018,0.00,,9.10,,"-1,158,001.35"
,CS,AR,32011501,1005,100,,Cash sale,,,,,,19/11/2018,19/11/2018,0.00,,15.18,,"-1,158,016.53"
,CS,AR,32011509,1005,100,,Cash sale,,,,,,19/11/2018,19/11/2018,0.00,,10.93,,"-1,158,027.46"
,CS,AR,32011534,1005,100,,Cash sale,,,,,,19/11/2018,19/11/2018,0.00,,10.93,,"-1,158,038.39"
,CS,AR,32011572,1005,100,,Cash sale,,,,,,19/11/2018,19/11/2018,0.00,,3.64,,"-1,158,042.03"
,CS,AR,32011583,1005,100,,Cash sale,,,,,,19/11/2018,19/11/2018,0.00,,3.64,,"-1,158,045.67"
,CS,AR,32011621,1005,100,,Cash sale,,,,,,19/11/2018,19/11/2018,0.00,,13.98,,"-1,158,059.65"
,CS,AR,32011671,1005,100,,Cash sale,,,,,,19/11/2018,19/11/2018,0.00,,14.58,,"-1,158,074.23"
,IN,AR,30331731,1005,100,,Invoice,,,,,,19/11/2018,19/11/2018,0.00,,84.54,,"-1,158,158.77"
,IN,AR,30331736,1005,100,,Invoice,,,,,,19/11/2018,19/11/2018,0.00,,47.46,,"-1,158,206.23"
,IN,AR,30331749,1005,100,,Invoice,,,,,,19/11/2018,19/11/2018,0.00,,14.58,,"-1,158,220.81"
,IN,AR,30331768,1005,100,,Invoice,,,,,,19/11/2018,19/11/2018,0.00,,6.08,,"-1,158,226.89"
,IN,AR,30331769,1005,100,,Invoice,,,,,,19/11/2018,19/11/2018,0.00,,8.10,,"-1,158,234.99"
,IN,AR,30331770,1005,100,,Invoice,,,,,,19/11/2018,19/11/2018,0.00,,4.05,,"-1,158,239.04"
,IN,AR,30331771,1005,100,,Invoice,,,,,,19/11/2018,19/11/2018,0.00,,16.20,,"-1,158,255.24"
,IN,AR,30331772,1005,100,,Invoice,,,,,,19/11/2018,19/11/2018,0.00,,14.18,,"-1,158,269.42"
,IN,AR,30331773,1005,100,,Invoice,,,,,,19/11/2018,19/11/2018,0.00,,4.05,,"-1,158,273.47"
,IN,AR,30331774,1005,100,,Invoice,,,,,,19/11/2018,19/11/2018,0.00,,12.15,,"-1,158,285.62"
,IN,AR,30331827,1005,100,,Invoice,,,,,,19/11/2018,19/11/2018,0.00,,31.70,,"-1,158,317.32"
,IN,AR,30331845,1005,100,,Invoice,,,,,,19/11/2018,19/11/2018,0.00,,10.93,,"-1,158,328.25"
,IN,AR,30331860,1005,100,,Invoice,,,,,,19/11/2018,19/11/2018,0.00,,30.00,,"-1,158,358.25"
,IN,AR,30331872,1005,100,,Invoice,,,,,,19/11/2018,19/11/2018,0.00,,11.02,,"-1,158,369.27"
,IN,AR,30331879,1005,100,,Invoice,,,,,,19/11/2018,19/11/2018,0.00,,56.00,,"-1,158,425.27"
,IN,AR,30331892,1005,100,,Invoice,,,,,,19/11/2018,19/11/2018,0.00,,61.51,,"-1,158,486.78"
,IN,AR,30331908,1005,100,,Invoice,,,,,,19/11/2018,19/11/2018,0.00,,26.00,,"-1,158,512.78"
,IN,AR,30331909,1005,100,,Invoice,,,,,,19/11/2018,19/11/2018,0.00,,28.00,,"-1,158,540.78"
,IN,AR,30331920,1005,100,,Invoice,,,,,,19/11/2018,19/11/2018,0.00,,5.51,,"-1,158,546.29"
,IN,AR,30331923,1005,100,,Invoice,,,,,,19/11/2018,19/11/2018,0.00,,27.97,,"-1,158,574.26"
,IN,AR,30331925,1005,100,,Invoice,,,,,,19/11/2018,19/11/2018,0.00,,8.26,,"-1,158,582.52"
,IN,AR,30331941,1005,100,,Invoice,,,,,,19/11/2018,19/11/2018,0.00,,6.00,,"-1,158,588.52"
,IN,AR,30331946,1005,100,,Invoice,,,,,,19/11/2018,19/11/2018,0.00,,14.58,,"-1,158,603.10"
,IN,AR,30331979,1005,100,,Invoice,,,,,,19/11/2018,19/11/2018,0.00,,32.00,,"-1,158,635.10"
,IN,AR,30332001,1005,100,,Invoice,,,,,,19/11/2018,19/11/2018,0.00,,16.10,,"-1,158,651.20"
,IN,AR,30332008,1005,100,,Invoice,,,,,,19/11/2018,19/11/2018,0.00,,36.44,,"-1,158,687.64"
,IN,AR,30332012,1005,100,,Invoice,,,,,,19/11/2018,19/11/2018,0.00,,7.29,,"-1,158,694.93"
,IN,AR,30332035,1005,100,,Invoice,,,,,,19/11/2018,19/11/2018,0.00,,2.58,,"-1,158,697.51"
,IN,AR,30332053,1005,100,,Invoice,,,,,,19/11/2018,19/11/2018,0.00,,9.19,,"-1,158,706.70"
,IN,AR,30332062,1005,100,,Invoice,,,,,,19/11/2018,19/11/2018,0.00,,5.25,,"-1,158,711.95"
,IN,AR,30332080,1005,100,,Invoice,,,,,,19/11/2018,19/11/2018,0.00,,61.02,,"-1,158,772.97"
,IN,AR,30332081,1005,100,,Invoice,,,,,,19/11/2018,19/11/2018,0.00,,20.34,,"-1,158,793.31"
,IN,AR,30332092,1005,100,,Invoice,,,,,,19/11/2018,19/11/2018,0.00,,10.93,,"-1,158,804.24"
,IN,AR,30332097,1005,100,,Invoice,,,,,,19/11/2018,19/11/2018,0.00,,20.68,,"-1,158,824.92"
,IN,AR,30332108,1005,100,,Invoice,,,,,,19/11/2018,19/11/2018,0.00,,8.90,,"-1,158,833.82"
,IN,AR,30332112,1005,100,,Invoice,,,,,,19/11/2018,19/11/2018,0.00,,7.76,,"-1,158,841.58"
,IN,AR,30332120,1005,100,,Invoice,,,,,,19/11/2018,19/11/2018,0.00,,52.20,,"-1,158,893.78"
,IN,AR,30332142,1005,100,,Invoice,,,,,,19/11/2018,19/11/2018,0.00,,69.73,,"-1,158,963.51"
,IN,AR,30332151,1005,100,,Invoice,,,,,,19/11/2018,19/11/2018,0.00,,40.68,,"-1,159,004.19"
,IN,AR,30332159,1005,100,,Invoice,,,,,,19/11/2018,19/11/2018,0.00,,21.51,,"-1,159,025.70"
,IN,AR,30332167,1005,100,,Invoice,,,,,,19/11/2018,19/11/2018,0.00,,32.20,,"-1,159,057.90"
,IN,AR,30332177,1005,100,,Invoice,,,,,,19/11/2018,19/11/2018,0.00,,6.02,,"-1,159,063.92"
,IN,AR,30332187,1005,100,,Invoice,,,,,,19/11/2018,19/11/2018,0.00,,10.93,,"-1,159,074.85"
,IN,AR,30332189,1005,100,,Invoice,,,,,,19/11/2018,19/11/2018,0.00,,12.03,,"-1,159,086.88"
,IN,AR,30332190,1005,100,,Invoice,,,,,,19/11/2018,19/11/2018,0.00,,2.75,,"-1,159,089.63"
,IN,AR,30332201,1005,100,,Invoice,,,,,,19/11/2018,19/11/2018,0.00,,6.02,,"-1,159,095.65"
,IN,AR,30332219,1005,100,,Invoice,,,,,,19/11/2018,19/11/2018,0.00,,7.63,,"-1,159,103.28"
,IN,AR,30332283,1005,100,,Invoice,,,,,,19/11/2018,19/11/2018,0.00,,20.34,,"-1,159,123.62"
,IN,AR,30332293,1005,100,,Invoice,,,,,,19/11/2018,19/11/2018,0.00,,10.17,,"-1,159,133.79"
,IN,AR,30332306,1005,100,,Invoice,,,,,,19/11/2018,19/11/2018,0.00,,3.64,,"-1,159,137.43"
,IN,AR,30332317,1005,100,,Invoice,,,,,,19/11/2018,19/11/2018,0.00,,3.64,,"-1,159,141.07"
,IN,AR,30332320,1005,100,,Invoice,,,,,,19/11/2018,19/11/2018,0.00,,14.58,,"-1,159,155.65"
,IN,AR,30332322,1005,100,,Invoice,,,,,,19/11/2018,19/11/2018,0.00,,6.36,,"-1,159,162.01"
,IN,AR,30332333,1005,100,,Invoice,,,,,,19/11/2018,19/11/2018,0.00,,13.77,,"-1,159,175.78"
,IN,AR,30332335,1005,100,,Invoice,,,,,,19/11/2018,19/11/2018,0.00,,7.29,,"-1,159,183.07"
,IN,AR,30332342,1005,100,,Invoice,,,,,,19/11/2018,19/11/2018,0.00,,15.21,,"-1,159,198.28"
,IN,AR,30332345,1005,100,,Invoice,,,,,,19/11/2018,19/11/2018,0.00,,4.59,,"-1,159,202.87"
,IN,AR,30332381,1005,100,,Invoice,,,,,,19/11/2018,19/11/2018,0.00,,4.24,,"-1,159,207.11"
,IN,AR,30332382,1005,100,,Invoice,,,,,,19/11/2018,19/11/2018,0.00,,8.47,,"-1,159,215.58"
,IN,AR,30332387,1005,100,,Invoice,,,,,,19/11/2018,19/11/2018,0.00,,48.81,,"-1,159,264.39"
,IN,AR,30332398,1005,100,,Invoice,,,,,,19/11/2018,19/11/2018,0.00,,26.00,,"-1,159,290.39"
,IN,AR,30332424,1005,100,,Invoice,,,,,,19/11/2018,19/11/2018,0.00,,5.17,,"-1,159,295.56"
,IN,AR,30332436,1005,100,,Invoice,,,,,,19/11/2018,19/11/2018,0.00,,42.69,,"-1,159,338.25"
,IN,AR,30332444,1005,100,,Invoice,,,,,,19/11/2018,19/11/2018,0.00,,4.49,,"-1,159,342.74"
,IN,AR,30332454,1005,100,,Invoice,,,,,,19/11/2018,19/11/2018,0.00,,9.13,,"-1,159,351.87"
,IN,AR,30332461,1005,100,,Invoice,,,,,,19/11/2018,19/11/2018,0.00,,51.91,,"-1,159,403.78"
,IN,AR,30332492,1005,100,,Invoice,,,,,,19/11/2018,19/11/2018,0.00,,14.09,,"-1,159,417.87"
,IN,AR,30332503,1005,100,,Invoice,,,,,,19/11/2018,19/11/2018,0.00,,7.29,,"-1,159,425.16"
,IN,AR,30332552,1005,100,,Invoice,,,,,,19/11/2018,19/11/2018,0.00,,4.29,,"-1,159,429.45"
,IN,AR,30332556,1005,100,,Invoice,,,,,,19/11/2018,19/11/2018,0.00,,10.93,,"-1,159,440.38"
,IN,AR,30332623,1005,100,,Invoice,,,,,,19/11/2018,19/11/2018,0.00,,14.03,,"-1,159,454.41"
,IN,AR,30332649,1005,100,,Invoice,,,,,,19/11/2018,19/11/2018,0.00,,15.76,,"-1,159,470.17"
,IN,AR,30332653,1005,100,,Invoice,,,,,,19/11/2018,19/11/2018,0.00,,4.58,,"-1,159,474.75"
,IN,AR,30332676,1005,100,,Invoice,,,,,,19/11/2018,19/11/2018,0.00,,3.64,,"-1,159,478.39"
,IN,AR,30332698,1005,100,,Invoice,,,,,,19/11/2018,19/11/2018,0.00,,6.00,,"-1,159,484.39"
,IN,AR,30332724,1005,100,,Invoice,,,,,,19/11/2018,19/11/2018,0.00,,49.78,,"-1,159,534.17"
,IN,AR,30332756,1005,100,,Invoice,,,,,,19/11/2018,19/11/2018,0.00,,18.22,,"-1,159,552.39"
,IN,AR,30332758,1005,100,,Invoice,,,,,,19/11/2018,19/11/2018,0.00,,5.83,,"-1,159,558.22"
,IN,AR,30332763,1005,100,,Invoice,,,,,,19/11/2018,19/11/2018,0.00,,21.75,,"-1,159,579.97"
,IN,AR,30332765,1005,100,,Invoice,,,,,,19/11/2018,19/11/2018,0.00,,160.81,,"-1,159,740.78"
,IN,AR,30332769,1005,100,,Invoice,,,,,,19/11/2018,19/11/2018,0.00,,22.44,,"-1,159,763.22"
,IN,AR,30332787,1005,100,,Invoice,,,,,,19/11/2018,19/11/2018,0.00,,6.42,,"-1,159,769.64"
,IN,AR,30332791,1005,100,,Invoice,,,,,,19/11/2018,19/11/2018,0.00,,116.00,,"-1,159,885.64"
,IN,AR,30332836,1005,100,,Invoice,,,,,,19/11/2018,19/11/2018,0.00,,26.69,,"-1,159,912.33"
,IN,AR,30332849,1005,100,,Invoice,,,,,,19/11/2018,19/11/2018,0.00,,23.90,,"-1,159,936.23"
,IN,AR,30332913,1005,100,,Invoice,,,,,,19/11/2018,19/11/2018,0.00,,16.00,,"-1,159,952.23"
,IN,AR,30332917,1005,100,,Invoice,,,,,,19/11/2018,19/11/2018,0.00,,3.64,,"-1,159,955.87"
,IN,AR,30332920,1005,100,,Invoice,,,,,,19/11/2018,19/11/2018,0.00,,3.76,,"-1,159,959.63"
,IN,AR,30332937,1005,100,,Invoice,,,,,,19/11/2018,19/11/2018,0.00,,3.64,,"-1,159,963.27"
,IN,AR,30332955,1005,100,,Invoice,,,,,,19/11/2018,19/11/2018,0.00,,5.47,,"-1,159,968.74"
,IN,AR,30332968,1005,100,,Invoice,,,,,,19/11/2018,19/11/2018,0.00,,54.66,,"-1,160,023.40"
,IN,AR,30332976,1005,100,,Invoice,,,,,,19/11/2018,19/11/2018,0.00,,29.15,,"-1,160,052.55"
,IN,AR,30332977,1005,100,,Invoice,,,,,,19/11/2018,19/11/2018,0.00,,5.24,,"-1,160,057.79"
,IN,AR,30332978,1005,100,,Invoice,,,,,,19/11/2018,19/11/2018,0.00,,3.51,,"-1,160,061.30"
,IN,AR,30332987,1005,100,,Invoice,,,,,,19/11/2018,19/11/2018,0.00,,4.08,,"-1,160,065.38"
,IN,AR,30332994,1005,100,,Invoice,,,,,,19/11/2018,19/11/2018,0.00,,10.21,,"-1,160,075.59"
,IN,AR,30333018,1005,100,,Invoice,,,,,,19/11/2018,19/11/2018,0.00,,46.78,,"-1,160,122.37"
,IN,AR,30333044,1005,100,,Invoice,,,,,,19/11/2018,19/11/2018,0.00,,6.23,,"-1,160,128.60"
,IN,AR,30333045,1005,100,,Invoice,,,,,,19/11/2018,19/11/2018,0.00,,4.15,,"-1,160,132.75"
,IN,AR,30333046,1005,100,,Invoice,,,,,,19/11/2018,19/11/2018,0.00,,6.23,,"-1,160,138.98"
,IN,AR,30333047,1005,100,,Invoice,,,,,,19/11/2018,19/11/2018,0.00,,22.84,,"-1,160,161.82"
,IN,AR,30333048,1005,100,,Invoice,,,,,,19/11/2018,19/11/2018,0.00,,8.31,,"-1,160,170.13"
,IN,AR,30333119,1005,100,,Invoice,,,,,,19/11/2018,19/11/2018,0.00,,3.51,,"-1,160,173.64"
,IN,AR,30333131,1005,100,,Invoice,,,,,,19/11/2018,19/11/2018,0.00,,8.41,,"-1,160,182.05"
,IN,AR,30333159,1005,100,,Invoice,,,,,,19/11/2018,19/11/2018,0.00,,69.71,,"-1,160,251.76"
,IN,AR,30333175,1005,100,,Invoice,,,,,,19/11/2018,19/11/2018,0.00,,54.66,,"-1,160,306.42"
,IN,AR,30333224,1005,100,,Invoice,,,,,,19/11/2018,19/11/2018,0.00,,7.75,,"-1,160,314.17"
,CN,AR,31019504,1005,100,,Credit Note,,,,,,20/11/2018,20/11/2018,5.51,,0.00,,"-1,160,308.66"
,CN,AR,31019579,1005,100,,Credit Note,,,,,,20/11/2018,20/11/2018,14.19,,0.00,,"-1,160,294.47"
,CS,AR,32011049,1005,100,,Cash sale,,,,,,20/11/2018,20/11/2018,0.00,,3.64,,"-1,160,298.11"
,CS,AR,32011057,1005,100,,Cash sale,,,,,,20/11/2018,20/11/2018,0.00,,7.29,,"-1,160,305.40"
,CS,AR,32011063,1005,100,,Cash sale,,,,,,20/11/2018,20/11/2018,0.00,,3.64,,"-1,160,309.04"
,CS,AR,32011072,1005,100,,Cash sale,,,,,,20/11/2018,20/11/2018,0.00,,14.58,,"-1,160,323.62"
,CS,AR,32011078,1005,100,,Cash sale,,,,,,20/11/2018,20/11/2018,0.00,,7.29,,"-1,160,330.91"
,CS,AR,32011086,1005,100,,Cash sale,,,,,,20/11/2018,20/11/2018,0.00,,3.01,,"-1,160,333.92"
,CS,AR,32011091,1005,100,,Cash sale,,,,,,20/11/2018,20/11/2018,0.00,,10.93,,"-1,160,344.85"
,CS,AR,32011099,1005,100,,Cash sale,,,,,,20/11/2018,20/11/2018,0.00,,7.29,,"-1,160,352.14"
,CS,AR,32011112,1005,100,,Cash sale,,,,,,20/11/2018,20/11/2018,0.00,,7.29,,"-1,160,359.43"
,CS,AR,32011133,1005,100,,Cash sale,,,,,,20/11/2018,20/11/2018,0.00,,7.29,,"-1,160,366.72"
,CS,AR,32011137,1005,100,,Cash sale,,,,,,20/11/2018,20/11/2018,0.00,,10.93,,"-1,160,377.65"
,CS,AR,32011151,1005,100,,Cash sale,,,,,,20/11/2018,20/11/2018,0.00,,7.29,,"-1,160,384.94"
,CS,AR,32011171,1005,100,,Cash sale,,,,,,20/11/2018,20/11/2018,0.00,,15.25,,"-1,160,400.19"
,CS,AR,32011175,1005,100,,Cash sale,,,,,,20/11/2018,20/11/2018,0.00,,7.29,,"-1,160,407.48"
,CS,AR,32011176,1005,100,,Cash sale,,,,,,20/11/2018,20/11/2018,0.00,,7.29,,"-1,160,414.77"
,CS,AR,32011179,1005,100,,Cash sale,,,,,,20/11/2018,20/11/2018,0.00,,2.58,,"-1,160,417.35"
,CS,AR,32011199,1005,100,,Cash sale,,,,,,20/11/2018,20/11/2018,0.00,,2.84,,"-1,160,420.19"
,CS,AR,32011217,1005,100,,Cash sale,,,,,,20/11/2018,20/11/2018,0.00,,2.58,,"-1,160,422.77"
,CS,AR,32011249,1005,100,,Cash sale,,,,,,20/11/2018,20/11/2018,0.00,,7.80,,"-1,160,430.57"
,CS,AR,32011257,1005,100,,Cash sale,,,,,,20/11/2018,20/11/2018,0.00,,11.23,,"-1,160,441.80"
,CS,AR,32011275,1005,100,,Cash sale,,,,,,20/11/2018,20/11/2018,0.00,,3.64,,"-1,160,445.44"
,CS,AR,32011278,1005,100,,Cash sale,,,,,,20/11/2018,20/11/2018,0.00,,5.85,,"-1,160,451.29"
,CS,AR,32011279,1005,100,,Cash sale,,,,,,20/11/2018,20/11/2018,0.00,,10.93,,"-1,160,462.22"
,CS,AR,32011285,1005,100,,Cash sale,,,,,,20/11/2018,20/11/2018,0.00,,3.90,,"-1,160,466.12"
,CS,AR,32011289,1005,100,,Cash sale,,,,,,20/11/2018,20/11/2018,0.00,,3.64,,"-1,160,469.76"
,CS,AR,32011290,1005,100,,Cash sale,,,,,,20/11/2018,20/11/2018,0.00,,14.58,,"-1,160,484.34"
,CS,AR,32011294,1005,100,,Cash sale,,,,,,20/11/2018,20/11/2018,0.00,,10.81,,"-1,160,495.15"
,CS,AR,32011298,1005,100,,Cash sale,,,,,,20/11/2018,20/11/2018,0.00,,7.29,,"-1,160,502.44"
,CS,AR,32011305,1005,100,,Cash sale,,,,,,20/11/2018,20/11/2018,0.00,,10.34,,"-1,160,512.78"
,CS,AR,32011312,1005,100,,Cash sale,,,,,,20/11/2018,20/11/2018,0.00,,25.51,,"-1,160,538.29"
,CS,AR,32011318,1005,100,,Cash sale,,,,,,20/11/2018,20/11/2018,0.00,,10.34,,"-1,160,548.63"
,CS,AR,32011321,1005,100,,Cash sale,,,,,,20/11/2018,20/11/2018,0.00,,7.29,,"-1,160,555.92"
,CS,AR,32011323,1005,100,,Cash sale,,,,,,20/11/2018,20/11/2018,0.00,,3.90,,"-1,160,559.82"
,CS,AR,32011343,1005,100,,Cash sale,,,,,,20/11/2018,20/11/2018,0.00,,10.93,,"-1,160,570.75"
,CS,AR,32011353,1005,100,,Cash sale,,,,,,20/11/2018,20/11/2018,0.00,,7.29,,"-1,160,578.04"
,CS,AR,32011374,1005,100,,Cash sale,,,,,,20/11/2018,20/11/2018,0.00,,3.64,,"-1,160,581.68"
,CS,AR,32011392,1005,100,,Cash sale,,,,,,20/11/2018,20/11/2018,0.00,,5.64,,"-1,160,587.32"
,CS,AR,32011411,1005,100,,Cash sale,,,,,,20/11/2018,20/11/2018,0.00,,7.29,,"-1,160,594.61"
,CS,AR,32011441,1005,100,,Cash sale,,,,,,20/11/2018,20/11/2018,0.00,,20.34,,"-1,160,614.95"
,CS,AR,32011444,1005,100,,Cash sale,,,,,,20/11/2018,20/11/2018,0.00,,20.00,,"-1,160,634.95"
,CS,AR,32011447,1005,100,,Cash sale,,,,,,20/11/2018,20/11/2018,0.00,,3.64,,"-1,160,638.59"
,CS,AR,32011476,1005,100,,Cash sale,,,,,,20/11/2018,20/11/2018,0.00,,5.93,,"-1,160,644.52"
,CS,AR,32011480,1005,100,,Cash sale,,,,,,20/11/2018,20/11/2018,0.00,,10.93,,"-1,160,655.45"
,CS,AR,32011490,1005,100,,Cash sale,,,,,,20/11/2018,20/11/2018,0.00,,5.50,,"-1,160,660.95"
,CS,AR,32011505,1005,100,,Cash sale,,,,,,20/11/2018,20/11/2018,0.00,,39.11,,"-1,160,700.06"
,CS,AR,32011506,1005,100,,Cash sale,,,,,,20/11/2018,20/11/2018,0.00,,111.31,,"-1,160,811.37"
,CS,AR,32011548,1005,100,,Cash sale,,,,,,20/11/2018,20/11/2018,0.00,,7.29,,"-1,160,818.66"
,CS,AR,32011563,1005,100,,Cash sale,,,,,,20/11/2018,20/11/2018,0.00,,10.93,,"-1,160,829.59"
,CS,AR,32011624,1005,100,,Cash sale,,,,,,20/11/2018,20/11/2018,0.00,,3.10,,"-1,160,832.69"
,CS,AR,32011651,1005,100,,Cash sale,,,,,,20/11/2018,20/11/2018,0.00,,2.97,,"-1,160,835.66"
,CS,AR,32011658,1005,100,,Cash sale,,,,,,20/11/2018,20/11/2018,0.00,,14.58,,"-1,160,850.24"
,IN,AR,30331732,1005,100,,Invoice,,,,,,20/11/2018,20/11/2018,0.00,,78.20,,"-1,160,928.44"
,IN,AR,30331818,1005,100,,Invoice,,,,,,20/11/2018,20/11/2018,0.00,,7.29,,"-1,160,935.73"
,IN,AR,30331821,1005,100,,Invoice,,,,,,20/11/2018,20/11/2018,0.00,,7.00,,"-1,160,942.73"
,IN,AR,30331850,1005,100,,Invoice,,,,,,20/11/2018,20/11/2018,0.00,,3.98,,"-1,160,946.71"
,IN,AR,30331861,1005,100,,Invoice,,,,,,20/11/2018,20/11/2018,0.00,,86.00,,"-1,161,032.71"
,IN,AR,30331886,1005,100,,Invoice,,,,,,20/11/2018,20/11/2018,0.00,,7.29,,"-1,161,040.00"
,IN,AR,30331921,1005,100,,Invoice,,,,,,20/11/2018,20/11/2018,0.00,,5.51,,"-1,161,045.51"
,IN,AR,30331950,1005,100,,Invoice,,,,,,20/11/2018,20/11/2018,0.00,,21.86,,"-1,161,067.37"
,IN,AR,30331987,1005,100,,Invoice,,,,,,20/11/2018,20/11/2018,0.00,,19.24,,"-1,161,086.61"
,IN,AR,30332010,1005,100,,Invoice,,,,,,20/11/2018,20/11/2018,0.00,,10.93,,"-1,161,097.54"
,IN,AR,30332011,1005,100,,Invoice,,,,,,20/11/2018,20/11/2018,0.00,,3.64,,"-1,161,101.18"
,IN,AR,30332020,1005,100,,Invoice,,,,,,20/11/2018,20/11/2018,0.00,,6.37,,"-1,161,107.55"
,IN,AR,30332040,1005,100,,Invoice,,,,,,20/11/2018,20/11/2018,0.00,,13.73,,"-1,161,121.28"
,IN,AR,30332042,1005,100,,Invoice,,,,,,20/11/2018,20/11/2018,0.00,,6.97,,"-1,161,128.25"
,IN,AR,30332068,1005,100,,Invoice,,,,,,20/11/2018,20/11/2018,0.00,,12.03,,"-1,161,140.28"
,IN,AR,30332070,1005,100,,Invoice,,,,,,20/11/2018,20/11/2018,0.00,,8.47,,"-1,161,148.75"
,IN,AR,30332088,1005,100,,Invoice,,,,,,20/11/2018,20/11/2018,0.00,,8.47,,"-1,161,157.22"
,IN,AR,30332129,1005,100,,Invoice,,,,,,20/11/2018,20/11/2018,0.00,,15.04,,"-1,161,172.26"
,IN,AR,30332155,1005,100,,Invoice,,,,,,20/11/2018,20/11/2018,0.00,,9.43,,"-1,161,181.69"
,IN,AR,30332160,1005,100,,Invoice,,,,,,20/11/2018,20/11/2018,0.00,,2.39,,"-1,161,184.08"
,IN,AR,30332234,1005,100,,Invoice,,,,,,20/11/2018,20/11/2018,0.00,,11.23,,"-1,161,195.31"
,IN,AR,30332240,1005,100,,Invoice,,,,,,20/11/2018,20/11/2018,0.00,,5.85,,"-1,161,201.16"
,IN,AR,30332241,1005,100,,Invoice,,,,,,20/11/2018,20/11/2018,0.00,,7.29,,"-1,161,208.45"
,IN,AR,30332244,1005,100,,Invoice,,,,,,20/11/2018,20/11/2018,0.00,,15.25,,"-1,161,223.70"
,IN,AR,30332257,1005,100,,Invoice,,,,,,20/11/2018,20/11/2018,0.00,,21.61,,"-1,161,245.31"
,IN,AR,30332260,1005,100,,Invoice,,,,,,20/11/2018,20/11/2018,0.00,,3.64,,"-1,161,248.95"
,IN,AR,30332278,1005,100,,Invoice,,,,,,20/11/2018,20/11/2018,0.00,,19.58,,"-1,161,268.53"
,IN,AR,30332295,1005,100,,Invoice,,,,,,20/11/2018,20/11/2018,0.00,,4.08,,"-1,161,272.61"
,IN,AR,30332303,1005,100,,Invoice,,,,,,20/11/2018,20/11/2018,0.00,,4.96,,"-1,161,277.57"
,IN,AR,30332308,1005,100,,Invoice,,,,,,20/11/2018,20/11/2018,0.00,,20.34,,"-1,161,297.91"
,IN,AR,30332313,1005,100,,Invoice,,,,,,20/11/2018,20/11/2018,0.00,,8.77,,"-1,161,306.68"
,IN,AR,30332323,1005,100,,Invoice,,,,,,20/11/2018,20/11/2018,0.00,,29.66,,"-1,161,336.34"
,IN,AR,30332329,1005,100,,Invoice,,,,,,20/11/2018,20/11/2018,0.00,,4.24,,"-1,161,340.58"
,IN,AR,30332348,1005,100,,Invoice,,,,,,20/11/2018,20/11/2018,0.00,,25.25,,"-1,161,365.83"
,IN,AR,30332373,1005,100,,Invoice,,,,,,20/11/2018,20/11/2018,0.00,,7.29,,"-1,161,373.12"
,IN,AR,30332401,1005,100,,Invoice,,,,,,20/11/2018,20/11/2018,0.00,,17.54,,"-1,161,390.66"
,IN,AR,30332420,1005,100,,Invoice,,,,,,20/11/2018,20/11/2018,0.00,,5.59,,"-1,161,396.25"
,IN,AR,30332428,1005,100,,Invoice,,,,,,20/11/2018,20/11/2018,0.00,,5.86,,"-1,161,402.11"
,IN,AR,30332466,1005,100,,Invoice,,,,,,20/11/2018,20/11/2018,0.00,,6.53,,"-1,161,408.64"
,IN,AR,30332470,1005,100,,Invoice,,,,,,20/11/2018,20/11/2018,0.00,,3.64,,"-1,161,412.28"
,IN,AR,30332481,1005,100,,Invoice,,,,,,20/11/2018,20/11/2018,0.00,,42.88,,"-1,161,455.16"
,IN,AR,30332482,1005,100,,Invoice,,,,,,20/11/2018,20/11/2018,0.00,,42.88,,"-1,161,498.04"
,IN,AR,30332493,1005,100,,Invoice,,,,,,20/11/2018,20/11/2018,0.00,,1.76,,"-1,161,499.80"
,IN,AR,30332514,1005,100,,Invoice,,,,,,20/11/2018,20/11/2018,0.00,,47.37,,"-1,161,547.17"
,IN,AR,30332516,1005,100,,Invoice,,,,,,20/11/2018,20/11/2018,0.00,,2.58,,"-1,161,549.75"
,IN,AR,30332522,1005,100,,Invoice,,,,,,20/11/2018,20/11/2018,0.00,,3.64,,"-1,161,553.39"
,IN,AR,30332523,1005,100,,Invoice,,,,,,20/11/2018,20/11/2018,0.00,,7.29,,"-1,161,560.68"
,IN,AR,30332525,1005,100,,Invoice,,,,,,20/11/2018,20/11/2018,0.00,,14.58,,"-1,161,575.26"
,IN,AR,30332551,1005,100,,Invoice,,,,,,20/11/2018,20/11/2018,0.00,,7.29,,"-1,161,582.55"
,IN,AR,30332582,1005,100,,Invoice,,,,,,20/11/2018,20/11/2018,0.00,,3.98,,"-1,161,586.53"
,IN,AR,30332583,1005,100,,Invoice,,,,,,20/11/2018,20/11/2018,0.00,,9.95,,"-1,161,596.48"
,IN,AR,30332584,1005,100,,Invoice,,,,,,20/11/2018,20/11/2018,0.00,,252.71,,"-1,161,849.19"
,IN,AR,30332585,1005,100,,Invoice,,,,,,20/11/2018,20/11/2018,0.00,,25.86,,"-1,161,875.05"
,IN,AR,30332586,1005,100,,Invoice,,,,,,20/11/2018,20/11/2018,0.00,,3.98,,"-1,161,879.03"
,IN,AR,30332600,1005,100,,Invoice,,,,,,20/11/2018,20/11/2018,0.00,,28.39,,"-1,161,907.42"
,IN,AR,30332632,1005,100,,Invoice,,,,,,20/11/2018,20/11/2018,0.00,,3.01,,"-1,161,910.43"
,IN,AR,30332639,1005,100,,Invoice,,,,,,20/11/2018,20/11/2018,0.00,,183.66,,"-1,162,094.09"
,IN,AR,30332659,1005,100,,Invoice,,,,,,20/11/2018,20/11/2018,0.00,,9.84,,"-1,162,103.93"
,IN,AR,30332666,1005,100,,Invoice,,,,,,20/11/2018,20/11/2018,0.00,,10.93,,"-1,162,114.86"
,IN,AR,30332685,1005,100,,Invoice,,,,,,20/11/2018,20/11/2018,0.00,,10.17,,"-1,162,125.03"
,IN,AR,30332686,1005,100,,Invoice,,,,,,20/11/2018,20/11/2018,0.00,,12.71,,"-1,162,137.74"
,IN,AR,30332704,1005,100,,Invoice,,,,,,20/11/2018,20/11/2018,0.00,,14.00,,"-1,162,151.74"
,IN,AR,30332767,1005,100,,Invoice,,,,,,20/11/2018,20/11/2018,0.00,,10.93,,"-1,162,162.67"
,IN,AR,30332809,1005,100,,Invoice,,,,,,20/11/2018,20/11/2018,0.00,,47.46,,"-1,162,210.13"
,IN,AR,30332820,1005,100,,Invoice,,,,,,20/11/2018,20/11/2018,0.00,,3.64,,"-1,162,213.77"
,IN,AR,30332850,1005,100,,Invoice,,,,,,20/11/2018,20/11/2018,0.00,,6.37,,"-1,162,220.14"
,IN,AR,30332863,1005,100,,Invoice,,,,,,20/11/2018,20/11/2018,0.00,,92.20,,"-1,162,312.34"
,IN,AR,30332876,1005,100,,Invoice,,,,,,20/11/2018,20/11/2018,0.00,,30.85,,"-1,162,343.19"
,IN,AR,30332877,1005,100,,Invoice,,,,,,20/11/2018,20/11/2018,0.00,,80.69,,"-1,162,423.88"
,IN,AR,30332896,1005,100,,Invoice,,,,,,20/11/2018,20/11/2018,0.00,,20.34,,"-1,162,444.22"
,IN,AR,30332909,1005,100,,Invoice,,,,,,20/11/2018,20/11/2018,0.00,,3.64,,"-1,162,447.86"
,IN,AR,30332927,1005,100,,Invoice,,,,,,20/11/2018,20/11/2018,0.00,,3.51,,"-1,162,451.37"
,IN,AR,30332931,1005,100,,Invoice,,,,,,20/11/2018,20/11/2018,0.00,,12.00,,"-1,162,463.37"
,IN,AR,30332933,1005,100,,Invoice,,,,,,20/11/2018,20/11/2018,0.00,,5.93,,"-1,162,469.30"
,IN,AR,30332940,1005,100,,Invoice,,,,,,20/11/2018,20/11/2018,0.00,,114.97,,"-1,162,584.27"
,IN,AR,30332947,1005,100,,Invoice,,,,,,20/11/2018,20/11/2018,0.00,,7.02,,"-1,162,591.29"
,IN,AR,30332966,1005,100,,Invoice,,,,,,20/11/2018,20/11/2018,0.00,,12.14,,"-1,162,603.43"
,IN,AR,30332972,1005,100,,Invoice,,,,,,20/11/2018,20/11/2018,0.00,,145.76,,"-1,162,749.19"
,IN,AR,30332981,1005,100,,Invoice,,,,,,20/11/2018,20/11/2018,0.00,,15.71,,"-1,162,764.90"
,IN,AR,30333003,1005,100,,Invoice,,,,,,20/11/2018,20/11/2018,0.00,,7.29,,"-1,162,772.19"
,IN,AR,30333007,1005,100,,Invoice,,,,,,20/11/2018,20/11/2018,0.00,,11.19,,"-1,162,783.38"
,IN,AR,30333011,1005,100,,Invoice,,,,,,20/11/2018,20/11/2018,0.00,,9.96,,"-1,162,793.34"
,IN,AR,30333049,1005,100,,Invoice,,,,,,20/11/2018,20/11/2018,0.00,,2.08,,"-1,162,795.42"
,IN,AR,30333050,1005,100,,Invoice,,,,,,20/11/2018,20/11/2018,0.00,,4.15,,"-1,162,799.57"
,IN,AR,30333051,1005,100,,Invoice,,,,,,20/11/2018,20/11/2018,0.00,,10.38,,"-1,162,809.95"
,IN,AR,30333052,1005,100,,Invoice,,,,,,20/11/2018,20/11/2018,0.00,,6.23,,"-1,162,816.18"
,IN,AR,30333078,1005,100,,Invoice,,,,,,20/11/2018,20/11/2018,0.00,,54.66,,"-1,162,870.84"
,IN,AR,30333079,1005,100,,Invoice,,,,,,20/11/2018,20/11/2018,0.00,,43.22,,"-1,162,914.06"
,IN,AR,30333083,1005,100,,Invoice,,,,,,20/11/2018,20/11/2018,0.00,,16.91,,"-1,162,930.97"
,IN,AR,30333113,1005,100,,Invoice,,,,,,20/11/2018,20/11/2018,0.00,,10.17,,"-1,162,941.14"
,IN,AR,30333145,1005,100,,Invoice,,,,,,20/11/2018,20/11/2018,0.00,,127.42,,"-1,163,068.56"
,IN,AR,30333156,1005,100,,Invoice,,,,,,20/11/2018,20/11/2018,0.00,,11.86,,"-1,163,080.42"
,IN,AR,30333157,1005,100,,Invoice,,,,,,20/11/2018,20/11/2018,0.00,,2.97,,"-1,163,083.39"
,IN,AR,30333161,1005,100,,Invoice,,,,,,20/11/2018,20/11/2018,0.00,,7.29,,"-1,163,090.68"
,IN,AR,30333168,1005,100,,Invoice,,,,,,20/11/2018,20/11/2018,0.00,,9.10,,"-1,163,099.78"
,IN,AR,30333172,1005,100,,Invoice,,,,,,20/11/2018,20/11/2018,0.00,,29.15,,"-1,163,128.93"
,IN,AR,30333194,1005,100,,Invoice,,,,,,20/11/2018,20/11/2018,0.00,,8.21,,"-1,163,137.14"
,IN,AR,30333203,1005,100,,Invoice,,,,,,20/11/2018,20/11/2018,0.00,,54.66,,"-1,163,191.80"
,IN,AR,30333207,1005,100,,Invoice,,,,,,20/11/2018,20/11/2018,0.00,,18.22,,"-1,163,210.02"
,IN,AR,30333225,1005,100,,Invoice,,,,,,20/11/2018,20/11/2018,0.00,,54.66,,"-1,163,264.68"
,IN,AR,30333230,1005,100,,Invoice,,,,,,20/11/2018,20/11/2018,0.00,,54.66,,"-1,163,319.34"
,CS,AR,32012564,1005,100,,Cash sale,,,,,,20/11/2018,20/11/2018,0.00,,9.75,,"-1,163,329.09"
,CN,AR,31019577,1005,100,,Credit Note,,,,,,21/11/2018,21/11/2018,14.03,,0.00,,"-1,163,315.06"
,CS,AR,32011026,1005,100,,Cash sale,,,,,,21/11/2018,21/11/2018,0.00,,5.61,,"-1,163,320.67"
,CS,AR,32011032,1005,100,,Cash sale,,,,,,21/11/2018,21/11/2018,0.00,,30.10,,"-1,163,350.77"
,CS,AR,32011058,1005,100,,Cash sale,,,,,,21/11/2018,21/11/2018,0.00,,7.29,,"-1,163,358.06"
,CS,AR,32011061,1005,100,,Cash sale,,,,,,21/11/2018,21/11/2018,0.00,,7.29,,"-1,163,365.35"
,CS,AR,32011093,1005,100,,Cash sale,,,,,,21/11/2018,21/11/2018,0.00,,3.64,,"-1,163,368.99"
,CS,AR,32011096,1005,100,,Cash sale,,,,,,21/11/2018,21/11/2018,0.00,,21.86,,"-1,163,390.85"
,CS,AR,32011115,1005,100,,Cash sale,,,,,,21/11/2018,21/11/2018,0.00,,9.03,,"-1,163,399.88"
,CS,AR,32011153,1005,100,,Cash sale,,,,,,21/11/2018,21/11/2018,0.00,,3.64,,"-1,163,403.52"
,CS,AR,32011157,1005,100,,Cash sale,,,,,,21/11/2018,21/11/2018,0.00,,5.86,,"-1,163,409.38"
,CS,AR,32011202,1005,100,,Cash sale,,,,,,21/11/2018,21/11/2018,0.00,,7.75,,"-1,163,417.13"
,CS,AR,32011214,1005,100,,Cash sale,,,,,,21/11/2018,21/11/2018,0.00,,10.93,,"-1,163,428.06"
,CS,AR,32011221,1005,100,,Cash sale,,,,,,21/11/2018,21/11/2018,0.00,,30.08,,"-1,163,458.14"
,CS,AR,32011223,1005,100,,Cash sale,,,,,,21/11/2018,21/11/2018,0.00,,6.43,,"-1,163,464.57"
,CS,AR,32011237,1005,100,,Cash sale,,,,,,21/11/2018,21/11/2018,0.00,,18.22,,"-1,163,482.79"
,CS,AR,32011283,1005,100,,Cash sale,,,,,,21/11/2018,21/11/2018,0.00,,3.64,,"-1,163,486.43"
,CS,AR,32011337,1005,100,,Cash sale,,,,,,21/11/2018,21/11/2018,0.00,,3.64,,"-1,163,490.07"
,CS,AR,32011341,1005,100,,Cash sale,,,,,,21/11/2018,21/11/2018,0.00,,14.58,,"-1,163,504.65"
,CS,AR,32011358,1005,100,,Cash sale,,,,,,21/11/2018,21/11/2018,0.00,,7.29,,"-1,163,511.94"
,CS,AR,32011391,1005,100,,Cash sale,,,,,,21/11/2018,21/11/2018,0.00,,18.22,,"-1,163,530.16"
,CS,AR,32011404,1005,100,,Cash sale,,,,,,21/11/2018,21/11/2018,0.00,,26.10,,"-1,163,556.26"
,CS,AR,32011436,1005,100,,Cash sale,,,,,,21/11/2018,21/11/2018,0.00,,3.64,,"-1,163,559.90"
,CS,AR,32011449,1005,100,,Cash sale,,,,,,21/11/2018,21/11/2018,0.00,,8.26,,"-1,163,568.16"
,CS,AR,32011461,1005,100,,Cash sale,,,,,,21/11/2018,21/11/2018,0.00,,3.28,,"-1,163,571.44"
,CS,AR,32011469,1005,100,,Cash sale,,,,,,21/11/2018,21/11/2018,0.00,,9.15,,"-1,163,580.59"
,CS,AR,32011497,1005,100,,Cash sale,,,,,,21/11/2018,21/11/2018,0.00,,6.02,,"-1,163,586.61"
,CS,AR,32011510,1005,100,,Cash sale,,,,,,21/11/2018,21/11/2018,0.00,,10.93,,"-1,163,597.54"
,CS,AR,32011562,1005,100,,Cash sale,,,,,,21/11/2018,21/11/2018,0.00,,54.66,,"-1,163,652.20"
,CS,AR,32011568,1005,100,,Cash sale,,,,,,21/11/2018,21/11/2018,0.00,,10.99,,"-1,163,663.19"
,CS,AR,32011573,1005,100,,Cash sale,,,,,,21/11/2018,21/11/2018,0.00,,3.64,,"-1,163,666.83"
,CS,AR,32011636,1005,100,,Cash sale,,,,,,21/11/2018,21/11/2018,0.00,,8.19,,"-1,163,675.02"
,CS,AR,32011640,1005,100,,Cash sale,,,,,,21/11/2018,21/11/2018,0.00,,3.64,,"-1,163,678.66"
,CS,AR,32011660,1005,100,,Cash sale,,,,,,21/11/2018,21/11/2018,0.00,,7.29,,"-1,163,685.95"
,IN,AR,30331737,1005,100,,Invoice,,,,,,21/11/2018,21/11/2018,0.00,,50.42,,"-1,163,736.37"
,IN,AR,30331756,1005,100,,Invoice,,,,,,21/11/2018,21/11/2018,0.00,,36.44,,"-1,163,772.81"
,IN,AR,30331762,1005,100,,Invoice,,,,,,21/11/2018,21/11/2018,0.00,,56.14,,"-1,163,828.95"
,IN,AR,30331763,1005,100,,Invoice,,,,,,21/11/2018,21/11/2018,0.00,,34.17,,"-1,163,863.12"
,IN,AR,30331792,1005,100,,Invoice,,,,,,21/11/2018,21/11/2018,0.00,,25.89,,"-1,163,889.01"
,IN,AR,30331801,1005,100,,Invoice,,,,,,21/11/2018,21/11/2018,0.00,,28.90,,"-1,163,917.91"
,IN,AR,30331802,1005,100,,Invoice,,,,,,21/11/2018,21/11/2018,0.00,,73.56,,"-1,163,991.47"
,IN,AR,30331805,1005,100,,Invoice,,,,,,21/11/2018,21/11/2018,0.00,,7.29,,"-1,163,998.76"
,IN,AR,30331809,1005,100,,Invoice,,,,,,21/11/2018,21/11/2018,0.00,,7.29,,"-1,164,006.05"
,IN,AR,30331812,1005,100,,Invoice,,,,,,21/11/2018,21/11/2018,0.00,,9.66,,"-1,164,015.71"
,IN,AR,30331824,1005,100,,Invoice,,,,,,21/11/2018,21/11/2018,0.00,,20.34,,"-1,164,036.05"
,IN,AR,30331862,1005,100,,Invoice,,,,,,21/11/2018,21/11/2018,0.00,,24.00,,"-1,164,060.05"
,IN,AR,30331883,1005,100,,Invoice,,,,,,21/11/2018,21/11/2018,0.00,,3.64,,"-1,164,063.69"
,IN,AR,30331910,1005,100,,Invoice,,,,,,21/11/2018,21/11/2018,0.00,,36.00,,"-1,164,099.69"
,IN,AR,30331930,1005,100,,Invoice,,,,,,21/11/2018,21/11/2018,0.00,,24.00,,"-1,164,123.69"
,IN,AR,30331957,1005,100,,Invoice,,,,,,21/11/2018,21/11/2018,0.00,,180.10,,"-1,164,303.79"
,IN,AR,30331964,1005,100,,Invoice,,,,,,21/11/2018,21/11/2018,0.00,,30.51,,"-1,164,334.30"
,IN,AR,30331992,1005,100,,Invoice,,,,,,21/11/2018,21/11/2018,0.00,,3.01,,"-1,164,337.31"
,IN,AR,30332005,1005,100,,Invoice,,,,,,21/11/2018,21/11/2018,0.00,,21.22,,"-1,164,358.53"
,IN,AR,30332014,1005,100,,Invoice,,,,,,21/11/2018,21/11/2018,0.00,,10.93,,"-1,164,369.46"
,IN,AR,30332064,1005,100,,Invoice,,,,,,21/11/2018,21/11/2018,0.00,,12.71,,"-1,164,382.17"
,IN,AR,30332074,1005,100,,Invoice,,,,,,21/11/2018,21/11/2018,0.00,,2.12,,"-1,164,384.29"
,IN,AR,30332076,1005,100,,Invoice,,,,,,21/11/2018,21/11/2018,0.00,,29.15,,"-1,164,413.44"
,IN,AR,30332085,1005,100,,Invoice,,,,,,21/11/2018,21/11/2018,0.00,,2.12,,"-1,164,415.56"
,IN,AR,30332090,1005,100,,Invoice,,,,,,21/11/2018,21/11/2018,0.00,,5.59,,"-1,164,421.15"
,IN,AR,30332093,1005,100,,Invoice,,,,,,21/11/2018,21/11/2018,0.00,,16.95,,"-1,164,438.10"
,IN,AR,30332094,1005,100,,Invoice,,,,,,21/11/2018,21/11/2018,0.00,,29.15,,"-1,164,467.25"
,IN,AR,30332115,1005,100,,Invoice,,,,,,21/11/2018,21/11/2018,0.00,,4.78,,"-1,164,472.03"
,IN,AR,30332122,1005,100,,Invoice,,,,,,21/11/2018,21/11/2018,0.00,,14.58,,"-1,164,486.61"
,IN,AR,30332134,1005,100,,Invoice,,,,,,21/11/2018,21/11/2018,0.00,,9.56,,"-1,164,496.17"
,IN,AR,30332139,1005,100,,Invoice,,,,,,21/11/2018,21/11/2018,0.00,,16.95,,"-1,164,513.12"
,IN,AR,30332143,1005,100,,Invoice,,,,,,21/11/2018,21/11/2018,0.00,,41.02,,"-1,164,554.14"
,IN,AR,30332168,1005,100,,Invoice,,,,,,21/11/2018,21/11/2018,0.00,,12.88,,"-1,164,567.02"
,IN,AR,30332186,1005,100,,Invoice,,,,,,21/11/2018,21/11/2018,0.00,,2.12,,"-1,164,569.14"
,IN,AR,30332192,1005,100,,Invoice,,,,,,21/11/2018,21/11/2018,0.00,,7.29,,"-1,164,576.43"
,IN,AR,30332196,1005,100,,Invoice,,,,,,21/11/2018,21/11/2018,0.00,,5.17,,"-1,164,581.60"
,IN,AR,30332203,1005,100,,Invoice,,,,,,21/11/2018,21/11/2018,0.00,,222.07,,"-1,164,803.67"
,IN,AR,30332207,1005,100,,Invoice,,,,,,21/11/2018,21/11/2018,0.00,,15.25,,"-1,164,818.92"
,IN,AR,30332220,1005,100,,Invoice,,,,,,21/11/2018,21/11/2018,0.00,,2.54,,"-1,164,821.46"
,IN,AR,30332236,1005,100,,Invoice,,,,,,21/11/2018,21/11/2018,0.00,,16.55,,"-1,164,838.01"
,IN,AR,30332242,1005,100,,Invoice,,,,,,21/11/2018,21/11/2018,0.00,,6.36,,"-1,164,844.37"
,IN,AR,30332275,1005,100,,Invoice,,,,,,21/11/2018,21/11/2018,0.00,,18.17,,"-1,164,862.54"
,IN,AR,30332281,1005,100,,Invoice,,,,,,21/11/2018,21/11/2018,0.00,,10.00,,"-1,164,872.54"
,IN,AR,30332326,1005,100,,Invoice,,,,,,21/11/2018,21/11/2018,0.00,,14.58,,"-1,164,887.12"
,IN,AR,30332339,1005,100,,Invoice,,,,,,21/11/2018,21/11/2018,0.00,,14.58,,"-1,164,901.70"
,IN,AR,30332341,1005,100,,Invoice,,,,,,21/11/2018,21/11/2018,0.00,,6.13,,"-1,164,907.83"
,IN,AR,30332360,1005,100,,Invoice,,,,,,21/11/2018,21/11/2018,0.00,,23.73,,"-1,164,931.56"
,IN,AR,30332375,1005,100,,Invoice,,,,,,21/11/2018,21/11/2018,0.00,,15.51,,"-1,164,947.07"
,IN,AR,30332380,1005,100,,Invoice,,,,,,21/11/2018,21/11/2018,0.00,,14.58,,"-1,164,961.65"
,IN,AR,30332385,1005,100,,Invoice,,,,,,21/11/2018,21/11/2018,0.00,,25.17,,"-1,164,986.82"
,IN,AR,30332392,1005,100,,Invoice,,,,,,21/11/2018,21/11/2018,0.00,,10.17,,"-1,164,996.99"
,IN,AR,30332395,1005,100,,Invoice,,,,,,21/11/2018,21/11/2018,0.00,,21.86,,"-1,165,018.85"
,IN,AR,30332396,1005,100,,Invoice,,,,,,21/11/2018,21/11/2018,0.00,,14.58,,"-1,165,033.43"
,IN,AR,30332404,1005,100,,Invoice,,,,,,21/11/2018,21/11/2018,0.00,,54.66,,"-1,165,088.09"
,IN,AR,30332434,1005,100,,Invoice,,,,,,21/11/2018,21/11/2018,0.00,,37.12,,"-1,165,125.21"
,IN,AR,30332440,1005,100,,Invoice,,,,,,21/11/2018,21/11/2018,0.00,,54.66,,"-1,165,179.87"
,IN,AR,30332447,1005,100,,Invoice,,,,,,21/11/2018,21/11/2018,0.00,,21.06,,"-1,165,200.93"
,IN,AR,30332463,1005,100,,Invoice,,,,,,21/11/2018,21/11/2018,0.00,,23.29,,"-1,165,224.22"
,IN,AR,30332473,1005,100,,Invoice,,,,,,21/11/2018,21/11/2018,0.00,,10.93,,"-1,165,235.15"
,IN,AR,30332501,1005,100,,Invoice,,,,,,21/11/2018,21/11/2018,0.00,,15.04,,"-1,165,250.19"
,IN,AR,30332505,1005,100,,Invoice,,,,,,21/11/2018,21/11/2018,0.00,,10.93,,"-1,165,261.12"
,IN,AR,30332528,1005,100,,Invoice,,,,,,21/11/2018,21/11/2018,0.00,,7.75,,"-1,165,268.87"
,IN,AR,30332533,1005,100,,Invoice,,,,,,21/11/2018,21/11/2018,0.00,,18.22,,"-1,165,287.09"
,IN,AR,30332541,1005,100,,Invoice,,,,,,21/11/2018,21/11/2018,0.00,,10.00,,"-1,165,297.09"
,IN,AR,30332545,1005,100,,Invoice,,,,,,21/11/2018,21/11/2018,0.00,,25.51,,"-1,165,322.60"
,IN,AR,30332546,1005,100,,Invoice,,,,,,21/11/2018,21/11/2018,0.00,,36.44,,"-1,165,359.04"
,IN,AR,30332562,1005,100,,Invoice,,,,,,21/11/2018,21/11/2018,0.00,,10.17,,"-1,165,369.21"
,IN,AR,30332564,1005,100,,Invoice,,,,,,21/11/2018,21/11/2018,0.00,,10.93,,"-1,165,380.14"
,IN,AR,30332595,1005,100,,Invoice,,,,,,21/11/2018,21/11/2018,0.00,,4.01,,"-1,165,384.15"
,IN,AR,30332606,1005,100,,Invoice,,,,,,21/11/2018,21/11/2018,0.00,,24.00,,"-1,165,408.15"
,IN,AR,30332620,1005,100,,Invoice,,,,,,21/11/2018,21/11/2018,0.00,,36.08,,"-1,165,444.23"
,IN,AR,30332626,1005,100,,Invoice,,,,,,21/11/2018,21/11/2018,0.00,,10.93,,"-1,165,455.16"
,IN,AR,30332628,1005,100,,Invoice,,,,,,21/11/2018,21/11/2018,0.00,,3.64,,"-1,165,458.80"
,IN,AR,30332657,1005,100,,Invoice,,,,,,21/11/2018,21/11/2018,0.00,,54.66,,"-1,165,513.46"
,IN,AR,30332662,1005,100,,Invoice,,,,,,21/11/2018,21/11/2018,0.00,,12.73,,"-1,165,526.19"
,IN,AR,30332668,1005,100,,Invoice,,,,,,21/11/2018,21/11/2018,0.00,,36.22,,"-1,165,562.41"
,IN,AR,30332687,1005,100,,Invoice,,,,,,21/11/2018,21/11/2018,0.00,,2.54,,"-1,165,564.95"
,IN,AR,30332694,1005,100,,Invoice,,,,,,21/11/2018,21/11/2018,0.00,,8.90,,"-1,165,573.85"
,IN,AR,30332718,1005,100,,Invoice,,,,,,21/11/2018,21/11/2018,0.00,,11.66,,"-1,165,585.51"
,IN,AR,30332722,1005,100,,Invoice,,,,,,21/11/2018,21/11/2018,0.00,,39.75,,"-1,165,625.26"
,IN,AR,30332725,1005,100,,Invoice,,,,,,21/11/2018,21/11/2018,0.00,,4.53,,"-1,165,629.79"
,IN,AR,30332728,1005,100,,Invoice,,,,,,21/11/2018,21/11/2018,0.00,,2.92,,"-1,165,632.71"
,IN,AR,30332738,1005,100,,Invoice,,,,,,21/11/2018,21/11/2018,0.00,,8.41,,"-1,165,641.12"
,IN,AR,30332739,1005,100,,Invoice,,,,,,21/11/2018,21/11/2018,0.00,,14.72,,"-1,165,655.84"
,IN,AR,30332770,1005,100,,Invoice,,,,,,21/11/2018,21/11/2018,0.00,,14.03,,"-1,165,669.87"
,IN,AR,30332771,1005,100,,Invoice,,,,,,21/11/2018,21/11/2018,0.00,,14.03,,"-1,165,683.90"
,IN,AR,30332784,1005,100,,Invoice,,,,,,21/11/2018,21/11/2018,0.00,,5.59,,"-1,165,689.49"
,IN,AR,30332798,1005,100,,Invoice,,,,,,21/11/2018,21/11/2018,0.00,,4.00,,"-1,165,693.49"
,IN,AR,30332825,1005,100,,Invoice,,,,,,21/11/2018,21/11/2018,0.00,,10.93,,"-1,165,704.42"
,IN,AR,30332835,1005,100,,Invoice,,,,,,21/11/2018,21/11/2018,0.00,,17.49,,"-1,165,721.91"
,IN,AR,30332851,1005,100,,Invoice,,,,,,21/11/2018,21/11/2018,0.00,,7.97,,"-1,165,729.88"
,IN,AR,30332852,1005,100,,Invoice,,,,,,21/11/2018,21/11/2018,0.00,,3.19,,"-1,165,733.07"
,IN,AR,30332924,1005,100,,Invoice,,,,,,21/11/2018,21/11/2018,0.00,,7.02,,"-1,165,740.09"
,IN,AR,30332929,1005,100,,Invoice,,,,,,21/11/2018,21/11/2018,0.00,,8.26,,"-1,165,748.35"
,IN,AR,30332950,1005,100,,Invoice,,,,,,21/11/2018,21/11/2018,0.00,,54.66,,"-1,165,803.01"
,IN,AR,30332963,1005,100,,Invoice,,,,,,21/11/2018,21/11/2018,0.00,,5.64,,"-1,165,808.65"
,IN,AR,30332964,1005,100,,Invoice,,,,,,21/11/2018,21/11/2018,0.00,,3.76,,"-1,165,812.41"
,IN,AR,30332982,1005,100,,Invoice,,,,,,21/11/2018,21/11/2018,0.00,,15.71,,"-1,165,828.12"
,IN,AR,30333005,1005,100,,Invoice,,,,,,21/11/2018,21/11/2018,0.00,,8.26,,"-1,165,836.38"
,IN,AR,30333021,1005,100,,Invoice,,,,,,21/11/2018,21/11/2018,0.00,,13.73,,"-1,165,850.11"
,IN,AR,30333053,1005,100,,Invoice,,,,,,21/11/2018,21/11/2018,0.00,,60.21,,"-1,165,910.32"
,IN,AR,30333054,1005,100,,Invoice,,,,,,21/11/2018,21/11/2018,0.00,,8.31,,"-1,165,918.63"
,IN,AR,30333055,1005,100,,Invoice,,,,,,21/11/2018,21/11/2018,0.00,,16.61,,"-1,165,935.24"
,IN,AR,30333056,1005,100,,Invoice,,,,,,21/11/2018,21/11/2018,0.00,,4.15,,"-1,165,939.39"
,IN,AR,30333089,1005,100,,Invoice,,,,,,21/11/2018,21/11/2018,0.00,,24.27,,"-1,165,963.66"
,IN,AR,30333116,1005,100,,Invoice,,,,,,21/11/2018,21/11/2018,0.00,,32.80,,"-1,165,996.46"
,IN,AR,30333126,1005,100,,Invoice,,,,,,21/11/2018,21/11/2018,0.00,,3.64,,"-1,166,000.10"
,IN,AR,30333139,1005,100,,Invoice,,,,,,21/11/2018,21/11/2018,0.00,,27.97,,"-1,166,028.07"
,IN,AR,30333153,1005,100,,Invoice,,,,,,21/11/2018,21/11/2018,0.00,,7.29,,"-1,166,035.36"
,IN,AR,30333178,1005,100,,Invoice,,,,,,21/11/2018,21/11/2018,0.00,,29.15,,"-1,166,064.51"
,IN,AR,30333183,1005,100,,Invoice,,,,,,21/11/2018,21/11/2018,0.00,,3.59,,"-1,166,068.10"
,IN,AR,30333186,1005,100,,Invoice,,,,,,21/11/2018,21/11/2018,0.00,,10.93,,"-1,166,079.03"
,IN,AR,30333223,1005,100,,Invoice,,,,,,21/11/2018,21/11/2018,0.00,,10.93,,"-1,166,089.96"
,IN,AR,30333231,1005,100,,Invoice,,,,,,21/11/2018,21/11/2018,0.00,,182.20,,"-1,166,272.16"
,CN,AR,31019538,1005,100,,Credit Note,,,,,,22/11/2018,22/11/2018,4.24,,0.00,,"-1,166,267.92"
,CS,AR,32011022,1005,100,,Cash sale,,,,,,22/11/2018,22/11/2018,0.00,,18.05,,"-1,166,285.97"
,CS,AR,32011040,1005,100,,Cash sale,,,,,,22/11/2018,22/11/2018,0.00,,11.36,,"-1,166,297.33"
,CS,AR,32011045,1005,100,,Cash sale,,,,,,22/11/2018,22/11/2018,0.00,,3.64,,"-1,166,300.97"
,CS,AR,32011064,1005,100,,Cash sale,,,,,,22/11/2018,22/11/2018,0.00,,7.29,,"-1,166,308.26"
,CS,AR,32011089,1005,100,,Cash sale,,,,,,22/11/2018,22/11/2018,0.00,,7.29,,"-1,166,315.55"
,CS,AR,32011109,1005,100,,Cash sale,,,,,,22/11/2018,22/11/2018,0.00,,7.29,,"-1,166,322.84"
,CS,AR,32011141,1005,100,,Cash sale,,,,,,22/11/2018,22/11/2018,0.00,,7.29,,"-1,166,330.13"
,CS,AR,32011152,1005,100,,Cash sale,,,,,,22/11/2018,22/11/2018,0.00,,3.01,,"-1,166,333.14"
,CS,AR,32011160,1005,100,,Cash sale,,,,,,22/11/2018,22/11/2018,0.00,,3.64,,"-1,166,336.78"
,CS,AR,32011163,1005,100,,Cash sale,,,,,,22/11/2018,22/11/2018,0.00,,7.29,,"-1,166,344.07"
,CS,AR,32011182,1005,100,,Cash sale,,,,,,22/11/2018,22/11/2018,0.00,,7.29,,"-1,166,351.36"
,CS,AR,32011196,1005,100,,Cash sale,,,,,,22/11/2018,22/11/2018,0.00,,7.75,,"-1,166,359.11"
,CS,AR,32011245,1005,100,,Cash sale,,,,,,22/11/2018,22/11/2018,0.00,,18.22,,"-1,166,377.33"
,CS,AR,32011272,1005,100,,Cash sale,,,,,,22/11/2018,22/11/2018,0.00,,10.21,,"-1,166,387.54"
,CS,AR,32011293,1005,100,,Cash sale,,,,,,22/11/2018,22/11/2018,0.00,,10.93,,"-1,166,398.47"
,CS,AR,32011311,1005,100,,Cash sale,,,,,,22/11/2018,22/11/2018,0.00,,7.29,,"-1,166,405.76"
,CS,AR,32011313,1005,100,,Cash sale,,,,,,22/11/2018,22/11/2018,0.00,,3.64,,"-1,166,409.40"
,CS,AR,32011333,1005,100,,Cash sale,,,,,,22/11/2018,22/11/2018,0.00,,33.56,,"-1,166,442.96"
,CS,AR,32011357,1005,100,,Cash sale,,,,,,22/11/2018,22/11/2018,0.00,,12.88,,"-1,166,455.84"
,CS,AR,32011365,1005,100,,Cash sale,,,,,,22/11/2018,22/11/2018,0.00,,7.29,,"-1,166,463.13"
,CS,AR,32011368,1005,100,,Cash sale,,,,,,22/11/2018,22/11/2018,0.00,,7.75,,"-1,166,470.88"
,CS,AR,32011423,1005,100,,Cash sale,,,,,,22/11/2018,22/11/2018,0.00,,2.58,,"-1,166,473.46"
,CS,AR,32011432,1005,100,,Cash sale,,,,,,22/11/2018,22/11/2018,0.00,,25.42,,"-1,166,498.88"
,CS,AR,32011452,1005,100,,Cash sale,,,,,,22/11/2018,22/11/2018,0.00,,5.93,,"-1,166,504.81"
,CS,AR,32011454,1005,100,,Cash sale,,,,,,22/11/2018,22/11/2018,0.00,,2.74,,"-1,166,507.55"
,CS,AR,32011464,1005,100,,Cash sale,,,,,,22/11/2018,22/11/2018,0.00,,3.64,,"-1,166,511.19"
,CS,AR,32011499,1005,100,,Cash sale,,,,,,22/11/2018,22/11/2018,0.00,,21.86,,"-1,166,533.05"
,CS,AR,32011500,1005,100,,Cash sale,,,,,,22/11/2018,22/11/2018,0.00,,7.29,,"-1,166,540.34"
,CS,AR,32011507,1005,100,,Cash sale,,,,,,22/11/2018,22/11/2018,0.00,,5.47,,"-1,166,545.81"
,CS,AR,32011546,1005,100,,Cash sale,,,,,,22/11/2018,22/11/2018,0.00,,10.93,,"-1,166,556.74"
,CS,AR,32011549,1005,100,,Cash sale,,,,,,22/11/2018,22/11/2018,0.00,,10.93,,"-1,166,567.67"
,CS,AR,32011559,1005,100,,Cash sale,,,,,,22/11/2018,22/11/2018,0.00,,8.78,,"-1,166,576.45"
,CS,AR,32011582,1005,100,,Cash sale,,,,,,22/11/2018,22/11/2018,0.00,,18.22,,"-1,166,594.67"
,CS,AR,32011639,1005,100,,Cash sale,,,,,,22/11/2018,22/11/2018,0.00,,7.29,,"-1,166,601.96"
,CS,AR,32011645,1005,100,,Cash sale,,,,,,22/11/2018,22/11/2018,0.00,,10.93,,"-1,166,612.89"
,CS,AR,32011648,1005,100,,Cash sale,,,,,,22/11/2018,22/11/2018,0.00,,3.64,,"-1,166,616.53"
,CS,AR,32011664,1005,100,,Cash sale,,,,,,22/11/2018,22/11/2018,0.00,,6.56,,"-1,166,623.09"
,CS,AR,32011670,1005,100,,Cash sale,,,,,,22/11/2018,22/11/2018,0.00,,3.64,,"-1,166,626.73"
,CS,AR,32011677,1005,100,,Cash sale,,,,,,22/11/2018,22/11/2018,0.00,,14.58,,"-1,166,641.31"
,CS,AR,32011678,1005,100,,Cash sale,,,,,,22/11/2018,22/11/2018,0.00,,14.58,,"-1,166,655.89"
,IN,AR,30331743,1005,100,,Invoice,,,,,,22/11/2018,22/11/2018,0.00,,15.04,,"-1,166,670.93"
,IN,AR,30331759,1005,100,,Invoice,,,,,,22/11/2018,22/11/2018,0.00,,10.93,,"-1,166,681.86"
,IN,AR,30331784,1005,100,,Invoice,,,,,,22/11/2018,22/11/2018,0.00,,3.64,,"-1,166,685.50"
,IN,AR,30331816,1005,100,,Invoice,,,,,,22/11/2018,22/11/2018,0.00,,14.58,,"-1,166,700.08"
,IN,AR,30331851,1005,100,,Invoice,,,,,,22/11/2018,22/11/2018,0.00,,3.98,,"-1,166,704.06"
,IN,AR,30331863,1005,100,,Invoice,,,,,,22/11/2018,22/11/2018,0.00,,56.00,,"-1,166,760.06"
,IN,AR,30331880,1005,100,,Invoice,,,,,,22/11/2018,22/11/2018,0.00,,26.00,,"-1,166,786.06"
,IN,AR,30331919,1005,100,,Invoice,,,,,,22/11/2018,22/11/2018,0.00,,3.64,,"-1,166,789.70"
,IN,AR,30331927,1005,100,,Invoice,,,,,,22/11/2018,22/11/2018,0.00,,7.29,,"-1,166,796.99"
,IN,AR,30331936,1005,100,,Invoice,,,,,,22/11/2018,22/11/2018,0.00,,14.24,,"-1,166,811.23"
,IN,AR,30331937,1005,100,,Invoice,,,,,,22/11/2018,22/11/2018,0.00,,47.46,,"-1,166,858.69"
,IN,AR,30331949,1005,100,,Invoice,,,,,,22/11/2018,22/11/2018,0.00,,43.93,,"-1,166,902.62"
,IN,AR,30331952,1005,100,,Invoice,,,,,,22/11/2018,22/11/2018,0.00,,11.36,,"-1,166,913.98"
,IN,AR,30331965,1005,100,,Invoice,,,,,,22/11/2018,22/11/2018,0.00,,748.42,,"-1,167,662.40"
,IN,AR,30332024,1005,100,,Invoice,,,,,,22/11/2018,22/11/2018,0.00,,14.58,,"-1,167,676.98"
,IN,AR,30332026,1005,100,,Invoice,,,,,,22/11/2018,22/11/2018,0.00,,12.92,,"-1,167,689.90"
,IN,AR,30332027,1005,100,,Invoice,,,,,,22/11/2018,22/11/2018,0.00,,18.22,,"-1,167,708.12"
,IN,AR,30332030,1005,100,,Invoice,,,,,,22/11/2018,22/11/2018,0.00,,24.50,,"-1,167,732.62"
,IN,AR,30332037,1005,100,,Invoice,,,,,,22/11/2018,22/11/2018,0.00,,182.20,,"-1,167,914.82"
,IN,AR,30332044,1005,100,,Invoice,,,,,,22/11/2018,22/11/2018,0.00,,6.02,,"-1,167,920.84"
,IN,AR,30332049,1005,100,,Invoice,,,,,,22/11/2018,22/11/2018,0.00,,7.19,,"-1,167,928.03"
,IN,AR,30332066,1005,100,,Invoice,,,,,,22/11/2018,22/11/2018,0.00,,7.29,,"-1,167,935.32"
,IN,AR,30332127,1005,100,,Invoice,,,,,,22/11/2018,22/11/2018,0.00,,23.90,,"-1,167,959.22"
,IN,AR,30332136,1005,100,,Invoice,,,,,,22/11/2018,22/11/2018,0.00,,408.14,,"-1,168,367.36"
,IN,AR,30332152,1005,100,,Invoice,,,,,,22/11/2018,22/11/2018,0.00,,68.64,,"-1,168,436.00"
,IN,AR,30332161,1005,100,,Invoice,,,,,,22/11/2018,22/11/2018,0.00,,21.51,,"-1,168,457.51"
,IN,AR,30332169,1005,100,,Invoice,,,,,,22/11/2018,22/11/2018,0.00,,6.44,,"-1,168,463.95"
,IN,AR,30332175,1005,100,,Invoice,,,,,,22/11/2018,22/11/2018,0.00,,16.10,,"-1,168,480.05"
,IN,AR,30332188,1005,100,,Invoice,,,,,,22/11/2018,22/11/2018,0.00,,26.10,,"-1,168,506.15"
,IN,AR,30332193,1005,100,,Invoice,,,,,,22/11/2018,22/11/2018,0.00,,54.66,,"-1,168,560.81"
,IN,AR,30332210,1005,100,,Invoice,,,,,,22/11/2018,22/11/2018,0.00,,6.36,,"-1,168,567.17"
,IN,AR,30332239,1005,100,,Invoice,,,,,,22/11/2018,22/11/2018,0.00,,5.17,,"-1,168,572.34"
,IN,AR,30332263,1005,100,,Invoice,,,,,,22/11/2018,22/11/2018,0.00,,2.12,,"-1,168,574.46"
,IN,AR,30332266,1005,100,,Invoice,,,,,,22/11/2018,22/11/2018,0.00,,10.59,,"-1,168,585.05"
,IN,AR,30332284,1005,100,,Invoice,,,,,,22/11/2018,22/11/2018,0.00,,20.34,,"-1,168,605.39"
,IN,AR,30332288,1005,100,,Invoice,,,,,,22/11/2018,22/11/2018,0.00,,20.00,,"-1,168,625.39"
,IN,AR,30332300,1005,100,,Invoice,,,,,,22/11/2018,22/11/2018,0.00,,3.64,,"-1,168,629.03"
,IN,AR,30332315,1005,100,,Invoice,,,,,,22/11/2018,22/11/2018,0.00,,19.28,,"-1,168,648.31"
,IN,AR,30332344,1005,100,,Invoice,,,,,,22/11/2018,22/11/2018,0.00,,16.47,,"-1,168,664.78"
,IN,AR,30332353,1005,100,,Invoice,,,,,,22/11/2018,22/11/2018,0.00,,4.24,,"-1,168,669.02"
,IN,AR,30332354,1005,100,,Invoice,,,,,,22/11/2018,22/11/2018,0.00,,12.71,,"-1,168,681.73"
,IN,AR,30332361,1005,100,,Invoice,,,,,,22/11/2018,22/11/2018,0.00,,35.59,,"-1,168,717.32"
,IN,AR,30332364,1005,100,,Invoice,,,,,,22/11/2018,22/11/2018,0.00,,10.50,,"-1,168,727.82"
,IN,AR,30332372,1005,100,,Invoice,,,,,,22/11/2018,22/11/2018,0.00,,3.64,,"-1,168,731.46"
,IN,AR,30332408,1005,100,,Invoice,,,,,,22/11/2018,22/11/2018,0.00,,6.97,,"-1,168,738.43"
,IN,AR,30332410,1005,100,,Invoice,,,,,,22/11/2018,22/11/2018,0.00,,5.85,,"-1,168,744.28"
,IN,AR,30332411,1005,100,,Invoice,,,,,,22/11/2018,22/11/2018,0.00,,18.22,,"-1,168,762.50"
,IN,AR,30332416,1005,100,,Invoice,,,,,,22/11/2018,22/11/2018,0.00,,24.79,,"-1,168,787.29"
,IN,AR,30332432,1005,100,,Invoice,,,,,,22/11/2018,22/11/2018,0.00,,5.68,,"-1,168,792.97"
,IN,AR,30332451,1005,100,,Invoice,,,,,,22/11/2018,22/11/2018,0.00,,18.05,,"-1,168,811.02"
,IN,AR,30332458,1005,100,,Invoice,,,,,,22/11/2018,22/11/2018,0.00,,8.25,,"-1,168,819.27"
,IN,AR,30332465,1005,100,,Invoice,,,,,,22/11/2018,22/11/2018,0.00,,7.63,,"-1,168,826.90"
,IN,AR,30332472,1005,100,,Invoice,,,,,,22/11/2018,22/11/2018,0.00,,31.23,,"-1,168,858.13"
,IN,AR,30332478,1005,100,,Invoice,,,,,,22/11/2018,22/11/2018,0.00,,10.00,,"-1,168,868.13"
,IN,AR,30332485,1005,100,,Invoice,,,,,,22/11/2018,22/11/2018,0.00,,10.68,,"-1,168,878.81"
,IN,AR,30332494,1005,100,,Invoice,,,,,,22/11/2018,22/11/2018,0.00,,1.76,,"-1,168,880.57"
,IN,AR,30332506,1005,100,,Invoice,,,,,,22/11/2018,22/11/2018,0.00,,10.93,,"-1,168,891.50"
,IN,AR,30332511,1005,100,,Invoice,,,,,,22/11/2018,22/11/2018,0.00,,6.81,,"-1,168,898.31"
,IN,AR,30332512,1005,100,,Invoice,,,,,,22/11/2018,22/11/2018,0.00,,3.64,,"-1,168,901.95"
,IN,AR,30332513,1005,100,,Invoice,,,,,,22/11/2018,22/11/2018,0.00,,5.49,,"-1,168,907.44"
,IN,AR,30332535,1005,100,,Invoice,,,,,,22/11/2018,22/11/2018,0.00,,13.09,,"-1,168,920.53"
,IN,AR,30332538,1005,100,,Invoice,,,,,,22/11/2018,22/11/2018,0.00,,5.86,,"-1,168,926.39"
,IN,AR,30332559,1005,100,,Invoice,,,,,,22/11/2018,22/11/2018,0.00,,10.93,,"-1,168,937.32"
,IN,AR,30332565,1005,100,,Invoice,,,,,,22/11/2018,22/11/2018,0.00,,18.22,,"-1,168,955.54"
,IN,AR,30332573,1005,100,,Invoice,,,,,,22/11/2018,22/11/2018,0.00,,13.94,,"-1,168,969.48"
,IN,AR,30332574,1005,100,,Invoice,,,,,,22/11/2018,22/11/2018,0.00,,13.94,,"-1,168,983.42"
,IN,AR,30332575,1005,100,,Invoice,,,,,,22/11/2018,22/11/2018,0.00,,3.98,,"-1,168,987.40"
,IN,AR,30332576,1005,100,,Invoice,,,,,,22/11/2018,22/11/2018,0.00,,41.82,,"-1,169,029.22"
,IN,AR,30332587,1005,100,,Invoice,,,,,,22/11/2018,22/11/2018,0.00,,13.93,,"-1,169,043.15"
,IN,AR,30332588,1005,100,,Invoice,,,,,,22/11/2018,22/11/2018,0.00,,15.92,,"-1,169,059.07"
,IN,AR,30332627,1005,100,,Invoice,,,,,,22/11/2018,22/11/2018,0.00,,54.66,,"-1,169,113.73"
,IN,AR,30332630,1005,100,,Invoice,,,,,,22/11/2018,22/11/2018,0.00,,3.64,,"-1,169,117.37"
,IN,AR,30332660,1005,100,,Invoice,,,,,,22/11/2018,22/11/2018,0.00,,6.56,,"-1,169,123.93"
,IN,AR,30332678,1005,100,,Invoice,,,,,,22/11/2018,22/11/2018,0.00,,8.90,,"-1,169,132.83"
,IN,AR,30332688,1005,100,,Invoice,,,,,,22/11/2018,22/11/2018,0.00,,20.34,,"-1,169,153.17"
,IN,AR,30332696,1005,100,,Invoice,,,,,,22/11/2018,22/11/2018,0.00,,22.01,,"-1,169,175.18"
,IN,AR,30332707,1005,100,,Invoice,,,,,,22/11/2018,22/11/2018,0.00,,24.01,,"-1,169,199.19"
,IN,AR,30332719,1005,100,,Invoice,,,,,,22/11/2018,22/11/2018,0.00,,8.75,,"-1,169,207.94"
,IN,AR,30332720,1005,100,,Invoice,,,,,,22/11/2018,22/11/2018,0.00,,14.58,,"-1,169,222.52"
,IN,AR,30332761,1005,100,,Invoice,,,,,,22/11/2018,22/11/2018,0.00,,21.86,,"-1,169,244.38"
,IN,AR,30332772,1005,100,,Invoice,,,,,,22/11/2018,22/11/2018,0.00,,16.83,,"-1,169,261.21"
,IN,AR,30332781,1005,100,,Invoice,,,,,,22/11/2018,22/11/2018,0.00,,20.59,,"-1,169,281.80"
,IN,AR,30332795,1005,100,,Invoice,,,,,,22/11/2018,22/11/2018,0.00,,6.07,,"-1,169,287.87"
,IN,AR,30332853,1005,100,,Invoice,,,,,,22/11/2018,22/11/2018,0.00,,4.78,,"-1,169,292.65"
,IN,AR,30332854,1005,100,,Invoice,,,,,,22/11/2018,22/11/2018,0.00,,114.71,,"-1,169,407.36"
,IN,AR,30332855,1005,100,,Invoice,,,,,,22/11/2018,22/11/2018,0.00,,11.15,,"-1,169,418.51"
,IN,AR,30332856,1005,100,,Invoice,,,,,,22/11/2018,22/11/2018,0.00,,4.78,,"-1,169,423.29"
,IN,AR,30332857,1005,100,,Invoice,,,,,,22/11/2018,22/11/2018,0.00,,12.75,,"-1,169,436.04"
,IN,AR,30332899,1005,100,,Invoice,,,,,,22/11/2018,22/11/2018,0.00,,18.31,,"-1,169,454.35"
,IN,AR,30332980,1005,100,,Invoice,,,,,,22/11/2018,22/11/2018,0.00,,3.64,,"-1,169,457.99"
,IN,AR,30332993,1005,100,,Invoice,,,,,,22/11/2018,22/11/2018,0.00,,4.08,,"-1,169,462.07"
,IN,AR,30333006,1005,100,,Invoice,,,,,,22/11/2018,22/11/2018,0.00,,10.35,,"-1,169,472.42"
,IN,AR,30333024,1005,100,,Invoice,,,,,,22/11/2018,22/11/2018,0.00,,2.42,,"-1,169,474.84"
,IN,AR,30333026,1005,100,,Invoice,,,,,,22/11/2018,22/11/2018,0.00,,15.18,,"-1,169,490.02"
,IN,AR,30333057,1005,100,,Invoice,,,,,,22/11/2018,22/11/2018,0.00,,6.23,,"-1,169,496.25"
,IN,AR,30333058,1005,100,,Invoice,,,,,,22/11/2018,22/11/2018,0.00,,8.31,,"-1,169,504.56"
,IN,AR,30333059,1005,100,,Invoice,,,,,,22/11/2018,22/11/2018,0.00,,6.23,,"-1,169,510.79"
,IN,AR,30333060,1005,100,,Invoice,,,,,,22/11/2018,22/11/2018,0.00,,18.69,,"-1,169,529.48"
,IN,AR,30333061,1005,100,,Invoice,,,,,,22/11/2018,22/11/2018,0.00,,10.38,,"-1,169,539.86"
,IN,AR,30333110,1005,100,,Invoice,,,,,,22/11/2018,22/11/2018,0.00,,4.07,,"-1,169,543.93"
,IN,AR,30333125,1005,100,,Invoice,,,,,,22/11/2018,22/11/2018,0.00,,7.63,,"-1,169,551.56"
,IN,AR,30333132,1005,100,,Invoice,,,,,,22/11/2018,22/11/2018,0.00,,8.41,,"-1,169,559.97"
,IN,AR,30333146,1005,100,,Invoice,,,,,,22/11/2018,22/11/2018,0.00,,81.92,,"-1,169,641.89"
,IN,AR,30333171,1005,100,,Invoice,,,,,,22/11/2018,22/11/2018,0.00,,7.02,,"-1,169,648.91"
,IN,AR,30333174,1005,100,,Invoice,,,,,,22/11/2018,22/11/2018,0.00,,7.29,,"-1,169,656.20"
,IN,AR,30333188,1005,100,,Invoice,,,,,,22/11/2018,22/11/2018,0.00,,12.17,,"-1,169,668.37"
,IN,AR,30333197,1005,100,,Invoice,,,,,,22/11/2018,22/11/2018,0.00,,14.44,,"-1,169,682.81"
,IN,AR,30333202,1005,100,,Invoice,,,,,,22/11/2018,22/11/2018,0.00,,5.93,,"-1,169,688.74"
,IN,AR,30333204,1005,100,,Invoice,,,,,,22/11/2018,22/11/2018,0.00,,2.10,,"-1,169,690.84"
,IN,AR,30333208,1005,100,,Invoice,,,,,,22/11/2018,22/11/2018,0.00,,36.44,,"-1,169,727.28"
,IN,AR,30333210,1005,100,,Invoice,,,,,,22/11/2018,22/11/2018,0.00,,25.51,,"-1,169,752.79"
,IN,AR,30333229,1005,100,,Invoice,,,,,,22/11/2018,22/11/2018,0.00,,30.34,,"-1,169,783.13"
,IN,AR,30333233,1005,100,,Invoice,,,,,,22/11/2018,22/11/2018,0.00,,72.88,,"-1,169,856.01"
,IN,AR,30333236,1005,100,,Invoice,,,,,,22/11/2018,22/11/2018,0.00,,29.15,,"-1,169,885.16"
,IN,AR,30333237,1005,100,,Invoice,,,,,,22/11/2018,22/11/2018,0.00,,29.15,,"-1,169,914.31"
,CN,AR,31019526,1005,100,,Credit Note,,,,,,23/11/2018,23/11/2018,5.07,,0.00,,"-1,169,909.24"
,CS,AR,32011020,1005,100,,Cash sale,,,,,,23/11/2018,23/11/2018,0.00,,18.22,,"-1,169,927.46"
,CS,AR,32011027,1005,100,,Cash sale,,,,,,23/11/2018,23/11/2018,0.00,,2.81,,"-1,169,930.27"
,CS,AR,32011036,1005,100,,Cash sale,,,,,,23/11/2018,23/11/2018,0.00,,9.49,,"-1,169,939.76"
,CS,AR,32011042,1005,100,,Cash sale,,,,,,23/11/2018,23/11/2018,0.00,,6.08,,"-1,169,945.84"
,CS,AR,32011054,1005,100,,Cash sale,,,,,,23/11/2018,23/11/2018,0.00,,18.22,,"-1,169,964.06"
,CS,AR,32011066,1005,100,,Cash sale,,,,,,23/11/2018,23/11/2018,0.00,,3.64,,"-1,169,967.70"
,CS,AR,32011070,1005,100,,Cash sale,,,,,,23/11/2018,23/11/2018,0.00,,7.29,,"-1,169,974.99"
,CS,AR,32011083,1005,100,,Cash sale,,,,,,23/11/2018,23/11/2018,0.00,,9.66,,"-1,169,984.65"
,CS,AR,32011102,1005,100,,Cash sale,,,,,,23/11/2018,23/11/2018,0.00,,10.93,,"-1,169,995.58"
,CS,AR,32011105,1005,100,,Cash sale,,,,,,23/11/2018,23/11/2018,0.00,,16.61,,"-1,170,012.19"
,CS,AR,32011120,1005,100,,Cash sale,,,,,,23/11/2018,23/11/2018,0.00,,3.89,,"-1,170,016.08"
,CS,AR,32011124,1005,100,,Cash sale,,,,,,23/11/2018,23/11/2018,0.00,,3.64,,"-1,170,019.72"
,CS,AR,32011126,1005,100,,Cash sale,,,,,,23/11/2018,23/11/2018,0.00,,7.29,,"-1,170,027.01"
,CS,AR,32011143,1005,100,,Cash sale,,,,,,23/11/2018,23/11/2018,0.00,,7.29,,"-1,170,034.30"
,CS,AR,32011147,1005,100,,Cash sale,,,,,,23/11/2018,23/11/2018,0.00,,18.11,,"-1,170,052.41"
,CS,AR,32011191,1005,100,,Cash sale,,,,,,23/11/2018,23/11/2018,0.00,,10.17,,"-1,170,062.58"
,CS,AR,32011205,1005,100,,Cash sale,,,,,,23/11/2018,23/11/2018,0.00,,3.64,,"-1,170,066.22"
,CS,AR,32011211,1005,100,,Cash sale,,,,,,23/11/2018,23/11/2018,0.00,,27.47,,"-1,170,093.69"
,CS,AR,32011216,1005,100,,Cash sale,,,,,,23/11/2018,23/11/2018,0.00,,47.69,,"-1,170,141.38"
,CS,AR,32011227,1005,100,,Cash sale,,,,,,23/11/2018,23/11/2018,0.00,,7.29,,"-1,170,148.67"
,CS,AR,32011253,1005,100,,Cash sale,,,,,,23/11/2018,23/11/2018,0.00,,20.47,,"-1,170,169.14"
,CS,AR,32011264,1005,100,,Cash sale,,,,,,23/11/2018,23/11/2018,0.00,,12.92,,"-1,170,182.06"
,CS,AR,32011267,1005,100,,Cash sale,,,,,,23/11/2018,23/11/2018,0.00,,18.05,,"-1,170,200.11"
,CS,AR,32011273,1005,100,,Cash sale,,,,,,23/11/2018,23/11/2018,0.00,,10.17,,"-1,170,210.28"
,CS,AR,32011292,1005,100,,Cash sale,,,,,,23/11/2018,23/11/2018,0.00,,3.64,,"-1,170,213.92"
,CS,AR,32011346,1005,100,,Cash sale,,,,,,23/11/2018,23/11/2018,0.00,,18.22,,"-1,170,232.14"
,CS,AR,32011356,1005,100,,Cash sale,,,,,,23/11/2018,23/11/2018,0.00,,7.29,,"-1,170,239.43"
,CS,AR,32011360,1005,100,,Cash sale,,,,,,23/11/2018,23/11/2018,0.00,,20.48,,"-1,170,259.91"
,CS,AR,32011376,1005,100,,Cash sale,,,,,,23/11/2018,23/11/2018,0.00,,7.29,,"-1,170,267.20"
,CS,AR,32011380,1005,100,,Cash sale,,,,,,23/11/2018,23/11/2018,0.00,,2.58,,"-1,170,269.78"
,CS,AR,32011384,1005,100,,Cash sale,,,,,,23/11/2018,23/11/2018,0.00,,7.29,,"-1,170,277.07"
,CS,AR,32011386,1005,100,,Cash sale,,,,,,23/11/2018,23/11/2018,0.00,,8.34,,"-1,170,285.41"
,CS,AR,32011398,1005,100,,Cash sale,,,,,,23/11/2018,23/11/2018,0.00,,7.29,,"-1,170,292.70"
,CS,AR,32011418,1005,100,,Cash sale,,,,,,23/11/2018,23/11/2018,0.00,,15.25,,"-1,170,307.95"
,CS,AR,32011445,1005,100,,Cash sale,,,,,,23/11/2018,23/11/2018,0.00,,7.63,,"-1,170,315.58"
,CS,AR,32011458,1005,100,,Cash sale,,,,,,23/11/2018,23/11/2018,0.00,,2.54,,"-1,170,318.12"
,CS,AR,32011460,1005,100,,Cash sale,,,,,,23/11/2018,23/11/2018,0.00,,2.58,,"-1,170,320.70"
,CS,AR,32011465,1005,100,,Cash sale,,,,,,23/11/2018,23/11/2018,0.00,,3.64,,"-1,170,324.34"
,CS,AR,32011470,1005,100,,Cash sale,,,,,,23/11/2018,23/11/2018,0.00,,6.86,,"-1,170,331.20"
,CS,AR,32011485,1005,100,,Cash sale,,,,,,23/11/2018,23/11/2018,0.00,,12.71,,"-1,170,343.91"
,CS,AR,32011488,1005,100,,Cash sale,,,,,,23/11/2018,23/11/2018,0.00,,3.64,,"-1,170,347.55"
,CS,AR,32011494,1005,100,,Cash sale,,,,,,23/11/2018,23/11/2018,0.00,,14.58,,"-1,170,362.13"
,CS,AR,32011511,1005,100,,Cash sale,,,,,,23/11/2018,23/11/2018,0.00,,14.58,,"-1,170,376.71"
,CS,AR,32011518,1005,100,,Cash sale,,,,,,23/11/2018,23/11/2018,0.00,,3.64,,"-1,170,380.35"
,CS,AR,32011520,1005,100,,Cash sale,,,,,,23/11/2018,23/11/2018,0.00,,12.14,,"-1,170,392.49"
,CS,AR,32011523,1005,100,,Cash sale,,,,,,23/11/2018,23/11/2018,0.00,,6.10,,"-1,170,398.59"
,CS,AR,32011530,1005,100,,Cash sale,,,,,,23/11/2018,23/11/2018,0.00,,4.15,,"-1,170,402.74"
,CS,AR,32011538,1005,100,,Cash sale,,,,,,23/11/2018,23/11/2018,0.00,,9.13,,"-1,170,411.87"
,CS,AR,32011543,1005,100,,Cash sale,,,,,,23/11/2018,23/11/2018,0.00,,14.58,,"-1,170,426.45"
,CS,AR,32011560,1005,100,,Cash sale,,,,,,23/11/2018,23/11/2018,0.00,,7.29,,"-1,170,433.74"
,CS,AR,32011574,1005,100,,Cash sale,,,,,,23/11/2018,23/11/2018,0.00,,3.64,,"-1,170,437.38"
,CS,AR,32011586,1005,100,,Cash sale,,,,,,23/11/2018,23/11/2018,0.00,,5.94,,"-1,170,443.32"
,CS,AR,32011622,1005,100,,Cash sale,,,,,,23/11/2018,23/11/2018,0.00,,13.98,,"-1,170,457.30"
,CS,AR,32011630,1005,100,,Cash sale,,,,,,23/11/2018,23/11/2018,0.00,,7.29,,"-1,170,464.59"
,CS,AR,32011638,1005,100,,Cash sale,,,,,,23/11/2018,23/11/2018,0.00,,10.93,,"-1,170,475.52"
,CS,AR,32011653,1005,100,,Cash sale,,,,,,23/11/2018,23/11/2018,0.00,,9.84,,"-1,170,485.36"
,CS,AR,32011656,1005,100,,Cash sale,,,,,,23/11/2018,23/11/2018,0.00,,21.86,,"-1,170,507.22"
,CS,AR,32011657,1005,100,,Cash sale,,,,,,23/11/2018,23/11/2018,0.00,,54.66,,"-1,170,561.88"
,CS,AR,32011661,1005,100,,Cash sale,,,,,,23/11/2018,23/11/2018,0.00,,18.22,,"-1,170,580.10"
,CS,AR,32011665,1005,100,,Cash sale,,,,,,23/11/2018,23/11/2018,0.00,,3.90,,"-1,170,584.00"
,IN,AR,30331745,1005,100,,Invoice,,,,,,23/11/2018,23/11/2018,0.00,,47.37,,"-1,170,631.37"
,IN,AR,30331748,1005,100,,Invoice,,,,,,23/11/2018,23/11/2018,0.00,,3.64,,"-1,170,635.01"
,IN,AR,30331753,1005,100,,Invoice,,,,,,23/11/2018,23/11/2018,0.00,,11.19,,"-1,170,646.20"
,IN,AR,30331786,1005,100,,Invoice,,,,,,23/11/2018,23/11/2018,0.00,,7.29,,"-1,170,653.49"
,IN,AR,30331793,1005,100,,Invoice,,,,,,23/11/2018,23/11/2018,0.00,,"1,093.22",,"-1,171,746.71"
,IN,AR,30331813,1005,100,,Invoice,,,,,,23/11/2018,23/11/2018,0.00,,7.25,,"-1,171,753.96"
,IN,AR,30331828,1005,100,,Invoice,,,,,,23/11/2018,23/11/2018,0.00,,38.04,,"-1,171,792.00"
,IN,AR,30331832,1005,100,,Invoice,,,,,,23/11/2018,23/11/2018,0.00,,54.66,,"-1,171,846.66"
,IN,AR,30331839,1005,100,,Invoice,,,,,,23/11/2018,23/11/2018,0.00,,11.48,,"-1,171,858.14"
,IN,AR,30331842,1005,100,,Invoice,,,,,,23/11/2018,23/11/2018,0.00,,100.92,,"-1,171,959.06"
,IN,AR,30331864,1005,100,,Invoice,,,,,,23/11/2018,23/11/2018,0.00,,36.00,,"-1,171,995.06"
,IN,AR,30331875,1005,100,,Invoice,,,,,,23/11/2018,23/11/2018,0.00,,14.58,,"-1,172,009.64"
,IN,AR,30331911,1005,100,,Invoice,,,,,,23/11/2018,23/11/2018,0.00,,24.00,,"-1,172,033.64"
,IN,AR,30331938,1005,100,,Invoice,,,,,,23/11/2018,23/11/2018,0.00,,4.75,,"-1,172,038.39"
,IN,AR,30331942,1005,100,,Invoice,,,,,,23/11/2018,23/11/2018,0.00,,24.00,,"-1,172,062.39"
,IN,AR,30331970,1005,100,,Invoice,,,,,,23/11/2018,23/11/2018,0.00,,13.58,,"-1,172,075.97"
,IN,AR,30331971,1005,100,,Invoice,,,,,,23/11/2018,23/11/2018,0.00,,5.82,,"-1,172,081.79"
,IN,AR,30331980,1005,100,,Invoice,,,,,,23/11/2018,23/11/2018,0.00,,28.00,,"-1,172,109.79"
,IN,AR,30331984,1005,100,,Invoice,,,,,,23/11/2018,23/11/2018,0.00,,3.64,,"-1,172,113.43"
,IN,AR,30331994,1005,100,,Invoice,,,,,,23/11/2018,23/11/2018,0.00,,40.08,,"-1,172,153.51"
,IN,AR,30332033,1005,100,,Invoice,,,,,,23/11/2018,23/11/2018,0.00,,5.17,,"-1,172,158.68"
,IN,AR,30332050,1005,100,,Invoice,,,,,,23/11/2018,23/11/2018,0.00,,11.99,,"-1,172,170.67"
,IN,AR,30332058,1005,100,,Invoice,,,,,,23/11/2018,23/11/2018,0.00,,10.93,,"-1,172,181.60"
,IN,AR,30332098,1005,100,,Invoice,,,,,,23/11/2018,23/11/2018,0.00,,15.51,,"-1,172,197.11"
,IN,AR,30332102,1005,100,,Invoice,,,,,,23/11/2018,23/11/2018,0.00,,4.78,,"-1,172,201.89"
,IN,AR,30332130,1005,100,,Invoice,,,,,,23/11/2018,23/11/2018,0.00,,6.02,,"-1,172,207.91"
,IN,AR,30332144,1005,100,,Invoice,,,,,,23/11/2018,23/11/2018,0.00,,47.17,,"-1,172,255.08"
,IN,AR,30332162,1005,100,,Invoice,,,,,,23/11/2018,23/11/2018,0.00,,14.34,,"-1,172,269.42"
,IN,AR,30332163,1005,100,,Invoice,,,,,,23/11/2018,23/11/2018,0.00,,9.56,,"-1,172,278.98"
,IN,AR,30332179,1005,100,,Invoice,,,,,,23/11/2018,23/11/2018,0.00,,6.02,,"-1,172,285.00"
,IN,AR,30332197,1005,100,,Invoice,,,,,,23/11/2018,23/11/2018,0.00,,10.34,,"-1,172,295.34"
,IN,AR,30332208,1005,100,,Invoice,,,,,,23/11/2018,23/11/2018,0.00,,10.17,,"-1,172,305.51"
,IN,AR,30332221,1005,100,,Invoice,,,,,,23/11/2018,23/11/2018,0.00,,5.08,,"-1,172,310.59"
,IN,AR,30332222,1005,100,,Invoice,,,,,,23/11/2018,23/11/2018,0.00,,2.54,,"-1,172,313.13"
,IN,AR,30332223,1005,100,,Invoice,,,,,,23/11/2018,23/11/2018,0.00,,10.17,,"-1,172,323.30"
,IN,AR,30332224,1005,100,,Invoice,,,,,,23/11/2018,23/11/2018,0.00,,2.54,,"-1,172,325.84"
,IN,AR,30332229,1005,100,,Invoice,,,,,,23/11/2018,23/11/2018,0.00,,2.54,,"-1,172,328.38"
,IN,AR,30332280,1005,100,,Invoice,,,,,,23/11/2018,23/11/2018,0.00,,7.29,,"-1,172,335.67"
,IN,AR,30332349,1005,100,,Invoice,,,,,,23/11/2018,23/11/2018,0.00,,16.83,,"-1,172,352.50"
,IN,AR,30332399,1005,100,,Invoice,,,,,,23/11/2018,23/11/2018,0.00,,38.00,,"-1,172,390.50"
,IN,AR,30332425,1005,100,,Invoice,,,,,,23/11/2018,23/11/2018,0.00,,5.17,,"-1,172,395.67"
,IN,AR,30332507,1005,100,,Invoice,,,,,,23/11/2018,23/11/2018,0.00,,9.69,,"-1,172,405.36"
,IN,AR,30332509,1005,100,,Invoice,,,,,,23/11/2018,23/11/2018,0.00,,8.01,,"-1,172,413.37"
,IN,AR,30332530,1005,100,,Invoice,,,,,,23/11/2018,23/11/2018,0.00,,21.86,,"-1,172,435.23"
,IN,AR,30332597,1005,100,,Invoice,,,,,,23/11/2018,23/11/2018,0.00,,12.98,,"-1,172,448.21"
,IN,AR,30332601,1005,100,,Invoice,,,,,,23/11/2018,23/11/2018,0.00,,19.87,,"-1,172,468.08"
,IN,AR,30332609,1005,100,,Invoice,,,,,,23/11/2018,23/11/2018,0.00,,36.00,,"-1,172,504.08"
,IN,AR,30332612,1005,100,,Invoice,,,,,,23/11/2018,23/11/2018,0.00,,20.95,,"-1,172,525.03"
,IN,AR,30332616,1005,100,,Invoice,,,,,,23/11/2018,23/11/2018,0.00,,2.97,,"-1,172,528.00"
,IN,AR,30332633,1005,100,,Invoice,,,,,,23/11/2018,23/11/2018,0.00,,6.02,,"-1,172,534.02"
,IN,AR,30332634,1005,100,,Invoice,,,,,,23/11/2018,23/11/2018,0.00,,3.64,,"-1,172,537.66"
,IN,AR,30332636,1005,100,,Invoice,,,,,,23/11/2018,23/11/2018,0.00,,41.06,,"-1,172,578.72"
,IN,AR,30332645,1005,100,,Invoice,,,,,,23/11/2018,23/11/2018,0.00,,14.58,,"-1,172,593.30"
,IN,AR,30332650,1005,100,,Invoice,,,,,,23/11/2018,23/11/2018,0.00,,39.41,,"-1,172,632.71"
,IN,AR,30332656,1005,100,,Invoice,,,,,,23/11/2018,23/11/2018,0.00,,5.08,,"-1,172,637.79"
,IN,AR,30332671,1005,100,,Invoice,,,,,,23/11/2018,23/11/2018,0.00,,7.17,,"-1,172,644.96"
,IN,AR,30332689,1005,100,,Invoice,,,,,,23/11/2018,23/11/2018,0.00,,12.71,,"-1,172,657.67"
,IN,AR,30332699,1005,100,,Invoice,,,,,,23/11/2018,23/11/2018,0.00,,6.00,,"-1,172,663.67"
,IN,AR,30332708,1005,100,,Invoice,,,,,,23/11/2018,23/11/2018,0.00,,8.00,,"-1,172,671.67"
,IN,AR,30332713,1005,100,,Invoice,,,,,,23/11/2018,23/11/2018,0.00,,110.04,,"-1,172,781.71"
,IN,AR,30332733,1005,100,,Invoice,,,,,,23/11/2018,23/11/2018,0.00,,21.90,,"-1,172,803.61"
,IN,AR,30332740,1005,100,,Invoice,,,,,,23/11/2018,23/11/2018,0.00,,25.23,,"-1,172,828.84"
,IN,AR,30332741,1005,100,,Invoice,,,,,,23/11/2018,23/11/2018,0.00,,21.03,,"-1,172,849.87"
,IN,AR,30332754,1005,100,,Invoice,,,,,,23/11/2018,23/11/2018,0.00,,4.66,,"-1,172,854.53"
,IN,AR,30332759,1005,100,,Invoice,,,,,,23/11/2018,23/11/2018,0.00,,29.15,,"-1,172,883.68"
,IN,AR,30332777,1005,100,,Invoice,,,,,,23/11/2018,23/11/2018,0.00,,6.89,,"-1,172,890.57"
,IN,AR,30332827,1005,100,,Invoice,,,,,,23/11/2018,23/11/2018,0.00,,10.93,,"-1,172,901.50"
,IN,AR,30332832,1005,100,,Invoice,,,,,,23/11/2018,23/11/2018,0.00,,5.68,,"-1,172,907.18"
,IN,AR,30332833,1005,100,,Invoice,,,,,,23/11/2018,23/11/2018,0.00,,16.91,,"-1,172,924.09"
,IN,AR,30332914,1005,100,,Invoice,,,,,,23/11/2018,23/11/2018,0.00,,8.00,,"-1,172,932.09"
,IN,AR,30332956,1005,100,,Invoice,,,,,,23/11/2018,23/11/2018,0.00,,10.95,,"-1,172,943.04"
,IN,AR,30332961,1005,100,,Invoice,,,,,,23/11/2018,23/11/2018,0.00,,38.14,,"-1,172,981.18"
,IN,AR,30332969,1005,100,,Invoice,,,,,,23/11/2018,23/11/2018,0.00,,10.93,,"-1,172,992.11"
,IN,AR,30332974,1005,100,,Invoice,,,,,,23/11/2018,23/11/2018,0.00,,7.29,,"-1,172,999.40"
,IN,AR,30332983,1005,100,,Invoice,,,,,,23/11/2018,23/11/2018,0.00,,182.20,,"-1,173,181.60"
,IN,AR,30332988,1005,100,,Invoice,,,,,,23/11/2018,23/11/2018,0.00,,10.21,,"-1,173,191.81"
,IN,AR,30332997,1005,100,,Invoice,,,,,,23/11/2018,23/11/2018,0.00,,43.73,,"-1,173,235.54"
,IN,AR,30333012,1005,100,,Invoice,,,,,,23/11/2018,23/11/2018,0.00,,5.97,,"-1,173,241.51"
,IN,AR,30333062,1005,100,,Invoice,,,,,,23/11/2018,23/11/2018,0.00,,10.38,,"-1,173,251.89"
,IN,AR,30333063,1005,100,,Invoice,,,,,,23/11/2018,23/11/2018,0.00,,8.31,,"-1,173,260.20"
,IN,AR,30333076,1005,100,,Invoice,,,,,,23/11/2018,23/11/2018,0.00,,7.29,,"-1,173,267.49"
,IN,AR,30333097,1005,100,,Invoice,,,,,,23/11/2018,23/11/2018,0.00,,17.06,,"-1,173,284.55"
,IN,AR,30333099,1005,100,,Invoice,,,,,,23/11/2018,23/11/2018,0.00,,9.10,,"-1,173,293.65"
,IN,AR,30333103,1005,100,,Invoice,,,,,,23/11/2018,23/11/2018,0.00,,10.93,,"-1,173,304.58"
,IN,AR,30333111,1005,100,,Invoice,,,,,,23/11/2018,23/11/2018,0.00,,2.03,,"-1,173,306.61"
,IN,AR,30333151,1005,100,,Invoice,,,,,,23/11/2018,23/11/2018,0.00,,10.93,,"-1,173,317.54"
,IN,AR,30333176,1005,100,,Invoice,,,,,,23/11/2018,23/11/2018,0.00,,14.58,,"-1,173,332.12"
,IN,AR,30333184,1005,100,,Invoice,,,,,,23/11/2018,23/11/2018,0.00,,5.39,,"-1,173,337.51"
,CS,AR,32011177,1005,100,,Cash sale,,,,,,24/11/2018,24/11/2018,0.00,,4.78,,"-1,173,342.29"
,CS,AR,32011450,1005,100,,Cash sale,,,,,,24/11/2018,24/11/2018,0.00,,14.58,,"-1,173,356.87"
,CS,AR,32011557,1005,100,,Cash sale,,,,,,24/11/2018,24/11/2018,0.00,,18.22,,"-1,173,375.09"
,CS,AR,32011633,1005,100,,Cash sale,,,,,,24/11/2018,24/11/2018,0.00,,10.93,,"-1,173,386.02"
,IN,AR,30331865,1005,100,,Invoice,,,,,,24/11/2018,24/11/2018,0.00,,18.00,,"-1,173,404.02"
,IN,AR,30331976,1005,100,,Invoice,,,,,,24/11/2018,24/11/2018,0.00,,14.58,,"-1,173,418.60"
,IN,AR,30332412,1005,100,,Invoice,,,,,,24/11/2018,24/11/2018,0.00,,14.58,,"-1,173,433.18"
,IN,AR,30332673,1005,100,,Invoice,,,,,,24/11/2018,24/11/2018,0.00,,54.66,,"-1,173,487.84"
,IN,AR,30333123,1005,100,,Invoice,,,,,,24/11/2018,24/11/2018,0.00,,7.29,,"-1,173,495.13"
,IN,AR,30333154,1005,100,,Invoice,,,,,,24/11/2018,24/11/2018,0.00,,7.29,,"-1,173,502.42"
,IN,AR,30333227,1005,100,,Invoice,,,,,,24/11/2018,24/11/2018,0.00,,3.64,,"-1,173,506.06"
,CS,AR,32011644,1005,100,,Cash sale,,,,,,25/11/2018,25/11/2018,0.00,,29.15,,"-1,173,535.21"
,CN,AR,31019524,1005,100,,Credit Note,,,,,,26/11/2018,26/11/2018,2.39,,0.00,,"-1,173,532.82"
,CN,AR,31019617,1005,100,,Credit Note,,,,,,26/11/2018,26/11/2018,7.29,,0.00,,"-1,173,525.53"
,CR,AR,33000312,1005,100,,Cash Return,,,,,,26/11/2018,26/11/2018,3.64,,0.00,,"-1,173,521.89"
,CS,AR,32011028,1005,100,,Cash sale,,,,,,26/11/2018,26/11/2018,0.00,,5.61,,"-1,173,527.50"
,CS,AR,32011037,1005,100,,Cash sale,,,,,,26/11/2018,26/11/2018,0.00,,7.12,,"-1,173,534.62"
,CS,AR,32011056,1005,100,,Cash sale,,,,,,26/11/2018,26/11/2018,0.00,,3.64,,"-1,173,538.26"
,CS,AR,32011059,1005,100,,Cash sale,,,,,,26/11/2018,26/11/2018,0.00,,10.93,,"-1,173,549.19"
,CS,AR,32011097,1005,100,,Cash sale,,,,,,26/11/2018,26/11/2018,0.00,,7.29,,"-1,173,556.48"
,CS,AR,32011106,1005,100,,Cash sale,,,,,,26/11/2018,26/11/2018,0.00,,12.46,,"-1,173,568.94"
,CS,AR,32011110,1005,100,,Cash sale,,,,,,26/11/2018,26/11/2018,0.00,,7.29,,"-1,173,576.23"
,CS,AR,32011113,1005,100,,Cash sale,,,,,,26/11/2018,26/11/2018,0.00,,7.29,,"-1,173,583.52"
,CS,AR,32011121,1005,100,,Cash sale,,,,,,26/11/2018,26/11/2018,0.00,,5.84,,"-1,173,589.36"
,CS,AR,32011131,1005,100,,Cash sale,,,,,,26/11/2018,26/11/2018,0.00,,7.29,,"-1,173,596.65"
,CS,AR,32011144,1005,100,,Cash sale,,,,,,26/11/2018,26/11/2018,0.00,,7.29,,"-1,173,603.94"
,CS,AR,32011154,1005,100,,Cash sale,,,,,,26/11/2018,26/11/2018,0.00,,3.64,,"-1,173,607.58"
,CS,AR,32011162,1005,100,,Cash sale,,,,,,26/11/2018,26/11/2018,0.00,,3.64,,"-1,173,611.22"
,CS,AR,32011165,1005,100,,Cash sale,,,,,,26/11/2018,26/11/2018,0.00,,3.64,,"-1,173,614.86"
,CS,AR,32011168,1005,100,,Cash sale,,,,,,26/11/2018,26/11/2018,0.00,,10.34,,"-1,173,625.20"
,CS,AR,32011183,1005,100,,Cash sale,,,,,,26/11/2018,26/11/2018,0.00,,3.64,,"-1,173,628.84"
,CS,AR,32011220,1005,100,,Cash sale,,,,,,26/11/2018,26/11/2018,0.00,,13.74,,"-1,173,642.58"
,CS,AR,32011229,1005,100,,Cash sale,,,,,,26/11/2018,26/11/2018,0.00,,7.29,,"-1,173,649.87"
,CS,AR,32011238,1005,100,,Cash sale,,,,,,26/11/2018,26/11/2018,0.00,,3.64,,"-1,173,653.51"
,CS,AR,32011240,1005,100,,Cash sale,,,,,,26/11/2018,26/11/2018,0.00,,7.29,,"-1,173,660.80"
,CS,AR,32011254,1005,100,,Cash sale,,,,,,26/11/2018,26/11/2018,0.00,,17.54,,"-1,173,678.34"
,CS,AR,32011259,1005,100,,Cash sale,,,,,,26/11/2018,26/11/2018,0.00,,5.44,,"-1,173,683.78"
,CS,AR,32011260,1005,100,,Cash sale,,,,,,26/11/2018,26/11/2018,0.00,,3.64,,"-1,173,687.42"
,CS,AR,32011261,1005,100,,Cash sale,,,,,,26/11/2018,26/11/2018,0.00,,6.02,,"-1,173,693.44"
,CS,AR,32011268,1005,100,,Cash sale,,,,,,26/11/2018,26/11/2018,0.00,,15.04,,"-1,173,708.48"
,CS,AR,32011284,1005,100,,Cash sale,,,,,,26/11/2018,26/11/2018,0.00,,182.20,,"-1,173,890.68"
,CS,AR,32011310,1005,100,,Cash sale,,,,,,26/11/2018,26/11/2018,0.00,,3.64,,"-1,173,894.32"
,CS,AR,32011316,1005,100,,Cash sale,,,,,,26/11/2018,26/11/2018,0.00,,5.08,,"-1,173,899.40"
,CS,AR,32011322,1005,100,,Cash sale,,,,,,26/11/2018,26/11/2018,0.00,,7.29,,"-1,173,906.69"
,CS,AR,32011350,1005,100,,Cash sale,,,,,,26/11/2018,26/11/2018,0.00,,3.64,,"-1,173,910.33"
,CS,AR,32011371,1005,100,,Cash sale,,,,,,26/11/2018,26/11/2018,0.00,,3.64,,"-1,173,913.97"
,CS,AR,32011378,1005,100,,Cash sale,,,,,,26/11/2018,26/11/2018,0.00,,6.42,,"-1,173,920.39"
,CS,AR,32011400,1005,100,,Cash sale,,,,,,26/11/2018,26/11/2018,0.00,,7.29,,"-1,173,927.68"
,CS,AR,32011415,1005,100,,Cash sale,,,,,,26/11/2018,26/11/2018,0.00,,13.74,,"-1,173,941.42"
,CS,AR,32011419,1005,100,,Cash sale,,,,,,26/11/2018,26/11/2018,0.00,,12.71,,"-1,173,954.13"
,CS,AR,32011426,1005,100,,Cash sale,,,,,,26/11/2018,26/11/2018,0.00,,7.29,,"-1,173,961.42"
,CS,AR,32011433,1005,100,,Cash sale,,,,,,26/11/2018,26/11/2018,0.00,,3.64,,"-1,173,965.06"
,CS,AR,32011456,1005,100,,Cash sale,,,,,,26/11/2018,26/11/2018,0.00,,3.28,,"-1,173,968.34"
,CS,AR,32011471,1005,100,,Cash sale,,,,,,26/11/2018,26/11/2018,0.00,,9.15,,"-1,173,977.49"
,CS,AR,32011487,1005,100,,Cash sale,,,,,,26/11/2018,26/11/2018,0.00,,9.10,,"-1,173,986.59"
,CS,AR,32011502,1005,100,,Cash sale,,,,,,26/11/2018,26/11/2018,0.00,,12.14,,"-1,173,998.73"
,CS,AR,32011512,1005,100,,Cash sale,,,,,,26/11/2018,26/11/2018,0.00,,10.93,,"-1,174,009.66"
,CS,AR,32011556,1005,100,,Cash sale,,,,,,26/11/2018,26/11/2018,0.00,,7.29,,"-1,174,016.95"
,CS,AR,32011575,1005,100,,Cash sale,,,,,,26/11/2018,26/11/2018,0.00,,3.64,,"-1,174,020.59"
,CS,AR,32011626,1005,100,,Cash sale,,,,,,26/11/2018,26/11/2018,0.00,,3.03,,"-1,174,023.62"
,CS,AR,32011632,1005,100,,Cash sale,,,,,,26/11/2018,26/11/2018,0.00,,7.29,,"-1,174,030.91"
,CS,AR,32011643,1005,100,,Cash sale,,,,,,26/11/2018,26/11/2018,0.00,,7.29,,"-1,174,038.20"
,IN,AR,30331738,1005,100,,Invoice,,,,,,26/11/2018,26/11/2018,0.00,,74.15,,"-1,174,112.35"
,IN,AR,30331739,1005,100,,Invoice,,,,,,26/11/2018,26/11/2018,0.00,,44.49,,"-1,174,156.84"
,IN,AR,30331750,1005,100,,Invoice,,,,,,26/11/2018,26/11/2018,0.00,,14.58,,"-1,174,171.42"
,IN,AR,30331775,1005,100,,Invoice,,,,,,26/11/2018,26/11/2018,0.00,,4.05,,"-1,174,175.47"
,IN,AR,30331776,1005,100,,Invoice,,,,,,26/11/2018,26/11/2018,0.00,,6.08,,"-1,174,181.55"
,IN,AR,30331777,1005,100,,Invoice,,,,,,26/11/2018,26/11/2018,0.00,,16.20,,"-1,174,197.75"
,IN,AR,30331778,1005,100,,Invoice,,,,,,26/11/2018,26/11/2018,0.00,,8.10,,"-1,174,205.85"
,IN,AR,30331779,1005,100,,Invoice,,,,,,26/11/2018,26/11/2018,0.00,,2.03,,"-1,174,207.88"
,IN,AR,30331780,1005,100,,Invoice,,,,,,26/11/2018,26/11/2018,0.00,,8.10,,"-1,174,215.98"
,IN,AR,30331781,1005,100,,Invoice,,,,,,26/11/2018,26/11/2018,0.00,,6.08,,"-1,174,222.06"
,IN,AR,30331798,1005,100,,Invoice,,,,,,26/11/2018,26/11/2018,0.00,,14.58,,"-1,174,236.64"
,IN,AR,30331829,1005,100,,Invoice,,,,,,26/11/2018,26/11/2018,0.00,,31.70,,"-1,174,268.34"
,IN,AR,30331834,1005,100,,Invoice,,,,,,26/11/2018,26/11/2018,0.00,,10.93,,"-1,174,279.27"
,IN,AR,30331866,1005,100,,Invoice,,,,,,26/11/2018,26/11/2018,0.00,,46.00,,"-1,174,325.27"
,IN,AR,30331873,1005,100,,Invoice,,,,,,26/11/2018,26/11/2018,0.00,,16.53,,"-1,174,341.80"
,IN,AR,30331881,1005,100,,Invoice,,,,,,26/11/2018,26/11/2018,0.00,,74.00,,"-1,174,415.80"
,IN,AR,30331893,1005,100,,Invoice,,,,,,26/11/2018,26/11/2018,0.00,,57.26,,"-1,174,473.06"
,IN,AR,30331900,1005,100,,Invoice,,,,,,26/11/2018,26/11/2018,0.00,,10.93,,"-1,174,483.99"
,IN,AR,30331901,1005,100,,Invoice,,,,,,26/11/2018,26/11/2018,0.00,,3.64,,"-1,174,487.63"
,IN,AR,30331912,1005,100,,Invoice,,,,,,26/11/2018,26/11/2018,0.00,,32.00,,"-1,174,519.63"
,IN,AR,30331913,1005,100,,Invoice,,,,,,26/11/2018,26/11/2018,0.00,,20.00,,"-1,174,539.63"
,IN,AR,30331922,1005,100,,Invoice,,,,,,26/11/2018,26/11/2018,0.00,,5.51,,"-1,174,545.14"
,IN,AR,30331924,1005,100,,Invoice,,,,,,26/11/2018,26/11/2018,0.00,,22.88,,"-1,174,568.02"
,IN,AR,30331926,1005,100,,Invoice,,,,,,26/11/2018,26/11/2018,0.00,,11.02,,"-1,174,579.04"
,IN,AR,30331932,1005,100,,Invoice,,,,,,26/11/2018,26/11/2018,0.00,,8.77,,"-1,174,587.81"
,IN,AR,30331943,1005,100,,Invoice,,,,,,26/11/2018,26/11/2018,0.00,,26.00,,"-1,174,613.81"
,IN,AR,30331958,1005,100,,Invoice,,,,,,26/11/2018,26/11/2018,0.00,,125.53,,"-1,174,739.34"
,IN,AR,30331981,1005,100,,Invoice,,,,,,26/11/2018,26/11/2018,0.00,,20.00,,"-1,174,759.34"
,IN,AR,30332002,1005,100,,Invoice,,,,,,26/11/2018,26/11/2018,0.00,,16.10,,"-1,174,775.44"
,IN,AR,30332009,1005,100,,Invoice,,,,,,26/11/2018,26/11/2018,0.00,,29.15,,"-1,174,804.59"
,IN,AR,30332013,1005,100,,Invoice,,,,,,26/11/2018,26/11/2018,0.00,,7.29,,"-1,174,811.88"
,IN,AR,30332015,1005,100,,Invoice,,,,,,26/11/2018,26/11/2018,0.00,,61.95,,"-1,174,873.83"
,IN,AR,30332021,1005,100,,Invoice,,,,,,26/11/2018,26/11/2018,0.00,,3.19,,"-1,174,877.02"
,IN,AR,30332036,1005,100,,Invoice,,,,,,26/11/2018,26/11/2018,0.00,,7.75,,"-1,174,884.77"
,IN,AR,30332054,1005,100,,Invoice,,,,,,26/11/2018,26/11/2018,0.00,,13.78,,"-1,174,898.55"
,IN,AR,30332099,1005,100,,Invoice,,,,,,26/11/2018,26/11/2018,0.00,,20.68,,"-1,174,919.23"
,IN,AR,30332109,1005,100,,Invoice,,,,,,26/11/2018,26/11/2018,0.00,,8.90,,"-1,174,928.13"
,IN,AR,30332113,1005,100,,Invoice,,,,,,26/11/2018,26/11/2018,0.00,,5.18,,"-1,174,933.31"
,IN,AR,30332114,1005,100,,Invoice,,,,,,26/11/2018,26/11/2018,0.00,,7.63,,"-1,174,940.94"
,IN,AR,30332125,1005,100,,Invoice,,,,,,26/11/2018,26/11/2018,0.00,,7.29,,"-1,174,948.23"
,IN,AR,30332135,1005,100,,Invoice,,,,,,26/11/2018,26/11/2018,0.00,,29.15,,"-1,174,977.38"
,IN,AR,30332145,1005,100,,Invoice,,,,,,26/11/2018,26/11/2018,0.00,,82.03,,"-1,175,059.41"
,IN,AR,30332153,1005,100,,Invoice,,,,,,26/11/2018,26/11/2018,0.00,,48.31,,"-1,175,107.72"
,IN,AR,30332164,1005,100,,Invoice,,,,,,26/11/2018,26/11/2018,0.00,,26.29,,"-1,175,134.01"
,IN,AR,30332170,1005,100,,Invoice,,,,,,26/11/2018,26/11/2018,0.00,,16.10,,"-1,175,150.11"
,IN,AR,30332178,1005,100,,Invoice,,,,,,26/11/2018,26/11/2018,0.00,,15.04,,"-1,175,165.15"
,IN,AR,30332199,1005,100,,Invoice,,,,,,26/11/2018,26/11/2018,0.00,,4.24,,"-1,175,169.39"
,IN,AR,30332225,1005,100,,Invoice,,,,,,26/11/2018,26/11/2018,0.00,,5.08,,"-1,175,174.47"
,IN,AR,30332237,1005,100,,Invoice,,,,,,26/11/2018,26/11/2018,0.00,,14.58,,"-1,175,189.05"
,IN,AR,30332285,1005,100,,Invoice,,,,,,26/11/2018,26/11/2018,0.00,,22.88,,"-1,175,211.93"
,IN,AR,30332294,1005,100,,Invoice,,,,,,26/11/2018,26/11/2018,0.00,,26.44,,"-1,175,238.37"
,IN,AR,30332318,1005,100,,Invoice,,,,,,26/11/2018,26/11/2018,0.00,,3.64,,"-1,175,242.01"
,IN,AR,30332321,1005,100,,Invoice,,,,,,26/11/2018,26/11/2018,0.00,,10.93,,"-1,175,252.94"
,IN,AR,30332334,1005,100,,Invoice,,,,,,26/11/2018,26/11/2018,0.00,,5.51,,"-1,175,258.45"
,IN,AR,30332336,1005,100,,Invoice,,,,,,26/11/2018,26/11/2018,0.00,,7.29,,"-1,175,265.74"
,IN,AR,30332346,1005,100,,Invoice,,,,,,26/11/2018,26/11/2018,0.00,,16.08,,"-1,175,281.82"
,IN,AR,30332350,1005,100,,Invoice,,,,,,26/11/2018,26/11/2018,0.00,,11.22,,"-1,175,293.04"
,IN,AR,30332352,1005,100,,Invoice,,,,,,26/11/2018,26/11/2018,0.00,,7.88,,"-1,175,300.92"
,IN,AR,30332367,1005,100,,Invoice,,,,,,26/11/2018,26/11/2018,0.00,,18.22,,"-1,175,319.14"
,IN,AR,30332376,1005,100,,Invoice,,,,,,26/11/2018,26/11/2018,0.00,,2.92,,"-1,175,322.06"
,IN,AR,30332388,1005,100,,Invoice,,,,,,26/11/2018,26/11/2018,0.00,,58.58,,"-1,175,380.64"
,IN,AR,30332437,1005,100,,Invoice,,,,,,26/11/2018,26/11/2018,0.00,,39.40,,"-1,175,420.04"
,IN,AR,30332445,1005,100,,Invoice,,,,,,26/11/2018,26/11/2018,0.00,,6.74,,"-1,175,426.78"
,IN,AR,30332504,1005,100,,Invoice,,,,,,26/11/2018,26/11/2018,0.00,,7.29,,"-1,175,434.07"
,IN,AR,30332532,1005,100,,Invoice,,,,,,26/11/2018,26/11/2018,0.00,,10.93,,"-1,175,445.00"
,IN,AR,30332553,1005,100,,Invoice,,,,,,26/11/2018,26/11/2018,0.00,,4.29,,"-1,175,449.29"
,IN,AR,30332567,1005,100,,Invoice,,,,,,26/11/2018,26/11/2018,0.00,,14.58,,"-1,175,463.87"
,IN,AR,30332589,1005,100,,Invoice,,,,,,26/11/2018,26/11/2018,0.00,,3.98,,"-1,175,467.85"
,IN,AR,30332614,1005,100,,Invoice,,,,,,26/11/2018,26/11/2018,0.00,,4.29,,"-1,175,472.14"
,IN,AR,30332624,1005,100,,Invoice,,,,,,26/11/2018,26/11/2018,0.00,,50.11,,"-1,175,522.25"
,IN,AR,30332641,1005,100,,Invoice,,,,,,26/11/2018,26/11/2018,0.00,,6.56,,"-1,175,528.81"
,IN,AR,30332651,1005,100,,Invoice,,,,,,26/11/2018,26/11/2018,0.00,,21.02,,"-1,175,549.83"
,IN,AR,30332654,1005,100,,Invoice,,,,,,26/11/2018,26/11/2018,0.00,,4.58,,"-1,175,554.41"
,IN,AR,30332677,1005,100,,Invoice,,,,,,26/11/2018,26/11/2018,0.00,,7.29,,"-1,175,561.70"
,IN,AR,30332700,1005,100,,Invoice,,,,,,26/11/2018,26/11/2018,0.00,,10.00,,"-1,175,571.70"
,IN,AR,30332711,1005,100,,Invoice,,,,,,26/11/2018,26/11/2018,0.00,,54.66,,"-1,175,626.36"
,IN,AR,30332726,1005,100,,Invoice,,,,,,26/11/2018,26/11/2018,0.00,,52.80,,"-1,175,679.16"
,IN,AR,30332742,1005,100,,Invoice,,,,,,26/11/2018,26/11/2018,0.00,,6.31,,"-1,175,685.47"
,IN,AR,30332743,1005,100,,Invoice,,,,,,26/11/2018,26/11/2018,0.00,,12.62,,"-1,175,698.09"
,IN,AR,30332760,1005,100,,Invoice,,,,,,26/11/2018,26/11/2018,0.00,,2.92,,"-1,175,701.01"
,IN,AR,30332764,1005,100,,Invoice,,,,,,26/11/2018,26/11/2018,0.00,,24.16,,"-1,175,725.17"
,IN,AR,30332766,1005,100,,Invoice,,,,,,26/11/2018,26/11/2018,0.00,,209.75,,"-1,175,934.92"
,IN,AR,30332773,1005,100,,Invoice,,,,,,26/11/2018,26/11/2018,0.00,,16.83,,"-1,175,951.75"
,IN,AR,30332858,1005,100,,Invoice,,,,,,26/11/2018,26/11/2018,0.00,,22.31,,"-1,175,974.06"
,IN,AR,30332859,1005,100,,Invoice,,,,,,26/11/2018,26/11/2018,0.00,,11.15,,"-1,175,985.21"
,IN,AR,30332915,1005,100,,Invoice,,,,,,26/11/2018,26/11/2018,0.00,,12.00,,"-1,175,997.21"
,IN,AR,30332921,1005,100,,Invoice,,,,,,26/11/2018,26/11/2018,0.00,,1.88,,"-1,175,999.09"
,IN,AR,30332922,1005,100,,Invoice,,,,,,26/11/2018,26/11/2018,0.00,,7.53,,"-1,176,006.62"
,IN,AR,30332957,1005,100,,Invoice,,,,,,26/11/2018,26/11/2018,0.00,,10.95,,"-1,176,017.57"
,IN,AR,30332989,1005,100,,Invoice,,,,,,26/11/2018,26/11/2018,0.00,,8.17,,"-1,176,025.74"
,IN,AR,30333019,1005,100,,Invoice,,,,,,26/11/2018,26/11/2018,0.00,,32.16,,"-1,176,057.90"
,IN,AR,30333031,1005,100,,Invoice,,,,,,26/11/2018,26/11/2018,0.00,,4.00,,"-1,176,061.90"
,IN,AR,30333064,1005,100,,Invoice,,,,,,26/11/2018,26/11/2018,0.00,,4.15,,"-1,176,066.05"
,IN,AR,30333065,1005,100,,Invoice,,,,,,26/11/2018,26/11/2018,0.00,,4.15,,"-1,176,070.20"
,IN,AR,30333066,1005,100,,Invoice,,,,,,26/11/2018,26/11/2018,0.00,,2.08,,"-1,176,072.28"
,IN,AR,30333067,1005,100,,Invoice,,,,,,26/11/2018,26/11/2018,0.00,,2.08,,"-1,176,074.36"
,IN,AR,30333068,1005,100,,Invoice,,,,,,26/11/2018,26/11/2018,0.00,,2.08,,"-1,176,076.44"
,IN,AR,30333077,1005,100,,Invoice,,,,,,26/11/2018,26/11/2018,0.00,,182.20,,"-1,176,258.64"
,IN,AR,30333081,1005,100,,Invoice,,,,,,26/11/2018,26/11/2018,0.00,,13.12,,"-1,176,271.76"
,IN,AR,30333105,1005,100,,Invoice,,,,,,26/11/2018,26/11/2018,0.00,,6.56,,"-1,176,278.32"
,IN,AR,30333120,1005,100,,Invoice,,,,,,26/11/2018,26/11/2018,0.00,,5.26,,"-1,176,283.58"
,IN,AR,30333133,1005,100,,Invoice,,,,,,26/11/2018,26/11/2018,0.00,,12.62,,"-1,176,296.20"
,IN,AR,30333160,1005,100,,Invoice,,,,,,26/11/2018,26/11/2018,0.00,,65.73,,"-1,176,361.93"
,IN,AR,30333240,1005,100,,Invoice,,,,,,26/11/2018,26/11/2018,0.00,,54.66,,"-1,176,416.59"
,CS,AR,32011050,1005,100,,Cash sale,,,,,,27/11/2018,27/11/2018,0.00,,3.64,,"-1,176,420.23"
,CS,AR,32011073,1005,100,,Cash sale,,,,,,27/11/2018,27/11/2018,0.00,,7.29,,"-1,176,427.52"
,CS,AR,32011075,1005,100,,Cash sale,,,,,,27/11/2018,27/11/2018,0.00,,7.29,,"-1,176,434.81"
,CS,AR,32011080,1005,100,,Cash sale,,,,,,27/11/2018,27/11/2018,0.00,,18.22,,"-1,176,453.03"
,CS,AR,32011087,1005,100,,Cash sale,,,,,,27/11/2018,27/11/2018,0.00,,6.02,,"-1,176,459.05"
,CS,AR,32011092,1005,100,,Cash sale,,,,,,27/11/2018,27/11/2018,0.00,,14.58,,"-1,176,473.63"
,CS,AR,32011111,1005,100,,Cash sale,,,,,,27/11/2018,27/11/2018,0.00,,10.93,,"-1,176,484.56"
,CS,AR,32011138,1005,100,,Cash sale,,,,,,27/11/2018,27/11/2018,0.00,,14.58,,"-1,176,499.14"
,CS,AR,32011139,1005,100,,Cash sale,,,,,,27/11/2018,27/11/2018,0.00,,3.64,,"-1,176,502.78"
,CS,AR,32011148,1005,100,,Cash sale,,,,,,27/11/2018,27/11/2018,0.00,,7.29,,"-1,176,510.07"
,CS,AR,32011149,1005,100,,Cash sale,,,,,,27/11/2018,27/11/2018,0.00,,10.93,,"-1,176,521.00"
,CS,AR,32011181,1005,100,,Cash sale,,,,,,27/11/2018,27/11/2018,0.00,,6.48,,"-1,176,527.48"
,CS,AR,32011193,1005,100,,Cash sale,,,,,,27/11/2018,27/11/2018,0.00,,3.90,,"-1,176,531.38"
,CS,AR,32011200,1005,100,,Cash sale,,,,,,27/11/2018,27/11/2018,0.00,,5.68,,"-1,176,537.06"
,CS,AR,32011207,1005,100,,Cash sale,,,,,,27/11/2018,27/11/2018,0.00,,7.29,,"-1,176,544.35"
,CS,AR,32011209,1005,100,,Cash sale,,,,,,27/11/2018,27/11/2018,0.00,,7.80,,"-1,176,552.15"
,CS,AR,32011235,1005,100,,Cash sale,,,,,,27/11/2018,27/11/2018,0.00,,7.29,,"-1,176,559.44"
,CS,AR,32011263,1005,100,,Cash sale,,,,,,27/11/2018,27/11/2018,0.00,,5.85,,"-1,176,565.29"
,CS,AR,32011286,1005,100,,Cash sale,,,,,,27/11/2018,27/11/2018,0.00,,1.95,,"-1,176,567.24"
,CS,AR,32011288,1005,100,,Cash sale,,,,,,27/11/2018,27/11/2018,0.00,,10.93,,"-1,176,578.17"
,CS,AR,32011296,1005,100,,Cash sale,,,,,,27/11/2018,27/11/2018,0.00,,5.08,,"-1,176,583.25"
,CS,AR,32011299,1005,100,,Cash sale,,,,,,27/11/2018,27/11/2018,0.00,,3.64,,"-1,176,586.89"
,CS,AR,32011306,1005,100,,Cash sale,,,,,,27/11/2018,27/11/2018,0.00,,10.34,,"-1,176,597.23"
,CS,AR,32011319,1005,100,,Cash sale,,,,,,27/11/2018,27/11/2018,0.00,,20.68,,"-1,176,617.91"
,CS,AR,32011320,1005,100,,Cash sale,,,,,,27/11/2018,27/11/2018,0.00,,9.03,,"-1,176,626.94"
,CS,AR,32011326,1005,100,,Cash sale,,,,,,27/11/2018,27/11/2018,0.00,,10.93,,"-1,176,637.87"
,CS,AR,32011348,1005,100,,Cash sale,,,,,,27/11/2018,27/11/2018,0.00,,7.29,,"-1,176,645.16"
,CS,AR,32011354,1005,100,,Cash sale,,,,,,27/11/2018,27/11/2018,0.00,,2.16,,"-1,176,647.32"
,CS,AR,32011355,1005,100,,Cash sale,,,,,,27/11/2018,27/11/2018,0.00,,10.93,,"-1,176,658.25"
,CS,AR,32011364,1005,100,,Cash sale,,,,,,27/11/2018,27/11/2018,0.00,,7.29,,"-1,176,665.54"
,CS,AR,32011375,1005,100,,Cash sale,,,,,,27/11/2018,27/11/2018,0.00,,3.64,,"-1,176,669.18"
,CS,AR,32011388,1005,100,,Cash sale,,,,,,27/11/2018,27/11/2018,0.00,,10.93,,"-1,176,680.11"
,CS,AR,32011393,1005,100,,Cash sale,,,,,,27/11/2018,27/11/2018,0.00,,1.88,,"-1,176,681.99"
,CS,AR,32011442,1005,100,,Cash sale,,,,,,27/11/2018,27/11/2018,0.00,,20.34,,"-1,176,702.33"
,CS,AR,32011448,1005,100,,Cash sale,,,,,,27/11/2018,27/11/2018,0.00,,3.64,,"-1,176,705.97"
,CS,AR,32011459,1005,100,,Cash sale,,,,,,27/11/2018,27/11/2018,0.00,,8.20,,"-1,176,714.17"
,CS,AR,32011491,1005,100,,Cash sale,,,,,,27/11/2018,27/11/2018,0.00,,8.25,,"-1,176,722.42"
,CS,AR,32011504,1005,100,,Cash sale,,,,,,27/11/2018,27/11/2018,0.00,,10.93,,"-1,176,733.35"
,CS,AR,32011526,1005,100,,Cash sale,,,,,,27/11/2018,27/11/2018,0.00,,7.29,,"-1,176,740.64"
,CS,AR,32011551,1005,100,,Cash sale,,,,,,27/11/2018,27/11/2018,0.00,,10.95,,"-1,176,751.59"
,CS,AR,32011553,1005,100,,Cash sale,,,,,,27/11/2018,27/11/2018,0.00,,8.75,,"-1,176,760.34"
,CS,AR,32011554,1005,100,,Cash sale,,,,,,27/11/2018,27/11/2018,0.00,,10.93,,"-1,176,771.27"
,CS,AR,32011564,1005,100,,Cash sale,,,,,,27/11/2018,27/11/2018,0.00,,3.64,,"-1,176,774.91"
,CS,AR,32011581,1005,100,,Cash sale,,,,,,27/11/2018,27/11/2018,0.00,,7.75,,"-1,176,782.66"
,CS,AR,32011647,1005,100,,Cash sale,,,,,,27/11/2018,27/11/2018,0.00,,5.93,,"-1,176,788.59"
,CS,AR,32011676,1005,100,,Cash sale,,,,,,27/11/2018,27/11/2018,0.00,,3.64,,"-1,176,792.23"
,IN,AR,30331767,1005,100,,Invoice,,,,,,27/11/2018,27/11/2018,0.00,,65.94,,"-1,176,858.17"
,IN,AR,30331795,1005,100,,Invoice,,,,,,27/11/2018,27/11/2018,0.00,,29.15,,"-1,176,887.32"
,IN,AR,30331819,1005,100,,Invoice,,,,,,27/11/2018,27/11/2018,0.00,,3.64,,"-1,176,890.96"
,IN,AR,30331822,1005,100,,Invoice,,,,,,27/11/2018,27/11/2018,0.00,,7.00,,"-1,176,897.96"
,IN,AR,30331843,1005,100,,Invoice,,,,,,27/11/2018,27/11/2018,0.00,,11.64,,"-1,176,909.60"
,IN,AR,30331852,1005,100,,Invoice,,,,,,27/11/2018,27/11/2018,0.00,,3.98,,"-1,176,913.58"
,IN,AR,30331867,1005,100,,Invoice,,,,,,27/11/2018,27/11/2018,0.00,,56.00,,"-1,176,969.58"
,IN,AR,30331887,1005,100,,Invoice,,,,,,27/11/2018,27/11/2018,0.00,,3.64,,"-1,176,973.22"
,IN,AR,30331916,1005,100,,Invoice,,,,,,27/11/2018,27/11/2018,0.00,,14.24,,"-1,176,987.46"
,IN,AR,30331972,1005,100,,Invoice,,,,,,27/11/2018,27/11/2018,0.00,,7.76,,"-1,176,995.22"
,IN,AR,30331988,1005,100,,Invoice,,,,,,27/11/2018,27/11/2018,0.00,,19.24,,"-1,177,014.46"
,IN,AR,30331990,1005,100,,Invoice,,,,,,27/11/2018,27/11/2018,0.00,,7.29,,"-1,177,021.75"
,IN,AR,30331996,1005,100,,Invoice,,,,,,27/11/2018,27/11/2018,0.00,,7.29,,"-1,177,029.04"
,IN,AR,30332003,1005,100,,Invoice,,,,,,27/11/2018,27/11/2018,0.00,,7.29,,"-1,177,036.33"
,IN,AR,30332028,1005,100,,Invoice,,,,,,27/11/2018,27/11/2018,0.00,,14.58,,"-1,177,050.91"
,IN,AR,30332041,1005,100,,Invoice,,,,,,27/11/2018,27/11/2018,0.00,,10.98,,"-1,177,061.89"
,IN,AR,30332043,1005,100,,Invoice,,,,,,27/11/2018,27/11/2018,0.00,,4.64,,"-1,177,066.53"
,IN,AR,30332056,1005,100,,Invoice,,,,,,27/11/2018,27/11/2018,0.00,,38.14,,"-1,177,104.67"
,IN,AR,30332059,1005,100,,Invoice,,,,,,27/11/2018,27/11/2018,0.00,,7.29,,"-1,177,111.96"
,IN,AR,30332067,1005,100,,Invoice,,,,,,27/11/2018,27/11/2018,0.00,,4.32,,"-1,177,116.28"
,IN,AR,30332071,1005,100,,Invoice,,,,,,27/11/2018,27/11/2018,0.00,,8.47,,"-1,177,124.75"
,IN,AR,30332131,1005,100,,Invoice,,,,,,27/11/2018,27/11/2018,0.00,,18.05,,"-1,177,142.80"
,IN,AR,30332171,1005,100,,Invoice,,,,,,27/11/2018,27/11/2018,0.00,,12.88,,"-1,177,155.68"
,IN,AR,30332172,1005,100,,Invoice,,,,,,27/11/2018,27/11/2018,0.00,,12.88,,"-1,177,168.56"
,IN,AR,30332173,1005,100,,Invoice,,,,,,27/11/2018,27/11/2018,0.00,,6.44,,"-1,177,175.00"
,IN,AR,30332182,1005,100,,Invoice,,,,,,27/11/2018,27/11/2018,0.00,,7.29,,"-1,177,182.29"
,IN,AR,30332194,1005,100,,Invoice,,,,,,27/11/2018,27/11/2018,0.00,,4.29,,"-1,177,186.58"
,IN,AR,30332212,1005,100,,Invoice,,,,,,27/11/2018,27/11/2018,0.00,,4.78,,"-1,177,191.36"
,IN,AR,30332227,1005,100,,Invoice,,,,,,27/11/2018,27/11/2018,0.00,,7.29,,"-1,177,198.65"
,IN,AR,30332245,1005,100,,Invoice,,,,,,27/11/2018,27/11/2018,0.00,,12.71,,"-1,177,211.36"
,IN,AR,30332268,1005,100,,Invoice,,,,,,27/11/2018,27/11/2018,0.00,,7.80,,"-1,177,219.16"
,IN,AR,30332279,1005,100,,Invoice,,,,,,27/11/2018,27/11/2018,0.00,,19.58,,"-1,177,238.74"
,IN,AR,30332286,1005,100,,Invoice,,,,,,27/11/2018,27/11/2018,0.00,,11.70,,"-1,177,250.44"
,IN,AR,30332290,1005,100,,Invoice,,,,,,27/11/2018,27/11/2018,0.00,,3.01,,"-1,177,253.45"
,IN,AR,30332304,1005,100,,Invoice,,,,,,27/11/2018,27/11/2018,0.00,,18.18,,"-1,177,271.63"
,IN,AR,30332309,1005,100,,Invoice,,,,,,27/11/2018,27/11/2018,0.00,,15.25,,"-1,177,286.88"
,IN,AR,30332314,1005,100,,Invoice,,,,,,27/11/2018,27/11/2018,0.00,,10.53,,"-1,177,297.41"
,IN,AR,30332330,1005,100,,Invoice,,,,,,27/11/2018,27/11/2018,0.00,,4.24,,"-1,177,301.65"
,IN,AR,30332332,1005,100,,Invoice,,,,,,27/11/2018,27/11/2018,0.00,,4.29,,"-1,177,305.94"
,IN,AR,30332356,1005,100,,Invoice,,,,,,27/11/2018,27/11/2018,0.00,,4.24,,"-1,177,310.18"
,IN,AR,30332390,1005,100,,Invoice,,,,,,27/11/2018,27/11/2018,0.00,,25.89,,"-1,177,336.07"
,IN,AR,30332402,1005,100,,Invoice,,,,,,27/11/2018,27/11/2018,0.00,,21.05,,"-1,177,357.12"
,IN,AR,30332417,1005,100,,Invoice,,,,,,27/11/2018,27/11/2018,0.00,,5.51,,"-1,177,362.63"
,IN,AR,30332421,1005,100,,Invoice,,,,,,27/11/2018,27/11/2018,0.00,,8.39,,"-1,177,371.02"
,IN,AR,30332429,1005,100,,Invoice,,,,,,27/11/2018,27/11/2018,0.00,,5.86,,"-1,177,376.88"
,IN,AR,30332441,1005,100,,Invoice,,,,,,27/11/2018,27/11/2018,0.00,,43.73,,"-1,177,420.61"
,IN,AR,30332471,1005,100,,Invoice,,,,,,27/11/2018,27/11/2018,0.00,,7.29,,"-1,177,427.90"
,IN,AR,30332475,1005,100,,Invoice,,,,,,27/11/2018,27/11/2018,0.00,,25.73,,"-1,177,453.63"
,IN,AR,30332483,1005,100,,Invoice,,,,,,27/11/2018,27/11/2018,0.00,,36.45,,"-1,177,490.08"
,IN,AR,30332495,1005,100,,Invoice,,,,,,27/11/2018,27/11/2018,0.00,,7.05,,"-1,177,497.13"
,IN,AR,30332517,1005,100,,Invoice,,,,,,27/11/2018,27/11/2018,0.00,,5.17,,"-1,177,502.30"
,IN,AR,30332519,1005,100,,Invoice,,,,,,27/11/2018,27/11/2018,0.00,,63.56,,"-1,177,565.86"
,IN,AR,30332521,1005,100,,Invoice,,,,,,27/11/2018,27/11/2018,0.00,,7.29,,"-1,177,573.15"
,IN,AR,30332539,1005,100,,Invoice,,,,,,27/11/2018,27/11/2018,0.00,,18.22,,"-1,177,591.37"
,IN,AR,30332555,1005,100,,Invoice,,,,,,27/11/2018,27/11/2018,0.00,,2.84,,"-1,177,594.21"
,IN,AR,30332590,1005,100,,Invoice,,,,,,27/11/2018,27/11/2018,0.00,,3.98,,"-1,177,598.19"
,IN,AR,30332591,1005,100,,Invoice,,,,,,27/11/2018,27/11/2018,0.00,,7.96,,"-1,177,606.15"
,IN,AR,30332603,1005,100,,Invoice,,,,,,27/11/2018,27/11/2018,0.00,,19.87,,"-1,177,626.02"
,IN,AR,30332604,1005,100,,Invoice,,,,,,27/11/2018,27/11/2018,0.00,,30.00,,"-1,177,656.02"
,IN,AR,30332640,1005,100,,Invoice,,,,,,27/11/2018,27/11/2018,0.00,,201.52,,"-1,177,857.54"
,IN,AR,30332647,1005,100,,Invoice,,,,,,27/11/2018,27/11/2018,0.00,,54.66,,"-1,177,912.20"
,IN,AR,30332679,1005,100,,Invoice,,,,,,27/11/2018,27/11/2018,0.00,,7.29,,"-1,177,919.49"
,IN,AR,30332690,1005,100,,Invoice,,,,,,27/11/2018,27/11/2018,0.00,,5.08,,"-1,177,924.57"
,IN,AR,30332705,1005,100,,Invoice,,,,,,27/11/2018,27/11/2018,0.00,,12.00,,"-1,177,936.57"
,IN,AR,30332730,1005,100,,Invoice,,,,,,27/11/2018,27/11/2018,0.00,,14.58,,"-1,177,951.15"
,IN,AR,30332744,1005,100,,Invoice,,,,,,27/11/2018,27/11/2018,0.00,,29.44,,"-1,177,980.59"
,IN,AR,30332788,1005,100,,Invoice,,,,,,27/11/2018,27/11/2018,0.00,,6.42,,"-1,177,987.01"
,IN,AR,30332792,1005,100,,Invoice,,,,,,27/11/2018,27/11/2018,0.00,,146.00,,"-1,178,133.01"
,IN,AR,30332815,1005,100,,Invoice,,,,,,27/11/2018,27/11/2018,0.00,,30.85,,"-1,178,163.86"
,IN,AR,30332830,1005,100,,Invoice,,,,,,27/11/2018,27/11/2018,0.00,,2.54,,"-1,178,166.40"
,IN,AR,30332864,1005,100,,Invoice,,,,,,27/11/2018,27/11/2018,0.00,,108.47,,"-1,178,274.87"
,IN,AR,30332878,1005,100,,Invoice,,,,,,27/11/2018,27/11/2018,0.00,,26.10,,"-1,178,300.97"
,IN,AR,30332879,1005,100,,Invoice,,,,,,27/11/2018,27/11/2018,0.00,,80.69,,"-1,178,381.66"
,IN,AR,30332880,1005,100,,Invoice,,,,,,27/11/2018,27/11/2018,0.00,,28.47,,"-1,178,410.13"
,IN,AR,30332905,1005,100,,Invoice,,,,,,27/11/2018,27/11/2018,0.00,,14.24,,"-1,178,424.37"
,IN,AR,30332910,1005,100,,Invoice,,,,,,27/11/2018,27/11/2018,0.00,,7.29,,"-1,178,431.66"
,IN,AR,30332928,1005,100,,Invoice,,,,,,27/11/2018,27/11/2018,0.00,,1.75,,"-1,178,433.41"
,IN,AR,30332932,1005,100,,Invoice,,,,,,27/11/2018,27/11/2018,0.00,,8.00,,"-1,178,441.41"
,IN,AR,30332934,1005,100,,Invoice,,,,,,27/11/2018,27/11/2018,0.00,,2.97,,"-1,178,444.38"
,IN,AR,30332941,1005,100,,Invoice,,,,,,27/11/2018,27/11/2018,0.00,,143.20,,"-1,178,587.58"
,IN,AR,30332945,1005,100,,Invoice,,,,,,27/11/2018,27/11/2018,0.00,,10.93,,"-1,178,598.51"
,IN,AR,30332948,1005,100,,Invoice,,,,,,27/11/2018,27/11/2018,0.00,,7.02,,"-1,178,605.53"
,IN,AR,30332990,1005,100,,Invoice,,,,,,27/11/2018,27/11/2018,0.00,,46.97,,"-1,178,652.50"
,IN,AR,30332999,1005,100,,Invoice,,,,,,27/11/2018,27/11/2018,0.00,,7.29,,"-1,178,659.79"
,IN,AR,30333013,1005,100,,Invoice,,,,,,27/11/2018,27/11/2018,0.00,,11.95,,"-1,178,671.74"
,IN,AR,30333069,1005,100,,Invoice,,,,,,27/11/2018,27/11/2018,0.00,,6.23,,"-1,178,677.97"
,IN,AR,30333070,1005,100,,Invoice,,,,,,27/11/2018,27/11/2018,0.00,,6.23,,"-1,178,684.20"
,IN,AR,30333071,1005,100,,Invoice,,,,,,27/11/2018,27/11/2018,0.00,,4.15,,"-1,178,688.35"
,IN,AR,30333080,1005,100,,Invoice,,,,,,27/11/2018,27/11/2018,0.00,,25.42,,"-1,178,713.77"
,IN,AR,30333084,1005,100,,Invoice,,,,,,27/11/2018,27/11/2018,0.00,,12.08,,"-1,178,725.85"
,IN,AR,30333086,1005,100,,Invoice,,,,,,27/11/2018,27/11/2018,0.00,,21.86,,"-1,178,747.71"
,IN,AR,30333114,1005,100,,Invoice,,,,,,27/11/2018,27/11/2018,0.00,,8.47,,"-1,178,756.18"
,IN,AR,30333147,1005,100,,Invoice,,,,,,27/11/2018,27/11/2018,0.00,,127.42,,"-1,178,883.60"
,IN,AR,30333155,1005,100,,Invoice,,,,,,27/11/2018,27/11/2018,0.00,,3.64,,"-1,178,887.24"
,IN,AR,30333163,1005,100,,Invoice,,,,,,27/11/2018,27/11/2018,0.00,,10.93,,"-1,178,898.17"
,IN,AR,30333164,1005,100,,Invoice,,,,,,27/11/2018,27/11/2018,0.00,,2.97,,"-1,178,901.14"
,IN,AR,30333166,1005,100,,Invoice,,,,,,27/11/2018,27/11/2018,0.00,,15.17,,"-1,178,916.31"
,IN,AR,30333195,1005,100,,Invoice,,,,,,27/11/2018,27/11/2018,0.00,,10.95,,"-1,178,927.26"
,IN,AR,30333209,1005,100,,Invoice,,,,,,27/11/2018,27/11/2018,0.00,,10.93,,"-1,178,938.19"
,IN,AR,30333239,1005,100,,Invoice,,,,,,27/11/2018,27/11/2018,0.00,,7.29,,"-1,178,945.48"
,IN,AR,30333242,1005,100,,Invoice,,,,,,27/11/2018,27/11/2018,0.00,,10.93,,"-1,178,956.41"
,CS,AR,32011033,1005,100,,Cash sale,,,,,,28/11/2018,28/11/2018,0.00,,30.10,,"-1,178,986.51"
,CS,AR,32011052,1005,100,,Cash sale,,,,,,28/11/2018,28/11/2018,0.00,,7.29,,"-1,178,993.80"
,CS,AR,32011062,1005,100,,Cash sale,,,,,,28/11/2018,28/11/2018,0.00,,3.64,,"-1,178,997.44"
,CS,AR,32011068,1005,100,,Cash sale,,,,,,28/11/2018,28/11/2018,0.00,,7.29,,"-1,179,004.73"
,CS,AR,32011094,1005,100,,Cash sale,,,,,,28/11/2018,28/11/2018,0.00,,3.64,,"-1,179,008.37"
,CS,AR,32011129,1005,100,,Cash sale,,,,,,28/11/2018,28/11/2018,0.00,,3.64,,"-1,179,012.01"
,CS,AR,32011158,1005,100,,Cash sale,,,,,,28/11/2018,28/11/2018,0.00,,5.86,,"-1,179,017.87"
,CS,AR,32011170,1005,100,,Cash sale,,,,,,28/11/2018,28/11/2018,0.00,,5.17,,"-1,179,023.04"
,CS,AR,32011173,1005,100,,Cash sale,,,,,,28/11/2018,28/11/2018,0.00,,14.58,,"-1,179,037.62"
,CS,AR,32011194,1005,100,,Cash sale,,,,,,28/11/2018,28/11/2018,0.00,,27.97,,"-1,179,065.59"
,CS,AR,32011203,1005,100,,Cash sale,,,,,,28/11/2018,28/11/2018,0.00,,7.75,,"-1,179,073.34"
,CS,AR,32011215,1005,100,,Cash sale,,,,,,28/11/2018,28/11/2018,0.00,,7.29,,"-1,179,080.63"
,CS,AR,32011224,1005,100,,Cash sale,,,,,,28/11/2018,28/11/2018,0.00,,8.58,,"-1,179,089.21"
,CS,AR,32011241,1005,100,,Cash sale,,,,,,28/11/2018,28/11/2018,0.00,,10.93,,"-1,179,100.14"
,CS,AR,32011246,1005,100,,Cash sale,,,,,,28/11/2018,28/11/2018,0.00,,5.08,,"-1,179,105.22"
,CS,AR,32011329,1005,100,,Cash sale,,,,,,28/11/2018,28/11/2018,0.00,,7.63,,"-1,179,112.85"
,CS,AR,32011342,1005,100,,Cash sale,,,,,,28/11/2018,28/11/2018,0.00,,18.22,,"-1,179,131.07"
,CS,AR,32011405,1005,100,,Cash sale,,,,,,28/11/2018,28/11/2018,0.00,,21.36,,"-1,179,152.43"
,CS,AR,32011406,1005,100,,Cash sale,,,,,,28/11/2018,28/11/2018,0.00,,8.90,,"-1,179,161.33"
,CS,AR,32011408,1005,100,,Cash sale,,,,,,28/11/2018,28/11/2018,0.00,,7.29,,"-1,179,168.62"
,CS,AR,32011422,1005,100,,Cash sale,,,,,,28/11/2018,28/11/2018,0.00,,6.53,,"-1,179,175.15"
,CS,AR,32011439,1005,100,,Cash sale,,,,,,28/11/2018,28/11/2018,0.00,,54.66,,"-1,179,229.81"
,CS,AR,32011462,1005,100,,Cash sale,,,,,,28/11/2018,28/11/2018,0.00,,9.84,,"-1,179,239.65"
,CS,AR,32011472,1005,100,,Cash sale,,,,,,28/11/2018,28/11/2018,0.00,,11.44,,"-1,179,251.09"
,CS,AR,32011474,1005,100,,Cash sale,,,,,,28/11/2018,28/11/2018,0.00,,25.51,,"-1,179,276.60"
,CS,AR,32011477,1005,100,,Cash sale,,,,,,28/11/2018,28/11/2018,0.00,,21.86,,"-1,179,298.46"
,CS,AR,32011479,1005,100,,Cash sale,,,,,,28/11/2018,28/11/2018,0.00,,6.07,,"-1,179,304.53"
,CS,AR,32011482,1005,100,,Cash sale,,,,,,28/11/2018,28/11/2018,0.00,,7.29,,"-1,179,311.82"
,CS,AR,32011498,1005,100,,Cash sale,,,,,,28/11/2018,28/11/2018,0.00,,6.02,,"-1,179,317.84"
,CS,AR,32011513,1005,100,,Cash sale,,,,,,28/11/2018,28/11/2018,0.00,,14.58,,"-1,179,332.42"
,CS,AR,32011535,1005,100,,Cash sale,,,,,,28/11/2018,28/11/2018,0.00,,7.29,,"-1,179,339.71"
,CS,AR,32011536,1005,100,,Cash sale,,,,,,28/11/2018,28/11/2018,0.00,,7.29,,"-1,179,347.00"
,CS,AR,32011569,1005,100,,Cash sale,,,,,,28/11/2018,28/11/2018,0.00,,10.99,,"-1,179,357.99"
,CS,AR,32011576,1005,100,,Cash sale,,,,,,28/11/2018,28/11/2018,0.00,,3.64,,"-1,179,361.63"
,CS,AR,32011584,1005,100,,Cash sale,,,,,,28/11/2018,28/11/2018,0.00,,7.29,,"-1,179,368.92"
,CS,AR,32011623,1005,100,,Cash sale,,,,,,28/11/2018,28/11/2018,0.00,,11.65,,"-1,179,380.57"
,CS,AR,32011635,1005,100,,Cash sale,,,,,,28/11/2018,28/11/2018,0.00,,3.64,,"-1,179,384.21"
,CS,AR,32011655,1005,100,,Cash sale,,,,,,28/11/2018,28/11/2018,0.00,,10.93,,"-1,179,395.14"
,IN,AR,30331740,1005,100,,Invoice,,,,,,28/11/2018,28/11/2018,0.00,,38.56,,"-1,179,433.70"
,IN,AR,30331757,1005,100,,Invoice,,,,,,28/11/2018,28/11/2018,0.00,,18.22,,"-1,179,451.92"
,IN,AR,30331764,1005,100,,Invoice,,,,,,28/11/2018,28/11/2018,0.00,,58.58,,"-1,179,510.50"
,IN,AR,30331765,1005,100,,Invoice,,,,,,28/11/2018,28/11/2018,0.00,,14.64,,"-1,179,525.14"
,IN,AR,30331783,1005,100,,Invoice,,,,,,28/11/2018,28/11/2018,0.00,,21.69,,"-1,179,546.83"
,IN,AR,30331789,1005,100,,Invoice,,,,,,28/11/2018,28/11/2018,0.00,,2.84,,"-1,179,549.67"
,IN,AR,30331791,1005,100,,Invoice,,,,,,28/11/2018,28/11/2018,0.00,,18.22,,"-1,179,567.89"
,IN,AR,30331803,1005,100,,Invoice,,,,,,28/11/2018,28/11/2018,0.00,,23.64,,"-1,179,591.53"
,IN,AR,30331804,1005,100,,Invoice,,,,,,28/11/2018,28/11/2018,0.00,,70.93,,"-1,179,662.46"
,IN,AR,30331810,1005,100,,Invoice,,,,,,28/11/2018,28/11/2018,0.00,,7.29,,"-1,179,669.75"
,IN,AR,30331814,1005,100,,Invoice,,,,,,28/11/2018,28/11/2018,0.00,,16.91,,"-1,179,686.66"
,IN,AR,30331825,1005,100,,Invoice,,,,,,28/11/2018,28/11/2018,0.00,,40.68,,"-1,179,727.34"
,IN,AR,30331853,1005,100,,Invoice,,,,,,28/11/2018,28/11/2018,0.00,,7.97,,"-1,179,735.31"
,IN,AR,30331868,1005,100,,Invoice,,,,,,28/11/2018,28/11/2018,0.00,,58.00,,"-1,179,793.31"
,IN,AR,30331884,1005,100,,Invoice,,,,,,28/11/2018,28/11/2018,0.00,,3.64,,"-1,179,796.95"
,IN,AR,30331914,1005,100,,Invoice,,,,,,28/11/2018,28/11/2018,0.00,,28.00,,"-1,179,824.95"
,IN,AR,30331931,1005,100,,Invoice,,,,,,28/11/2018,28/11/2018,0.00,,24.00,,"-1,179,848.95"
,IN,AR,30331948,1005,100,,Invoice,,,,,,28/11/2018,28/11/2018,0.00,,11.15,,"-1,179,860.10"
,IN,AR,30331959,1005,100,,Invoice,,,,,,28/11/2018,28/11/2018,0.00,,68.22,,"-1,179,928.32"
,IN,AR,30331998,1005,100,,Invoice,,,,,,28/11/2018,28/11/2018,0.00,,5.59,,"-1,179,933.91"
,IN,AR,30332006,1005,100,,Invoice,,,,,,28/11/2018,28/11/2018,0.00,,5.31,,"-1,179,939.22"
,IN,AR,30332065,1005,100,,Invoice,,,,,,28/11/2018,28/11/2018,0.00,,25.42,,"-1,179,964.64"
,IN,AR,30332072,1005,100,,Invoice,,,,,,28/11/2018,28/11/2018,0.00,,4.24,,"-1,179,968.88"
,IN,AR,30332075,1005,100,,Invoice,,,,,,28/11/2018,28/11/2018,0.00,,4.24,,"-1,179,973.12"
,IN,AR,30332082,1005,100,,Invoice,,,,,,28/11/2018,28/11/2018,0.00,,22.37,,"-1,179,995.49"
,IN,AR,30332086,1005,100,,Invoice,,,,,,28/11/2018,28/11/2018,0.00,,2.12,,"-1,179,997.61"
,IN,AR,30332091,1005,100,,Invoice,,,,,,28/11/2018,28/11/2018,0.00,,8.39,,"-1,180,006.00"
,IN,AR,30332116,1005,100,,Invoice,,,,,,28/11/2018,28/11/2018,0.00,,7.17,,"-1,180,013.17"
,IN,AR,30332123,1005,100,,Invoice,,,,,,28/11/2018,28/11/2018,0.00,,14.58,,"-1,180,027.75"
,IN,AR,30332146,1005,100,,Invoice,,,,,,28/11/2018,28/11/2018,0.00,,38.97,,"-1,180,066.72"
,IN,AR,30332184,1005,100,,Invoice,,,,,,28/11/2018,28/11/2018,0.00,,10.93,,"-1,180,077.65"
,IN,AR,30332198,1005,100,,Invoice,,,,,,28/11/2018,28/11/2018,0.00,,10.34,,"-1,180,087.99"
,IN,AR,30332204,1005,100,,Invoice,,,,,,28/11/2018,28/11/2018,0.00,,180.05,,"-1,180,268.04"
,IN,AR,30332209,1005,100,,Invoice,,,,,,28/11/2018,28/11/2018,0.00,,10.17,,"-1,180,278.21"
,IN,AR,30332226,1005,100,,Invoice,,,,,,28/11/2018,28/11/2018,0.00,,2.54,,"-1,180,280.75"
,IN,AR,30332233,1005,100,,Invoice,,,,,,28/11/2018,28/11/2018,0.00,,3.19,,"-1,180,283.94"
,IN,AR,30332248,1005,100,,Invoice,,,,,,28/11/2018,28/11/2018,0.00,,14.58,,"-1,180,298.52"
,IN,AR,30332272,1005,100,,Invoice,,,,,,28/11/2018,28/11/2018,0.00,,2.58,,"-1,180,301.10"
,IN,AR,30332276,1005,100,,Invoice,,,,,,28/11/2018,28/11/2018,0.00,,13.63,,"-1,180,314.73"
,IN,AR,30332327,1005,100,,Invoice,,,,,,28/11/2018,28/11/2018,0.00,,14.58,,"-1,180,329.31"
,IN,AR,30332351,1005,100,,Invoice,,,,,,28/11/2018,28/11/2018,0.00,,22.44,,"-1,180,351.75"
,IN,AR,30332362,1005,100,,Invoice,,,,,,28/11/2018,28/11/2018,0.00,,14.83,,"-1,180,366.58"
,IN,AR,30332371,1005,100,,Invoice,,,,,,28/11/2018,28/11/2018,0.00,,10.93,,"-1,180,377.51"
,IN,AR,30332386,1005,100,,Invoice,,,,,,28/11/2018,28/11/2018,0.00,,27.97,,"-1,180,405.48"
,IN,AR,30332389,1005,100,,Invoice,,,,,,28/11/2018,28/11/2018,0.00,,7.29,,"-1,180,412.77"
,IN,AR,30332393,1005,100,,Invoice,,,,,,28/11/2018,28/11/2018,0.00,,10.17,,"-1,180,422.94"
,IN,AR,30332406,1005,100,,Invoice,,,,,,28/11/2018,28/11/2018,0.00,,16.27,,"-1,180,439.21"
,IN,AR,30332418,1005,100,,Invoice,,,,,,28/11/2018,28/11/2018,0.00,,3.64,,"-1,180,442.85"
,IN,AR,30332426,1005,100,,Invoice,,,,,,28/11/2018,28/11/2018,0.00,,7.75,,"-1,180,450.60"
,IN,AR,30332435,1005,100,,Invoice,,,,,,28/11/2018,28/11/2018,0.00,,31.55,,"-1,180,482.15"
,IN,AR,30332448,1005,100,,Invoice,,,,,,28/11/2018,28/11/2018,0.00,,18.05,,"-1,180,500.20"
,IN,AR,30332496,1005,100,,Invoice,,,,,,28/11/2018,28/11/2018,0.00,,5.29,,"-1,180,505.49"
,IN,AR,30332497,1005,100,,Invoice,,,,,,28/11/2018,28/11/2018,0.00,,14.09,,"-1,180,519.58"
,IN,AR,30332498,1005,100,,Invoice,,,,,,28/11/2018,28/11/2018,0.00,,3.53,,"-1,180,523.11"
,IN,AR,30332502,1005,100,,Invoice,,,,,,28/11/2018,28/11/2018,0.00,,12.03,,"-1,180,535.14"
,IN,AR,30332529,1005,100,,Invoice,,,,,,28/11/2018,28/11/2018,0.00,,7.75,,"-1,180,542.89"
,IN,AR,30332542,1005,100,,Invoice,,,,,,28/11/2018,28/11/2018,0.00,,6.00,,"-1,180,548.89"
,IN,AR,30332547,1005,100,,Invoice,,,,,,28/11/2018,28/11/2018,0.00,,32.80,,"-1,180,581.69"
,IN,AR,30332548,1005,100,,Invoice,,,,,,28/11/2018,28/11/2018,0.00,,18.22,,"-1,180,599.91"
,IN,AR,30332563,1005,100,,Invoice,,,,,,28/11/2018,28/11/2018,0.00,,15.25,,"-1,180,615.16"
,IN,AR,30332592,1005,100,,Invoice,,,,,,28/11/2018,28/11/2018,0.00,,9.95,,"-1,180,625.11"
,IN,AR,30332596,1005,100,,Invoice,,,,,,28/11/2018,28/11/2018,0.00,,4.01,,"-1,180,629.12"
,IN,AR,30332621,1005,100,,Invoice,,,,,,28/11/2018,28/11/2018,0.00,,36.08,,"-1,180,665.20"
,IN,AR,30332663,1005,100,,Invoice,,,,,,28/11/2018,28/11/2018,0.00,,5.09,,"-1,180,670.29"
,IN,AR,30332669,1005,100,,Invoice,,,,,,28/11/2018,28/11/2018,0.00,,36.22,,"-1,180,706.51"
,IN,AR,30332691,1005,100,,Invoice,,,,,,28/11/2018,28/11/2018,0.00,,12.71,,"-1,180,719.22"
,IN,AR,30332692,1005,100,,Invoice,,,,,,28/11/2018,28/11/2018,0.00,,7.63,,"-1,180,726.85"
,IN,AR,30332710,1005,100,,Invoice,,,,,,28/11/2018,28/11/2018,0.00,,16.01,,"-1,180,742.86"
,IN,AR,30332729,1005,100,,Invoice,,,,,,28/11/2018,28/11/2018,0.00,,2.92,,"-1,180,745.78"
,IN,AR,30332745,1005,100,,Invoice,,,,,,28/11/2018,28/11/2018,0.00,,23.13,,"-1,180,768.91"
,IN,AR,30332751,1005,100,,Invoice,,,,,,28/11/2018,28/11/2018,0.00,,32.39,,"-1,180,801.30"
,IN,AR,30332752,1005,100,,Invoice,,,,,,28/11/2018,28/11/2018,0.00,,14.58,,"-1,180,815.88"
,IN,AR,30332755,1005,100,,Invoice,,,,,,28/11/2018,28/11/2018,0.00,,4.66,,"-1,180,820.54"
,IN,AR,30332785,1005,100,,Invoice,,,,,,28/11/2018,28/11/2018,0.00,,5.59,,"-1,180,826.13"
,IN,AR,30332824,1005,100,,Invoice,,,,,,28/11/2018,28/11/2018,0.00,,54.66,,"-1,180,880.79"
,IN,AR,30332837,1005,100,,Invoice,,,,,,28/11/2018,28/11/2018,0.00,,40.04,,"-1,180,920.83"
,IN,AR,30332860,1005,100,,Invoice,,,,,,28/11/2018,28/11/2018,0.00,,7.97,,"-1,180,928.80"
,IN,AR,30332861,1005,100,,Invoice,,,,,,28/11/2018,28/11/2018,0.00,,3.19,,"-1,180,931.99"
,IN,AR,30332925,1005,100,,Invoice,,,,,,28/11/2018,28/11/2018,0.00,,5.26,,"-1,180,937.25"
,IN,AR,30332936,1005,100,,Invoice,,,,,,28/11/2018,28/11/2018,0.00,,18.22,,"-1,180,955.47"
,IN,AR,30332965,1005,100,,Invoice,,,,,,28/11/2018,28/11/2018,0.00,,9.41,,"-1,180,964.88"
,IN,AR,30333022,1005,100,,Invoice,,,,,,28/11/2018,28/11/2018,0.00,,20.59,,"-1,180,985.47"
,IN,AR,30333072,1005,100,,Invoice,,,,,,28/11/2018,28/11/2018,0.00,,56.06,,"-1,181,041.53"
,IN,AR,30333073,1005,100,,Invoice,,,,,,28/11/2018,28/11/2018,0.00,,8.31,,"-1,181,049.84"
,IN,AR,30333074,1005,100,,Invoice,,,,,,28/11/2018,28/11/2018,0.00,,8.31,,"-1,181,058.15"
,IN,AR,30333117,1005,100,,Invoice,,,,,,28/11/2018,28/11/2018,0.00,,36.44,,"-1,181,094.59"
,IN,AR,30333140,1005,100,,Invoice,,,,,,28/11/2018,28/11/2018,0.00,,13.98,,"-1,181,108.57"
,IN,AR,30333149,1005,100,,Invoice,,,,,,28/11/2018,28/11/2018,0.00,,7.29,,"-1,181,115.86"
,IN,AR,30333214,1005,100,,Invoice,,,,,,28/11/2018,28/11/2018,0.00,,3.64,,"-1,181,119.50"
,IN,AR,30333219,1005,100,,Invoice,,,,,,28/11/2018,28/11/2018,0.00,,3.64,,"-1,181,123.14"
,IN,AR,30333221,1005,100,,Invoice,,,,,,28/11/2018,28/11/2018,0.00,,3.64,,"-1,181,126.78"
,IN,AR,30333244,1005,100,,Invoice,,,,,,28/11/2018,28/11/2018,0.00,,29.15,,"-1,181,155.93"
,CN,AR,31019628,1005,100,,Credit Note,,,,,,28/11/2018,28/11/2018,759.36,,0.00,,"-1,180,396.57"
,CS,AR,32011690,1005,100,,Cash sale,,,,,,28/11/2018,28/11/2018,0.00,,6.02,,"-1,180,402.59"
,CS,AR,32011702,1005,100,,Cash sale,,,,,,28/11/2018,28/11/2018,0.00,,18.05,,"-1,180,420.64"
,CS,AR,32011703,1005,100,,Cash sale,,,,,,28/11/2018,28/11/2018,0.00,,18.22,,"-1,180,438.86"
,CS,AR,32011720,1005,100,,Cash sale,,,,,,28/11/2018,28/11/2018,0.00,,7.29,,"-1,180,446.15"
,IN,AR,30333280,1005,100,,Invoice,,,,,,28/11/2018,28/11/2018,0.00,,4.24,,"-1,180,450.39"
,IN,AR,30333412,1005,100,,Invoice,,,,,,28/11/2018,28/11/2018,0.00,,11.36,,"-1,180,461.75"
,IN,AR,30333414,1005,100,,Invoice,,,,,,28/11/2018,28/11/2018,0.00,,10.93,,"-1,180,472.68"
,IN,AR,30333426,1005,100,,Invoice,,,,,,28/11/2018,28/11/2018,0.00,,25.51,,"-1,180,498.19"
,IN,AR,30333427,1005,100,,Invoice,,,,,,28/11/2018,28/11/2018,0.00,,59.62,,"-1,180,557.81"
,IN,AR,30333429,1005,100,,Invoice,,,,,,28/11/2018,28/11/2018,0.00,,14.03,,"-1,180,571.84"
,IN,AR,30333435,1005,100,,Invoice,,,,,,28/11/2018,28/11/2018,0.00,,759.36,,"-1,181,331.20"
,IN,AR,30333500,1005,100,,Invoice,,,,,,28/11/2018,28/11/2018,0.00,,24.27,,"-1,181,355.47"
,IN,AR,30333508,1005,100,,Invoice,,,,,,28/11/2018,28/11/2018,0.00,,5.39,,"-1,181,360.86"
,CN,AR,31019623,1005,100,,Credit Note,,,,,,29/11/2018,29/11/2018,10.93,,0.00,,"-1,181,349.93"
,CS,AR,32011307,1005,100,,Cash sale,,,,,,29/11/2018,29/11/2018,0.00,,364.41,,"-1,181,714.34"
,CS,AR,32011331,1005,100,,Cash sale,,,,,,29/11/2018,29/11/2018,0.00,,9.66,,"-1,181,724.00"
,CS,AR,32011390,1005,100,,Cash sale,,,,,,29/11/2018,29/11/2018,0.00,,5.34,,"-1,181,729.34"
,CS,AR,32011566,1005,100,,Cash sale,,,,,,29/11/2018,29/11/2018,0.00,,6.56,,"-1,181,735.90"
,CS,AR,32011588,1005,100,,Cash sale,,,,,,29/11/2018,29/11/2018,0.00,,10.93,,"-1,181,746.83"
,IN,AR,30331751,1005,100,,Invoice,,,,,,29/11/2018,29/11/2018,0.00,,439.62,,"-1,182,186.45"
,IN,AR,30331837,1005,100,,Invoice,,,,,,29/11/2018,29/11/2018,0.00,,51.02,,"-1,182,237.47"
,IN,AR,30331877,1005,100,,Invoice,,,,,,29/11/2018,29/11/2018,0.00,,54.66,,"-1,182,292.13"
,IN,AR,30331903,1005,100,,Invoice,,,,,,29/11/2018,29/11/2018,0.00,,54.66,,"-1,182,346.79"
,IN,AR,30332000,1005,100,,Invoice,,,,,,29/11/2018,29/11/2018,0.00,,10.93,,"-1,182,357.72"
,IN,AR,30332031,1005,100,,Invoice,,,,,,29/11/2018,29/11/2018,0.00,,24.50,,"-1,182,382.22"
,IN,AR,30332106,1005,100,,Invoice,,,,,,29/11/2018,29/11/2018,0.00,,"1,093.22",,"-1,183,475.44"
,CN,AR,31019627,1005,100,,Credit Note,,,,,,29/11/2018,29/11/2018,42.47,,0.00,,"-1,183,432.97"
,CS,AR,32011680,1005,100,,Cash sale,,,,,,29/11/2018,29/11/2018,0.00,,18.05,,"-1,183,451.02"
,CS,AR,32011681,1005,100,,Cash sale,,,,,,29/11/2018,29/11/2018,0.00,,18.98,,"-1,183,470.00"
,CS,AR,32011683,1005,100,,Cash sale,,,,,,29/11/2018,29/11/2018,0.00,,3.64,,"-1,183,473.64"
,CS,AR,32011684,1005,100,,Cash sale,,,,,,29/11/2018,29/11/2018,0.00,,5.68,,"-1,183,479.32"
,CS,AR,32011685,1005,100,,Cash sale,,,,,,29/11/2018,29/11/2018,0.00,,3.64,,"-1,183,482.96"
,CS,AR,32011692,1005,100,,Cash sale,,,,,,29/11/2018,29/11/2018,0.00,,3.64,,"-1,183,486.60"
,CS,AR,32011693,1005,100,,Cash sale,,,,,,29/11/2018,29/11/2018,0.00,,3.01,,"-1,183,489.61"
,CS,AR,32011694,1005,100,,Cash sale,,,,,,29/11/2018,29/11/2018,0.00,,3.64,,"-1,183,493.25"
,CS,AR,32011695,1005,100,,Cash sale,,,,,,29/11/2018,29/11/2018,0.00,,3.64,,"-1,183,496.89"
,CS,AR,32011696,1005,100,,Cash sale,,,,,,29/11/2018,29/11/2018,0.00,,10.93,,"-1,183,507.82"
,CS,AR,32011700,1005,100,,Cash sale,,,,,,29/11/2018,29/11/2018,0.00,,5.17,,"-1,183,512.99"
,CS,AR,32011704,1005,100,,Cash sale,,,,,,29/11/2018,29/11/2018,0.00,,3.64,,"-1,183,516.63"
,CS,AR,32011705,1005,100,,Cash sale,,,,,,29/11/2018,29/11/2018,0.00,,4.32,,"-1,183,520.95"
,CS,AR,32011707,1005,100,,Cash sale,,,,,,29/11/2018,29/11/2018,0.00,,3.64,,"-1,183,524.59"
,CS,AR,32011709,1005,100,,Cash sale,,,,,,29/11/2018,29/11/2018,0.00,,3.64,,"-1,183,528.23"
,CS,AR,32011710,1005,100,,Cash sale,,,,,,29/11/2018,29/11/2018,0.00,,33.56,,"-1,183,561.79"
,CS,AR,32011711,1005,100,,Cash sale,,,,,,29/11/2018,29/11/2018,0.00,,10.93,,"-1,183,572.72"
,CS,AR,32011712,1005,100,,Cash sale,,,,,,29/11/2018,29/11/2018,0.00,,14.58,,"-1,183,587.30"
,CS,AR,32011713,1005,100,,Cash sale,,,,,,29/11/2018,29/11/2018,0.00,,5.17,,"-1,183,592.47"
,CS,AR,32011717,1005,100,,Cash sale,,,,,,29/11/2018,29/11/2018,0.00,,7.75,,"-1,183,600.22"
,CS,AR,32011718,1005,100,,Cash sale,,,,,,29/11/2018,29/11/2018,0.00,,5.59,,"-1,183,605.81"
,CS,AR,32011719,1005,100,,Cash sale,,,,,,29/11/2018,29/11/2018,0.00,,3.64,,"-1,183,609.45"
,CS,AR,32011721,1005,100,,Cash sale,,,,,,29/11/2018,29/11/2018,0.00,,3.64,,"-1,183,613.09"
,CS,AR,32011722,1005,100,,Cash sale,,,,,,29/11/2018,29/11/2018,0.00,,5.17,,"-1,183,618.26"
,CS,AR,32011723,1005,100,,Cash sale,,,,,,29/11/2018,29/11/2018,0.00,,7.29,,"-1,183,625.55"
,CS,AR,32011724,1005,100,,Cash sale,,,,,,29/11/2018,29/11/2018,0.00,,10.93,,"-1,183,636.48"
,CS,AR,32011725,1005,100,,Cash sale,,,,,,29/11/2018,29/11/2018,0.00,,3.64,,"-1,183,640.12"
,CS,AR,32011728,1005,100,,Cash sale,,,,,,29/11/2018,29/11/2018,0.00,,17.80,,"-1,183,657.92"
,CS,AR,32011729,1005,100,,Cash sale,,,,,,29/11/2018,29/11/2018,0.00,,39.46,,"-1,183,697.38"
,CS,AR,32011731,1005,100,,Cash sale,,,,,,29/11/2018,29/11/2018,0.00,,10.00,,"-1,183,707.38"
,CS,AR,32011733,1005,100,,Cash sale,,,,,,29/11/2018,29/11/2018,0.00,,18.22,,"-1,183,725.60"
,CS,AR,32011735,1005,100,,Cash sale,,,,,,29/11/2018,29/11/2018,0.00,,5.86,,"-1,183,731.46"
,CS,AR,32011738,1005,100,,Cash sale,,,,,,29/11/2018,29/11/2018,0.00,,3.64,,"-1,183,735.10"
,CS,AR,32011741,1005,100,,Cash sale,,,,,,29/11/2018,29/11/2018,0.00,,7.29,,"-1,183,742.39"
,CS,AR,32011742,1005,100,,Cash sale,,,,,,29/11/2018,29/11/2018,0.00,,3.64,,"-1,183,746.03"
,CS,AR,32011743,1005,100,,Cash sale,,,,,,29/11/2018,29/11/2018,0.00,,2.54,,"-1,183,748.57"
,CS,AR,32011745,1005,100,,Cash sale,,,,,,29/11/2018,29/11/2018,0.00,,10.93,,"-1,183,759.50"
,IN,AR,30333245,1005,100,,Invoice,,,,,,29/11/2018,29/11/2018,0.00,,7.29,,"-1,183,766.79"
,IN,AR,30333247,1005,100,,Invoice,,,,,,29/11/2018,29/11/2018,0.00,,10.93,,"-1,183,777.72"
,IN,AR,30333249,1005,100,,Invoice,,,,,,29/11/2018,29/11/2018,0.00,,18.22,,"-1,183,795.94"
,IN,AR,30333250,1005,100,,Invoice,,,,,,29/11/2018,29/11/2018,0.00,,3.98,,"-1,183,799.92"
,IN,AR,30333251,1005,100,,Invoice,,,,,,29/11/2018,29/11/2018,0.00,,12.00,,"-1,183,811.92"
,IN,AR,30333253,1005,100,,Invoice,,,,,,29/11/2018,29/11/2018,0.00,,3.64,,"-1,183,815.56"
,IN,AR,30333254,1005,100,,Invoice,,,,,,29/11/2018,29/11/2018,0.00,,58.00,,"-1,183,873.56"
,IN,AR,30333255,1005,100,,Invoice,,,,,,29/11/2018,29/11/2018,0.00,,14.83,,"-1,183,888.39"
,IN,AR,30333256,1005,100,,Invoice,,,,,,29/11/2018,29/11/2018,0.00,,14.58,,"-1,183,902.97"
,IN,AR,30333257,1005,100,,Invoice,,,,,,29/11/2018,29/11/2018,0.00,,7.29,,"-1,183,910.26"
,IN,AR,30333259,1005,100,,Invoice,,,,,,29/11/2018,29/11/2018,0.00,,68.81,,"-1,183,979.07"
,IN,AR,30333261,1005,100,,Invoice,,,,,,29/11/2018,29/11/2018,0.00,,7.29,,"-1,183,986.36"
,IN,AR,30333262,1005,100,,Invoice,,,,,,29/11/2018,29/11/2018,0.00,,27.46,,"-1,184,013.82"
,IN,AR,30333263,1005,100,,Invoice,,,,,,29/11/2018,29/11/2018,0.00,,8.52,,"-1,184,022.34"
,IN,AR,30333264,1005,100,,Invoice,,,,,,29/11/2018,29/11/2018,0.00,,780.96,,"-1,184,803.30"
,IN,AR,30333265,1005,100,,Invoice,,,,,,29/11/2018,29/11/2018,0.00,,88.42,,"-1,184,891.72"
,IN,AR,30333266,1005,100,,Invoice,,,,,,29/11/2018,29/11/2018,0.00,,18.22,,"-1,184,909.94"
,IN,AR,30333269,1005,100,,Invoice,,,,,,29/11/2018,29/11/2018,0.00,,14.58,,"-1,184,924.52"
,IN,AR,30333270,1005,100,,Invoice,,,,,,29/11/2018,29/11/2018,0.00,,12.92,,"-1,184,937.44"
,IN,AR,30333272,1005,100,,Invoice,,,,,,29/11/2018,29/11/2018,0.00,,4.80,,"-1,184,942.24"
,IN,AR,30333278,1005,100,,Invoice,,,,,,29/11/2018,29/11/2018,0.00,,8.47,,"-1,184,950.71"
,IN,AR,30333281,1005,100,,Invoice,,,,,,29/11/2018,29/11/2018,0.00,,14.58,,"-1,184,965.29"
,IN,AR,30333282,1005,100,,Invoice,,,,,,29/11/2018,29/11/2018,0.00,,21.97,,"-1,184,987.26"
,IN,AR,30333283,1005,100,,Invoice,,,,,,29/11/2018,29/11/2018,0.00,,167.47,,"-1,185,154.73"
,IN,AR,30333284,1005,100,,Invoice,,,,,,29/11/2018,29/11/2018,0.00,,23.29,,"-1,185,178.02"
,IN,AR,30333285,1005,100,,Invoice,,,,,,29/11/2018,29/11/2018,0.00,,7.29,,"-1,185,185.31"
,IN,AR,30333286,1005,100,,Invoice,,,,,,29/11/2018,29/11/2018,0.00,,11.95,,"-1,185,197.26"
,IN,AR,30333289,1005,100,,Invoice,,,,,,29/11/2018,29/11/2018,0.00,,25.42,,"-1,185,222.68"
,IN,AR,30333290,1005,100,,Invoice,,,,,,29/11/2018,29/11/2018,0.00,,83.90,,"-1,185,306.58"
,IN,AR,30333291,1005,100,,Invoice,,,,,,29/11/2018,29/11/2018,0.00,,10.17,,"-1,185,316.75"
,IN,AR,30333292,1005,100,,Invoice,,,,,,29/11/2018,29/11/2018,0.00,,19.12,,"-1,185,335.87"
,IN,AR,30333293,1005,100,,Invoice,,,,,,29/11/2018,29/11/2018,0.00,,12.88,,"-1,185,348.75"
,IN,AR,30333320,1005,100,,Invoice,,,,,,29/11/2018,29/11/2018,0.00,,5.08,,"-1,185,353.83"
,IN,AR,30333324,1005,100,,Invoice,,,,,,29/11/2018,29/11/2018,0.00,,33.10,,"-1,185,386.93"
,IN,AR,30333326,1005,100,,Invoice,,,,,,29/11/2018,29/11/2018,0.00,,5.17,,"-1,185,392.10"
,IN,AR,30333327,1005,100,,Invoice,,,,,,29/11/2018,29/11/2018,0.00,,4.32,,"-1,185,396.42"
,IN,AR,30333328,1005,100,,Invoice,,,,,,29/11/2018,29/11/2018,0.00,,4.32,,"-1,185,400.74"
,IN,AR,30333356,1005,100,,Invoice,,,,,,29/11/2018,29/11/2018,0.00,,17.80,,"-1,185,418.54"
,IN,AR,30333358,1005,100,,Invoice,,,,,,29/11/2018,29/11/2018,0.00,,20.00,,"-1,185,438.54"
,IN,AR,30333359,1005,100,,Invoice,,,,,,29/11/2018,29/11/2018,0.00,,9.92,,"-1,185,448.46"
,IN,AR,30333360,1005,100,,Invoice,,,,,,29/11/2018,29/11/2018,0.00,,12.03,,"-1,185,460.49"
,IN,AR,30333362,1005,100,,Invoice,,,,,,29/11/2018,29/11/2018,0.00,,16.47,,"-1,185,476.96"
,IN,AR,30333364,1005,100,,Invoice,,,,,,29/11/2018,29/11/2018,0.00,,5.93,,"-1,185,482.89"
,IN,AR,30333365,1005,100,,Invoice,,,,,,29/11/2018,29/11/2018,0.00,,32.63,,"-1,185,515.52"
,IN,AR,30333369,1005,100,,Invoice,,,,,,29/11/2018,29/11/2018,0.00,,10.93,,"-1,185,526.45"
,IN,AR,30333371,1005,100,,Invoice,,,,,,29/11/2018,29/11/2018,0.00,,6.97,,"-1,185,533.42"
,IN,AR,30333372,1005,100,,Invoice,,,,,,29/11/2018,29/11/2018,0.00,,8.77,,"-1,185,542.19"
,IN,AR,30333373,1005,100,,Invoice,,,,,,29/11/2018,29/11/2018,0.00,,14.58,,"-1,185,556.77"
,IN,AR,30333374,1005,100,,Invoice,,,,,,29/11/2018,29/11/2018,0.00,,24.79,,"-1,185,581.56"
,IN,AR,30333376,1005,100,,Invoice,,,,,,29/11/2018,29/11/2018,0.00,,12.03,,"-1,185,593.59"
,IN,AR,30333377,1005,100,,Invoice,,,,,,29/11/2018,29/11/2018,0.00,,9.10,,"-1,185,602.69"
,IN,AR,30333378,1005,100,,Invoice,,,,,,29/11/2018,29/11/2018,0.00,,5.49,,"-1,185,608.18"
,IN,AR,30333379,1005,100,,Invoice,,,,,,29/11/2018,29/11/2018,0.00,,17.47,,"-1,185,625.65"
,IN,AR,30333380,1005,100,,Invoice,,,,,,29/11/2018,29/11/2018,0.00,,7.63,,"-1,185,633.28"
,IN,AR,30333382,1005,100,,Invoice,,,,,,29/11/2018,29/11/2018,0.00,,48.14,,"-1,185,681.42"
,IN,AR,30333383,1005,100,,Invoice,,,,,,29/11/2018,29/11/2018,0.00,,4.00,,"-1,185,685.42"
,IN,AR,30333384,1005,100,,Invoice,,,,,,29/11/2018,29/11/2018,0.00,,1.76,,"-1,185,687.18"
,IN,AR,30333385,1005,100,,Invoice,,,,,,29/11/2018,29/11/2018,0.00,,18.33,,"-1,185,705.51"
,IN,AR,30333386,1005,100,,Invoice,,,,,,29/11/2018,29/11/2018,0.00,,5.86,,"-1,185,711.37"
,IN,AR,30333389,1005,100,,Invoice,,,,,,29/11/2018,29/11/2018,0.00,,5.18,,"-1,185,716.55"
,IN,AR,30333402,1005,100,,Invoice,,,,,,29/11/2018,29/11/2018,0.00,,10.93,,"-1,185,727.48"
,IN,AR,30333404,1005,100,,Invoice,,,,,,29/11/2018,29/11/2018,0.00,,9.96,,"-1,185,737.44"
,IN,AR,30333405,1005,100,,Invoice,,,,,,29/11/2018,29/11/2018,0.00,,13.94,,"-1,185,751.38"
,IN,AR,30333406,1005,100,,Invoice,,,,,,29/11/2018,29/11/2018,0.00,,3.98,,"-1,185,755.36"
,IN,AR,30333407,1005,100,,Invoice,,,,,,29/11/2018,29/11/2018,0.00,,31.86,,"-1,185,787.22"
,IN,AR,30333408,1005,100,,Invoice,,,,,,29/11/2018,29/11/2018,0.00,,7.96,,"-1,185,795.18"
,IN,AR,30333409,1005,100,,Invoice,,,,,,29/11/2018,29/11/2018,0.00,,23.88,,"-1,185,819.06"
,IN,AR,30333410,1005,100,,Invoice,,,,,,29/11/2018,29/11/2018,0.00,,5.97,,"-1,185,825.03"
,IN,AR,30333415,1005,100,,Invoice,,,,,,29/11/2018,29/11/2018,0.00,,3.64,,"-1,185,828.67"
,IN,AR,30333418,1005,100,,Invoice,,,,,,29/11/2018,29/11/2018,0.00,,10.93,,"-1,185,839.60"
,IN,AR,30333420,1005,100,,Invoice,,,,,,29/11/2018,29/11/2018,0.00,,17.80,,"-1,185,857.40"
,IN,AR,30333421,1005,100,,Invoice,,,,,,29/11/2018,29/11/2018,0.00,,18.01,,"-1,185,875.41"
,IN,AR,30333422,1005,100,,Invoice,,,,,,29/11/2018,29/11/2018,0.00,,2.00,,"-1,185,877.41"
,IN,AR,30333423,1005,100,,Invoice,,,,,,29/11/2018,29/11/2018,0.00,,8.00,,"-1,185,885.41"
,IN,AR,30333424,1005,100,,Invoice,,,,,,29/11/2018,29/11/2018,0.00,,20.01,,"-1,185,905.42"
,IN,AR,30333425,1005,100,,Invoice,,,,,,29/11/2018,29/11/2018,0.00,,40.81,,"-1,185,946.23"
,IN,AR,30333430,1005,100,,Invoice,,,,,,29/11/2018,29/11/2018,0.00,,11.22,,"-1,185,957.45"
,IN,AR,30333431,1005,100,,Invoice,,,,,,29/11/2018,29/11/2018,0.00,,16.02,,"-1,185,973.47"
,IN,AR,30333433,1005,100,,Invoice,,,,,,29/11/2018,29/11/2018,0.00,,42.47,,"-1,186,015.94"
,IN,AR,30333434,1005,100,,Invoice,,,,,,29/11/2018,29/11/2018,0.00,,15.17,,"-1,186,031.11"
,IN,AR,30333436,1005,100,,Invoice,,,,,,29/11/2018,29/11/2018,0.00,,11.86,,"-1,186,042.97"
,IN,AR,30333437,1005,100,,Invoice,,,,,,29/11/2018,29/11/2018,0.00,,81.15,,"-1,186,124.12"
,IN,AR,30333438,1005,100,,Invoice,,,,,,29/11/2018,29/11/2018,0.00,,21.86,,"-1,186,145.98"
,IN,AR,30333439,1005,100,,Invoice,,,,,,29/11/2018,29/11/2018,0.00,,103.56,,"-1,186,249.54"
,IN,AR,30333440,1005,100,,Invoice,,,,,,29/11/2018,29/11/2018,0.00,,3.19,,"-1,186,252.73"
,IN,AR,30333441,1005,100,,Invoice,,,,,,29/11/2018,29/11/2018,0.00,,11.15,,"-1,186,263.88"
,IN,AR,30333442,1005,100,,Invoice,,,,,,29/11/2018,29/11/2018,0.00,,14.34,,"-1,186,278.22"
,IN,AR,30333443,1005,100,,Invoice,,,,,,29/11/2018,29/11/2018,0.00,,12.75,,"-1,186,290.97"
,IN,AR,30333444,1005,100,,Invoice,,,,,,29/11/2018,29/11/2018,0.00,,4.78,,"-1,186,295.75"
,IN,AR,30333445,1005,100,,Invoice,,,,,,29/11/2018,29/11/2018,0.00,,15.93,,"-1,186,311.68"
,IN,AR,30333471,1005,100,,Invoice,,,,,,29/11/2018,29/11/2018,0.00,,18.31,,"-1,186,329.99"
,IN,AR,30333478,1005,100,,Invoice,,,,,,29/11/2018,29/11/2018,0.00,,18.20,,"-1,186,348.19"
,IN,AR,30333483,1005,100,,Invoice,,,,,,29/11/2018,29/11/2018,0.00,,9.10,,"-1,186,357.29"
,IN,AR,30333484,1005,100,,Invoice,,,,,,29/11/2018,29/11/2018,0.00,,12.25,,"-1,186,369.54"
,IN,AR,30333491,1005,100,,Invoice,,,,,,29/11/2018,29/11/2018,0.00,,15.18,,"-1,186,384.72"
,IN,AR,30333492,1005,100,,Invoice,,,,,,29/11/2018,29/11/2018,0.00,,2.08,,"-1,186,386.80"
,IN,AR,30333493,1005,100,,Invoice,,,,,,29/11/2018,29/11/2018,0.00,,2.08,,"-1,186,388.88"
,IN,AR,30333494,1005,100,,Invoice,,,,,,29/11/2018,29/11/2018,0.00,,16.61,,"-1,186,405.49"
,IN,AR,30333495,1005,100,,Invoice,,,,,,29/11/2018,29/11/2018,0.00,,7.29,,"-1,186,412.78"
,IN,AR,30333496,1005,100,,Invoice,,,,,,29/11/2018,29/11/2018,0.00,,5.08,,"-1,186,417.86"
,IN,AR,30333503,1005,100,,Invoice,,,,,,29/11/2018,29/11/2018,0.00,,2.10,,"-1,186,419.96"
,IN,AR,30333504,1005,100,,Invoice,,,,,,29/11/2018,29/11/2018,0.00,,7.29,,"-1,186,427.25"
,IN,AR,30333505,1005,100,,Invoice,,,,,,29/11/2018,29/11/2018,0.00,,91.02,,"-1,186,518.27"
,IN,AR,30333506,1005,100,,Invoice,,,,,,29/11/2018,29/11/2018,0.00,,7.29,,"-1,186,525.56"
,IN,AR,30333507,1005,100,,Invoice,,,,,,29/11/2018,29/11/2018,0.00,,5.26,,"-1,186,530.82"
,IN,AR,30333510,1005,100,,Invoice,,,,,,29/11/2018,29/11/2018,0.00,,6.08,,"-1,186,536.90"
,IN,AR,30333511,1005,100,,Invoice,,,,,,29/11/2018,29/11/2018,0.00,,14.44,,"-1,186,551.34"
,IN,AR,30333512,1005,100,,Invoice,,,,,,29/11/2018,29/11/2018,0.00,,7.29,,"-1,186,558.63"
,IN,AR,30333513,1005,100,,Invoice,,,,,,29/11/2018,29/11/2018,0.00,,7.29,,"-1,186,565.92"
,CN,AR,31019605,1005,100,,Credit Note,,,,,,30/11/2018,30/11/2018,3.98,,0.00,,"-1,186,561.94"
,CS,AR,32011029,1005,100,,Cash sale,,,,,,30/11/2018,30/11/2018,0.00,,5.61,,"-1,186,567.55"
,CS,AR,32011038,1005,100,,Cash sale,,,,,,30/11/2018,30/11/2018,0.00,,14.24,,"-1,186,581.79"
,CS,AR,32011043,1005,100,,Cash sale,,,,,,30/11/2018,30/11/2018,0.00,,6.08,,"-1,186,587.87"
,CS,AR,32011047,1005,100,,Cash sale,,,,,,30/11/2018,30/11/2018,0.00,,3.64,,"-1,186,591.51"
,CS,AR,32011067,1005,100,,Cash sale,,,,,,30/11/2018,30/11/2018,0.00,,3.64,,"-1,186,595.15"
,CS,AR,32011084,1005,100,,Cash sale,,,,,,30/11/2018,30/11/2018,0.00,,9.66,,"-1,186,604.81"
,CS,AR,32011107,1005,100,,Cash sale,,,,,,30/11/2018,30/11/2018,0.00,,12.46,,"-1,186,617.27"
,CS,AR,32011122,1005,100,,Cash sale,,,,,,30/11/2018,30/11/2018,0.00,,7.78,,"-1,186,625.05"
,CS,AR,32011130,1005,100,,Cash sale,,,,,,30/11/2018,30/11/2018,0.00,,14.58,,"-1,186,639.63"
,CS,AR,32011135,1005,100,,Cash sale,,,,,,30/11/2018,30/11/2018,0.00,,25.25,,"-1,186,664.88"
,CS,AR,32011192,1005,100,,Cash sale,,,,,,30/11/2018,30/11/2018,0.00,,12.71,,"-1,186,677.59"
,CS,AR,32011212,1005,100,,Cash sale,,,,,,30/11/2018,30/11/2018,0.00,,49.46,,"-1,186,727.05"
,CS,AR,32011248,1005,100,,Cash sale,,,,,,30/11/2018,30/11/2018,0.00,,5.08,,"-1,186,732.13"
,CS,AR,32011255,1005,100,,Cash sale,,,,,,30/11/2018,30/11/2018,0.00,,23.39,,"-1,186,755.52"
,CS,AR,32011269,1005,100,,Cash sale,,,,,,30/11/2018,30/11/2018,0.00,,21.06,,"-1,186,776.58"
,CS,AR,32011281,1005,100,,Cash sale,,,,,,30/11/2018,30/11/2018,0.00,,10.93,,"-1,186,787.51"
,CS,AR,32011303,1005,100,,Cash sale,,,,,,30/11/2018,30/11/2018,0.00,,14.58,,"-1,186,802.09"
,CS,AR,32011324,1005,100,,Cash sale,,,,,,30/11/2018,30/11/2018,0.00,,14.58,,"-1,186,816.67"
,CS,AR,32011361,1005,100,,Cash sale,,,,,,30/11/2018,30/11/2018,0.00,,11.70,,"-1,186,828.37"
,CS,AR,32011366,1005,100,,Cash sale,,,,,,30/11/2018,30/11/2018,0.00,,10.93,,"-1,186,839.30"
,CS,AR,32011381,1005,100,,Cash sale,,,,,,30/11/2018,30/11/2018,0.00,,5.17,,"-1,186,844.47"
,CS,AR,32011382,1005,100,,Cash sale,,,,,,30/11/2018,30/11/2018,0.00,,14.58,,"-1,186,859.05"
,CS,AR,32011387,1005,100,,Cash sale,,,,,,30/11/2018,30/11/2018,0.00,,8.34,,"-1,186,867.39"
,CS,AR,32011397,1005,100,,Cash sale,,,,,,30/11/2018,30/11/2018,0.00,,3.64,,"-1,186,871.03"
,CS,AR,32011402,1005,100,,Cash sale,,,,,,30/11/2018,30/11/2018,0.00,,7.29,,"-1,186,878.32"
,CS,AR,32011420,1005,100,,Cash sale,,,,,,30/11/2018,30/11/2018,0.00,,9.03,,"-1,186,887.35"
,CS,AR,32011431,1005,100,,Cash sale,,,,,,30/11/2018,30/11/2018,0.00,,3.64,,"-1,186,890.99"
,CS,AR,32011473,1005,100,,Cash sale,,,,,,30/11/2018,30/11/2018,0.00,,6.86,,"-1,186,897.85"
,CS,AR,32011493,1005,100,,Cash sale,,,,,,30/11/2018,30/11/2018,0.00,,14.58,,"-1,186,912.43"
,CS,AR,32011514,1005,100,,Cash sale,,,,,,30/11/2018,30/11/2018,0.00,,10.93,,"-1,186,923.36"
,CS,AR,32011516,1005,100,,Cash sale,,,,,,30/11/2018,30/11/2018,0.00,,5.08,,"-1,186,928.44"
,CS,AR,32011521,1005,100,,Cash sale,,,,,,30/11/2018,30/11/2018,0.00,,6.07,,"-1,186,934.51"
,CS,AR,32011524,1005,100,,Cash sale,,,,,,30/11/2018,30/11/2018,0.00,,12.20,,"-1,186,946.71"
,CS,AR,32011539,1005,100,,Cash sale,,,,,,30/11/2018,30/11/2018,0.00,,6.08,,"-1,186,952.79"
,CS,AR,32011544,1005,100,,Cash sale,,,,,,30/11/2018,30/11/2018,0.00,,14.58,,"-1,186,967.37"
,CS,AR,32011561,1005,100,,Cash sale,,,,,,30/11/2018,30/11/2018,0.00,,3.64,,"-1,186,971.01"
,CS,AR,32011577,1005,100,,Cash sale,,,,,,30/11/2018,30/11/2018,0.00,,3.64,,"-1,186,974.65"
,CS,AR,32011578,1005,100,,Cash sale,,,,,,30/11/2018,30/11/2018,0.00,,3.98,,"-1,186,978.63"
,CS,AR,32011589,1005,100,,Cash sale,,,,,,30/11/2018,30/11/2018,0.00,,7.29,,"-1,186,985.92"
,CS,AR,32011663,1005,100,,Cash sale,,,,,,30/11/2018,30/11/2018,0.00,,2.97,,"-1,186,988.89"
,IN,AR,30331729,1005,100,,Invoice,,,,,,30/11/2018,30/11/2018,0.00,,35.59,,"-1,187,024.48"
,IN,AR,30331741,1005,100,,Invoice,,,,,,30/11/2018,30/11/2018,0.00,,14.83,,"-1,187,039.31"
,IN,AR,30331742,1005,100,,Invoice,,,,,,30/11/2018,30/11/2018,0.00,,8.90,,"-1,187,048.21"
,IN,AR,30331746,1005,100,,Invoice,,,,,,30/11/2018,30/11/2018,0.00,,18.22,,"-1,187,066.43"
,IN,AR,30331754,1005,100,,Invoice,,,,,,30/11/2018,30/11/2018,0.00,,13.98,,"-1,187,080.41"
,IN,AR,30331787,1005,100,,Invoice,,,,,,30/11/2018,30/11/2018,0.00,,10.93,,"-1,187,091.34"
,IN,AR,30331815,1005,100,,Invoice,,,,,,30/11/2018,30/11/2018,0.00,,7.25,,"-1,187,098.59"
,IN,AR,30331830,1005,100,,Invoice,,,,,,30/11/2018,30/11/2018,0.00,,48.61,,"-1,187,147.20"
,IN,AR,30331840,1005,100,,Invoice,,,,,,30/11/2018,30/11/2018,0.00,,11.48,,"-1,187,158.68"
,IN,AR,30331844,1005,100,,Invoice,,,,,,30/11/2018,30/11/2018,0.00,,77.63,,"-1,187,236.31"
,IN,AR,30331869,1005,100,,Invoice,,,,,,30/11/2018,30/11/2018,0.00,,28.00,,"-1,187,264.31"
,IN,AR,30331915,1005,100,,Invoice,,,,,,30/11/2018,30/11/2018,0.00,,10.93,,"-1,187,275.24"
,IN,AR,30331939,1005,100,,Invoice,,,,,,30/11/2018,30/11/2018,0.00,,4.75,,"-1,187,279.99"
,IN,AR,30331944,1005,100,,Invoice,,,,,,30/11/2018,30/11/2018,0.00,,14.00,,"-1,187,293.99"
,IN,AR,30331973,1005,100,,Invoice,,,,,,30/11/2018,30/11/2018,0.00,,11.64,,"-1,187,305.63"
,IN,AR,30331974,1005,100,,Invoice,,,,,,30/11/2018,30/11/2018,0.00,,5.82,,"-1,187,311.45"
,IN,AR,30331982,1005,100,,Invoice,,,,,,30/11/2018,30/11/2018,0.00,,40.00,,"-1,187,351.45"
,IN,AR,30331985,1005,100,,Invoice,,,,,,30/11/2018,30/11/2018,0.00,,3.64,,"-1,187,355.09"
,IN,AR,30331995,1005,100,,Invoice,,,,,,30/11/2018,30/11/2018,0.00,,29.15,,"-1,187,384.24"
,IN,AR,30331999,1005,100,,Invoice,,,,,,30/11/2018,30/11/2018,0.00,,27.97,,"-1,187,412.21"
,IN,AR,30332022,1005,100,,Invoice,,,,,,30/11/2018,30/11/2018,0.00,,9.56,,"-1,187,421.77"
,IN,AR,30332051,1005,100,,Invoice,,,,,,30/11/2018,30/11/2018,0.00,,7.19,,"-1,187,428.96"
,IN,AR,30332083,1005,100,,Invoice,,,,,,30/11/2018,30/11/2018,0.00,,18.05,,"-1,187,447.01"
,IN,AR,30332095,1005,100,,Invoice,,,,,,30/11/2018,30/11/2018,0.00,,29.15,,"-1,187,476.16"
,IN,AR,30332100,1005,100,,Invoice,,,,,,30/11/2018,30/11/2018,0.00,,12.92,,"-1,187,489.08"
,IN,AR,30332103,1005,100,,Invoice,,,,,,30/11/2018,30/11/2018,0.00,,7.17,,"-1,187,496.25"
,IN,AR,30332104,1005,100,,Invoice,,,,,,30/11/2018,30/11/2018,0.00,,5.17,,"-1,187,501.42"
,IN,AR,30332132,1005,100,,Invoice,,,,,,30/11/2018,30/11/2018,0.00,,6.02,,"-1,187,507.44"
,IN,AR,30332147,1005,100,,Invoice,,,,,,30/11/2018,30/11/2018,0.00,,49.22,,"-1,187,556.66"
,IN,AR,30332148,1005,100,,Invoice,,,,,,30/11/2018,30/11/2018,0.00,,28.05,,"-1,187,584.71"
,IN,AR,30332166,1005,100,,Invoice,,,,,,30/11/2018,30/11/2018,0.00,,2.58,,"-1,187,587.29"
,IN,AR,30332180,1005,100,,Invoice,,,,,,30/11/2018,30/11/2018,0.00,,9.03,,"-1,187,596.32"
,IN,AR,30332181,1005,100,,Invoice,,,,,,30/11/2018,30/11/2018,0.00,,3.01,,"-1,187,599.33"
,IN,AR,30332230,1005,100,,Invoice,,,,,,30/11/2018,30/11/2018,0.00,,5.08,,"-1,187,604.41"
,IN,AR,30332249,1005,100,,Invoice,,,,,,30/11/2018,30/11/2018,0.00,,228.88,,"-1,187,833.29"
,IN,AR,30332250,1005,100,,Invoice,,,,,,30/11/2018,30/11/2018,0.00,,10.73,,"-1,187,844.02"
,IN,AR,30332251,1005,100,,Invoice,,,,,,30/11/2018,30/11/2018,0.00,,23.25,,"-1,187,867.27"
,IN,AR,30332252,1005,100,,Invoice,,,,,,30/11/2018,30/11/2018,0.00,,14.31,,"-1,187,881.58"
,IN,AR,30332253,1005,100,,Invoice,,,,,,30/11/2018,30/11/2018,0.00,,35.76,,"-1,187,917.34"
,IN,AR,30332254,1005,100,,Invoice,,,,,,30/11/2018,30/11/2018,0.00,,62.58,,"-1,187,979.92"
,IN,AR,30332255,1005,100,,Invoice,,,,,,30/11/2018,30/11/2018,0.00,,32.19,,"-1,188,012.11"
,IN,AR,30332259,1005,100,,Invoice,,,,,,30/11/2018,30/11/2018,0.00,,20.34,,"-1,188,032.45"
,IN,AR,30332262,1005,100,,Invoice,,,,,,30/11/2018,30/11/2018,0.00,,15.25,,"-1,188,047.70"
,IN,AR,30332265,1005,100,,Invoice,,,,,,30/11/2018,30/11/2018,0.00,,4.24,,"-1,188,051.94"
,IN,AR,30332379,1005,100,,Invoice,,,,,,30/11/2018,30/11/2018,0.00,,4.24,,"-1,188,056.18"
,IN,AR,30332405,1005,100,,Invoice,,,,,,30/11/2018,30/11/2018,0.00,,10.93,,"-1,188,067.11"
,IN,AR,30332443,1005,100,,Invoice,,,,,,30/11/2018,30/11/2018,0.00,,7.29,,"-1,188,074.40"
,IN,AR,30332467,1005,100,,Invoice,,,,,,30/11/2018,30/11/2018,0.00,,6.53,,"-1,188,080.93"
,IN,AR,30332484,1005,100,,Invoice,,,,,,30/11/2018,30/11/2018,0.00,,32.16,,"-1,188,113.09"
,IN,AR,30332499,1005,100,,Invoice,,,,,,30/11/2018,30/11/2018,0.00,,8.81,,"-1,188,121.90"
,IN,AR,30332508,1005,100,,Invoice,,,,,,30/11/2018,30/11/2018,0.00,,2.42,,"-1,188,124.32"
,IN,AR,30332607,1005,100,,Invoice,,,,,,30/11/2018,30/11/2018,0.00,,38.00,,"-1,188,162.32"
,IN,AR,30332610,1005,100,,Invoice,,,,,,30/11/2018,30/11/2018,0.00,,28.00,,"-1,188,190.32"
,IN,AR,30332613,1005,100,,Invoice,,,,,,30/11/2018,30/11/2018,0.00,,20.95,,"-1,188,211.27"
,IN,AR,30332617,1005,100,,Invoice,,,,,,30/11/2018,30/11/2018,0.00,,8.90,,"-1,188,220.17"
,IN,AR,30332637,1005,100,,Invoice,,,,,,30/11/2018,30/11/2018,0.00,,28.09,,"-1,188,248.26"
,IN,AR,30332643,1005,100,,Invoice,,,,,,30/11/2018,30/11/2018,0.00,,28.03,,"-1,188,276.29"
,IN,AR,30332646,1005,100,,Invoice,,,,,,30/11/2018,30/11/2018,0.00,,10.93,,"-1,188,287.22"
,IN,AR,30332652,1005,100,,Invoice,,,,,,30/11/2018,30/11/2018,0.00,,28.90,,"-1,188,316.12"
,IN,AR,30332672,1005,100,,Invoice,,,,,,30/11/2018,30/11/2018,0.00,,21.52,,"-1,188,337.64"
,IN,AR,30332693,1005,100,,Invoice,,,,,,30/11/2018,30/11/2018,0.00,,5.08,,"-1,188,342.72"
,IN,AR,30332701,1005,100,,Invoice,,,,,,30/11/2018,30/11/2018,0.00,,10.00,,"-1,188,352.72"
,IN,AR,30332734,1005,100,,Invoice,,,,,,30/11/2018,30/11/2018,0.00,,19.16,,"-1,188,371.88"
,IN,AR,30332746,1005,100,,Invoice,,,,,,30/11/2018,30/11/2018,0.00,,14.72,,"-1,188,386.60"
,IN,AR,30332747,1005,100,,Invoice,,,,,,30/11/2018,30/11/2018,0.00,,21.03,,"-1,188,407.63"
,IN,AR,30332778,1005,100,,Invoice,,,,,,30/11/2018,30/11/2018,0.00,,6.89,,"-1,188,414.52"
,IN,AR,30332800,1005,100,,Invoice,,,,,,30/11/2018,30/11/2018,0.00,,4.15,,"-1,188,418.67"
,IN,AR,30332828,1005,100,,Invoice,,,,,,30/11/2018,30/11/2018,0.00,,10.93,,"-1,188,429.60"
,IN,AR,30332865,1005,100,,Invoice,,,,,,30/11/2018,30/11/2018,0.00,,33.14,,"-1,188,462.74"
,IN,AR,30332866,1005,100,,Invoice,,,,,,30/11/2018,30/11/2018,0.00,,15.59,,"-1,188,478.33"
,IN,AR,30332867,1005,100,,Invoice,,,,,,30/11/2018,30/11/2018,0.00,,728.98,,"-1,189,207.31"
,IN,AR,30332868,1005,100,,Invoice,,,,,,30/11/2018,30/11/2018,0.00,,27.29,,"-1,189,234.60"
,IN,AR,30332911,1005,100,,Invoice,,,,,,30/11/2018,30/11/2018,0.00,,"3,133.90",,"-1,192,368.50"
,IN,AR,30332916,1005,100,,Invoice,,,,,,30/11/2018,30/11/2018,0.00,,12.00,,"-1,192,380.50"
,IN,AR,30332958,1005,100,,Invoice,,,,,,30/11/2018,30/11/2018,0.00,,16.42,,"-1,192,396.92"
,IN,AR,30332962,1005,100,,Invoice,,,,,,30/11/2018,30/11/2018,0.00,,44.49,,"-1,192,441.41"
,IN,AR,30332975,1005,100,,Invoice,,,,,,30/11/2018,30/11/2018,0.00,,7.29,,"-1,192,448.70"
,IN,AR,30332991,1005,100,,Invoice,,,,,,30/11/2018,30/11/2018,0.00,,10.21,,"-1,192,458.91"
,IN,AR,30333002,1005,100,,Invoice,,,,,,30/11/2018,30/11/2018,0.00,,10.93,,"-1,192,469.84"
,IN,AR,30333014,1005,100,,Invoice,,,,,,30/11/2018,30/11/2018,0.00,,7.97,,"-1,192,477.81"
,IN,AR,30333075,1005,100,,Invoice,,,,,,30/11/2018,30/11/2018,0.00,,8.31,,"-1,192,486.12"
,IN,AR,30333098,1005,100,,Invoice,,,,,,30/11/2018,30/11/2018,0.00,,9.31,,"-1,192,495.43"
,IN,AR,30333101,1005,100,,Invoice,,,,,,30/11/2018,30/11/2018,0.00,,10.93,,"-1,192,506.36"
,IN,AR,30333185,1005,100,,Invoice,,,,,,30/11/2018,30/11/2018,0.00,,3.59,,"-1,192,509.95"
,IN,AR,30333205,1005,100,,Invoice,,,,,,30/11/2018,30/11/2018,0.00,,10.93,,"-1,192,520.88"
,CN,AR,31019629,1005,100,,Credit Note,,,,,,30/11/2018,30/11/2018,3.64,,0.00,,"-1,192,517.24"
,CS,AR,32011689,1005,100,,Cash sale,,,,,,30/11/2018,30/11/2018,0.00,,7.29,,"-1,192,524.53"
,CS,AR,32011691,1005,100,,Cash sale,,,,,,30/11/2018,30/11/2018,0.00,,31.05,,"-1,192,555.58"
,CS,AR,32011701,1005,100,,Cash sale,,,,,,30/11/2018,30/11/2018,0.00,,3.64,,"-1,192,559.22"
,CS,AR,32011706,1005,100,,Cash sale,,,,,,30/11/2018,30/11/2018,0.00,,3.64,,"-1,192,562.86"
,CS,AR,32011708,1005,100,,Cash sale,,,,,,30/11/2018,30/11/2018,0.00,,3.64,,"-1,192,566.50"
,CS,AR,32011730,1005,100,,Cash sale,,,,,,30/11/2018,30/11/2018,0.00,,7.29,,"-1,192,573.79"
,CS,AR,32011732,1005,100,,Cash sale,,,,,,30/11/2018,30/11/2018,0.00,,9.10,,"-1,192,582.89"
,CS,AR,32011734,1005,100,,Cash sale,,,,,,30/11/2018,30/11/2018,0.00,,14.58,,"-1,192,597.47"
,CS,AR,32011736,1005,100,,Cash sale,,,,,,30/11/2018,30/11/2018,0.00,,5.94,,"-1,192,603.41"
,IN,AR,30333246,1005,100,,Invoice,,,,,,30/11/2018,30/11/2018,0.00,,"1,704.43",,"-1,194,307.84"
,IN,AR,30333252,1005,100,,Invoice,,,,,,30/11/2018,30/11/2018,0.00,,"1,638.35",,"-1,195,946.19"
,IN,AR,30333258,1005,100,,Invoice,,,,,,30/11/2018,30/11/2018,0.00,,26.00,,"-1,195,972.19"
,IN,AR,30333260,1005,100,,Invoice,,,,,,30/11/2018,30/11/2018,0.00,,60.59,,"-1,196,032.78"
,IN,AR,30333267,1005,100,,Invoice,,,,,,30/11/2018,30/11/2018,0.00,,78.22,,"-1,196,111.00"
,IN,AR,30333273,1005,100,,Invoice,,,,,,30/11/2018,30/11/2018,0.00,,"1,087.63",,"-1,197,198.63"
,IN,AR,30333274,1005,100,,Invoice,,,,,,30/11/2018,30/11/2018,0.00,,28.07,,"-1,197,226.70"
,IN,AR,30333275,1005,100,,Invoice,,,,,,30/11/2018,30/11/2018,0.00,,31.58,,"-1,197,258.28"
,IN,AR,30333276,1005,100,,Invoice,,,,,,30/11/2018,30/11/2018,0.00,,17.54,,"-1,197,275.82"
,IN,AR,30333277,1005,100,,Invoice,,,,,,30/11/2018,30/11/2018,0.00,,401.72,,"-1,197,677.54"
,IN,AR,30333279,1005,100,,Invoice,,,,,,30/11/2018,30/11/2018,0.00,,199.15,,"-1,197,876.69"
,IN,AR,30333287,1005,100,,Invoice,,,,,,30/11/2018,30/11/2018,0.00,,"1,880.27",,"-1,199,756.96"
,IN,AR,30333288,1005,100,,Invoice,,,,,,30/11/2018,30/11/2018,0.00,,33.60,,"-1,199,790.56"
,IN,AR,30333294,1005,100,,Invoice,,,,,,30/11/2018,30/11/2018,0.00,,7.29,,"-1,199,797.85"
,IN,AR,30333295,1005,100,,Invoice,,,,,,30/11/2018,30/11/2018,0.00,,107.01,,"-1,199,904.86"
,IN,AR,30333296,1005,100,,Invoice,,,,,,30/11/2018,30/11/2018,0.00,,150.86,,"-1,200,055.72"
,IN,AR,30333297,1005,100,,Invoice,,,,,,30/11/2018,30/11/2018,0.00,,35.75,,"-1,200,091.47"
,IN,AR,30333298,1005,100,,Invoice,,,,,,30/11/2018,30/11/2018,0.00,,38.59,,"-1,200,130.06"
,IN,AR,30333299,1005,100,,Invoice,,,,,,30/11/2018,30/11/2018,0.00,,164.90,,"-1,200,294.96"
,IN,AR,30333300,1005,100,,Invoice,,,,,,30/11/2018,30/11/2018,0.00,,49.12,,"-1,200,344.08"
,IN,AR,30333301,1005,100,,Invoice,,,,,,30/11/2018,30/11/2018,0.00,,3.76,,"-1,200,347.84"
,IN,AR,30333302,1005,100,,Invoice,,,,,,30/11/2018,30/11/2018,0.00,,30.10,,"-1,200,377.94"
,IN,AR,30333303,1005,100,,Invoice,,,,,,30/11/2018,30/11/2018,0.00,,48.92,,"-1,200,426.86"
,IN,AR,30333304,1005,100,,Invoice,,,,,,30/11/2018,30/11/2018,0.00,,30.10,,"-1,200,456.96"
,IN,AR,30333305,1005,100,,Invoice,,,,,,30/11/2018,30/11/2018,0.00,,28.22,,"-1,200,485.18"
,IN,AR,30333306,1005,100,,Invoice,,,,,,30/11/2018,30/11/2018,0.00,,15.05,,"-1,200,500.23"
,IN,AR,30333307,1005,100,,Invoice,,,,,,30/11/2018,30/11/2018,0.00,,7.53,,"-1,200,507.76"
,IN,AR,30333308,1005,100,,Invoice,,,,,,30/11/2018,30/11/2018,0.00,,52.68,,"-1,200,560.44"
,IN,AR,30333309,1005,100,,Invoice,,,,,,30/11/2018,30/11/2018,0.00,,15.05,,"-1,200,575.49"
,IN,AR,30333310,1005,100,,Invoice,,,,,,30/11/2018,30/11/2018,0.00,,284.19,,"-1,200,859.68"
,IN,AR,30333311,1005,100,,Invoice,,,,,,30/11/2018,30/11/2018,0.00,,75.43,,"-1,200,935.11"
,IN,AR,30333312,1005,100,,Invoice,,,,,,30/11/2018,30/11/2018,0.00,,35.08,,"-1,200,970.19"
,IN,AR,30333313,1005,100,,Invoice,,,,,,30/11/2018,30/11/2018,0.00,,20.69,,"-1,200,990.88"
,IN,AR,30333314,1005,100,,Invoice,,,,,,30/11/2018,30/11/2018,0.00,,38.59,,"-1,201,029.47"
,IN,AR,30333315,1005,100,,Invoice,,,,,,30/11/2018,30/11/2018,0.00,,28.07,,"-1,201,057.54"
,IN,AR,30333316,1005,100,,Invoice,,,,,,30/11/2018,30/11/2018,0.00,,21.05,,"-1,201,078.59"
,IN,AR,30333317,1005,100,,Invoice,,,,,,30/11/2018,30/11/2018,0.00,,12.28,,"-1,201,090.87"
,IN,AR,30333318,1005,100,,Invoice,,,,,,30/11/2018,30/11/2018,0.00,,15.79,,"-1,201,106.66"
,IN,AR,30333319,1005,100,,Invoice,,,,,,30/11/2018,30/11/2018,0.00,,5.26,,"-1,201,111.92"
,IN,AR,30333321,1005,100,,Invoice,,,,,,30/11/2018,30/11/2018,0.00,,5.08,,"-1,201,117.00"
,IN,AR,30333322,1005,100,,Invoice,,,,,,30/11/2018,30/11/2018,0.00,,7.63,,"-1,201,124.63"
,IN,AR,30333323,1005,100,,Invoice,,,,,,30/11/2018,30/11/2018,0.00,,17.54,,"-1,201,142.17"
,IN,AR,30333325,1005,100,,Invoice,,,,,,30/11/2018,30/11/2018,0.00,,435.05,,"-1,201,577.22"
,IN,AR,30333329,1005,100,,Invoice,,,,,,30/11/2018,30/11/2018,0.00,,128.75,,"-1,201,705.97"
,IN,AR,30333330,1005,100,,Invoice,,,,,,30/11/2018,30/11/2018,0.00,,128.75,,"-1,201,834.72"
,IN,AR,30333331,1005,100,,Invoice,,,,,,30/11/2018,30/11/2018,0.00,,25.03,,"-1,201,859.75"
,IN,AR,30333332,1005,100,,Invoice,,,,,,30/11/2018,30/11/2018,0.00,,73.31,,"-1,201,933.06"
,IN,AR,30333333,1005,100,,Invoice,,,,,,30/11/2018,30/11/2018,0.00,,35.76,,"-1,201,968.82"
,IN,AR,30333334,1005,100,,Invoice,,,,,,30/11/2018,30/11/2018,0.00,,55.43,,"-1,202,024.25"
,IN,AR,30333335,1005,100,,Invoice,,,,,,30/11/2018,30/11/2018,0.00,,32.19,,"-1,202,056.44"
,IN,AR,30333336,1005,100,,Invoice,,,,,,30/11/2018,30/11/2018,0.00,,41.13,,"-1,202,097.57"
,IN,AR,30333337,1005,100,,Invoice,,,,,,30/11/2018,30/11/2018,0.00,,78.68,,"-1,202,176.25"
,IN,AR,30333339,1005,100,,Invoice,,,,,,30/11/2018,30/11/2018,0.00,,8.94,,"-1,202,185.19"
,IN,AR,30333340,1005,100,,Invoice,,,,,,30/11/2018,30/11/2018,0.00,,41.13,,"-1,202,226.32"
,IN,AR,30333341,1005,100,,Invoice,,,,,,30/11/2018,30/11/2018,0.00,,28.61,,"-1,202,254.93"
,IN,AR,30333342,1005,100,,Invoice,,,,,,30/11/2018,30/11/2018,0.00,,10.73,,"-1,202,265.66"
,IN,AR,30333343,1005,100,,Invoice,,,,,,30/11/2018,30/11/2018,0.00,,14.31,,"-1,202,279.97"
,IN,AR,30333344,1005,100,,Invoice,,,,,,30/11/2018,30/11/2018,0.00,,28.61,,"-1,202,308.58"
,IN,AR,30333345,1005,100,,Invoice,,,,,,30/11/2018,30/11/2018,0.00,,14.31,,"-1,202,322.89"
,IN,AR,30333346,1005,100,,Invoice,,,,,,30/11/2018,30/11/2018,0.00,,3.58,,"-1,202,326.47"
,IN,AR,30333347,1005,100,,Invoice,,,,,,30/11/2018,30/11/2018,0.00,,152.62,,"-1,202,479.09"
,IN,AR,30333348,1005,100,,Invoice,,,,,,30/11/2018,30/11/2018,0.00,,140.92,,"-1,202,620.01"
,IN,AR,30333349,1005,100,,Invoice,,,,,,30/11/2018,30/11/2018,0.00,,102.12,,"-1,202,722.13"
,IN,AR,30333350,1005,100,,Invoice,,,,,,30/11/2018,30/11/2018,0.00,,4.08,,"-1,202,726.21"
,IN,AR,30333351,1005,100,,Invoice,,,,,,30/11/2018,30/11/2018,0.00,,220.58,,"-1,202,946.79"
,IN,AR,30333352,1005,100,,Invoice,,,,,,30/11/2018,30/11/2018,0.00,,30.64,,"-1,202,977.43"
,IN,AR,30333353,1005,100,,Invoice,,,,,,30/11/2018,30/11/2018,0.00,,173.60,,"-1,203,151.03"
,IN,AR,30333355,1005,100,,Invoice,,,,,,30/11/2018,30/11/2018,0.00,,7.29,,"-1,203,158.32"
,IN,AR,30333357,1001,100,,Invoice,,,,,,30/11/2018,30/11/2018,0.00,,268.86,,"-1,203,427.18"
,IN,AR,30333361,1005,100,,Invoice,,,,,,30/11/2018,30/11/2018,0.00,,66.10,,"-1,203,493.28"
,IN,AR,30333363,1005,100,,Invoice,,,,,,30/11/2018,30/11/2018,0.00,,11.22,,"-1,203,504.50"
,IN,AR,30333366,1005,100,,Invoice,,,,,,30/11/2018,30/11/2018,0.00,,"1,130.38",,"-1,204,634.88"
,IN,AR,30333367,1005,100,,Invoice,,,,,,30/11/2018,30/11/2018,0.00,,75.51,,"-1,204,710.39"
,IN,AR,30333368,1005,100,,Invoice,,,,,,30/11/2018,30/11/2018,0.00,,36.84,,"-1,204,747.23"
,IN,AR,30333375,1005,100,,Invoice,,,,,,30/11/2018,30/11/2018,0.00,,85.36,,"-1,204,832.59"
,IN,AR,30333381,1005,100,,Invoice,,,,,,30/11/2018,30/11/2018,0.00,,83.05,,"-1,204,915.64"
,IN,AR,30333387,1005,100,,Invoice,,,,,,30/11/2018,30/11/2018,0.00,,524.30,,"-1,205,439.94"
,IN,AR,30333388,1005,100,,Invoice,,,,,,30/11/2018,30/11/2018,0.00,,124.00,,"-1,205,563.94"
,IN,AR,30333392,1005,100,,Invoice,,,,,,30/11/2018,30/11/2018,0.00,,18.64,,"-1,205,582.58"
,IN,AR,30333393,1005,100,,Invoice,,,,,,30/11/2018,30/11/2018,0.00,,58.26,,"-1,205,640.84"
,IN,AR,30333394,1005,100,,Invoice,,,,,,30/11/2018,30/11/2018,0.00,,16.31,,"-1,205,657.15"
,IN,AR,30333395,1005,100,,Invoice,,,,,,30/11/2018,30/11/2018,0.00,,48.94,,"-1,205,706.09"
,IN,AR,30333396,1005,100,,Invoice,,,,,,30/11/2018,30/11/2018,0.00,,46.61,,"-1,205,752.70"
,IN,AR,30333397,1005,100,,Invoice,,,,,,30/11/2018,30/11/2018,0.00,,20.97,,"-1,205,773.67"
,IN,AR,30333398,1005,100,,Invoice,,,,,,30/11/2018,30/11/2018,0.00,,44.28,,"-1,205,817.95"
,IN,AR,30333399,1005,100,,Invoice,,,,,,30/11/2018,30/11/2018,0.00,,32.63,,"-1,205,850.58"
,IN,AR,30333400,1005,100,,Invoice,,,,,,30/11/2018,30/11/2018,0.00,,13.98,,"-1,205,864.56"
,IN,AR,30333401,1005,100,,Invoice,,,,,,30/11/2018,30/11/2018,0.00,,760.27,,"-1,206,624.83"
,IN,AR,30333403,1005,100,,Invoice,,,,,,30/11/2018,30/11/2018,0.00,,11.69,,"-1,206,636.52"
,IN,AR,30333411,1005,100,,Invoice,,,,,,30/11/2018,30/11/2018,0.00,,25.55,,"-1,206,662.07"
,IN,AR,30333413,1005,100,,Invoice,,,,,,30/11/2018,30/11/2018,0.00,,406.94,,"-1,207,069.01"
,IN,AR,30333416,1005,100,,Invoice,,,,,,30/11/2018,30/11/2018,0.00,,104.65,,"-1,207,173.66"
,IN,AR,30333417,1005,100,,Invoice,,,,,,30/11/2018,30/11/2018,0.00,,249.17,,"-1,207,422.83"
,IN,AR,30333428,1005,100,,Invoice,,,,,,30/11/2018,30/11/2018,0.00,,63.04,,"-1,207,485.87"
,IN,AR,30333432,1005,100,,Invoice,,,,,,30/11/2018,30/11/2018,0.00,,14.58,,"-1,207,500.45"
,IN,AR,30333446,1005,100,,Invoice,,,,,,30/11/2018,30/11/2018,0.00,,699.75,,"-1,208,200.20"
,IN,AR,30333447,1005,100,,Invoice,,,,,,30/11/2018,30/11/2018,0.00,,7.80,,"-1,208,208.00"
,IN,AR,30333448,1005,100,,Invoice,,,,,,30/11/2018,30/11/2018,0.00,,11.69,,"-1,208,219.69"
,IN,AR,30333449,1005,100,,Invoice,,,,,,30/11/2018,30/11/2018,0.00,,15.59,,"-1,208,235.28"
,IN,AR,30333450,1005,100,,Invoice,,,,,,30/11/2018,30/11/2018,0.00,,9.75,,"-1,208,245.03"
,IN,AR,30333451,1005,100,,Invoice,,,,,,30/11/2018,30/11/2018,0.00,,5.85,,"-1,208,250.88"
,IN,AR,30333452,1005,100,,Invoice,,,,,,30/11/2018,30/11/2018,0.00,,27.29,,"-1,208,278.17"
,IN,AR,30333453,1005,100,,Invoice,,,,,,30/11/2018,30/11/2018,0.00,,9.75,,"-1,208,287.92"
,IN,AR,30333454,1005,100,,Invoice,,,,,,30/11/2018,30/11/2018,0.00,,25.34,,"-1,208,313.26"
,IN,AR,30333455,1005,100,,Invoice,,,,,,30/11/2018,30/11/2018,0.00,,144.24,,"-1,208,457.50"
,IN,AR,30333456,1005,100,,Invoice,,,,,,30/11/2018,30/11/2018,0.00,,11.69,,"-1,208,469.19"
,IN,AR,30333457,1005,100,,Invoice,,,,,,30/11/2018,30/11/2018,0.00,,13.64,,"-1,208,482.83"
,IN,AR,30333458,1005,100,,Invoice,,,,,,30/11/2018,30/11/2018,0.00,,11.69,,"-1,208,494.52"
,IN,AR,30333459,1005,100,,Invoice,,,,,,30/11/2018,30/11/2018,0.00,,15.59,,"-1,208,510.11"
,IN,AR,30333460,1005,100,,Invoice,,,,,,30/11/2018,30/11/2018,0.00,,17.54,,"-1,208,527.65"
,IN,AR,30333461,1005,100,,Invoice,,,,,,30/11/2018,30/11/2018,0.00,,56.53,,"-1,208,584.18"
,IN,AR,30333462,1005,100,,Invoice,,,,,,30/11/2018,30/11/2018,0.00,,13.64,,"-1,208,597.82"
,IN,AR,30333463,1005,100,,Invoice,,,,,,30/11/2018,30/11/2018,0.00,,33.14,,"-1,208,630.96"
,IN,AR,30333464,1005,100,,Invoice,,,,,,30/11/2018,30/11/2018,0.00,,5.85,,"-1,208,636.81"
,IN,AR,30333465,1005,100,,Invoice,,,,,,30/11/2018,30/11/2018,0.00,,13.64,,"-1,208,650.45"
,IN,AR,30333466,1005,100,,Invoice,,,,,,30/11/2018,30/11/2018,0.00,,21.44,,"-1,208,671.89"
,IN,AR,30333467,1005,100,,Invoice,,,,,,30/11/2018,30/11/2018,0.00,,23.39,,"-1,208,695.28"
,IN,AR,30333468,1005,100,,Invoice,,,,,,30/11/2018,30/11/2018,0.00,,33.14,,"-1,208,728.42"
,IN,AR,30333469,1005,100,,Invoice,,,,,,30/11/2018,30/11/2018,0.00,,670.51,,"-1,209,398.93"
,IN,AR,30333470,1005,100,,Invoice,,,,,,30/11/2018,30/11/2018,0.00,,17.54,,"-1,209,416.47"
,IN,AR,30333472,1005,100,,Invoice,,,,,,30/11/2018,30/11/2018,0.00,,16.93,,"-1,209,433.40"
,IN,AR,30333473,1005,100,,Invoice,,,,,,30/11/2018,30/11/2018,0.00,,7.53,,"-1,209,440.93"
,IN,AR,30333474,1005,100,,Invoice,,,,,,30/11/2018,30/11/2018,0.00,,15.05,,"-1,209,455.98"
,IN,AR,30333475,1005,100,,Invoice,,,,,,30/11/2018,30/11/2018,0.00,,11.29,,"-1,209,467.27"
,IN,AR,30333476,1005,100,,Invoice,,,,,,30/11/2018,30/11/2018,0.00,,838.53,,"-1,210,305.80"
,IN,AR,30333480,1005,100,,Invoice,,,,,,30/11/2018,30/11/2018,0.00,,443.92,,"-1,210,749.72"
,IN,AR,30333481,1005,100,,Invoice,,,,,,30/11/2018,30/11/2018,0.00,,180.29,,"-1,210,930.01"
,IN,AR,30333482,1005,100,,Invoice,,,,,,30/11/2018,30/11/2018,0.00,,14.83,,"-1,210,944.84"
,IN,AR,30333485,1005,100,,Invoice,,,,,,30/11/2018,30/11/2018,0.00,,43.80,,"-1,210,988.64"
,IN,AR,30333486,1005,100,,Invoice,,,,,,30/11/2018,30/11/2018,0.00,,24.64,,"-1,211,013.28"
,IN,AR,30333487,1005,100,,Invoice,,,,,,30/11/2018,30/11/2018,0.00,,24.64,,"-1,211,037.92"
,IN,AR,30333488,1005,100,,Invoice,,,,,,30/11/2018,30/11/2018,0.00,,2.74,,"-1,211,040.66"
,IN,AR,30333489,1005,100,,Invoice,,,,,,30/11/2018,30/11/2018,0.00,,5.47,,"-1,211,046.13"
,IN,AR,30333501,1005,100,,Invoice,,,,,,30/11/2018,30/11/2018,0.00,,179.69,,"-1,211,225.82"
,IN,AR,30333502,1005,100,,Invoice,,,,,,30/11/2018,30/11/2018,0.00,,7.29,,"-1,211,233.11"
,CS,AR,32011882,1005,100,,Cash sale,,,,,,01/12/2018,01/12/2018,0.00,,7.29,,"-1,211,240.40"
,CS,AR,32012046,1005,100,,Cash sale,,,,,,01/12/2018,01/12/2018,0.00,,7.29,,"-1,211,247.69"
,CS,AR,32012158,1005,100,,Cash sale,,,,,,01/12/2018,01/12/2018,0.00,,14.58,,"-1,211,262.27"
,CS,AR,32012270,1005,100,,Cash sale,,,,,,01/12/2018,01/12/2018,0.00,,4.24,,"-1,211,266.51"
,CS,AR,32012345,1005,100,,Cash sale,,,,,,01/12/2018,01/12/2018,0.00,,14.58,,"-1,211,281.09"
,CS,AR,32012372,1005,100,,Cash sale,,,,,,01/12/2018,01/12/2018,0.00,,25.51,,"-1,211,306.60"
,IN,AR,30333653,1005,100,,Invoice,,,,,,01/12/2018,01/12/2018,0.00,,6.00,,"-1,211,312.60"
,IN,AR,30333919,1005,100,,Invoice,,,,,,01/12/2018,01/12/2018,0.00,,95.59,,"-1,211,408.19"
,IN,AR,30334361,1005,100,,Invoice,,,,,,01/12/2018,01/12/2018,0.00,,16.53,,"-1,211,424.72"
,IN,AR,30334498,1005,100,,Invoice,,,,,,01/12/2018,01/12/2018,0.00,,7.29,,"-1,211,432.01"
,IN,AR,30334970,1005,100,,Invoice,,,,,,01/12/2018,01/12/2018,0.00,,8.25,,"-1,211,440.26"
,IN,AR,30335082,1005,100,,Invoice,,,,,,01/12/2018,01/12/2018,0.00,,10.93,,"-1,211,451.19"
,CS,AR,32012221,1005,100,,Cash sale,,,,,,02/12/2018,02/12/2018,0.00,,29.15,,"-1,211,480.34"
,IN,AR,30335357,1005,100,,Invoice,,,,,,02/12/2018,02/12/2018,0.00,,29.15,,"-1,211,509.49"
,CN,AR,31019675,1005,100,,Credit Note,,,,,,03/12/2018,03/12/2018,10.93,,0.00,,"-1,211,498.56"
,CN,AR,31019688,1005,100,,Credit Note,,,,,,03/12/2018,03/12/2018,34.21,,0.00,,"-1,211,464.35"
,CN,AR,31019689,1005,100,,Credit Note,,,,,,03/12/2018,03/12/2018,7.82,,0.00,,"-1,211,456.53"
,CN,AR,31019695,1005,100,,Credit Note,,,,,,03/12/2018,03/12/2018,3.64,,0.00,,"-1,211,452.89"
,CN,AR,31019710,1005,100,,Credit Note,,,,,,03/12/2018,03/12/2018,21.86,,0.00,,"-1,211,431.03"
,CN,AR,31019767,1005,100,,Credit Note,,,,,,03/12/2018,03/12/2018,7.29,,0.00,,"-1,211,423.74"
,CS,AR,32011751,1005,100,,Cash sale,,,,,,03/12/2018,03/12/2018,0.00,,2.81,,"-1,211,426.55"
,CS,AR,32011762,1005,100,,Cash sale,,,,,,03/12/2018,03/12/2018,0.00,,4.75,,"-1,211,431.30"
,CS,AR,32011775,1005,100,,Cash sale,,,,,,03/12/2018,03/12/2018,0.00,,3.64,,"-1,211,434.94"
,CS,AR,32011792,1005,100,,Cash sale,,,,,,03/12/2018,03/12/2018,0.00,,3.64,,"-1,211,438.58"
,CS,AR,32011838,1005,100,,Cash sale,,,,,,03/12/2018,03/12/2018,0.00,,7.29,,"-1,211,445.87"
,CS,AR,32011843,1005,100,,Cash sale,,,,,,03/12/2018,03/12/2018,0.00,,16.61,,"-1,211,462.48"
,CS,AR,32011863,1005,100,,Cash sale,,,,,,03/12/2018,03/12/2018,0.00,,5.84,,"-1,211,468.32"
,CS,AR,32011873,1005,100,,Cash sale,,,,,,03/12/2018,03/12/2018,0.00,,7.29,,"-1,211,475.61"
,CS,AR,32011892,1005,100,,Cash sale,,,,,,03/12/2018,03/12/2018,0.00,,3.64,,"-1,211,479.25"
,CS,AR,32011902,1005,100,,Cash sale,,,,,,03/12/2018,03/12/2018,0.00,,3.64,,"-1,211,482.89"
,CS,AR,32011907,1005,100,,Cash sale,,,,,,03/12/2018,03/12/2018,0.00,,10.34,,"-1,211,493.23"
,CS,AR,32011934,1005,100,,Cash sale,,,,,,03/12/2018,03/12/2018,0.00,,7.63,,"-1,211,500.86"
,CS,AR,32011945,1005,100,,Cash sale,,,,,,03/12/2018,03/12/2018,0.00,,7.29,,"-1,211,508.15"
,CS,AR,32011971,1005,100,,Cash sale,,,,,,03/12/2018,03/12/2018,0.00,,16.48,,"-1,211,524.63"
,CS,AR,32011981,1005,100,,Cash sale,,,,,,03/12/2018,03/12/2018,0.00,,3.64,,"-1,211,528.27"
,CS,AR,32011983,1005,100,,Cash sale,,,,,,03/12/2018,03/12/2018,0.00,,10.93,,"-1,211,539.20"
,CS,AR,32011995,1005,100,,Cash sale,,,,,,03/12/2018,03/12/2018,0.00,,7.29,,"-1,211,546.49"
,CS,AR,32011999,1005,100,,Cash sale,,,,,,03/12/2018,03/12/2018,0.00,,63.18,,"-1,211,609.67"
,CS,AR,32012004,1005,100,,Cash sale,,,,,,03/12/2018,03/12/2018,0.00,,7.63,,"-1,211,617.30"
,CS,AR,32012010,1005,100,,Cash sale,,,,,,03/12/2018,03/12/2018,0.00,,20.47,,"-1,211,637.77"
,CS,AR,32012028,1005,100,,Cash sale,,,,,,03/12/2018,03/12/2018,0.00,,21.06,,"-1,211,658.83"
,CS,AR,32012042,1005,100,,Cash sale,,,,,,03/12/2018,03/12/2018,0.00,,6.48,,"-1,211,665.31"
,CS,AR,32012053,1005,100,,Cash sale,,,,,,03/12/2018,03/12/2018,0.00,,3.64,,"-1,211,668.95"
,CS,AR,32012072,1005,100,,Cash sale,,,,,,03/12/2018,03/12/2018,0.00,,3.64,,"-1,211,672.59"
,CS,AR,32012077,1005,100,,Cash sale,,,,,,03/12/2018,03/12/2018,0.00,,2.54,,"-1,211,675.13"
,CS,AR,32012086,1005,100,,Cash sale,,,,,,03/12/2018,03/12/2018,0.00,,3.64,,"-1,211,678.77"
,CS,AR,32012101,1005,100,,Cash sale,,,,,,03/12/2018,03/12/2018,0.00,,10.93,,"-1,211,689.70"
,CS,AR,32012102,1005,100,,Cash sale,,,,,,03/12/2018,03/12/2018,0.00,,7.75,,"-1,211,697.45"
,CS,AR,32012112,1005,100,,Cash sale,,,,,,03/12/2018,03/12/2018,0.00,,7.29,,"-1,211,704.74"
,CS,AR,32012133,1005,100,,Cash sale,,,,,,03/12/2018,03/12/2018,0.00,,9.03,,"-1,211,713.77"
,CS,AR,32012134,1005,100,,Cash sale,,,,,,03/12/2018,03/12/2018,0.00,,3.64,,"-1,211,717.41"
,CS,AR,32012143,1005,100,,Cash sale,,,,,,03/12/2018,03/12/2018,0.00,,9.13,,"-1,211,726.54"
,CS,AR,32012146,1005,100,,Cash sale,,,,,,03/12/2018,03/12/2018,0.00,,7.29,,"-1,211,733.83"
,CS,AR,32012185,1005,100,,Cash sale,,,,,,03/12/2018,03/12/2018,0.00,,12.71,,"-1,211,746.54"
,CS,AR,32012192,1005,100,,Cash sale,,,,,,03/12/2018,03/12/2018,0.00,,29.15,,"-1,211,775.69"
,CS,AR,32012197,1005,100,,Cash sale,,,,,,03/12/2018,03/12/2018,0.00,,3.64,,"-1,211,779.33"
,CS,AR,32012203,1005,100,,Cash sale,,,,,,03/12/2018,03/12/2018,0.00,,5.17,,"-1,211,784.50"
,CS,AR,32012207,1005,100,,Cash sale,,,,,,03/12/2018,03/12/2018,0.00,,22.88,,"-1,211,807.38"
,CS,AR,32012232,1005,100,,Cash sale,,,,,,03/12/2018,03/12/2018,0.00,,6.56,,"-1,211,813.94"
,CS,AR,32012237,1005,100,,Cash sale,,,,,,03/12/2018,03/12/2018,0.00,,3.64,,"-1,211,817.58"
,CS,AR,32012248,1005,100,,Cash sale,,,,,,03/12/2018,03/12/2018,0.00,,11.44,,"-1,211,829.02"
,CS,AR,32012271,1005,100,,Cash sale,,,,,,03/12/2018,03/12/2018,0.00,,9.10,,"-1,211,838.12"
,CS,AR,32012273,1005,100,,Cash sale,,,,,,03/12/2018,03/12/2018,0.00,,18.22,,"-1,211,856.34"
,CS,AR,32012283,1005,100,,Cash sale,,,,,,03/12/2018,03/12/2018,0.00,,21.25,,"-1,211,877.59"
,CS,AR,32012293,1005,100,,Cash sale,,,,,,03/12/2018,03/12/2018,0.00,,10.93,,"-1,211,888.52"
,CS,AR,32012311,1005,100,,Cash sale,,,,,,03/12/2018,03/12/2018,0.00,,21.86,,"-1,211,910.38"
,CS,AR,32012320,1005,100,,Cash sale,,,,,,03/12/2018,03/12/2018,0.00,,14.58,,"-1,211,924.96"
,CS,AR,32012330,1005,100,,Cash sale,,,,,,03/12/2018,03/12/2018,0.00,,3.64,,"-1,211,928.60"
,CS,AR,32012361,1005,100,,Cash sale,,,,,,03/12/2018,03/12/2018,0.00,,3.64,,"-1,211,932.24"
,CS,AR,32012375,1005,100,,Cash sale,,,,,,03/12/2018,03/12/2018,0.00,,3.64,,"-1,211,935.88"
,CS,AR,32012441,1005,100,,Cash sale,,,,,,03/12/2018,03/12/2018,0.00,,9.32,,"-1,211,945.20"
,CS,AR,32012466,1005,100,,Cash sale,,,,,,03/12/2018,03/12/2018,0.00,,10.93,,"-1,211,956.13"
,IN,AR,30333520,1005,100,,Invoice,,,,,,03/12/2018,03/12/2018,0.00,,32.63,,"-1,211,988.76"
,IN,AR,30333536,1005,100,,Invoice,,,,,,03/12/2018,03/12/2018,0.00,,14.58,,"-1,212,003.34"
,IN,AR,30333557,1005,100,,Invoice,,,,,,03/12/2018,03/12/2018,0.00,,4.05,,"-1,212,007.39"
,IN,AR,30333558,1005,100,,Invoice,,,,,,03/12/2018,03/12/2018,0.00,,8.10,,"-1,212,015.49"
,IN,AR,30333559,1005,100,,Invoice,,,,,,03/12/2018,03/12/2018,0.00,,16.20,,"-1,212,031.69"
,IN,AR,30333560,1005,100,,Invoice,,,,,,03/12/2018,03/12/2018,0.00,,2.03,,"-1,212,033.72"
,IN,AR,30333561,1005,100,,Invoice,,,,,,03/12/2018,03/12/2018,0.00,,14.18,,"-1,212,047.90"
,IN,AR,30333562,1005,100,,Invoice,,,,,,03/12/2018,03/12/2018,0.00,,10.13,,"-1,212,058.03"
,IN,AR,30333563,1005,100,,Invoice,,,,,,03/12/2018,03/12/2018,0.00,,16.20,,"-1,212,074.23"
,IN,AR,30333625,1005,100,,Invoice,,,,,,03/12/2018,03/12/2018,0.00,,25.36,,"-1,212,099.59"
,IN,AR,30333639,1005,100,,Invoice,,,,,,03/12/2018,03/12/2018,0.00,,5.82,,"-1,212,105.41"
,IN,AR,30333643,1005,100,,Invoice,,,,,,03/12/2018,03/12/2018,0.00,,3.64,,"-1,212,109.05"
,IN,AR,30333654,1005,100,,Invoice,,,,,,03/12/2018,03/12/2018,0.00,,84.00,,"-1,212,193.05"
,IN,AR,30333669,1005,100,,Invoice,,,,,,03/12/2018,03/12/2018,0.00,,13.77,,"-1,212,206.82"
,IN,AR,30333674,1005,100,,Invoice,,,,,,03/12/2018,03/12/2018,0.00,,3.64,,"-1,212,210.46"
,IN,AR,30333679,1005,100,,Invoice,,,,,,03/12/2018,03/12/2018,0.00,,48.00,,"-1,212,258.46"
,IN,AR,30333693,1005,100,,Invoice,,,,,,03/12/2018,03/12/2018,0.00,,55.14,,"-1,212,313.60"
,IN,AR,30333712,1005,100,,Invoice,,,,,,03/12/2018,03/12/2018,0.00,,29.15,,"-1,212,342.75"
,IN,AR,30333716,1005,100,,Invoice,,,,,,03/12/2018,03/12/2018,0.00,,24.00,,"-1,212,366.75"
,IN,AR,30333717,1005,100,,Invoice,,,,,,03/12/2018,03/12/2018,0.00,,28.00,,"-1,212,394.75"
,IN,AR,30333735,1005,100,,Invoice,,,,,,03/12/2018,03/12/2018,0.00,,5.51,,"-1,212,400.26"
,IN,AR,30333739,1005,100,,Invoice,,,,,,03/12/2018,03/12/2018,0.00,,25.42,,"-1,212,425.68"
,IN,AR,30333743,1005,100,,Invoice,,,,,,03/12/2018,03/12/2018,0.00,,13.77,,"-1,212,439.45"
,IN,AR,30333752,1005,100,,Invoice,,,,,,03/12/2018,03/12/2018,0.00,,11.69,,"-1,212,451.14"
,IN,AR,30333771,1005,100,,Invoice,,,,,,03/12/2018,03/12/2018,0.00,,10.93,,"-1,212,462.07"
,IN,AR,30333790,1005,100,,Invoice,,,,,,03/12/2018,03/12/2018,0.00,,122.80,,"-1,212,584.87"
,IN,AR,30333816,1005,100,,Invoice,,,,,,03/12/2018,03/12/2018,0.00,,10.93,,"-1,212,595.80"
,IN,AR,30333817,1005,100,,Invoice,,,,,,03/12/2018,03/12/2018,0.00,,14.00,,"-1,212,609.80"
,IN,AR,30333827,1005,100,,Invoice,,,,,,03/12/2018,03/12/2018,0.00,,3.64,,"-1,212,613.44"
,IN,AR,30333843,1005,100,,Invoice,,,,,,03/12/2018,03/12/2018,0.00,,14.49,,"-1,212,627.93"
,IN,AR,30333851,1005,100,,Invoice,,,,,,03/12/2018,03/12/2018,0.00,,29.15,,"-1,212,657.08"
,IN,AR,30333861,1005,100,,Invoice,,,,,,03/12/2018,03/12/2018,0.00,,3.19,,"-1,212,660.27"
,IN,AR,30333881,1005,100,,Invoice,,,,,,03/12/2018,03/12/2018,0.00,,2.58,,"-1,212,662.85"
,IN,AR,30333896,1005,100,,Invoice,,,,,,03/12/2018,03/12/2018,0.00,,13.78,,"-1,212,676.63"
,IN,AR,30333905,1005,100,,Invoice,,,,,,03/12/2018,03/12/2018,0.00,,5.25,,"-1,212,681.88"
,IN,AR,30333943,1005,100,,Invoice,,,,,,03/12/2018,03/12/2018,0.00,,10.34,,"-1,212,692.22"
,IN,AR,30333953,1005,100,,Invoice,,,,,,03/12/2018,03/12/2018,0.00,,8.90,,"-1,212,701.12"
,IN,AR,30333956,1005,100,,Invoice,,,,,,03/12/2018,03/12/2018,0.00,,7.76,,"-1,212,708.88"
,IN,AR,30333989,1005,100,,Invoice,,,,,,03/12/2018,03/12/2018,0.00,,90.24,,"-1,212,799.12"
,IN,AR,30334001,1005,100,,Invoice,,,,,,03/12/2018,03/12/2018,0.00,,48.31,,"-1,212,847.43"
,IN,AR,30334014,1005,100,,Invoice,,,,,,03/12/2018,03/12/2018,0.00,,23.90,,"-1,212,871.33"
,IN,AR,30334015,1005,100,,Invoice,,,,,,03/12/2018,03/12/2018,0.00,,14.34,,"-1,212,885.67"
,IN,AR,30334029,1005,100,,Invoice,,,,,,03/12/2018,03/12/2018,0.00,,32.20,,"-1,212,917.87"
,IN,AR,30334039,1005,100,,Invoice,,,,,,03/12/2018,03/12/2018,0.00,,6.02,,"-1,212,923.89"
,IN,AR,30334050,1005,100,,Invoice,,,,,,03/12/2018,03/12/2018,0.00,,5.51,,"-1,212,929.40"
,IN,AR,30334069,1005,100,,Invoice,,,,,,03/12/2018,03/12/2018,0.00,,6.02,,"-1,212,935.42"
,IN,AR,30334082,1005,100,,Invoice,,,,,,03/12/2018,03/12/2018,0.00,,12.71,,"-1,212,948.13"
,IN,AR,30334123,1005,100,,Invoice,,,,,,03/12/2018,03/12/2018,0.00,,2.16,,"-1,212,950.29"
,IN,AR,30334137,1005,100,,Invoice,,,,,,03/12/2018,03/12/2018,0.00,,12.71,,"-1,212,963.00"
,IN,AR,30334156,1005,100,,Invoice,,,,,,03/12/2018,03/12/2018,0.00,,22.88,,"-1,212,985.88"
,IN,AR,30334166,1005,100,,Invoice,,,,,,03/12/2018,03/12/2018,0.00,,22.37,,"-1,213,008.25"
,IN,AR,30334178,1005,100,,Invoice,,,,,,03/12/2018,03/12/2018,0.00,,3.64,,"-1,213,011.89"
,IN,AR,30334179,1005,100,,Invoice,,,,,,03/12/2018,03/12/2018,0.00,,3.64,,"-1,213,015.53"
,IN,AR,30334182,1005,100,,Invoice,,,,,,03/12/2018,03/12/2018,0.00,,20.34,,"-1,213,035.87"
,IN,AR,30334202,1005,100,,Invoice,,,,,,03/12/2018,03/12/2018,0.00,,7.29,,"-1,213,043.16"
,IN,AR,30334220,1005,100,,Invoice,,,,,,03/12/2018,03/12/2018,0.00,,7.29,,"-1,213,050.45"
,IN,AR,30334232,1005,100,,Invoice,,,,,,03/12/2018,03/12/2018,0.00,,9.13,,"-1,213,059.58"
,IN,AR,30334236,1005,100,,Invoice,,,,,,03/12/2018,03/12/2018,0.00,,9.19,,"-1,213,068.77"
,IN,AR,30334240,1005,100,,Invoice,,,,,,03/12/2018,03/12/2018,0.00,,16.83,,"-1,213,085.60"
,IN,AR,30334250,1005,100,,Invoice,,,,,,03/12/2018,03/12/2018,0.00,,13.14,,"-1,213,098.74"
,IN,AR,30334291,1005,100,,Invoice,,,,,,03/12/2018,03/12/2018,0.00,,4.24,,"-1,213,102.98"
,IN,AR,30334296,1005,100,,Invoice,,,,,,03/12/2018,03/12/2018,0.00,,36.61,,"-1,213,139.59"
,IN,AR,30334307,1005,100,,Invoice,,,,,,03/12/2018,03/12/2018,0.00,,14.00,,"-1,213,153.59"
,IN,AR,30334316,1005,100,,Invoice,,,,,,03/12/2018,03/12/2018,0.00,,10.93,,"-1,213,164.52"
,IN,AR,30334353,1005,100,,Invoice,,,,,,03/12/2018,03/12/2018,0.00,,42.69,,"-1,213,207.21"
,IN,AR,30334364,1005,100,,Invoice,,,,,,03/12/2018,03/12/2018,0.00,,4.49,,"-1,213,211.70"
,IN,AR,30334431,1005,100,,Invoice,,,,,,03/12/2018,03/12/2018,0.00,,7.29,,"-1,213,218.99"
,IN,AR,30334438,1005,100,,Invoice,,,,,,03/12/2018,03/12/2018,0.00,,7.29,,"-1,213,226.28"
,IN,AR,30334486,1005,100,,Invoice,,,,,,03/12/2018,03/12/2018,0.00,,2.14,,"-1,213,228.42"
,IN,AR,30334495,1005,100,,Invoice,,,,,,03/12/2018,03/12/2018,0.00,,21.86,,"-1,213,250.28"
,IN,AR,30334522,1005,100,,Invoice,,,,,,03/12/2018,03/12/2018,0.00,,1.99,,"-1,213,252.27"
,IN,AR,30334563,1005,100,,Invoice,,,,,,03/12/2018,03/12/2018,0.00,,66.62,,"-1,213,318.89"
,IN,AR,30334567,1005,100,,Invoice,,,,,,03/12/2018,03/12/2018,0.00,,34.08,,"-1,213,352.97"
,IN,AR,30334571,1005,100,,Invoice,,,,,,03/12/2018,03/12/2018,0.00,,3.64,,"-1,213,356.61"
,IN,AR,30334607,1005,100,,Invoice,,,,,,03/12/2018,03/12/2018,0.00,,13.14,,"-1,213,369.75"
,IN,AR,30334613,1005,100,,Invoice,,,,,,03/12/2018,03/12/2018,0.00,,4.58,,"-1,213,374.33"
,IN,AR,30334639,1005,100,,Invoice,,,,,,03/12/2018,03/12/2018,0.00,,21.86,,"-1,213,396.19"
,IN,AR,30334662,1005,100,,Invoice,,,,,,03/12/2018,03/12/2018,0.00,,8.00,,"-1,213,404.19"
,IN,AR,30334692,1005,100,,Invoice,,,,,,03/12/2018,03/12/2018,0.00,,46.76,,"-1,213,450.95"
,IN,AR,30334706,1005,100,,Invoice,,,,,,03/12/2018,03/12/2018,0.00,,6.31,,"-1,213,457.26"
,IN,AR,30334728,1005,100,,Invoice,,,,,,03/12/2018,03/12/2018,0.00,,11.66,,"-1,213,468.92"
,IN,AR,30334740,1005,100,,Invoice,,,,,,03/12/2018,03/12/2018,0.00,,186.44,,"-1,213,655.36"
,IN,AR,30334749,1005,100,,Invoice,,,,,,03/12/2018,03/12/2018,0.00,,28.05,,"-1,213,683.41"
,IN,AR,30334785,1005,100,,Invoice,,,,,,03/12/2018,03/12/2018,0.00,,29.15,,"-1,213,712.56"
,IN,AR,30334829,1005,100,,Invoice,,,,,,03/12/2018,03/12/2018,0.00,,18.69,,"-1,213,731.25"
,IN,AR,30334834,1005,100,,Invoice,,,,,,03/12/2018,03/12/2018,0.00,,4.78,,"-1,213,736.03"
,IN,AR,30334920,1005,100,,Invoice,,,,,,03/12/2018,03/12/2018,0.00,,12.00,,"-1,213,748.03"
,IN,AR,30334928,1005,100,,Invoice,,,,,,03/12/2018,03/12/2018,0.00,,1.88,,"-1,213,749.91"
,IN,AR,30334973,1005,100,,Invoice,,,,,,03/12/2018,03/12/2018,0.00,,8.21,,"-1,213,758.12"
,IN,AR,30334999,1005,100,,Invoice,,,,,,03/12/2018,03/12/2018,0.00,,88.23,,"-1,213,846.35"
,IN,AR,30335042,1005,100,,Invoice,,,,,,03/12/2018,03/12/2018,0.00,,5.26,,"-1,213,851.61"
,IN,AR,30335048,1005,100,,Invoice,,,,,,03/12/2018,03/12/2018,0.00,,6.13,,"-1,213,857.74"
,IN,AR,30335088,1005,100,,Invoice,,,,,,03/12/2018,03/12/2018,0.00,,5.97,,"-1,213,863.71"
,IN,AR,30335095,1005,100,,Invoice,,,,,,03/12/2018,03/12/2018,0.00,,54.66,,"-1,213,918.37"
,IN,AR,30335097,1005,100,,Invoice,,,,,,03/12/2018,03/12/2018,0.00,,32.16,,"-1,213,950.53"
,IN,AR,30335115,1005,100,,Invoice,,,,,,03/12/2018,03/12/2018,0.00,,2.08,,"-1,213,952.61"
,IN,AR,30335116,1005,100,,Invoice,,,,,,03/12/2018,03/12/2018,0.00,,8.31,,"-1,213,960.92"
,IN,AR,30335117,1005,100,,Invoice,,,,,,03/12/2018,03/12/2018,0.00,,8.31,,"-1,213,969.23"
,IN,AR,30335118,1005,100,,Invoice,,,,,,03/12/2018,03/12/2018,0.00,,6.23,,"-1,213,975.46"
,IN,AR,30335119,1005,100,,Invoice,,,,,,03/12/2018,03/12/2018,0.00,,4.15,,"-1,213,979.61"
,IN,AR,30335120,1005,100,,Invoice,,,,,,03/12/2018,03/12/2018,0.00,,2.08,,"-1,213,981.69"
,IN,AR,30335212,1005,100,,Invoice,,,,,,03/12/2018,03/12/2018,0.00,,14.58,,"-1,213,996.27"
,IN,AR,30335214,1005,100,,Invoice,,,,,,03/12/2018,03/12/2018,0.00,,1.75,,"-1,213,998.02"
,IN,AR,30335216,1005,100,,Invoice,,,,,,03/12/2018,03/12/2018,0.00,,7.29,,"-1,214,005.31"
,IN,AR,30335229,1005,100,,Invoice,,,,,,03/12/2018,03/12/2018,0.00,,31.54,,"-1,214,036.85"
,IN,AR,30335230,1005,100,,Invoice,,,,,,03/12/2018,03/12/2018,0.00,,16.82,,"-1,214,053.67"
,IN,AR,30335260,1005,100,,Invoice,,,,,,03/12/2018,03/12/2018,0.00,,69.71,,"-1,214,123.38"
,IN,AR,30335282,1005,100,,Invoice,,,,,,03/12/2018,03/12/2018,0.00,,10.93,,"-1,214,134.31"
,IN,AR,30335300,1005,100,,Invoice,,,,,,03/12/2018,03/12/2018,0.00,,7.29,,"-1,214,141.60"
,IN,AR,30335327,1005,100,,Invoice,,,,,,03/12/2018,03/12/2018,0.00,,32.80,,"-1,214,174.40"
,IN,AR,30335336,1005,100,,Invoice,,,,,,03/12/2018,03/12/2018,0.00,,29.15,,"-1,214,203.55"
,CN,AR,31019648,1005,100,,Credit Note,,,,,,04/12/2018,04/12/2018,4.78,,0.00,,"-1,214,198.77"
,CS,AR,32011785,1005,100,,Cash sale,,,,,,04/12/2018,04/12/2018,0.00,,3.64,,"-1,214,202.41"
,CS,AR,32011787,1005,100,,Cash sale,,,,,,04/12/2018,04/12/2018,0.00,,3.64,,"-1,214,206.05"
,CS,AR,32011794,1005,100,,Cash sale,,,,,,04/12/2018,04/12/2018,0.00,,10.93,,"-1,214,216.98"
,CS,AR,32011795,1005,100,,Cash sale,,,,,,04/12/2018,04/12/2018,0.00,,3.64,,"-1,214,220.62"
,CS,AR,32011796,1005,100,,Cash sale,,,,,,04/12/2018,04/12/2018,0.00,,10.93,,"-1,214,231.55"
,CS,AR,32011799,1005,100,,Cash sale,,,,,,04/12/2018,04/12/2018,0.00,,21.86,,"-1,214,253.41"
,CS,AR,32011803,1005,100,,Cash sale,,,,,,04/12/2018,04/12/2018,0.00,,7.29,,"-1,214,260.70"
,CS,AR,32011811,1005,100,,Cash sale,,,,,,04/12/2018,04/12/2018,0.00,,18.22,,"-1,214,278.92"
,CS,AR,32011814,1005,100,,Cash sale,,,,,,04/12/2018,04/12/2018,0.00,,7.29,,"-1,214,286.21"
,CS,AR,32011820,1005,100,,Cash sale,,,,,,04/12/2018,04/12/2018,0.00,,18.22,,"-1,214,304.43"
,CS,AR,32011828,1005,100,,Cash sale,,,,,,04/12/2018,04/12/2018,0.00,,3.01,,"-1,214,307.44"
,CS,AR,32011833,1005,100,,Cash sale,,,,,,04/12/2018,04/12/2018,0.00,,14.58,,"-1,214,322.02"
,CS,AR,32011857,1005,100,,Cash sale,,,,,,04/12/2018,04/12/2018,0.00,,10.93,,"-1,214,332.95"
,CS,AR,32011878,1005,100,,Cash sale,,,,,,04/12/2018,04/12/2018,0.00,,14.58,,"-1,214,347.53"
,CS,AR,32011911,1005,100,,Cash sale,,,,,,04/12/2018,04/12/2018,0.00,,7.63,,"-1,214,355.16"
,CS,AR,32011913,1005,100,,Cash sale,,,,,,04/12/2018,04/12/2018,0.00,,7.29,,"-1,214,362.45"
,CS,AR,32011916,1005,100,,Cash sale,,,,,,04/12/2018,04/12/2018,0.00,,7.29,,"-1,214,369.74"
,CS,AR,32011917,1005,100,,Cash sale,,,,,,04/12/2018,04/12/2018,0.00,,4.32,,"-1,214,374.06"
,CS,AR,32011931,1005,100,,Cash sale,,,,,,04/12/2018,04/12/2018,0.00,,2.81,,"-1,214,376.87"
,CS,AR,32011933,1005,100,,Cash sale,,,,,,04/12/2018,04/12/2018,0.00,,2.58,,"-1,214,379.45"
,CS,AR,32011947,1005,100,,Cash sale,,,,,,04/12/2018,04/12/2018,0.00,,2.84,,"-1,214,382.29"
,CS,AR,32011960,1005,100,,Cash sale,,,,,,04/12/2018,04/12/2018,0.00,,7.80,,"-1,214,390.09"
,CS,AR,32011969,1005,100,,Cash sale,,,,,,04/12/2018,04/12/2018,0.00,,18.22,,"-1,214,408.31"
,CS,AR,32011996,1005,100,,Cash sale,,,,,,04/12/2018,04/12/2018,0.00,,4.29,,"-1,214,412.60"
,CS,AR,32012006,1005,100,,Cash sale,,,,,,04/12/2018,04/12/2018,0.00,,15.51,,"-1,214,428.11"
,CS,AR,32012007,1005,100,,Cash sale,,,,,,04/12/2018,04/12/2018,0.00,,12.03,,"-1,214,440.14"
,CS,AR,32012037,1005,100,,Cash sale,,,,,,04/12/2018,04/12/2018,0.00,,7.29,,"-1,214,447.43"
,CS,AR,32012040,1005,100,,Cash sale,,,,,,04/12/2018,04/12/2018,0.00,,7.29,,"-1,214,454.72"
,CS,AR,32012056,1005,100,,Cash sale,,,,,,04/12/2018,04/12/2018,0.00,,3.64,,"-1,214,458.36"
,CS,AR,32012063,1005,100,,Cash sale,,,,,,04/12/2018,04/12/2018,0.00,,3.64,,"-1,214,462.00"
,CS,AR,32012067,1005,100,,Cash sale,,,,,,04/12/2018,04/12/2018,0.00,,7.75,,"-1,214,469.75"
,CS,AR,32012076,1005,100,,Cash sale,,,,,,04/12/2018,04/12/2018,0.00,,18.22,,"-1,214,487.97"
,CS,AR,32012082,1005,100,,Cash sale,,,,,,04/12/2018,04/12/2018,0.00,,7.75,,"-1,214,495.72"
,CS,AR,32012085,1005,100,,Cash sale,,,,,,04/12/2018,04/12/2018,0.00,,18.22,,"-1,214,513.94"
,CS,AR,32012089,1005,100,,Cash sale,,,,,,04/12/2018,04/12/2018,0.00,,7.80,,"-1,214,521.74"
,CS,AR,32012098,1005,100,,Cash sale,,,,,,04/12/2018,04/12/2018,0.00,,3.64,,"-1,214,525.38"
,CS,AR,32012108,1005,100,,Cash sale,,,,,,04/12/2018,04/12/2018,0.00,,7.29,,"-1,214,532.67"
,CS,AR,32012109,1005,100,,Cash sale,,,,,,04/12/2018,04/12/2018,0.00,,25.90,,"-1,214,558.57"
,CS,AR,32012116,1005,100,,Cash sale,,,,,,04/12/2018,04/12/2018,0.00,,7.29,,"-1,214,565.86"
,CS,AR,32012130,1005,100,,Cash sale,,,,,,04/12/2018,04/12/2018,0.00,,14.58,,"-1,214,580.44"
,CS,AR,32012154,1005,100,,Cash sale,,,,,,04/12/2018,04/12/2018,0.00,,3.76,,"-1,214,584.20"
,CS,AR,32012165,1005,100,,Cash sale,,,,,,04/12/2018,04/12/2018,0.00,,5.18,,"-1,214,589.38"
,CS,AR,32012170,1005,100,,Cash sale,,,,,,04/12/2018,04/12/2018,0.00,,3.64,,"-1,214,593.02"
,CS,AR,32012173,1005,100,,Cash sale,,,,,,04/12/2018,04/12/2018,0.00,,10.93,,"-1,214,603.95"
,CS,AR,32012177,1005,100,,Cash sale,,,,,,04/12/2018,04/12/2018,0.00,,7.29,,"-1,214,611.24"
,CS,AR,32012190,1005,100,,Cash sale,,,,,,04/12/2018,04/12/2018,0.00,,15.04,,"-1,214,626.28"
,CS,AR,32012200,1005,100,,Cash sale,,,,,,04/12/2018,04/12/2018,0.00,,3.64,,"-1,214,629.92"
,CS,AR,32012213,1005,100,,Cash sale,,,,,,04/12/2018,04/12/2018,0.00,,15.25,,"-1,214,645.17"
,CS,AR,32012216,1005,100,,Cash sale,,,,,,04/12/2018,04/12/2018,0.00,,32.00,,"-1,214,677.17"
,CS,AR,32012274,1005,100,,Cash sale,,,,,,04/12/2018,04/12/2018,0.00,,8.25,,"-1,214,685.42"
,CS,AR,32012292,1005,100,,Cash sale,,,,,,04/12/2018,04/12/2018,0.00,,5.47,,"-1,214,690.89"
,CS,AR,32012335,1005,100,,Cash sale,,,,,,04/12/2018,04/12/2018,0.00,,14.58,,"-1,214,705.47"
,CS,AR,32012444,1005,100,,Cash sale,,,,,,04/12/2018,04/12/2018,0.00,,6.19,,"-1,214,711.66"
,CS,AR,32012468,1005,100,,Cash sale,,,,,,04/12/2018,04/12/2018,0.00,,2.97,,"-1,214,714.63"
,CS,AR,32012470,1005,100,,Cash sale,,,,,,04/12/2018,04/12/2018,0.00,,5.93,,"-1,214,720.56"
,CS,AR,32012475,1005,100,,Cash sale,,,,,,04/12/2018,04/12/2018,0.00,,3.64,,"-1,214,724.20"
,CS,AR,32012478,1005,100,,Cash sale,,,,,,04/12/2018,04/12/2018,0.00,,7.29,,"-1,214,731.49"
,IN,AR,30333515,1005,100,,Invoice,,,,,,04/12/2018,04/12/2018,0.00,,12.03,,"-1,214,743.52"
,IN,AR,30333617,1005,100,,Invoice,,,,,,04/12/2018,04/12/2018,0.00,,7.00,,"-1,214,750.52"
,IN,AR,30333647,1005,100,,Invoice,,,,,,04/12/2018,04/12/2018,0.00,,5.97,,"-1,214,756.49"
,IN,AR,30333655,1005,100,,Invoice,,,,,,04/12/2018,04/12/2018,0.00,,42.00,,"-1,214,798.49"
,IN,AR,30333689,1005,100,,Invoice,,,,,,04/12/2018,04/12/2018,0.00,,7.29,,"-1,214,805.78"
,IN,AR,30333692,1005,100,,Invoice,,,,,,04/12/2018,04/12/2018,0.00,,14.58,,"-1,214,820.36"
,IN,AR,30333757,1005,100,,Invoice,,,,,,04/12/2018,04/12/2018,0.00,,3.64,,"-1,214,824.00"
,IN,AR,30333774,1005,100,,Invoice,,,,,,04/12/2018,04/12/2018,0.00,,18.22,,"-1,214,842.22"
,IN,AR,30333804,1005,100,,Invoice,,,,,,04/12/2018,04/12/2018,0.00,,12.92,,"-1,214,855.14"
,IN,AR,30333812,1005,100,,Invoice,,,,,,04/12/2018,04/12/2018,0.00,,64.53,,"-1,214,919.67"
,IN,AR,30333829,1005,100,,Invoice,,,,,,04/12/2018,04/12/2018,0.00,,19.24,,"-1,214,938.91"
,IN,AR,30333833,1005,100,,Invoice,,,,,,04/12/2018,04/12/2018,0.00,,7.29,,"-1,214,946.20"
,IN,AR,30333913,1005,100,,Invoice,,,,,,04/12/2018,04/12/2018,0.00,,10.59,,"-1,214,956.79"
,IN,AR,30333920,1005,100,,Invoice,,,,,,04/12/2018,04/12/2018,0.00,,52.88,,"-1,215,009.67"
,IN,AR,30333929,1005,100,,Invoice,,,,,,04/12/2018,04/12/2018,0.00,,12.71,,"-1,215,022.38"
,IN,AR,30333931,1005,100,,Invoice,,,,,,04/12/2018,04/12/2018,0.00,,6.36,,"-1,215,028.74"
,IN,AR,30333972,1005,100,,Invoice,,,,,,04/12/2018,04/12/2018,0.00,,9.03,,"-1,215,037.77"
,IN,AR,30334016,1005,100,,Invoice,,,,,,04/12/2018,04/12/2018,0.00,,2.39,,"-1,215,040.16"
,IN,AR,30334051,1005,100,,Invoice,,,,,,04/12/2018,04/12/2018,0.00,,5.51,,"-1,215,045.67"
,IN,AR,30334059,1005,100,,Invoice,,,,,,04/12/2018,04/12/2018,0.00,,30.30,,"-1,215,075.97"
,IN,AR,30334099,1005,100,,Invoice,,,,,,04/12/2018,04/12/2018,0.00,,6.74,,"-1,215,082.71"
,IN,AR,30334118,1005,100,,Invoice,,,,,,04/12/2018,04/12/2018,0.00,,3.90,,"-1,215,086.61"
,IN,AR,30334120,1005,100,,Invoice,,,,,,04/12/2018,04/12/2018,0.00,,15.25,,"-1,215,101.86"
,IN,AR,30334142,1005,100,,Invoice,,,,,,04/12/2018,04/12/2018,0.00,,5.85,,"-1,215,107.71"
,IN,AR,30334152,1005,100,,Invoice,,,,,,04/12/2018,04/12/2018,0.00,,16.02,,"-1,215,123.73"
,IN,AR,30334164,1005,100,,Invoice,,,,,,04/12/2018,04/12/2018,0.00,,3.01,,"-1,215,126.74"
,IN,AR,30334174,1005,100,,Invoice,,,,,,04/12/2018,04/12/2018,0.00,,9.92,,"-1,215,136.66"
,IN,AR,30334191,1005,100,,Invoice,,,,,,04/12/2018,04/12/2018,0.00,,3.90,,"-1,215,140.56"
,IN,AR,30334192,1005,100,,Invoice,,,,,,04/12/2018,04/12/2018,0.00,,3.51,,"-1,215,144.07"
,IN,AR,30334207,1005,100,,Invoice,,,,,,04/12/2018,04/12/2018,0.00,,4.24,,"-1,215,148.31"
,IN,AR,30334213,1005,100,,Invoice,,,,,,04/12/2018,04/12/2018,0.00,,4.24,,"-1,215,152.55"
,IN,AR,30334216,1005,100,,Invoice,,,,,,04/12/2018,04/12/2018,0.00,,12.71,,"-1,215,165.26"
,IN,AR,30334224,1005,100,,Invoice,,,,,,04/12/2018,04/12/2018,0.00,,2.54,,"-1,215,167.80"
,IN,AR,30334230,1005,100,,Invoice,,,,,,04/12/2018,04/12/2018,0.00,,54.66,,"-1,215,222.46"
,IN,AR,30334261,1005,100,,Invoice,,,,,,04/12/2018,04/12/2018,0.00,,18.31,,"-1,215,240.77"
,IN,AR,30334312,1005,100,,Invoice,,,,,,04/12/2018,04/12/2018,0.00,,15.79,,"-1,215,256.56"
,IN,AR,30334338,1005,100,,Invoice,,,,,,04/12/2018,04/12/2018,0.00,,5.59,,"-1,215,262.15"
,IN,AR,30334346,1005,100,,Invoice,,,,,,04/12/2018,04/12/2018,0.00,,5.86,,"-1,215,268.01"
,IN,AR,30334367,1005,100,,Invoice,,,,,,04/12/2018,04/12/2018,0.00,,29.15,,"-1,215,297.16"
,IN,AR,30334393,1005,100,,Invoice,,,,,,04/12/2018,04/12/2018,0.00,,7.29,,"-1,215,304.45"
,IN,AR,30334397,1005,100,,Invoice,,,,,,04/12/2018,04/12/2018,0.00,,15.01,,"-1,215,319.46"
,IN,AR,30334407,1005,100,,Invoice,,,,,,04/12/2018,04/12/2018,0.00,,34.31,,"-1,215,353.77"
,IN,AR,30334416,1005,100,,Invoice,,,,,,04/12/2018,04/12/2018,0.00,,5.29,,"-1,215,359.06"
,IN,AR,30334447,1005,100,,Invoice,,,,,,04/12/2018,04/12/2018,0.00,,2.58,,"-1,215,361.64"
,IN,AR,30334460,1005,100,,Invoice,,,,,,04/12/2018,04/12/2018,0.00,,3.64,,"-1,215,365.28"
,IN,AR,30334523,1005,100,,Invoice,,,,,,04/12/2018,04/12/2018,0.00,,9.95,,"-1,215,375.23"
,IN,AR,30334524,1005,100,,Invoice,,,,,,04/12/2018,04/12/2018,0.00,,9.95,,"-1,215,385.18"
,IN,AR,30334525,1005,100,,Invoice,,,,,,04/12/2018,04/12/2018,0.00,,306.43,,"-1,215,691.61"
,IN,AR,30334546,1005,100,,Invoice,,,,,,04/12/2018,04/12/2018,0.00,,17.03,,"-1,215,708.64"
,IN,AR,30334580,1005,100,,Invoice,,,,,,04/12/2018,04/12/2018,0.00,,3.64,,"-1,215,712.28"
,IN,AR,30334588,1005,100,,Invoice,,,,,,04/12/2018,04/12/2018,0.00,,9.03,,"-1,215,721.31"
,IN,AR,30334597,1005,100,,Invoice,,,,,,04/12/2018,04/12/2018,0.00,,206.62,,"-1,215,927.93"
,IN,AR,30334618,1005,100,,Invoice,,,,,,04/12/2018,04/12/2018,0.00,,6.56,,"-1,215,934.49"
,IN,AR,30334625,1005,100,,Invoice,,,,,,04/12/2018,04/12/2018,0.00,,25.51,,"-1,215,960.00"
,IN,AR,30334629,1005,100,,Invoice,,,,,,04/12/2018,04/12/2018,0.00,,7.29,,"-1,215,967.29"
,IN,AR,30334642,1005,100,,Invoice,,,,,,04/12/2018,04/12/2018,0.00,,8.90,,"-1,215,976.19"
,IN,AR,30334647,1005,100,,Invoice,,,,,,04/12/2018,04/12/2018,0.00,,12.71,,"-1,215,988.90"
,IN,AR,30334667,1005,100,,Invoice,,,,,,04/12/2018,04/12/2018,0.00,,4.00,,"-1,215,992.90"
,IN,AR,30334686,1005,100,,Invoice,,,,,,04/12/2018,04/12/2018,0.00,,18.22,,"-1,216,011.12"
,IN,AR,30334703,1005,100,,Invoice,,,,,,04/12/2018,04/12/2018,0.00,,21.86,,"-1,216,032.98"
,IN,AR,30334737,1005,100,,Invoice,,,,,,04/12/2018,04/12/2018,0.00,,45.91,,"-1,216,078.89"
,IN,AR,30334747,1005,100,,Invoice,,,,,,04/12/2018,04/12/2018,0.00,,21.86,,"-1,216,100.75"
,IN,AR,30334773,1005,100,,Invoice,,,,,,04/12/2018,04/12/2018,0.00,,12.85,,"-1,216,113.60"
,IN,AR,30334777,1005,100,,Invoice,,,,,,04/12/2018,04/12/2018,0.00,,88.00,,"-1,216,201.60"
,IN,AR,30334793,1005,100,,Invoice,,,,,,04/12/2018,04/12/2018,0.00,,30.85,,"-1,216,232.45"
,IN,AR,30334814,1005,100,,Invoice,,,,,,04/12/2018,04/12/2018,0.00,,3.64,,"-1,216,236.09"
,IN,AR,30334862,1005,100,,Invoice,,,,,,04/12/2018,04/12/2018,0.00,,75.93,,"-1,216,312.02"
,IN,AR,30334868,1005,100,,Invoice,,,,,,04/12/2018,04/12/2018,0.00,,28.47,,"-1,216,340.49"
,IN,AR,30334883,1005,100,,Invoice,,,,,,04/12/2018,04/12/2018,0.00,,12.20,,"-1,216,352.69"
,IN,AR,30334937,1005,100,,Invoice,,,,,,04/12/2018,04/12/2018,0.00,,5.26,,"-1,216,357.95"
,IN,AR,30334941,1005,100,,Invoice,,,,,,04/12/2018,04/12/2018,0.00,,14.00,,"-1,216,371.95"
,IN,AR,30334947,1005,100,,Invoice,,,,,,04/12/2018,04/12/2018,0.00,,2.97,,"-1,216,374.92"
,IN,AR,30334951,1005,100,,Invoice,,,,,,04/12/2018,04/12/2018,0.00,,7.29,,"-1,216,382.21"
,IN,AR,30334954,1005,100,,Invoice,,,,,,04/12/2018,04/12/2018,0.00,,104.88,,"-1,216,487.09"
,IN,AR,30334957,1005,100,,Invoice,,,,,,04/12/2018,04/12/2018,0.00,,7.29,,"-1,216,494.38"
,IN,AR,30334963,1005,100,,Invoice,,,,,,04/12/2018,04/12/2018,0.00,,7.02,,"-1,216,501.40"
,IN,AR,30334983,1005,100,,Invoice,,,,,,04/12/2018,04/12/2018,0.00,,10.93,,"-1,216,512.33"
,IN,AR,30334996,1005,100,,Invoice,,,,,,04/12/2018,04/12/2018,0.00,,364.41,,"-1,216,876.74"
,IN,AR,30335049,1005,100,,Invoice,,,,,,04/12/2018,04/12/2018,0.00,,18.38,,"-1,216,895.12"
,IN,AR,30335050,1005,100,,Invoice,,,,,,04/12/2018,04/12/2018,0.00,,55.14,,"-1,216,950.26"
,IN,AR,30335086,1005,100,,Invoice,,,,,,04/12/2018,04/12/2018,0.00,,8.39,,"-1,216,958.65"
,IN,AR,30335121,1005,100,,Invoice,,,,,,04/12/2018,04/12/2018,0.00,,6.23,,"-1,216,964.88"
,IN,AR,30335122,1005,100,,Invoice,,,,,,04/12/2018,04/12/2018,0.00,,8.31,,"-1,216,973.19"
,IN,AR,30335162,1005,100,,Invoice,,,,,,04/12/2018,04/12/2018,0.00,,22.88,,"-1,216,996.07"
,IN,AR,30335166,1005,100,,Invoice,,,,,,04/12/2018,04/12/2018,0.00,,24.15,,"-1,217,020.22"
,IN,AR,30335203,1005,100,,Invoice,,,,,,04/12/2018,04/12/2018,0.00,,5.08,,"-1,217,025.30"
,IN,AR,30335205,1005,100,,Invoice,,,,,,04/12/2018,04/12/2018,0.00,,10.17,,"-1,217,035.47"
,IN,AR,30335218,1005,100,,Invoice,,,,,,04/12/2018,04/12/2018,0.00,,7.29,,"-1,217,042.76"
,IN,AR,30335225,1005,100,,Invoice,,,,,,04/12/2018,04/12/2018,0.00,,7.29,,"-1,217,050.05"
,IN,AR,30335248,1005,100,,Invoice,,,,,,04/12/2018,04/12/2018,0.00,,100.12,,"-1,217,150.17"
,IN,AR,30335264,1005,100,,Invoice,,,,,,04/12/2018,04/12/2018,0.00,,7.29,,"-1,217,157.46"
,IN,AR,30335271,1005,100,,Invoice,,,,,,04/12/2018,04/12/2018,0.00,,12.14,,"-1,217,169.60"
,IN,AR,30335275,1005,100,,Invoice,,,,,,04/12/2018,04/12/2018,0.00,,9.10,,"-1,217,178.70"
,IN,AR,30335287,1005,100,,Invoice,,,,,,04/12/2018,04/12/2018,0.00,,18.22,,"-1,217,196.92"
,IN,AR,30335293,1005,100,,Invoice,,,,,,04/12/2018,04/12/2018,0.00,,51.02,,"-1,217,247.94"
,IN,AR,30335304,1005,100,,Invoice,,,,,,04/12/2018,04/12/2018,0.00,,8.21,,"-1,217,256.15"
,IN,AR,30335334,1005,100,,Invoice,,,,,,04/12/2018,04/12/2018,0.00,,7.29,,"-1,217,263.44"
,IN,AR,30335350,1005,100,,Invoice,,,,,,04/12/2018,04/12/2018,0.00,,36.41,,"-1,217,299.85"
,CN,AR,31019637,1005,100,,Credit Note,,,,,,05/12/2018,05/12/2018,182.20,,0.00,,"-1,217,117.65"
,CS,AR,32011752,1005,100,,Cash sale,,,,,,05/12/2018,05/12/2018,0.00,,5.61,,"-1,217,123.26"
,CS,AR,32011759,1005,100,,Cash sale,,,,,,05/12/2018,05/12/2018,0.00,,45.15,,"-1,217,168.41"
,CS,AR,32011782,1005,100,,Cash sale,,,,,,05/12/2018,05/12/2018,0.00,,3.64,,"-1,217,172.05"
,CS,AR,32011801,1005,100,,Cash sale,,,,,,05/12/2018,05/12/2018,0.00,,3.64,,"-1,217,175.69"
,CS,AR,32011817,1005,100,,Cash sale,,,,,,05/12/2018,05/12/2018,0.00,,3.64,,"-1,217,179.33"
,CS,AR,32011836,1005,100,,Cash sale,,,,,,05/12/2018,05/12/2018,0.00,,3.64,,"-1,217,182.97"
,CS,AR,32011858,1005,100,,Cash sale,,,,,,05/12/2018,05/12/2018,0.00,,3.64,,"-1,217,186.61"
,CS,AR,32011860,1005,100,,Cash sale,,,,,,05/12/2018,05/12/2018,0.00,,6.02,,"-1,217,192.63"
,CS,AR,32011896,1005,100,,Cash sale,,,,,,05/12/2018,05/12/2018,0.00,,5.86,,"-1,217,198.49"
,CS,AR,32011951,1005,100,,Cash sale,,,,,,05/12/2018,05/12/2018,0.00,,12.92,,"-1,217,211.41"
,CS,AR,32011966,1005,100,,Cash sale,,,,,,05/12/2018,05/12/2018,0.00,,7.29,,"-1,217,218.70"
,CS,AR,32011976,1005,100,,Cash sale,,,,,,05/12/2018,05/12/2018,0.00,,15.04,,"-1,217,233.74"
,CS,AR,32011992,1005,100,,Cash sale,,,,,,05/12/2018,05/12/2018,0.00,,14.58,,"-1,217,248.32"
,CS,AR,32012001,1005,100,,Cash sale,,,,,,05/12/2018,05/12/2018,0.00,,2.54,,"-1,217,250.86"
,CS,AR,32012045,1005,100,,Cash sale,,,,,,05/12/2018,05/12/2018,0.00,,7.75,,"-1,217,258.61"
,CS,AR,32012120,1005,100,,Cash sale,,,,,,05/12/2018,05/12/2018,0.00,,3.64,,"-1,217,262.25"
,CS,AR,32012156,1005,100,,Cash sale,,,,,,05/12/2018,05/12/2018,0.00,,10.93,,"-1,217,273.18"
,CS,AR,32012166,1005,100,,Cash sale,,,,,,05/12/2018,05/12/2018,0.00,,18.98,,"-1,217,292.16"
,CS,AR,32012172,1005,100,,Cash sale,,,,,,05/12/2018,05/12/2018,0.00,,4.88,,"-1,217,297.04"
,CS,AR,32012210,1005,100,,Cash sale,,,,,,05/12/2018,05/12/2018,0.00,,11.44,,"-1,217,308.48"
,CS,AR,32012228,1005,100,,Cash sale,,,,,,05/12/2018,05/12/2018,0.00,,10.93,,"-1,217,319.41"
,CS,AR,32012230,1005,100,,Cash sale,,,,,,05/12/2018,05/12/2018,0.00,,6.07,,"-1,217,325.48"
,CS,AR,32012243,1005,100,,Cash sale,,,,,,05/12/2018,05/12/2018,0.00,,9.84,,"-1,217,335.32"
,CS,AR,32012249,1005,100,,Cash sale,,,,,,05/12/2018,05/12/2018,0.00,,9.15,,"-1,217,344.47"
,CS,AR,32012261,1005,100,,Cash sale,,,,,,05/12/2018,05/12/2018,0.00,,14.58,,"-1,217,359.05"
,CS,AR,32012279,1005,100,,Cash sale,,,,,,05/12/2018,05/12/2018,0.00,,9.03,,"-1,217,368.08"
,CS,AR,32012294,1005,100,,Cash sale,,,,,,05/12/2018,05/12/2018,0.00,,14.58,,"-1,217,382.66"
,CS,AR,32012307,1005,100,,Cash sale,,,,,,05/12/2018,05/12/2018,0.00,,5.08,,"-1,217,387.74"
,CS,AR,32012332,1005,100,,Cash sale,,,,,,05/12/2018,05/12/2018,0.00,,29.15,,"-1,217,416.89"
,CS,AR,32012340,1005,100,,Cash sale,,,,,,05/12/2018,05/12/2018,0.00,,3.64,,"-1,217,420.53"
,CS,AR,32012343,1005,100,,Cash sale,,,,,,05/12/2018,05/12/2018,0.00,,13.12,,"-1,217,433.65"
,CS,AR,32012346,1005,100,,Cash sale,,,,,,05/12/2018,05/12/2018,0.00,,7.29,,"-1,217,440.94"
,CS,AR,32012358,1005,100,,Cash sale,,,,,,05/12/2018,05/12/2018,0.00,,10.99,,"-1,217,451.93"
,IN,AR,30333518,1005,100,,Invoice,,,,,,05/12/2018,05/12/2018,0.00,,84.54,,"-1,217,536.47"
,IN,AR,30333549,1005,100,,Invoice,,,,,,05/12/2018,05/12/2018,0.00,,7.29,,"-1,217,543.76"
,IN,AR,30333552,1005,100,,Invoice,,,,,,05/12/2018,05/12/2018,0.00,,29.29,,"-1,217,573.05"
,IN,AR,30333553,1005,100,,Invoice,,,,,,05/12/2018,05/12/2018,0.00,,63.46,,"-1,217,636.51"
,IN,AR,30333588,1005,100,,Invoice,,,,,,05/12/2018,05/12/2018,0.00,,2.84,,"-1,217,639.35"
,IN,AR,30333590,1005,100,,Invoice,,,,,,05/12/2018,05/12/2018,0.00,,10.93,,"-1,217,650.28"
,IN,AR,30333593,1005,100,,Invoice,,,,,,05/12/2018,05/12/2018,0.00,,19.92,,"-1,217,670.20"
,IN,AR,30333598,1005,100,,Invoice,,,,,,05/12/2018,05/12/2018,0.00,,23.64,,"-1,217,693.84"
,IN,AR,30333599,1005,100,,Invoice,,,,,,05/12/2018,05/12/2018,0.00,,78.81,,"-1,217,772.65"
,IN,AR,30333656,1005,100,,Invoice,,,,,,05/12/2018,05/12/2018,0.00,,22.00,,"-1,217,794.65"
,IN,AR,30333676,1005,100,,Invoice,,,,,,05/12/2018,05/12/2018,0.00,,36.10,,"-1,217,830.75"
,IN,AR,30333690,1005,100,,Invoice,,,,,,05/12/2018,05/12/2018,0.00,,3.64,,"-1,217,834.39"
,IN,AR,30333709,1005,100,,Invoice,,,,,,05/12/2018,05/12/2018,0.00,,182.20,,"-1,218,016.59"
,IN,AR,30333710,1005,100,,Invoice,,,,,,05/12/2018,05/12/2018,0.00,,182.20,,"-1,218,198.79"
,IN,AR,30333711,1005,100,,Invoice,,,,,,05/12/2018,05/12/2018,0.00,,182.20,,"-1,218,380.99"
,IN,AR,30333718,1005,100,,Invoice,,,,,,05/12/2018,05/12/2018,0.00,,24.00,,"-1,218,404.99"
,IN,AR,30333748,1005,100,,Invoice,,,,,,05/12/2018,05/12/2018,0.00,,28.00,,"-1,218,432.99"
,IN,AR,30333753,1005,100,,Invoice,,,,,,05/12/2018,05/12/2018,0.00,,2.92,,"-1,218,435.91"
,IN,AR,30333792,1005,100,,Invoice,,,,,,05/12/2018,05/12/2018,0.00,,62.76,,"-1,218,498.67"
,IN,AR,30333799,1005,100,,Invoice,,,,,,05/12/2018,05/12/2018,0.00,,585.72,,"-1,219,084.39"
,IN,AR,30333835,1005,100,,Invoice,,,,,,05/12/2018,05/12/2018,0.00,,9.03,,"-1,219,093.42"
,IN,AR,30333848,1005,100,,Invoice,,,,,,05/12/2018,05/12/2018,0.00,,13.26,,"-1,219,106.68"
,IN,AR,30333858,1005,100,,Invoice,,,,,,05/12/2018,05/12/2018,0.00,,7.29,,"-1,219,113.97"
,IN,AR,30333890,1005,100,,Invoice,,,,,,05/12/2018,05/12/2018,0.00,,14.58,,"-1,219,128.55"
,IN,AR,30333915,1005,100,,Invoice,,,,,,05/12/2018,05/12/2018,0.00,,4.24,,"-1,219,132.79"
,IN,AR,30333926,1005,100,,Invoice,,,,,,05/12/2018,05/12/2018,0.00,,4.24,,"-1,219,137.03"
,IN,AR,30333933,1005,100,,Invoice,,,,,,05/12/2018,05/12/2018,0.00,,8.39,,"-1,219,145.42"
,IN,AR,30333960,1005,100,,Invoice,,,,,,05/12/2018,05/12/2018,0.00,,33.46,,"-1,219,178.88"
,IN,AR,30333963,1005,100,,Invoice,,,,,,05/12/2018,05/12/2018,0.00,,14.58,,"-1,219,193.46"
,IN,AR,30333990,1005,100,,Invoice,,,,,,05/12/2018,05/12/2018,0.00,,45.12,,"-1,219,238.58"
,IN,AR,30334047,1005,100,,Invoice,,,,,,05/12/2018,05/12/2018,0.00,,7.29,,"-1,219,245.87"
,IN,AR,30334070,1005,100,,Invoice,,,,,,05/12/2018,05/12/2018,0.00,,144.04,,"-1,219,389.91"
,IN,AR,30334073,1005,100,,Invoice,,,,,,05/12/2018,05/12/2018,0.00,,5.08,,"-1,219,394.99"
,IN,AR,30334083,1005,100,,Invoice,,,,,,05/12/2018,05/12/2018,0.00,,2.54,,"-1,219,397.53"
,IN,AR,30334108,1005,100,,Invoice,,,,,,05/12/2018,05/12/2018,0.00,,1.59,,"-1,219,399.12"
,IN,AR,30334111,1005,100,,Invoice,,,,,,05/12/2018,05/12/2018,0.00,,12.87,,"-1,219,411.99"
,IN,AR,30334119,1005,100,,Invoice,,,,,,05/12/2018,05/12/2018,0.00,,4.24,,"-1,219,416.23"
,IN,AR,30334149,1005,100,,Invoice,,,,,,05/12/2018,05/12/2018,0.00,,15.90,,"-1,219,432.13"
,IN,AR,30334190,1005,100,,Invoice,,,,,,05/12/2018,05/12/2018,0.00,,38.14,,"-1,219,470.27"
,IN,AR,30334210,1005,100,,Invoice,,,,,,05/12/2018,05/12/2018,0.00,,14.58,,"-1,219,484.85"
,IN,AR,30334231,1005,100,,Invoice,,,,,,05/12/2018,05/12/2018,0.00,,8.17,,"-1,219,493.02"
,IN,AR,30334241,1005,100,,Invoice,,,,,,05/12/2018,05/12/2018,0.00,,11.22,,"-1,219,504.24"
,IN,AR,30334253,1005,100,,Invoice,,,,,,05/12/2018,05/12/2018,0.00,,17.80,,"-1,219,522.04"
,IN,AR,30334267,1005,100,,Invoice,,,,,,05/12/2018,05/12/2018,0.00,,11.19,,"-1,219,533.23"
,IN,AR,30334273,1005,100,,Invoice,,,,,,05/12/2018,05/12/2018,0.00,,1.88,,"-1,219,535.11"
,IN,AR,30334277,1005,100,,Invoice,,,,,,05/12/2018,05/12/2018,0.00,,18.09,,"-1,219,553.20"
,IN,AR,30334284,1005,100,,Invoice,,,,,,05/12/2018,05/12/2018,0.00,,10.93,,"-1,219,564.13"
,IN,AR,30334287,1005,100,,Invoice,,,,,,05/12/2018,05/12/2018,0.00,,14.58,,"-1,219,578.71"
,IN,AR,30334293,1005,100,,Invoice,,,,,,05/12/2018,05/12/2018,0.00,,22.37,,"-1,219,601.08"
,IN,AR,30334299,1005,100,,Invoice,,,,,,05/12/2018,05/12/2018,0.00,,7.29,,"-1,219,608.37"
,IN,AR,30334300,1005,100,,Invoice,,,,,,05/12/2018,05/12/2018,0.00,,10.17,,"-1,219,618.54"
,IN,AR,30334308,1005,100,,Invoice,,,,,,05/12/2018,05/12/2018,0.00,,16.00,,"-1,219,634.54"
,IN,AR,30334342,1005,100,,Invoice,,,,,,05/12/2018,05/12/2018,0.00,,5.17,,"-1,219,639.71"
,IN,AR,30334351,1005,100,,Invoice,,,,,,05/12/2018,05/12/2018,0.00,,9.28,,"-1,219,648.99"
,IN,AR,30334357,1005,100,,Invoice,,,,,,05/12/2018,05/12/2018,0.00,,8.33,,"-1,219,657.32"
,IN,AR,30334369,1005,100,,Invoice,,,,,,05/12/2018,05/12/2018,0.00,,18.05,,"-1,219,675.37"
,IN,AR,30334428,1005,100,,Invoice,,,,,,05/12/2018,05/12/2018,0.00,,18.05,,"-1,219,693.42"
,IN,AR,30334457,1005,100,,Invoice,,,,,,05/12/2018,05/12/2018,0.00,,7.75,,"-1,219,701.17"
,IN,AR,30334471,1005,100,,Invoice,,,,,,05/12/2018,05/12/2018,0.00,,8.00,,"-1,219,709.17"
,IN,AR,30334474,1005,100,,Invoice,,,,,,05/12/2018,05/12/2018,0.00,,32.80,,"-1,219,741.97"
,IN,AR,30334475,1005,100,,Invoice,,,,,,05/12/2018,05/12/2018,0.00,,29.15,,"-1,219,771.12"
,IN,AR,30334492,1005,100,,Invoice,,,,,,05/12/2018,05/12/2018,0.00,,2.84,,"-1,219,773.96"
,IN,AR,30334501,1005,100,,Invoice,,,,,,05/12/2018,05/12/2018,0.00,,10.17,,"-1,219,784.13"
,IN,AR,30334505,1005,100,,Invoice,,,,,,05/12/2018,05/12/2018,0.00,,7.29,,"-1,219,791.42"
,IN,AR,30334543,1005,100,,Invoice,,,,,,05/12/2018,05/12/2018,0.00,,2.01,,"-1,219,793.43"
,IN,AR,30334553,1005,100,,Invoice,,,,,,05/12/2018,05/12/2018,0.00,,20.00,,"-1,219,813.43"
,IN,AR,30334558,1005,100,,Invoice,,,,,,05/12/2018,05/12/2018,0.00,,7.29,,"-1,219,820.72"
,IN,AR,30334564,1005,100,,Invoice,,,,,,05/12/2018,05/12/2018,0.00,,32.07,,"-1,219,852.79"
,IN,AR,30334573,1005,100,,Invoice,,,,,,05/12/2018,05/12/2018,0.00,,7.29,,"-1,219,860.08"
,IN,AR,30334593,1005,100,,Invoice,,,,,,05/12/2018,05/12/2018,0.00,,21.61,,"-1,219,881.69"
,IN,AR,30334601,1005,100,,Invoice,,,,,,05/12/2018,05/12/2018,0.00,,14.58,,"-1,219,896.27"
,IN,AR,30334619,1005,100,,Invoice,,,,,,05/12/2018,05/12/2018,0.00,,6.56,,"-1,219,902.83"
,IN,AR,30334622,1005,100,,Invoice,,,,,,05/12/2018,05/12/2018,0.00,,5.09,,"-1,219,907.92"
,IN,AR,30334632,1005,100,,Invoice,,,,,,05/12/2018,05/12/2018,0.00,,33.63,,"-1,219,941.55"
,IN,AR,30334677,1005,100,,Invoice,,,,,,05/12/2018,05/12/2018,0.00,,12.00,,"-1,219,953.55"
,IN,AR,30334689,1005,100,,Invoice,,,,,,05/12/2018,05/12/2018,0.00,,39.75,,"-1,219,993.30"
,IN,AR,30334699,1005,100,,Invoice,,,,,,05/12/2018,05/12/2018,0.00,,5.83,,"-1,219,999.13"
,IN,AR,30334707,1005,100,,Invoice,,,,,,05/12/2018,05/12/2018,0.00,,10.52,,"-1,220,009.65"
,IN,AR,30334708,1005,100,,Invoice,,,,,,05/12/2018,05/12/2018,0.00,,8.41,,"-1,220,018.06"
,IN,AR,30334709,1005,100,,Invoice,,,,,,05/12/2018,05/12/2018,0.00,,16.82,,"-1,220,034.88"
,IN,AR,30334750,1005,100,,Invoice,,,,,,05/12/2018,05/12/2018,0.00,,14.03,,"-1,220,048.91"
,IN,AR,30334795,1005,100,,Invoice,,,,,,05/12/2018,05/12/2018,0.00,,7.12,,"-1,220,056.03"
,IN,AR,30334817,1005,100,,Invoice,,,,,,05/12/2018,05/12/2018,0.00,,7.29,,"-1,220,063.32"
,IN,AR,30334835,1005,100,,Invoice,,,,,,05/12/2018,05/12/2018,0.00,,3.19,,"-1,220,066.51"
,IN,AR,30334836,1005,100,,Invoice,,,,,,05/12/2018,05/12/2018,0.00,,79.66,,"-1,220,146.17"
,IN,AR,30334837,1005,100,,Invoice,,,,,,05/12/2018,05/12/2018,0.00,,6.37,,"-1,220,152.54"
,IN,AR,30334838,1005,100,,Invoice,,,,,,05/12/2018,05/12/2018,0.00,,4.78,,"-1,220,157.32"
,IN,AR,30334839,1005,100,,Invoice,,,,,,05/12/2018,05/12/2018,0.00,,1.59,,"-1,220,158.91"
,IN,AR,30334934,1005,100,,Invoice,,,,,,05/12/2018,05/12/2018,0.00,,5.26,,"-1,220,164.17"
,IN,AR,30334952,1005,100,,Invoice,,,,,,05/12/2018,05/12/2018,0.00,,14.19,,"-1,220,178.36"
,IN,AR,30334991,1005,100,,Invoice,,,,,,05/12/2018,05/12/2018,0.00,,7.53,,"-1,220,185.89"
,IN,AR,30335103,1005,100,,Invoice,,,,,,05/12/2018,05/12/2018,0.00,,13.73,,"-1,220,199.62"
,IN,AR,30335123,1005,100,,Invoice,,,,,,05/12/2018,05/12/2018,0.00,,60.21,,"-1,220,259.83"
,IN,AR,30335124,1005,100,,Invoice,,,,,,05/12/2018,05/12/2018,0.00,,6.23,,"-1,220,266.06"
,IN,AR,30335125,1005,100,,Invoice,,,,,,05/12/2018,05/12/2018,0.00,,12.46,,"-1,220,278.52"
,IN,AR,30335126,1005,100,,Invoice,,,,,,05/12/2018,05/12/2018,0.00,,26.99,,"-1,220,305.51"
,IN,AR,30335175,1005,100,,Invoice,,,,,,05/12/2018,05/12/2018,0.00,,27.31,,"-1,220,332.82"
,IN,AR,30335209,1005,100,,Invoice,,,,,,05/12/2018,05/12/2018,0.00,,29.15,,"-1,220,361.97"
,IN,AR,30335237,1005,100,,Invoice,,,,,,05/12/2018,05/12/2018,0.00,,29.15,,"-1,220,391.12"
,IN,AR,30335241,1005,100,,Invoice,,,,,,05/12/2018,05/12/2018,0.00,,27.97,,"-1,220,419.09"
,IN,AR,30335246,1005,100,,Invoice,,,,,,05/12/2018,05/12/2018,0.00,,14.58,,"-1,220,433.67"
,IN,AR,30335267,1005,100,,Invoice,,,,,,05/12/2018,05/12/2018,0.00,,21.86,,"-1,220,455.53"
,IN,AR,30335268,1005,100,,Invoice,,,,,,05/12/2018,05/12/2018,0.00,,7.29,,"-1,220,462.82"
,IN,AR,30335286,1005,100,,Invoice,,,,,,05/12/2018,05/12/2018,0.00,,7.29,,"-1,220,470.11"
,IN,AR,30335288,1005,100,,Invoice,,,,,,05/12/2018,05/12/2018,0.00,,10.78,,"-1,220,480.89"
,IN,AR,30335294,1005,100,,Invoice,,,,,,05/12/2018,05/12/2018,0.00,,10.93,,"-1,220,491.82"
,IN,AR,30335344,1005,100,,Invoice,,,,,,05/12/2018,05/12/2018,0.00,,3.64,,"-1,220,495.46"
,IN,AR,30335361,1005,100,,Invoice,,,,,,05/12/2018,05/12/2018,0.00,,7.29,,"-1,220,502.75"
,IN,AR,30335363,1005,100,,Invoice,,,,,,05/12/2018,05/12/2018,0.00,,47.84,,"-1,220,550.59"
,IN,AR,30335364,1005,100,,Invoice,,,,,,05/12/2018,05/12/2018,0.00,,17.94,,"-1,220,568.53"
,IN,AR,30335365,1005,100,,Invoice,,,,,,05/12/2018,05/12/2018,0.00,,35.88,,"-1,220,604.41"
,IN,AR,30335366,1005,100,,Invoice,,,,,,05/12/2018,05/12/2018,0.00,,11.96,,"-1,220,616.37"
,CN,AR,31019651,1005,100,,Credit Note,,,,,,06/12/2018,06/12/2018,2.75,,0.00,,"-1,220,613.62"
,CS,AR,32011748,1005,100,,Cash sale,,,,,,06/12/2018,06/12/2018,0.00,,21.06,,"-1,220,634.68"
,CS,AR,32011770,1005,100,,Cash sale,,,,,,06/12/2018,06/12/2018,0.00,,11.36,,"-1,220,646.04"
,CS,AR,32011779,1005,100,,Cash sale,,,,,,06/12/2018,06/12/2018,0.00,,7.29,,"-1,220,653.33"
,CS,AR,32011789,1005,100,,Cash sale,,,,,,06/12/2018,06/12/2018,0.00,,5.17,,"-1,220,658.50"
,CS,AR,32011790,1005,100,,Cash sale,,,,,,06/12/2018,06/12/2018,0.00,,8.42,,"-1,220,666.92"
,CS,AR,32011804,1005,100,,Cash sale,,,,,,06/12/2018,06/12/2018,0.00,,7.29,,"-1,220,674.21"
,CS,AR,32011824,1005,100,,Cash sale,,,,,,06/12/2018,06/12/2018,0.00,,7.29,,"-1,220,681.50"
,CS,AR,32011831,1005,100,,Cash sale,,,,,,06/12/2018,06/12/2018,0.00,,3.64,,"-1,220,685.14"
,CS,AR,32011852,1005,100,,Cash sale,,,,,,06/12/2018,06/12/2018,0.00,,14.58,,"-1,220,699.72"
,CS,AR,32011854,1005,100,,Cash sale,,,,,,06/12/2018,06/12/2018,0.00,,7.29,,"-1,220,707.01"
,CS,AR,32011920,1005,100,,Cash sale,,,,,,06/12/2018,06/12/2018,0.00,,7.29,,"-1,220,714.30"
,CS,AR,32011943,1005,100,,Cash sale,,,,,,06/12/2018,06/12/2018,0.00,,7.75,,"-1,220,722.05"
,CS,AR,32012057,1005,100,,Cash sale,,,,,,06/12/2018,06/12/2018,0.00,,16.53,,"-1,220,738.58"
,CS,AR,32012070,1005,100,,Cash sale,,,,,,06/12/2018,06/12/2018,0.00,,3.64,,"-1,220,742.22"
,CS,AR,32012075,1005,100,,Cash sale,,,,,,06/12/2018,06/12/2018,0.00,,3.64,,"-1,220,745.86"
,CS,AR,32012095,1005,100,,Cash sale,,,,,,06/12/2018,06/12/2018,0.00,,11.19,,"-1,220,757.05"
,CS,AR,32012117,1005,100,,Cash sale,,,,,,06/12/2018,06/12/2018,0.00,,12.88,,"-1,220,769.93"
,CS,AR,32012128,1005,100,,Cash sale,,,,,,06/12/2018,06/12/2018,0.00,,5.17,,"-1,220,775.10"
,CS,AR,32012201,1005,100,,Cash sale,,,,,,06/12/2018,06/12/2018,0.00,,2.58,,"-1,220,777.68"
,CS,AR,32012226,1005,100,,Cash sale,,,,,,06/12/2018,06/12/2018,0.00,,5.93,,"-1,220,783.61"
,CS,AR,32012245,1005,100,,Cash sale,,,,,,06/12/2018,06/12/2018,0.00,,7.29,,"-1,220,790.90"
,CS,AR,32012263,1005,100,,Cash sale,,,,,,06/12/2018,06/12/2018,0.00,,8.90,,"-1,220,799.80"
,CS,AR,32012265,1005,100,,Cash sale,,,,,,06/12/2018,06/12/2018,0.00,,21.86,,"-1,220,821.66"
,CS,AR,32012349,1005,100,,Cash sale,,,,,,06/12/2018,06/12/2018,0.00,,2.92,,"-1,220,824.58"
,CS,AR,32012373,1005,100,,Cash sale,,,,,,06/12/2018,06/12/2018,0.00,,7.29,,"-1,220,831.87"
,CS,AR,32012448,1005,100,,Cash sale,,,,,,06/12/2018,06/12/2018,0.00,,10.93,,"-1,220,842.80"
,CS,AR,32012471,1005,100,,Cash sale,,,,,,06/12/2018,06/12/2018,0.00,,7.29,,"-1,220,850.09"
,CS,AR,32012488,1005,100,,Cash sale,,,,,,06/12/2018,06/12/2018,0.00,,5.93,,"-1,220,856.02"
,CS,AR,32012499,1005,100,,Cash sale,,,,,,06/12/2018,06/12/2018,0.00,,10.93,,"-1,220,866.95"
,IN,AR,30333533,1005,100,,Invoice,,,,,,06/12/2018,06/12/2018,0.00,,3.64,,"-1,220,870.59"
,IN,AR,30333544,1005,100,,Invoice,,,,,,06/12/2018,06/12/2018,0.00,,14.58,,"-1,220,885.17"
,IN,AR,30333551,1005,100,,Invoice,,,,,,06/12/2018,06/12/2018,0.00,,7.29,,"-1,220,892.46"
,IN,AR,30333595,1005,100,,Invoice,,,,,,06/12/2018,06/12/2018,0.00,,3.64,,"-1,220,896.10"
,IN,AR,30333613,1005,100,,Invoice,,,,,,06/12/2018,06/12/2018,0.00,,10.93,,"-1,220,907.03"
,IN,AR,30333622,1005,100,,Invoice,,,,,,06/12/2018,06/12/2018,0.00,,16.27,,"-1,220,923.30"
,IN,AR,30333648,1005,100,,Invoice,,,,,,06/12/2018,06/12/2018,0.00,,3.98,,"-1,220,927.28"
,IN,AR,30333680,1005,100,,Invoice,,,,,,06/12/2018,06/12/2018,0.00,,42.00,,"-1,220,969.28"
,IN,AR,30333700,1005,100,,Invoice,,,,,,06/12/2018,06/12/2018,0.00,,7.29,,"-1,220,976.57"
,IN,AR,30333701,1005,100,,Invoice,,,,,,06/12/2018,06/12/2018,0.00,,40.08,,"-1,221,016.65"
,IN,AR,30333733,1005,100,,Invoice,,,,,,06/12/2018,06/12/2018,0.00,,10.93,,"-1,221,027.58"
,IN,AR,30333747,1005,100,,Invoice,,,,,,06/12/2018,06/12/2018,0.00,,21.86,,"-1,221,049.44"
,IN,AR,30333759,1005,100,,Invoice,,,,,,06/12/2018,06/12/2018,0.00,,18.98,,"-1,221,068.42"
,IN,AR,30333760,1005,100,,Invoice,,,,,,06/12/2018,06/12/2018,0.00,,47.46,,"-1,221,115.88"
,IN,AR,30333778,1005,100,,Invoice,,,,,,06/12/2018,06/12/2018,0.00,,32.95,,"-1,221,148.83"
,IN,AR,30333787,1005,100,,Invoice,,,,,,06/12/2018,06/12/2018,0.00,,17.03,,"-1,221,165.86"
,IN,AR,30333866,1005,100,,Invoice,,,,,,06/12/2018,06/12/2018,0.00,,14.58,,"-1,221,180.44"
,IN,AR,30333869,1005,100,,Invoice,,,,,,06/12/2018,06/12/2018,0.00,,10.93,,"-1,221,191.37"
,IN,AR,30333873,1005,100,,Invoice,,,,,,06/12/2018,06/12/2018,0.00,,24.50,,"-1,221,215.87"
,IN,AR,30333891,1005,100,,Invoice,,,,,,06/12/2018,06/12/2018,0.00,,6.02,,"-1,221,221.89"
,IN,AR,30333893,1005,100,,Invoice,,,,,,06/12/2018,06/12/2018,0.00,,2.40,,"-1,221,224.29"
,IN,AR,30333910,1005,100,,Invoice,,,,,,06/12/2018,06/12/2018,0.00,,54.66,,"-1,221,278.95"
,IN,AR,30333911,1005,100,,Invoice,,,,,,06/12/2018,06/12/2018,0.00,,6.02,,"-1,221,284.97"
,IN,AR,30333921,1005,100,,Invoice,,,,,,06/12/2018,06/12/2018,0.00,,52.88,,"-1,221,337.85"
,IN,AR,30333969,1005,100,,Invoice,,,,,,06/12/2018,06/12/2018,0.00,,19.12,,"-1,221,356.97"
,IN,AR,30333978,1005,100,,Invoice,,,,,,06/12/2018,06/12/2018,0.00,,9.56,,"-1,221,366.53"
,IN,AR,30333986,1005,100,,Invoice,,,,,,06/12/2018,06/12/2018,0.00,,18.64,,"-1,221,385.17"
,IN,AR,30334002,1005,100,,Invoice,,,,,,06/12/2018,06/12/2018,0.00,,83.90,,"-1,221,469.07"
,IN,AR,30334003,1005,100,,Invoice,,,,,,06/12/2018,06/12/2018,0.00,,7.63,,"-1,221,476.70"
,IN,AR,30334017,1005,100,,Invoice,,,,,,06/12/2018,06/12/2018,0.00,,19.12,,"-1,221,495.82"
,IN,AR,30334035,1005,100,,Invoice,,,,,,06/12/2018,06/12/2018,0.00,,12.88,,"-1,221,508.70"
,IN,AR,30334077,1005,100,,Invoice,,,,,,06/12/2018,06/12/2018,0.00,,8.47,,"-1,221,517.17"
,IN,AR,30334115,1005,100,,Invoice,,,,,,06/12/2018,06/12/2018,0.00,,5.17,,"-1,221,522.34"
,IN,AR,30334126,1005,100,,Invoice,,,,,,06/12/2018,06/12/2018,0.00,,3.43,,"-1,221,525.77"
,IN,AR,30334135,1005,100,,Invoice,,,,,,06/12/2018,06/12/2018,0.00,,6.36,,"-1,221,532.13"
,IN,AR,30334144,1005,100,,Invoice,,,,,,06/12/2018,06/12/2018,0.00,,32.80,,"-1,221,564.93"
,IN,AR,30334160,1005,100,,Invoice,,,,,,06/12/2018,06/12/2018,0.00,,17.50,,"-1,221,582.43"
,IN,AR,30334171,1005,100,,Invoice,,,,,,06/12/2018,06/12/2018,0.00,,10.93,,"-1,221,593.36"
,IN,AR,30334234,1005,100,,Invoice,,,,,,06/12/2018,06/12/2018,0.00,,8.24,,"-1,221,601.60"
,IN,AR,30334254,1005,100,,Invoice,,,,,,06/12/2018,06/12/2018,0.00,,26.69,,"-1,221,628.29"
,IN,AR,30334304,1005,100,,Invoice,,,,,,06/12/2018,06/12/2018,0.00,,21.86,,"-1,221,650.15"
,IN,AR,30334320,1005,100,,Invoice,,,,,,06/12/2018,06/12/2018,0.00,,4.64,,"-1,221,654.79"
,IN,AR,30334326,1005,100,,Invoice,,,,,,06/12/2018,06/12/2018,0.00,,5.85,,"-1,221,660.64"
,IN,AR,30334329,1005,100,,Invoice,,,,,,06/12/2018,06/12/2018,0.00,,21.86,,"-1,221,682.50"
,IN,AR,30334334,1005,100,,Invoice,,,,,,06/12/2018,06/12/2018,0.00,,22.03,,"-1,221,704.53"
,IN,AR,30334349,1005,100,,Invoice,,,,,,06/12/2018,06/12/2018,0.00,,5.68,,"-1,221,710.21"
,IN,AR,30334374,1005,100,,Invoice,,,,,,06/12/2018,06/12/2018,0.00,,6.02,,"-1,221,716.23"
,IN,AR,30334378,1005,100,,Invoice,,,,,,06/12/2018,06/12/2018,0.00,,6.07,,"-1,221,722.30"
,IN,AR,30334379,1005,100,,Invoice,,,,,,06/12/2018,06/12/2018,0.00,,5.49,,"-1,221,727.79"
,IN,AR,30334383,1005,100,,Invoice,,,,,,06/12/2018,06/12/2018,0.00,,13.58,,"-1,221,741.37"
,IN,AR,30334387,1005,100,,Invoice,,,,,,06/12/2018,06/12/2018,0.00,,5.08,,"-1,221,746.45"
,IN,AR,30334396,1005,100,,Invoice,,,,,,06/12/2018,06/12/2018,0.00,,22.71,,"-1,221,769.16"
,IN,AR,30334400,1005,100,,Invoice,,,,,,06/12/2018,06/12/2018,0.00,,15.04,,"-1,221,784.20"
,IN,AR,30334402,1005,100,,Invoice,,,,,,06/12/2018,06/12/2018,0.00,,12.00,,"-1,221,796.20"
,IN,AR,30334412,1005,100,,Invoice,,,,,,06/12/2018,06/12/2018,0.00,,10.68,,"-1,221,806.88"
,IN,AR,30334417,1005,100,,Invoice,,,,,,06/12/2018,06/12/2018,0.00,,1.76,,"-1,221,808.64"
,IN,AR,30334435,1005,100,,Invoice,,,,,,06/12/2018,06/12/2018,0.00,,10.93,,"-1,221,819.57"
,IN,AR,30334443,1005,100,,Invoice,,,,,,06/12/2018,06/12/2018,0.00,,9.08,,"-1,221,828.65"
,IN,AR,30334465,1005,100,,Invoice,,,,,,06/12/2018,06/12/2018,0.00,,7.86,,"-1,221,836.51"
,IN,AR,30334468,1005,100,,Invoice,,,,,,06/12/2018,06/12/2018,0.00,,5.86,,"-1,221,842.37"
,IN,AR,30334500,1005,100,,Invoice,,,,,,06/12/2018,06/12/2018,0.00,,14.58,,"-1,221,856.95"
,IN,AR,30334507,1005,100,,Invoice,,,,,,06/12/2018,06/12/2018,0.00,,14.58,,"-1,221,871.53"
,IN,AR,30334509,1005,100,,Invoice,,,,,,06/12/2018,06/12/2018,0.00,,13.94,,"-1,221,885.47"
,IN,AR,30334510,1005,100,,Invoice,,,,,,06/12/2018,06/12/2018,0.00,,19.92,,"-1,221,905.39"
,IN,AR,30334511,1005,100,,Invoice,,,,,,06/12/2018,06/12/2018,0.00,,3.98,,"-1,221,909.37"
,IN,AR,30334512,1005,100,,Invoice,,,,,,06/12/2018,06/12/2018,0.00,,39.83,,"-1,221,949.20"
,IN,AR,30334526,1005,100,,Invoice,,,,,,06/12/2018,06/12/2018,0.00,,13.93,,"-1,221,963.13"
,IN,AR,30334584,1005,100,,Invoice,,,,,,06/12/2018,06/12/2018,0.00,,3.64,,"-1,221,966.77"
,IN,AR,30334628,1005,100,,Invoice,,,,,,06/12/2018,06/12/2018,0.00,,14.58,,"-1,221,981.35"
,IN,AR,30334648,1005,100,,Invoice,,,,,,06/12/2018,06/12/2018,0.00,,22.88,,"-1,222,004.23"
,IN,AR,30334659,1005,100,,Invoice,,,,,,06/12/2018,06/12/2018,0.00,,22.01,,"-1,222,026.24"
,IN,AR,30334672,1005,100,,Invoice,,,,,,06/12/2018,06/12/2018,0.00,,22.01,,"-1,222,048.25"
,IN,AR,30334681,1005,100,,Invoice,,,,,,06/12/2018,06/12/2018,0.00,,11.66,,"-1,222,059.91"
,IN,AR,30334682,1005,100,,Invoice,,,,,,06/12/2018,06/12/2018,0.00,,14.58,,"-1,222,074.49"
,IN,AR,30334732,1005,100,,Invoice,,,,,,06/12/2018,06/12/2018,0.00,,18.22,,"-1,222,092.71"
,IN,AR,30334751,1005,100,,Invoice,,,,,,06/12/2018,06/12/2018,0.00,,11.22,,"-1,222,103.93"
,IN,AR,30334763,1005,100,,Invoice,,,,,,06/12/2018,06/12/2018,0.00,,27.46,,"-1,222,131.39"
,IN,AR,30334766,1005,100,,Invoice,,,,,,06/12/2018,06/12/2018,0.00,,14.58,,"-1,222,145.97"
,IN,AR,30334782,1005,100,,Invoice,,,,,,06/12/2018,06/12/2018,0.00,,9.10,,"-1,222,155.07"
,IN,AR,30334832,1005,100,,Invoice,,,,,,06/12/2018,06/12/2018,0.00,,81.15,,"-1,222,236.22"
,IN,AR,30334840,1005,100,,Invoice,,,,,,06/12/2018,06/12/2018,0.00,,7.97,,"-1,222,244.19"
,IN,AR,30334841,1005,100,,Invoice,,,,,,06/12/2018,06/12/2018,0.00,,14.34,,"-1,222,258.53"
,IN,AR,30334842,1005,100,,Invoice,,,,,,06/12/2018,06/12/2018,0.00,,9.56,,"-1,222,268.09"
,IN,AR,30334869,1005,100,,Invoice,,,,,,06/12/2018,06/12/2018,0.00,,80.69,,"-1,222,348.78"
,IN,AR,30334885,1005,100,,Invoice,,,,,,06/12/2018,06/12/2018,0.00,,20.34,,"-1,222,369.12"
,IN,AR,30334940,1005,100,,Invoice,,,,,,06/12/2018,06/12/2018,0.00,,8.26,,"-1,222,377.38"
,IN,AR,30334967,1005,100,,Invoice,,,,,,06/12/2018,06/12/2018,0.00,,11.66,,"-1,222,389.04"
,IN,AR,30335058,1005,100,,Invoice,,,,,,06/12/2018,06/12/2018,0.00,,6.13,,"-1,222,395.17"
,IN,AR,30335127,1005,100,,Invoice,,,,,,06/12/2018,06/12/2018,0.00,,2.08,,"-1,222,397.25"
,IN,AR,30335128,1005,100,,Invoice,,,,,,06/12/2018,06/12/2018,0.00,,6.23,,"-1,222,403.48"
,IN,AR,30335129,1005,100,,Invoice,,,,,,06/12/2018,06/12/2018,0.00,,10.38,,"-1,222,413.86"
,IN,AR,30335161,1005,100,,Invoice,,,,,,06/12/2018,06/12/2018,0.00,,7.29,,"-1,222,421.15"
,IN,AR,30335192,1005,100,,Invoice,,,,,,06/12/2018,06/12/2018,0.00,,14.58,,"-1,222,435.73"
,IN,AR,30335198,1005,100,,Invoice,,,,,,06/12/2018,06/12/2018,0.00,,10.93,,"-1,222,446.66"
,IN,AR,30335199,1005,100,,Invoice,,,,,,06/12/2018,06/12/2018,0.00,,4.07,,"-1,222,450.73"
,IN,AR,30335231,1005,100,,Invoice,,,,,,06/12/2018,06/12/2018,0.00,,8.41,,"-1,222,459.14"
,IN,AR,30335240,1005,100,,Invoice,,,,,,06/12/2018,06/12/2018,0.00,,7.29,,"-1,222,466.43"
,IN,AR,30335249,1005,100,,Invoice,,,,,,06/12/2018,06/12/2018,0.00,,91.02,,"-1,222,557.45"
,IN,AR,30335296,1005,100,,Invoice,,,,,,06/12/2018,06/12/2018,0.00,,6.08,,"-1,222,563.53"
,IN,AR,30335328,1005,100,,Invoice,,,,,,06/12/2018,06/12/2018,0.00,,21.86,,"-1,222,585.39"
,IN,AR,30335347,1005,100,,Invoice,,,,,,06/12/2018,06/12/2018,0.00,,14.58,,"-1,222,599.97"
,CS,AR,32011763,1005,100,,Cash sale,,,,,,07/12/2018,07/12/2018,0.00,,9.49,,"-1,222,609.46"
,CS,AR,32011776,1005,100,,Cash sale,,,,,,07/12/2018,07/12/2018,0.00,,6.08,,"-1,222,615.54"
,CS,AR,32011805,1005,100,,Cash sale,,,,,,07/12/2018,07/12/2018,0.00,,7.29,,"-1,222,622.83"
,CS,AR,32011808,1005,100,,Cash sale,,,,,,07/12/2018,07/12/2018,0.00,,3.64,,"-1,222,626.47"
,CS,AR,32011810,1005,100,,Cash sale,,,,,,07/12/2018,07/12/2018,0.00,,10.93,,"-1,222,637.40"
,CS,AR,32011826,1005,100,,Cash sale,,,,,,07/12/2018,07/12/2018,0.00,,9.66,,"-1,222,647.06"
,CS,AR,32011840,1005,100,,Cash sale,,,,,,07/12/2018,07/12/2018,0.00,,7.29,,"-1,222,654.35"
,CS,AR,32011844,1005,100,,Cash sale,,,,,,07/12/2018,07/12/2018,0.00,,12.46,,"-1,222,666.81"
,CS,AR,32011853,1005,100,,Cash sale,,,,,,07/12/2018,07/12/2018,0.00,,10.93,,"-1,222,677.74"
,CS,AR,32011855,1005,100,,Cash sale,,,,,,07/12/2018,07/12/2018,0.00,,3.64,,"-1,222,681.38"
,CS,AR,32011862,1005,100,,Cash sale,,,,,,07/12/2018,07/12/2018,0.00,,10.93,,"-1,222,692.31"
,CS,AR,32011864,1005,100,,Cash sale,,,,,,07/12/2018,07/12/2018,0.00,,3.89,,"-1,222,696.20"
,CS,AR,32011870,1005,100,,Cash sale,,,,,,07/12/2018,07/12/2018,0.00,,3.64,,"-1,222,699.84"
,CS,AR,32011883,1005,100,,Cash sale,,,,,,07/12/2018,07/12/2018,0.00,,8.39,,"-1,222,708.23"
,CS,AR,32011887,1005,100,,Cash sale,,,,,,07/12/2018,07/12/2018,0.00,,33.64,,"-1,222,741.87"
,CS,AR,32011893,1005,100,,Cash sale,,,,,,07/12/2018,07/12/2018,0.00,,3.64,,"-1,222,745.51"
,CS,AR,32011895,1005,100,,Cash sale,,,,,,07/12/2018,07/12/2018,0.00,,7.29,,"-1,222,752.80"
,CS,AR,32011929,1005,100,,Cash sale,,,,,,07/12/2018,07/12/2018,0.00,,2.58,,"-1,222,755.38"
,CS,AR,32011935,1005,100,,Cash sale,,,,,,07/12/2018,07/12/2018,0.00,,5.08,,"-1,222,760.46"
,CS,AR,32011954,1005,100,,Cash sale,,,,,,07/12/2018,07/12/2018,0.00,,3.64,,"-1,222,764.10"
,CS,AR,32011964,1005,100,,Cash sale,,,,,,07/12/2018,07/12/2018,0.00,,27.47,,"-1,222,791.57"
,CS,AR,32011972,1005,100,,Cash sale,,,,,,07/12/2018,07/12/2018,0.00,,10.99,,"-1,222,802.56"
,CS,AR,32012011,1005,100,,Cash sale,,,,,,07/12/2018,07/12/2018,0.00,,14.62,,"-1,222,817.18"
,CS,AR,32012029,1005,100,,Cash sale,,,,,,07/12/2018,07/12/2018,0.00,,24.07,,"-1,222,841.25"
,CS,AR,32012038,1005,100,,Cash sale,,,,,,07/12/2018,07/12/2018,0.00,,10.17,,"-1,222,851.42"
,CS,AR,32012047,1005,100,,Cash sale,,,,,,07/12/2018,07/12/2018,0.00,,3.64,,"-1,222,855.06"
,CS,AR,32012060,1005,100,,Cash sale,,,,,,07/12/2018,07/12/2018,0.00,,3.64,,"-1,222,858.70"
,CS,AR,32012064,1005,100,,Cash sale,,,,,,07/12/2018,07/12/2018,0.00,,15.25,,"-1,222,873.95"
,CS,AR,32012065,1005,100,,Cash sale,,,,,,07/12/2018,07/12/2018,0.00,,21.86,,"-1,222,895.81"
,CS,AR,32012066,1005,100,,Cash sale,,,,,,07/12/2018,07/12/2018,0.00,,14.58,,"-1,222,910.39"
,CS,AR,32012081,1005,100,,Cash sale,,,,,,07/12/2018,07/12/2018,0.00,,3.64,,"-1,222,914.03"
,CS,AR,32012110,1005,100,,Cash sale,,,,,,07/12/2018,07/12/2018,0.00,,14.58,,"-1,222,928.61"
,CS,AR,32012121,1005,100,,Cash sale,,,,,,07/12/2018,07/12/2018,0.00,,17.56,,"-1,222,946.17"
,CS,AR,32012140,1005,100,,Cash sale,,,,,,07/12/2018,07/12/2018,0.00,,3.64,,"-1,222,949.81"
,CS,AR,32012149,1005,100,,Cash sale,,,,,,07/12/2018,07/12/2018,0.00,,5.56,,"-1,222,955.37"
,CS,AR,32012161,1005,100,,Cash sale,,,,,,07/12/2018,07/12/2018,0.00,,3.64,,"-1,222,959.01"
,CS,AR,32012186,1005,100,,Cash sale,,,,,,07/12/2018,07/12/2018,0.00,,20.34,,"-1,222,979.35"
,CS,AR,32012198,1005,100,,Cash sale,,,,,,07/12/2018,07/12/2018,0.00,,8.16,,"-1,222,987.51"
,CS,AR,32012205,1005,100,,Cash sale,,,,,,07/12/2018,07/12/2018,0.00,,3.64,,"-1,222,991.15"
,CS,AR,32012208,1005,100,,Cash sale,,,,,,07/12/2018,07/12/2018,0.00,,3.64,,"-1,222,994.79"
,CS,AR,32012225,1005,100,,Cash sale,,,,,,07/12/2018,07/12/2018,0.00,,10.17,,"-1,223,004.96"
,CS,AR,32012239,1005,100,,Cash sale,,,,,,07/12/2018,07/12/2018,0.00,,2.54,,"-1,223,007.50"
,CS,AR,32012250,1005,100,,Cash sale,,,,,,07/12/2018,07/12/2018,0.00,,4.58,,"-1,223,012.08"
,CS,AR,32012259,1005,100,,Cash sale,,,,,,07/12/2018,07/12/2018,0.00,,10.93,,"-1,223,023.01"
,CS,AR,32012269,1005,100,,Cash sale,,,,,,07/12/2018,07/12/2018,0.00,,17.80,,"-1,223,040.81"
,CS,AR,32012290,1005,100,,Cash sale,,,,,,07/12/2018,07/12/2018,0.00,,10.93,,"-1,223,051.74"
,CS,AR,32012291,1005,100,,Cash sale,,,,,,07/12/2018,07/12/2018,0.00,,15.25,,"-1,223,066.99"
,CS,AR,32012295,1005,100,,Cash sale,,,,,,07/12/2018,07/12/2018,0.00,,10.93,,"-1,223,077.92"
,CS,AR,32012303,1005,100,,Cash sale,,,,,,07/12/2018,07/12/2018,0.00,,5.08,,"-1,223,083.00"
,CS,AR,32012305,1005,100,,Cash sale,,,,,,07/12/2018,07/12/2018,0.00,,3.64,,"-1,223,086.64"
,CS,AR,32012308,1005,100,,Cash sale,,,,,,07/12/2018,07/12/2018,0.00,,9.10,,"-1,223,095.74"
,CS,AR,32012312,1005,100,,Cash sale,,,,,,07/12/2018,07/12/2018,0.00,,9.15,,"-1,223,104.89"
,CS,AR,32012319,1005,100,,Cash sale,,,,,,07/12/2018,07/12/2018,0.00,,29.15,,"-1,223,134.04"
,CS,AR,32012325,1005,100,,Cash sale,,,,,,07/12/2018,07/12/2018,0.00,,3.04,,"-1,223,137.08"
,CS,AR,32012329,1005,100,,Cash sale,,,,,,07/12/2018,07/12/2018,0.00,,7.29,,"-1,223,144.37"
,CS,AR,32012352,1005,100,,Cash sale,,,,,,07/12/2018,07/12/2018,0.00,,3.64,,"-1,223,148.01"
,CS,AR,32012362,1005,100,,Cash sale,,,,,,07/12/2018,07/12/2018,0.00,,7.29,,"-1,223,155.30"
,CS,AR,32012378,1005,100,,Cash sale,,,,,,07/12/2018,07/12/2018,0.00,,2.97,,"-1,223,158.27"
,CS,AR,32012399,1005,100,,Cash sale,,,,,,07/12/2018,07/12/2018,0.00,,7.29,,"-1,223,165.56"
,CS,AR,32012446,1005,100,,Cash sale,,,,,,07/12/2018,07/12/2018,0.00,,6.07,,"-1,223,171.63"
,CS,AR,32012474,1005,100,,Cash sale,,,,,,07/12/2018,07/12/2018,0.00,,7.29,,"-1,223,178.92"
,CS,AR,32012489,1005,100,,Cash sale,,,,,,07/12/2018,07/12/2018,0.00,,2.97,,"-1,223,181.89"
,CS,AR,32012500,1005,100,,Cash sale,,,,,,07/12/2018,07/12/2018,0.00,,3.64,,"-1,223,185.53"
,CS,AR,32012501,1005,100,,Cash sale,,,,,,07/12/2018,07/12/2018,0.00,,10.93,,"-1,223,196.46"
,IN,AR,30333519,1005,100,,Invoice,,,,,,07/12/2018,07/12/2018,0.00,,84.54,,"-1,223,281.00"
,IN,AR,30333521,1005,100,,Invoice,,,,,,07/12/2018,07/12/2018,0.00,,53.39,,"-1,223,334.39"
,IN,AR,30333531,1005,100,,Invoice,,,,,,07/12/2018,07/12/2018,0.00,,18.22,,"-1,223,352.61"
,IN,AR,30333541,1005,100,,Invoice,,,,,,07/12/2018,07/12/2018,0.00,,11.19,,"-1,223,363.80"
,IN,AR,30333608,1005,100,,Invoice,,,,,,07/12/2018,07/12/2018,0.00,,24.15,,"-1,223,387.95"
,IN,AR,30333621,1005,100,,Invoice,,,,,,07/12/2018,07/12/2018,0.00,,3.64,,"-1,223,391.59"
,IN,AR,30333626,1005,100,,Invoice,,,,,,07/12/2018,07/12/2018,0.00,,44.38,,"-1,223,435.97"
,IN,AR,30333636,1005,100,,Invoice,,,,,,07/12/2018,07/12/2018,0.00,,9.19,,"-1,223,445.16"
,IN,AR,30333640,1005,100,,Invoice,,,,,,07/12/2018,07/12/2018,0.00,,67.92,,"-1,223,513.08"
,IN,AR,30333657,1005,100,,Invoice,,,,,,07/12/2018,07/12/2018,0.00,,54.00,,"-1,223,567.08"
,IN,AR,30333673,1005,100,,Invoice,,,,,,07/12/2018,07/12/2018,0.00,,10.93,,"-1,223,578.01"
,IN,AR,30333719,1005,100,,Invoice,,,,,,07/12/2018,07/12/2018,0.00,,28.00,,"-1,223,606.01"
,IN,AR,30333761,1005,100,,Invoice,,,,,,07/12/2018,07/12/2018,0.00,,4.75,,"-1,223,610.76"
,IN,AR,30333766,1005,100,,Invoice,,,,,,07/12/2018,07/12/2018,0.00,,12.00,,"-1,223,622.76"
,IN,AR,30333805,1005,100,,Invoice,,,,,,07/12/2018,07/12/2018,0.00,,11.64,,"-1,223,634.40"
,IN,AR,30333806,1005,100,,Invoice,,,,,,07/12/2018,07/12/2018,0.00,,7.76,,"-1,223,642.16"
,IN,AR,30333818,1005,100,,Invoice,,,,,,07/12/2018,07/12/2018,0.00,,34.00,,"-1,223,676.16"
,IN,AR,30333824,1005,100,,Invoice,,,,,,07/12/2018,07/12/2018,0.00,,3.64,,"-1,223,679.80"
,IN,AR,30333837,1005,100,,Invoice,,,,,,07/12/2018,07/12/2018,0.00,,29.15,,"-1,223,708.95"
,IN,AR,30333842,1005,100,,Invoice,,,,,,07/12/2018,07/12/2018,0.00,,8.39,,"-1,223,717.34"
,IN,AR,30333879,1005,100,,Invoice,,,,,,07/12/2018,07/12/2018,0.00,,10.34,,"-1,223,727.68"
,IN,AR,30333902,1005,100,,Invoice,,,,,,07/12/2018,07/12/2018,0.00,,14.58,,"-1,223,742.26"
,IN,AR,30333906,1005,100,,Invoice,,,,,,07/12/2018,07/12/2018,0.00,,38.14,,"-1,223,780.40"
,IN,AR,30333938,1005,100,,Invoice,,,,,,07/12/2018,07/12/2018,0.00,,21.86,,"-1,223,802.26"
,IN,AR,30333939,1005,100,,Invoice,,,,,,07/12/2018,07/12/2018,0.00,,18.22,,"-1,223,820.48"
,IN,AR,30333944,1005,100,,Invoice,,,,,,07/12/2018,07/12/2018,0.00,,20.68,,"-1,223,841.16"
,IN,AR,30333950,1005,100,,Invoice,,,,,,07/12/2018,07/12/2018,0.00,,4.78,,"-1,223,845.94"
,IN,AR,30333973,1005,100,,Invoice,,,,,,07/12/2018,07/12/2018,0.00,,9.03,,"-1,223,854.97"
,IN,AR,30333991,1005,100,,Invoice,,,,,,07/12/2018,07/12/2018,0.00,,38.97,,"-1,223,893.94"
,IN,AR,30334018,1005,100,,Invoice,,,,,,07/12/2018,07/12/2018,0.00,,7.17,,"-1,223,901.11"
,IN,AR,30334042,1005,100,,Invoice,,,,,,07/12/2018,07/12/2018,0.00,,3.01,,"-1,223,904.12"
,IN,AR,30334043,1005,100,,Invoice,,,,,,07/12/2018,07/12/2018,0.00,,6.02,,"-1,223,910.14"
,IN,AR,30334058,1005,100,,Invoice,,,,,,07/12/2018,07/12/2018,0.00,,12.03,,"-1,223,922.17"
,IN,AR,30334065,1005,100,,Invoice,,,,,,07/12/2018,07/12/2018,0.00,,7.75,,"-1,223,929.92"
,IN,AR,30334081,1005,100,,Invoice,,,,,,07/12/2018,07/12/2018,0.00,,364.41,,"-1,224,294.33"
,IN,AR,30334084,1005,100,,Invoice,,,,,,07/12/2018,07/12/2018,0.00,,7.63,,"-1,224,301.96"
,IN,AR,30334085,1005,100,,Invoice,,,,,,07/12/2018,07/12/2018,0.00,,7.63,,"-1,224,309.59"
,IN,AR,30334086,1005,100,,Invoice,,,,,,07/12/2018,07/12/2018,0.00,,5.08,,"-1,224,314.67"
,IN,AR,30334087,1005,100,,Invoice,,,,,,07/12/2018,07/12/2018,0.00,,10.17,,"-1,224,324.84"
,IN,AR,30334102,1005,100,,Invoice,,,,,,07/12/2018,07/12/2018,0.00,,2.54,,"-1,224,327.38"
,IN,AR,30334128,1005,100,,Invoice,,,,,,07/12/2018,07/12/2018,0.00,,17.80,,"-1,224,345.18"
,IN,AR,30334133,1005,100,,Invoice,,,,,,07/12/2018,07/12/2018,0.00,,6.36,,"-1,224,351.54"
,IN,AR,30334146,1005,100,,Invoice,,,,,,07/12/2018,07/12/2018,0.00,,10.93,,"-1,224,362.47"
,IN,AR,30334175,1005,100,,Invoice,,,,,,07/12/2018,07/12/2018,0.00,,1.65,,"-1,224,364.12"
,IN,AR,30334183,1005,100,,Invoice,,,,,,07/12/2018,07/12/2018,0.00,,12.71,,"-1,224,376.83"
,IN,AR,30334206,1005,100,,Invoice,,,,,,07/12/2018,07/12/2018,0.00,,4.24,,"-1,224,381.07"
,IN,AR,30334208,1005,100,,Invoice,,,,,,07/12/2018,07/12/2018,0.00,,6.36,,"-1,224,387.43"
,IN,AR,30334242,1005,100,,Invoice,,,,,,07/12/2018,07/12/2018,0.00,,14.03,,"-1,224,401.46"
,IN,AR,30334263,1005,100,,Invoice,,,,,,07/12/2018,07/12/2018,0.00,,6.02,,"-1,224,407.48"
,IN,AR,30334343,1005,100,,Invoice,,,,,,07/12/2018,07/12/2018,0.00,,12.92,,"-1,224,420.40"
,IN,AR,30334384,1005,100,,Invoice,,,,,,07/12/2018,07/12/2018,0.00,,1.94,,"-1,224,422.34"
,IN,AR,30334408,1005,100,,Invoice,,,,,,07/12/2018,07/12/2018,0.00,,42.88,,"-1,224,465.22"
,IN,AR,30334440,1005,100,,Invoice,,,,,,07/12/2018,07/12/2018,0.00,,4.85,,"-1,224,470.07"
,IN,AR,30334445,1005,100,,Invoice,,,,,,07/12/2018,07/12/2018,0.00,,5.49,,"-1,224,475.56"
,IN,AR,30334461,1005,100,,Invoice,,,,,,07/12/2018,07/12/2018,0.00,,21.86,,"-1,224,497.42"
,IN,AR,30334527,1005,100,,Invoice,,,,,,07/12/2018,07/12/2018,0.00,,23.88,,"-1,224,521.30"
,IN,AR,30334547,1005,100,,Invoice,,,,,,07/12/2018,07/12/2018,0.00,,39.75,,"-1,224,561.05"
,IN,AR,30334556,1005,100,,Invoice,,,,,,07/12/2018,07/12/2018,0.00,,36.00,,"-1,224,597.05"
,IN,AR,30334559,1005,100,,Invoice,,,,,,07/12/2018,07/12/2018,0.00,,26.19,,"-1,224,623.24"
,IN,AR,30334574,1005,100,,Invoice,,,,,,07/12/2018,07/12/2018,0.00,,18.22,,"-1,224,641.46"
,IN,AR,30334583,1005,100,,Invoice,,,,,,07/12/2018,07/12/2018,0.00,,8.21,,"-1,224,649.67"
,IN,AR,30334589,1005,100,,Invoice,,,,,,07/12/2018,07/12/2018,0.00,,3.01,,"-1,224,652.68"
,IN,AR,30334594,1005,100,,Invoice,,,,,,07/12/2018,07/12/2018,0.00,,8.64,,"-1,224,661.32"
,IN,AR,30334604,1005,100,,Invoice,,,,,,07/12/2018,07/12/2018,0.00,,7.29,,"-1,224,668.61"
,IN,AR,30334608,1005,100,,Invoice,,,,,,07/12/2018,07/12/2018,0.00,,21.02,,"-1,224,689.63"
,IN,AR,30334635,1005,100,,Invoice,,,,,,07/12/2018,07/12/2018,0.00,,9.56,,"-1,224,699.19"
,IN,AR,30334649,1005,100,,Invoice,,,,,,07/12/2018,07/12/2018,0.00,,12.71,,"-1,224,711.90"
,IN,AR,30334675,1005,100,,Invoice,,,,,,07/12/2018,07/12/2018,0.00,,6.00,,"-1,224,717.90"
,IN,AR,30334702,1005,100,,Invoice,,,,,,07/12/2018,07/12/2018,0.00,,10.93,,"-1,224,728.83"
,IN,AR,30334704,1005,100,,Invoice,,,,,,07/12/2018,07/12/2018,0.00,,27.37,,"-1,224,756.20"
,IN,AR,30334710,1005,100,,Invoice,,,,,,07/12/2018,07/12/2018,0.00,,12.62,,"-1,224,768.82"
,IN,AR,30334711,1005,100,,Invoice,,,,,,07/12/2018,07/12/2018,0.00,,21.03,,"-1,224,789.85"
,IN,AR,30334724,1005,100,,Invoice,,,,,,07/12/2018,07/12/2018,0.00,,4.66,,"-1,224,794.51"
,IN,AR,30334731,1005,100,,Invoice,,,,,,07/12/2018,07/12/2018,0.00,,14.58,,"-1,224,809.09"
,IN,AR,30334734,1005,100,,Invoice,,,,,,07/12/2018,07/12/2018,0.00,,7.29,,"-1,224,816.38"
,IN,AR,30334759,1005,100,,Invoice,,,,,,07/12/2018,07/12/2018,0.00,,4.59,,"-1,224,820.97"
,IN,AR,30334819,1005,100,,Invoice,,,,,,07/12/2018,07/12/2018,0.00,,10.93,,"-1,224,831.90"
,IN,AR,30334825,1005,100,,Invoice,,,,,,07/12/2018,07/12/2018,0.00,,19.87,,"-1,224,851.77"
,IN,AR,30334827,1005,100,,Invoice,,,,,,07/12/2018,07/12/2018,0.00,,19.32,,"-1,224,871.09"
,IN,AR,30334866,1005,100,,Invoice,,,,,,07/12/2018,07/12/2018,0.00,,10.93,,"-1,224,882.02"
,IN,AR,30334867,1005,100,,Invoice,,,,,,07/12/2018,07/12/2018,0.00,,56.53,,"-1,224,938.55"
,IN,AR,30334921,1005,100,,Invoice,,,,,,07/12/2018,07/12/2018,0.00,,8.00,,"-1,224,946.55"
,IN,AR,30334944,1005,100,,Invoice,,,,,,07/12/2018,07/12/2018,0.00,,10.93,,"-1,224,957.48"
,IN,AR,30334953,1005,100,,Invoice,,,,,,07/12/2018,07/12/2018,0.00,,29.15,,"-1,224,986.63"
,IN,AR,30334966,1005,100,,Invoice,,,,,,07/12/2018,07/12/2018,0.00,,8.75,,"-1,224,995.38"
,IN,AR,30334974,1005,100,,Invoice,,,,,,07/12/2018,07/12/2018,0.00,,8.21,,"-1,225,003.59"
,IN,AR,30334986,1005,100,,Invoice,,,,,,07/12/2018,07/12/2018,0.00,,33.90,,"-1,225,037.49"
,IN,AR,30335037,1005,100,,Invoice,,,,,,07/12/2018,07/12/2018,0.00,,7.29,,"-1,225,044.78"
,IN,AR,30335051,1005,100,,Invoice,,,,,,07/12/2018,07/12/2018,0.00,,8.17,,"-1,225,052.95"
,IN,AR,30335084,1005,100,,Invoice,,,,,,07/12/2018,07/12/2018,0.00,,5.51,,"-1,225,058.46"
,IN,AR,30335089,1005,100,,Invoice,,,,,,07/12/2018,07/12/2018,0.00,,11.95,,"-1,225,070.41"
,IN,AR,30335101,1005,100,,Invoice,,,,,,07/12/2018,07/12/2018,0.00,,5.83,,"-1,225,076.24"
,IN,AR,30335113,1005,100,,Invoice,,,,,,07/12/2018,07/12/2018,0.00,,4.00,,"-1,225,080.24"
,IN,AR,30335114,1005,100,,Invoice,,,,,,07/12/2018,07/12/2018,0.00,,4.00,,"-1,225,084.24"
,IN,AR,30335179,1005,100,,Invoice,,,,,,07/12/2018,07/12/2018,0.00,,29.15,,"-1,225,113.39"
,IN,AR,30335187,1005,100,,Invoice,,,,,,07/12/2018,07/12/2018,0.00,,10.86,,"-1,225,124.25"
,IN,AR,30335202,1005,100,,Invoice,,,,,,07/12/2018,07/12/2018,0.00,,18.22,,"-1,225,142.47"
,IN,AR,30335204,1005,100,,Invoice,,,,,,07/12/2018,07/12/2018,0.00,,12.71,,"-1,225,155.18"
,IN,AR,30335284,1005,100,,Invoice,,,,,,07/12/2018,07/12/2018,0.00,,4.24,,"-1,225,159.42"
,IN,AR,30335289,1005,100,,Invoice,,,,,,07/12/2018,07/12/2018,0.00,,3.59,,"-1,225,163.01"
,IN,AR,30335302,1005,100,,Invoice,,,,,,07/12/2018,07/12/2018,0.00,,24.71,,"-1,225,187.72"
,IN,AR,30335303,1005,100,,Invoice,,,,,,07/12/2018,07/12/2018,0.00,,18.22,,"-1,225,205.94"
,IN,AR,30335340,1005,100,,Invoice,,,,,,07/12/2018,07/12/2018,0.00,,18.22,,"-1,225,224.16"
,IN,AR,30335352,1005,100,,Invoice,,,,,,07/12/2018,07/12/2018,0.00,,7.29,,"-1,225,231.45"
,IN,AR,30335356,1005,100,,Invoice,,,,,,07/12/2018,07/12/2018,0.00,,3.64,,"-1,225,235.09"
,CS,AR,32011753,1005,100,,Cash sale,,,,,,10/12/2018,10/12/2018,0.00,,5.61,,"-1,225,240.70"
,CS,AR,32011764,1005,100,,Cash sale,,,,,,10/12/2018,10/12/2018,0.00,,7.12,,"-1,225,247.82"
,CS,AR,32011845,1005,100,,Cash sale,,,,,,10/12/2018,10/12/2018,0.00,,14.53,,"-1,225,262.35"
,CS,AR,32011859,1005,100,,Cash sale,,,,,,10/12/2018,10/12/2018,0.00,,7.29,,"-1,225,269.64"
,CS,AR,32011865,1005,100,,Cash sale,,,,,,10/12/2018,10/12/2018,0.00,,1.95,,"-1,225,271.59"
,CS,AR,32011884,1005,100,,Cash sale,,,,,,10/12/2018,10/12/2018,0.00,,3.64,,"-1,225,275.23"
,CS,AR,32011900,1005,100,,Cash sale,,,,,,10/12/2018,10/12/2018,0.00,,3.64,,"-1,225,278.87"
,CS,AR,32011908,1005,100,,Cash sale,,,,,,10/12/2018,10/12/2018,0.00,,10.34,,"-1,225,289.21"
,CS,AR,32011922,1005,100,,Cash sale,,,,,,10/12/2018,10/12/2018,0.00,,7.29,,"-1,225,296.50"
,CS,AR,32011936,1005,100,,Cash sale,,,,,,10/12/2018,10/12/2018,0.00,,12.71,,"-1,225,309.21"
,CS,AR,32011958,1005,100,,Cash sale,,,,,,10/12/2018,10/12/2018,0.00,,31.02,,"-1,225,340.23"
,CS,AR,32011973,1005,100,,Cash sale,,,,,,10/12/2018,10/12/2018,0.00,,19.24,,"-1,225,359.47"
,CS,AR,32011988,1005,100,,Cash sale,,,,,,10/12/2018,10/12/2018,0.00,,3.89,,"-1,225,363.36"
,CS,AR,32012012,1005,100,,Cash sale,,,,,,10/12/2018,10/12/2018,0.00,,14.62,,"-1,225,377.98"
,CS,AR,32012018,1005,100,,Cash sale,,,,,,10/12/2018,10/12/2018,0.00,,10.88,,"-1,225,388.86"
,CS,AR,32012020,1005,100,,Cash sale,,,,,,10/12/2018,10/12/2018,0.00,,3.64,,"-1,225,392.50"
,CS,AR,32012021,1005,100,,Cash sale,,,,,,10/12/2018,10/12/2018,0.00,,6.02,,"-1,225,398.52"
,CS,AR,32012027,1005,100,,Cash sale,,,,,,10/12/2018,10/12/2018,0.00,,7.12,,"-1,225,405.64"
,CS,AR,32012030,1005,100,,Cash sale,,,,,,10/12/2018,10/12/2018,0.00,,18.05,,"-1,225,423.69"
,CS,AR,32012054,1005,100,,Cash sale,,,,,,10/12/2018,10/12/2018,0.00,,7.29,,"-1,225,430.98"
,CS,AR,32012073,1005,100,,Cash sale,,,,,,10/12/2018,10/12/2018,0.00,,3.64,,"-1,225,434.62"
,CS,AR,32012078,1005,100,,Cash sale,,,,,,10/12/2018,10/12/2018,0.00,,5.08,,"-1,225,439.70"
,CS,AR,32012087,1005,100,,Cash sale,,,,,,10/12/2018,10/12/2018,0.00,,7.29,,"-1,225,446.99"
,CS,AR,32012103,1005,100,,Cash sale,,,,,,10/12/2018,10/12/2018,0.00,,5.85,,"-1,225,452.84"
,CS,AR,32012135,1005,100,,Cash sale,,,,,,10/12/2018,10/12/2018,0.00,,3.64,,"-1,225,456.48"
,CS,AR,32012137,1005,100,,Cash sale,,,,,,10/12/2018,10/12/2018,0.00,,10.34,,"-1,225,466.82"
,CS,AR,32012142,1005,100,,Cash sale,,,,,,10/12/2018,10/12/2018,0.00,,3.20,,"-1,225,470.02"
,CS,AR,32012157,1005,100,,Cash sale,,,,,,10/12/2018,10/12/2018,0.00,,29.15,,"-1,225,499.17"
,CS,AR,32012229,1005,100,,Cash sale,,,,,,10/12/2018,10/12/2018,0.00,,2.74,,"-1,225,501.91"
,CS,AR,32012231,1005,100,,Cash sale,,,,,,10/12/2018,10/12/2018,0.00,,6.56,,"-1,225,508.47"
,CS,AR,32012233,1005,100,,Cash sale,,,,,,10/12/2018,10/12/2018,0.00,,6.56,,"-1,225,515.03"
,CS,AR,32012251,1005,100,,Cash sale,,,,,,10/12/2018,10/12/2018,0.00,,11.44,,"-1,225,526.47"
,CS,AR,32012284,1005,100,,Cash sale,,,,,,10/12/2018,10/12/2018,0.00,,21.25,,"-1,225,547.72"
,CS,AR,32012296,1005,100,,Cash sale,,,,,,10/12/2018,10/12/2018,0.00,,14.58,,"-1,225,562.30"
,CS,AR,32012333,1005,100,,Cash sale,,,,,,10/12/2018,10/12/2018,0.00,,6.56,,"-1,225,568.86"
,CS,AR,32012344,1005,100,,Cash sale,,,,,,10/12/2018,10/12/2018,0.00,,19.16,,"-1,225,588.02"
,CS,AR,32012363,1005,100,,Cash sale,,,,,,10/12/2018,10/12/2018,0.00,,3.64,,"-1,225,591.66"
,CS,AR,32012376,1005,100,,Cash sale,,,,,,10/12/2018,10/12/2018,0.00,,3.64,,"-1,225,595.30"
,CS,AR,32012404,1005,100,,Cash sale,,,,,,10/12/2018,10/12/2018,0.00,,25.51,,"-1,225,620.81"
,CS,AR,32012442,1005,100,,Cash sale,,,,,,10/12/2018,10/12/2018,0.00,,13.98,,"-1,225,634.79"
,CS,AR,32012458,1005,100,,Cash sale,,,,,,10/12/2018,10/12/2018,0.00,,10.93,,"-1,225,645.72"
,CS,AR,32012479,1005,100,,Cash sale,,,,,,10/12/2018,10/12/2018,0.00,,5.17,,"-1,225,650.89"
,CS,AR,32012481,1005,100,,Cash sale,,,,,,10/12/2018,10/12/2018,0.00,,10.93,,"-1,225,661.82"
,CS,AR,32012496,1005,100,,Cash sale,,,,,,10/12/2018,10/12/2018,0.00,,10.93,,"-1,225,672.75"
,CS,AR,32012502,1005,100,,Cash sale,,,,,,10/12/2018,10/12/2018,0.00,,14.58,,"-1,225,687.33"
,IN,AR,30333537,1005,100,,Invoice,,,,,,10/12/2018,10/12/2018,0.00,,21.86,,"-1,225,709.19"
,IN,AR,30333540,1005,100,,Invoice,,,,,,10/12/2018,10/12/2018,0.00,,364.41,,"-1,226,073.60"
,IN,AR,30333564,1005,100,,Invoice,,,,,,10/12/2018,10/12/2018,0.00,,6.08,,"-1,226,079.68"
,IN,AR,30333565,1005,100,,Invoice,,,,,,10/12/2018,10/12/2018,0.00,,4.05,,"-1,226,083.73"
,IN,AR,30333566,1005,100,,Invoice,,,,,,10/12/2018,10/12/2018,0.00,,18.23,,"-1,226,101.96"
,IN,AR,30333567,1005,100,,Invoice,,,,,,10/12/2018,10/12/2018,0.00,,2.03,,"-1,226,103.99"
,IN,AR,30333568,1005,100,,Invoice,,,,,,10/12/2018,10/12/2018,0.00,,10.13,,"-1,226,114.12"
,IN,AR,30333569,1005,100,,Invoice,,,,,,10/12/2018,10/12/2018,0.00,,4.05,,"-1,226,118.17"
,IN,AR,30333570,1005,100,,Invoice,,,,,,10/12/2018,10/12/2018,0.00,,2.03,,"-1,226,120.20"
,IN,AR,30333571,1005,100,,Invoice,,,,,,10/12/2018,10/12/2018,0.00,,10.13,,"-1,226,130.33"
,IN,AR,30333572,1005,100,,Invoice,,,,,,10/12/2018,10/12/2018,0.00,,10.13,,"-1,226,140.46"
,IN,AR,30333609,1005,100,,Invoice,,,,,,10/12/2018,10/12/2018,0.00,,7.25,,"-1,226,147.71"
,IN,AR,30333623,1005,100,,Invoice,,,,,,10/12/2018,10/12/2018,0.00,,12.20,,"-1,226,159.91"
,IN,AR,30333627,1005,100,,Invoice,,,,,,10/12/2018,10/12/2018,0.00,,27.47,,"-1,226,187.38"
,IN,AR,30333658,1005,100,,Invoice,,,,,,10/12/2018,10/12/2018,0.00,,62.00,,"-1,226,249.38"
,IN,AR,30333670,1005,100,,Invoice,,,,,,10/12/2018,10/12/2018,0.00,,13.77,,"-1,226,263.15"
,IN,AR,30333681,1005,100,,Invoice,,,,,,10/12/2018,10/12/2018,0.00,,38.00,,"-1,226,301.15"
,IN,AR,30333694,1005,100,,Invoice,,,,,,10/12/2018,10/12/2018,0.00,,65.75,,"-1,226,366.90"
,IN,AR,30333720,1005,100,,Invoice,,,,,,10/12/2018,10/12/2018,0.00,,16.00,,"-1,226,382.90"
,IN,AR,30333721,1005,100,,Invoice,,,,,,10/12/2018,10/12/2018,0.00,,24.00,,"-1,226,406.90"
,IN,AR,30333729,1005,100,,Invoice,,,,,,10/12/2018,10/12/2018,0.00,,10.93,,"-1,226,417.83"
,IN,AR,30333736,1005,100,,Invoice,,,,,,10/12/2018,10/12/2018,0.00,,2.75,,"-1,226,420.58"
,IN,AR,30333740,1005,100,,Invoice,,,,,,10/12/2018,10/12/2018,0.00,,20.34,,"-1,226,440.92"
,IN,AR,30333744,1005,100,,Invoice,,,,,,10/12/2018,10/12/2018,0.00,,35.81,,"-1,226,476.73"
,IN,AR,30333784,1005,100,,Invoice,,,,,,10/12/2018,10/12/2018,0.00,,364.41,,"-1,226,841.14"
,IN,AR,30333793,1005,100,,Invoice,,,,,,10/12/2018,10/12/2018,0.00,,111.88,,"-1,226,953.02"
,IN,AR,30333819,1005,100,,Invoice,,,,,,10/12/2018,10/12/2018,0.00,,28.00,,"-1,226,981.02"
,IN,AR,30333844,1005,100,,Invoice,,,,,,10/12/2018,10/12/2018,0.00,,12.88,,"-1,226,993.90"
,IN,AR,30333852,1005,100,,Invoice,,,,,,10/12/2018,10/12/2018,0.00,,36.44,,"-1,227,030.34"
,IN,AR,30333860,1005,100,,Invoice,,,,,,10/12/2018,10/12/2018,0.00,,364.41,,"-1,227,394.75"
,IN,AR,30333862,1005,100,,Invoice,,,,,,10/12/2018,10/12/2018,0.00,,3.19,,"-1,227,397.94"
,IN,AR,30333882,1005,100,,Invoice,,,,,,10/12/2018,10/12/2018,0.00,,2.58,,"-1,227,400.52"
,IN,AR,30333894,1005,100,,Invoice,,,,,,10/12/2018,10/12/2018,0.00,,7.19,,"-1,227,407.71"
,IN,AR,30333897,1005,100,,Invoice,,,,,,10/12/2018,10/12/2018,0.00,,13.78,,"-1,227,421.49"
,IN,AR,30333922,1005,100,,Invoice,,,,,,10/12/2018,10/12/2018,0.00,,28.47,,"-1,227,449.96"
,IN,AR,30333937,1005,100,,Invoice,,,,,,10/12/2018,10/12/2018,0.00,,8.47,,"-1,227,458.43"
,IN,AR,30333945,1005,100,,Invoice,,,,,,10/12/2018,10/12/2018,0.00,,10.34,,"-1,227,468.77"
,IN,AR,30333954,1005,100,,Invoice,,,,,,10/12/2018,10/12/2018,0.00,,11.86,,"-1,227,480.63"
,IN,AR,30333957,1005,100,,Invoice,,,,,,10/12/2018,10/12/2018,0.00,,5.18,,"-1,227,485.81"
,IN,AR,30333966,1005,100,,Invoice,,,,,,10/12/2018,10/12/2018,0.00,,3.64,,"-1,227,489.45"
,IN,AR,30333979,1005,100,,Invoice,,,,,,10/12/2018,10/12/2018,0.00,,66.92,,"-1,227,556.37"
,IN,AR,30333983,1005,100,,Invoice,,,,,,10/12/2018,10/12/2018,0.00,,408.14,,"-1,227,964.51"
,IN,AR,30333992,1005,100,,Invoice,,,,,,10/12/2018,10/12/2018,0.00,,75.88,,"-1,228,040.39"
,IN,AR,30334004,1005,100,,Invoice,,,,,,10/12/2018,10/12/2018,0.00,,40.68,,"-1,228,081.07"
,IN,AR,30334030,1005,100,,Invoice,,,,,,10/12/2018,10/12/2018,0.00,,16.10,,"-1,228,097.17"
,IN,AR,30334036,1005,100,,Invoice,,,,,,10/12/2018,10/12/2018,0.00,,3.22,,"-1,228,100.39"
,IN,AR,30334040,1005,100,,Invoice,,,,,,10/12/2018,10/12/2018,0.00,,12.03,,"-1,228,112.42"
,IN,AR,30334049,1005,100,,Invoice,,,,,,10/12/2018,10/12/2018,0.00,,9.03,,"-1,228,121.45"
,IN,AR,30334052,1005,100,,Invoice,,,,,,10/12/2018,10/12/2018,0.00,,2.75,,"-1,228,124.20"
,IN,AR,30334053,1005,100,,Invoice,,,,,,10/12/2018,10/12/2018,0.00,,364.41,,"-1,228,488.61"
,IN,AR,30334055,1005,100,,Invoice,,,,,,10/12/2018,10/12/2018,0.00,,3.64,,"-1,228,492.25"
,IN,AR,30334066,1005,100,,Invoice,,,,,,10/12/2018,10/12/2018,0.00,,6.36,,"-1,228,498.61"
,IN,AR,30334074,1005,100,,Invoice,,,,,,10/12/2018,10/12/2018,0.00,,5.08,,"-1,228,503.69"
,IN,AR,30334088,1005,100,,Invoice,,,,,,10/12/2018,10/12/2018,0.00,,5.08,,"-1,228,508.77"
,IN,AR,30334140,1005,100,,Invoice,,,,,,10/12/2018,10/12/2018,0.00,,10.93,,"-1,228,519.70"
,IN,AR,30334157,1005,100,,Invoice,,,,,,10/12/2018,10/12/2018,0.00,,10.17,,"-1,228,529.87"
,IN,AR,30334167,1005,100,,Invoice,,,,,,10/12/2018,10/12/2018,0.00,,22.37,,"-1,228,552.24"
,IN,AR,30334198,1005,100,,Invoice,,,,,,10/12/2018,10/12/2018,0.00,,3.64,,"-1,228,555.88"
,IN,AR,30334218,1005,100,,Invoice,,,,,,10/12/2018,10/12/2018,0.00,,19.28,,"-1,228,575.16"
,IN,AR,30334221,1005,100,,Invoice,,,,,,10/12/2018,10/12/2018,0.00,,7.29,,"-1,228,582.45"
,IN,AR,30334237,1005,100,,Invoice,,,,,,10/12/2018,10/12/2018,0.00,,11.48,,"-1,228,593.93"
,IN,AR,30334243,1005,100,,Invoice,,,,,,10/12/2018,10/12/2018,0.00,,19.64,,"-1,228,613.57"
,IN,AR,30334251,1005,100,,Invoice,,,,,,10/12/2018,10/12/2018,0.00,,13.14,,"-1,228,626.71"
,IN,AR,30334297,1005,100,,Invoice,,,,,,10/12/2018,10/12/2018,0.00,,75.66,,"-1,228,702.37"
,IN,AR,30334305,1005,100,,Invoice,,,,,,10/12/2018,10/12/2018,0.00,,10.93,,"-1,228,713.30"
,IN,AR,30334309,1005,100,,Invoice,,,,,,10/12/2018,10/12/2018,0.00,,22.00,,"-1,228,735.30"
,IN,AR,30334323,1005,100,,Invoice,,,,,,10/12/2018,10/12/2018,0.00,,"1,093.22",,"-1,229,828.52"
,IN,AR,30334354,1005,100,,Invoice,,,,,,10/12/2018,10/12/2018,0.00,,42.69,,"-1,229,871.21"
,IN,AR,30334360,1005,100,,Invoice,,,,,,10/12/2018,10/12/2018,0.00,,7.75,,"-1,229,878.96"
,IN,AR,30334365,1005,100,,Invoice,,,,,,10/12/2018,10/12/2018,0.00,,4.49,,"-1,229,883.45"
,IN,AR,30334372,1005,100,,Invoice,,,,,,10/12/2018,10/12/2018,0.00,,54.66,,"-1,229,938.11"
,IN,AR,30334382,1005,100,,Invoice,,,,,,10/12/2018,10/12/2018,0.00,,37.37,,"-1,229,975.48"
,IN,AR,30334418,1005,100,,Invoice,,,,,,10/12/2018,10/12/2018,0.00,,17.62,,"-1,229,993.10"
,IN,AR,30334432,1005,100,,Invoice,,,,,,10/12/2018,10/12/2018,0.00,,7.29,,"-1,230,000.39"
,IN,AR,30334439,1005,100,,Invoice,,,,,,10/12/2018,10/12/2018,0.00,,7.29,,"-1,230,007.68"
,IN,AR,30334481,1005,100,,Invoice,,,,,,10/12/2018,10/12/2018,0.00,,546.61,,"-1,230,554.29"
,IN,AR,30334528,1005,100,,Invoice,,,,,,10/12/2018,10/12/2018,0.00,,3.98,,"-1,230,558.27"
,IN,AR,30334545,1005,100,,Invoice,,,,,,10/12/2018,10/12/2018,0.00,,12.98,,"-1,230,571.25"
,IN,AR,30334562,1005,100,,Invoice,,,,,,10/12/2018,10/12/2018,0.00,,2.14,,"-1,230,573.39"
,IN,AR,30334568,1005,100,,Invoice,,,,,,10/12/2018,10/12/2018,0.00,,40.08,,"-1,230,613.47"
,IN,AR,30334598,1005,100,,Invoice,,,,,,10/12/2018,10/12/2018,0.00,,198.97,,"-1,230,812.44"
,IN,AR,30334609,1005,100,,Invoice,,,,,,10/12/2018,10/12/2018,0.00,,15.76,,"-1,230,828.20"
,IN,AR,30334614,1005,100,,Invoice,,,,,,10/12/2018,10/12/2018,0.00,,4.58,,"-1,230,832.78"
,IN,AR,30334630,1005,100,,Invoice,,,,,,10/12/2018,10/12/2018,0.00,,10.93,,"-1,230,843.71"
,IN,AR,30334638,1005,100,,Invoice,,,,,,10/12/2018,10/12/2018,0.00,,"1,093.22",,"-1,231,936.93"
,IN,AR,30334640,1005,100,,Invoice,,,,,,10/12/2018,10/12/2018,0.00,,7.29,,"-1,231,944.22"
,IN,AR,30334663,1005,100,,Invoice,,,,,,10/12/2018,10/12/2018,0.00,,8.00,,"-1,231,952.22"
,IN,AR,30334693,1005,100,,Invoice,,,,,,10/12/2018,10/12/2018,0.00,,37.71,,"-1,231,989.93"
,IN,AR,30334726,1005,100,,Invoice,,,,,,10/12/2018,10/12/2018,0.00,,7.29,,"-1,231,997.22"
,IN,AR,30334729,1005,100,,Invoice,,,,,,10/12/2018,10/12/2018,0.00,,43.73,,"-1,232,040.95"
,IN,AR,30334730,1005,100,,Invoice,,,,,,10/12/2018,10/12/2018,0.00,,5.83,,"-1,232,046.78"
,IN,AR,30334741,1005,100,,Invoice,,,,,,10/12/2018,10/12/2018,0.00,,158.47,,"-1,232,205.25"
,IN,AR,30334752,1005,100,,Invoice,,,,,,10/12/2018,10/12/2018,0.00,,16.83,,"-1,232,222.08"
,IN,AR,30334830,1005,100,,Invoice,,,,,,10/12/2018,10/12/2018,0.00,,26.69,,"-1,232,248.77"
,IN,AR,30334843,1005,100,,Invoice,,,,,,10/12/2018,10/12/2018,0.00,,25.49,,"-1,232,274.26"
,IN,AR,30334922,1005,100,,Invoice,,,,,,10/12/2018,10/12/2018,0.00,,12.00,,"-1,232,286.26"
,IN,AR,30334929,1005,100,,Invoice,,,,,,10/12/2018,10/12/2018,0.00,,1.88,,"-1,232,288.14"
,IN,AR,30334930,1005,100,,Invoice,,,,,,10/12/2018,10/12/2018,0.00,,7.53,,"-1,232,295.67"
,IN,AR,30334975,1005,100,,Invoice,,,,,,10/12/2018,10/12/2018,0.00,,16.42,,"-1,232,312.09"
,IN,AR,30334994,1005,100,,Invoice,,,,,,10/12/2018,10/12/2018,0.00,,29.15,,"-1,232,341.24"
,IN,AR,30335043,1005,100,,Invoice,,,,,,10/12/2018,10/12/2018,0.00,,3.51,,"-1,232,344.75"
,IN,AR,30335052,1005,100,,Invoice,,,,,,10/12/2018,10/12/2018,0.00,,4.08,,"-1,232,348.83"
,IN,AR,30335098,1005,100,,Invoice,,,,,,10/12/2018,10/12/2018,0.00,,23.39,,"-1,232,372.22"
,IN,AR,30335130,1005,100,,Invoice,,,,,,10/12/2018,10/12/2018,0.00,,4.15,,"-1,232,376.37"
,IN,AR,30335131,1005,100,,Invoice,,,,,,10/12/2018,10/12/2018,0.00,,6.23,,"-1,232,382.60"
,IN,AR,30335132,1005,100,,Invoice,,,,,,10/12/2018,10/12/2018,0.00,,4.15,,"-1,232,386.75"
,IN,AR,30335133,1005,100,,Invoice,,,,,,10/12/2018,10/12/2018,0.00,,4.15,,"-1,232,390.90"
,IN,AR,30335134,1005,100,,Invoice,,,,,,10/12/2018,10/12/2018,0.00,,4.15,,"-1,232,395.05"
,IN,AR,30335135,1005,100,,Invoice,,,,,,10/12/2018,10/12/2018,0.00,,10.38,,"-1,232,405.43"
,IN,AR,30335232,1005,100,,Invoice,,,,,,10/12/2018,10/12/2018,0.00,,8.41,,"-1,232,413.84"
,IN,AR,30335261,1005,100,,Invoice,,,,,,10/12/2018,10/12/2018,0.00,,71.70,,"-1,232,485.54"
,IN,AR,30335285,1005,100,,Invoice,,,,,,10/12/2018,10/12/2018,0.00,,29.15,,"-1,232,514.69"
,IN,AR,30335308,1005,100,,Invoice,,,,,,10/12/2018,10/12/2018,0.00,,24.07,,"-1,232,538.76"
,IN,AR,30335339,1005,100,,Invoice,,,,,,10/12/2018,10/12/2018,0.00,,10.93,,"-1,232,549.69"
,CS,AR,32011771,1005,100,,Cash sale,,,,,,11/12/2018,11/12/2018,0.00,,5.68,,"-1,232,555.37"
,CS,AR,32011780,1005,100,,Cash sale,,,,,,11/12/2018,11/12/2018,0.00,,3.64,,"-1,232,559.01"
,CS,AR,32011791,1005,100,,Cash sale,,,,,,11/12/2018,11/12/2018,0.00,,7.29,,"-1,232,566.30"
,CS,AR,32011812,1005,100,,Cash sale,,,,,,11/12/2018,11/12/2018,0.00,,10.93,,"-1,232,577.23"
,CS,AR,32011818,1005,100,,Cash sale,,,,,,11/12/2018,11/12/2018,0.00,,3.64,,"-1,232,580.87"
,CS,AR,32011829,1005,100,,Cash sale,,,,,,11/12/2018,11/12/2018,0.00,,3.01,,"-1,232,583.88"
,CS,AR,32011834,1005,100,,Cash sale,,,,,,11/12/2018,11/12/2018,0.00,,10.93,,"-1,232,594.81"
,CS,AR,32011850,1005,100,,Cash sale,,,,,,11/12/2018,11/12/2018,0.00,,3.64,,"-1,232,598.45"
,CS,AR,32011879,1005,100,,Cash sale,,,,,,11/12/2018,11/12/2018,0.00,,10.93,,"-1,232,609.38"
,CS,AR,32011890,1005,100,,Cash sale,,,,,,11/12/2018,11/12/2018,0.00,,7.29,,"-1,232,616.67"
,CS,AR,32011891,1005,100,,Cash sale,,,,,,11/12/2018,11/12/2018,0.00,,3.01,,"-1,232,619.68"
,CS,AR,32011910,1005,100,,Cash sale,,,,,,11/12/2018,11/12/2018,0.00,,32.80,,"-1,232,652.48"
,CS,AR,32011918,1005,100,,Cash sale,,,,,,11/12/2018,11/12/2018,0.00,,4.32,,"-1,232,656.80"
,CS,AR,32011941,1005,100,,Cash sale,,,,,,11/12/2018,11/12/2018,0.00,,3.90,,"-1,232,660.70"
,CS,AR,32011948,1005,100,,Cash sale,,,,,,11/12/2018,11/12/2018,0.00,,2.84,,"-1,232,663.54"
,CS,AR,32011957,1005,100,,Cash sale,,,,,,11/12/2018,11/12/2018,0.00,,10.93,,"-1,232,674.47"
,CS,AR,32011961,1005,100,,Cash sale,,,,,,11/12/2018,11/12/2018,0.00,,5.85,,"-1,232,680.32"
,CS,AR,32011989,1005,100,,Cash sale,,,,,,11/12/2018,11/12/2018,0.00,,10.93,,"-1,232,691.25"
,CS,AR,32012024,1005,100,,Cash sale,,,,,,11/12/2018,11/12/2018,0.00,,1.95,,"-1,232,693.20"
,CS,AR,32012025,1005,100,,Cash sale,,,,,,11/12/2018,11/12/2018,0.00,,5.85,,"-1,232,699.05"
,CS,AR,32012044,1005,100,,Cash sale,,,,,,11/12/2018,11/12/2018,0.00,,5.85,,"-1,232,704.90"
,CS,AR,32012052,1005,100,,Cash sale,,,,,,11/12/2018,11/12/2018,0.00,,1.95,,"-1,232,706.85"
,CS,AR,32012068,1005,100,,Cash sale,,,,,,11/12/2018,11/12/2018,0.00,,10.34,,"-1,232,717.19"
,CS,AR,32012083,1005,100,,Cash sale,,,,,,11/12/2018,11/12/2018,0.00,,7.75,,"-1,232,724.94"
,CS,AR,32012091,1005,100,,Cash sale,,,,,,11/12/2018,11/12/2018,0.00,,14.58,,"-1,232,739.52"
,CS,AR,32012096,1005,100,,Cash sale,,,,,,11/12/2018,11/12/2018,0.00,,11.19,,"-1,232,750.71"
,CS,AR,32012099,1005,100,,Cash sale,,,,,,11/12/2018,11/12/2018,0.00,,3.64,,"-1,232,754.35"
,CS,AR,32012106,1005,100,,Cash sale,,,,,,11/12/2018,11/12/2018,0.00,,25.51,,"-1,232,779.86"
,CS,AR,32012138,1005,100,,Cash sale,,,,,,11/12/2018,11/12/2018,0.00,,7.29,,"-1,232,787.15"
,CS,AR,32012145,1005,100,,Cash sale,,,,,,11/12/2018,11/12/2018,0.00,,7.29,,"-1,232,794.44"
,CS,AR,32012159,1005,100,,Cash sale,,,,,,11/12/2018,11/12/2018,0.00,,16.78,,"-1,232,811.22"
,CS,AR,32012164,1005,100,,Cash sale,,,,,,11/12/2018,11/12/2018,0.00,,7.29,,"-1,232,818.51"
,CS,AR,32012182,1005,100,,Cash sale,,,,,,11/12/2018,11/12/2018,0.00,,3.64,,"-1,232,822.15"
,CS,AR,32012183,1005,100,,Cash sale,,,,,,11/12/2018,11/12/2018,0.00,,29.15,,"-1,232,851.30"
,CS,AR,32012202,1005,100,,Cash sale,,,,,,11/12/2018,11/12/2018,0.00,,2.58,,"-1,232,853.88"
,CS,AR,32012214,1005,100,,Cash sale,,,,,,11/12/2018,11/12/2018,0.00,,17.80,,"-1,232,871.68"
,CS,AR,32012217,1005,100,,Cash sale,,,,,,11/12/2018,11/12/2018,0.00,,32.00,,"-1,232,903.68"
,CS,AR,32012222,1005,100,,Cash sale,,,,,,11/12/2018,11/12/2018,0.00,,12.14,,"-1,232,915.82"
,CS,AR,32012275,1005,100,,Cash sale,,,,,,11/12/2018,11/12/2018,0.00,,5.50,,"-1,232,921.32"
,CS,AR,32012288,1005,100,,Cash sale,,,,,,11/12/2018,11/12/2018,0.00,,7.29,,"-1,232,928.61"
,CS,AR,32012315,1005,100,,Cash sale,,,,,,11/12/2018,11/12/2018,0.00,,10.93,,"-1,232,939.54"
,CS,AR,32012317,1005,100,,Cash sale,,,,,,11/12/2018,11/12/2018,0.00,,6.56,,"-1,232,946.10"
,CS,AR,32012327,1005,100,,Cash sale,,,,,,11/12/2018,11/12/2018,0.00,,7.29,,"-1,232,953.39"
,CS,AR,32012336,1005,100,,Cash sale,,,,,,11/12/2018,11/12/2018,0.00,,3.64,,"-1,232,957.03"
,CS,AR,32012339,1005,100,,Cash sale,,,,,,11/12/2018,11/12/2018,0.00,,10.93,,"-1,232,967.96"
,CS,AR,32012350,1005,100,,Cash sale,,,,,,11/12/2018,11/12/2018,0.00,,5.86,,"-1,232,973.82"
,CS,AR,32012356,1005,100,,Cash sale,,,,,,11/12/2018,11/12/2018,0.00,,3.64,,"-1,232,977.46"
,CS,AR,32012368,1005,100,,Cash sale,,,,,,11/12/2018,11/12/2018,0.00,,7.75,,"-1,232,985.21"
,CS,AR,32012369,1005,100,,Cash sale,,,,,,11/12/2018,11/12/2018,0.00,,18.21,,"-1,233,003.42"
,CS,AR,32012449,1005,100,,Cash sale,,,,,,11/12/2018,11/12/2018,0.00,,3.64,,"-1,233,007.06"
,CS,AR,32012457,1005,100,,Cash sale,,,,,,11/12/2018,11/12/2018,0.00,,5.17,,"-1,233,012.23"
,CS,AR,32012469,1005,100,,Cash sale,,,,,,11/12/2018,11/12/2018,0.00,,5.93,,"-1,233,018.16"
,IN,AR,30333522,1005,100,,Invoice,,,,,,11/12/2018,11/12/2018,0.00,,41.53,,"-1,233,059.69"
,IN,AR,30333523,1005,100,,Invoice,,,,,,11/12/2018,11/12/2018,0.00,,50.42,,"-1,233,110.11"
,IN,AR,30333596,1005,100,,Invoice,,,,,,11/12/2018,11/12/2018,0.00,,3.64,,"-1,233,113.75"
,IN,AR,30333600,1005,100,,Invoice,,,,,,11/12/2018,11/12/2018,0.00,,10.51,,"-1,233,124.26"
,IN,AR,30333614,1005,100,,Invoice,,,,,,11/12/2018,11/12/2018,0.00,,3.64,,"-1,233,127.90"
,IN,AR,30333618,1005,100,,Invoice,,,,,,11/12/2018,11/12/2018,0.00,,7.00,,"-1,233,134.90"
,IN,AR,30333633,1005,100,,Invoice,,,,,,11/12/2018,11/12/2018,0.00,,11.19,,"-1,233,146.09"
,IN,AR,30333649,1005,100,,Invoice,,,,,,11/12/2018,11/12/2018,0.00,,3.98,,"-1,233,150.07"
,IN,AR,30333659,1005,100,,Invoice,,,,,,11/12/2018,11/12/2018,0.00,,28.00,,"-1,233,178.07"
,IN,AR,30333678,1005,100,,Invoice,,,,,,11/12/2018,11/12/2018,0.00,,14.58,,"-1,233,192.65"
,IN,AR,30333706,1005,100,,Invoice,,,,,,11/12/2018,11/12/2018,0.00,,3.64,,"-1,233,196.29"
,IN,AR,30333734,1005,100,,Invoice,,,,,,11/12/2018,11/12/2018,0.00,,3.64,,"-1,233,199.93"
,IN,AR,30333781,1005,100,,Invoice,,,,,,11/12/2018,11/12/2018,0.00,,10.93,,"-1,233,210.86"
,IN,AR,30333788,1005,100,,Invoice,,,,,,11/12/2018,11/12/2018,0.00,,5.68,,"-1,233,216.54"
,IN,AR,30333807,1005,100,,Invoice,,,,,,11/12/2018,11/12/2018,0.00,,5.82,,"-1,233,222.36"
,IN,AR,30333813,1005,100,,Invoice,,,,,,11/12/2018,11/12/2018,0.00,,47.80,,"-1,233,270.16"
,IN,AR,30333830,1005,100,,Invoice,,,,,,11/12/2018,11/12/2018,0.00,,21.98,,"-1,233,292.14"
,IN,AR,30333846,1005,100,,Invoice,,,,,,11/12/2018,11/12/2018,0.00,,54.66,,"-1,233,346.80"
,IN,AR,30333854,1005,100,,Invoice,,,,,,11/12/2018,11/12/2018,0.00,,21.86,,"-1,233,368.66"
,IN,AR,30333885,1005,100,,Invoice,,,,,,11/12/2018,11/12/2018,0.00,,13.73,,"-1,233,382.39"
,IN,AR,30333887,1005,100,,Invoice,,,,,,11/12/2018,11/12/2018,0.00,,4.64,,"-1,233,387.03"
,IN,AR,30333968,1005,100,,Invoice,,,,,,11/12/2018,11/12/2018,0.00,,29.15,,"-1,233,416.18"
,IN,AR,30333974,1005,100,,Invoice,,,,,,11/12/2018,11/12/2018,0.00,,6.02,,"-1,233,422.20"
,IN,AR,30333987,1005,100,,Invoice,,,,,,11/12/2018,11/12/2018,0.00,,13.56,,"-1,233,435.76"
,IN,AR,30334010,1005,100,,Invoice,,,,,,11/12/2018,11/12/2018,0.00,,5.17,,"-1,233,440.93"
,IN,AR,30334011,1005,100,,Invoice,,,,,,11/12/2018,11/12/2018,0.00,,9.43,,"-1,233,450.36"
,IN,AR,30334019,1005,100,,Invoice,,,,,,11/12/2018,11/12/2018,0.00,,7.17,,"-1,233,457.53"
,IN,AR,30334045,1005,100,,Invoice,,,,,,11/12/2018,11/12/2018,0.00,,7.29,,"-1,233,464.82"
,IN,AR,30334064,1005,100,,Invoice,,,,,,11/12/2018,11/12/2018,0.00,,10.34,,"-1,233,475.16"
,IN,AR,30334080,1005,100,,Invoice,,,,,,11/12/2018,11/12/2018,0.00,,2.39,,"-1,233,477.55"
,IN,AR,30334089,1005,100,,Invoice,,,,,,11/12/2018,11/12/2018,0.00,,7.63,,"-1,233,485.18"
,IN,AR,30334116,1005,100,,Invoice,,,,,,11/12/2018,11/12/2018,0.00,,2.58,,"-1,233,487.76"
,IN,AR,30334121,1005,100,,Invoice,,,,,,11/12/2018,11/12/2018,0.00,,15.25,,"-1,233,503.01"
,IN,AR,30334153,1005,100,,Invoice,,,,,,11/12/2018,11/12/2018,0.00,,10.68,,"-1,233,513.69"
,IN,AR,30334170,1005,100,,Invoice,,,,,,11/12/2018,11/12/2018,0.00,,4.08,,"-1,233,517.77"
,IN,AR,30334177,1005,100,,Invoice,,,,,,11/12/2018,11/12/2018,0.00,,2.39,,"-1,233,520.16"
,IN,AR,30334184,1005,100,,Invoice,,,,,,11/12/2018,11/12/2018,0.00,,5.08,,"-1,233,525.24"
,IN,AR,30334193,1005,100,,Invoice,,,,,,11/12/2018,11/12/2018,0.00,,10.53,,"-1,233,535.77"
,IN,AR,30334200,1005,100,,Invoice,,,,,,11/12/2018,11/12/2018,0.00,,9.03,,"-1,233,544.80"
,IN,AR,30334214,1005,100,,Invoice,,,,,,11/12/2018,11/12/2018,0.00,,4.24,,"-1,233,549.04"
,IN,AR,30334225,1005,100,,Invoice,,,,,,11/12/2018,11/12/2018,0.00,,5.08,,"-1,233,554.12"
,IN,AR,30334255,1005,100,,Invoice,,,,,,11/12/2018,11/12/2018,0.00,,8.90,,"-1,233,563.02"
,IN,AR,30334313,1005,100,,Invoice,,,,,,11/12/2018,11/12/2018,0.00,,21.05,,"-1,233,584.07"
,IN,AR,30334332,1005,100,,Invoice,,,,,,11/12/2018,11/12/2018,0.00,,10.93,,"-1,233,595.00"
,IN,AR,30334335,1005,100,,Invoice,,,,,,11/12/2018,11/12/2018,0.00,,8.26,,"-1,233,603.26"
,IN,AR,30334388,1005,100,,Invoice,,,,,,11/12/2018,11/12/2018,0.00,,7.63,,"-1,233,610.89"
,IN,AR,30334394,1005,100,,Invoice,,,,,,11/12/2018,11/12/2018,0.00,,7.29,,"-1,233,618.18"
,IN,AR,30334401,1005,100,,Invoice,,,,,,11/12/2018,11/12/2018,0.00,,27.08,,"-1,233,645.26"
,IN,AR,30334403,1005,100,,Invoice,,,,,,11/12/2018,11/12/2018,0.00,,4.00,,"-1,233,649.26"
,IN,AR,30334419,1005,100,,Invoice,,,,,,11/12/2018,11/12/2018,0.00,,1.76,,"-1,233,651.02"
,IN,AR,30334448,1005,100,,Invoice,,,,,,11/12/2018,11/12/2018,0.00,,2.58,,"-1,233,653.60"
,IN,AR,30334452,1005,100,,Invoice,,,,,,11/12/2018,11/12/2018,0.00,,38.14,,"-1,233,691.74"
,IN,AR,30334454,1005,100,,Invoice,,,,,,11/12/2018,11/12/2018,0.00,,24.64,,"-1,233,716.38"
,IN,AR,30334469,1005,100,,Invoice,,,,,,11/12/2018,11/12/2018,0.00,,2.92,,"-1,233,719.30"
,IN,AR,30334485,1005,100,,Invoice,,,,,,11/12/2018,11/12/2018,0.00,,54.66,,"-1,233,773.96"
,IN,AR,30334487,1005,100,,Invoice,,,,,,11/12/2018,11/12/2018,0.00,,6.43,,"-1,233,780.39"
,IN,AR,30334490,1005,100,,Invoice,,,,,,11/12/2018,11/12/2018,0.00,,14.58,,"-1,233,794.97"
,IN,AR,30334513,1005,100,,Invoice,,,,,,11/12/2018,11/12/2018,0.00,,1.99,,"-1,233,796.96"
,IN,AR,30334514,1005,100,,Invoice,,,,,,11/12/2018,11/12/2018,0.00,,3.98,,"-1,233,800.94"
,IN,AR,30334529,1005,100,,Invoice,,,,,,11/12/2018,11/12/2018,0.00,,3.98,,"-1,233,804.92"
,IN,AR,30334530,1005,100,,Invoice,,,,,,11/12/2018,11/12/2018,0.00,,3.98,,"-1,233,808.90"
,IN,AR,30334531,1005,100,,Invoice,,,,,,11/12/2018,11/12/2018,0.00,,5.97,,"-1,233,814.87"
,IN,AR,30334532,1005,100,,Invoice,,,,,,11/12/2018,11/12/2018,0.00,,1.99,,"-1,233,816.86"
,IN,AR,30334533,1005,100,,Invoice,,,,,,11/12/2018,11/12/2018,0.00,,15.92,,"-1,233,832.78"
,IN,AR,30334548,1005,100,,Invoice,,,,,,11/12/2018,11/12/2018,0.00,,22.71,,"-1,233,855.49"
,IN,AR,30334581,1005,100,,Invoice,,,,,,11/12/2018,11/12/2018,0.00,,3.64,,"-1,233,859.13"
,IN,AR,30334585,1005,100,,Invoice,,,,,,11/12/2018,11/12/2018,0.00,,3.64,,"-1,233,862.77"
,IN,AR,30334650,1005,100,,Invoice,,,,,,11/12/2018,11/12/2018,0.00,,5.08,,"-1,233,867.85"
,IN,AR,30334651,1005,100,,Invoice,,,,,,11/12/2018,11/12/2018,0.00,,12.71,,"-1,233,880.56"
,IN,AR,30334660,1005,100,,Invoice,,,,,,11/12/2018,11/12/2018,0.00,,14.00,,"-1,233,894.56"
,IN,AR,30334668,1005,100,,Invoice,,,,,,11/12/2018,11/12/2018,0.00,,12.00,,"-1,233,906.56"
,IN,AR,30334673,1005,100,,Invoice,,,,,,11/12/2018,11/12/2018,0.00,,18.01,,"-1,233,924.57"
,IN,AR,30334694,1005,100,,Invoice,,,,,,11/12/2018,11/12/2018,0.00,,9.05,,"-1,233,933.62"
,IN,AR,30334720,1005,100,,Invoice,,,,,,11/12/2018,11/12/2018,0.00,,34.88,,"-1,233,968.50"
,IN,AR,30334764,1005,100,,Invoice,,,,,,11/12/2018,11/12/2018,0.00,,13.73,,"-1,233,982.23"
,IN,AR,30334774,1005,100,,Invoice,,,,,,11/12/2018,11/12/2018,0.00,,6.42,,"-1,233,988.65"
,IN,AR,30334778,1005,100,,Invoice,,,,,,11/12/2018,11/12/2018,0.00,,148.00,,"-1,234,136.65"
,IN,AR,30334783,1005,100,,Invoice,,,,,,11/12/2018,11/12/2018,0.00,,9.10,,"-1,234,145.75"
,IN,AR,30334821,1005,100,,Invoice,,,,,,11/12/2018,11/12/2018,0.00,,5.08,,"-1,234,150.83"
,IN,AR,30334844,1005,100,,Invoice,,,,,,11/12/2018,11/12/2018,0.00,,1.59,,"-1,234,152.42"
,IN,AR,30334845,1005,100,,Invoice,,,,,,11/12/2018,11/12/2018,0.00,,7.97,,"-1,234,160.39"
,IN,AR,30334863,1005,100,,Invoice,,,,,,11/12/2018,11/12/2018,0.00,,70.51,,"-1,234,230.90"
,IN,AR,30334865,1005,100,,Invoice,,,,,,11/12/2018,11/12/2018,0.00,,18.22,,"-1,234,249.12"
,IN,AR,30334870,1005,100,,Invoice,,,,,,11/12/2018,11/12/2018,0.00,,28.47,,"-1,234,277.59"
,IN,AR,30334871,1005,100,,Invoice,,,,,,11/12/2018,11/12/2018,0.00,,28.47,,"-1,234,306.06"
,IN,AR,30334872,1005,100,,Invoice,,,,,,11/12/2018,11/12/2018,0.00,,52.20,,"-1,234,358.26"
,IN,AR,30334896,1005,100,,Invoice,,,,,,11/12/2018,11/12/2018,0.00,,14.24,,"-1,234,372.50"
,IN,AR,30334897,1005,100,,Invoice,,,,,,11/12/2018,11/12/2018,0.00,,10.17,,"-1,234,382.67"
,IN,AR,30334938,1005,100,,Invoice,,,,,,11/12/2018,11/12/2018,0.00,,3.51,,"-1,234,386.18"
,IN,AR,30334942,1005,100,,Invoice,,,,,,11/12/2018,11/12/2018,0.00,,12.00,,"-1,234,398.18"
,IN,AR,30334948,1005,100,,Invoice,,,,,,11/12/2018,11/12/2018,0.00,,5.93,,"-1,234,404.11"
,IN,AR,30334955,1005,100,,Invoice,,,,,,11/12/2018,11/12/2018,0.00,,125.05,,"-1,234,529.16"
,IN,AR,30334964,1005,100,,Invoice,,,,,,11/12/2018,11/12/2018,0.00,,7.02,,"-1,234,536.18"
,IN,AR,30335062,1005,100,,Invoice,,,,,,11/12/2018,11/12/2018,0.00,,18.22,,"-1,234,554.40"
,IN,AR,30335072,1005,100,,Invoice,,,,,,11/12/2018,11/12/2018,0.00,,32.80,,"-1,234,587.20"
,IN,AR,30335087,1005,100,,Invoice,,,,,,11/12/2018,11/12/2018,0.00,,54.66,,"-1,234,641.86"
,IN,AR,30335090,1005,100,,Invoice,,,,,,11/12/2018,11/12/2018,0.00,,7.97,,"-1,234,649.83"
,IN,AR,30335106,1005,100,,Invoice,,,,,,11/12/2018,11/12/2018,0.00,,4.83,,"-1,234,654.66"
,IN,AR,30335136,1005,100,,Invoice,,,,,,11/12/2018,11/12/2018,0.00,,8.31,,"-1,234,662.97"
,IN,AR,30335137,1005,100,,Invoice,,,,,,11/12/2018,11/12/2018,0.00,,8.31,,"-1,234,671.28"
,IN,AR,30335138,1005,100,,Invoice,,,,,,11/12/2018,11/12/2018,0.00,,8.31,,"-1,234,679.59"
,IN,AR,30335139,1005,100,,Invoice,,,,,,11/12/2018,11/12/2018,0.00,,2.08,,"-1,234,681.67"
,IN,AR,30335140,1005,100,,Invoice,,,,,,11/12/2018,11/12/2018,0.00,,2.08,,"-1,234,683.75"
,IN,AR,30335167,1005,100,,Invoice,,,,,,11/12/2018,11/12/2018,0.00,,24.15,,"-1,234,707.90"
,IN,AR,30335206,1005,100,,Invoice,,,,,,11/12/2018,11/12/2018,0.00,,10.17,,"-1,234,718.07"
,IN,AR,30335226,1005,100,,Invoice,,,,,,11/12/2018,11/12/2018,0.00,,3.64,,"-1,234,721.71"
,IN,AR,30335239,1005,100,,Invoice,,,,,,11/12/2018,11/12/2018,0.00,,7.75,,"-1,234,729.46"
,IN,AR,30335250,1005,100,,Invoice,,,,,,11/12/2018,11/12/2018,0.00,,109.22,,"-1,234,838.68"
,IN,AR,30335272,1005,100,,Invoice,,,,,,11/12/2018,11/12/2018,0.00,,12.14,,"-1,234,850.82"
,IN,AR,30335277,1005,100,,Invoice,,,,,,11/12/2018,11/12/2018,0.00,,10.53,,"-1,234,861.35"
,IN,AR,30335297,1005,100,,Invoice,,,,,,11/12/2018,11/12/2018,0.00,,21.30,,"-1,234,882.65"
,IN,AR,30335299,1005,100,,Invoice,,,,,,11/12/2018,11/12/2018,0.00,,5.17,,"-1,234,887.82"
,IN,AR,30335301,1005,100,,Invoice,,,,,,11/12/2018,11/12/2018,0.00,,7.29,,"-1,234,895.11"
,IN,AR,30335305,1005,100,,Invoice,,,,,,11/12/2018,11/12/2018,0.00,,10.95,,"-1,234,906.06"
,IN,AR,30335329,1005,100,,Invoice,,,,,,11/12/2018,11/12/2018,0.00,,14.58,,"-1,234,920.64"
,IN,AR,30335348,1005,100,,Invoice,,,,,,11/12/2018,11/12/2018,0.00,,182.20,,"-1,235,102.84"
,IN,AR,30335373,1005,100,,Invoice,,,,,,11/12/2018,11/12/2018,0.00,,10.93,,"-1,235,113.77"
,IN,AR,30348512,1005,100,,Invoice,,,,,,11/12/2018,11/12/2018,0.00,,7.29,,"-1,235,121.06"
,CR,AR,33000328,1005,100,,Cash Return,,,,,,12/12/2018,12/12/2018,3.64,,0.00,,"-1,235,117.42"
,CS,AR,32011749,1005,100,,Cash sale,,,,,,12/12/2018,12/12/2018,0.00,,21.06,,"-1,235,138.48"
,CS,AR,32011760,1005,100,,Cash sale,,,,,,12/12/2018,12/12/2018,0.00,,27.59,,"-1,235,166.07"
,CS,AR,32011875,1005,100,,Cash sale,,,,,,12/12/2018,12/12/2018,0.00,,3.64,,"-1,235,169.71"
,CS,AR,32011897,1005,100,,Cash sale,,,,,,12/12/2018,12/12/2018,0.00,,2.92,,"-1,235,172.63"
,CS,AR,32011899,1005,100,,Cash sale,,,,,,12/12/2018,12/12/2018,0.00,,3.64,,"-1,235,176.27"
,CS,AR,32011906,1005,100,,Cash sale,,,,,,12/12/2018,12/12/2018,0.00,,3.64,,"-1,235,179.91"
,CS,AR,32011924,1005,100,,Cash sale,,,,,,12/12/2018,12/12/2018,0.00,,7.29,,"-1,235,187.20"
,CS,AR,32011942,1005,100,,Cash sale,,,,,,12/12/2018,12/12/2018,0.00,,27.97,,"-1,235,215.17"
,CS,AR,32011952,1005,100,,Cash sale,,,,,,12/12/2018,12/12/2018,0.00,,5.17,,"-1,235,220.34"
,CS,AR,32011967,1005,100,,Cash sale,,,,,,12/12/2018,12/12/2018,0.00,,7.29,,"-1,235,227.63"
,CS,AR,32011977,1005,100,,Cash sale,,,,,,12/12/2018,12/12/2018,0.00,,15.04,,"-1,235,242.67"
,CS,AR,32011979,1005,100,,Cash sale,,,,,,12/12/2018,12/12/2018,0.00,,8.58,,"-1,235,251.25"
,CS,AR,32011993,1005,100,,Cash sale,,,,,,12/12/2018,12/12/2018,0.00,,14.58,,"-1,235,265.83"
,CS,AR,32012002,1005,100,,Cash sale,,,,,,12/12/2018,12/12/2018,0.00,,5.08,,"-1,235,270.91"
,CS,AR,32012023,1005,100,,Cash sale,,,,,,12/12/2018,12/12/2018,0.00,,4.32,,"-1,235,275.23"
,CS,AR,32012051,1005,100,,Cash sale,,,,,,12/12/2018,12/12/2018,0.00,,3.64,,"-1,235,278.87"
,CS,AR,32012058,1005,100,,Cash sale,,,,,,12/12/2018,12/12/2018,0.00,,14.58,,"-1,235,293.45"
,CS,AR,32012094,1005,100,,Cash sale,,,,,,12/12/2018,12/12/2018,0.00,,9.66,,"-1,235,303.11"
,CS,AR,32012113,1005,100,,Cash sale,,,,,,12/12/2018,12/12/2018,0.00,,7.29,,"-1,235,310.40"
,CS,AR,32012118,1005,100,,Cash sale,,,,,,12/12/2018,12/12/2018,0.00,,3.22,,"-1,235,313.62"
,CS,AR,32012125,1005,100,,Cash sale,,,,,,12/12/2018,12/12/2018,0.00,,7.29,,"-1,235,320.91"
,CS,AR,32012139,1005,100,,Cash sale,,,,,,12/12/2018,12/12/2018,0.00,,7.29,,"-1,235,328.20"
,CS,AR,32012152,1005,100,,Cash sale,,,,,,12/12/2018,12/12/2018,0.00,,5.34,,"-1,235,333.54"
,CS,AR,32012167,1005,100,,Cash sale,,,,,,12/12/2018,12/12/2018,0.00,,21.36,,"-1,235,354.90"
,CS,AR,32012169,1005,100,,Cash sale,,,,,,12/12/2018,12/12/2018,0.00,,3.64,,"-1,235,358.54"
,CS,AR,32012175,1005,100,,Cash sale,,,,,,12/12/2018,12/12/2018,0.00,,10.93,,"-1,235,369.47"
,CS,AR,32012184,1005,100,,Cash sale,,,,,,12/12/2018,12/12/2018,0.00,,10.47,,"-1,235,379.94"
,CS,AR,32012194,1005,100,,Cash sale,,,,,,12/12/2018,12/12/2018,0.00,,6.53,,"-1,235,386.47"
,CS,AR,32012209,1005,100,,Cash sale,,,,,,12/12/2018,12/12/2018,0.00,,3.64,,"-1,235,390.11"
,CS,AR,32012223,1005,100,,Cash sale,,,,,,12/12/2018,12/12/2018,0.00,,3.64,,"-1,235,393.75"
,CS,AR,32012247,1005,100,,Cash sale,,,,,,12/12/2018,12/12/2018,0.00,,3.64,,"-1,235,397.39"
,CS,AR,32012252,1005,100,,Cash sale,,,,,,12/12/2018,12/12/2018,0.00,,9.15,,"-1,235,406.54"
,CS,AR,32012262,1005,100,,Cash sale,,,,,,12/12/2018,12/12/2018,0.00,,9.10,,"-1,235,415.64"
,CS,AR,32012266,1005,100,,Cash sale,,,,,,12/12/2018,12/12/2018,0.00,,7.29,,"-1,235,422.93"
,CS,AR,32012272,1005,100,,Cash sale,,,,,,12/12/2018,12/12/2018,0.00,,12.14,,"-1,235,435.07"
,CS,AR,32012280,1005,100,,Cash sale,,,,,,12/12/2018,12/12/2018,0.00,,9.03,,"-1,235,444.10"
,CS,AR,32012282,1005,100,,Cash sale,,,,,,12/12/2018,12/12/2018,0.00,,7.29,,"-1,235,451.39"
,CS,AR,32012297,1005,100,,Cash sale,,,,,,12/12/2018,12/12/2018,0.00,,10.93,,"-1,235,462.32"
,CS,AR,32012357,1005,100,,Cash sale,,,,,,12/12/2018,12/12/2018,0.00,,6.56,,"-1,235,468.88"
,CS,AR,32012359,1005,100,,Cash sale,,,,,,12/12/2018,12/12/2018,0.00,,10.99,,"-1,235,479.87"
,CS,AR,32012459,1005,100,,Cash sale,,,,,,12/12/2018,12/12/2018,0.00,,7.29,,"-1,235,487.16"
,CS,AR,32012461,1005,100,,Cash sale,,,,,,12/12/2018,12/12/2018,0.00,,7.29,,"-1,235,494.45"
,CS,AR,32012484,1005,100,,Cash sale,,,,,,12/12/2018,12/12/2018,0.00,,14.58,,"-1,235,509.03"
,CS,AR,32012486,1005,100,,Cash sale,,,,,,12/12/2018,12/12/2018,0.00,,18.22,,"-1,235,527.25"
,CS,AR,32012494,1005,100,,Cash sale,,,,,,12/12/2018,12/12/2018,0.00,,14.58,,"-1,235,541.83"
,IN,AR,30333524,1005,100,,Invoice,,,,,,12/12/2018,12/12/2018,0.00,,5.93,,"-1,235,547.76"
,IN,AR,30333525,1005,100,,Invoice,,,,,,12/12/2018,12/12/2018,0.00,,20.76,,"-1,235,568.52"
,IN,AR,30333545,1005,100,,Invoice,,,,,,12/12/2018,12/12/2018,0.00,,14.58,,"-1,235,583.10"
,IN,AR,30333550,1005,100,,Invoice,,,,,,12/12/2018,12/12/2018,0.00,,14.58,,"-1,235,597.68"
,IN,AR,30333554,1005,100,,Invoice,,,,,,12/12/2018,12/12/2018,0.00,,65.90,,"-1,235,663.58"
,IN,AR,30333586,1005,100,,Invoice,,,,,,12/12/2018,12/12/2018,0.00,,16.27,,"-1,235,679.85"
,IN,AR,30333589,1005,100,,Invoice,,,,,,12/12/2018,12/12/2018,0.00,,11.36,,"-1,235,691.21"
,IN,AR,30333591,1005,100,,Invoice,,,,,,12/12/2018,12/12/2018,0.00,,10.93,,"-1,235,702.14"
,IN,AR,30333601,1005,100,,Invoice,,,,,,12/12/2018,12/12/2018,0.00,,21.02,,"-1,235,723.16"
,IN,AR,30333602,1005,100,,Invoice,,,,,,12/12/2018,12/12/2018,0.00,,60.42,,"-1,235,783.58"
,IN,AR,30333606,1005,100,,Invoice,,,,,,12/12/2018,12/12/2018,0.00,,14.58,,"-1,235,798.16"
,IN,AR,30333650,1005,100,,Invoice,,,,,,12/12/2018,12/12/2018,0.00,,3.98,,"-1,235,802.14"
,IN,AR,30333660,1005,100,,Invoice,,,,,,12/12/2018,12/12/2018,0.00,,52.00,,"-1,235,854.14"
,IN,AR,30333686,1005,100,,Invoice,,,,,,12/12/2018,12/12/2018,0.00,,7.29,,"-1,235,861.43"
,IN,AR,30333703,1005,100,,Invoice,,,,,,12/12/2018,12/12/2018,0.00,,7.29,,"-1,235,868.72"
,IN,AR,30333722,1005,100,,Invoice,,,,,,12/12/2018,12/12/2018,0.00,,18.00,,"-1,235,886.72"
,IN,AR,30333749,1005,100,,Invoice,,,,,,12/12/2018,12/12/2018,0.00,,34.00,,"-1,235,920.72"
,IN,AR,30333754,1005,100,,Invoice,,,,,,12/12/2018,12/12/2018,0.00,,8.77,,"-1,235,929.49"
,IN,AR,30333767,1005,100,,Invoice,,,,,,12/12/2018,12/12/2018,0.00,,16.00,,"-1,235,945.49"
,IN,AR,30333779,1005,100,,Invoice,,,,,,12/12/2018,12/12/2018,0.00,,38.44,,"-1,235,983.93"
,IN,AR,30333794,1005,100,,Invoice,,,,,,12/12/2018,12/12/2018,0.00,,87.32,,"-1,236,071.25"
,IN,AR,30333849,1005,100,,Invoice,,,,,,12/12/2018,12/12/2018,0.00,,13.26,,"-1,236,084.51"
,IN,AR,30333874,1005,100,,Invoice,,,,,,12/12/2018,12/12/2018,0.00,,14.00,,"-1,236,098.51"
,IN,AR,30333901,1005,100,,Invoice,,,,,,12/12/2018,12/12/2018,0.00,,7.29,,"-1,236,105.80"
,IN,AR,30333907,1005,100,,Invoice,,,,,,12/12/2018,12/12/2018,0.00,,25.42,,"-1,236,131.22"
,IN,AR,30333916,1005,100,,Invoice,,,,,,12/12/2018,12/12/2018,0.00,,4.24,,"-1,236,135.46"
,IN,AR,30333927,1005,100,,Invoice,,,,,,12/12/2018,12/12/2018,0.00,,4.24,,"-1,236,139.70"
,IN,AR,30333934,1005,100,,Invoice,,,,,,12/12/2018,12/12/2018,0.00,,8.39,,"-1,236,148.09"
,IN,AR,30333964,1005,100,,Invoice,,,,,,12/12/2018,12/12/2018,0.00,,21.86,,"-1,236,169.95"
,IN,AR,30333970,1005,100,,Invoice,,,,,,12/12/2018,12/12/2018,0.00,,9.56,,"-1,236,179.51"
,IN,AR,30333993,1005,100,,Invoice,,,,,,12/12/2018,12/12/2018,0.00,,32.81,,"-1,236,212.32"
,IN,AR,30334005,1005,100,,Invoice,,,,,,12/12/2018,12/12/2018,0.00,,25.42,,"-1,236,237.74"
,IN,AR,30334012,1005,100,,Invoice,,,,,,12/12/2018,12/12/2018,0.00,,29.15,,"-1,236,266.89"
,IN,AR,30334071,1005,100,,Invoice,,,,,,12/12/2018,12/12/2018,0.00,,252.08,,"-1,236,518.97"
,IN,AR,30334090,1005,100,,Invoice,,,,,,12/12/2018,12/12/2018,0.00,,5.08,,"-1,236,524.05"
,IN,AR,30334109,1005,100,,Invoice,,,,,,12/12/2018,12/12/2018,0.00,,1.59,,"-1,236,525.64"
,IN,AR,30334112,1005,100,,Invoice,,,,,,12/12/2018,12/12/2018,0.00,,18.39,,"-1,236,544.03"
,IN,AR,30334125,1005,100,,Invoice,,,,,,12/12/2018,12/12/2018,0.00,,10.93,,"-1,236,554.96"
,IN,AR,30334136,1005,100,,Invoice,,,,,,12/12/2018,12/12/2018,0.00,,4.24,,"-1,236,559.20"
,IN,AR,30334147,1005,100,,Invoice,,,,,,12/12/2018,12/12/2018,0.00,,2.58,,"-1,236,561.78"
,IN,AR,30334150,1005,100,,Invoice,,,,,,12/12/2018,12/12/2018,0.00,,11.36,,"-1,236,573.14"
,IN,AR,30334211,1005,100,,Invoice,,,,,,12/12/2018,12/12/2018,0.00,,10.93,,"-1,236,584.07"
,IN,AR,30334244,1005,100,,Invoice,,,,,,12/12/2018,12/12/2018,0.00,,14.03,,"-1,236,598.10"
,IN,AR,30334256,1005,100,,Invoice,,,,,,12/12/2018,12/12/2018,0.00,,17.80,,"-1,236,615.90"
,IN,AR,30334274,1005,100,,Invoice,,,,,,12/12/2018,12/12/2018,0.00,,7.29,,"-1,236,623.19"
,IN,AR,30334275,1005,100,,Invoice,,,,,,12/12/2018,12/12/2018,0.00,,18.22,,"-1,236,641.41"
,IN,AR,30334288,1005,100,,Invoice,,,,,,12/12/2018,12/12/2018,0.00,,7.29,,"-1,236,648.70"
,IN,AR,30334294,1005,100,,Invoice,,,,,,12/12/2018,12/12/2018,0.00,,16.78,,"-1,236,665.48"
,IN,AR,30334301,1005,100,,Invoice,,,,,,12/12/2018,12/12/2018,0.00,,10.17,,"-1,236,675.65"
,IN,AR,30334319,1005,100,,Invoice,,,,,,12/12/2018,12/12/2018,0.00,,8.14,,"-1,236,683.79"
,IN,AR,30334327,1005,100,,Invoice,,,,,,12/12/2018,12/12/2018,0.00,,5.85,,"-1,236,689.64"
,IN,AR,30334339,1005,100,,Invoice,,,,,,12/12/2018,12/12/2018,0.00,,8.39,,"-1,236,698.03"
,IN,AR,30334344,1005,100,,Invoice,,,,,,12/12/2018,12/12/2018,0.00,,7.75,,"-1,236,705.78"
,IN,AR,30334370,1005,100,,Invoice,,,,,,12/12/2018,12/12/2018,0.00,,30.08,,"-1,236,735.86"
,IN,AR,30334380,1005,100,,Invoice,,,,,,12/12/2018,12/12/2018,0.00,,10.99,,"-1,236,746.85"
,IN,AR,30334385,1005,100,,Invoice,,,,,,12/12/2018,12/12/2018,0.00,,11.64,,"-1,236,758.49"
,IN,AR,30334390,1005,100,,Invoice,,,,,,12/12/2018,12/12/2018,0.00,,6.53,,"-1,236,765.02"
,IN,AR,30334414,1005,100,,Invoice,,,,,,12/12/2018,12/12/2018,0.00,,13.14,,"-1,236,778.16"
,IN,AR,30334420,1005,100,,Invoice,,,,,,12/12/2018,12/12/2018,0.00,,12.33,,"-1,236,790.49"
,IN,AR,30334421,1005,100,,Invoice,,,,,,12/12/2018,12/12/2018,0.00,,3.53,,"-1,236,794.02"
,IN,AR,30334422,1005,100,,Invoice,,,,,,12/12/2018,12/12/2018,0.00,,3.53,,"-1,236,797.55"
,IN,AR,30334429,1005,100,,Invoice,,,,,,12/12/2018,12/12/2018,0.00,,18.05,,"-1,236,815.60"
,IN,AR,30334434,1005,100,,Invoice,,,,,,12/12/2018,12/12/2018,0.00,,10.93,,"-1,236,826.53"
,IN,AR,30334472,1005,100,,Invoice,,,,,,12/12/2018,12/12/2018,0.00,,6.00,,"-1,236,832.53"
,IN,AR,30334476,1005,100,,Invoice,,,,,,12/12/2018,12/12/2018,0.00,,29.15,,"-1,236,861.68"
,IN,AR,30334477,1005,100,,Invoice,,,,,,12/12/2018,12/12/2018,0.00,,29.15,,"-1,236,890.83"
,IN,AR,30334493,1005,100,,Invoice,,,,,,12/12/2018,12/12/2018,0.00,,2.84,,"-1,236,893.67"
,IN,AR,30334502,1005,100,,Invoice,,,,,,12/12/2018,12/12/2018,0.00,,10.17,,"-1,236,903.84"
,IN,AR,30334506,1005,100,,Invoice,,,,,,12/12/2018,12/12/2018,0.00,,10.93,,"-1,236,914.77"
,IN,AR,30334554,1005,100,,Invoice,,,,,,12/12/2018,12/12/2018,0.00,,24.00,,"-1,236,938.77"
,IN,AR,30334575,1005,100,,Invoice,,,,,,12/12/2018,12/12/2018,0.00,,7.29,,"-1,236,946.06"
,IN,AR,30334577,1005,100,,Invoice,,,,,,12/12/2018,12/12/2018,0.00,,56.06,,"-1,237,002.12"
,IN,AR,30334579,1005,100,,Invoice,,,,,,12/12/2018,12/12/2018,0.00,,3.64,,"-1,237,005.76"
,IN,AR,30334587,1005,100,,Invoice,,,,,,12/12/2018,12/12/2018,0.00,,21.86,,"-1,237,027.62"
,IN,AR,30334623,1005,100,,Invoice,,,,,,12/12/2018,12/12/2018,0.00,,7.64,,"-1,237,035.26"
,IN,AR,30334626,1005,100,,Invoice,,,,,,12/12/2018,12/12/2018,0.00,,6.56,,"-1,237,041.82"
,IN,AR,30334633,1005,100,,Invoice,,,,,,12/12/2018,12/12/2018,0.00,,43.97,,"-1,237,085.79"
,IN,AR,30334652,1005,100,,Invoice,,,,,,12/12/2018,12/12/2018,0.00,,7.63,,"-1,237,093.42"
,IN,AR,30334678,1005,100,,Invoice,,,,,,12/12/2018,12/12/2018,0.00,,16.01,,"-1,237,109.43"
,IN,AR,30334683,1005,100,,Invoice,,,,,,12/12/2018,12/12/2018,0.00,,5.83,,"-1,237,115.26"
,IN,AR,30334700,1005,100,,Invoice,,,,,,12/12/2018,12/12/2018,0.00,,2.92,,"-1,237,118.18"
,IN,AR,30334712,1005,100,,Invoice,,,,,,12/12/2018,12/12/2018,0.00,,8.41,,"-1,237,126.59"
,IN,AR,30334713,1005,100,,Invoice,,,,,,12/12/2018,12/12/2018,0.00,,2.10,,"-1,237,128.69"
,IN,AR,30334725,1005,100,,Invoice,,,,,,12/12/2018,12/12/2018,0.00,,4.66,,"-1,237,133.35"
,IN,AR,30334753,1005,100,,Invoice,,,,,,12/12/2018,12/12/2018,0.00,,19.64,,"-1,237,152.99"
,IN,AR,30334767,1005,100,,Invoice,,,,,,12/12/2018,12/12/2018,0.00,,5.47,,"-1,237,158.46"
,IN,AR,30334769,1005,100,,Invoice,,,,,,12/12/2018,12/12/2018,0.00,,5.59,,"-1,237,164.05"
,IN,AR,30334787,1005,100,,Invoice,,,,,,12/12/2018,12/12/2018,0.00,,20.01,,"-1,237,184.06"
,IN,AR,30334846,1005,100,,Invoice,,,,,,12/12/2018,12/12/2018,0.00,,6.37,,"-1,237,190.43"
,IN,AR,30334847,1005,100,,Invoice,,,,,,12/12/2018,12/12/2018,0.00,,9.56,,"-1,237,199.99"
,IN,AR,30334848,1005,100,,Invoice,,,,,,12/12/2018,12/12/2018,0.00,,97.19,,"-1,237,297.18"
,IN,AR,30334849,1005,100,,Invoice,,,,,,12/12/2018,12/12/2018,0.00,,3.19,,"-1,237,300.37"
,IN,AR,30334850,1005,100,,Invoice,,,,,,12/12/2018,12/12/2018,0.00,,7.97,,"-1,237,308.34"
,IN,AR,30334851,1005,100,,Invoice,,,,,,12/12/2018,12/12/2018,0.00,,6.37,,"-1,237,314.71"
,IN,AR,30334935,1005,100,,Invoice,,,,,,12/12/2018,12/12/2018,0.00,,3.51,,"-1,237,318.22"
,IN,AR,30334971,1005,100,,Invoice,,,,,,12/12/2018,12/12/2018,0.00,,54.66,,"-1,237,372.88"
,IN,AR,30334992,1005,100,,Invoice,,,,,,12/12/2018,12/12/2018,0.00,,9.41,,"-1,237,382.29"
,IN,AR,30335059,1005,100,,Invoice,,,,,,12/12/2018,12/12/2018,0.00,,4.08,,"-1,237,386.37"
,IN,AR,30335104,1005,100,,Invoice,,,,,,12/12/2018,12/12/2018,0.00,,20.59,,"-1,237,406.96"
,IN,AR,30335109,1005,100,,Invoice,,,,,,12/12/2018,12/12/2018,0.00,,182.20,,"-1,237,589.16"
,IN,AR,30335141,1005,100,,Invoice,,,,,,12/12/2018,12/12/2018,0.00,,43.60,,"-1,237,632.76"
,IN,AR,30335142,1005,100,,Invoice,,,,,,12/12/2018,12/12/2018,0.00,,4.15,,"-1,237,636.91"
,IN,AR,30335143,1005,100,,Invoice,,,,,,12/12/2018,12/12/2018,0.00,,8.31,,"-1,237,645.22"
,IN,AR,30335144,1005,100,,Invoice,,,,,,12/12/2018,12/12/2018,0.00,,12.46,,"-1,237,657.68"
,IN,AR,30335164,1005,100,,Invoice,,,,,,12/12/2018,12/12/2018,0.00,,5.08,,"-1,237,662.76"
,IN,AR,30335176,1005,100,,Invoice,,,,,,12/12/2018,12/12/2018,0.00,,24.27,,"-1,237,687.03"
,IN,AR,30335233,1005,100,,Invoice,,,,,,12/12/2018,12/12/2018,0.00,,6.31,,"-1,237,693.34"
,IN,AR,30335242,1005,100,,Invoice,,,,,,12/12/2018,12/12/2018,0.00,,11.19,,"-1,237,704.53"
,IN,AR,30335270,1005,100,,Invoice,,,,,,12/12/2018,12/12/2018,0.00,,2.97,,"-1,237,707.50"
,IN,AR,30335281,1005,100,,Invoice,,,,,,12/12/2018,12/12/2018,0.00,,10.93,,"-1,237,718.43"
,IN,AR,30335290,1005,100,,Invoice,,,,,,12/12/2018,12/12/2018,0.00,,7.19,,"-1,237,725.62"
,IN,AR,30335338,1005,100,,Invoice,,,,,,12/12/2018,12/12/2018,0.00,,3.64,,"-1,237,729.26"
,IN,AR,30335342,1005,100,,Invoice,,,,,,12/12/2018,12/12/2018,0.00,,3.64,,"-1,237,732.90"
,IN,AR,30335345,1005,100,,Invoice,,,,,,12/12/2018,12/12/2018,0.00,,3.64,,"-1,237,736.54"
,IN,AR,30335362,1005,100,,Invoice,,,,,,12/12/2018,12/12/2018,0.00,,29.15,,"-1,237,765.69"
,IN,AR,30335367,1005,100,,Invoice,,,,,,12/12/2018,12/12/2018,0.00,,5.98,,"-1,237,771.67"
,IN,AR,30335368,1005,100,,Invoice,,,,,,12/12/2018,12/12/2018,0.00,,2.99,,"-1,237,774.66"
,IN,AR,30335369,1005,100,,Invoice,,,,,,12/12/2018,12/12/2018,0.00,,11.96,,"-1,237,786.62"
,IN,AR,30335374,1005,100,,Invoice,,,,,,12/12/2018,12/12/2018,0.00,,29.15,,"-1,237,815.77"
,IN,AR,30335376,1005,100,,Invoice,,,,,,12/12/2018,12/12/2018,0.00,,692.37,,"-1,238,508.14"
,IN,AR,30335378,1005,100,,Invoice,,,,,,12/12/2018,12/12/2018,0.00,,182.20,,"-1,238,690.34"
,IN,AR,30335266,1005,100,,Invoice,,,,,,13/12/2018,13/12/2018,0.00,,29.15,,"-1,238,719.49"
,CR,AR,33000320,1005,100,,Cash Return,,,,,,14/12/2018,14/12/2018,10.93,,0.00,,"-1,238,708.56"
,CS,AR,32011754,1005,100,,Cash sale,,,,,,14/12/2018,14/12/2018,0.00,,8.42,,"-1,238,716.98"
,CS,AR,32011758,1005,100,,Cash sale,,,,,,14/12/2018,14/12/2018,0.00,,23.73,,"-1,238,740.71"
,CS,AR,32011765,1005,100,,Cash sale,,,,,,14/12/2018,14/12/2018,0.00,,9.49,,"-1,238,750.20"
,CS,AR,32011777,1005,100,,Cash sale,,,,,,14/12/2018,14/12/2018,0.00,,6.08,,"-1,238,756.28"
,CS,AR,32011784,1005,100,,Cash sale,,,,,,14/12/2018,14/12/2018,0.00,,3.64,,"-1,238,759.92"
,CS,AR,32011827,1005,100,,Cash sale,,,,,,14/12/2018,14/12/2018,0.00,,7.25,,"-1,238,767.17"
,CS,AR,32011841,1005,100,,Cash sale,,,,,,14/12/2018,14/12/2018,0.00,,10.93,,"-1,238,778.10"
,CS,AR,32011846,1005,100,,Cash sale,,,,,,14/12/2018,14/12/2018,0.00,,16.61,,"-1,238,794.71"
,CS,AR,32011856,1005,100,,Cash sale,,,,,,14/12/2018,14/12/2018,0.00,,3.64,,"-1,238,798.35"
,CS,AR,32011866,1005,100,,Cash sale,,,,,,14/12/2018,14/12/2018,0.00,,7.78,,"-1,238,806.13"
,CS,AR,32011871,1005,100,,Cash sale,,,,,,14/12/2018,14/12/2018,0.00,,3.64,,"-1,238,809.77"
,CS,AR,32011888,1005,100,,Cash sale,,,,,,14/12/2018,14/12/2018,0.00,,23.29,,"-1,238,833.06"
,CS,AR,32011894,1005,100,,Cash sale,,,,,,14/12/2018,14/12/2018,0.00,,3.64,,"-1,238,836.70"
,CS,AR,32011927,1005,100,,Cash sale,,,,,,14/12/2018,14/12/2018,0.00,,21.86,,"-1,238,858.56"
,CS,AR,32011937,1005,100,,Cash sale,,,,,,14/12/2018,14/12/2018,0.00,,10.17,,"-1,238,868.73"
,CS,AR,32011955,1005,100,,Cash sale,,,,,,14/12/2018,14/12/2018,0.00,,3.64,,"-1,238,872.37"
,CS,AR,32011985,1005,100,,Cash sale,,,,,,14/12/2018,14/12/2018,0.00,,6.02,,"-1,238,878.39"
,CS,AR,32011991,1005,100,,Cash sale,,,,,,14/12/2018,14/12/2018,0.00,,3.64,,"-1,238,882.03"
,CS,AR,32012008,1005,100,,Cash sale,,,,,,14/12/2018,14/12/2018,0.00,,10.81,,"-1,238,892.84"
,CS,AR,32012013,1005,100,,Cash sale,,,,,,14/12/2018,14/12/2018,0.00,,14.62,,"-1,238,907.46"
,CS,AR,32012031,1005,100,,Cash sale,,,,,,14/12/2018,14/12/2018,0.00,,18.05,,"-1,238,925.51"
,CS,AR,32012039,1005,100,,Cash sale,,,,,,14/12/2018,14/12/2018,0.00,,15.25,,"-1,238,940.76"
,CS,AR,32012048,1005,100,,Cash sale,,,,,,14/12/2018,14/12/2018,0.00,,3.64,,"-1,238,944.40"
,CS,AR,32012061,1005,100,,Cash sale,,,,,,14/12/2018,14/12/2018,0.00,,3.64,,"-1,238,948.04"
,CS,AR,32012074,1005,100,,Cash sale,,,,,,14/12/2018,14/12/2018,0.00,,3.64,,"-1,238,951.68"
,CS,AR,32012100,1005,100,,Cash sale,,,,,,14/12/2018,14/12/2018,0.00,,12.92,,"-1,238,964.60"
,CS,AR,32012122,1005,100,,Cash sale,,,,,,14/12/2018,14/12/2018,0.00,,14.63,,"-1,238,979.23"
,CS,AR,32012141,1005,100,,Cash sale,,,,,,14/12/2018,14/12/2018,0.00,,3.64,,"-1,238,982.87"
,CS,AR,32012150,1005,100,,Cash sale,,,,,,14/12/2018,14/12/2018,0.00,,5.56,,"-1,238,988.43"
,CS,AR,32012176,1005,100,,Cash sale,,,,,,14/12/2018,14/12/2018,0.00,,7.29,,"-1,238,995.72"
,CS,AR,32012180,1005,100,,Cash sale,,,,,,14/12/2018,14/12/2018,0.00,,18.22,,"-1,239,013.94"
,CS,AR,32012191,1005,100,,Cash sale,,,,,,14/12/2018,14/12/2018,0.00,,3.01,,"-1,239,016.95"
,CS,AR,32012199,1005,100,,Cash sale,,,,,,14/12/2018,14/12/2018,0.00,,4.08,,"-1,239,021.03"
,CS,AR,32012206,1005,100,,Cash sale,,,,,,14/12/2018,14/12/2018,0.00,,3.64,,"-1,239,024.67"
,CS,AR,32012240,1005,100,,Cash sale,,,,,,14/12/2018,14/12/2018,0.00,,7.63,,"-1,239,032.30"
,CS,AR,32012253,1005,100,,Cash sale,,,,,,14/12/2018,14/12/2018,0.00,,6.86,,"-1,239,039.16"
,CS,AR,32012278,1005,100,,Cash sale,,,,,,14/12/2018,14/12/2018,0.00,,57.68,,"-1,239,096.84"
,CS,AR,32012298,1005,100,,Cash sale,,,,,,14/12/2018,14/12/2018,0.00,,10.93,,"-1,239,107.77"
,CS,AR,32012306,1005,100,,Cash sale,,,,,,14/12/2018,14/12/2018,0.00,,3.64,,"-1,239,111.41"
,CS,AR,32012309,1005,100,,Cash sale,,,,,,14/12/2018,14/12/2018,0.00,,12.14,,"-1,239,123.55"
,CS,AR,32012313,1005,100,,Cash sale,,,,,,14/12/2018,14/12/2018,0.00,,12.20,,"-1,239,135.75"
,CS,AR,32012353,1005,100,,Cash sale,,,,,,14/12/2018,14/12/2018,0.00,,3.64,,"-1,239,139.39"
,CS,AR,32012354,1005,100,,Cash sale,,,,,,14/12/2018,14/12/2018,0.00,,10.93,,"-1,239,150.32"
,CS,AR,32012370,1005,100,,Cash sale,,,,,,14/12/2018,14/12/2018,0.00,,6.02,,"-1,239,156.34"
,CS,AR,32012379,1005,100,,Cash sale,,,,,,14/12/2018,14/12/2018,0.00,,5.94,,"-1,239,162.28"
,CS,AR,32012464,1005,100,,Cash sale,,,,,,14/12/2018,14/12/2018,0.00,,18.22,,"-1,239,180.50"
,CS,AR,32012467,1005,100,,Cash sale,,,,,,14/12/2018,14/12/2018,0.00,,3.64,,"-1,239,184.14"
,CS,AR,32012477,1005,100,,Cash sale,,,,,,14/12/2018,14/12/2018,0.00,,182.20,,"-1,239,366.34"
,CS,AR,32012480,1005,100,,Cash sale,,,,,,14/12/2018,14/12/2018,0.00,,36.44,,"-1,239,402.78"
,CS,AR,32012490,1005,100,,Cash sale,,,,,,14/12/2018,14/12/2018,0.00,,2.97,,"-1,239,405.75"
,CS,AR,32012491,1005,100,,Cash sale,,,,,,14/12/2018,14/12/2018,0.00,,18.22,,"-1,239,423.97"
,IN,AR,30333516,1005,100,,Invoice,,,,,,14/12/2018,14/12/2018,0.00,,8.90,,"-1,239,432.87"
,IN,AR,30333526,1005,100,,Invoice,,,,,,14/12/2018,14/12/2018,0.00,,44.49,,"-1,239,477.36"
,IN,AR,30333532,1005,100,,Invoice,,,,,,14/12/2018,14/12/2018,0.00,,21.86,,"-1,239,499.22"
,IN,AR,30333534,1005,100,,Invoice,,,,,,14/12/2018,14/12/2018,0.00,,7.29,,"-1,239,506.51"
,IN,AR,30333542,1005,100,,Invoice,,,,,,14/12/2018,14/12/2018,0.00,,11.19,,"-1,239,517.70"
,IN,AR,30333587,1005,100,,Invoice,,,,,,14/12/2018,14/12/2018,0.00,,21.86,,"-1,239,539.56"
,IN,AR,30333605,1005,100,,Invoice,,,,,,14/12/2018,14/12/2018,0.00,,6.02,,"-1,239,545.58"
,IN,AR,30333610,1005,100,,Invoice,,,,,,14/12/2018,14/12/2018,0.00,,9.66,,"-1,239,555.24"
,IN,AR,30333628,1005,100,,Invoice,,,,,,14/12/2018,14/12/2018,0.00,,46.50,,"-1,239,601.74"
,IN,AR,30333637,1005,100,,Invoice,,,,,,14/12/2018,14/12/2018,0.00,,22.97,,"-1,239,624.71"
,IN,AR,30333641,1005,100,,Invoice,,,,,,14/12/2018,14/12/2018,0.00,,77.63,,"-1,239,702.34"
,IN,AR,30333661,1005,100,,Invoice,,,,,,14/12/2018,14/12/2018,0.00,,88.00,,"-1,239,790.34"
,IN,AR,30333682,1005,100,,Invoice,,,,,,14/12/2018,14/12/2018,0.00,,62.00,,"-1,239,852.34"
,IN,AR,30333708,1005,100,,Invoice,,,,,,14/12/2018,14/12/2018,0.00,,10.93,,"-1,239,863.27"
,IN,AR,30333723,1005,100,,Invoice,,,,,,14/12/2018,14/12/2018,0.00,,28.00,,"-1,239,891.27"
,IN,AR,30333731,1005,100,,Invoice,,,,,,14/12/2018,14/12/2018,0.00,,10.93,,"-1,239,902.20"
,IN,AR,30333758,1005,100,,Invoice,,,,,,14/12/2018,14/12/2018,0.00,,3.64,,"-1,239,905.84"
,IN,AR,30333762,1005,100,,Invoice,,,,,,14/12/2018,14/12/2018,0.00,,80.68,,"-1,239,986.52"
,IN,AR,30333763,1005,100,,Invoice,,,,,,14/12/2018,14/12/2018,0.00,,7.12,,"-1,239,993.64"
,IN,AR,30333768,1005,100,,Invoice,,,,,,14/12/2018,14/12/2018,0.00,,16.00,,"-1,240,009.64"
,IN,AR,30333808,1005,100,,Invoice,,,,,,14/12/2018,14/12/2018,0.00,,9.70,,"-1,240,019.34"
,IN,AR,30333809,1005,100,,Invoice,,,,,,14/12/2018,14/12/2018,0.00,,7.76,,"-1,240,027.10"
,IN,AR,30333820,1005,100,,Invoice,,,,,,14/12/2018,14/12/2018,0.00,,28.00,,"-1,240,055.10"
,IN,AR,30333825,1005,100,,Invoice,,,,,,14/12/2018,14/12/2018,0.00,,3.64,,"-1,240,058.74"
,IN,AR,30333838,1005,100,,Invoice,,,,,,14/12/2018,14/12/2018,0.00,,21.86,,"-1,240,080.60"
,IN,AR,30333863,1005,100,,Invoice,,,,,,14/12/2018,14/12/2018,0.00,,9.56,,"-1,240,090.16"
,IN,AR,30333870,1005,100,,Invoice,,,,,,14/12/2018,14/12/2018,0.00,,3.64,,"-1,240,093.80"
,IN,AR,30333940,1005,100,,Invoice,,,,,,14/12/2018,14/12/2018,0.00,,21.86,,"-1,240,115.66"
,IN,AR,30333946,1005,100,,Invoice,,,,,,14/12/2018,14/12/2018,0.00,,25.85,,"-1,240,141.51"
,IN,AR,30333951,1005,100,,Invoice,,,,,,14/12/2018,14/12/2018,0.00,,4.78,,"-1,240,146.29"
,IN,AR,30333975,1005,100,,Invoice,,,,,,14/12/2018,14/12/2018,0.00,,6.02,,"-1,240,152.31"
,IN,AR,30333985,1005,100,,Invoice,,,,,,14/12/2018,14/12/2018,0.00,,41.21,,"-1,240,193.52"
,IN,AR,30333994,1005,100,,Invoice,,,,,,14/12/2018,14/12/2018,0.00,,45.12,,"-1,240,238.64"
,IN,AR,30333999,1005,100,,Invoice,,,,,,14/12/2018,14/12/2018,0.00,,33.66,,"-1,240,272.30"
,IN,AR,30334006,1005,100,,Invoice,,,,,,14/12/2018,14/12/2018,0.00,,76.27,,"-1,240,348.57"
,IN,AR,30334020,1005,100,,Invoice,,,,,,14/12/2018,14/12/2018,0.00,,16.73,,"-1,240,365.30"
,IN,AR,30334021,1005,100,,Invoice,,,,,,14/12/2018,14/12/2018,0.00,,35.85,,"-1,240,401.15"
,IN,AR,30334028,1005,100,,Invoice,,,,,,14/12/2018,14/12/2018,0.00,,3.64,,"-1,240,404.79"
,IN,AR,30334044,1005,100,,Invoice,,,,,,14/12/2018,14/12/2018,0.00,,3.01,,"-1,240,407.80"
,IN,AR,30334075,1005,100,,Invoice,,,,,,14/12/2018,14/12/2018,0.00,,12.71,,"-1,240,420.51"
,IN,AR,30334091,1005,100,,Invoice,,,,,,14/12/2018,14/12/2018,0.00,,5.08,,"-1,240,425.59"
,IN,AR,30334092,1005,100,,Invoice,,,,,,14/12/2018,14/12/2018,0.00,,7.63,,"-1,240,433.22"
,IN,AR,30334093,1005,100,,Invoice,,,,,,14/12/2018,14/12/2018,0.00,,2.54,,"-1,240,435.76"
,IN,AR,30334103,1005,100,,Invoice,,,,,,14/12/2018,14/12/2018,0.00,,2.54,,"-1,240,438.30"
,IN,AR,30334129,1005,100,,Invoice,,,,,,14/12/2018,14/12/2018,0.00,,12.71,,"-1,240,451.01"
,IN,AR,30334134,1005,100,,Invoice,,,,,,14/12/2018,14/12/2018,0.00,,6.36,,"-1,240,457.37"
,IN,AR,30334148,1005,100,,Invoice,,,,,,14/12/2018,14/12/2018,0.00,,7.29,,"-1,240,464.66"
,IN,AR,30334162,1005,100,,Invoice,,,,,,14/12/2018,14/12/2018,0.00,,17.50,,"-1,240,482.16"
,IN,AR,30334172,1005,100,,Invoice,,,,,,14/12/2018,14/12/2018,0.00,,3.64,,"-1,240,485.80"
,IN,AR,30334185,1005,100,,Invoice,,,,,,14/12/2018,14/12/2018,0.00,,5.08,,"-1,240,490.88"
,IN,AR,30334196,1005,100,,Invoice,,,,,,14/12/2018,14/12/2018,0.00,,14.58,,"-1,240,505.46"
,IN,AR,30334272,1005,100,,Invoice,,,,,,14/12/2018,14/12/2018,0.00,,21.86,,"-1,240,527.32"
,IN,AR,30334281,1005,100,,Invoice,,,,,,14/12/2018,14/12/2018,0.00,,7.29,,"-1,240,534.61"
,IN,AR,30334283,1005,100,,Invoice,,,,,,14/12/2018,14/12/2018,0.00,,2.12,,"-1,240,536.73"
,IN,AR,30334318,1005,100,,Invoice,,,,,,14/12/2018,14/12/2018,0.00,,7.29,,"-1,240,544.02"
,IN,AR,30334375,1005,100,,Invoice,,,,,,14/12/2018,14/12/2018,0.00,,15.04,,"-1,240,559.06"
,IN,AR,30334423,1005,100,,Invoice,,,,,,14/12/2018,14/12/2018,0.00,,8.81,,"-1,240,567.87"
,IN,AR,30334441,1005,100,,Invoice,,,,,,14/12/2018,14/12/2018,0.00,,4.85,,"-1,240,572.72"
,IN,AR,30334459,1005,100,,Invoice,,,,,,14/12/2018,14/12/2018,0.00,,5.17,,"-1,240,577.89"
,IN,AR,30334467,1005,100,,Invoice,,,,,,14/12/2018,14/12/2018,0.00,,29.15,,"-1,240,607.04"
,IN,AR,30334504,1005,100,,Invoice,,,,,,14/12/2018,14/12/2018,0.00,,29.24,,"-1,240,636.28"
,IN,AR,30334515,1005,100,,Invoice,,,,,,14/12/2018,14/12/2018,0.00,,7.97,,"-1,240,644.25"
,IN,AR,30334549,1005,100,,Invoice,,,,,,14/12/2018,14/12/2018,0.00,,31.23,,"-1,240,675.48"
,IN,AR,30334557,1005,100,,Invoice,,,,,,14/12/2018,14/12/2018,0.00,,44.00,,"-1,240,719.48"
,IN,AR,30334560,1005,100,,Invoice,,,,,,14/12/2018,14/12/2018,0.00,,18.33,,"-1,240,737.81"
,IN,AR,30334595,1005,100,,Invoice,,,,,,14/12/2018,14/12/2018,0.00,,32.42,,"-1,240,770.23"
,IN,AR,30334603,1005,100,,Invoice,,,,,,14/12/2018,14/12/2018,0.00,,10.93,,"-1,240,781.16"
,IN,AR,30334605,1005,100,,Invoice,,,,,,14/12/2018,14/12/2018,0.00,,7.29,,"-1,240,788.45"
,IN,AR,30334610,1005,100,,Invoice,,,,,,14/12/2018,14/12/2018,0.00,,23.64,,"-1,240,812.09"
,IN,AR,30334627,1005,100,,Invoice,,,,,,14/12/2018,14/12/2018,0.00,,7.29,,"-1,240,819.38"
,IN,AR,30334636,1005,100,,Invoice,,,,,,14/12/2018,14/12/2018,0.00,,14.34,,"-1,240,833.72"
,IN,AR,30334653,1005,100,,Invoice,,,,,,14/12/2018,14/12/2018,0.00,,10.17,,"-1,240,843.89"
,IN,AR,30334664,1005,100,,Invoice,,,,,,14/12/2018,14/12/2018,0.00,,12.00,,"-1,240,855.89"
,IN,AR,30334676,1005,100,,Invoice,,,,,,14/12/2018,14/12/2018,0.00,,10.00,,"-1,240,865.89"
,IN,AR,30334690,1005,100,,Invoice,,,,,,14/12/2018,14/12/2018,0.00,,73.81,,"-1,240,939.70"
,IN,AR,30334714,1005,100,,Invoice,,,,,,14/12/2018,14/12/2018,0.00,,67.29,,"-1,241,006.99"
,IN,AR,30334715,1005,100,,Invoice,,,,,,14/12/2018,14/12/2018,0.00,,10.52,,"-1,241,017.51"
,IN,AR,30334719,1005,100,,Invoice,,,,,,14/12/2018,14/12/2018,0.00,,21.86,,"-1,241,039.37"
,IN,AR,30334745,1005,100,,Invoice,,,,,,14/12/2018,14/12/2018,0.00,,36.44,,"-1,241,075.81"
,IN,AR,30334754,1005,100,,Invoice,,,,,,14/12/2018,14/12/2018,0.00,,16.83,,"-1,241,092.64"
,IN,AR,30334760,1005,100,,Invoice,,,,,,14/12/2018,14/12/2018,0.00,,4.59,,"-1,241,097.23"
,IN,AR,30334776,1005,100,,Invoice,,,,,,14/12/2018,14/12/2018,0.00,,14.58,,"-1,241,111.81"
,IN,AR,30334788,1005,100,,Invoice,,,,,,14/12/2018,14/12/2018,0.00,,6.23,,"-1,241,118.04"
,IN,AR,30334816,1005,100,,Invoice,,,,,,14/12/2018,14/12/2018,0.00,,14.58,,"-1,241,132.62"
,IN,AR,30334826,1005,100,,Invoice,,,,,,14/12/2018,14/12/2018,0.00,,2.84,,"-1,241,135.46"
,IN,AR,30334923,1005,100,,Invoice,,,,,,14/12/2018,14/12/2018,0.00,,10.00,,"-1,241,145.46"
,IN,AR,30334976,1005,100,,Invoice,,,,,,14/12/2018,14/12/2018,0.00,,10.95,,"-1,241,156.41"
,IN,AR,30334987,1005,100,,Invoice,,,,,,14/12/2018,14/12/2018,0.00,,25.42,,"-1,241,181.83"
,IN,AR,30335038,1005,100,,Invoice,,,,,,14/12/2018,14/12/2018,0.00,,7.29,,"-1,241,189.12"
,IN,AR,30335053,1005,100,,Invoice,,,,,,14/12/2018,14/12/2018,0.00,,6.13,,"-1,241,195.25"
,IN,AR,30335074,1005,100,,Invoice,,,,,,14/12/2018,14/12/2018,0.00,,7.29,,"-1,241,202.54"
,IN,AR,30335091,1005,100,,Invoice,,,,,,14/12/2018,14/12/2018,0.00,,3.98,,"-1,241,206.52"
,IN,AR,30335110,1005,100,,Invoice,,,,,,14/12/2018,14/12/2018,0.00,,7.29,,"-1,241,213.81"
,IN,AR,30335178,1005,100,,Invoice,,,,,,14/12/2018,14/12/2018,0.00,,27.03,,"-1,241,240.84"
,IN,AR,30335188,1005,100,,Invoice,,,,,,14/12/2018,14/12/2018,0.00,,10.86,,"-1,241,251.70"
,IN,AR,30335195,1005,100,,Invoice,,,,,,14/12/2018,14/12/2018,0.00,,7.29,,"-1,241,258.99"
,IN,AR,30335200,1005,100,,Invoice,,,,,,14/12/2018,14/12/2018,0.00,,4.07,,"-1,241,263.06"
,IN,AR,30335210,1005,100,,Invoice,,,,,,14/12/2018,14/12/2018,0.00,,69.24,,"-1,241,332.30"
,IN,AR,30335215,1005,100,,Invoice,,,,,,14/12/2018,14/12/2018,0.00,,5.26,,"-1,241,337.56"
,IN,AR,30335245,1005,100,,Invoice,,,,,,14/12/2018,14/12/2018,0.00,,29.15,,"-1,241,366.71"
,IN,AR,30335252,1005,100,,Invoice,,,,,,14/12/2018,14/12/2018,0.00,,66.75,,"-1,241,433.46"
,IN,AR,30335273,1005,100,,Invoice,,,,,,14/12/2018,14/12/2018,0.00,,6.07,,"-1,241,439.53"
,IN,AR,30335279,1005,100,,Invoice,,,,,,14/12/2018,14/12/2018,0.00,,7.29,,"-1,241,446.82"
,IN,AR,30335283,1005,100,,Invoice,,,,,,14/12/2018,14/12/2018,0.00,,14.58,,"-1,241,461.40"
,IN,AR,30335291,1005,100,,Invoice,,,,,,14/12/2018,14/12/2018,0.00,,3.59,,"-1,241,464.99"
,IN,AR,30335379,1005,100,,Invoice,,,,,,14/12/2018,14/12/2018,0.00,,29.15,,"-1,241,494.14"
,CS,AR,32012326,1005,100,,Cash sale,,,,,,15/12/2018,15/12/2018,0.00,,14.58,,"-1,241,508.72"
,CS,AR,32012347,1005,100,,Cash sale,,,,,,15/12/2018,15/12/2018,0.00,,7.29,,"-1,241,516.01"
,CS,AR,32012492,1005,100,,Cash sale,,,,,,15/12/2018,15/12/2018,0.00,,21.86,,"-1,241,537.87"
,CS,AR,32012497,1005,100,,Cash sale,,,,,,15/12/2018,15/12/2018,0.00,,14.58,,"-1,241,552.45"
,IN,AR,30333801,1005,100,,Invoice,,,,,,15/12/2018,15/12/2018,0.00,,406.75,,"-1,241,959.20"
,IN,AR,30333909,1005,100,,Invoice,,,,,,15/12/2018,15/12/2018,0.00,,7.17,,"-1,241,966.37"
,IN,AR,30334286,1005,100,,Invoice,,,,,,15/12/2018,15/12/2018,0.00,,10.93,,"-1,241,977.30"
,IN,AR,30334409,1005,100,,Invoice,,,,,,15/12/2018,15/12/2018,0.00,,47.17,,"-1,242,024.47"
,IN,AR,30334959,1005,100,,Invoice,,,,,,15/12/2018,15/12/2018,0.00,,31.95,,"-1,242,056.42"
,IN,AR,30334997,1005,100,,Invoice,,,,,,15/12/2018,15/12/2018,0.00,,7.29,,"-1,242,063.71"
,IN,AR,30335112,1005,100,,Invoice,,,,,,15/12/2018,15/12/2018,0.00,,7.29,,"-1,242,071.00"
,IN,AR,30335196,1005,100,,Invoice,,,,,,15/12/2018,15/12/2018,0.00,,6.56,,"-1,242,077.56"
,IN,AR,30335220,1005,100,,Invoice,,,,,,15/12/2018,15/12/2018,0.00,,7.29,,"-1,242,084.85"
,CS,AR,32012462,1005,100,,Cash sale,,,,,,16/12/2018,16/12/2018,0.00,,54.66,,"-1,242,139.51"
,IN,AR,30334687,1005,100,,Invoice,,,,,,16/12/2018,16/12/2018,0.00,,29.15,,"-1,242,168.66"
,CN,AR,31019723,1005,100,,Credit Note,,,,,,17/12/2018,17/12/2018,"7,204.87",,0.00,,"-1,234,963.79"
,CN,AR,31019737,1005,100,,Credit Note,,,,,,17/12/2018,17/12/2018,189.27,,0.00,,"-1,234,774.52"
,CS,AR,32011755,1005,100,,Cash sale,,,,,,17/12/2018,17/12/2018,0.00,,2.81,,"-1,234,777.33"
,CS,AR,32011766,1005,100,,Cash sale,,,,,,17/12/2018,17/12/2018,0.00,,4.75,,"-1,234,782.08"
,CS,AR,32011793,1005,100,,Cash sale,,,,,,17/12/2018,17/12/2018,0.00,,3.64,,"-1,234,785.72"
,CS,AR,32011816,1005,100,,Cash sale,,,,,,17/12/2018,17/12/2018,0.00,,3.64,,"-1,234,789.36"
,CS,AR,32011847,1005,100,,Cash sale,,,,,,17/12/2018,17/12/2018,0.00,,12.46,,"-1,234,801.82"
,CS,AR,32011867,1005,100,,Cash sale,,,,,,17/12/2018,17/12/2018,0.00,,5.84,,"-1,234,807.66"
,CS,AR,32011874,1005,100,,Cash sale,,,,,,17/12/2018,17/12/2018,0.00,,10.93,,"-1,234,818.59"
,CS,AR,32011901,1005,100,,Cash sale,,,,,,17/12/2018,17/12/2018,0.00,,3.64,,"-1,234,822.23"
,CS,AR,32011903,1005,100,,Cash sale,,,,,,17/12/2018,17/12/2018,0.00,,7.29,,"-1,234,829.52"
,CS,AR,32011909,1005,100,,Cash sale,,,,,,17/12/2018,17/12/2018,0.00,,10.34,,"-1,234,839.86"
,CS,AR,32011915,1005,100,,Cash sale,,,,,,17/12/2018,17/12/2018,0.00,,10.93,,"-1,234,850.79"
,CS,AR,32011923,1005,100,,Cash sale,,,,,,17/12/2018,17/12/2018,0.00,,7.29,,"-1,234,858.08"
,CS,AR,32011925,1005,100,,Cash sale,,,,,,17/12/2018,17/12/2018,0.00,,7.29,,"-1,234,865.37"
,CS,AR,32011938,1005,100,,Cash sale,,,,,,17/12/2018,17/12/2018,0.00,,7.63,,"-1,234,873.00"
,CS,AR,32011946,1005,100,,Cash sale,,,,,,17/12/2018,17/12/2018,0.00,,10.93,,"-1,234,883.93"
,CS,AR,32011974,1005,100,,Cash sale,,,,,,17/12/2018,17/12/2018,0.00,,32.97,,"-1,234,916.90"
,CS,AR,32012014,1005,100,,Cash sale,,,,,,17/12/2018,17/12/2018,0.00,,17.54,,"-1,234,934.44"
,CS,AR,32012019,1005,100,,Cash sale,,,,,,17/12/2018,17/12/2018,0.00,,8.16,,"-1,234,942.60"
,CS,AR,32012032,1005,100,,Cash sale,,,,,,17/12/2018,17/12/2018,0.00,,15.04,,"-1,234,957.64"
,CS,AR,32012043,1005,100,,Cash sale,,,,,,17/12/2018,17/12/2018,0.00,,4.32,,"-1,234,961.96"
,CS,AR,32012079,1005,100,,Cash sale,,,,,,17/12/2018,17/12/2018,0.00,,2.54,,"-1,234,964.50"
,CS,AR,32012131,1005,100,,Cash sale,,,,,,17/12/2018,17/12/2018,0.00,,13.88,,"-1,234,978.38"
,CS,AR,32012136,1005,100,,Cash sale,,,,,,17/12/2018,17/12/2018,0.00,,3.64,,"-1,234,982.02"
,CS,AR,32012163,1005,100,,Cash sale,,,,,,17/12/2018,17/12/2018,0.00,,3.64,,"-1,234,985.66"
,CS,AR,32012187,1005,100,,Cash sale,,,,,,17/12/2018,17/12/2018,0.00,,10.17,,"-1,234,995.83"
,CS,AR,32012204,1005,100,,Cash sale,,,,,,17/12/2018,17/12/2018,0.00,,5.17,,"-1,235,001.00"
,CS,AR,32012234,1005,100,,Cash sale,,,,,,17/12/2018,17/12/2018,0.00,,6.56,,"-1,235,007.56"
,CS,AR,32012238,1005,100,,Cash sale,,,,,,17/12/2018,17/12/2018,0.00,,3.64,,"-1,235,011.20"
,CS,AR,32012241,1005,100,,Cash sale,,,,,,17/12/2018,17/12/2018,0.00,,10.17,,"-1,235,021.37"
,CS,AR,32012242,1005,100,,Cash sale,,,,,,17/12/2018,17/12/2018,0.00,,29.15,,"-1,235,050.52"
,CS,AR,32012254,1005,100,,Cash sale,,,,,,17/12/2018,17/12/2018,0.00,,11.44,,"-1,235,061.96"
,CS,AR,32012285,1005,100,,Cash sale,,,,,,17/12/2018,17/12/2018,0.00,,18.21,,"-1,235,080.17"
,CS,AR,32012299,1005,100,,Cash sale,,,,,,17/12/2018,17/12/2018,0.00,,14.58,,"-1,235,094.75"
,CS,AR,32012321,1005,100,,Cash sale,,,,,,17/12/2018,17/12/2018,0.00,,10.93,,"-1,235,105.68"
,CS,AR,32012364,1005,100,,Cash sale,,,,,,17/12/2018,17/12/2018,0.00,,7.29,,"-1,235,112.97"
,CS,AR,32012377,1005,100,,Cash sale,,,,,,17/12/2018,17/12/2018,0.00,,3.64,,"-1,235,116.61"
,CS,AR,32012381,1005,100,,Cash sale,,,,,,17/12/2018,17/12/2018,0.00,,7.29,,"-1,235,123.90"
,CS,AR,32012503,1005,100,,Cash sale,,,,,,17/12/2018,17/12/2018,0.00,,10.93,,"-1,235,134.83"
,IN,AR,30333527,1005,100,,Invoice,,,,,,17/12/2018,17/12/2018,0.00,,44.49,,"-1,235,179.32"
,IN,AR,30333538,1005,100,,Invoice,,,,,,17/12/2018,17/12/2018,0.00,,14.58,,"-1,235,193.90"
,IN,AR,30333573,1005,100,,Invoice,,,,,,17/12/2018,17/12/2018,0.00,,2.03,,"-1,235,195.93"
,IN,AR,30333574,1005,100,,Invoice,,,,,,17/12/2018,17/12/2018,0.00,,12.15,,"-1,235,208.08"
,IN,AR,30333575,1005,100,,Invoice,,,,,,17/12/2018,17/12/2018,0.00,,2.03,,"-1,235,210.11"
,IN,AR,30333576,1005,100,,Invoice,,,,,,17/12/2018,17/12/2018,0.00,,8.10,,"-1,235,218.21"
,IN,AR,30333577,1005,100,,Invoice,,,,,,17/12/2018,17/12/2018,0.00,,6.08,,"-1,235,224.29"
,IN,AR,30333578,1005,100,,Invoice,,,,,,17/12/2018,17/12/2018,0.00,,4.05,,"-1,235,228.34"
,IN,AR,30333579,1005,100,,Invoice,,,,,,17/12/2018,17/12/2018,0.00,,6.08,,"-1,235,234.42"
,IN,AR,30333629,1005,100,,Invoice,,,,,,17/12/2018,17/12/2018,0.00,,42.27,,"-1,235,276.69"
,IN,AR,30333635,1005,100,,Invoice,,,,,,17/12/2018,17/12/2018,0.00,,7.29,,"-1,235,283.98"
,IN,AR,30333644,1005,100,,Invoice,,,,,,17/12/2018,17/12/2018,0.00,,3.64,,"-1,235,287.62"
,IN,AR,30333662,1005,100,,Invoice,,,,,,17/12/2018,17/12/2018,0.00,,70.00,,"-1,235,357.62"
,IN,AR,30333671,1005,100,,Invoice,,,,,,17/12/2018,17/12/2018,0.00,,13.77,,"-1,235,371.39"
,IN,AR,30333683,1005,100,,Invoice,,,,,,17/12/2018,17/12/2018,0.00,,22.00,,"-1,235,393.39"
,IN,AR,30333688,1005,100,,Invoice,,,,,,17/12/2018,17/12/2018,0.00,,23.73,,"-1,235,417.12"
,IN,AR,30333695,1005,100,,Invoice,,,,,,17/12/2018,17/12/2018,0.00,,29.69,,"-1,235,446.81"
,IN,AR,30333715,1005,100,,Invoice,,,,,,17/12/2018,17/12/2018,0.00,,10.93,,"-1,235,457.74"
,IN,AR,30333724,1005,100,,Invoice,,,,,,17/12/2018,17/12/2018,0.00,,34.00,,"-1,235,491.74"
,IN,AR,30333725,1005,100,,Invoice,,,,,,17/12/2018,17/12/2018,0.00,,16.00,,"-1,235,507.74"
,IN,AR,30333737,1005,100,,Invoice,,,,,,17/12/2018,17/12/2018,0.00,,5.51,,"-1,235,513.25"
,IN,AR,30333741,1005,100,,Invoice,,,,,,17/12/2018,17/12/2018,0.00,,27.97,,"-1,235,541.22"
,IN,AR,30333745,1005,100,,Invoice,,,,,,17/12/2018,17/12/2018,0.00,,5.51,,"-1,235,546.73"
,IN,AR,30333755,1005,100,,Invoice,,,,,,17/12/2018,17/12/2018,0.00,,5.85,,"-1,235,552.58"
,IN,AR,30333769,1005,100,,Invoice,,,,,,17/12/2018,17/12/2018,0.00,,8.00,,"-1,235,560.58"
,IN,AR,30333772,1005,100,,Invoice,,,,,,17/12/2018,17/12/2018,0.00,,14.58,,"-1,235,575.16"
,IN,AR,30333795,1005,100,,Invoice,,,,,,17/12/2018,17/12/2018,0.00,,65.49,,"-1,235,640.65"
,IN,AR,30333821,1005,100,,Invoice,,,,,,17/12/2018,17/12/2018,0.00,,8.00,,"-1,235,648.65"
,IN,AR,30333845,1005,100,,Invoice,,,,,,17/12/2018,17/12/2018,0.00,,14.49,,"-1,235,663.14"
,IN,AR,30333853,1005,100,,Invoice,,,,,,17/12/2018,17/12/2018,0.00,,18.22,,"-1,235,681.36"
,IN,AR,30333864,1005,100,,Invoice,,,,,,17/12/2018,17/12/2018,0.00,,1.59,,"-1,235,682.95"
,IN,AR,30333892,1005,100,,Invoice,,,,,,17/12/2018,17/12/2018,0.00,,29.15,,"-1,235,712.10"
,IN,AR,30333895,1005,100,,Invoice,,,,,,17/12/2018,17/12/2018,0.00,,4.80,,"-1,235,716.90"
,IN,AR,30333898,1005,100,,Invoice,,,,,,17/12/2018,17/12/2018,0.00,,13.78,,"-1,235,730.68"
,IN,AR,30333918,1005,100,,Invoice,,,,,,17/12/2018,17/12/2018,0.00,,2.12,,"-1,235,732.80"
,IN,AR,30333947,1005,100,,Invoice,,,,,,17/12/2018,17/12/2018,0.00,,10.34,,"-1,235,743.14"
,IN,AR,30333955,1005,100,,Invoice,,,,,,17/12/2018,17/12/2018,0.00,,5.93,,"-1,235,749.07"
,IN,AR,30333995,1005,100,,Invoice,,,,,,17/12/2018,17/12/2018,0.00,,57.42,,"-1,235,806.49"
,IN,AR,30334007,1005,100,,Invoice,,,,,,17/12/2018,17/12/2018,0.00,,45.76,,"-1,235,852.25"
,IN,AR,30334022,1005,100,,Invoice,,,,,,17/12/2018,17/12/2018,0.00,,7.17,,"-1,235,859.42"
,IN,AR,30334031,1005,100,,Invoice,,,,,,17/12/2018,17/12/2018,0.00,,12.88,,"-1,235,872.30"
,IN,AR,30334041,1005,100,,Invoice,,,,,,17/12/2018,17/12/2018,0.00,,9.03,,"-1,235,881.33"
,IN,AR,30334046,1005,100,,Invoice,,,,,,17/12/2018,17/12/2018,0.00,,10.93,,"-1,235,892.26"
,IN,AR,30334094,1005,100,,Invoice,,,,,,17/12/2018,17/12/2018,0.00,,10.17,,"-1,235,902.43"
,IN,AR,30334168,1005,100,,Invoice,,,,,,17/12/2018,17/12/2018,0.00,,20.34,,"-1,235,922.77"
,IN,AR,30334180,1005,100,,Invoice,,,,,,17/12/2018,17/12/2018,0.00,,10.93,,"-1,235,933.70"
,IN,AR,30334199,1005,100,,Invoice,,,,,,17/12/2018,17/12/2018,0.00,,3.64,,"-1,235,937.34"
,IN,AR,30334203,1005,100,,Invoice,,,,,,17/12/2018,17/12/2018,0.00,,14.58,,"-1,235,951.92"
,IN,AR,30334219,1005,100,,Invoice,,,,,,17/12/2018,17/12/2018,0.00,,5.51,,"-1,235,957.43"
,IN,AR,30334222,1005,100,,Invoice,,,,,,17/12/2018,17/12/2018,0.00,,3.64,,"-1,235,961.07"
,IN,AR,30334238,1005,100,,Invoice,,,,,,17/12/2018,17/12/2018,0.00,,13.78,,"-1,235,974.85"
,IN,AR,30334245,1005,100,,Invoice,,,,,,17/12/2018,17/12/2018,0.00,,19.64,,"-1,235,994.49"
,IN,AR,30334252,1005,100,,Invoice,,,,,,17/12/2018,17/12/2018,0.00,,10.51,,"-1,236,005.00"
,IN,AR,30334310,1005,100,,Invoice,,,,,,17/12/2018,17/12/2018,0.00,,32.00,,"-1,236,037.00"
,IN,AR,30334321,1005,100,,Invoice,,,,,,17/12/2018,17/12/2018,0.00,,9.29,,"-1,236,046.29"
,IN,AR,30334355,1005,100,,Invoice,,,,,,17/12/2018,17/12/2018,0.00,,29.55,,"-1,236,075.84"
,IN,AR,30334366,1005,100,,Invoice,,,,,,17/12/2018,17/12/2018,0.00,,4.49,,"-1,236,080.33"
,IN,AR,30334377,1005,100,,Invoice,,,,,,17/12/2018,17/12/2018,0.00,,17.56,,"-1,236,097.89"
,IN,AR,30334413,1005,100,,Invoice,,,,,,17/12/2018,17/12/2018,0.00,,54.66,,"-1,236,152.55"
,IN,AR,30334433,1005,100,,Invoice,,,,,,17/12/2018,17/12/2018,0.00,,7.29,,"-1,236,159.84"
,IN,AR,30334463,1005,100,,Invoice,,,,,,17/12/2018,17/12/2018,0.00,,10.93,,"-1,236,170.77"
,IN,AR,30334488,1005,100,,Invoice,,,,,,17/12/2018,17/12/2018,0.00,,2.14,,"-1,236,172.91"
,IN,AR,30334497,1005,100,,Invoice,,,,,,17/12/2018,17/12/2018,0.00,,7.29,,"-1,236,180.20"
,IN,AR,30334534,1005,100,,Invoice,,,,,,17/12/2018,17/12/2018,0.00,,1.99,,"-1,236,182.19"
,IN,AR,30334569,1005,100,,Invoice,,,,,,17/12/2018,17/12/2018,0.00,,42.09,,"-1,236,224.28"
,IN,AR,30334572,1005,100,,Invoice,,,,,,17/12/2018,17/12/2018,0.00,,7.29,,"-1,236,231.57"
,IN,AR,30334576,1005,100,,Invoice,,,,,,17/12/2018,17/12/2018,0.00,,32.80,,"-1,236,264.37"
,IN,AR,30334611,1005,100,,Invoice,,,,,,17/12/2018,17/12/2018,0.00,,7.88,,"-1,236,272.25"
,IN,AR,30334615,1005,100,,Invoice,,,,,,17/12/2018,17/12/2018,0.00,,2.29,,"-1,236,274.54"
,IN,AR,30334641,1005,100,,Invoice,,,,,,17/12/2018,17/12/2018,0.00,,14.58,,"-1,236,289.12"
,IN,AR,30334695,1005,100,,Invoice,,,,,,17/12/2018,17/12/2018,0.00,,39.22,,"-1,236,328.34"
,IN,AR,30334716,1005,100,,Invoice,,,,,,17/12/2018,17/12/2018,0.00,,4.20,,"-1,236,332.54"
,IN,AR,30334738,1005,100,,Invoice,,,,,,17/12/2018,17/12/2018,0.00,,24.16,,"-1,236,356.70"
,IN,AR,30334742,1005,100,,Invoice,,,,,,17/12/2018,17/12/2018,0.00,,128.18,,"-1,236,484.88"
,IN,AR,30334755,1005,100,,Invoice,,,,,,17/12/2018,17/12/2018,0.00,,16.83,,"-1,236,501.71"
,IN,AR,30334828,1005,100,,Invoice,,,,,,17/12/2018,17/12/2018,0.00,,23.32,,"-1,236,525.03"
,IN,AR,30334831,1005,100,,Invoice,,,,,,17/12/2018,17/12/2018,0.00,,16.02,,"-1,236,541.05"
,IN,AR,30334852,1005,100,,Invoice,,,,,,17/12/2018,17/12/2018,0.00,,12.75,,"-1,236,553.80"
,IN,AR,30334853,1005,100,,Invoice,,,,,,17/12/2018,17/12/2018,0.00,,6.37,,"-1,236,560.17"
,IN,AR,30334924,1005,100,,Invoice,,,,,,17/12/2018,17/12/2018,0.00,,12.00,,"-1,236,572.17"
,IN,AR,30334927,1005,100,,Invoice,,,,,,17/12/2018,17/12/2018,0.00,,3.64,,"-1,236,575.81"
,IN,AR,30334931,1005,100,,Invoice,,,,,,17/12/2018,17/12/2018,0.00,,3.76,,"-1,236,579.57"
,IN,AR,30334932,1005,100,,Invoice,,,,,,17/12/2018,17/12/2018,0.00,,1.88,,"-1,236,581.45"
,IN,AR,30334977,1005,100,,Invoice,,,,,,17/12/2018,17/12/2018,0.00,,5.47,,"-1,236,586.92"
,IN,AR,30335001,1005,100,,Invoice,,,,,,17/12/2018,17/12/2018,0.00,,513.72,,"-1,237,100.64"
,IN,AR,30335002,1005,100,,Invoice,,,,,,17/12/2018,17/12/2018,0.00,,749.69,,"-1,237,850.33"
,IN,AR,30335003,1005,100,,Invoice,,,,,,17/12/2018,17/12/2018,0.00,,235.97,,"-1,238,086.30"
,IN,AR,30335004,1005,100,,Invoice,,,,,,17/12/2018,17/12/2018,0.00,,179.43,,"-1,238,265.73"
,IN,AR,30335005,1005,100,,Invoice,,,,,,17/12/2018,17/12/2018,0.00,,122.90,,"-1,238,388.63"
,IN,AR,30335006,1005,100,,Invoice,,,,,,17/12/2018,17/12/2018,0.00,,240.88,,"-1,238,629.51"
,IN,AR,30335007,1005,100,,Invoice,,,,,,17/12/2018,17/12/2018,0.00,,208.93,,"-1,238,838.44"
,IN,AR,30335008,1005,100,,Invoice,,,,,,17/12/2018,17/12/2018,0.00,,127.82,,"-1,238,966.26"
,IN,AR,30335009,1005,100,,Invoice,,,,,,17/12/2018,17/12/2018,0.00,,280.21,,"-1,239,246.47"
,IN,AR,30335010,1005,100,,Invoice,,,,,,17/12/2018,17/12/2018,0.00,,76.20,,"-1,239,322.67"
,IN,AR,30335011,1005,100,,Invoice,,,,,,17/12/2018,17/12/2018,0.00,,201.56,,"-1,239,524.23"
,IN,AR,30335012,1005,100,,Invoice,,,,,,17/12/2018,17/12/2018,0.00,,290.04,,"-1,239,814.27"
,IN,AR,30335013,1005,100,,Invoice,,,,,,17/12/2018,17/12/2018,0.00,,189.27,,"-1,240,003.54"
,IN,AR,30335015,1005,100,,Invoice,,,,,,17/12/2018,17/12/2018,0.00,,189.27,,"-1,240,192.81"
,IN,AR,30335017,1005,100,,Invoice,,,,,,17/12/2018,17/12/2018,0.00,,164.69,,"-1,240,357.50"
,IN,AR,30335018,1005,100,,Invoice,,,,,,17/12/2018,17/12/2018,0.00,,253.17,,"-1,240,610.67"
,IN,AR,30335019,1005,100,,Invoice,,,,,,17/12/2018,17/12/2018,0.00,,356.41,,"-1,240,967.08"
,IN,AR,30335020,1005,100,,Invoice,,,,,,17/12/2018,17/12/2018,0.00,,253.17,,"-1,241,220.25"
,IN,AR,30335021,1005,100,,Invoice,,,,,,17/12/2018,17/12/2018,0.00,,127.82,,"-1,241,348.07"
,IN,AR,30335022,1005,100,,Invoice,,,,,,17/12/2018,17/12/2018,0.00,,449.81,,"-1,241,797.88"
,IN,AR,30335023,1005,100,,Invoice,,,,,,17/12/2018,17/12/2018,0.00,,194.18,,"-1,241,992.06"
,IN,AR,30335024,1005,100,,Invoice,,,,,,17/12/2018,17/12/2018,0.00,,260.55,,"-1,242,252.61"
,IN,AR,30335025,1005,100,,Invoice,,,,,,17/12/2018,17/12/2018,0.00,,361.33,,"-1,242,613.94"
,IN,AR,30335026,1005,100,,Invoice,,,,,,17/12/2018,17/12/2018,0.00,,191.72,,"-1,242,805.66"
,IN,AR,30335027,1005,100,,Invoice,,,,,,17/12/2018,17/12/2018,0.00,,299.88,,"-1,243,105.54"
,IN,AR,30335028,1005,100,,Invoice,,,,,,17/12/2018,17/12/2018,0.00,,339.20,,"-1,243,444.74"
,IN,AR,30335030,1005,100,,Invoice,,,,,,17/12/2018,17/12/2018,0.00,,245.80,,"-1,243,690.54"
,IN,AR,30335031,1005,100,,Invoice,,,,,,17/12/2018,17/12/2018,0.00,,169.60,,"-1,243,860.14"
,IN,AR,30335040,1005,100,,Invoice,,,,,,17/12/2018,17/12/2018,0.00,,26.19,,"-1,243,886.33"
,IN,AR,30335044,1005,100,,Invoice,,,,,,17/12/2018,17/12/2018,0.00,,1.75,,"-1,243,888.08"
,IN,AR,30335054,1005,100,,Invoice,,,,,,17/12/2018,17/12/2018,0.00,,6.13,,"-1,243,894.21"
,IN,AR,30335099,1005,100,,Invoice,,,,,,17/12/2018,17/12/2018,0.00,,32.16,,"-1,243,926.37"
,IN,AR,30335145,1005,100,,Invoice,,,,,,17/12/2018,17/12/2018,0.00,,4.15,,"-1,243,930.52"
,IN,AR,30335146,1005,100,,Invoice,,,,,,17/12/2018,17/12/2018,0.00,,12.46,,"-1,243,942.98"
,IN,AR,30335147,1005,100,,Invoice,,,,,,17/12/2018,17/12/2018,0.00,,2.08,,"-1,243,945.06"
,IN,AR,30335148,1005,100,,Invoice,,,,,,17/12/2018,17/12/2018,0.00,,18.69,,"-1,243,963.75"
,IN,AR,30335213,1005,100,,Invoice,,,,,,17/12/2018,17/12/2018,0.00,,14.58,,"-1,243,978.33"
,IN,AR,30335234,1005,100,,Invoice,,,,,,17/12/2018,17/12/2018,0.00,,18.92,,"-1,243,997.25"
,IN,AR,30335262,1005,100,,Invoice,,,,,,17/12/2018,17/12/2018,0.00,,65.73,,"-1,244,062.98"
,IN,AR,30335337,1005,100,,Invoice,,,,,,17/12/2018,17/12/2018,0.00,,21.86,,"-1,244,084.84"
,CS,AR,32011746,1005,100,,Cash sale,,,,,,18/12/2018,18/12/2018,0.00,,6.02,,"-1,244,090.86"
,CS,AR,32011797,1005,100,,Cash sale,,,,,,18/12/2018,18/12/2018,0.00,,7.29,,"-1,244,098.15"
,CS,AR,32011800,1005,100,,Cash sale,,,,,,18/12/2018,18/12/2018,0.00,,10.93,,"-1,244,109.08"
,CS,AR,32011813,1005,100,,Cash sale,,,,,,18/12/2018,18/12/2018,0.00,,7.29,,"-1,244,116.37"
,CS,AR,32011815,1005,100,,Cash sale,,,,,,18/12/2018,18/12/2018,0.00,,3.64,,"-1,244,120.01"
,CS,AR,32011830,1005,100,,Cash sale,,,,,,18/12/2018,18/12/2018,0.00,,3.01,,"-1,244,123.02"
,CS,AR,32011835,1005,100,,Cash sale,,,,,,18/12/2018,18/12/2018,0.00,,10.93,,"-1,244,133.95"
,CS,AR,32011877,1005,100,,Cash sale,,,,,,18/12/2018,18/12/2018,0.00,,29.15,,"-1,244,163.10"
,CS,AR,32011880,1005,100,,Cash sale,,,,,,18/12/2018,18/12/2018,0.00,,10.93,,"-1,244,174.03"
,CS,AR,32011912,1005,100,,Cash sale,,,,,,18/12/2018,18/12/2018,0.00,,10.17,,"-1,244,184.20"
,CS,AR,32011914,1005,100,,Cash sale,,,,,,18/12/2018,18/12/2018,0.00,,14.58,,"-1,244,198.78"
,CS,AR,32011919,1005,100,,Cash sale,,,,,,18/12/2018,18/12/2018,0.00,,6.48,,"-1,244,205.26"
,CS,AR,32011949,1005,100,,Cash sale,,,,,,18/12/2018,18/12/2018,0.00,,2.84,,"-1,244,208.10"
,CS,AR,32011962,1005,100,,Cash sale,,,,,,18/12/2018,18/12/2018,0.00,,5.85,,"-1,244,213.95"
,CS,AR,32011990,1005,100,,Cash sale,,,,,,18/12/2018,18/12/2018,0.00,,3.64,,"-1,244,217.59"
,CS,AR,32012026,1005,100,,Cash sale,,,,,,18/12/2018,18/12/2018,0.00,,1.95,,"-1,244,219.54"
,CS,AR,32012036,1005,100,,Cash sale,,,,,,18/12/2018,18/12/2018,0.00,,15.13,,"-1,244,234.67"
,CS,AR,32012041,1005,100,,Cash sale,,,,,,18/12/2018,18/12/2018,0.00,,7.29,,"-1,244,241.96"
,CS,AR,32012050,1005,100,,Cash sale,,,,,,18/12/2018,18/12/2018,0.00,,36.19,,"-1,244,278.15"
,CS,AR,32012069,1005,100,,Cash sale,,,,,,18/12/2018,18/12/2018,0.00,,10.34,,"-1,244,288.49"
,CS,AR,32012084,1005,100,,Cash sale,,,,,,18/12/2018,18/12/2018,0.00,,12.92,,"-1,244,301.41"
,CS,AR,32012090,1005,100,,Cash sale,,,,,,18/12/2018,18/12/2018,0.00,,3.90,,"-1,244,305.31"
,CS,AR,32012092,1005,100,,Cash sale,,,,,,18/12/2018,18/12/2018,0.00,,3.64,,"-1,244,308.95"
,CS,AR,32012171,1005,100,,Cash sale,,,,,,18/12/2018,18/12/2018,0.00,,7.29,,"-1,244,316.24"
,CS,AR,32012178,1005,100,,Cash sale,,,,,,18/12/2018,18/12/2018,0.00,,7.29,,"-1,244,323.53"
,CS,AR,32012193,1005,100,,Cash sale,,,,,,18/12/2018,18/12/2018,0.00,,7.29,,"-1,244,330.82"
,CS,AR,32012215,1005,100,,Cash sale,,,,,,18/12/2018,18/12/2018,0.00,,22.88,,"-1,244,353.70"
,CS,AR,32012218,1005,100,,Cash sale,,,,,,18/12/2018,18/12/2018,0.00,,34.00,,"-1,244,387.70"
,CS,AR,32012276,1005,100,,Cash sale,,,,,,18/12/2018,18/12/2018,0.00,,2.75,,"-1,244,390.45"
,CS,AR,32012337,1005,100,,Cash sale,,,,,,18/12/2018,18/12/2018,0.00,,7.29,,"-1,244,397.74"
,CS,AR,32012348,1005,100,,Cash sale,,,,,,18/12/2018,18/12/2018,0.00,,7.29,,"-1,244,405.03"
,CS,AR,32012445,1005,100,,Cash sale,,,,,,18/12/2018,18/12/2018,0.00,,6.19,,"-1,244,411.22"
,CS,AR,32012450,1005,100,,Cash sale,,,,,,18/12/2018,18/12/2018,0.00,,3.64,,"-1,244,414.86"
,CS,AR,32012493,1005,100,,Cash sale,,,,,,18/12/2018,18/12/2018,0.00,,14.58,,"-1,244,429.44"
,CS,AR,32012504,1005,100,,Cash sale,,,,,,18/12/2018,18/12/2018,0.00,,14.58,,"-1,244,444.02"
,IN,AR,30333597,1005,100,,Invoice,,,,,,18/12/2018,18/12/2018,0.00,,3.64,,"-1,244,447.66"
,IN,AR,30333616,1005,100,,Invoice,,,,,,18/12/2018,18/12/2018,0.00,,3.64,,"-1,244,451.30"
,IN,AR,30333619,1005,100,,Invoice,,,,,,18/12/2018,18/12/2018,0.00,,3.50,,"-1,244,454.80"
,IN,AR,30333631,1005,100,,Invoice,,,,,,18/12/2018,18/12/2018,0.00,,29.15,,"-1,244,483.95"
,IN,AR,30333651,1005,100,,Invoice,,,,,,18/12/2018,18/12/2018,0.00,,5.97,,"-1,244,489.92"
,IN,AR,30333663,1005,100,,Invoice,,,,,,18/12/2018,18/12/2018,0.00,,16.00,,"-1,244,505.92"
,IN,AR,30333668,1005,100,,Invoice,,,,,,18/12/2018,18/12/2018,0.00,,18.22,,"-1,244,524.14"
,IN,AR,30333773,1005,100,,Invoice,,,,,,18/12/2018,18/12/2018,0.00,,14.58,,"-1,244,538.72"
,IN,AR,30333776,1005,100,,Invoice,,,,,,18/12/2018,18/12/2018,0.00,,23.90,,"-1,244,562.62"
,IN,AR,30333814,1005,100,,Invoice,,,,,,18/12/2018,18/12/2018,0.00,,21.51,,"-1,244,584.13"
,IN,AR,30333831,1005,100,,Invoice,,,,,,18/12/2018,18/12/2018,0.00,,10.99,,"-1,244,595.12"
,IN,AR,30333834,1005,100,,Invoice,,,,,,18/12/2018,18/12/2018,0.00,,7.29,,"-1,244,602.41"
,IN,AR,30333847,1005,100,,Invoice,,,,,,18/12/2018,18/12/2018,0.00,,3.64,,"-1,244,606.05"
,IN,AR,30333855,1005,100,,Invoice,,,,,,18/12/2018,18/12/2018,0.00,,14.58,,"-1,244,620.63"
,IN,AR,30333856,1005,100,,Invoice,,,,,,18/12/2018,18/12/2018,0.00,,21.86,,"-1,244,642.49"
,IN,AR,30333865,1005,100,,Invoice,,,,,,18/12/2018,18/12/2018,0.00,,19.12,,"-1,244,661.61"
,IN,AR,30333872,1005,100,,Invoice,,,,,,18/12/2018,18/12/2018,0.00,,10.93,,"-1,244,672.54"
,IN,AR,30333886,1005,100,,Invoice,,,,,,18/12/2018,18/12/2018,0.00,,16.47,,"-1,244,689.01"
,IN,AR,30333888,1005,100,,Invoice,,,,,,18/12/2018,18/12/2018,0.00,,4.64,,"-1,244,693.65"
,IN,AR,30333914,1005,100,,Invoice,,,,,,18/12/2018,18/12/2018,0.00,,12.71,,"-1,244,706.36"
,IN,AR,30333923,1005,100,,Invoice,,,,,,18/12/2018,18/12/2018,0.00,,61.02,,"-1,244,767.38"
,IN,AR,30333930,1005,100,,Invoice,,,,,,18/12/2018,18/12/2018,0.00,,8.47,,"-1,244,775.85"
,IN,AR,30333932,1005,100,,Invoice,,,,,,18/12/2018,18/12/2018,0.00,,4.24,,"-1,244,780.09"
,IN,AR,30333976,1005,100,,Invoice,,,,,,18/12/2018,18/12/2018,0.00,,12.03,,"-1,244,792.12"
,IN,AR,30334023,1005,100,,Invoice,,,,,,18/12/2018,18/12/2018,0.00,,2.39,,"-1,244,794.51"
,IN,AR,30334032,1005,100,,Invoice,,,,,,18/12/2018,18/12/2018,0.00,,6.44,,"-1,244,800.95"
,IN,AR,30334100,1005,100,,Invoice,,,,,,18/12/2018,18/12/2018,0.00,,4.49,,"-1,244,805.44"
,IN,AR,30334101,1005,100,,Invoice,,,,,,18/12/2018,18/12/2018,0.00,,7.29,,"-1,244,812.73"
,IN,AR,30334122,1005,100,,Invoice,,,,,,18/12/2018,18/12/2018,0.00,,12.71,,"-1,244,825.44"
,IN,AR,30334131,1005,100,,Invoice,,,,,,18/12/2018,18/12/2018,0.00,,7.29,,"-1,244,832.73"
,IN,AR,30334141,1005,100,,Invoice,,,,,,18/12/2018,18/12/2018,0.00,,7.17,,"-1,244,839.90"
,IN,AR,30334143,1005,100,,Invoice,,,,,,18/12/2018,18/12/2018,0.00,,7.80,,"-1,244,847.70"
,IN,AR,30334145,1005,100,,Invoice,,,,,,18/12/2018,18/12/2018,0.00,,7.75,,"-1,244,855.45"
,IN,AR,30334154,1005,100,,Invoice,,,,,,18/12/2018,18/12/2018,0.00,,12.46,,"-1,244,867.91"
,IN,AR,30334159,1005,100,,Invoice,,,,,,18/12/2018,18/12/2018,0.00,,11.70,,"-1,244,879.61"
,IN,AR,30334186,1005,100,,Invoice,,,,,,18/12/2018,18/12/2018,0.00,,5.08,,"-1,244,884.69"
,IN,AR,30334194,1005,100,,Invoice,,,,,,18/12/2018,18/12/2018,0.00,,7.02,,"-1,244,891.71"
,IN,AR,30334195,1005,100,,Invoice,,,,,,18/12/2018,18/12/2018,0.00,,7.29,,"-1,244,899.00"
,IN,AR,30334215,1005,100,,Invoice,,,,,,18/12/2018,18/12/2018,0.00,,2.12,,"-1,244,901.12"
,IN,AR,30334279,1005,100,,Invoice,,,,,,18/12/2018,18/12/2018,0.00,,10.93,,"-1,244,912.05"
,IN,AR,30334303,1005,100,,Invoice,,,,,,18/12/2018,18/12/2018,0.00,,54.66,,"-1,244,966.71"
,IN,AR,30334314,1005,100,,Invoice,,,,,,18/12/2018,18/12/2018,0.00,,15.79,,"-1,244,982.50"
,IN,AR,30334325,1005,100,,Invoice,,,,,,18/12/2018,18/12/2018,0.00,,"1,093.22",,"-1,246,075.72"
,IN,AR,30334331,1005,100,,Invoice,,,,,,18/12/2018,18/12/2018,0.00,,14.58,,"-1,246,090.30"
,IN,AR,30334340,1005,100,,Invoice,,,,,,18/12/2018,18/12/2018,0.00,,5.59,,"-1,246,095.89"
,IN,AR,30334341,1005,100,,Invoice,,,,,,18/12/2018,18/12/2018,0.00,,7.29,,"-1,246,103.18"
,IN,AR,30334347,1005,100,,Invoice,,,,,,18/12/2018,18/12/2018,0.00,,8.78,,"-1,246,111.96"
,IN,AR,30334352,1005,100,,Invoice,,,,,,18/12/2018,18/12/2018,0.00,,54.66,,"-1,246,166.62"
,IN,AR,30334362,1005,100,,Invoice,,,,,,18/12/2018,18/12/2018,0.00,,3.64,,"-1,246,170.26"
,IN,AR,30334381,1005,100,,Invoice,,,,,,18/12/2018,18/12/2018,0.00,,419.07,,"-1,246,589.33"
,IN,AR,30334398,1005,100,,Invoice,,,,,,18/12/2018,18/12/2018,0.00,,21.44,,"-1,246,610.77"
,IN,AR,30334405,1005,100,,Invoice,,,,,,18/12/2018,18/12/2018,0.00,,1.88,,"-1,246,612.65"
,IN,AR,30334424,1005,100,,Invoice,,,,,,18/12/2018,18/12/2018,0.00,,8.81,,"-1,246,621.46"
,IN,AR,30334449,1005,100,,Invoice,,,,,,18/12/2018,18/12/2018,0.00,,2.58,,"-1,246,624.04"
,IN,AR,30334535,1005,100,,Invoice,,,,,,18/12/2018,18/12/2018,0.00,,234.80,,"-1,246,858.84"
,IN,AR,30334536,1005,100,,Invoice,,,,,,18/12/2018,18/12/2018,0.00,,9.95,,"-1,246,868.79"
,IN,AR,30334537,1005,100,,Invoice,,,,,,18/12/2018,18/12/2018,0.00,,5.97,,"-1,246,874.76"
,IN,AR,30334538,1005,100,,Invoice,,,,,,18/12/2018,18/12/2018,0.00,,9.95,,"-1,246,884.71"
,IN,AR,30334550,1005,100,,Invoice,,,,,,18/12/2018,18/12/2018,0.00,,25.55,,"-1,246,910.26"
,IN,AR,30334590,1005,100,,Invoice,,,,,,18/12/2018,18/12/2018,0.00,,6.02,,"-1,246,916.28"
,IN,AR,30334591,1005,100,,Invoice,,,,,,18/12/2018,18/12/2018,0.00,,14.58,,"-1,246,930.86"
,IN,AR,30334599,1005,100,,Invoice,,,,,,18/12/2018,18/12/2018,0.00,,191.31,,"-1,247,122.17"
,IN,AR,30334620,1005,100,,Invoice,,,,,,18/12/2018,18/12/2018,0.00,,6.56,,"-1,247,128.73"
,IN,AR,30334631,1005,100,,Invoice,,,,,,18/12/2018,18/12/2018,0.00,,10.93,,"-1,247,139.66"
,IN,AR,30334643,1005,100,,Invoice,,,,,,18/12/2018,18/12/2018,0.00,,5.93,,"-1,247,145.59"
,IN,AR,30334654,1005,100,,Invoice,,,,,,18/12/2018,18/12/2018,0.00,,10.17,,"-1,247,155.76"
,IN,AR,30334658,1005,100,,Invoice,,,,,,18/12/2018,18/12/2018,0.00,,8.75,,"-1,247,164.51"
,IN,AR,30334661,1005,100,,Invoice,,,,,,18/12/2018,18/12/2018,0.00,,28.01,,"-1,247,192.52"
,IN,AR,30334669,1005,100,,Invoice,,,,,,18/12/2018,18/12/2018,0.00,,12.00,,"-1,247,204.52"
,IN,AR,30334736,1005,100,,Invoice,,,,,,18/12/2018,18/12/2018,0.00,,54.66,,"-1,247,259.18"
,IN,AR,30334748,1005,100,,Invoice,,,,,,18/12/2018,18/12/2018,0.00,,7.29,,"-1,247,266.47"
,IN,AR,30334775,1005,100,,Invoice,,,,,,18/12/2018,18/12/2018,0.00,,9.64,,"-1,247,276.11"
,IN,AR,30334779,1005,100,,Invoice,,,,,,18/12/2018,18/12/2018,0.00,,146.00,,"-1,247,422.11"
,IN,AR,30334804,1005,100,,Invoice,,,,,,18/12/2018,18/12/2018,0.00,,42.71,,"-1,247,464.82"
,IN,AR,30334815,1005,100,,Invoice,,,,,,18/12/2018,18/12/2018,0.00,,7.29,,"-1,247,472.11"
,IN,AR,30334864,1005,100,,Invoice,,,,,,18/12/2018,18/12/2018,0.00,,84.07,,"-1,247,556.18"
,IN,AR,30334873,1005,100,,Invoice,,,,,,18/12/2018,18/12/2018,0.00,,33.22,,"-1,247,589.40"
,IN,AR,30334908,1005,100,,Invoice,,,,,,18/12/2018,18/12/2018,0.00,,16.27,,"-1,247,605.67"
,IN,AR,30334919,1005,100,,Invoice,,,,,,18/12/2018,18/12/2018,0.00,,3.64,,"-1,247,609.31"
,IN,AR,30334939,1005,100,,Invoice,,,,,,18/12/2018,18/12/2018,0.00,,3.51,,"-1,247,612.82"
,IN,AR,30334943,1005,100,,Invoice,,,,,,18/12/2018,18/12/2018,0.00,,8.00,,"-1,247,620.82"
,IN,AR,30334949,1005,100,,Invoice,,,,,,18/12/2018,18/12/2018,0.00,,2.97,,"-1,247,623.79"
,IN,AR,30334956,1005,100,,Invoice,,,,,,18/12/2018,18/12/2018,0.00,,123.03,,"-1,247,746.82"
,IN,AR,30334965,1005,100,,Invoice,,,,,,18/12/2018,18/12/2018,0.00,,7.02,,"-1,247,753.84"
,IN,AR,30334980,1005,100,,Invoice,,,,,,18/12/2018,18/12/2018,0.00,,29.15,,"-1,247,782.99"
,IN,AR,30334982,1005,100,,Invoice,,,,,,18/12/2018,18/12/2018,0.00,,8.75,,"-1,247,791.74"
,IN,AR,30334995,1005,100,,Invoice,,,,,,18/12/2018,18/12/2018,0.00,,12.14,,"-1,247,803.88"
,IN,AR,30334998,1005,100,,Invoice,,,,,,18/12/2018,18/12/2018,0.00,,14.58,,"-1,247,818.46"
,IN,AR,30335036,1005,100,,Invoice,,,,,,18/12/2018,18/12/2018,0.00,,72.88,,"-1,247,891.34"
,IN,AR,30335076,1005,100,,Invoice,,,,,,18/12/2018,18/12/2018,0.00,,18.22,,"-1,247,909.56"
,IN,AR,30335092,1005,100,,Invoice,,,,,,18/12/2018,18/12/2018,0.00,,9.96,,"-1,247,919.52"
,IN,AR,30335096,1005,100,,Invoice,,,,,,18/12/2018,18/12/2018,0.00,,29.15,,"-1,247,948.67"
,IN,AR,30335149,1005,100,,Invoice,,,,,,18/12/2018,18/12/2018,0.00,,12.46,,"-1,247,961.13"
,IN,AR,30335150,1005,100,,Invoice,,,,,,18/12/2018,18/12/2018,0.00,,6.23,,"-1,247,967.36"
,IN,AR,30335163,1005,100,,Invoice,,,,,,18/12/2018,18/12/2018,0.00,,43.22,,"-1,248,010.58"
,IN,AR,30335168,1005,100,,Invoice,,,,,,18/12/2018,18/12/2018,0.00,,9.66,,"-1,248,020.24"
,IN,AR,30335173,1005,100,,Invoice,,,,,,18/12/2018,18/12/2018,0.00,,40.08,,"-1,248,060.32"
,IN,AR,30335191,1005,100,,Invoice,,,,,,18/12/2018,18/12/2018,0.00,,10.93,,"-1,248,071.25"
,IN,AR,30335207,1005,100,,Invoice,,,,,,18/12/2018,18/12/2018,0.00,,10.17,,"-1,248,081.42"
,IN,AR,30335224,1005,100,,Invoice,,,,,,18/12/2018,18/12/2018,0.00,,18.22,,"-1,248,099.64"
,IN,AR,30335227,1005,100,,Invoice,,,,,,18/12/2018,18/12/2018,0.00,,7.29,,"-1,248,106.93"
,IN,AR,30335253,1005,100,,Invoice,,,,,,18/12/2018,18/12/2018,0.00,,78.88,,"-1,248,185.81"
,IN,AR,30335269,1005,100,,Invoice,,,,,,18/12/2018,18/12/2018,0.00,,14.58,,"-1,248,200.39"
,IN,AR,30335280,1005,100,,Invoice,,,,,,18/12/2018,18/12/2018,0.00,,7.29,,"-1,248,207.68"
,IN,AR,30335306,1005,100,,Invoice,,,,,,18/12/2018,18/12/2018,0.00,,10.95,,"-1,248,218.63"
,IN,AR,30335335,1005,100,,Invoice,,,,,,18/12/2018,18/12/2018,0.00,,10.93,,"-1,248,229.56"
,IN,AR,30335349,1005,100,,Invoice,,,,,,18/12/2018,18/12/2018,0.00,,10.93,,"-1,248,240.49"
,CS,AR,32011756,1005,100,,Cash sale,,,,,,19/12/2018,19/12/2018,0.00,,2.81,,"-1,248,243.30"
,CS,AR,32011761,1005,100,,Cash sale,,,,,,19/12/2018,19/12/2018,0.00,,35.12,,"-1,248,278.42"
,CS,AR,32011773,1005,100,,Cash sale,,,,,,19/12/2018,19/12/2018,0.00,,14.58,,"-1,248,293.00"
,CS,AR,32011783,1005,100,,Cash sale,,,,,,19/12/2018,19/12/2018,0.00,,7.29,,"-1,248,300.29"
,CS,AR,32011802,1005,100,,Cash sale,,,,,,19/12/2018,19/12/2018,0.00,,3.64,,"-1,248,303.93"
,CS,AR,32011806,1005,100,,Cash sale,,,,,,19/12/2018,19/12/2018,0.00,,21.86,,"-1,248,325.79"
,CS,AR,32011837,1005,100,,Cash sale,,,,,,19/12/2018,19/12/2018,0.00,,3.64,,"-1,248,329.43"
,CS,AR,32011861,1005,100,,Cash sale,,,,,,19/12/2018,19/12/2018,0.00,,9.03,,"-1,248,338.46"
,CS,AR,32011898,1005,100,,Cash sale,,,,,,19/12/2018,19/12/2018,0.00,,5.86,,"-1,248,344.32"
,CS,AR,32011928,1005,100,,Cash sale,,,,,,19/12/2018,19/12/2018,0.00,,25.51,,"-1,248,369.83"
,CS,AR,32011953,1005,100,,Cash sale,,,,,,19/12/2018,19/12/2018,0.00,,7.75,,"-1,248,377.58"
,CS,AR,32011959,1005,100,,Cash sale,,,,,,19/12/2018,19/12/2018,0.00,,23.26,,"-1,248,400.84"
,CS,AR,32011968,1005,100,,Cash sale,,,,,,19/12/2018,19/12/2018,0.00,,7.29,,"-1,248,408.13"
,CS,AR,32011978,1005,100,,Cash sale,,,,,,19/12/2018,19/12/2018,0.00,,15.04,,"-1,248,423.17"
,CS,AR,32011980,1005,100,,Cash sale,,,,,,19/12/2018,19/12/2018,0.00,,6.43,,"-1,248,429.60"
,CS,AR,32011982,1005,100,,Cash sale,,,,,,19/12/2018,19/12/2018,0.00,,3.64,,"-1,248,433.24"
,CS,AR,32011994,1005,100,,Cash sale,,,,,,19/12/2018,19/12/2018,0.00,,10.93,,"-1,248,444.17"
,CS,AR,32012000,1005,100,,Cash sale,,,,,,19/12/2018,19/12/2018,0.00,,6.02,,"-1,248,450.19"
,CS,AR,32012003,1005,100,,Cash sale,,,,,,19/12/2018,19/12/2018,0.00,,2.54,,"-1,248,452.73"
,CS,AR,32012005,1005,100,,Cash sale,,,,,,19/12/2018,19/12/2018,0.00,,20.34,,"-1,248,473.07"
,CS,AR,32012035,1005,100,,Cash sale,,,,,,19/12/2018,19/12/2018,0.00,,12.25,,"-1,248,485.32"
,CS,AR,32012088,1005,100,,Cash sale,,,,,,19/12/2018,19/12/2018,0.00,,7.29,,"-1,248,492.61"
,CS,AR,32012093,1005,100,,Cash sale,,,,,,19/12/2018,19/12/2018,0.00,,10.17,,"-1,248,502.78"
,CS,AR,32012107,1005,100,,Cash sale,,,,,,19/12/2018,19/12/2018,0.00,,14.58,,"-1,248,517.36"
,CS,AR,32012127,1005,100,,Cash sale,,,,,,19/12/2018,19/12/2018,0.00,,7.29,,"-1,248,524.65"
,CS,AR,32012168,1005,100,,Cash sale,,,,,,19/12/2018,19/12/2018,0.00,,21.36,,"-1,248,546.01"
,CS,AR,32012174,1005,100,,Cash sale,,,,,,19/12/2018,19/12/2018,0.00,,10.93,,"-1,248,556.94"
,CS,AR,32012179,1005,100,,Cash sale,,,,,,19/12/2018,19/12/2018,0.00,,10.93,,"-1,248,567.87"
,CS,AR,32012195,1005,100,,Cash sale,,,,,,19/12/2018,19/12/2018,0.00,,6.53,,"-1,248,574.40"
,CS,AR,32012211,1005,100,,Cash sale,,,,,,19/12/2018,19/12/2018,0.00,,6.86,,"-1,248,581.26"
,CS,AR,32012212,1005,100,,Cash sale,,,,,,19/12/2018,19/12/2018,0.00,,7.29,,"-1,248,588.55"
,CS,AR,32012244,1005,100,,Cash sale,,,,,,19/12/2018,19/12/2018,0.00,,9.84,,"-1,248,598.39"
,CS,AR,32012255,1005,100,,Cash sale,,,,,,19/12/2018,19/12/2018,0.00,,4.58,,"-1,248,602.97"
,CS,AR,32012258,1005,100,,Cash sale,,,,,,19/12/2018,19/12/2018,0.00,,32.80,,"-1,248,635.77"
,CS,AR,32012277,1005,100,,Cash sale,,,,,,19/12/2018,19/12/2018,0.00,,14.58,,"-1,248,650.35"
,CS,AR,32012281,1005,100,,Cash sale,,,,,,19/12/2018,19/12/2018,0.00,,9.03,,"-1,248,659.38"
,CS,AR,32012300,1005,100,,Cash sale,,,,,,19/12/2018,19/12/2018,0.00,,10.93,,"-1,248,670.31"
,CS,AR,32012318,1005,100,,Cash sale,,,,,,19/12/2018,19/12/2018,0.00,,29.15,,"-1,248,699.46"
,CS,AR,32012323,1005,100,,Cash sale,,,,,,19/12/2018,19/12/2018,0.00,,10.93,,"-1,248,710.39"
,CS,AR,32012324,1005,100,,Cash sale,,,,,,19/12/2018,19/12/2018,0.00,,7.29,,"-1,248,717.68"
,CS,AR,32012360,1005,100,,Cash sale,,,,,,19/12/2018,19/12/2018,0.00,,13.74,,"-1,248,731.42"
,CS,AR,32012365,1005,100,,Cash sale,,,,,,19/12/2018,19/12/2018,0.00,,3.64,,"-1,248,735.06"
,CS,AR,32012443,1005,100,,Cash sale,,,,,,19/12/2018,19/12/2018,0.00,,18.64,,"-1,248,753.70"
,CS,AR,32012455,1005,100,,Cash sale,,,,,,19/12/2018,19/12/2018,0.00,,14.58,,"-1,248,768.28"
,IN,AR,30333528,1005,100,,Invoice,,,,,,19/12/2018,19/12/2018,0.00,,17.80,,"-1,248,786.08"
,IN,AR,30333555,1005,100,,Invoice,,,,,,19/12/2018,19/12/2018,0.00,,21.97,,"-1,248,808.05"
,IN,AR,30333592,1005,100,,Invoice,,,,,,19/12/2018,19/12/2018,0.00,,7.29,,"-1,248,815.34"
,IN,AR,30333594,1005,100,,Invoice,,,,,,19/12/2018,19/12/2018,0.00,,25.89,,"-1,248,841.23"
,IN,AR,30333603,1005,100,,Invoice,,,,,,19/12/2018,19/12/2018,0.00,,26.27,,"-1,248,867.50"
,IN,AR,30333604,1005,100,,Invoice,,,,,,19/12/2018,19/12/2018,0.00,,60.42,,"-1,248,927.92"
,IN,AR,30333607,1005,100,,Invoice,,,,,,19/12/2018,19/12/2018,0.00,,10.93,,"-1,248,938.85"
,IN,AR,30333611,1005,100,,Invoice,,,,,,19/12/2018,19/12/2018,0.00,,14.49,,"-1,248,953.34"
,IN,AR,30333664,1005,100,,Invoice,,,,,,19/12/2018,19/12/2018,0.00,,30.00,,"-1,248,983.34"
,IN,AR,30333704,1005,100,,Invoice,,,,,,19/12/2018,19/12/2018,0.00,,3.64,,"-1,248,986.98"
,IN,AR,30333714,1005,100,,Invoice,,,,,,19/12/2018,19/12/2018,0.00,,7.29,,"-1,248,994.27"
,IN,AR,30333726,1005,100,,Invoice,,,,,,19/12/2018,19/12/2018,0.00,,18.00,,"-1,249,012.27"
,IN,AR,30333730,1005,100,,Invoice,,,,,,19/12/2018,19/12/2018,0.00,,3.64,,"-1,249,015.91"
,IN,AR,30333750,1005,100,,Invoice,,,,,,19/12/2018,19/12/2018,0.00,,28.00,,"-1,249,043.91"
,IN,AR,30333777,1005,100,,Invoice,,,,,,19/12/2018,19/12/2018,0.00,,7.29,,"-1,249,051.20"
,IN,AR,30333796,1005,100,,Invoice,,,,,,19/12/2018,19/12/2018,0.00,,90.05,,"-1,249,141.25"
,IN,AR,30333802,1005,100,,Invoice,,,,,,19/12/2018,19/12/2018,0.00,,780.96,,"-1,249,922.21"
,IN,AR,30333836,1005,100,,Invoice,,,,,,19/12/2018,19/12/2018,0.00,,12.03,,"-1,249,934.24"
,IN,AR,30333841,1005,100,,Invoice,,,,,,19/12/2018,19/12/2018,0.00,,10.93,,"-1,249,945.17"
,IN,AR,30333850,1005,100,,Invoice,,,,,,19/12/2018,19/12/2018,0.00,,5.31,,"-1,249,950.48"
,IN,AR,30333875,1005,100,,Invoice,,,,,,19/12/2018,19/12/2018,0.00,,10.50,,"-1,249,960.98"
,IN,AR,30333908,1005,100,,Invoice,,,,,,19/12/2018,19/12/2018,0.00,,15.25,,"-1,249,976.23"
,IN,AR,30333917,1005,100,,Invoice,,,,,,19/12/2018,19/12/2018,0.00,,2.12,,"-1,249,978.35"
,IN,AR,30333928,1005,100,,Invoice,,,,,,19/12/2018,19/12/2018,0.00,,2.12,,"-1,249,980.47"
,IN,AR,30333935,1005,100,,Invoice,,,,,,19/12/2018,19/12/2018,0.00,,11.19,,"-1,249,991.66"
,IN,AR,30333958,1005,100,,Invoice,,,,,,19/12/2018,19/12/2018,0.00,,7.76,,"-1,249,999.42"
,IN,AR,30333961,1005,100,,Invoice,,,,,,19/12/2018,19/12/2018,0.00,,21.51,,"-1,250,020.93"
,IN,AR,30333962,1005,100,,Invoice,,,,,,19/12/2018,19/12/2018,0.00,,22.03,,"-1,250,042.96"
,IN,AR,30333965,1005,100,,Invoice,,,,,,19/12/2018,19/12/2018,0.00,,14.58,,"-1,250,057.54"
,IN,AR,30333980,1005,100,,Invoice,,,,,,19/12/2018,19/12/2018,0.00,,9.56,,"-1,250,067.10"
,IN,AR,30333996,1005,100,,Invoice,,,,,,19/12/2018,19/12/2018,0.00,,41.02,,"-1,250,108.12"
,IN,AR,30334024,1005,100,,Invoice,,,,,,19/12/2018,19/12/2018,0.00,,9.56,,"-1,250,117.68"
,IN,AR,30334033,1005,100,,Invoice,,,,,,19/12/2018,19/12/2018,0.00,,6.44,,"-1,250,124.12"
,IN,AR,30334037,1005,100,,Invoice,,,,,,19/12/2018,19/12/2018,0.00,,77.29,,"-1,250,201.41"
,IN,AR,30334060,1005,100,,Invoice,,,,,,19/12/2018,19/12/2018,0.00,,54.66,,"-1,250,256.07"
,IN,AR,30334072,1005,100,,Invoice,,,,,,19/12/2018,19/12/2018,0.00,,108.03,,"-1,250,364.10"
,IN,AR,30334095,1005,100,,Invoice,,,,,,19/12/2018,19/12/2018,0.00,,2.54,,"-1,250,366.64"
,IN,AR,30334096,1005,100,,Invoice,,,,,,19/12/2018,19/12/2018,0.00,,2.54,,"-1,250,369.18"
,IN,AR,30334110,1005,100,,Invoice,,,,,,19/12/2018,19/12/2018,0.00,,1.59,,"-1,250,370.77"
,IN,AR,30334138,1005,100,,Invoice,,,,,,19/12/2018,19/12/2018,0.00,,10.59,,"-1,250,381.36"
,IN,AR,30334151,1005,100,,Invoice,,,,,,19/12/2018,19/12/2018,0.00,,11.36,,"-1,250,392.72"
,IN,AR,30334165,1005,100,,Invoice,,,,,,19/12/2018,19/12/2018,0.00,,3.01,,"-1,250,395.73"
,IN,AR,30334181,1005,100,,Invoice,,,,,,19/12/2018,19/12/2018,0.00,,3.64,,"-1,250,399.37"
,IN,AR,30334212,1005,100,,Invoice,,,,,,19/12/2018,19/12/2018,0.00,,14.58,,"-1,250,413.95"
,IN,AR,30334226,1005,100,,Invoice,,,,,,19/12/2018,19/12/2018,0.00,,2.54,,"-1,250,416.49"
,IN,AR,30334246,1005,100,,Invoice,,,,,,19/12/2018,19/12/2018,0.00,,42.08,,"-1,250,458.57"
,IN,AR,30334257,1005,100,,Invoice,,,,,,19/12/2018,19/12/2018,0.00,,20.76,,"-1,250,479.33"
,IN,AR,30334268,1005,100,,Invoice,,,,,,19/12/2018,19/12/2018,0.00,,980.62,,"-1,251,459.95"
,IN,AR,30334278,1005,100,,Invoice,,,,,,19/12/2018,19/12/2018,0.00,,12.92,,"-1,251,472.87"
,IN,AR,30334285,1005,100,,Invoice,,,,,,19/12/2018,19/12/2018,0.00,,10.93,,"-1,251,483.80"
,IN,AR,30334292,1005,100,,Invoice,,,,,,19/12/2018,19/12/2018,0.00,,5.17,,"-1,251,488.97"
,IN,AR,30334295,1005,100,,Invoice,,,,,,19/12/2018,19/12/2018,0.00,,16.78,,"-1,251,505.75"
,IN,AR,30334302,1005,100,,Invoice,,,,,,19/12/2018,19/12/2018,0.00,,7.63,,"-1,251,513.38"
,IN,AR,30334336,1005,100,,Invoice,,,,,,19/12/2018,19/12/2018,0.00,,13.77,,"-1,251,527.15"
,IN,AR,30334345,1005,100,,Invoice,,,,,,19/12/2018,19/12/2018,0.00,,2.58,,"-1,251,529.73"
,IN,AR,30334359,1005,100,,Invoice,,,,,,19/12/2018,19/12/2018,0.00,,8.47,,"-1,251,538.20"
,IN,AR,30334371,1005,100,,Invoice,,,,,,19/12/2018,19/12/2018,0.00,,18.05,,"-1,251,556.25"
,IN,AR,30334410,1005,100,,Invoice,,,,,,19/12/2018,19/12/2018,0.00,,21.44,,"-1,251,577.69"
,IN,AR,30334415,1005,100,,Invoice,,,,,,19/12/2018,19/12/2018,0.00,,29.15,,"-1,251,606.84"
,IN,AR,30334425,1005,100,,Invoice,,,,,,19/12/2018,19/12/2018,0.00,,5.29,,"-1,251,612.13"
,IN,AR,30334430,1005,100,,Invoice,,,,,,19/12/2018,19/12/2018,0.00,,6.02,,"-1,251,618.15"
,IN,AR,30334464,1005,100,,Invoice,,,,,,19/12/2018,19/12/2018,0.00,,14.58,,"-1,251,632.73"
,IN,AR,30334473,1005,100,,Invoice,,,,,,19/12/2018,19/12/2018,0.00,,6.00,,"-1,251,638.73"
,IN,AR,30334478,1005,100,,Invoice,,,,,,19/12/2018,19/12/2018,0.00,,21.86,,"-1,251,660.59"
,IN,AR,30334479,1005,100,,Invoice,,,,,,19/12/2018,19/12/2018,0.00,,10.93,,"-1,251,671.52"
,IN,AR,30334496,1005,100,,Invoice,,,,,,19/12/2018,19/12/2018,0.00,,10.93,,"-1,251,682.45"
,IN,AR,30334503,1005,100,,Invoice,,,,,,19/12/2018,19/12/2018,0.00,,12.71,,"-1,251,695.16"
,IN,AR,30334508,1005,100,,Invoice,,,,,,19/12/2018,19/12/2018,0.00,,14.58,,"-1,251,709.74"
,IN,AR,30334516,1005,100,,Invoice,,,,,,19/12/2018,19/12/2018,0.00,,11.95,,"-1,251,721.69"
,IN,AR,30334539,1005,100,,Invoice,,,,,,19/12/2018,19/12/2018,0.00,,47.75,,"-1,251,769.44"
,IN,AR,30334544,1005,100,,Invoice,,,,,,19/12/2018,19/12/2018,0.00,,6.02,,"-1,251,775.46"
,IN,AR,30334555,1005,100,,Invoice,,,,,,19/12/2018,19/12/2018,0.00,,22.00,,"-1,251,797.46"
,IN,AR,30334565,1005,100,,Invoice,,,,,,19/12/2018,19/12/2018,0.00,,60.13,,"-1,251,857.59"
,IN,AR,30334602,1005,100,,Invoice,,,,,,19/12/2018,19/12/2018,0.00,,6.07,,"-1,251,863.66"
,IN,AR,30334624,1005,100,,Invoice,,,,,,19/12/2018,19/12/2018,0.00,,10.19,,"-1,251,873.85"
,IN,AR,30334634,1005,100,,Invoice,,,,,,19/12/2018,19/12/2018,0.00,,28.46,,"-1,251,902.31"
,IN,AR,30334655,1005,100,,Invoice,,,,,,19/12/2018,19/12/2018,0.00,,5.08,,"-1,251,907.39"
,IN,AR,30334696,1005,100,,Invoice,,,,,,19/12/2018,19/12/2018,0.00,,4.53,,"-1,251,911.92"
,IN,AR,30334697,1005,100,,Invoice,,,,,,19/12/2018,19/12/2018,0.00,,45.25,,"-1,251,957.17"
,IN,AR,30334701,1005,100,,Invoice,,,,,,19/12/2018,19/12/2018,0.00,,18.22,,"-1,251,975.39"
,IN,AR,30334717,1005,100,,Invoice,,,,,,19/12/2018,19/12/2018,0.00,,8.41,,"-1,251,983.80"
,IN,AR,30334721,1005,100,,Invoice,,,,,,19/12/2018,19/12/2018,0.00,,12.46,,"-1,251,996.26"
,IN,AR,30334723,1005,100,,Invoice,,,,,,19/12/2018,19/12/2018,0.00,,14.58,,"-1,252,010.84"
,IN,AR,30334743,1005,100,,Invoice,,,,,,19/12/2018,19/12/2018,0.00,,41.95,,"-1,252,052.79"
,IN,AR,30334770,1005,100,,Invoice,,,,,,19/12/2018,19/12/2018,0.00,,5.59,,"-1,252,058.38"
,IN,AR,30334818,1005,100,,Invoice,,,,,,19/12/2018,19/12/2018,0.00,,7.29,,"-1,252,065.67"
,IN,AR,30334823,1005,100,,Invoice,,,,,,19/12/2018,19/12/2018,0.00,,9.10,,"-1,252,074.77"
,IN,AR,30334854,1005,100,,Invoice,,,,,,19/12/2018,19/12/2018,0.00,,6.37,,"-1,252,081.14"
,IN,AR,30334855,1005,100,,Invoice,,,,,,19/12/2018,19/12/2018,0.00,,35.05,,"-1,252,116.19"
,IN,AR,30334936,1005,100,,Invoice,,,,,,19/12/2018,19/12/2018,0.00,,3.51,,"-1,252,119.70"
,IN,AR,30334960,1005,100,,Invoice,,,,,,19/12/2018,19/12/2018,0.00,,19.66,,"-1,252,139.36"
,IN,AR,30334993,1005,100,,Invoice,,,,,,19/12/2018,19/12/2018,0.00,,5.64,,"-1,252,145.00"
,IN,AR,30335032,1005,100,,Invoice,,,,,,19/12/2018,19/12/2018,0.00,,324.41,,"-1,252,469.41"
,IN,AR,30335033,1005,100,,Invoice,,,,,,19/12/2018,19/12/2018,0.00,,233.47,,"-1,252,702.88"
,IN,AR,30335034,1005,100,,Invoice,,,,,,19/12/2018,19/12/2018,0.00,,351.44,,"-1,253,054.32"
,IN,AR,30335035,1005,100,,Invoice,,,,,,19/12/2018,19/12/2018,0.00,,167.12,,"-1,253,221.44"
,IN,AR,30335046,1005,100,,Invoice,,,,,,19/12/2018,19/12/2018,0.00,,14.83,,"-1,253,236.27"
,IN,AR,30335083,1005,100,,Invoice,,,,,,19/12/2018,19/12/2018,0.00,,10.93,,"-1,253,247.20"
,IN,AR,30335085,1005,100,,Invoice,,,,,,19/12/2018,19/12/2018,0.00,,25.87,,"-1,253,273.07"
,IN,AR,30335105,1005,100,,Invoice,,,,,,19/12/2018,19/12/2018,0.00,,16.02,,"-1,253,289.09"
,IN,AR,30335151,1005,100,,Invoice,,,,,,19/12/2018,19/12/2018,0.00,,4.15,,"-1,253,293.24"
,IN,AR,30335152,1005,100,,Invoice,,,,,,19/12/2018,19/12/2018,0.00,,35.30,,"-1,253,328.54"
,IN,AR,30335153,1005,100,,Invoice,,,,,,19/12/2018,19/12/2018,0.00,,6.23,,"-1,253,334.77"
,IN,AR,30335154,1005,100,,Invoice,,,,,,19/12/2018,19/12/2018,0.00,,4.15,,"-1,253,338.92"
,IN,AR,30335155,1005,100,,Invoice,,,,,,19/12/2018,19/12/2018,0.00,,118.35,,"-1,253,457.27"
,IN,AR,30335156,1005,100,,Invoice,,,,,,19/12/2018,19/12/2018,0.00,,10.38,,"-1,253,467.65"
,IN,AR,30335165,1005,100,,Invoice,,,,,,19/12/2018,19/12/2018,0.00,,6.56,,"-1,253,474.21"
,IN,AR,30335177,1005,100,,Invoice,,,,,,19/12/2018,19/12/2018,0.00,,24.27,,"-1,253,498.48"
,IN,AR,30335243,1005,100,,Invoice,,,,,,19/12/2018,19/12/2018,0.00,,13.98,,"-1,253,512.46"
,IN,AR,30335292,1005,100,,Invoice,,,,,,19/12/2018,19/12/2018,0.00,,5.39,,"-1,253,517.85"
,IN,AR,30335295,1005,100,,Invoice,,,,,,19/12/2018,19/12/2018,0.00,,10.93,,"-1,253,528.78"
,IN,AR,30335298,1005,100,,Invoice,,,,,,19/12/2018,19/12/2018,0.00,,54.66,,"-1,253,583.44"
,IN,AR,30335353,1005,100,,Invoice,,,,,,19/12/2018,19/12/2018,0.00,,10.93,,"-1,253,594.37"
,IN,AR,30335370,1005,100,,Invoice,,,,,,19/12/2018,19/12/2018,0.00,,8.97,,"-1,253,603.34"
,IN,AR,30335371,1005,100,,Invoice,,,,,,19/12/2018,19/12/2018,0.00,,2.99,,"-1,253,606.33"
,IN,AR,30335372,1005,100,,Invoice,,,,,,19/12/2018,19/12/2018,0.00,,11.96,,"-1,253,618.29"
,IN,AR,30335382,1005,100,,Invoice,,,,,,19/12/2018,19/12/2018,0.00,,14.58,,"-1,253,632.87"
,IN,AR,30335383,1005,100,,Invoice,,,,,,19/12/2018,19/12/2018,0.00,,7.29,,"-1,253,640.16"
,IN,AR,30335384,1005,100,,Invoice,,,,,,19/12/2018,19/12/2018,0.00,,24.07,,"-1,253,664.23"
,CN,AR,31019646,1005,100,,Credit Note,,,,,,20/12/2018,20/12/2018,"3,475.62",,0.00,,"-1,250,188.61"
,CS,AR,32011750,1005,100,,Cash sale,,,,,,20/12/2018,20/12/2018,0.00,,24.07,,"-1,250,212.68"
,CS,AR,32011772,1005,100,,Cash sale,,,,,,20/12/2018,20/12/2018,0.00,,11.36,,"-1,250,224.04"
,CS,AR,32011774,1005,100,,Cash sale,,,,,,20/12/2018,20/12/2018,0.00,,3.64,,"-1,250,227.68"
,CS,AR,32011781,1005,100,,Cash sale,,,,,,20/12/2018,20/12/2018,0.00,,10.93,,"-1,250,238.61"
,CS,AR,32011809,1005,100,,Cash sale,,,,,,20/12/2018,20/12/2018,0.00,,21.86,,"-1,250,260.47"
,CS,AR,32011819,1005,100,,Cash sale,,,,,,20/12/2018,20/12/2018,0.00,,3.64,,"-1,250,264.11"
,CS,AR,32011825,1005,100,,Cash sale,,,,,,20/12/2018,20/12/2018,0.00,,3.64,,"-1,250,267.75"
,CS,AR,32011832,1005,100,,Cash sale,,,,,,20/12/2018,20/12/2018,0.00,,3.64,,"-1,250,271.39"
,CS,AR,32011851,1005,100,,Cash sale,,,,,,20/12/2018,20/12/2018,0.00,,7.29,,"-1,250,278.68"
,CS,AR,32011921,1005,100,,Cash sale,,,,,,20/12/2018,20/12/2018,0.00,,7.29,,"-1,250,285.97"
,CS,AR,32011944,1005,100,,Cash sale,,,,,,20/12/2018,20/12/2018,0.00,,12.92,,"-1,250,298.89"
,CS,AR,32011970,1005,100,,Cash sale,,,,,,20/12/2018,20/12/2018,0.00,,10.93,,"-1,250,309.82"
,CS,AR,32012009,1005,100,,Cash sale,,,,,,20/12/2018,20/12/2018,0.00,,14.58,,"-1,250,324.40"
,CS,AR,32012071,1005,100,,Cash sale,,,,,,20/12/2018,20/12/2018,0.00,,7.29,,"-1,250,331.69"
,CS,AR,32012097,1005,100,,Cash sale,,,,,,20/12/2018,20/12/2018,0.00,,27.97,,"-1,250,359.66"
,CS,AR,32012105,1005,100,,Cash sale,,,,,,20/12/2018,20/12/2018,0.00,,9.03,,"-1,250,368.69"
,CS,AR,32012114,1005,100,,Cash sale,,,,,,20/12/2018,20/12/2018,0.00,,7.29,,"-1,250,375.98"
,CS,AR,32012119,1005,100,,Cash sale,,,,,,20/12/2018,20/12/2018,0.00,,9.66,,"-1,250,385.64"
,CS,AR,32012126,1005,100,,Cash sale,,,,,,20/12/2018,20/12/2018,0.00,,3.64,,"-1,250,389.28"
,CS,AR,32012129,1005,100,,Cash sale,,,,,,20/12/2018,20/12/2018,0.00,,12.92,,"-1,250,402.20"
,CS,AR,32012153,1005,100,,Cash sale,,,,,,20/12/2018,20/12/2018,0.00,,18.05,,"-1,250,420.25"
,CS,AR,32012155,1005,100,,Cash sale,,,,,,20/12/2018,20/12/2018,0.00,,10.93,,"-1,250,431.18"
,CS,AR,32012160,1005,100,,Cash sale,,,,,,20/12/2018,20/12/2018,0.00,,13.98,,"-1,250,445.16"
,CS,AR,32012227,1005,100,,Cash sale,,,,,,20/12/2018,20/12/2018,0.00,,5.93,,"-1,250,451.09"
,CS,AR,32012246,1005,100,,Cash sale,,,,,,20/12/2018,20/12/2018,0.00,,7.29,,"-1,250,458.38"
,CS,AR,32012264,1005,100,,Cash sale,,,,,,20/12/2018,20/12/2018,0.00,,8.90,,"-1,250,467.28"
,CS,AR,32012334,1005,100,,Cash sale,,,,,,20/12/2018,20/12/2018,0.00,,10.93,,"-1,250,478.21"
,CS,AR,32012342,1005,100,,Cash sale,,,,,,20/12/2018,20/12/2018,0.00,,10.93,,"-1,250,489.14"
,CS,AR,32012374,1005,100,,Cash sale,,,,,,20/12/2018,20/12/2018,0.00,,3.64,,"-1,250,492.78"
,CS,AR,32012456,1005,100,,Cash sale,,,,,,20/12/2018,20/12/2018,0.00,,7.29,,"-1,250,500.07"
,CS,AR,32012472,1005,100,,Cash sale,,,,,,20/12/2018,20/12/2018,0.00,,7.29,,"-1,250,507.36"
,CS,AR,32012473,1005,100,,Cash sale,,,,,,20/12/2018,20/12/2018,0.00,,7.29,,"-1,250,514.65"
,IN,AR,30333535,1005,100,,Invoice,,,,,,20/12/2018,20/12/2018,0.00,,3.64,,"-1,250,518.29"
,IN,AR,30333546,1005,100,,Invoice,,,,,,20/12/2018,20/12/2018,0.00,,7.29,,"-1,250,525.58"
,IN,AR,30333556,1005,100,,Invoice,,,,,,20/12/2018,20/12/2018,0.00,,26.85,,"-1,250,552.43"
,IN,AR,30333624,1005,100,,Invoice,,,,,,20/12/2018,20/12/2018,0.00,,32.54,,"-1,250,584.97"
,IN,AR,30333652,1005,100,,Invoice,,,,,,20/12/2018,20/12/2018,0.00,,3.98,,"-1,250,588.95"
,IN,AR,30333665,1005,100,,Invoice,,,,,,20/12/2018,20/12/2018,0.00,,32.00,,"-1,250,620.95"
,IN,AR,30333684,1005,100,,Invoice,,,,,,20/12/2018,20/12/2018,0.00,,46.00,,"-1,250,666.95"
,IN,AR,30333702,1005,100,,Invoice,,,,,,20/12/2018,20/12/2018,0.00,,18.22,,"-1,250,685.17"
,IN,AR,30333738,1005,100,,Invoice,,,,,,20/12/2018,20/12/2018,0.00,,5.51,,"-1,250,690.68"
,IN,AR,30333764,1005,100,,Invoice,,,,,,20/12/2018,20/12/2018,0.00,,68.81,,"-1,250,759.49"
,IN,AR,30333765,1005,100,,Invoice,,,,,,20/12/2018,20/12/2018,0.00,,28.47,,"-1,250,787.96"
,IN,AR,30333780,1005,100,,Invoice,,,,,,20/12/2018,20/12/2018,0.00,,24.71,,"-1,250,812.67"
,IN,AR,30333782,1005,100,,Invoice,,,,,,20/12/2018,20/12/2018,0.00,,18.22,,"-1,250,830.89"
,IN,AR,30333789,1005,100,,Invoice,,,,,,20/12/2018,20/12/2018,0.00,,8.52,,"-1,250,839.41"
,IN,AR,30333828,1005,100,,Invoice,,,,,,20/12/2018,20/12/2018,0.00,,7.29,,"-1,250,846.70"
,IN,AR,30333857,1005,100,,Invoice,,,,,,20/12/2018,20/12/2018,0.00,,3.64,,"-1,250,850.34"
,IN,AR,30333859,1005,100,,Invoice,,,,,,20/12/2018,20/12/2018,0.00,,218.64,,"-1,251,068.98"
,IN,AR,30333867,1005,100,,Invoice,,,,,,20/12/2018,20/12/2018,0.00,,14.58,,"-1,251,083.56"
,IN,AR,30333868,1005,100,,Invoice,,,,,,20/12/2018,20/12/2018,0.00,,43.94,,"-1,251,127.50"
,IN,AR,30333871,1005,100,,Invoice,,,,,,20/12/2018,20/12/2018,0.00,,7.29,,"-1,251,134.79"
,IN,AR,30333876,1005,100,,Invoice,,,,,,20/12/2018,20/12/2018,0.00,,24.50,,"-1,251,159.29"
,IN,AR,30333889,1005,100,,Invoice,,,,,,20/12/2018,20/12/2018,0.00,,4.64,,"-1,251,163.93"
,IN,AR,30333904,1005,100,,Invoice,,,,,,20/12/2018,20/12/2018,0.00,,7.29,,"-1,251,171.22"
,IN,AR,30333912,1005,100,,Invoice,,,,,,20/12/2018,20/12/2018,0.00,,6.02,,"-1,251,177.24"
,IN,AR,30333959,1005,100,,Invoice,,,,,,20/12/2018,20/12/2018,0.00,,182.20,,"-1,251,359.44"
,IN,AR,30333971,1005,100,,Invoice,,,,,,20/12/2018,20/12/2018,0.00,,11.95,,"-1,251,371.39"
,IN,AR,30333988,1005,100,,Invoice,,,,,,20/12/2018,20/12/2018,0.00,,25.42,,"-1,251,396.81"
,IN,AR,30334008,1005,100,,Invoice,,,,,,20/12/2018,20/12/2018,0.00,,12.71,,"-1,251,409.52"
,IN,AR,30334009,1005,100,,Invoice,,,,,,20/12/2018,20/12/2018,0.00,,66.10,,"-1,251,475.62"
,IN,AR,30334025,1005,100,,Invoice,,,,,,20/12/2018,20/12/2018,0.00,,16.73,,"-1,251,492.35"
,IN,AR,30334068,1005,100,,Invoice,,,,,,20/12/2018,20/12/2018,0.00,,75.21,,"-1,251,567.56"
,IN,AR,30334078,1005,100,,Invoice,,,,,,20/12/2018,20/12/2018,0.00,,6.36,,"-1,251,573.92"
,IN,AR,30334113,1005,100,,Invoice,,,,,,20/12/2018,20/12/2018,0.00,,16.55,,"-1,251,590.47"
,IN,AR,30334117,1005,100,,Invoice,,,,,,20/12/2018,20/12/2018,0.00,,7.75,,"-1,251,598.22"
,IN,AR,30334124,1005,100,,Invoice,,,,,,20/12/2018,20/12/2018,0.00,,4.32,,"-1,251,602.54"
,IN,AR,30334127,1005,100,,Invoice,,,,,,20/12/2018,20/12/2018,0.00,,3.43,,"-1,251,605.97"
,IN,AR,30334163,1005,100,,Invoice,,,,,,20/12/2018,20/12/2018,0.00,,15.00,,"-1,251,620.97"
,IN,AR,30334173,1005,100,,Invoice,,,,,,20/12/2018,20/12/2018,0.00,,3.64,,"-1,251,624.61"
,IN,AR,30334201,1005,100,,Invoice,,,,,,20/12/2018,20/12/2018,0.00,,6.02,,"-1,251,630.63"
,IN,AR,30334205,1005,100,,Invoice,,,,,,20/12/2018,20/12/2018,0.00,,364.41,,"-1,251,995.04"
,IN,AR,30334235,1005,100,,Invoice,,,,,,20/12/2018,20/12/2018,0.00,,38.44,,"-1,252,033.48"
,IN,AR,30334249,1005,100,,Invoice,,,,,,20/12/2018,20/12/2018,0.00,,3.64,,"-1,252,037.12"
,IN,AR,30334258,1005,100,,Invoice,,,,,,20/12/2018,20/12/2018,0.00,,2.97,,"-1,252,040.09"
,IN,AR,30334259,1005,100,,Invoice,,,,,,20/12/2018,20/12/2018,0.00,,41.53,,"-1,252,081.62"
,IN,AR,30334262,1005,100,,Invoice,,,,,,20/12/2018,20/12/2018,0.00,,9.15,,"-1,252,090.77"
,IN,AR,30334271,1005,100,,Invoice,,,,,,20/12/2018,20/12/2018,0.00,,14.58,,"-1,252,105.35"
,IN,AR,30334322,1005,100,,Invoice,,,,,,20/12/2018,20/12/2018,0.00,,2.32,,"-1,252,107.67"
,IN,AR,30334328,1005,100,,Invoice,,,,,,20/12/2018,20/12/2018,0.00,,5.85,,"-1,252,113.52"
,IN,AR,30334330,1005,100,,Invoice,,,,,,20/12/2018,20/12/2018,0.00,,10.93,,"-1,252,124.45"
,IN,AR,30334333,1005,100,,Invoice,,,,,,20/12/2018,20/12/2018,0.00,,10.93,,"-1,252,135.38"
,IN,AR,30334337,1005,100,,Invoice,,,,,,20/12/2018,20/12/2018,0.00,,33.05,,"-1,252,168.43"
,IN,AR,30334350,1005,100,,Invoice,,,,,,20/12/2018,20/12/2018,0.00,,14.19,,"-1,252,182.62"
,IN,AR,30334358,1005,100,,Invoice,,,,,,20/12/2018,20/12/2018,0.00,,9.03,,"-1,252,191.65"
,IN,AR,30334373,1005,100,,Invoice,,,,,,20/12/2018,20/12/2018,0.00,,10.93,,"-1,252,202.58"
,IN,AR,30334386,1005,100,,Invoice,,,,,,20/12/2018,20/12/2018,0.00,,13.58,,"-1,252,216.16"
,IN,AR,30334389,1005,100,,Invoice,,,,,,20/12/2018,20/12/2018,0.00,,7.63,,"-1,252,223.79"
,IN,AR,30334404,1005,100,,Invoice,,,,,,20/12/2018,20/12/2018,0.00,,8.00,,"-1,252,231.79"
,IN,AR,30334426,1005,100,,Invoice,,,,,,20/12/2018,20/12/2018,0.00,,1.76,,"-1,252,233.55"
,IN,AR,30334436,1005,100,,Invoice,,,,,,20/12/2018,20/12/2018,0.00,,7.29,,"-1,252,240.84"
,IN,AR,30334451,1005,100,,Invoice,,,,,,20/12/2018,20/12/2018,0.00,,5.93,,"-1,252,246.77"
,IN,AR,30334458,1005,100,,Invoice,,,,,,20/12/2018,20/12/2018,0.00,,18.09,,"-1,252,264.86"
,IN,AR,30334466,1005,100,,Invoice,,,,,,20/12/2018,20/12/2018,0.00,,20.95,,"-1,252,285.81"
,IN,AR,30334470,1005,100,,Invoice,,,,,,20/12/2018,20/12/2018,0.00,,8.78,,"-1,252,294.59"
,IN,AR,30334494,1005,100,,Invoice,,,,,,20/12/2018,20/12/2018,0.00,,2.84,,"-1,252,297.43"
,IN,AR,30334517,1005,100,,Invoice,,,,,,20/12/2018,20/12/2018,0.00,,5.97,,"-1,252,303.40"
,IN,AR,30334518,1005,100,,Invoice,,,,,,20/12/2018,20/12/2018,0.00,,19.92,,"-1,252,323.32"
,IN,AR,30334519,1005,100,,Invoice,,,,,,20/12/2018,20/12/2018,0.00,,3.98,,"-1,252,327.30"
,IN,AR,30334520,1005,100,,Invoice,,,,,,20/12/2018,20/12/2018,0.00,,31.86,,"-1,252,359.16"
,IN,AR,30334540,1005,100,,Invoice,,,,,,20/12/2018,20/12/2018,0.00,,15.92,,"-1,252,375.08"
,IN,AR,30334566,1005,100,,Invoice,,,,,,20/12/2018,20/12/2018,0.00,,11.36,,"-1,252,386.44"
,IN,AR,30334578,1005,100,,Invoice,,,,,,20/12/2018,20/12/2018,0.00,,26.69,,"-1,252,413.13"
,IN,AR,30334586,1005,100,,Invoice,,,,,,20/12/2018,20/12/2018,0.00,,7.29,,"-1,252,420.42"
,IN,AR,30334592,1005,100,,Invoice,,,,,,20/12/2018,20/12/2018,0.00,,24.29,,"-1,252,444.71"
,IN,AR,30334621,1005,100,,Invoice,,,,,,20/12/2018,20/12/2018,0.00,,9.84,,"-1,252,454.55"
,IN,AR,30334656,1005,100,,Invoice,,,,,,20/12/2018,20/12/2018,0.00,,25.42,,"-1,252,479.97"
,IN,AR,30334670,1005,100,,Invoice,,,,,,20/12/2018,20/12/2018,0.00,,2.00,,"-1,252,481.97"
,IN,AR,30334674,1005,100,,Invoice,,,,,,20/12/2018,20/12/2018,0.00,,34.01,,"-1,252,515.98"
,IN,AR,30334684,1005,100,,Invoice,,,,,,20/12/2018,20/12/2018,0.00,,26.24,,"-1,252,542.22"
,IN,AR,30334691,1005,100,,Invoice,,,,,,20/12/2018,20/12/2018,0.00,,36.91,,"-1,252,579.13"
,IN,AR,30334727,1005,100,,Invoice,,,,,,20/12/2018,20/12/2018,0.00,,14.58,,"-1,252,593.71"
,IN,AR,30334756,1005,100,,Invoice,,,,,,20/12/2018,20/12/2018,0.00,,11.22,,"-1,252,604.93"
,IN,AR,30334757,1005,100,,Invoice,,,,,,20/12/2018,20/12/2018,0.00,,19.64,,"-1,252,624.57"
,IN,AR,30334765,1005,100,,Invoice,,,,,,20/12/2018,20/12/2018,0.00,,20.59,,"-1,252,645.16"
,IN,AR,30334768,1005,100,,Invoice,,,,,,20/12/2018,20/12/2018,0.00,,7.29,,"-1,252,652.45"
,IN,AR,30334784,1005,100,,Invoice,,,,,,20/12/2018,20/12/2018,0.00,,18.20,,"-1,252,670.65"
,IN,AR,30334833,1005,100,,Invoice,,,,,,20/12/2018,20/12/2018,0.00,,81.15,,"-1,252,751.80"
,IN,AR,30334856,1005,100,,Invoice,,,,,,20/12/2018,20/12/2018,0.00,,94.00,,"-1,252,845.80"
,IN,AR,30334857,1005,100,,Invoice,,,,,,20/12/2018,20/12/2018,0.00,,4.78,,"-1,252,850.58"
,IN,AR,30334858,1005,100,,Invoice,,,,,,20/12/2018,20/12/2018,0.00,,9.56,,"-1,252,860.14"
,IN,AR,30334859,1005,100,,Invoice,,,,,,20/12/2018,20/12/2018,0.00,,4.78,,"-1,252,864.92"
,IN,AR,30334874,1005,100,,Invoice,,,,,,20/12/2018,20/12/2018,0.00,,71.19,,"-1,252,936.11"
,IN,AR,30334912,1005,100,,Invoice,,,,,,20/12/2018,20/12/2018,0.00,,22.37,,"-1,252,958.48"
,IN,AR,30334985,1005,100,,Invoice,,,,,,20/12/2018,20/12/2018,0.00,,10.93,,"-1,252,969.41"
,IN,AR,30335060,1005,100,,Invoice,,,,,,20/12/2018,20/12/2018,0.00,,14.30,,"-1,252,983.71"
,IN,AR,30335061,1005,100,,Invoice,,,,,,20/12/2018,20/12/2018,0.00,,7.29,,"-1,252,991.00"
,IN,AR,30335107,1005,100,,Invoice,,,,,,20/12/2018,20/12/2018,0.00,,18.21,,"-1,253,009.21"
,IN,AR,30335111,1005,100,,Invoice,,,,,,20/12/2018,20/12/2018,0.00,,7.29,,"-1,253,016.50"
,IN,AR,30335157,1005,100,,Invoice,,,,,,20/12/2018,20/12/2018,0.00,,4.15,,"-1,253,020.65"
,IN,AR,30335158,1005,100,,Invoice,,,,,,20/12/2018,20/12/2018,0.00,,6.23,,"-1,253,026.88"
,IN,AR,30335201,1005,100,,Invoice,,,,,,20/12/2018,20/12/2018,0.00,,4.07,,"-1,253,030.95"
,IN,AR,30335211,1005,100,,Invoice,,,,,,20/12/2018,20/12/2018,0.00,,61.95,,"-1,253,092.90"
,IN,AR,30335235,1005,100,,Invoice,,,,,,20/12/2018,20/12/2018,0.00,,8.41,,"-1,253,101.31"
,IN,AR,30335244,1005,100,,Invoice,,,,,,20/12/2018,20/12/2018,0.00,,7.29,,"-1,253,108.60"
,IN,AR,30335254,1005,100,,Invoice,,,,,,20/12/2018,20/12/2018,0.00,,72.81,,"-1,253,181.41"
,IN,AR,30335276,1005,100,,Invoice,,,,,,20/12/2018,20/12/2018,0.00,,7.29,,"-1,253,188.70"
,IN,AR,30335278,1005,100,,Invoice,,,,,,20/12/2018,20/12/2018,0.00,,5.26,,"-1,253,193.96"
,IN,AR,30335309,1005,100,,Invoice,,,,,,20/12/2018,20/12/2018,0.00,,16.85,,"-1,253,210.81"
,IN,AR,30335323,1005,100,,Invoice,,,,,,20/12/2018,20/12/2018,0.00,,5.93,,"-1,253,216.74"
,IN,AR,30335324,1005,100,,Invoice,,,,,,20/12/2018,20/12/2018,0.00,,47.37,,"-1,253,264.11"
,CN,AR,31019659,1005,100,,Credit Note,,,,,,21/12/2018,21/12/2018,54.66,,0.00,,"-1,253,209.45"
,CN,AR,31019660,1005,100,,Credit Note,,,,,,21/12/2018,21/12/2018,418.61,,0.00,,"-1,252,790.84"
,CR,AR,33000331,1005,100,,Cash Return,,,,,,21/12/2018,21/12/2018,21.86,,0.00,,"-1,252,768.98"
,CS,AR,32011747,1005,100,,Cash sale,,,,,,21/12/2018,21/12/2018,0.00,,25.51,,"-1,252,794.49"
,CS,AR,32011767,1005,100,,Cash sale,,,,,,21/12/2018,21/12/2018,0.00,,11.86,,"-1,252,806.35"
,CS,AR,32011769,1005,100,,Cash sale,,,,,,21/12/2018,21/12/2018,0.00,,6.02,,"-1,252,812.37"
,CS,AR,32011778,1005,100,,Cash sale,,,,,,21/12/2018,21/12/2018,0.00,,6.08,,"-1,252,818.45"
,CS,AR,32011807,1005,100,,Cash sale,,,,,,21/12/2018,21/12/2018,0.00,,29.15,,"-1,252,847.60"
,CS,AR,32011823,1005,100,,Cash sale,,,,,,21/12/2018,21/12/2018,0.00,,7.29,,"-1,252,854.89"
,CS,AR,32011842,1005,100,,Cash sale,,,,,,21/12/2018,21/12/2018,0.00,,10.93,,"-1,252,865.82"
,CS,AR,32011848,1005,100,,Cash sale,,,,,,21/12/2018,21/12/2018,0.00,,14.53,,"-1,252,880.35"
,CS,AR,32011868,1005,100,,Cash sale,,,,,,21/12/2018,21/12/2018,0.00,,5.84,,"-1,252,886.19"
,CS,AR,32011872,1005,100,,Cash sale,,,,,,21/12/2018,21/12/2018,0.00,,3.64,,"-1,252,889.83"
,CS,AR,32011886,1005,100,,Cash sale,,,,,,21/12/2018,21/12/2018,0.00,,10.93,,"-1,252,900.76"
,CS,AR,32011889,1005,100,,Cash sale,,,,,,21/12/2018,21/12/2018,0.00,,38.81,,"-1,252,939.57"
,CS,AR,32011905,1005,100,,Cash sale,,,,,,21/12/2018,21/12/2018,0.00,,7.29,,"-1,252,946.86"
,CS,AR,32011930,1005,100,,Cash sale,,,,,,21/12/2018,21/12/2018,0.00,,5.17,,"-1,252,952.03"
,CS,AR,32011939,1005,100,,Cash sale,,,,,,21/12/2018,21/12/2018,0.00,,10.17,,"-1,252,962.20"
,CS,AR,32011956,1005,100,,Cash sale,,,,,,21/12/2018,21/12/2018,0.00,,3.64,,"-1,252,965.84"
,CS,AR,32011965,1005,100,,Cash sale,,,,,,21/12/2018,21/12/2018,0.00,,38.47,,"-1,253,004.31"
,CS,AR,32011975,1005,100,,Cash sale,,,,,,21/12/2018,21/12/2018,0.00,,10.99,,"-1,253,015.30"
,CS,AR,32011986,1005,100,,Cash sale,,,,,,21/12/2018,21/12/2018,0.00,,3.01,,"-1,253,018.31"
,CS,AR,32011987,1005,100,,Cash sale,,,,,,21/12/2018,21/12/2018,0.00,,3.01,,"-1,253,021.32"
,CS,AR,32011998,1005,100,,Cash sale,,,,,,21/12/2018,21/12/2018,0.00,,9.03,,"-1,253,030.35"
,CS,AR,32012015,1005,100,,Cash sale,,,,,,21/12/2018,21/12/2018,0.00,,20.47,,"-1,253,050.82"
,CS,AR,32012017,1005,100,,Cash sale,,,,,,21/12/2018,21/12/2018,0.00,,6.74,,"-1,253,057.56"
,CS,AR,32012033,1005,100,,Cash sale,,,,,,21/12/2018,21/12/2018,0.00,,21.06,,"-1,253,078.62"
,CS,AR,32012059,1005,100,,Cash sale,,,,,,21/12/2018,21/12/2018,0.00,,10.93,,"-1,253,089.55"
,CS,AR,32012111,1005,100,,Cash sale,,,,,,21/12/2018,21/12/2018,0.00,,21.86,,"-1,253,111.41"
,CS,AR,32012123,1005,100,,Cash sale,,,,,,21/12/2018,21/12/2018,0.00,,20.48,,"-1,253,131.89"
,CS,AR,32012124,1005,100,,Cash sale,,,,,,21/12/2018,21/12/2018,0.00,,29.15,,"-1,253,161.04"
,CS,AR,32012151,1005,100,,Cash sale,,,,,,21/12/2018,21/12/2018,0.00,,8.34,,"-1,253,169.38"
,CS,AR,32012162,1005,100,,Cash sale,,,,,,21/12/2018,21/12/2018,0.00,,7.29,,"-1,253,176.67"
,CS,AR,32012188,1005,100,,Cash sale,,,,,,21/12/2018,21/12/2018,0.00,,20.34,,"-1,253,197.01"
,CS,AR,32012220,1005,100,,Cash sale,,,,,,21/12/2018,21/12/2018,0.00,,36.00,,"-1,253,233.01"
,CS,AR,32012236,1005,100,,Cash sale,,,,,,21/12/2018,21/12/2018,0.00,,13.12,,"-1,253,246.13"
,CS,AR,32012256,1005,100,,Cash sale,,,,,,21/12/2018,21/12/2018,0.00,,9.15,,"-1,253,255.28"
,CS,AR,32012287,1005,100,,Cash sale,,,,,,21/12/2018,21/12/2018,0.00,,7.29,,"-1,253,262.57"
,CS,AR,32012301,1005,100,,Cash sale,,,,,,21/12/2018,21/12/2018,0.00,,10.93,,"-1,253,273.50"
,CS,AR,32012304,1005,100,,Cash sale,,,,,,21/12/2018,21/12/2018,0.00,,10.93,,"-1,253,284.43"
,CS,AR,32012310,1005,100,,Cash sale,,,,,,21/12/2018,21/12/2018,0.00,,12.14,,"-1,253,296.57"
,CS,AR,32012314,1005,100,,Cash sale,,,,,,21/12/2018,21/12/2018,0.00,,9.15,,"-1,253,305.72"
,CS,AR,32012328,1005,100,,Cash sale,,,,,,21/12/2018,21/12/2018,0.00,,14.58,,"-1,253,320.30"
,CS,AR,32012341,1005,100,,Cash sale,,,,,,21/12/2018,21/12/2018,0.00,,3.64,,"-1,253,323.94"
,CS,AR,32012351,1005,100,,Cash sale,,,,,,21/12/2018,21/12/2018,0.00,,8.78,,"-1,253,332.72"
,CS,AR,32012366,1005,100,,Cash sale,,,,,,21/12/2018,21/12/2018,0.00,,3.64,,"-1,253,336.36"
,CS,AR,32012371,1005,100,,Cash sale,,,,,,21/12/2018,21/12/2018,0.00,,3.01,,"-1,253,339.37"
,CS,AR,32012380,1005,100,,Cash sale,,,,,,21/12/2018,21/12/2018,0.00,,2.97,,"-1,253,342.34"
,CS,AR,32012447,1005,100,,Cash sale,,,,,,21/12/2018,21/12/2018,0.00,,12.14,,"-1,253,354.48"
,CS,AR,32012453,1005,100,,Cash sale,,,,,,21/12/2018,21/12/2018,0.00,,21.86,,"-1,253,376.34"
,CS,AR,32012460,1005,100,,Cash sale,,,,,,21/12/2018,21/12/2018,0.00,,5.47,,"-1,253,381.81"
,CS,AR,32012463,1005,100,,Cash sale,,,,,,21/12/2018,21/12/2018,0.00,,10.93,,"-1,253,392.74"
,IN,AR,30333514,1005,100,,Invoice,,,,,,21/12/2018,21/12/2018,0.00,,3.64,,"-1,253,396.38"
,IN,AR,30333517,1005,100,,Invoice,,,,,,21/12/2018,21/12/2018,0.00,,8.90,,"-1,253,405.28"
,IN,AR,30333529,1005,100,,Invoice,,,,,,21/12/2018,21/12/2018,0.00,,32.63,,"-1,253,437.91"
,IN,AR,30333543,1005,100,,Invoice,,,,,,21/12/2018,21/12/2018,0.00,,13.98,,"-1,253,451.89"
,IN,AR,30333612,1005,100,,Invoice,,,,,,21/12/2018,21/12/2018,0.00,,7.25,,"-1,253,459.14"
,IN,AR,30333615,1005,100,,Invoice,,,,,,21/12/2018,21/12/2018,0.00,,10.93,,"-1,253,470.07"
,IN,AR,30333630,1005,100,,Invoice,,,,,,21/12/2018,21/12/2018,0.00,,46.50,,"-1,253,516.57"
,IN,AR,30333634,1005,100,,Invoice,,,,,,21/12/2018,21/12/2018,0.00,,4.32,,"-1,253,520.89"
,IN,AR,30333638,1005,100,,Invoice,,,,,,21/12/2018,21/12/2018,0.00,,4.59,,"-1,253,525.48"
,IN,AR,30333642,1005,100,,Invoice,,,,,,21/12/2018,21/12/2018,0.00,,91.21,,"-1,253,616.69"
,IN,AR,30333707,1005,100,,Invoice,,,,,,21/12/2018,21/12/2018,0.00,,7.29,,"-1,253,623.98"
,IN,AR,30333727,1005,100,,Invoice,,,,,,21/12/2018,21/12/2018,0.00,,32.00,,"-1,253,655.98"
,IN,AR,30333770,1005,100,,Invoice,,,,,,21/12/2018,21/12/2018,0.00,,14.00,,"-1,253,669.98"
,IN,AR,30333775,1005,100,,Invoice,,,,,,21/12/2018,21/12/2018,0.00,,40.08,,"-1,253,710.06"
,IN,AR,30333810,1005,100,,Invoice,,,,,,21/12/2018,21/12/2018,0.00,,5.82,,"-1,253,715.88"
,IN,AR,30333811,1005,100,,Invoice,,,,,,21/12/2018,21/12/2018,0.00,,15.53,,"-1,253,731.41"
,IN,AR,30333822,1005,100,,Invoice,,,,,,21/12/2018,21/12/2018,0.00,,26.00,,"-1,253,757.41"
,IN,AR,30333826,1005,100,,Invoice,,,,,,21/12/2018,21/12/2018,0.00,,3.64,,"-1,253,761.05"
,IN,AR,30333839,1005,100,,Invoice,,,,,,21/12/2018,21/12/2018,0.00,,25.51,,"-1,253,786.56"
,IN,AR,30333840,1005,100,,Invoice,,,,,,21/12/2018,21/12/2018,0.00,,7.29,,"-1,253,793.85"
,IN,AR,30333880,1005,100,,Invoice,,,,,,21/12/2018,21/12/2018,0.00,,7.75,,"-1,253,801.60"
,IN,AR,30333903,1005,100,,Invoice,,,,,,21/12/2018,21/12/2018,0.00,,10.93,,"-1,253,812.53"
,IN,AR,30333941,1005,100,,Invoice,,,,,,21/12/2018,21/12/2018,0.00,,21.86,,"-1,253,834.39"
,IN,AR,30333948,1005,100,,Invoice,,,,,,21/12/2018,21/12/2018,0.00,,18.09,,"-1,253,852.48"
,IN,AR,30333952,1005,100,,Invoice,,,,,,21/12/2018,21/12/2018,0.00,,2.39,,"-1,253,854.87"
,IN,AR,30333977,1005,100,,Invoice,,,,,,21/12/2018,21/12/2018,0.00,,6.02,,"-1,253,860.89"
,IN,AR,30333984,1005,100,,Invoice,,,,,,21/12/2018,21/12/2018,0.00,,612.20,,"-1,254,473.09"
,IN,AR,30333997,1005,100,,Invoice,,,,,,21/12/2018,21/12/2018,0.00,,28.71,,"-1,254,501.80"
,IN,AR,30334000,1005,100,,Invoice,,,,,,21/12/2018,21/12/2018,0.00,,14.03,,"-1,254,515.83"
,IN,AR,30334061,1005,100,,Invoice,,,,,,21/12/2018,21/12/2018,0.00,,837.22,,"-1,255,353.05"
,IN,AR,30334097,1005,100,,Invoice,,,,,,21/12/2018,21/12/2018,0.00,,5.08,,"-1,255,358.13"
,IN,AR,30334098,1005,100,,Invoice,,,,,,21/12/2018,21/12/2018,0.00,,10.17,,"-1,255,368.30"
,IN,AR,30334105,1005,100,,Invoice,,,,,,21/12/2018,21/12/2018,0.00,,5.08,,"-1,255,373.38"
,IN,AR,30334132,1005,100,,Invoice,,,,,,21/12/2018,21/12/2018,0.00,,10.17,,"-1,255,383.55"
,IN,AR,30334176,1005,100,,Invoice,,,,,,21/12/2018,21/12/2018,0.00,,3.31,,"-1,255,386.86"
,IN,AR,30334187,1005,100,,Invoice,,,,,,21/12/2018,21/12/2018,0.00,,15.25,,"-1,255,402.11"
,IN,AR,30334188,1005,100,,Invoice,,,,,,21/12/2018,21/12/2018,0.00,,14.58,,"-1,255,416.69"
,IN,AR,30334247,1005,100,,Invoice,,,,,,21/12/2018,21/12/2018,0.00,,16.83,,"-1,255,433.52"
,IN,AR,30334260,1005,100,,Invoice,,,,,,21/12/2018,21/12/2018,0.00,,8.90,,"-1,255,442.42"
,IN,AR,30334266,1005,100,,Invoice,,,,,,21/12/2018,21/12/2018,0.00,,14.58,,"-1,255,457.00"
,IN,AR,30334306,1005,100,,Invoice,,,,,,21/12/2018,21/12/2018,0.00,,21.86,,"-1,255,478.86"
,IN,AR,30334311,1005,100,,Invoice,,,,,,21/12/2018,21/12/2018,0.00,,4.00,,"-1,255,482.86"
,IN,AR,30334376,1005,100,,Invoice,,,,,,21/12/2018,21/12/2018,0.00,,18.05,,"-1,255,500.91"
,IN,AR,30334391,1005,100,,Invoice,,,,,,21/12/2018,21/12/2018,0.00,,6.53,,"-1,255,507.44"
,IN,AR,30334444,1005,100,,Invoice,,,,,,21/12/2018,21/12/2018,0.00,,11.36,,"-1,255,518.80"
,IN,AR,30334462,1005,100,,Invoice,,,,,,21/12/2018,21/12/2018,0.00,,14.58,,"-1,255,533.38"
,IN,AR,30334499,1005,100,,Invoice,,,,,,21/12/2018,21/12/2018,0.00,,3.64,,"-1,255,537.02"
,IN,AR,30334521,1005,100,,Invoice,,,,,,21/12/2018,21/12/2018,0.00,,27.88,,"-1,255,564.90"
,IN,AR,30334541,1005,100,,Invoice,,,,,,21/12/2018,21/12/2018,0.00,,23.88,,"-1,255,588.78"
,IN,AR,30334551,1005,100,,Invoice,,,,,,21/12/2018,21/12/2018,0.00,,25.55,,"-1,255,614.33"
,IN,AR,30334561,1005,100,,Invoice,,,,,,21/12/2018,21/12/2018,0.00,,28.81,,"-1,255,643.14"
,IN,AR,30334570,1005,100,,Invoice,,,,,,21/12/2018,21/12/2018,0.00,,32.07,,"-1,255,675.21"
,IN,AR,30334596,1005,100,,Invoice,,,,,,21/12/2018,21/12/2018,0.00,,34.58,,"-1,255,709.79"
,IN,AR,30334606,1005,100,,Invoice,,,,,,21/12/2018,21/12/2018,0.00,,10.93,,"-1,255,720.72"
,IN,AR,30334612,1005,100,,Invoice,,,,,,21/12/2018,21/12/2018,0.00,,31.53,,"-1,255,752.25"
,IN,AR,30334616,1005,100,,Invoice,,,,,,21/12/2018,21/12/2018,0.00,,14.58,,"-1,255,766.83"
,IN,AR,30334637,1005,100,,Invoice,,,,,,21/12/2018,21/12/2018,0.00,,16.74,,"-1,255,783.57"
,IN,AR,30334644,1005,100,,Invoice,,,,,,21/12/2018,21/12/2018,0.00,,36.44,,"-1,255,820.01"
,IN,AR,30334657,1005,100,,Invoice,,,,,,21/12/2018,21/12/2018,0.00,,7.63,,"-1,255,827.64"
,IN,AR,30334665,1005,100,,Invoice,,,,,,21/12/2018,21/12/2018,0.00,,4.00,,"-1,255,831.64"
,IN,AR,30334685,1005,100,,Invoice,,,,,,21/12/2018,21/12/2018,0.00,,5.83,,"-1,255,837.47"
,IN,AR,30334705,1005,100,,Invoice,,,,,,21/12/2018,21/12/2018,0.00,,38.32,,"-1,255,875.79"
,IN,AR,30334733,1005,100,,Invoice,,,,,,21/12/2018,21/12/2018,0.00,,29.15,,"-1,255,904.94"
,IN,AR,30334761,1005,100,,Invoice,,,,,,21/12/2018,21/12/2018,0.00,,9.19,,"-1,255,914.13"
,IN,AR,30334820,1005,100,,Invoice,,,,,,21/12/2018,21/12/2018,0.00,,10.93,,"-1,255,925.06"
,IN,AR,30334925,1005,100,,Invoice,,,,,,21/12/2018,21/12/2018,0.00,,8.00,,"-1,255,933.06"
,IN,AR,30334978,1005,100,,Invoice,,,,,,21/12/2018,21/12/2018,0.00,,13.69,,"-1,255,946.75"
,IN,AR,30334988,1005,100,,Invoice,,,,,,21/12/2018,21/12/2018,0.00,,36.02,,"-1,255,982.77"
,IN,AR,30335039,1005,100,,Invoice,,,,,,21/12/2018,21/12/2018,0.00,,7.29,,"-1,255,990.06"
,IN,AR,30335055,1005,100,,Invoice,,,,,,21/12/2018,21/12/2018,0.00,,51.06,,"-1,256,041.12"
,IN,AR,30335056,1005,100,,Invoice,,,,,,21/12/2018,21/12/2018,0.00,,10.21,,"-1,256,051.33"
,IN,AR,30335057,1005,100,,Invoice,,,,,,21/12/2018,21/12/2018,0.00,,10.21,,"-1,256,061.54"
,IN,AR,30335093,1005,100,,Invoice,,,,,,21/12/2018,21/12/2018,0.00,,7.97,,"-1,256,069.51"
,IN,AR,30335159,1005,100,,Invoice,,,,,,21/12/2018,21/12/2018,0.00,,20.76,,"-1,256,090.27"
,IN,AR,30335189,1005,100,,Invoice,,,,,,21/12/2018,21/12/2018,0.00,,4.65,,"-1,256,094.92"
,IN,AR,30335190,1005,100,,Invoice,,,,,,21/12/2018,21/12/2018,0.00,,12.14,,"-1,256,107.06"
,IN,AR,30335247,1005,100,,Invoice,,,,,,21/12/2018,21/12/2018,0.00,,3.28,,"-1,256,110.34"
,IN,AR,30335256,1005,100,,Invoice,,,,,,21/12/2018,21/12/2018,0.00,,54.66,,"-1,256,165.00"
,IN,AR,30335274,1005,100,,Invoice,,,,,,21/12/2018,21/12/2018,0.00,,6.07,,"-1,256,171.07"
,IN,AR,30335330,1005,100,,Invoice,,,,,,21/12/2018,21/12/2018,0.00,,21.86,,"-1,256,192.93"
,IN,AR,30335331,1005,100,,Invoice,,,,,,21/12/2018,21/12/2018,0.00,,10.93,,"-1,256,203.86"
,IN,AR,30335343,1005,100,,Invoice,,,,,,21/12/2018,21/12/2018,0.00,,3.64,,"-1,256,207.50"
,IN,AR,30335346,1005,100,,Invoice,,,,,,21/12/2018,21/12/2018,0.00,,3.64,,"-1,256,211.14"
,IN,AR,30335386,1005,100,,Invoice,,,,,,21/12/2018,21/12/2018,0.00,,10.93,,"-1,256,222.07"
,CS,AR,32011822,1005,100,,Cash sale,,,,,,22/12/2018,22/12/2018,0.00,,14.58,,"-1,256,236.65"
,CS,AR,32011963,1005,100,,Cash sale,,,,,,22/12/2018,22/12/2018,0.00,,3.90,,"-1,256,240.55"
,CS,AR,32012049,1005,100,,Cash sale,,,,,,22/12/2018,22/12/2018,0.00,,7.29,,"-1,256,247.84"
,CS,AR,32012062,1005,100,,Cash sale,,,,,,22/12/2018,22/12/2018,0.00,,3.64,,"-1,256,251.48"
,CS,AR,32012181,1005,100,,Cash sale,,,,,,22/12/2018,22/12/2018,0.00,,3.64,,"-1,256,255.12"
,CS,AR,32012316,1005,100,,Cash sale,,,,,,22/12/2018,22/12/2018,0.00,,8.90,,"-1,256,264.02"
,CS,AR,32012476,1005,100,,Cash sale,,,,,,22/12/2018,22/12/2018,0.00,,9.84,,"-1,256,273.86"
,CS,AR,32012498,1005,100,,Cash sale,,,,,,22/12/2018,22/12/2018,0.00,,7.29,,"-1,256,281.15"
,IN,AR,30333666,1005,100,,Invoice,,,,,,22/12/2018,22/12/2018,0.00,,62.00,,"-1,256,343.15"
,IN,AR,30333675,1005,100,,Invoice,,,,,,22/12/2018,22/12/2018,0.00,,10.93,,"-1,256,354.08"
,IN,AR,30333815,1005,100,,Invoice,,,,,,22/12/2018,22/12/2018,0.00,,7.29,,"-1,256,361.37"
,IN,AR,30333924,1005,100,,Invoice,,,,,,22/12/2018,22/12/2018,0.00,,89.49,,"-1,256,450.86"
,IN,AR,30334282,1005,100,,Invoice,,,,,,22/12/2018,22/12/2018,0.00,,3.64,,"-1,256,454.50"
,IN,AR,30334406,1005,100,,Invoice,,,,,,22/12/2018,22/12/2018,0.00,,1.88,,"-1,256,456.38"
,IN,AR,30334680,1005,100,,Invoice,,,,,,22/12/2018,22/12/2018,0.00,,17.80,,"-1,256,474.18"
,IN,AR,30334786,1005,100,,Invoice,,,,,,22/12/2018,22/12/2018,0.00,,18.22,,"-1,256,492.40"
,IN,AR,30334945,1005,100,,Invoice,,,,,,22/12/2018,22/12/2018,0.00,,14.58,,"-1,256,506.98"
,IN,AR,30334981,1005,100,,Invoice,,,,,,22/12/2018,22/12/2018,0.00,,10.93,,"-1,256,517.91"
,IN,AR,30335080,1005,100,,Invoice,,,,,,22/12/2018,22/12/2018,0.00,,10.93,,"-1,256,528.84"
,IN,AR,30335217,1005,100,,Invoice,,,,,,22/12/2018,22/12/2018,0.00,,7.29,,"-1,256,536.13"
,CN,AR,31019635,1005,100,,Credit Note,,,,,,24/12/2018,24/12/2018,10.93,,0.00,,"-1,256,525.20"
,CS,AR,32011757,1005,100,,Cash sale,,,,,,24/12/2018,24/12/2018,0.00,,5.61,,"-1,256,530.81"
,CS,AR,32011768,1005,100,,Cash sale,,,,,,24/12/2018,24/12/2018,0.00,,7.12,,"-1,256,537.93"
,CS,AR,32011786,1005,100,,Cash sale,,,,,,24/12/2018,24/12/2018,0.00,,3.64,,"-1,256,541.57"
,CS,AR,32011798,1005,100,,Cash sale,,,,,,24/12/2018,24/12/2018,0.00,,7.29,,"-1,256,548.86"
,CS,AR,32011821,1005,100,,Cash sale,,,,,,24/12/2018,24/12/2018,0.00,,60.17,,"-1,256,609.03"
,CS,AR,32011839,1005,100,,Cash sale,,,,,,24/12/2018,24/12/2018,0.00,,7.29,,"-1,256,616.32"
,CS,AR,32011849,1005,100,,Cash sale,,,,,,24/12/2018,24/12/2018,0.00,,14.53,,"-1,256,630.85"
,CS,AR,32011869,1005,100,,Cash sale,,,,,,24/12/2018,24/12/2018,0.00,,5.84,,"-1,256,636.69"
,CS,AR,32011876,1005,100,,Cash sale,,,,,,24/12/2018,24/12/2018,0.00,,7.29,,"-1,256,643.98"
,CS,AR,32011881,1005,100,,Cash sale,,,,,,24/12/2018,24/12/2018,0.00,,14.58,,"-1,256,658.56"
,CS,AR,32011885,1005,100,,Cash sale,,,,,,24/12/2018,24/12/2018,0.00,,3.64,,"-1,256,662.20"
,CS,AR,32011904,1005,100,,Cash sale,,,,,,24/12/2018,24/12/2018,0.00,,3.64,,"-1,256,665.84"
,CS,AR,32011926,1005,100,,Cash sale,,,,,,24/12/2018,24/12/2018,0.00,,7.29,,"-1,256,673.13"
,CS,AR,32011940,1005,100,,Cash sale,,,,,,24/12/2018,24/12/2018,0.00,,7.63,,"-1,256,680.76"
,CS,AR,32011950,1005,100,,Cash sale,,,,,,24/12/2018,24/12/2018,0.00,,5.68,,"-1,256,686.44"
,CS,AR,32011984,1005,100,,Cash sale,,,,,,24/12/2018,24/12/2018,0.00,,10.93,,"-1,256,697.37"
,CS,AR,32012016,1005,100,,Cash sale,,,,,,24/12/2018,24/12/2018,0.00,,14.62,,"-1,256,711.99"
,CS,AR,32012022,1005,100,,Cash sale,,,,,,24/12/2018,24/12/2018,0.00,,6.02,,"-1,256,718.01"
,CS,AR,32012034,1005,100,,Cash sale,,,,,,24/12/2018,24/12/2018,0.00,,18.05,,"-1,256,736.06"
,CS,AR,32012055,1005,100,,Cash sale,,,,,,24/12/2018,24/12/2018,0.00,,10.93,,"-1,256,746.99"
,CS,AR,32012080,1005,100,,Cash sale,,,,,,24/12/2018,24/12/2018,0.00,,5.08,,"-1,256,752.07"
,CS,AR,32012104,1005,100,,Cash sale,,,,,,24/12/2018,24/12/2018,0.00,,5.85,,"-1,256,757.92"
,CS,AR,32012115,1005,100,,Cash sale,,,,,,24/12/2018,24/12/2018,0.00,,3.64,,"-1,256,761.56"
,CS,AR,32012144,1005,100,,Cash sale,,,,,,24/12/2018,24/12/2018,0.00,,12.17,,"-1,256,773.73"
,CS,AR,32012189,1005,100,,Cash sale,,,,,,24/12/2018,24/12/2018,0.00,,12.71,,"-1,256,786.44"
,CS,AR,32012196,1005,100,,Cash sale,,,,,,24/12/2018,24/12/2018,0.00,,6.53,,"-1,256,792.97"
,CS,AR,32012219,1005,100,,Cash sale,,,,,,24/12/2018,24/12/2018,0.00,,26.00,,"-1,256,818.97"
,CS,AR,32012235,1005,100,,Cash sale,,,,,,24/12/2018,24/12/2018,0.00,,6.56,,"-1,256,825.53"
,CS,AR,32012257,1005,100,,Cash sale,,,,,,24/12/2018,24/12/2018,0.00,,9.15,,"-1,256,834.68"
,CS,AR,32012260,1005,100,,Cash sale,,,,,,24/12/2018,24/12/2018,0.00,,10.93,,"-1,256,845.61"
,CS,AR,32012286,1005,100,,Cash sale,,,,,,24/12/2018,24/12/2018,0.00,,21.25,,"-1,256,866.86"
,CS,AR,32012302,1005,100,,Cash sale,,,,,,24/12/2018,24/12/2018,0.00,,14.58,,"-1,256,881.44"
,CS,AR,32012322,1005,100,,Cash sale,,,,,,24/12/2018,24/12/2018,0.00,,3.64,,"-1,256,885.08"
,CS,AR,32012331,1005,100,,Cash sale,,,,,,24/12/2018,24/12/2018,0.00,,3.64,,"-1,256,888.72"
,CS,AR,32012338,1005,100,,Cash sale,,,,,,24/12/2018,24/12/2018,0.00,,7.29,,"-1,256,896.01"
,CS,AR,32012367,1005,100,,Cash sale,,,,,,24/12/2018,24/12/2018,0.00,,3.64,,"-1,256,899.65"
,CS,AR,32012451,1005,100,,Cash sale,,,,,,24/12/2018,24/12/2018,0.00,,7.29,,"-1,256,906.94"
,CS,AR,32012487,1005,100,,Cash sale,,,,,,24/12/2018,24/12/2018,0.00,,14.58,,"-1,256,921.52"
,IN,AR,30333530,1005,100,,Invoice,,,,,,24/12/2018,24/12/2018,0.00,,32.63,,"-1,256,954.15"
,IN,AR,30333580,1005,100,,Invoice,,,,,,24/12/2018,24/12/2018,0.00,,4.05,,"-1,256,958.20"
,IN,AR,30333581,1005,100,,Invoice,,,,,,24/12/2018,24/12/2018,0.00,,6.08,,"-1,256,964.28"
,IN,AR,30333582,1005,100,,Invoice,,,,,,24/12/2018,24/12/2018,0.00,,16.20,,"-1,256,980.48"
,IN,AR,30333583,1005,100,,Invoice,,,,,,24/12/2018,24/12/2018,0.00,,14.18,,"-1,256,994.66"
,IN,AR,30333584,1005,100,,Invoice,,,,,,24/12/2018,24/12/2018,0.00,,4.05,,"-1,256,998.71"
,IN,AR,30333585,1005,100,,Invoice,,,,,,24/12/2018,24/12/2018,0.00,,8.10,,"-1,257,006.81"
,IN,AR,30333620,1005,100,,Invoice,,,,,,24/12/2018,24/12/2018,0.00,,7.00,,"-1,257,013.81"
,IN,AR,30333667,1005,100,,Invoice,,,,,,24/12/2018,24/12/2018,0.00,,46.00,,"-1,257,059.81"
,IN,AR,30333672,1005,100,,Invoice,,,,,,24/12/2018,24/12/2018,0.00,,11.02,,"-1,257,070.83"
,IN,AR,30333685,1005,100,,Invoice,,,,,,24/12/2018,24/12/2018,0.00,,40.00,,"-1,257,110.83"
,IN,AR,30333696,1005,100,,Invoice,,,,,,24/12/2018,24/12/2018,0.00,,48.78,,"-1,257,159.61"
,IN,AR,30333705,1005,100,,Invoice,,,,,,24/12/2018,24/12/2018,0.00,,3.01,,"-1,257,162.62"
,IN,AR,30333713,1005,100,,Invoice,,,,,,24/12/2018,24/12/2018,0.00,,10.93,,"-1,257,173.55"
,IN,AR,30333742,1005,100,,Invoice,,,,,,24/12/2018,24/12/2018,0.00,,22.88,,"-1,257,196.43"
,IN,AR,30333756,1005,100,,Invoice,,,,,,24/12/2018,24/12/2018,0.00,,11.69,,"-1,257,208.12"
,IN,AR,30333823,1005,100,,Invoice,,,,,,24/12/2018,24/12/2018,0.00,,16.00,,"-1,257,224.12"
,IN,AR,30333832,1005,100,,Invoice,,,,,,24/12/2018,24/12/2018,0.00,,27.47,,"-1,257,251.59"
,IN,AR,30333884,1005,100,,Invoice,,,,,,24/12/2018,24/12/2018,0.00,,15.51,,"-1,257,267.10"
,IN,AR,30333899,1005,100,,Invoice,,,,,,24/12/2018,24/12/2018,0.00,,18.37,,"-1,257,285.47"
,IN,AR,30333925,1005,100,,Invoice,,,,,,24/12/2018,24/12/2018,0.00,,30.51,,"-1,257,315.98"
,IN,AR,30333936,1005,100,,Invoice,,,,,,24/12/2018,24/12/2018,0.00,,10.93,,"-1,257,326.91"
,IN,AR,30333942,1005,100,,Invoice,,,,,,24/12/2018,24/12/2018,0.00,,29.15,,"-1,257,356.06"
,IN,AR,30333949,1005,100,,Invoice,,,,,,24/12/2018,24/12/2018,0.00,,12.92,,"-1,257,368.98"
,IN,AR,30333967,1005,100,,Invoice,,,,,,24/12/2018,24/12/2018,0.00,,7.29,,"-1,257,376.27"
,IN,AR,30333998,1005,100,,Invoice,,,,,,24/12/2018,24/12/2018,0.00,,63.58,,"-1,257,439.85"
,IN,AR,30334026,1005,100,,Invoice,,,,,,24/12/2018,24/12/2018,0.00,,23.90,,"-1,257,463.75"
,IN,AR,30334027,1005,100,,Invoice,,,,,,24/12/2018,24/12/2018,0.00,,2.39,,"-1,257,466.14"
,IN,AR,30334034,1005,100,,Invoice,,,,,,24/12/2018,24/12/2018,0.00,,25.76,,"-1,257,491.90"
,IN,AR,30334048,1005,100,,Invoice,,,,,,24/12/2018,24/12/2018,0.00,,7.29,,"-1,257,499.19"
,IN,AR,30334063,1005,100,,Invoice,,,,,,24/12/2018,24/12/2018,0.00,,7.29,,"-1,257,506.48"
,IN,AR,30334076,1005,100,,Invoice,,,,,,24/12/2018,24/12/2018,0.00,,2.54,,"-1,257,509.02"
,IN,AR,30334130,1005,100,,Invoice,,,,,,24/12/2018,24/12/2018,0.00,,22.88,,"-1,257,531.90"
,IN,AR,30334155,1005,100,,Invoice,,,,,,24/12/2018,24/12/2018,0.00,,7.29,,"-1,257,539.19"
,IN,AR,30334158,1005,100,,Invoice,,,,,,24/12/2018,24/12/2018,0.00,,22.88,,"-1,257,562.07"
,IN,AR,30334169,1005,100,,Invoice,,,,,,24/12/2018,24/12/2018,0.00,,6.10,,"-1,257,568.17"
,IN,AR,30334204,1005,100,,Invoice,,,,,,24/12/2018,24/12/2018,0.00,,10.93,,"-1,257,579.10"
,IN,AR,30334217,1005,100,,Invoice,,,,,,24/12/2018,24/12/2018,0.00,,6.43,,"-1,257,585.53"
,IN,AR,30334223,1005,100,,Invoice,,,,,,24/12/2018,24/12/2018,0.00,,3.64,,"-1,257,589.17"
,IN,AR,30334227,1005,100,,Invoice,,,,,,24/12/2018,24/12/2018,0.00,,2.54,,"-1,257,591.71"
,IN,AR,30334228,1005,100,,Invoice,,,,,,24/12/2018,24/12/2018,0.00,,3.64,,"-1,257,595.35"
,IN,AR,30334233,1005,100,,Invoice,,,,,,24/12/2018,24/12/2018,0.00,,7.29,,"-1,257,602.64"
,IN,AR,30334239,1005,100,,Invoice,,,,,,24/12/2018,24/12/2018,0.00,,16.08,,"-1,257,618.72"
,IN,AR,30334248,1005,100,,Invoice,,,,,,24/12/2018,24/12/2018,0.00,,16.83,,"-1,257,635.55"
,IN,AR,30334280,1005,100,,Invoice,,,,,,24/12/2018,24/12/2018,0.00,,7.75,,"-1,257,643.30"
,IN,AR,30334298,1005,100,,Invoice,,,,,,24/12/2018,24/12/2018,0.00,,82.98,,"-1,257,726.28"
,IN,AR,30334348,1005,100,,Invoice,,,,,,24/12/2018,24/12/2018,0.00,,2.92,,"-1,257,729.20"
,IN,AR,30334356,1005,100,,Invoice,,,,,,24/12/2018,24/12/2018,0.00,,36.12,,"-1,257,765.32"
,IN,AR,30334395,1005,100,,Invoice,,,,,,24/12/2018,24/12/2018,0.00,,18.22,,"-1,257,783.54"
,IN,AR,30334399,1005,100,,Invoice,,,,,,24/12/2018,24/12/2018,0.00,,21.44,,"-1,257,804.98"
,IN,AR,30334411,1005,100,,Invoice,,,,,,24/12/2018,24/12/2018,0.00,,21.44,,"-1,257,826.42"
,IN,AR,30334427,1005,100,,Invoice,,,,,,24/12/2018,24/12/2018,0.00,,1.76,,"-1,257,828.18"
,IN,AR,30334442,1005,100,,Invoice,,,,,,24/12/2018,24/12/2018,0.00,,10.68,,"-1,257,838.86"
,IN,AR,30334450,1005,100,,Invoice,,,,,,24/12/2018,24/12/2018,0.00,,2.58,,"-1,257,841.44"
,IN,AR,30334453,1005,100,,Invoice,,,,,,24/12/2018,24/12/2018,0.00,,29.15,,"-1,257,870.59"
,IN,AR,30334489,1005,100,,Invoice,,,,,,24/12/2018,24/12/2018,0.00,,4.29,,"-1,257,874.88"
,IN,AR,30334542,1005,100,,Invoice,,,,,,24/12/2018,24/12/2018,0.00,,3.98,,"-1,257,878.86"
,IN,AR,30334552,1005,100,,Invoice,,,,,,24/12/2018,24/12/2018,0.00,,8.52,,"-1,257,887.38"
,IN,AR,30334582,1005,100,,Invoice,,,,,,24/12/2018,24/12/2018,0.00,,3.64,,"-1,257,891.02"
,IN,AR,30334600,1005,100,,Invoice,,,,,,24/12/2018,24/12/2018,0.00,,165.81,,"-1,258,056.83"
,IN,AR,30334666,1005,100,,Invoice,,,,,,24/12/2018,24/12/2018,0.00,,12.00,,"-1,258,068.83"
,IN,AR,30334671,1005,100,,Invoice,,,,,,24/12/2018,24/12/2018,0.00,,8.00,,"-1,258,076.83"
,IN,AR,30334679,1005,100,,Invoice,,,,,,24/12/2018,24/12/2018,0.00,,12.00,,"-1,258,088.83"
,IN,AR,30334698,1005,100,,Invoice,,,,,,24/12/2018,24/12/2018,0.00,,34.69,,"-1,258,123.52"
,IN,AR,30334718,1005,100,,Invoice,,,,,,24/12/2018,24/12/2018,0.00,,21.03,,"-1,258,144.55"
,IN,AR,30334735,1005,100,,Invoice,,,,,,24/12/2018,24/12/2018,0.00,,174.92,,"-1,258,319.47"
,IN,AR,30334739,1005,100,,Invoice,,,,,,24/12/2018,24/12/2018,0.00,,21.75,,"-1,258,341.22"
,IN,AR,30334758,1005,100,,Invoice,,,,,,24/12/2018,24/12/2018,0.00,,16.83,,"-1,258,358.05"
,IN,AR,30334762,1005,100,,Invoice,,,,,,24/12/2018,24/12/2018,0.00,,75.21,,"-1,258,433.26"
,IN,AR,30334771,1005,100,,Invoice,,,,,,24/12/2018,24/12/2018,0.00,,11.19,,"-1,258,444.45"
,IN,AR,30334780,1005,100,,Invoice,,,,,,24/12/2018,24/12/2018,0.00,,156.00,,"-1,258,600.45"
,IN,AR,30334860,1005,100,,Invoice,,,,,,24/12/2018,24/12/2018,0.00,,4.78,,"-1,258,605.23"
,IN,AR,30334861,1005,100,,Invoice,,,,,,24/12/2018,24/12/2018,0.00,,3.19,,"-1,258,608.42"
,IN,AR,30334875,1005,100,,Invoice,,,,,,24/12/2018,24/12/2018,0.00,,23.73,,"-1,258,632.15"
,IN,AR,30334876,1005,100,,Invoice,,,,,,24/12/2018,24/12/2018,0.00,,42.71,,"-1,258,674.86"
,IN,AR,30334877,1005,100,,Invoice,,,,,,24/12/2018,24/12/2018,0.00,,21.36,,"-1,258,696.22"
,IN,AR,30334917,1005,100,,Invoice,,,,,,24/12/2018,24/12/2018,0.00,,14.24,,"-1,258,710.46"
,IN,AR,30334926,1005,100,,Invoice,,,,,,24/12/2018,24/12/2018,0.00,,12.00,,"-1,258,722.46"
,IN,AR,30334933,1005,100,,Invoice,,,,,,24/12/2018,24/12/2018,0.00,,3.76,,"-1,258,726.22"
,IN,AR,30334950,1005,100,,Invoice,,,,,,24/12/2018,24/12/2018,0.00,,2.97,,"-1,258,729.19"
,IN,AR,30334979,1005,100,,Invoice,,,,,,24/12/2018,24/12/2018,0.00,,10.95,,"-1,258,740.14"
,IN,AR,30335047,1005,100,,Invoice,,,,,,24/12/2018,24/12/2018,0.00,,10.47,,"-1,258,750.61"
,IN,AR,30335094,1005,100,,Invoice,,,,,,24/12/2018,24/12/2018,0.00,,3.98,,"-1,258,754.59"
,IN,AR,30335100,1005,100,,Invoice,,,,,,24/12/2018,24/12/2018,0.00,,40.93,,"-1,258,795.52"
,IN,AR,30335102,1005,100,,Invoice,,,,,,24/12/2018,24/12/2018,0.00,,14.58,,"-1,258,810.10"
,IN,AR,30335160,1005,100,,Invoice,,,,,,24/12/2018,24/12/2018,0.00,,2.08,,"-1,258,812.18"
,IN,AR,30335236,1005,100,,Invoice,,,,,,24/12/2018,24/12/2018,0.00,,12.62,,"-1,258,824.80"
,IN,AR,30335258,1005,100,,Invoice,,,,,,24/12/2018,24/12/2018,0.00,,72.88,,"-1,258,897.68"
,IN,AR,30335259,1005,100,,Invoice,,,,,,24/12/2018,24/12/2018,0.00,,8.90,,"-1,258,906.58"
,IN,AR,30335263,1005,100,,Invoice,,,,,,24/12/2018,24/12/2018,0.00,,43.82,,"-1,258,950.40"
,IN,AR,30335265,1005,100,,Invoice,,,,,,24/12/2018,24/12/2018,0.00,,7.29,,"-1,258,957.69"
,IN,AR,30335307,1005,100,,Invoice,,,,,,24/12/2018,24/12/2018,0.00,,8.21,,"-1,258,965.90"
,CS,AR,32012593,1005,100,,Cash sale,,,,,,24/12/2018,24/12/2018,0.00,,5.17,,"-1,258,971.07"
,CS,AR,32012483,1005,100,,Cash sale,,,,,,25/12/2018,25/12/2018,0.00,,54.66,,"-1,259,025.73"
,CN,AR,31019792,1005,100,,Credit Note,,,,,,26/12/2018,26/12/2018,10.51,,0.00,,"-1,259,015.22"
,CN,AR,31019795,1005,100,,Credit Note,,,,,,26/12/2018,26/12/2018,29.15,,0.00,,"-1,258,986.07"
,CS,AR,32012508,1005,100,,Cash sale,,,,,,26/12/2018,26/12/2018,0.00,,5.61,,"-1,258,991.68"
,CS,AR,32012510,1005,100,,Cash sale,,,,,,26/12/2018,26/12/2018,0.00,,35.12,,"-1,259,026.80"
,CS,AR,32012516,1005,100,,Cash sale,,,,,,26/12/2018,26/12/2018,0.00,,3.64,,"-1,259,030.44"
,CS,AR,32012520,1005,100,,Cash sale,,,,,,26/12/2018,26/12/2018,0.00,,3.64,,"-1,259,034.08"
,CS,AR,32012522,1005,100,,Cash sale,,,,,,26/12/2018,26/12/2018,0.00,,16.91,,"-1,259,050.99"
,CS,AR,32012546,1005,100,,Cash sale,,,,,,26/12/2018,26/12/2018,0.00,,7.29,,"-1,259,058.28"
,CS,AR,32012548,1005,100,,Cash sale,,,,,,26/12/2018,26/12/2018,0.00,,10.93,,"-1,259,069.21"
,CS,AR,32012551,1005,100,,Cash sale,,,,,,26/12/2018,26/12/2018,0.00,,7.17,,"-1,259,076.38"
,CS,AR,32012552,1005,100,,Cash sale,,,,,,26/12/2018,26/12/2018,0.00,,3.64,,"-1,259,080.02"
,CS,AR,32012556,1005,100,,Cash sale,,,,,,26/12/2018,26/12/2018,0.00,,2.58,,"-1,259,082.60"
,CS,AR,32012562,1005,100,,Cash sale,,,,,,26/12/2018,26/12/2018,0.00,,7.29,,"-1,259,089.89"
,CS,AR,32012563,1005,100,,Cash sale,,,,,,26/12/2018,26/12/2018,0.00,,15.51,,"-1,259,105.40"
,CS,AR,32012566,1005,100,,Cash sale,,,,,,26/12/2018,26/12/2018,0.00,,10.93,,"-1,259,116.33"
,CS,AR,32012570,1005,100,,Cash sale,,,,,,26/12/2018,26/12/2018,0.00,,4.29,,"-1,259,120.62"
,CS,AR,32012573,1005,100,,Cash sale,,,,,,26/12/2018,26/12/2018,0.00,,10.93,,"-1,259,131.55"
,CS,AR,32012598,1005,100,,Cash sale,,,,,,26/12/2018,26/12/2018,0.00,,14.58,,"-1,259,146.13"
,CS,AR,32012601,1005,100,,Cash sale,,,,,,26/12/2018,26/12/2018,0.00,,7.29,,"-1,259,153.42"
,CS,AR,32012602,1005,100,,Cash sale,,,,,,26/12/2018,26/12/2018,0.00,,10.93,,"-1,259,164.35"
,CS,AR,32012616,1005,100,,Cash sale,,,,,,26/12/2018,26/12/2018,0.00,,15.04,,"-1,259,179.39"
,CS,AR,32012618,1005,100,,Cash sale,,,,,,26/12/2018,26/12/2018,0.00,,29.15,,"-1,259,208.54"
,CS,AR,32012621,1005,100,,Cash sale,,,,,,26/12/2018,26/12/2018,0.00,,29.15,,"-1,259,237.69"
,CS,AR,32012622,1005,100,,Cash sale,,,,,,26/12/2018,26/12/2018,0.00,,12.71,,"-1,259,250.40"
,CS,AR,32012625,1005,100,,Cash sale,,,,,,26/12/2018,26/12/2018,0.00,,3.64,,"-1,259,254.04"
,CS,AR,32012628,1005,100,,Cash sale,,,,,,26/12/2018,26/12/2018,0.00,,10.93,,"-1,259,264.97"
,CS,AR,32012632,1005,100,,Cash sale,,,,,,26/12/2018,26/12/2018,0.00,,11.44,,"-1,259,276.41"
,CS,AR,32012636,1005,100,,Cash sale,,,,,,26/12/2018,26/12/2018,0.00,,9.10,,"-1,259,285.51"
,CS,AR,32012637,1005,100,,Cash sale,,,,,,26/12/2018,26/12/2018,0.00,,7.29,,"-1,259,292.80"
,CS,AR,32012638,1005,100,,Cash sale,,,,,,26/12/2018,26/12/2018,0.00,,5.50,,"-1,259,298.30"
,CS,AR,32012642,1005,100,,Cash sale,,,,,,26/12/2018,26/12/2018,0.00,,7.29,,"-1,259,305.59"
,CS,AR,32012649,1005,100,,Cash sale,,,,,,26/12/2018,26/12/2018,0.00,,7.29,,"-1,259,312.88"
,CS,AR,32012658,1005,100,,Cash sale,,,,,,26/12/2018,26/12/2018,0.00,,10.99,,"-1,259,323.87"
,CS,AR,32012681,1005,100,,Cash sale,,,,,,26/12/2018,26/12/2018,0.00,,11.65,,"-1,259,335.52"
,CS,AR,32012690,1005,100,,Cash sale,,,,,,26/12/2018,26/12/2018,0.00,,14.58,,"-1,259,350.10"
,CS,AR,32012694,1005,100,,Cash sale,,,,,,26/12/2018,26/12/2018,0.00,,7.29,,"-1,259,357.39"
,CS,AR,32012697,1005,100,,Cash sale,,,,,,26/12/2018,26/12/2018,0.00,,7.29,,"-1,259,364.68"
,IN,AR,30335388,1005,100,,Invoice,,,,,,26/12/2018,26/12/2018,0.00,,32.63,,"-1,259,397.31"
,IN,AR,30335396,1005,100,,Invoice,,,,,,26/12/2018,26/12/2018,0.00,,14.58,,"-1,259,411.89"
,IN,AR,30335409,1005,100,,Invoice,,,,,,26/12/2018,26/12/2018,0.00,,13.94,,"-1,259,425.83"
,IN,AR,30335420,1005,100,,Invoice,,,,,,26/12/2018,26/12/2018,0.00,,5.97,,"-1,259,431.80"
,IN,AR,30335422,1005,100,,Invoice,,,,,,26/12/2018,26/12/2018,0.00,,44.00,,"-1,259,475.80"
,IN,AR,30335434,1005,100,,Invoice,,,,,,26/12/2018,26/12/2018,0.00,,10.93,,"-1,259,486.73"
,IN,AR,30335435,1005,100,,Invoice,,,,,,26/12/2018,26/12/2018,0.00,,46.00,,"-1,259,532.73"
,IN,AR,30335444,1005,100,,Invoice,,,,,,26/12/2018,26/12/2018,0.00,,24.00,,"-1,259,556.73"
,IN,AR,30335450,1005,100,,Invoice,,,,,,26/12/2018,26/12/2018,0.00,,8.00,,"-1,259,564.73"
,IN,AR,30335459,1005,100,,Invoice,,,,,,26/12/2018,26/12/2018,0.00,,14.58,,"-1,259,579.31"
,IN,AR,30335466,1005,100,,Invoice,,,,,,26/12/2018,26/12/2018,0.00,,12.88,,"-1,259,592.19"
,IN,AR,30335468,1005,100,,Invoice,,,,,,26/12/2018,26/12/2018,0.00,,14.58,,"-1,259,606.77"
,IN,AR,30335477,1005,100,,Invoice,,,,,,26/12/2018,26/12/2018,0.00,,7.29,,"-1,259,614.06"
,IN,AR,30335481,1005,100,,Invoice,,,,,,26/12/2018,26/12/2018,0.00,,45.76,,"-1,259,659.82"
,IN,AR,30335487,1005,100,,Invoice,,,,,,26/12/2018,26/12/2018,0.00,,52.88,,"-1,259,712.70"
,IN,AR,30335497,1005,100,,Invoice,,,,,,26/12/2018,26/12/2018,0.00,,10.93,,"-1,259,723.63"
,IN,AR,30335499,1005,100,,Invoice,,,,,,26/12/2018,26/12/2018,0.00,,7.17,,"-1,259,730.80"
,IN,AR,30335502,1005,100,,Invoice,,,,,,26/12/2018,26/12/2018,0.00,,49.22,,"-1,259,780.02"
,IN,AR,30335506,1005,100,,Invoice,,,,,,26/12/2018,26/12/2018,0.00,,53.39,,"-1,259,833.41"
,IN,AR,30335519,1005,100,,Invoice,,,,,,26/12/2018,26/12/2018,0.00,,144.04,,"-1,259,977.45"
,IN,AR,30335543,1005,100,,Invoice,,,,,,26/12/2018,26/12/2018,0.00,,2.54,,"-1,259,979.99"
,IN,AR,30335544,1005,100,,Invoice,,,,,,26/12/2018,26/12/2018,0.00,,10.17,,"-1,259,990.16"
,IN,AR,30335551,1005,100,,Invoice,,,,,,26/12/2018,26/12/2018,0.00,,1.59,,"-1,259,991.75"
,IN,AR,30335603,1005,100,,Invoice,,,,,,26/12/2018,26/12/2018,0.00,,10.93,,"-1,260,002.68"
,IN,AR,30335606,1005,100,,Invoice,,,,,,26/12/2018,26/12/2018,0.00,,7.75,,"-1,260,010.43"
,IN,AR,30335610,1005,100,,Invoice,,,,,,26/12/2018,26/12/2018,0.00,,5.61,,"-1,260,016.04"
,IN,AR,30335613,1005,100,,Invoice,,,,,,26/12/2018,26/12/2018,0.00,,10.51,,"-1,260,026.55"
,IN,AR,30335625,1005,100,,Invoice,,,,,,26/12/2018,26/12/2018,0.00,,25.17,,"-1,260,051.72"
,IN,AR,30335638,1005,100,,Invoice,,,,,,26/12/2018,26/12/2018,0.00,,30.08,,"-1,260,081.80"
,IN,AR,30335639,1005,100,,Invoice,,,,,,26/12/2018,26/12/2018,0.00,,29.15,,"-1,260,110.95"
,IN,AR,30335642,1005,100,,Invoice,,,,,,26/12/2018,26/12/2018,0.00,,41.53,,"-1,260,152.48"
,IN,AR,30335653,1005,100,,Invoice,,,,,,26/12/2018,26/12/2018,0.00,,9.03,,"-1,260,161.51"
,IN,AR,30335660,1005,100,,Invoice,,,,,,26/12/2018,26/12/2018,0.00,,6.00,,"-1,260,167.51"
,IN,AR,30335681,1005,100,,Invoice,,,,,,26/12/2018,26/12/2018,0.00,,3.98,,"-1,260,171.49"
,IN,AR,30335689,1005,100,,Invoice,,,,,,26/12/2018,26/12/2018,0.00,,30.07,,"-1,260,201.56"
,IN,AR,30335693,1005,100,,Invoice,,,,,,26/12/2018,26/12/2018,0.00,,14.58,,"-1,260,216.14"
,IN,AR,30335696,1005,100,,Invoice,,,,,,26/12/2018,26/12/2018,0.00,,17.29,,"-1,260,233.43"
,IN,AR,30335700,1005,100,,Invoice,,,,,,26/12/2018,26/12/2018,0.00,,23.64,,"-1,260,257.07"
,IN,AR,30335703,1005,100,,Invoice,,,,,,26/12/2018,26/12/2018,0.00,,5.09,,"-1,260,262.16"
,IN,AR,30335704,1005,100,,Invoice,,,,,,26/12/2018,26/12/2018,0.00,,9.84,,"-1,260,272.00"
,IN,AR,30335718,1005,100,,Invoice,,,,,,26/12/2018,26/12/2018,0.00,,6.03,,"-1,260,278.03"
,IN,AR,30335724,1005,100,,Invoice,,,,,,26/12/2018,26/12/2018,0.00,,16.82,,"-1,260,294.85"
,IN,AR,30335727,1005,100,,Invoice,,,,,,26/12/2018,26/12/2018,0.00,,9.03,,"-1,260,303.88"
,IN,AR,30335737,1005,100,,Invoice,,,,,,26/12/2018,26/12/2018,0.00,,3.21,,"-1,260,307.09"
,IN,AR,30335739,1005,100,,Invoice,,,,,,26/12/2018,26/12/2018,0.00,,10.00,,"-1,260,317.09"
,IN,AR,30335743,1005,100,,Invoice,,,,,,26/12/2018,26/12/2018,0.00,,3.19,,"-1,260,320.28"
,IN,AR,30335788,1005,100,,Invoice,,,,,,26/12/2018,26/12/2018,0.00,,5.26,,"-1,260,325.54"
,IN,AR,30335796,1005,100,,Invoice,,,,,,26/12/2018,26/12/2018,0.00,,5.64,,"-1,260,331.18"
,IN,AR,30335798,1005,100,,Invoice,,,,,,26/12/2018,26/12/2018,0.00,,10.93,,"-1,260,342.11"
,IN,AR,30335804,1005,100,,Invoice,,,,,,26/12/2018,26/12/2018,0.00,,2.62,,"-1,260,344.73"
,IN,AR,30335820,1005,100,,Invoice,,,,,,26/12/2018,26/12/2018,0.00,,10.38,,"-1,260,355.11"
,IN,AR,30335828,1005,100,,Invoice,,,,,,26/12/2018,26/12/2018,0.00,,2.54,,"-1,260,357.65"
,IN,AR,30335830,1005,100,,Invoice,,,,,,26/12/2018,26/12/2018,0.00,,18.20,,"-1,260,375.85"
,IN,AR,30335842,1005,100,,Invoice,,,,,,26/12/2018,26/12/2018,0.00,,3.64,,"-1,260,379.49"
,IN,AR,30335843,1005,100,,Invoice,,,,,,26/12/2018,26/12/2018,0.00,,27.97,,"-1,260,407.46"
,IN,AR,30335844,1005,100,,Invoice,,,,,,26/12/2018,26/12/2018,0.00,,69.78,,"-1,260,477.24"
,IN,AR,30335848,1005,100,,Invoice,,,,,,26/12/2018,26/12/2018,0.00,,12.14,,"-1,260,489.38"
,IN,AR,30335853,1005,100,,Invoice,,,,,,26/12/2018,26/12/2018,0.00,,54.66,,"-1,260,544.04"
,IN,AR,30335854,1005,100,,Invoice,,,,,,26/12/2018,26/12/2018,0.00,,14.37,,"-1,260,558.41"
,CN,AR,31019806,1005,100,,Credit Note,,,,,,27/12/2018,27/12/2018,14.58,,0.00,,"-1,260,543.83"
,CS,AR,32012507,1005,100,,Cash sale,,,,,,27/12/2018,27/12/2018,0.00,,21.06,,"-1,260,564.89"
,CS,AR,32012509,1005,100,,Cash sale,,,,,,27/12/2018,27/12/2018,0.00,,26.10,,"-1,260,590.99"
,CS,AR,32012515,1005,100,,Cash sale,,,,,,27/12/2018,27/12/2018,0.00,,7.75,,"-1,260,598.74"
,CS,AR,32012519,1005,100,,Cash sale,,,,,,27/12/2018,27/12/2018,0.00,,3.64,,"-1,260,602.38"
,CS,AR,32012528,1005,100,,Cash sale,,,,,,27/12/2018,27/12/2018,0.00,,3.64,,"-1,260,606.02"
,CS,AR,32012533,1005,100,,Cash sale,,,,,,27/12/2018,27/12/2018,0.00,,7.78,,"-1,260,613.80"
,CS,AR,32012537,1005,100,,Cash sale,,,,,,27/12/2018,27/12/2018,0.00,,7.29,,"-1,260,621.09"
,CS,AR,32012545,1005,100,,Cash sale,,,,,,27/12/2018,27/12/2018,0.00,,7.29,,"-1,260,628.38"
,CS,AR,32012569,1005,100,,Cash sale,,,,,,27/12/2018,27/12/2018,0.00,,21.06,,"-1,260,649.44"
,CS,AR,32012574,1005,100,,Cash sale,,,,,,27/12/2018,27/12/2018,0.00,,7.29,,"-1,260,656.73"
,CS,AR,32012577,1005,100,,Cash sale,,,,,,27/12/2018,27/12/2018,0.00,,17.54,,"-1,260,674.27"
,CS,AR,32012578,1005,100,,Cash sale,,,,,,27/12/2018,27/12/2018,0.00,,8.77,,"-1,260,683.04"
,CS,AR,32012584,1005,100,,Cash sale,,,,,,27/12/2018,27/12/2018,0.00,,3.43,,"-1,260,686.47"
,CS,AR,32012587,1005,100,,Cash sale,,,,,,27/12/2018,27/12/2018,0.00,,10.00,,"-1,260,696.47"
,CS,AR,32012589,1005,100,,Cash sale,,,,,,27/12/2018,27/12/2018,0.00,,19.28,,"-1,260,715.75"
,CS,AR,32012595,1005,100,,Cash sale,,,,,,27/12/2018,27/12/2018,0.00,,22.37,,"-1,260,738.12"
,CS,AR,32012600,1005,100,,Cash sale,,,,,,27/12/2018,27/12/2018,0.00,,6.44,,"-1,260,744.56"
,CS,AR,32012606,1005,100,,Cash sale,,,,,,27/12/2018,27/12/2018,0.00,,7.29,,"-1,260,751.85"
,CS,AR,32012608,1005,100,,Cash sale,,,,,,27/12/2018,27/12/2018,0.00,,10.93,,"-1,260,762.78"
,CS,AR,32012611,1005,100,,Cash sale,,,,,,27/12/2018,27/12/2018,0.00,,7.29,,"-1,260,770.07"
,CS,AR,32012613,1005,100,,Cash sale,,,,,,27/12/2018,27/12/2018,0.00,,7.29,,"-1,260,777.36"
,CS,AR,32012623,1005,100,,Cash sale,,,,,,27/12/2018,27/12/2018,0.00,,12.00,,"-1,260,789.36"
,CS,AR,32012627,1005,100,,Cash sale,,,,,,27/12/2018,27/12/2018,0.00,,5.93,,"-1,260,795.29"
,CS,AR,32012630,1005,100,,Cash sale,,,,,,27/12/2018,27/12/2018,0.00,,8.20,,"-1,260,803.49"
,CS,AR,32012641,1005,100,,Cash sale,,,,,,27/12/2018,27/12/2018,0.00,,5.47,,"-1,260,808.96"
,CS,AR,32012654,1005,100,,Cash sale,,,,,,27/12/2018,27/12/2018,0.00,,13.69,,"-1,260,822.65"
,CS,AR,32012657,1005,100,,Cash sale,,,,,,27/12/2018,27/12/2018,0.00,,6.56,,"-1,260,829.21"
,CS,AR,32012685,1005,100,,Cash sale,,,,,,27/12/2018,27/12/2018,0.00,,10.93,,"-1,260,840.14"
,CS,AR,32012687,1005,100,,Cash sale,,,,,,27/12/2018,27/12/2018,0.00,,3.64,,"-1,260,843.78"
,CS,AR,32012688,1005,100,,Cash sale,,,,,,27/12/2018,27/12/2018,0.00,,3.64,,"-1,260,847.42"
,CS,AR,32012689,1005,100,,Cash sale,,,,,,27/12/2018,27/12/2018,0.00,,14.58,,"-1,260,862.00"
,CS,AR,32012691,1005,100,,Cash sale,,,,,,27/12/2018,27/12/2018,0.00,,3.64,,"-1,260,865.64"
,CS,AR,32012695,1005,100,,Cash sale,,,,,,27/12/2018,27/12/2018,0.00,,7.29,,"-1,260,872.93"
,CS,AR,32012698,1005,100,,Cash sale,,,,,,27/12/2018,27/12/2018,0.00,,14.58,,"-1,260,887.51"
,IN,AR,30335389,1005,100,,Invoice,,,,,,27/12/2018,27/12/2018,0.00,,29.66,,"-1,260,917.17"
,IN,AR,30335390,1005,100,,Invoice,,,,,,27/12/2018,27/12/2018,0.00,,59.32,,"-1,260,976.49"
,IN,AR,30335394,1005,100,,Invoice,,,,,,27/12/2018,27/12/2018,0.00,,12.03,,"-1,260,988.52"
,IN,AR,30335400,1005,100,,Invoice,,,,,,27/12/2018,27/12/2018,0.00,,7.29,,"-1,260,995.81"
,IN,AR,30335411,1005,100,,Invoice,,,,,,27/12/2018,27/12/2018,0.00,,24.41,,"-1,261,020.22"
,IN,AR,30335412,1005,100,,Invoice,,,,,,27/12/2018,27/12/2018,0.00,,42.27,,"-1,261,062.49"
,IN,AR,30335415,1005,100,,Invoice,,,,,,27/12/2018,27/12/2018,0.00,,7.29,,"-1,261,069.78"
,IN,AR,30335416,1005,100,,Invoice,,,,,,27/12/2018,27/12/2018,0.00,,11.64,,"-1,261,081.42"
,IN,AR,30335421,1005,100,,Invoice,,,,,,27/12/2018,27/12/2018,0.00,,1.99,,"-1,261,083.41"
,IN,AR,30335423,1005,100,,Invoice,,,,,,27/12/2018,27/12/2018,0.00,,62.00,,"-1,261,145.41"
,IN,AR,30335429,1005,100,,Invoice,,,,,,27/12/2018,27/12/2018,0.00,,46.00,,"-1,261,191.41"
,IN,AR,30335431,1005,100,,Invoice,,,,,,27/12/2018,27/12/2018,0.00,,29.15,,"-1,261,220.56"
,IN,AR,30335432,1005,100,,Invoice,,,,,,27/12/2018,27/12/2018,0.00,,7.29,,"-1,261,227.85"
,IN,AR,30335447,1005,100,,Invoice,,,,,,27/12/2018,27/12/2018,0.00,,54.58,,"-1,261,282.43"
,IN,AR,30335452,1005,100,,Invoice,,,,,,27/12/2018,27/12/2018,0.00,,16.47,,"-1,261,298.90"
,IN,AR,30335455,1005,100,,Invoice,,,,,,27/12/2018,27/12/2018,0.00,,7.76,,"-1,261,306.66"
,IN,AR,30335473,1005,100,,Invoice,,,,,,27/12/2018,27/12/2018,0.00,,21.00,,"-1,261,327.66"
,IN,AR,30335478,1005,100,,Invoice,,,,,,27/12/2018,27/12/2018,0.00,,16.79,,"-1,261,344.45"
,IN,AR,30335486,1005,100,,Invoice,,,,,,27/12/2018,27/12/2018,0.00,,4.32,,"-1,261,348.77"
,IN,AR,30335494,1005,100,,Invoice,,,,,,27/12/2018,27/12/2018,0.00,,169.52,,"-1,261,518.29"
,IN,AR,30335495,1005,100,,Invoice,,,,,,27/12/2018,27/12/2018,0.00,,41.40,,"-1,261,559.69"
,IN,AR,30335507,1005,100,,Invoice,,,,,,27/12/2018,27/12/2018,0.00,,5.08,,"-1,261,564.77"
,IN,AR,30335508,1005,100,,Invoice,,,,,,27/12/2018,27/12/2018,0.00,,76.27,,"-1,261,641.04"
,IN,AR,30335510,1005,100,,Invoice,,,,,,27/12/2018,27/12/2018,0.00,,9.56,,"-1,261,650.60"
,IN,AR,30335515,1005,100,,Invoice,,,,,,27/12/2018,27/12/2018,0.00,,22.54,,"-1,261,673.14"
,IN,AR,30335545,1005,100,,Invoice,,,,,,27/12/2018,27/12/2018,0.00,,5.08,,"-1,261,678.22"
,IN,AR,30335552,1005,100,,Invoice,,,,,,27/12/2018,27/12/2018,0.00,,14.71,,"-1,261,692.93"
,IN,AR,30335554,1005,100,,Invoice,,,,,,27/12/2018,27/12/2018,0.00,,5.17,,"-1,261,698.10"
,IN,AR,30335555,1005,100,,Invoice,,,,,,27/12/2018,27/12/2018,0.00,,10.17,,"-1,261,708.27"
,IN,AR,30335593,1005,100,,Invoice,,,,,,27/12/2018,27/12/2018,0.00,,6.36,,"-1,261,714.63"
,IN,AR,30335596,1005,100,,Invoice,,,,,,27/12/2018,27/12/2018,0.00,,7.50,,"-1,261,722.13"
,IN,AR,30335600,1005,100,,Invoice,,,,,,27/12/2018,27/12/2018,0.00,,14.03,,"-1,261,736.16"
,IN,AR,30335602,1005,100,,Invoice,,,,,,27/12/2018,27/12/2018,0.00,,3.01,,"-1,261,739.17"
,IN,AR,30335607,1005,100,,Invoice,,,,,,27/12/2018,27/12/2018,0.00,,8.17,,"-1,261,747.34"
,IN,AR,30335608,1005,100,,Invoice,,,,,,27/12/2018,27/12/2018,0.00,,13.73,,"-1,261,761.07"
,IN,AR,30335615,1005,100,,Invoice,,,,,,27/12/2018,27/12/2018,0.00,,4.24,,"-1,261,765.31"
,IN,AR,30335616,1005,100,,Invoice,,,,,,27/12/2018,27/12/2018,0.00,,10.50,,"-1,261,775.81"
,IN,AR,30335621,1005,100,,Invoice,,,,,,27/12/2018,27/12/2018,0.00,,3.64,,"-1,261,779.45"
,IN,AR,30335626,1005,100,,Invoice,,,,,,27/12/2018,27/12/2018,0.00,,14.58,,"-1,261,794.03"
,IN,AR,30335627,1005,100,,Invoice,,,,,,27/12/2018,27/12/2018,0.00,,12.28,,"-1,261,806.31"
,IN,AR,30335629,1005,100,,Invoice,,,,,,27/12/2018,27/12/2018,0.00,,6.97,,"-1,261,813.28"
,IN,AR,30335630,1005,100,,Invoice,,,,,,27/12/2018,27/12/2018,0.00,,2.92,,"-1,261,816.20"
,IN,AR,30335631,1005,100,,Invoice,,,,,,27/12/2018,27/12/2018,0.00,,3.64,,"-1,261,819.84"
,IN,AR,30335632,1005,100,,Invoice,,,,,,27/12/2018,27/12/2018,0.00,,8.26,,"-1,261,828.10"
,IN,AR,30335640,1005,100,,Invoice,,,,,,27/12/2018,27/12/2018,0.00,,9.03,,"-1,261,837.13"
,IN,AR,30335643,1005,100,,Invoice,,,,,,27/12/2018,27/12/2018,0.00,,9.70,,"-1,261,846.83"
,IN,AR,30335648,1005,100,,Invoice,,,,,,27/12/2018,27/12/2018,0.00,,28.39,,"-1,261,875.22"
,IN,AR,30335651,1005,100,,Invoice,,,,,,27/12/2018,27/12/2018,0.00,,15.04,,"-1,261,890.26"
,IN,AR,30335652,1005,100,,Invoice,,,,,,27/12/2018,27/12/2018,0.00,,10.68,,"-1,261,900.94"
,IN,AR,30335658,1005,100,,Invoice,,,,,,27/12/2018,27/12/2018,0.00,,7.29,,"-1,261,908.23"
,IN,AR,30335659,1005,100,,Invoice,,,,,,27/12/2018,27/12/2018,0.00,,13.09,,"-1,261,921.32"
,IN,AR,30335677,1005,100,,Invoice,,,,,,27/12/2018,27/12/2018,0.00,,18.22,,"-1,261,939.54"
,IN,AR,30335678,1005,100,,Invoice,,,,,,27/12/2018,27/12/2018,0.00,,7.29,,"-1,261,946.83"
,IN,AR,30335679,1005,100,,Invoice,,,,,,27/12/2018,27/12/2018,0.00,,1.99,,"-1,261,948.82"
,IN,AR,30335680,1005,100,,Invoice,,,,,,27/12/2018,27/12/2018,0.00,,19.92,,"-1,261,968.74"
,IN,AR,30335682,1005,100,,Invoice,,,,,,27/12/2018,27/12/2018,0.00,,1.99,,"-1,261,970.73"
,IN,AR,30335708,1005,100,,Invoice,,,,,,27/12/2018,27/12/2018,0.00,,24.01,,"-1,261,994.74"
,IN,AR,30335712,1005,100,,Invoice,,,,,,27/12/2018,27/12/2018,0.00,,6.00,,"-1,262,000.74"
,IN,AR,30335714,1005,100,,Invoice,,,,,,27/12/2018,27/12/2018,0.00,,32.01,,"-1,262,032.75"
,IN,AR,30335716,1005,100,,Invoice,,,,,,27/12/2018,27/12/2018,0.00,,122.50,,"-1,262,155.25"
,IN,AR,30335717,1005,100,,Invoice,,,,,,27/12/2018,27/12/2018,0.00,,23.32,,"-1,262,178.57"
,IN,AR,30335721,1005,100,,Invoice,,,,,,27/12/2018,27/12/2018,0.00,,3.64,,"-1,262,182.21"
,IN,AR,30335728,1005,100,,Invoice,,,,,,27/12/2018,27/12/2018,0.00,,11.66,,"-1,262,193.87"
,IN,AR,30335730,1005,100,,Invoice,,,,,,27/12/2018,27/12/2018,0.00,,7.29,,"-1,262,201.16"
,IN,AR,30335732,1005,100,,Invoice,,,,,,27/12/2018,27/12/2018,0.00,,16.83,,"-1,262,217.99"
,IN,AR,30335733,1005,100,,Invoice,,,,,,27/12/2018,27/12/2018,0.00,,14.03,,"-1,262,232.02"
,IN,AR,30335735,1005,100,,Invoice,,,,,,27/12/2018,27/12/2018,0.00,,20.59,,"-1,262,252.61"
,IN,AR,30335738,1005,100,,Invoice,,,,,,27/12/2018,27/12/2018,0.00,,12.14,,"-1,262,264.75"
,IN,AR,30335740,1005,100,,Invoice,,,,,,27/12/2018,27/12/2018,0.00,,4.75,,"-1,262,269.50"
,IN,AR,30335742,1005,100,,Invoice,,,,,,27/12/2018,27/12/2018,0.00,,2.54,,"-1,262,272.04"
,IN,AR,30335744,1005,100,,Invoice,,,,,,27/12/2018,27/12/2018,0.00,,9.56,,"-1,262,281.60"
,IN,AR,30335745,1005,100,,Invoice,,,,,,27/12/2018,27/12/2018,0.00,,12.75,,"-1,262,294.35"
,IN,AR,30335746,1005,100,,Invoice,,,,,,27/12/2018,27/12/2018,0.00,,31.86,,"-1,262,326.21"
,IN,AR,30335777,1005,100,,Invoice,,,,,,27/12/2018,27/12/2018,0.00,,25.51,,"-1,262,351.72"
,IN,AR,30335781,1005,100,,Invoice,,,,,,27/12/2018,27/12/2018,0.00,,12.20,,"-1,262,363.92"
,IN,AR,30335789,1005,100,,Invoice,,,,,,27/12/2018,27/12/2018,0.00,,3.51,,"-1,262,367.43"
,IN,AR,30335793,1005,100,,Invoice,,,,,,27/12/2018,27/12/2018,0.00,,8.77,,"-1,262,376.20"
,IN,AR,30335805,1005,100,,Invoice,,,,,,27/12/2018,27/12/2018,0.00,,20.42,,"-1,262,396.62"
,IN,AR,30335808,1005,100,,Invoice,,,,,,27/12/2018,27/12/2018,0.00,,4.08,,"-1,262,400.70"
,IN,AR,30335809,1005,100,,Invoice,,,,,,27/12/2018,27/12/2018,0.00,,18.22,,"-1,262,418.92"
,IN,AR,30335818,1005,100,,Invoice,,,,,,27/12/2018,27/12/2018,0.00,,13.73,,"-1,262,432.65"
,IN,AR,30335819,1005,100,,Invoice,,,,,,27/12/2018,27/12/2018,0.00,,9.11,,"-1,262,441.76"
,IN,AR,30335821,1005,100,,Invoice,,,,,,27/12/2018,27/12/2018,0.00,,8.31,,"-1,262,450.07"
,IN,AR,30335822,1005,100,,Invoice,,,,,,27/12/2018,27/12/2018,0.00,,6.23,,"-1,262,456.30"
,IN,AR,30335823,1005,100,,Invoice,,,,,,27/12/2018,27/12/2018,0.00,,6.23,,"-1,262,462.53"
,IN,AR,30335824,1005,100,,Invoice,,,,,,27/12/2018,27/12/2018,0.00,,33.22,,"-1,262,495.75"
,IN,AR,30335834,1005,100,,Invoice,,,,,,27/12/2018,27/12/2018,0.00,,2.03,,"-1,262,497.78"
,IN,AR,30335839,1005,100,,Invoice,,,,,,27/12/2018,27/12/2018,0.00,,12.71,,"-1,262,510.49"
,IN,AR,30335840,1005,100,,Invoice,,,,,,27/12/2018,27/12/2018,0.00,,8.41,,"-1,262,518.90"
,IN,AR,30335847,1005,100,,Invoice,,,,,,27/12/2018,27/12/2018,0.00,,3.64,,"-1,262,522.54"
,IN,AR,30335849,1005,100,,Invoice,,,,,,27/12/2018,27/12/2018,0.00,,6.07,,"-1,262,528.61"
,IN,AR,30335850,1005,100,,Invoice,,,,,,27/12/2018,27/12/2018,0.00,,5.26,,"-1,262,533.87"
,IN,AR,30335851,1005,100,,Invoice,,,,,,27/12/2018,27/12/2018,0.00,,29.15,,"-1,262,563.02"
,IN,AR,30335855,1005,100,,Invoice,,,,,,27/12/2018,27/12/2018,0.00,,18.25,,"-1,262,581.27"
,IN,AR,30335856,1005,100,,Invoice,,,,,,27/12/2018,27/12/2018,0.00,,14.44,,"-1,262,595.71"
,IN,AR,30335857,1005,100,,Invoice,,,,,,27/12/2018,27/12/2018,0.00,,6.31,,"-1,262,602.02"
,IN,AR,30335858,1005,100,,Invoice,,,,,,27/12/2018,27/12/2018,0.00,,29.15,,"-1,262,631.17"
,IN,AR,30335863,1005,100,,Invoice,,,,,,27/12/2018,27/12/2018,0.00,,14.58,,"-1,262,645.75"
,CS,AR,32012511,1005,100,,Cash sale,,,,,,28/12/2018,28/12/2018,0.00,,11.86,,"-1,262,657.61"
,CS,AR,32012514,1005,100,,Cash sale,,,,,,28/12/2018,28/12/2018,0.00,,3.64,,"-1,262,661.25"
,CS,AR,32012517,1005,100,,Cash sale,,,,,,28/12/2018,28/12/2018,0.00,,10.93,,"-1,262,672.18"
,CS,AR,32012518,1005,100,,Cash sale,,,,,,28/12/2018,28/12/2018,0.00,,7.29,,"-1,262,679.47"
,CS,AR,32012521,1005,100,,Cash sale,,,,,,28/12/2018,28/12/2018,0.00,,10.93,,"-1,262,690.40"
,CS,AR,32012525,1005,100,,Cash sale,,,,,,28/12/2018,28/12/2018,0.00,,7.29,,"-1,262,697.69"
,CS,AR,32012526,1005,100,,Cash sale,,,,,,28/12/2018,28/12/2018,0.00,,10.38,,"-1,262,708.07"
,CS,AR,32012530,1005,100,,Cash sale,,,,,,28/12/2018,28/12/2018,0.00,,7.29,,"-1,262,715.36"
,CS,AR,32012535,1005,100,,Cash sale,,,,,,28/12/2018,28/12/2018,0.00,,3.64,,"-1,262,719.00"
,CS,AR,32012536,1005,100,,Cash sale,,,,,,28/12/2018,28/12/2018,0.00,,7.29,,"-1,262,726.29"
,CS,AR,32012539,1005,100,,Cash sale,,,,,,28/12/2018,28/12/2018,0.00,,7.29,,"-1,262,733.58"
,CS,AR,32012540,1005,100,,Cash sale,,,,,,28/12/2018,28/12/2018,0.00,,28.46,,"-1,262,762.04"
,CS,AR,32012542,1005,100,,Cash sale,,,,,,28/12/2018,28/12/2018,0.00,,3.64,,"-1,262,765.68"
,CS,AR,32012543,1005,100,,Cash sale,,,,,,28/12/2018,28/12/2018,0.00,,3.64,,"-1,262,769.32"
,CS,AR,32012544,1005,100,,Cash sale,,,,,,28/12/2018,28/12/2018,0.00,,5.86,,"-1,262,775.18"
,CS,AR,32012550,1005,100,,Cash sale,,,,,,28/12/2018,28/12/2018,0.00,,10.93,,"-1,262,786.11"
,CS,AR,32012554,1005,100,,Cash sale,,,,,,28/12/2018,28/12/2018,0.00,,21.86,,"-1,262,807.97"
,CS,AR,32012555,1005,100,,Cash sale,,,,,,28/12/2018,28/12/2018,0.00,,2.58,,"-1,262,810.55"
,CS,AR,32012557,1005,100,,Cash sale,,,,,,28/12/2018,28/12/2018,0.00,,10.17,,"-1,262,820.72"
,CS,AR,32012559,1005,100,,Cash sale,,,,,,28/12/2018,28/12/2018,0.00,,27.97,,"-1,262,848.69"
,CS,AR,32012565,1005,100,,Cash sale,,,,,,28/12/2018,28/12/2018,0.00,,43.97,,"-1,262,892.66"
,CS,AR,32012567,1005,100,,Cash sale,,,,,,28/12/2018,28/12/2018,0.00,,30.22,,"-1,262,922.88"
,CS,AR,32012572,1005,100,,Cash sale,,,,,,28/12/2018,28/12/2018,0.00,,3.01,,"-1,262,925.89"
,CS,AR,32012576,1005,100,,Cash sale,,,,,,28/12/2018,28/12/2018,0.00,,7.00,,"-1,262,932.89"
,CS,AR,32012579,1005,100,,Cash sale,,,,,,28/12/2018,28/12/2018,0.00,,8.77,,"-1,262,941.66"
,CS,AR,32012590,1005,100,,Cash sale,,,,,,28/12/2018,28/12/2018,0.00,,3.64,,"-1,262,945.30"
,CS,AR,32012591,1005,100,,Cash sale,,,,,,28/12/2018,28/12/2018,0.00,,14.58,,"-1,262,959.88"
,CS,AR,32012596,1005,100,,Cash sale,,,,,,28/12/2018,28/12/2018,0.00,,10.34,,"-1,262,970.22"
,CS,AR,32012599,1005,100,,Cash sale,,,,,,28/12/2018,28/12/2018,0.00,,10.93,,"-1,262,981.15"
,CS,AR,32012604,1005,100,,Cash sale,,,,,,28/12/2018,28/12/2018,0.00,,7.29,,"-1,262,988.44"
,CS,AR,32012605,1005,100,,Cash sale,,,,,,28/12/2018,28/12/2018,0.00,,7.75,,"-1,262,996.19"
,CS,AR,32012614,1005,100,,Cash sale,,,,,,28/12/2018,28/12/2018,0.00,,20.34,,"-1,263,016.53"
,CS,AR,32012617,1005,100,,Cash sale,,,,,,28/12/2018,28/12/2018,0.00,,10.93,,"-1,263,027.46"
,CS,AR,32012619,1005,100,,Cash sale,,,,,,28/12/2018,28/12/2018,0.00,,3.64,,"-1,263,031.10"
,CS,AR,32012620,1005,100,,Cash sale,,,,,,28/12/2018,28/12/2018,0.00,,7.29,,"-1,263,038.39"
,CS,AR,32012624,1005,100,,Cash sale,,,,,,28/12/2018,28/12/2018,0.00,,46.00,,"-1,263,084.39"
,CS,AR,32012626,1005,100,,Cash sale,,,,,,28/12/2018,28/12/2018,0.00,,54.66,,"-1,263,139.05"
,CS,AR,32012631,1005,100,,Cash sale,,,,,,28/12/2018,28/12/2018,0.00,,7.29,,"-1,263,146.34"
,CS,AR,32012633,1005,100,,Cash sale,,,,,,28/12/2018,28/12/2018,0.00,,6.86,,"-1,263,153.20"
,CS,AR,32012635,1005,100,,Cash sale,,,,,,28/12/2018,28/12/2018,0.00,,10.93,,"-1,263,164.13"
,CS,AR,32012643,1005,100,,Cash sale,,,,,,28/12/2018,28/12/2018,0.00,,10.93,,"-1,263,175.06"
,CS,AR,32012645,1005,100,,Cash sale,,,,,,28/12/2018,28/12/2018,0.00,,3.64,,"-1,263,178.70"
,CS,AR,32012646,1005,100,,Cash sale,,,,,,28/12/2018,28/12/2018,0.00,,12.14,,"-1,263,190.84"
,CS,AR,32012647,1005,100,,Cash sale,,,,,,28/12/2018,28/12/2018,0.00,,3.05,,"-1,263,193.89"
,CS,AR,32012650,1005,100,,Cash sale,,,,,,28/12/2018,28/12/2018,0.00,,18.25,,"-1,263,212.14"
,CS,AR,32012651,1005,100,,Cash sale,,,,,,28/12/2018,28/12/2018,0.00,,14.58,,"-1,263,226.72"
,CS,AR,32012655,1005,100,,Cash sale,,,,,,28/12/2018,28/12/2018,0.00,,7.29,,"-1,263,234.01"
,CS,AR,32012656,1005,100,,Cash sale,,,,,,28/12/2018,28/12/2018,0.00,,7.29,,"-1,263,241.30"
,CS,AR,32012661,1005,100,,Cash sale,,,,,,28/12/2018,28/12/2018,0.00,,7.29,,"-1,263,248.59"
,CS,AR,32012662,1005,100,,Cash sale,,,,,,28/12/2018,28/12/2018,0.00,,7.29,,"-1,263,255.88"
,CS,AR,32012683,1005,100,,Cash sale,,,,,,28/12/2018,28/12/2018,0.00,,10.93,,"-1,263,266.81"
,CS,AR,32012684,1005,100,,Cash sale,,,,,,28/12/2018,28/12/2018,0.00,,14.58,,"-1,263,281.39"
,CS,AR,32012692,1005,100,,Cash sale,,,,,,28/12/2018,28/12/2018,0.00,,2.97,,"-1,263,284.36"
,CS,AR,32012696,1005,100,,Cash sale,,,,,,28/12/2018,28/12/2018,0.00,,7.29,,"-1,263,291.65"
,IN,AR,30335391,1005,100,,Invoice,,,,,,28/12/2018,28/12/2018,0.00,,2.97,,"-1,263,294.62"
,IN,AR,30335392,1005,100,,Invoice,,,,,,28/12/2018,28/12/2018,0.00,,29.66,,"-1,263,324.28"
,IN,AR,30335395,1005,100,,Invoice,,,,,,28/12/2018,28/12/2018,0.00,,32.80,,"-1,263,357.08"
,IN,AR,30335398,1005,100,,Invoice,,,,,,28/12/2018,28/12/2018,0.00,,11.19,,"-1,263,368.27"
,IN,AR,30335417,1005,100,,Invoice,,,,,,28/12/2018,28/12/2018,0.00,,69.86,,"-1,263,438.13"
,IN,AR,30335418,1005,100,,Invoice,,,,,,28/12/2018,28/12/2018,0.00,,1.94,,"-1,263,440.07"
,IN,AR,30335419,1005,100,,Invoice,,,,,,28/12/2018,28/12/2018,0.00,,7.29,,"-1,263,447.36"
,IN,AR,30335424,1005,100,,Invoice,,,,,,28/12/2018,28/12/2018,0.00,,46.00,,"-1,263,493.36"
,IN,AR,30335428,1005,100,,Invoice,,,,,,28/12/2018,28/12/2018,0.00,,7.29,,"-1,263,500.65"
,IN,AR,30335436,1005,100,,Invoice,,,,,,28/12/2018,28/12/2018,0.00,,24.00,,"-1,263,524.65"
,IN,AR,30335437,1005,100,,Invoice,,,,,,28/12/2018,28/12/2018,0.00,,26.00,,"-1,263,550.65"
,IN,AR,30335448,1005,100,,Invoice,,,,,,28/12/2018,28/12/2018,0.00,,11.86,,"-1,263,562.51"
,IN,AR,30335451,1005,100,,Invoice,,,,,,28/12/2018,28/12/2018,0.00,,14.00,,"-1,263,576.51"
,IN,AR,30335454,1005,100,,Invoice,,,,,,28/12/2018,28/12/2018,0.00,,683.34,,"-1,264,259.85"
,IN,AR,30335456,1005,100,,Invoice,,,,,,28/12/2018,28/12/2018,0.00,,11.64,,"-1,264,271.49"
,IN,AR,30335457,1005,100,,Invoice,,,,,,28/12/2018,28/12/2018,0.00,,7.76,,"-1,264,279.25"
,IN,AR,30335461,1005,100,,Invoice,,,,,,28/12/2018,28/12/2018,0.00,,38.00,,"-1,264,317.25"
,IN,AR,30335463,1005,100,,Invoice,,,,,,28/12/2018,28/12/2018,0.00,,3.64,,"-1,264,320.89"
,IN,AR,30335465,1005,100,,Invoice,,,,,,28/12/2018,28/12/2018,0.00,,14.58,,"-1,264,335.47"
,IN,AR,30335470,1005,100,,Invoice,,,,,,28/12/2018,28/12/2018,0.00,,43.73,,"-1,264,379.20"
,IN,AR,30335474,1005,100,,Invoice,,,,,,28/12/2018,28/12/2018,0.00,,5.17,,"-1,264,384.37"
,IN,AR,30335479,1005,100,,Invoice,,,,,,28/12/2018,28/12/2018,0.00,,7.19,,"-1,264,391.56"
,IN,AR,30335491,1005,100,,Invoice,,,,,,28/12/2018,28/12/2018,0.00,,21.86,,"-1,264,413.42"
,IN,AR,30335492,1005,100,,Invoice,,,,,,28/12/2018,28/12/2018,0.00,,20.68,,"-1,264,434.10"
,IN,AR,30335496,1005,100,,Invoice,,,,,,28/12/2018,28/12/2018,0.00,,7.76,,"-1,264,441.86"
,IN,AR,30335498,1005,100,,Invoice,,,,,,28/12/2018,28/12/2018,0.00,,18.05,,"-1,264,459.91"
,IN,AR,30335503,1005,100,,Invoice,,,,,,28/12/2018,28/12/2018,0.00,,43.07,,"-1,264,502.98"
,IN,AR,30335505,1005,100,,Invoice,,,,,,28/12/2018,28/12/2018,0.00,,14.03,,"-1,264,517.01"
,IN,AR,30335511,1005,100,,Invoice,,,,,,28/12/2018,28/12/2018,0.00,,9.56,,"-1,264,526.57"
,IN,AR,30335512,1005,100,,Invoice,,,,,,28/12/2018,28/12/2018,0.00,,9.56,,"-1,264,536.13"
,IN,AR,30335516,1005,100,,Invoice,,,,,,28/12/2018,28/12/2018,0.00,,24.07,,"-1,264,560.20"
,IN,AR,30335531,1005,100,,Invoice,,,,,,28/12/2018,28/12/2018,0.00,,10.17,,"-1,264,570.37"
,IN,AR,30335546,1005,100,,Invoice,,,,,,28/12/2018,28/12/2018,0.00,,7.63,,"-1,264,578.00"
,IN,AR,30335547,1005,100,,Invoice,,,,,,28/12/2018,28/12/2018,0.00,,7.63,,"-1,264,585.63"
,IN,AR,30335548,1005,100,,Invoice,,,,,,28/12/2018,28/12/2018,0.00,,5.08,,"-1,264,590.71"
,IN,AR,30335549,1005,100,,Invoice,,,,,,28/12/2018,28/12/2018,0.00,,10.17,,"-1,264,600.88"
,IN,AR,30335556,1005,100,,Invoice,,,,,,28/12/2018,28/12/2018,0.00,,18.05,,"-1,264,618.93"
,IN,AR,30335590,1005,100,,Invoice,,,,,,28/12/2018,28/12/2018,0.00,,10.17,,"-1,264,629.10"
,IN,AR,30335591,1005,100,,Invoice,,,,,,28/12/2018,28/12/2018,0.00,,10.17,,"-1,264,639.27"
,IN,AR,30335592,1005,100,,Invoice,,,,,,28/12/2018,28/12/2018,0.00,,2.12,,"-1,264,641.39"
,IN,AR,30335598,1005,100,,Invoice,,,,,,28/12/2018,28/12/2018,0.00,,5.08,,"-1,264,646.47"
,IN,AR,30335604,1005,100,,Invoice,,,,,,28/12/2018,28/12/2018,0.00,,16.95,,"-1,264,663.42"
,IN,AR,30335611,1005,100,,Invoice,,,,,,28/12/2018,28/12/2018,0.00,,11.22,,"-1,264,674.64"
,IN,AR,30335623,1005,100,,Invoice,,,,,,28/12/2018,28/12/2018,0.00,,364.41,,"-1,265,039.05"
,IN,AR,30335628,1005,100,,Invoice,,,,,,28/12/2018,28/12/2018,0.00,,7.29,,"-1,265,046.34"
,IN,AR,30335633,1005,100,,Invoice,,,,,,28/12/2018,28/12/2018,0.00,,10.34,,"-1,265,056.68"
,IN,AR,30335644,1005,100,,Invoice,,,,,,28/12/2018,28/12/2018,0.00,,1.94,,"-1,265,058.62"
,IN,AR,30335655,1005,100,,Invoice,,,,,,28/12/2018,28/12/2018,0.00,,7.27,,"-1,265,065.89"
,IN,AR,30335664,1005,100,,Invoice,,,,,,28/12/2018,28/12/2018,0.00,,14.58,,"-1,265,080.47"
,IN,AR,30335675,1005,100,,Invoice,,,,,,28/12/2018,28/12/2018,0.00,,7.29,,"-1,265,087.76"
,IN,AR,30335683,1005,100,,Invoice,,,,,,28/12/2018,28/12/2018,0.00,,5.97,,"-1,265,093.73"
,IN,AR,30335684,1005,100,,Invoice,,,,,,28/12/2018,28/12/2018,0.00,,14.19,,"-1,265,107.92"
,IN,AR,30335686,1005,100,,Invoice,,,,,,28/12/2018,28/12/2018,0.00,,34.00,,"-1,265,141.92"
,IN,AR,30335687,1005,100,,Invoice,,,,,,28/12/2018,28/12/2018,0.00,,28.81,,"-1,265,170.73"
,IN,AR,30335690,1005,100,,Invoice,,,,,,28/12/2018,28/12/2018,0.00,,22.05,,"-1,265,192.78"
,IN,AR,30335695,1005,100,,Invoice,,,,,,28/12/2018,28/12/2018,0.00,,3.64,,"-1,265,196.42"
,IN,AR,30335697,1005,100,,Invoice,,,,,,28/12/2018,28/12/2018,0.00,,17.29,,"-1,265,213.71"
,IN,AR,30335699,1005,100,,Invoice,,,,,,28/12/2018,28/12/2018,0.00,,3.64,,"-1,265,217.35"
,IN,AR,30335701,1005,100,,Invoice,,,,,,28/12/2018,28/12/2018,0.00,,10.51,,"-1,265,227.86"
,IN,AR,30335705,1005,100,,Invoice,,,,,,28/12/2018,28/12/2018,0.00,,19.13,,"-1,265,246.99"
,IN,AR,30335709,1005,100,,Invoice,,,,,,28/12/2018,28/12/2018,0.00,,10.00,,"-1,265,256.99"
,IN,AR,30335715,1005,100,,Invoice,,,,,,28/12/2018,28/12/2018,0.00,,6.00,,"-1,265,262.99"
,IN,AR,30335723,1005,100,,Invoice,,,,,,28/12/2018,28/12/2018,0.00,,38.32,,"-1,265,301.31"
,IN,AR,30335725,1005,100,,Invoice,,,,,,28/12/2018,28/12/2018,0.00,,6.31,,"-1,265,307.62"
,IN,AR,30335726,1005,100,,Invoice,,,,,,28/12/2018,28/12/2018,0.00,,39.95,,"-1,265,347.57"
,IN,AR,30335729,1005,100,,Invoice,,,,,,28/12/2018,28/12/2018,0.00,,11.66,,"-1,265,359.23"
,IN,AR,30335736,1005,100,,Invoice,,,,,,28/12/2018,28/12/2018,0.00,,22.37,,"-1,265,381.60"
,IN,AR,30335778,1005,100,,Invoice,,,,,,28/12/2018,28/12/2018,0.00,,10.93,,"-1,265,392.53"
,IN,AR,30335782,1005,100,,Invoice,,,,,,28/12/2018,28/12/2018,0.00,,16.00,,"-1,265,408.53"
,IN,AR,30335794,1005,100,,Invoice,,,,,,28/12/2018,28/12/2018,0.00,,8.21,,"-1,265,416.74"
,IN,AR,30335801,1005,100,,Invoice,,,,,,28/12/2018,28/12/2018,0.00,,18.33,,"-1,265,435.07"
,IN,AR,30335806,1005,100,,Invoice,,,,,,28/12/2018,28/12/2018,0.00,,8.17,,"-1,265,443.24"
,IN,AR,30335810,1005,100,,Invoice,,,,,,28/12/2018,28/12/2018,0.00,,7.97,,"-1,265,451.21"
,IN,AR,30335812,1005,100,,Invoice,,,,,,28/12/2018,28/12/2018,0.00,,11.69,,"-1,265,462.90"
,IN,AR,30335814,1005,100,,Invoice,,,,,,28/12/2018,28/12/2018,0.00,,2.92,,"-1,265,465.82"
,IN,AR,30335831,1005,100,,Invoice,,,,,,28/12/2018,28/12/2018,0.00,,13.96,,"-1,265,479.78"
,IN,AR,30335832,1005,100,,Invoice,,,,,,28/12/2018,28/12/2018,0.00,,10.93,,"-1,265,490.71"
,IN,AR,30335835,1005,100,,Invoice,,,,,,28/12/2018,28/12/2018,0.00,,2.03,,"-1,265,492.74"
,IN,AR,30335841,1005,100,,Invoice,,,,,,28/12/2018,28/12/2018,0.00,,10.93,,"-1,265,503.67"
,IN,AR,30335845,1005,100,,Invoice,,,,,,28/12/2018,28/12/2018,0.00,,39.44,,"-1,265,543.11"
,IN,AR,30335864,1005,100,,Invoice,,,,,,28/12/2018,28/12/2018,0.00,,10.93,,"-1,265,554.04"
,IN,AR,30335870,1005,100,,Invoice,,,,,,28/12/2018,28/12/2018,0.00,,29.15,,"-1,265,583.19"
,CN,AR,31019785,1005,100,,Credit Note,,,,,,29/12/2018,29/12/2018,3.64,,0.00,,"-1,265,579.55"
,CS,AR,32012513,1005,100,,Cash sale,,,,,,29/12/2018,29/12/2018,0.00,,6.02,,"-1,265,585.57"
,CS,AR,32012529,1005,100,,Cash sale,,,,,,29/12/2018,29/12/2018,0.00,,7.29,,"-1,265,592.86"
,CS,AR,32012532,1005,100,,Cash sale,,,,,,29/12/2018,29/12/2018,0.00,,18.22,,"-1,265,611.08"
,CS,AR,32012571,1005,100,,Cash sale,,,,,,29/12/2018,29/12/2018,0.00,,3.64,,"-1,265,614.72"
,CS,AR,32012585,1005,100,,Cash sale,,,,,,29/12/2018,29/12/2018,0.00,,3.64,,"-1,265,618.36"
,CS,AR,32012586,1005,100,,Cash sale,,,,,,29/12/2018,29/12/2018,0.00,,7.29,,"-1,265,625.65"
,CS,AR,32012609,1005,100,,Cash sale,,,,,,29/12/2018,29/12/2018,0.00,,14.58,,"-1,265,640.23"
,CS,AR,32012612,1005,100,,Cash sale,,,,,,29/12/2018,29/12/2018,0.00,,3.64,,"-1,265,643.87"
,IN,AR,30335414,1005,100,,Invoice,,,,,,29/12/2018,29/12/2018,0.00,,10.93,,"-1,265,654.80"
,IN,AR,30335425,1005,100,,Invoice,,,,,,29/12/2018,29/12/2018,0.00,,50.00,,"-1,265,704.80"
,IN,AR,30335441,1005,100,,Invoice,,,,,,29/12/2018,29/12/2018,0.00,,10.93,,"-1,265,715.73"
,IN,AR,30335446,1005,100,,Invoice,,,,,,29/12/2018,29/12/2018,0.00,,3.64,,"-1,265,719.37"
,IN,AR,30335460,1005,100,,Invoice,,,,,,29/12/2018,29/12/2018,0.00,,7.29,,"-1,265,726.66"
,IN,AR,30335476,1005,100,,Invoice,,,,,,29/12/2018,29/12/2018,0.00,,16.47,,"-1,265,743.13"
,IN,AR,30335501,1005,100,,Invoice,,,,,,29/12/2018,29/12/2018,0.00,,5.85,,"-1,265,748.98"
,IN,AR,30335541,1005,100,,Invoice,,,,,,29/12/2018,29/12/2018,0.00,,4.78,,"-1,265,753.76"
,IN,AR,30335720,1005,100,,Invoice,,,,,,29/12/2018,29/12/2018,0.00,,7.29,,"-1,265,761.05"
,IN,AR,30335838,1005,100,,Invoice,,,,,,29/12/2018,29/12/2018,0.00,,7.29,,"-1,265,768.34"
,IN,AR,30335865,1005,100,,Invoice,,,,,,29/12/2018,29/12/2018,0.00,,21.06,,"-1,265,789.40"
,IN,AR,30335866,1005,100,,Invoice,,,,,,29/12/2018,29/12/2018,0.00,,7.29,,"-1,265,796.69"
,CS,AR,32012512,1005,100,,Cash sale,,,,,,31/12/2018,31/12/2018,0.00,,9.49,,"-1,265,806.18"
,CS,AR,32012524,1005,100,,Cash sale,,,,,,31/12/2018,31/12/2018,0.00,,7.29,,"-1,265,813.47"
,CS,AR,32012527,1005,100,,Cash sale,,,,,,31/12/2018,31/12/2018,0.00,,12.46,,"-1,265,825.93"
,CS,AR,32012531,1005,100,,Cash sale,,,,,,31/12/2018,31/12/2018,0.00,,10.93,,"-1,265,836.86"
,CS,AR,32012534,1005,100,,Cash sale,,,,,,31/12/2018,31/12/2018,0.00,,9.73,,"-1,265,846.59"
,CS,AR,32012538,1005,100,,Cash sale,,,,,,31/12/2018,31/12/2018,0.00,,14.58,,"-1,265,861.17"
,CS,AR,32012547,1005,100,,Cash sale,,,,,,31/12/2018,31/12/2018,0.00,,3.64,,"-1,265,864.81"
,CS,AR,32012549,1005,100,,Cash sale,,,,,,31/12/2018,31/12/2018,0.00,,10.34,,"-1,265,875.15"
,CS,AR,32012558,1005,100,,Cash sale,,,,,,31/12/2018,31/12/2018,0.00,,12.71,,"-1,265,887.86"
,CS,AR,32012560,1005,100,,Cash sale,,,,,,31/12/2018,31/12/2018,0.00,,7.29,,"-1,265,895.15"
,CS,AR,32012561,1005,100,,Cash sale,,,,,,31/12/2018,31/12/2018,0.00,,2.84,,"-1,265,897.99"
,CS,AR,32012568,1005,100,,Cash sale,,,,,,31/12/2018,31/12/2018,0.00,,13.74,,"-1,265,911.73"
,CS,AR,32012575,1005,100,,Cash sale,,,,,,31/12/2018,31/12/2018,0.00,,25.51,,"-1,265,937.24"
,CS,AR,32012580,1005,100,,Cash sale,,,,,,31/12/2018,31/12/2018,0.00,,23.39,,"-1,265,960.63"
,CS,AR,32012581,1005,100,,Cash sale,,,,,,31/12/2018,31/12/2018,0.00,,7.29,,"-1,265,967.92"
,CS,AR,32012582,1005,100,,Cash sale,,,,,,31/12/2018,31/12/2018,0.00,,7.12,,"-1,265,975.04"
,CS,AR,32012583,1005,100,,Cash sale,,,,,,31/12/2018,31/12/2018,0.00,,15.04,,"-1,265,990.08"
,CS,AR,32012588,1005,100,,Cash sale,,,,,,31/12/2018,31/12/2018,0.00,,7.29,,"-1,265,997.37"
,CS,AR,32012592,1005,100,,Cash sale,,,,,,31/12/2018,31/12/2018,0.00,,2.54,,"-1,265,999.91"
,CS,AR,32012594,1005,100,,Cash sale,,,,,,31/12/2018,31/12/2018,0.00,,3.64,,"-1,266,003.55"
,CS,AR,32012597,1005,100,,Cash sale,,,,,,31/12/2018,31/12/2018,0.00,,3.64,,"-1,266,007.19"
,CS,AR,32012603,1005,100,,Cash sale,,,,,,31/12/2018,31/12/2018,0.00,,10.93,,"-1,266,018.12"
,CS,AR,32012610,1005,100,,Cash sale,,,,,,31/12/2018,31/12/2018,0.00,,7.29,,"-1,266,025.41"
,CS,AR,32012615,1005,100,,Cash sale,,,,,,31/12/2018,31/12/2018,0.00,,12.71,,"-1,266,038.12"
,CS,AR,32012629,1005,100,,Cash sale,,,,,,31/12/2018,31/12/2018,0.00,,6.56,,"-1,266,044.68"
,CS,AR,32012634,1005,100,,Cash sale,,,,,,31/12/2018,31/12/2018,0.00,,11.44,,"-1,266,056.12"
,CS,AR,32012639,1005,100,,Cash sale,,,,,,31/12/2018,31/12/2018,0.00,,32.80,,"-1,266,088.92"
,CS,AR,32012640,1005,100,,Cash sale,,,,,,31/12/2018,31/12/2018,0.00,,12.14,,"-1,266,101.06"
,CS,AR,32012644,1005,100,,Cash sale,,,,,,31/12/2018,31/12/2018,0.00,,10.93,,"-1,266,111.99"
,CS,AR,32012648,1005,100,,Cash sale,,,,,,31/12/2018,31/12/2018,0.00,,3.64,,"-1,266,115.63"
,CS,AR,32012652,1005,100,,Cash sale,,,,,,31/12/2018,31/12/2018,0.00,,3.64,,"-1,266,119.27"
,CS,AR,32012653,1005,100,,Cash sale,,,,,,31/12/2018,31/12/2018,0.00,,10.93,,"-1,266,130.20"
,CS,AR,32012659,1005,100,,Cash sale,,,,,,31/12/2018,31/12/2018,0.00,,10.93,,"-1,266,141.13"
,CS,AR,32012660,1005,100,,Cash sale,,,,,,31/12/2018,31/12/2018,0.00,,3.64,,"-1,266,144.77"
,CS,AR,32012682,1005,100,,Cash sale,,,,,,31/12/2018,31/12/2018,0.00,,18.64,,"-1,266,163.41"
,CS,AR,32012686,1005,100,,Cash sale,,,,,,31/12/2018,31/12/2018,0.00,,14.58,,"-1,266,177.99"
,CS,AR,32012693,1005,100,,Cash sale,,,,,,31/12/2018,31/12/2018,0.00,,14.58,,"-1,266,192.57"
,IN,AR,30335387,1005,100,,Invoice,,,,,,31/12/2018,31/12/2018,0.00,,18.64,,"-1,266,211.21"
,IN,AR,30335393,1005,100,,Invoice,,,,,,31/12/2018,31/12/2018,0.00,,44.49,,"-1,266,255.70"
,IN,AR,30335397,1005,100,,Invoice,,,,,,31/12/2018,31/12/2018,0.00,,14.58,,"-1,266,270.28"
,IN,AR,30335401,1005,100,,Invoice,,,,,,31/12/2018,31/12/2018,0.00,,2.03,,"-1,266,272.31"
,IN,AR,30335402,1005,100,,Invoice,,,,,,31/12/2018,31/12/2018,0.00,,2.03,,"-1,266,274.34"
,IN,AR,30335403,1005,100,,Invoice,,,,,,31/12/2018,31/12/2018,0.00,,8.10,,"-1,266,282.44"
,IN,AR,30335404,1005,100,,Invoice,,,,,,31/12/2018,31/12/2018,0.00,,2.03,,"-1,266,284.47"
,IN,AR,30335405,1005,100,,Invoice,,,,,,31/12/2018,31/12/2018,0.00,,8.10,,"-1,266,292.57"
,IN,AR,30335406,1005,100,,Invoice,,,,,,31/12/2018,31/12/2018,0.00,,6.08,,"-1,266,298.65"
,IN,AR,30335407,1005,100,,Invoice,,,,,,31/12/2018,31/12/2018,0.00,,4.05,,"-1,266,302.70"
,IN,AR,30335408,1005,100,,Invoice,,,,,,31/12/2018,31/12/2018,0.00,,"1,343.28",,"-1,267,645.98"
,IN,AR,30335410,1005,100,,Invoice,,,,,,31/12/2018,31/12/2018,0.00,,3.50,,"-1,267,649.48"
,IN,AR,30335413,1005,100,,Invoice,,,,,,31/12/2018,31/12/2018,0.00,,76.08,,"-1,267,725.56"
,IN,AR,30335426,1005,100,,Invoice,,,,,,31/12/2018,31/12/2018,0.00,,56.00,,"-1,267,781.56"
,IN,AR,30335427,1005,100,,Invoice,,,,,,31/12/2018,31/12/2018,0.00,,"1,106.99",,"-1,268,888.55"
,IN,AR,30335430,1005,100,,Invoice,,,,,,31/12/2018,31/12/2018,0.00,,54.00,,"-1,268,942.55"
,IN,AR,30335433,1005,100,,Invoice,,,,,,31/12/2018,31/12/2018,0.00,,14.85,,"-1,268,957.40"
,IN,AR,30335438,1005,100,,Invoice,,,,,,31/12/2018,31/12/2018,0.00,,36.00,,"-1,268,993.40"
,IN,AR,30335439,1005,100,,Invoice,,,,,,31/12/2018,31/12/2018,0.00,,34.00,,"-1,269,027.40"
,IN,AR,30335443,1005,100,,Invoice,,,,,,31/12/2018,31/12/2018,0.00,,20.34,,"-1,269,047.74"
,IN,AR,30335445,1005,100,,Invoice,,,,,,31/12/2018,31/12/2018,0.00,,14.62,,"-1,269,062.36"
,IN,AR,30335449,1005,100,,Invoice,,,,,,31/12/2018,31/12/2018,0.00,,46.61,,"-1,269,108.97"
,IN,AR,30335453,1005,100,,Invoice,,,,,,31/12/2018,31/12/2018,0.00,,18.22,,"-1,269,127.19"
,IN,AR,30335458,1005,100,,Invoice,,,,,,31/12/2018,31/12/2018,0.00,,88.42,,"-1,269,215.61"
,IN,AR,30335462,1005,100,,Invoice,,,,,,31/12/2018,31/12/2018,0.00,,17.99,,"-1,269,233.60"
,IN,AR,30335464,1005,100,,Invoice,,,,,,31/12/2018,31/12/2018,0.00,,7.29,,"-1,269,240.89"
,IN,AR,30335467,1005,100,,Invoice,,,,,,31/12/2018,31/12/2018,0.00,,12.88,,"-1,269,253.77"
,IN,AR,30335469,1005,100,,Invoice,,,,,,31/12/2018,31/12/2018,0.00,,66.19,,"-1,269,319.96"
,IN,AR,30335471,1005,100,,Invoice,,,,,,31/12/2018,31/12/2018,0.00,,14.58,,"-1,269,334.54"
,IN,AR,30335475,1005,100,,Invoice,,,,,,31/12/2018,31/12/2018,0.00,,5.17,,"-1,269,339.71"
,IN,AR,30335480,1005,100,,Invoice,,,,,,31/12/2018,31/12/2018,0.00,,18.37,,"-1,269,358.08"
,IN,AR,30335482,1005,100,,Invoice,,,,,,31/12/2018,31/12/2018,0.00,,"3,057.37",,"-1,272,415.45"
,IN,AR,30335483,1005,100,,Invoice,,,,,,31/12/2018,31/12/2018,0.00,,80.17,,"-1,272,495.62"
,IN,AR,30335484,1005,100,,Invoice,,,,,,31/12/2018,31/12/2018,0.00,,32.80,,"-1,272,528.42"
,IN,AR,30335485,1005,100,,Invoice,,,,,,31/12/2018,31/12/2018,0.00,,193.14,,"-1,272,721.56"
,IN,AR,30335488,1005,100,,Invoice,,,,,,31/12/2018,31/12/2018,0.00,,138.31,,"-1,272,859.87"
,IN,AR,30335489,1005,100,,Invoice,,,,,,31/12/2018,31/12/2018,0.00,,116.53,,"-1,272,976.40"
,IN,AR,30335490,1005,100,,Invoice,,,,,,31/12/2018,31/12/2018,0.00,,11.19,,"-1,272,987.59"
,IN,AR,30335493,1005,100,,Invoice,,,,,,31/12/2018,31/12/2018,0.00,,10.34,,"-1,272,997.93"
,IN,AR,30335500,1005,100,,Invoice,,,,,,31/12/2018,31/12/2018,0.00,,"1,559.69",,"-1,274,557.62"
,IN,AR,30335504,1005,100,,Invoice,,,,,,31/12/2018,31/12/2018,0.00,,69.73,,"-1,274,627.35"
,IN,AR,30335509,1005,100,,Invoice,,,,,,31/12/2018,31/12/2018,0.00,,22.88,,"-1,274,650.23"
,IN,AR,30335513,1005,100,,Invoice,,,,,,31/12/2018,31/12/2018,0.00,,23.90,,"-1,274,674.13"
,IN,AR,30335514,1005,100,,Invoice,,,,,,31/12/2018,31/12/2018,0.00,,6.44,,"-1,274,680.57"
,IN,AR,30335517,1005,100,,Invoice,,,,,,31/12/2018,31/12/2018,0.00,,131.57,,"-1,274,812.14"
,IN,AR,30335518,1005,100,,Invoice,,,,,,31/12/2018,31/12/2018,0.00,,177.09,,"-1,274,989.23"
,IN,AR,30335520,1005,100,,Invoice,,,,,,31/12/2018,31/12/2018,0.00,,35.75,,"-1,275,024.98"
,IN,AR,30335521,1005,100,,Invoice,,,,,,31/12/2018,31/12/2018,0.00,,35.07,,"-1,275,060.05"
,IN,AR,30335522,1005,100,,Invoice,,,,,,31/12/2018,31/12/2018,0.00,,142.03,,"-1,275,202.08"
,IN,AR,30335523,1005,100,,Invoice,,,,,,31/12/2018,31/12/2018,0.00,,33.31,,"-1,275,235.39"
,IN,AR,30335524,1005,100,,Invoice,,,,,,31/12/2018,31/12/2018,0.00,,7.53,,"-1,275,242.92"
,IN,AR,30335525,1005,100,,Invoice,,,,,,31/12/2018,31/12/2018,0.00,,20.69,,"-1,275,263.61"
,IN,AR,30335526,1005,100,,Invoice,,,,,,31/12/2018,31/12/2018,0.00,,24.46,,"-1,275,288.07"
,IN,AR,30335527,1005,100,,Invoice,,,,,,31/12/2018,31/12/2018,0.00,,24.46,,"-1,275,312.53"
,IN,AR,30335528,1005,100,,Invoice,,,,,,31/12/2018,31/12/2018,0.00,,18.81,,"-1,275,331.34"
,IN,AR,30335529,1005,100,,Invoice,,,,,,31/12/2018,31/12/2018,0.00,,20.69,,"-1,275,352.03"
,IN,AR,30335530,1005,100,,Invoice,,,,,,31/12/2018,31/12/2018,0.00,,52.68,,"-1,275,404.71"
,IN,AR,30335532,1005,100,,Invoice,,,,,,31/12/2018,31/12/2018,0.00,,336.65,,"-1,275,741.36"
,IN,AR,30335533,1005,100,,Invoice,,,,,,31/12/2018,31/12/2018,0.00,,45.58,,"-1,275,786.94"
,IN,AR,30335534,1005,100,,Invoice,,,,,,31/12/2018,31/12/2018,0.00,,43.86,,"-1,275,830.80"
,IN,AR,30335535,1005,100,,Invoice,,,,,,31/12/2018,31/12/2018,0.00,,3.76,,"-1,275,834.56"
,IN,AR,30335536,1005,100,,Invoice,,,,,,31/12/2018,31/12/2018,0.00,,29.81,,"-1,275,864.37"
,IN,AR,30335537,1005,100,,Invoice,,,,,,31/12/2018,31/12/2018,0.00,,31.56,,"-1,275,895.93"
,IN,AR,30335538,1005,100,,Invoice,,,,,,31/12/2018,31/12/2018,0.00,,12.27,,"-1,275,908.20"
,IN,AR,30335539,1005,100,,Invoice,,,,,,31/12/2018,31/12/2018,0.00,,8.76,,"-1,275,916.96"
,IN,AR,30335540,1005,100,,Invoice,,,,,,31/12/2018,31/12/2018,0.00,,17.54,,"-1,275,934.50"
,IN,AR,30335542,1005,100,,Invoice,,,,,,31/12/2018,31/12/2018,0.00,,3.51,,"-1,275,938.01"
,IN,AR,30335550,1005,100,,Invoice,,,,,,31/12/2018,31/12/2018,0.00,,14.03,,"-1,275,952.04"
,IN,AR,30335553,1005,100,,Invoice,,,,,,31/12/2018,31/12/2018,0.00,,270.15,,"-1,276,222.19"
,IN,AR,30335557,1005,100,,Invoice,,,,,,31/12/2018,31/12/2018,0.00,,98.35,,"-1,276,320.54"
,IN,AR,30335558,1005,100,,Invoice,,,,,,31/12/2018,31/12/2018,0.00,,28.61,,"-1,276,349.15"
,IN,AR,30335559,1005,100,,Invoice,,,,,,31/12/2018,31/12/2018,0.00,,8.94,,"-1,276,358.09"
,IN,AR,30335560,1005,100,,Invoice,,,,,,31/12/2018,31/12/2018,0.00,,44.70,,"-1,276,402.79"
,IN,AR,30335561,1005,100,,Invoice,,,,,,31/12/2018,31/12/2018,0.00,,32.19,,"-1,276,434.98"
,IN,AR,30335562,1005,100,,Invoice,,,,,,31/12/2018,31/12/2018,0.00,,28.61,,"-1,276,463.59"
,IN,AR,30335563,1005,100,,Invoice,,,,,,31/12/2018,31/12/2018,0.00,,23.25,,"-1,276,486.84"
,IN,AR,30335564,1005,100,,Invoice,,,,,,31/12/2018,31/12/2018,0.00,,30.40,,"-1,276,517.24"
,IN,AR,30335565,1005,100,,Invoice,,,,,,31/12/2018,31/12/2018,0.00,,19.67,,"-1,276,536.91"
,IN,AR,30335566,1005,100,,Invoice,,,,,,31/12/2018,31/12/2018,0.00,,177.03,,"-1,276,713.94"
,IN,AR,30335567,1005,100,,Invoice,,,,,,31/12/2018,31/12/2018,0.00,,5.36,,"-1,276,719.30"
,IN,AR,30335568,1005,100,,Invoice,,,,,,31/12/2018,31/12/2018,0.00,,17.88,,"-1,276,737.18"
,IN,AR,30335569,1005,100,,Invoice,,,,,,31/12/2018,31/12/2018,0.00,,10.73,,"-1,276,747.91"
,IN,AR,30335570,1005,100,,Invoice,,,,,,31/12/2018,31/12/2018,0.00,,44.70,,"-1,276,792.61"
,IN,AR,30335571,1005,100,,Invoice,,,,,,31/12/2018,31/12/2018,0.00,,51.86,,"-1,276,844.47"
,IN,AR,30335572,1005,100,,Invoice,,,,,,31/12/2018,31/12/2018,0.00,,12.52,,"-1,276,856.99"
,IN,AR,30335573,1005,100,,Invoice,,,,,,31/12/2018,31/12/2018,0.00,,10.73,,"-1,276,867.72"
,IN,AR,30335574,1005,100,,Invoice,,,,,,31/12/2018,31/12/2018,0.00,,7.15,,"-1,276,874.87"
,IN,AR,30335575,1005,100,,Invoice,,,,,,31/12/2018,31/12/2018,0.00,,39.34,,"-1,276,914.21"
,IN,AR,30335576,1005,100,,Invoice,,,,,,31/12/2018,31/12/2018,0.00,,26.82,,"-1,276,941.03"
,IN,AR,30335577,1005,100,,Invoice,,,,,,31/12/2018,31/12/2018,0.00,,39.34,,"-1,276,980.37"
,IN,AR,30335578,1005,100,,Invoice,,,,,,31/12/2018,31/12/2018,0.00,,12.52,,"-1,276,992.89"
,IN,AR,30335579,1005,100,,Invoice,,,,,,31/12/2018,31/12/2018,0.00,,8.94,,"-1,277,001.83"
,IN,AR,30335580,1005,100,,Invoice,,,,,,31/12/2018,31/12/2018,0.00,,108.71,,"-1,277,110.54"
,IN,AR,30335581,1005,100,,Invoice,,,,,,31/12/2018,31/12/2018,0.00,,159.31,,"-1,277,269.85"
,IN,AR,30335582,1005,100,,Invoice,,,,,,31/12/2018,31/12/2018,0.00,,93.95,,"-1,277,363.80"
,IN,AR,30335583,1005,100,,Invoice,,,,,,31/12/2018,31/12/2018,0.00,,4.08,,"-1,277,367.88"
,IN,AR,30335584,1005,100,,Invoice,,,,,,31/12/2018,31/12/2018,0.00,,175.64,,"-1,277,543.52"
,IN,AR,30335585,1005,100,,Invoice,,,,,,31/12/2018,31/12/2018,0.00,,34.72,,"-1,277,578.24"
,IN,AR,30335586,1005,100,,Invoice,,,,,,31/12/2018,31/12/2018,0.00,,138.88,,"-1,277,717.12"
,IN,AR,30335587,1005,100,,Invoice,,,,,,31/12/2018,31/12/2018,0.00,,8.17,,"-1,277,725.29"
,IN,AR,30335588,1005,100,,Invoice,,,,,,31/12/2018,31/12/2018,0.00,,20.42,,"-1,277,745.71"
,IN,AR,30335589,1005,100,,Invoice,,,,,,31/12/2018,31/12/2018,0.00,,26.55,,"-1,277,772.26"
,IN,AR,30335594,1005,100,,Invoice,,,,,,31/12/2018,31/12/2018,0.00,,7.80,,"-1,277,780.06"
,IN,AR,30335595,1005,100,,Invoice,,,,,,31/12/2018,31/12/2018,0.00,,"1,388.09",,"-1,279,168.15"
,IN,AR,30335597,1005,100,,Invoice,,,,,,31/12/2018,31/12/2018,0.00,,20.34,,"-1,279,188.49"
,IN,AR,30335601,1005,100,,Invoice,,,,,,31/12/2018,31/12/2018,0.00,,7.29,,"-1,279,195.78"
,IN,AR,30335605,1005,100,,Invoice,,,,,,31/12/2018,31/12/2018,0.00,,30.30,,"-1,279,226.08"
,IN,AR,30335609,1005,100,,Invoice,,,,,,31/12/2018,31/12/2018,0.00,,9.19,,"-1,279,235.27"
,IN,AR,30335612,1005,100,,Invoice,,,,,,31/12/2018,31/12/2018,0.00,,11.22,,"-1,279,246.49"
,IN,AR,30335614,1005,100,,Invoice,,,,,,31/12/2018,31/12/2018,0.00,,15.76,,"-1,279,262.25"
,IN,AR,30335617,1005,100,,Invoice,,,,,,31/12/2018,31/12/2018,0.00,,968.90,,"-1,280,231.15"
,IN,AR,30335618,1005,100,,Invoice,,,,,,31/12/2018,31/12/2018,0.00,,505.07,,"-1,280,736.22"
,IN,AR,30335619,1005,100,,Invoice,,,,,,31/12/2018,31/12/2018,0.00,,21.04,,"-1,280,757.26"
,IN,AR,30335622,1005,100,,Invoice,,,,,,31/12/2018,31/12/2018,0.00,,2.92,,"-1,280,760.18"
,IN,AR,30335634,1005,100,,Invoice,,,,,,31/12/2018,31/12/2018,0.00,,5.86,,"-1,280,766.04"
,IN,AR,30335635,1005,100,,Invoice,,,,,,31/12/2018,31/12/2018,0.00,,16.42,,"-1,280,782.46"
,IN,AR,30335636,1005,100,,Invoice,,,,,,31/12/2018,31/12/2018,0.00,,4.49,,"-1,280,786.95"
,IN,AR,30335637,1005,100,,Invoice,,,,,,31/12/2018,31/12/2018,0.00,,59.50,,"-1,280,846.45"
,IN,AR,30335646,1005,100,,Invoice,,,,,,31/12/2018,31/12/2018,0.00,,6.53,,"-1,280,852.98"
,IN,AR,30335647,1005,100,,Invoice,,,,,,31/12/2018,31/12/2018,0.00,,10.93,,"-1,280,863.91"
,IN,AR,30335649,1005,100,,Invoice,,,,,,31/12/2018,31/12/2018,0.00,,21.44,,"-1,280,885.35"
,IN,AR,30335650,1005,100,,Invoice,,,,,,31/12/2018,31/12/2018,0.00,,66.44,,"-1,280,951.79"
,IN,AR,30335654,1005,100,,Invoice,,,,,,31/12/2018,31/12/2018,0.00,,10.93,,"-1,280,962.72"
,IN,AR,30335657,1005,100,,Invoice,,,,,,31/12/2018,31/12/2018,0.00,,2.58,,"-1,280,965.30"
,IN,AR,30335661,1005,100,,Invoice,,,,,,31/12/2018,31/12/2018,0.00,,332.84,,"-1,281,298.14"
,IN,AR,30335662,1005,100,,Invoice,,,,,,31/12/2018,31/12/2018,0.00,,134.87,,"-1,281,433.01"
,IN,AR,30335663,1005,100,,Invoice,,,,,,31/12/2018,31/12/2018,0.00,,4.29,,"-1,281,437.30"
,IN,AR,30335665,1005,100,,Invoice,,,,,,31/12/2018,31/12/2018,0.00,,25.64,,"-1,281,462.94"
,IN,AR,30335666,1005,100,,Invoice,,,,,,31/12/2018,31/12/2018,0.00,,9.32,,"-1,281,472.26"
,IN,AR,30335667,1005,100,,Invoice,,,,,,31/12/2018,31/12/2018,0.00,,72.25,,"-1,281,544.51"
,IN,AR,30335668,1005,100,,Invoice,,,,,,31/12/2018,31/12/2018,0.00,,18.64,,"-1,281,563.15"
,IN,AR,30335669,1005,100,,Invoice,,,,,,31/12/2018,31/12/2018,0.00,,44.28,,"-1,281,607.43"
,IN,AR,30335670,1005,100,,Invoice,,,,,,31/12/2018,31/12/2018,0.00,,48.94,,"-1,281,656.37"
,IN,AR,30335671,1005,100,,Invoice,,,,,,31/12/2018,31/12/2018,0.00,,25.64,,"-1,281,682.01"
,IN,AR,30335672,1005,100,,Invoice,,,,,,31/12/2018,31/12/2018,0.00,,27.97,,"-1,281,709.98"
,IN,AR,30335673,1005,100,,Invoice,,,,,,31/12/2018,31/12/2018,0.00,,34.96,,"-1,281,744.94"
,IN,AR,30335674,1005,100,,Invoice,,,,,,31/12/2018,31/12/2018,0.00,,18.64,,"-1,281,763.58"
,IN,AR,30335676,1005,100,,Invoice,,,,,,31/12/2018,31/12/2018,0.00,,534.00,,"-1,282,297.58"
,IN,AR,30335685,1005,100,,Invoice,,,,,,31/12/2018,31/12/2018,0.00,,14.19,,"-1,282,311.77"
,IN,AR,30335688,1005,100,,Invoice,,,,,,31/12/2018,31/12/2018,0.00,,4.29,,"-1,282,316.06"
,IN,AR,30335691,1005,100,,Invoice,,,,,,31/12/2018,31/12/2018,0.00,,16.03,,"-1,282,332.09"
,IN,AR,30335692,1005,100,,Invoice,,,,,,31/12/2018,31/12/2018,0.00,,308.94,,"-1,282,641.03"
,IN,AR,30335694,1005,100,,Invoice,,,,,,31/12/2018,31/12/2018,0.00,,79.74,,"-1,282,720.77"
,IN,AR,30335698,1005,100,,Invoice,,,,,,31/12/2018,31/12/2018,0.00,,86.73,,"-1,282,807.50"
,IN,AR,30335702,1005,100,,Invoice,,,,,,31/12/2018,31/12/2018,0.00,,251.01,,"-1,283,058.51"
,IN,AR,30335706,1005,100,,Invoice,,,,,,31/12/2018,31/12/2018,0.00,,10.93,,"-1,283,069.44"
,IN,AR,30335710,1005,100,,Invoice,,,,,,31/12/2018,31/12/2018,0.00,,4.00,,"-1,283,073.44"
,IN,AR,30335711,1005,100,,Invoice,,,,,,31/12/2018,31/12/2018,0.00,,4.00,,"-1,283,077.44"
,IN,AR,30335713,1005,100,,Invoice,,,,,,31/12/2018,31/12/2018,0.00,,8.00,,"-1,283,085.44"
,IN,AR,30335719,1005,100,,Invoice,,,,,,31/12/2018,31/12/2018,0.00,,18.10,,"-1,283,103.54"
,IN,AR,30335722,1005,100,,Invoice,,,,,,31/12/2018,31/12/2018,0.00,,44.14,,"-1,283,147.68"
,IN,AR,30335734,1005,100,,Invoice,,,,,,31/12/2018,31/12/2018,0.00,,16.83,,"-1,283,164.51"
,IN,AR,30335747,1005,100,,Invoice,,,,,,31/12/2018,31/12/2018,0.00,,22.30,,"-1,283,186.81"
,IN,AR,30335748,1005,100,,Invoice,,,,,,31/12/2018,31/12/2018,0.00,,588.64,,"-1,283,775.45"
,IN,AR,30335749,1005,100,,Invoice,,,,,,31/12/2018,31/12/2018,0.00,,9.75,,"-1,283,785.20"
,IN,AR,30335750,1005,100,,Invoice,,,,,,31/12/2018,31/12/2018,0.00,,9.75,,"-1,283,794.95"
,IN,AR,30335751,1005,100,,Invoice,,,,,,31/12/2018,31/12/2018,0.00,,11.69,,"-1,283,806.64"
,IN,AR,30335752,1005,100,,Invoice,,,,,,31/12/2018,31/12/2018,0.00,,11.69,,"-1,283,818.33"
,IN,AR,30335753,1005,100,,Invoice,,,,,,31/12/2018,31/12/2018,0.00,,11.69,,"-1,283,830.02"
,IN,AR,30335754,1005,100,,Invoice,,,,,,31/12/2018,31/12/2018,0.00,,19.49,,"-1,283,849.51"
,IN,AR,30335755,1005,100,,Invoice,,,,,,31/12/2018,31/12/2018,0.00,,11.69,,"-1,283,861.20"
,IN,AR,30335756,1005,100,,Invoice,,,,,,31/12/2018,31/12/2018,0.00,,33.14,,"-1,283,894.34"
,IN,AR,30335757,1005,100,,Invoice,,,,,,31/12/2018,31/12/2018,0.00,,13.64,,"-1,283,907.98"
,IN,AR,30335758,1005,100,,Invoice,,,,,,31/12/2018,31/12/2018,0.00,,19.49,,"-1,283,927.47"
,IN,AR,30335759,1005,100,,Invoice,,,,,,31/12/2018,31/12/2018,0.00,,27.29,,"-1,283,954.76"
,IN,AR,30335760,1005,100,,Invoice,,,,,,31/12/2018,31/12/2018,0.00,,9.75,,"-1,283,964.51"
,IN,AR,30335761,1005,100,,Invoice,,,,,,31/12/2018,31/12/2018,0.00,,5.85,,"-1,283,970.36"
,IN,AR,30335762,1005,100,,Invoice,,,,,,31/12/2018,31/12/2018,0.00,,13.64,,"-1,283,984.00"
,IN,AR,30335763,1005,100,,Invoice,,,,,,31/12/2018,31/12/2018,0.00,,1.95,,"-1,283,985.95"
,IN,AR,30335764,1005,100,,Invoice,,,,,,31/12/2018,31/12/2018,0.00,,11.69,,"-1,283,997.64"
,IN,AR,30335765,1005,100,,Invoice,,,,,,31/12/2018,31/12/2018,0.00,,9.75,,"-1,284,007.39"
,IN,AR,30335766,1005,100,,Invoice,,,,,,31/12/2018,31/12/2018,0.00,,15.59,,"-1,284,022.98"
,IN,AR,30335767,1005,100,,Invoice,,,,,,31/12/2018,31/12/2018,0.00,,374.24,,"-1,284,397.22"
,IN,AR,30335768,1005,100,,Invoice,,,,,,31/12/2018,31/12/2018,0.00,,27.29,,"-1,284,424.51"
,IN,AR,30335769,1005,100,,Invoice,,,,,,31/12/2018,31/12/2018,0.00,,510.68,,"-1,284,935.19"
,IN,AR,30335770,1005,100,,Invoice,,,,,,31/12/2018,31/12/2018,0.00,,19.49,,"-1,284,954.68"
,IN,AR,30335771,1005,100,,Invoice,,,,,,31/12/2018,31/12/2018,0.00,,93.56,,"-1,285,048.24"
,IN,AR,30335772,1005,100,,Invoice,,,,,,31/12/2018,31/12/2018,0.00,,21.44,,"-1,285,069.68"
,IN,AR,30335773,1005,100,,Invoice,,,,,,31/12/2018,31/12/2018,0.00,,31.19,,"-1,285,100.87"
,IN,AR,30335774,1005,100,,Invoice,,,,,,31/12/2018,31/12/2018,0.00,,9.75,,"-1,285,110.62"
,IN,AR,30335775,1005,100,,Invoice,,,,,,31/12/2018,31/12/2018,0.00,,3.90,,"-1,285,114.52"
,IN,AR,30335776,1005,100,,Invoice,,,,,,31/12/2018,31/12/2018,0.00,,5.85,,"-1,285,120.37"
,IN,AR,30335779,1005,100,,Invoice,,,,,,31/12/2018,31/12/2018,0.00,,21.36,,"-1,285,141.73"
,IN,AR,30335780,1005,100,,Invoice,,,,,,31/12/2018,31/12/2018,0.00,,73.56,,"-1,285,215.29"
,IN,AR,30335783,1005,100,,Invoice,,,,,,31/12/2018,31/12/2018,0.00,,8.00,,"-1,285,223.29"
,IN,AR,30335784,1005,100,,Invoice,,,,,,31/12/2018,31/12/2018,0.00,,9.41,,"-1,285,232.70"
,IN,AR,30335785,1005,100,,Invoice,,,,,,31/12/2018,31/12/2018,0.00,,3.76,,"-1,285,236.46"
,IN,AR,30335786,1005,100,,Invoice,,,,,,31/12/2018,31/12/2018,0.00,,7.53,,"-1,285,243.99"
,IN,AR,30335787,1005,100,,Invoice,,,,,,31/12/2018,31/12/2018,0.00,,11.29,,"-1,285,255.28"
,IN,AR,30335791,1005,100,,Invoice,,,,,,31/12/2018,31/12/2018,0.00,,90.76,,"-1,285,346.04"
,IN,AR,30335792,1005,100,,Invoice,,,,,,31/12/2018,31/12/2018,0.00,,585.64,,"-1,285,931.68"
,IN,AR,30335795,1005,100,,Invoice,,,,,,31/12/2018,31/12/2018,0.00,,10.95,,"-1,285,942.63"
,IN,AR,30335797,1005,100,,Invoice,,,,,,31/12/2018,31/12/2018,0.00,,14.58,,"-1,285,957.21"
,IN,AR,30335799,1005,100,,Invoice,,,,,,31/12/2018,31/12/2018,0.00,,205.70,,"-1,286,162.91"
,IN,AR,30335800,1005,100,,Invoice,,,,,,31/12/2018,31/12/2018,0.00,,159.80,,"-1,286,322.71"
,IN,AR,30335802,1005,100,,Invoice,,,,,,31/12/2018,31/12/2018,0.00,,7.02,,"-1,286,329.73"
,IN,AR,30335807,1005,100,,Invoice,,,,,,31/12/2018,31/12/2018,0.00,,6.13,,"-1,286,335.86"
,IN,AR,30335811,1005,100,,Invoice,,,,,,31/12/2018,31/12/2018,0.00,,9.96,,"-1,286,345.82"
,IN,AR,30335813,1005,100,,Invoice,,,,,,31/12/2018,31/12/2018,0.00,,23.39,,"-1,286,369.21"
,IN,AR,30335815,1005,100,,Invoice,,,,,,31/12/2018,31/12/2018,0.00,,30.11,,"-1,286,399.32"
,IN,AR,30335816,1005,100,,Invoice,,,,,,31/12/2018,31/12/2018,0.00,,21.90,,"-1,286,421.22"
,IN,AR,30335817,1005,100,,Invoice,,,,,,31/12/2018,31/12/2018,0.00,,5.47,,"-1,286,426.69"
,IN,AR,30335825,1005,100,,Invoice,,,,,,31/12/2018,31/12/2018,0.00,,14.53,,"-1,286,441.22"
,IN,AR,30335826,1005,100,,Invoice,,,,,,31/12/2018,31/12/2018,0.00,,8.31,,"-1,286,449.53"
,IN,AR,30335827,1005,100,,Invoice,,,,,,31/12/2018,31/12/2018,0.00,,2.08,,"-1,286,451.61"
,IN,AR,30335833,1005,100,,Invoice,,,,,,31/12/2018,31/12/2018,0.00,,6.56,,"-1,286,458.17"
,IN,AR,30335836,1005,100,,Invoice,,,,,,31/12/2018,31/12/2018,0.00,,5.26,,"-1,286,463.43"
,IN,AR,30335837,1005,100,,Invoice,,,,,,31/12/2018,31/12/2018,0.00,,154.02,,"-1,286,617.45"
,IN,AR,30335846,1005,100,,Invoice,,,,,,31/12/2018,31/12/2018,0.00,,5.93,,"-1,286,623.38"
,IN,AR,30335852,1005,100,,Invoice,,,,,,31/12/2018,31/12/2018,0.00,,10.93,,"-1,286,634.31"
,CN,AR,31019847,1005,100,,Credit Note,,,,,,31/12/2018,31/12/2018,"1,093.22",,0.00,,"-1,285,541.09"
,CN,AR,31019850,1005,100,,Credit Note,,,,,,31/12/2018,31/12/2018,77.54,,0.00,,"-1,285,463.55"
,CN,AR,31019852,1005,100,,Credit Note,,,,,,31/12/2018,31/12/2018,3.76,,0.00,,"-1,285,459.79"
,IN,AR,30337120,1005,100,,Invoice,,,,,,31/12/2018,31/12/2018,0.00,,364.41,,"-1,285,824.20"
,IN,AR,30337121,1005,100,,Invoice,,,,,,31/12/2018,31/12/2018,0.00,,364.41,,"-1,286,188.61"
,IN,AR,30337124,1005,100,,Invoice,,,,,,31/12/2018,31/12/2018,0.00,,25.85,,"-1,286,214.46"
,IN,AR,30337129,1005,100,,Invoice,,,,,,31/12/2018,31/12/2018,0.00,,364.41,,"-1,286,578.87"
,,,,,,,,,,,,,,,,,,,
,Account: 1000110 - Sales - 11ltr Water,,,,,,,,,,,,,,,,,,
,Pr.,Mod.,Reference,Dept,Div,Suffix,Details,,,Cheque,,User,Doc Date,Post Date,Debit,,Credit,,Balance
,IN,AR,30304463,1005,100,,Invoice,,,,,,02/01/2018,02/01/2018,0.00,,14.24,,-14.24
,CS,AR,32000075,1005,100,,Cash sale,,,,,,03/01/2018,03/01/2018,0.00,,7.12,,-21.36
,CS,AR,32000254,1005,100,,Cash sale,,,,,,03/01/2018,03/01/2018,0.00,,2.37,,-23.73
,IN,AR,30306151,1005,100,,Invoice,,,,,,04/01/2018,04/01/2018,0.00,,4.75,,-28.48
,CS,AR,32000772,1005,100,,Cash sale,,,,,,05/01/2018,05/01/2018,0.00,,13.36,,-41.84
,IN,AR,30304357,1005,100,,Invoice,,,,,,08/01/2018,08/01/2018,0.00,,35.59,,-77.43
,CS,AR,32000076,1005,100,,Cash sale,,,,,,09/01/2018,09/01/2018,0.00,,7.12,,-84.55
,CS,AR,32000816,1005,100,,Cash sale,,,,,,10/01/2018,10/01/2018,0.00,,10.68,,-95.23
,CS,AR,32000897,1005,100,,Cash sale,,,,,,10/01/2018,10/01/2018,0.00,,2.37,,-97.60
,IN,AR,30305746,1005,100,,Invoice,,,,,,10/01/2018,10/01/2018,0.00,,9.49,,-107.09
,IN,AR,30306492,1005,100,,Invoice,,,,,,10/01/2018,10/01/2018,0.00,,9.49,,-116.58
,CS,AR,32000551,1005,100,,Cash sale,,,,,,11/01/2018,11/01/2018,0.00,,9.49,,-126.07
,CS,AR,32000738,1005,100,,Cash sale,,,,,,11/01/2018,11/01/2018,0.00,,4.75,,-130.82
,IN,AR,30304636,1005,100,,Invoice,,,,,,11/01/2018,11/01/2018,0.00,,11.86,,-142.68
,IN,AR,30305963,1005,100,,Invoice,,,,,,11/01/2018,11/01/2018,0.00,,7.12,,-149.80
,IN,AR,30306644,1005,100,,Invoice,,,,,,11/01/2018,11/01/2018,0.00,,18.98,,-168.78
,CS,AR,32000049,1005,100,,Cash sale,,,,,,12/01/2018,12/01/2018,0.00,,7.12,,-175.90
,IN,AR,30305886,1005,100,,Invoice,,,,,,12/01/2018,12/01/2018,0.00,,11.86,,-187.76
,IN,AR,30306491,1005,100,,Invoice,,,,,,12/01/2018,12/01/2018,0.00,,39.49,,-227.25
,CS,AR,32000560,1005,100,,Cash sale,,,,,,13/01/2018,13/01/2018,0.00,,14.24,,-241.49
,CS,AR,32000773,1005,100,,Cash sale,,,,,,15/01/2018,15/01/2018,0.00,,9.54,,-251.03
,IN,AR,30304599,1005,100,,Invoice,,,,,,15/01/2018,15/01/2018,0.00,,4.75,,-255.78
,CS,AR,32000048,1005,100,,Cash sale,,,,,,16/01/2018,16/01/2018,0.00,,9.49,,-265.27
,IN,AR,30304565,1005,100,,Invoice,,,,,,16/01/2018,16/01/2018,0.00,,35.59,,-300.86
,IN,AR,30304855,1005,100,,Invoice,,,,,,18/01/2018,18/01/2018,0.00,,11.86,,-312.72
,CS,AR,32000077,1005,100,,Cash sale,,,,,,19/01/2018,19/01/2018,0.00,,7.12,,-319.84
,CS,AR,32000575,1005,100,,Cash sale,,,,,,19/01/2018,19/01/2018,0.00,,7.12,,-326.96
,IN,AR,30304464,1005,100,,Invoice,,,,,,19/01/2018,19/01/2018,0.00,,14.24,,-341.20
,IN,AR,30304600,1005,100,,Invoice,,,,,,19/01/2018,19/01/2018,0.00,,7.12,,-348.32
,IN,AR,30305887,1005,100,,Invoice,,,,,,19/01/2018,19/01/2018,0.00,,7.12,,-355.44
,CS,AR,32000917,1005,100,,Cash sale,,,,,,20/01/2018,20/01/2018,0.00,,7.12,,-362.56
,CN,AR,31017200,1005,100,,Credit Note,,,,,,22/01/2018,22/01/2018,18.98,,0.00,,-343.58
,CS,AR,32000541,1005,100,,Cash sale,,,,,,23/01/2018,23/01/2018,0.00,,7.12,,-350.70
,IN,AR,30306493,1005,100,,Invoice,,,,,,23/01/2018,23/01/2018,0.00,,18.98,,-369.68
,CS,AR,32000774,1005,100,,Cash sale,,,,,,24/01/2018,24/01/2018,0.00,,9.54,,-379.22
,CS,AR,32000124,1005,100,,Cash sale,,,,,,25/01/2018,25/01/2018,0.00,,7.12,,-386.34
,CS,AR,32000255,1005,100,,Cash sale,,,,,,25/01/2018,25/01/2018,0.00,,2.37,,-388.71
,CS,AR,32000740,1005,100,,Cash sale,,,,,,25/01/2018,25/01/2018,0.00,,2.37,,-391.08
,CS,AR,32000576,1005,100,,Cash sale,,,,,,26/01/2018,26/01/2018,0.00,,7.12,,-398.20
,IN,AR,30305888,1005,100,,Invoice,,,,,,26/01/2018,26/01/2018,0.00,,4.75,,-402.95
,IN,AR,30305964,1005,100,,Invoice,,,,,,26/01/2018,26/01/2018,0.00,,11.86,,-414.81
,CS,AR,32000487,1005,100,,Cash sale,,,,,,29/01/2018,29/01/2018,0.00,,16.61,,-431.42
,IN,AR,30305581,1005,100,,Invoice,,,,,,29/01/2018,29/01/2018,0.00,,11.86,,-443.28
,IN,AR,30304825,1005,100,,Invoice,,,,,,30/01/2018,30/01/2018,0.00,,7.12,,-450.40
,CS,AR,32000078,1005,100,,Cash sale,,,,,,31/01/2018,31/01/2018,0.00,,7.12,,-457.52
,IN,AR,30305299,1005,100,,Invoice,,,,,,31/01/2018,31/01/2018,0.00,,13.35,,-470.87
,IN,AR,30305713,1005,100,,Invoice,,,,,,31/01/2018,31/01/2018,0.00,,9.49,,-480.36
,CS,AR,32000941,1005,100,,Cash sale,,,,,,01/02/2018,01/02/2018,0.00,,7.12,,-487.48
,IN,AR,30307808,1005,100,,Invoice,,,,,,05/02/2018,05/02/2018,0.00,,4.75,,-492.23
,IN,AR,30308705,1005,100,,Invoice,,,,,,05/02/2018,05/02/2018,0.00,,7.12,,-499.35
,CS,AR,32000992,1005,100,,Cash sale,,,,,,06/02/2018,06/02/2018,0.00,,4.75,,-504.10
,CS,AR,32001661,1005,100,,Cash sale,,,,,,06/02/2018,06/02/2018,0.00,,7.12,,-511.22
,CS,AR,32001402,1005,100,,Cash sale,,,,,,07/02/2018,07/02/2018,0.00,,9.49,,-520.71
,IN,AR,30307964,1005,100,,Invoice,,,,,,07/02/2018,07/02/2018,0.00,,7.12,,-527.83
,IN,AR,30308306,1005,100,,Invoice,,,,,,07/02/2018,07/02/2018,0.00,,35.59,,-563.42
,CS,AR,32001138,1005,100,,Cash sale,,,,,,08/02/2018,08/02/2018,0.00,,2.37,,-565.79
,CS,AR,32001553,1005,100,,Cash sale,,,,,,08/02/2018,08/02/2018,0.00,,4.75,,-570.54
,IN,AR,30306766,1005,100,,Invoice,,,,,,08/02/2018,08/02/2018,0.00,,9.49,,-580.03
,CN,AR,31017415,1005,100,,Credit Note,,,,,,12/02/2018,12/02/2018,18.98,,0.00,,-561.05
,CS,AR,32001584,1005,100,,Cash sale,,,,,,12/02/2018,12/02/2018,0.00,,13.36,,-574.41
,IN,AR,30307082,1005,100,,Invoice,,,,,,12/02/2018,12/02/2018,0.00,,14.24,,-588.65
,IN,AR,30308555,1005,100,,Invoice,,,,,,12/02/2018,12/02/2018,0.00,,18.98,,-607.63
,CS,AR,32001431,1005,100,,Cash sale,,,,,,13/02/2018,13/02/2018,0.00,,9.49,,-617.12
,CS,AR,32001385,1005,100,,Cash sale,,,,,,14/02/2018,14/02/2018,0.00,,9.49,,-626.61
,CS,AR,32001670,1005,100,,Cash sale,,,,,,14/02/2018,14/02/2018,0.00,,4.75,,-631.36
,CS,AR,32001381,1005,100,,Cash sale,,,,,,15/02/2018,15/02/2018,0.00,,9.49,,-640.85
,CS,AR,32001554,1005,100,,Cash sale,,,,,,15/02/2018,15/02/2018,0.00,,4.75,,-645.60
,IN,AR,30307138,1005,100,,Invoice,,,,,,15/02/2018,15/02/2018,0.00,,7.12,,-652.72
,IN,AR,30308173,1005,100,,Invoice,,,,,,15/02/2018,15/02/2018,0.00,,35.59,,-688.31
,CS,AR,32000993,1005,100,,Cash sale,,,,,,16/02/2018,16/02/2018,0.00,,4.75,,-693.06
,IN,AR,30307965,1005,100,,Invoice,,,,,,16/02/2018,16/02/2018,0.00,,9.49,,-702.55
,CN,AR,31017423,1005,100,,Credit Note,,,,,,19/02/2018,19/02/2018,35.59,,0.00,,-666.96
,CS,AR,32000994,1005,100,,Cash sale,,,,,,19/02/2018,19/02/2018,0.00,,7.12,,-674.08
,IN,AR,30306776,1005,100,,Invoice,,,,,,19/02/2018,19/02/2018,0.00,,35.59,,-709.67
,IN,AR,30308045,1005,100,,Invoice,,,,,,19/02/2018,19/02/2018,0.00,,7.12,,-716.79
,IN,AR,30308605,1005,100,,Invoice,,,,,,19/02/2018,19/02/2018,0.00,,35.59,,-752.38
,CS,AR,32001139,1005,100,,Cash sale,,,,,,22/02/2018,22/02/2018,0.00,,2.37,,-754.75
,IN,AR,30306712,1005,100,,Invoice,,,,,,22/02/2018,22/02/2018,0.00,,4.75,,-759.50
,IN,AR,30308190,1005,100,,Invoice,,,,,,22/02/2018,22/02/2018,0.00,,9.49,,-768.99
,CS,AR,32001403,1005,100,,Cash sale,,,,,,23/02/2018,23/02/2018,0.00,,7.12,,-776.11
,IN,AR,30308214,1005,100,,Invoice,,,,,,23/02/2018,23/02/2018,0.00,,4.75,,-780.86
,IN,AR,30308783,1005,100,,Invoice,,,,,,23/02/2018,23/02/2018,0.00,,18.98,,-799.84
,IN,AR,30308706,1005,100,,Invoice,,,,,,24/02/2018,24/02/2018,0.00,,7.12,,-806.96
,IN,AR,30308547,1005,100,,Invoice,,,,,,26/02/2018,26/02/2018,0.00,,9.49,,-816.45
,CS,AR,32000973,1005,100,,Cash sale,,,,,,27/02/2018,27/02/2018,0.00,,9.49,,-825.94
,IN,AR,30308554,1005,100,,Invoice,,,,,,27/02/2018,27/02/2018,0.00,,39.49,,-865.43
,CS,AR,32001386,1005,100,,Cash sale,,,,,,28/02/2018,28/02/2018,0.00,,11.86,,-877.29
,IN,AR,30307110,1005,100,,Invoice,,,,,,28/02/2018,28/02/2018,0.00,,7.12,,-884.41
,IN,AR,30307499,1005,100,,Invoice,,,,,,28/02/2018,28/02/2018,0.00,,17.80,,-902.21
,IN,AR,30307966,1005,100,,Invoice,,,,,,28/02/2018,28/02/2018,0.00,,9.49,,-911.70
,IN,AR,30308556,1005,100,,Invoice,,,,,,28/02/2018,28/02/2018,0.00,,18.98,,-930.68
,CN,AR,31017676,1005,100,,Credit Note,,,,,,01/03/2018,01/03/2018,18.98,,0.00,,-911.70
,CS,AR,32001937,1005,100,,Cash sale,,,,,,01/03/2018,01/03/2018,0.00,,2.37,,-914.07
,IN,AR,30310446,1005,100,,Invoice,,,,,,01/03/2018,01/03/2018,0.00,,4.75,,-918.82
,CN,AR,31017663,1005,100,,Credit Note,,,,,,02/03/2018,02/03/2018,14.24,,0.00,,-904.58
,CS,AR,32001757,1005,100,,Cash sale,,,,,,02/03/2018,02/03/2018,0.00,,11.86,,-916.44
,CS,AR,32001777,1005,100,,Cash sale,,,,,,02/03/2018,02/03/2018,0.00,,7.12,,-923.56
,IN,AR,30308906,1005,100,,Invoice,,,,,,02/03/2018,02/03/2018,0.00,,14.24,,-937.80
,IN,AR,30310900,1005,100,,Invoice,,,,,,02/03/2018,02/03/2018,0.00,,14.24,,-952.04
,IN,AR,30310903,1005,100,,Invoice,,,,,,02/03/2018,02/03/2018,0.00,,18.98,,-971.02
,CS,AR,32002200,1005,100,,Cash sale,,,,,,03/03/2018,03/03/2018,0.00,,7.12,,-978.14
,CS,AR,32002230,1005,100,,Cash sale,,,,,,03/03/2018,03/03/2018,0.00,,4.75,,-982.89
,CS,AR,32002443,1005,100,,Cash sale,,,,,,05/03/2018,05/03/2018,0.00,,13.36,,-996.25
,IN,AR,30310948,1005,100,,Invoice,,,,,,05/03/2018,05/03/2018,0.00,,18.98,,"-1,015.23"
,CN,AR,31017653,1005,100,,Credit Note,,,,,,06/03/2018,06/03/2018,18.98,,0.00,,-996.25
,IN,AR,30310833,1005,100,,Invoice,,,,,,06/03/2018,06/03/2018,0.00,,18.98,,"-1,015.23"
,IN,AR,30310174,1005,100,,Invoice,,,,,,07/03/2018,07/03/2018,0.00,,9.49,,"-1,024.72"
,IN,AR,30310557,1005,100,,Invoice,,,,,,07/03/2018,07/03/2018,0.00,,118.64,,"-1,143.36"
,CS,AR,32002403,1005,100,,Cash sale,,,,,,08/03/2018,08/03/2018,0.00,,4.75,,"-1,148.11"
,IN,AR,30308830,1005,100,,Invoice,,,,,,08/03/2018,08/03/2018,0.00,,7.12,,"-1,155.23"
,CS,AR,32002231,1005,100,,Cash sale,,,,,,09/03/2018,09/03/2018,0.00,,7.12,,"-1,162.35"
,IN,AR,30308931,1005,100,,Invoice,,,,,,09/03/2018,09/03/2018,0.00,,7.12,,"-1,169.47"
,IN,AR,30309006,1005,100,,Invoice,,,,,,09/03/2018,09/03/2018,0.00,,4.75,,"-1,174.22"
,IN,AR,30308879,1005,100,,Invoice,,,,,,13/03/2018,13/03/2018,0.00,,35.59,,"-1,209.81"
,CS,AR,32002398,1005,100,,Cash sale,,,,,,14/03/2018,14/03/2018,0.00,,16.61,,"-1,226.42"
,IN,AR,30310175,1005,100,,Invoice,,,,,,14/03/2018,14/03/2018,0.00,,9.49,,"-1,235.91"
,IN,AR,30310905,1005,100,,Invoice,,,,,,14/03/2018,14/03/2018,0.00,,18.98,,"-1,254.89"
,CS,AR,32001938,1005,100,,Cash sale,,,,,,15/03/2018,15/03/2018,0.00,,2.37,,"-1,257.26"
,CS,AR,32002147,1005,100,,Cash sale,,,,,,15/03/2018,15/03/2018,0.00,,14.24,,"-1,271.50"
,CS,AR,32002260,1005,100,,Cash sale,,,,,,15/03/2018,15/03/2018,0.00,,7.12,,"-1,278.62"
,CS,AR,32002404,1005,100,,Cash sale,,,,,,15/03/2018,15/03/2018,0.00,,4.75,,"-1,283.37"
,IN,AR,30309073,1005,100,,Invoice,,,,,,15/03/2018,15/03/2018,0.00,,9.49,,"-1,292.86"
,CS,AR,32002232,1005,100,,Cash sale,,,,,,16/03/2018,16/03/2018,0.00,,9.49,,"-1,302.35"
,IN,AR,30309160,1005,100,,Invoice,,,,,,19/03/2018,19/03/2018,0.00,,18.51,,"-1,320.86"
,CN,AR,31017498,1005,100,,Credit Note,,,,,,20/03/2018,20/03/2018,118.64,,0.00,,"-1,202.22"
,IN,AR,30309287,1005,100,,Invoice,,,,,,20/03/2018,20/03/2018,0.00,,118.64,,"-1,320.86"
,CS,AR,32001880,1005,100,,Cash sale,,,,,,21/03/2018,21/03/2018,0.00,,14.24,,"-1,335.10"
,CS,AR,32002405,1005,100,,Cash sale,,,,,,22/03/2018,22/03/2018,0.00,,4.75,,"-1,339.85"
,IN,AR,30310842,1005,100,,Invoice,,,,,,22/03/2018,22/03/2018,0.00,,18.98,,"-1,358.83"
,CS,AR,32002214,1005,100,,Cash sale,,,,,,23/03/2018,23/03/2018,0.00,,9.49,,"-1,368.32"
,IN,AR,30308907,1005,100,,Invoice,,,,,,23/03/2018,23/03/2018,0.00,,14.24,,"-1,382.56"
,IN,AR,30309997,1005,100,,Invoice,,,,,,23/03/2018,23/03/2018,0.00,,14.24,,"-1,396.80"
,IN,AR,30310176,1005,100,,Invoice,,,,,,23/03/2018,23/03/2018,0.00,,7.12,,"-1,403.92"
,IN,AR,30310265,1005,100,,Invoice,,,,,,23/03/2018,23/03/2018,0.00,,4.75,,"-1,408.67"
,CS,AR,32002233,1005,100,,Cash sale,,,,,,26/03/2018,26/03/2018,0.00,,7.12,,"-1,415.79"
,CS,AR,32002444,1005,100,,Cash sale,,,,,,26/03/2018,26/03/2018,0.00,,11.45,,"-1,427.24"
,CS,AR,32002533,1005,100,,Cash sale,,,,,,27/03/2018,27/03/2018,0.00,,7.12,,"-1,434.36"
,IN,AR,30309998,1005,100,,Invoice,,,,,,27/03/2018,27/03/2018,0.00,,14.24,,"-1,448.60"
,CS,AR,32001758,1005,100,,Cash sale,,,,,,29/03/2018,29/03/2018,0.00,,9.49,,"-1,458.09"
,IN,AR,30308831,1005,100,,Invoice,,,,,,29/03/2018,29/03/2018,0.00,,4.75,,"-1,462.84"
,IN,AR,30310447,1005,100,,Invoice,,,,,,29/03/2018,29/03/2018,0.00,,4.75,,"-1,467.59"
,IN,AR,30309031,1005,100,,Invoice,,,,,,31/03/2018,31/03/2018,0.00,,4.75,,"-1,472.34"
,IN,AR,30309668,1005,100,,Invoice,,,,,,31/03/2018,31/03/2018,0.00,,17.80,,"-1,490.14"
,CS,AR,32002669,1005,100,,Cash sale,,,,,,02/04/2018,02/04/2018,0.00,,9.49,,"-1,499.63"
,IN,AR,30313079,1005,100,,Invoice,,,,,,02/04/2018,02/04/2018,0.00,,18.98,,"-1,518.61"
,IN,AR,30313081,1005,100,,Invoice,,,,,,02/04/2018,02/04/2018,0.00,,18.98,,"-1,537.59"
,IN,AR,30313075,1005,100,,Invoice,,,,,,03/04/2018,03/04/2018,0.00,,9.49,,"-1,547.08"
,CS,AR,32003092,1005,100,,Cash sale,,,,,,04/04/2018,04/04/2018,0.00,,7.12,,"-1,554.20"
,IN,AR,30312279,1005,100,,Invoice,,,,,,04/04/2018,04/04/2018,0.00,,9.49,,"-1,563.69"
,CS,AR,32002821,1005,100,,Cash sale,,,,,,05/04/2018,05/04/2018,0.00,,2.37,,"-1,566.06"
,CS,AR,32003252,1005,100,,Cash sale,,,,,,05/04/2018,05/04/2018,0.00,,4.75,,"-1,570.81"
,CS,AR,32002788,1005,100,,Cash sale,,,,,,06/04/2018,06/04/2018,0.00,,7.12,,"-1,577.93"
,IN,AR,30311326,1005,100,,Invoice,,,,,,06/04/2018,06/04/2018,0.00,,118.64,,"-1,696.57"
,IN,AR,30312848,1005,100,,Invoice,,,,,,06/04/2018,06/04/2018,0.00,,49.36,,"-1,745.93"
,IN,AR,30311506,1005,100,,Invoice,,,,,,09/04/2018,09/04/2018,0.00,,14.24,,"-1,760.17"
,CN,AR,31017749,1005,100,,Credit Note,,,,,,11/04/2018,11/04/2018,17.80,,0.00,,"-1,742.37"
,CS,AR,32002704,1005,100,,Cash sale,,,,,,11/04/2018,11/04/2018,0.00,,4.75,,"-1,747.12"
,IN,AR,30311172,1005,100,,Invoice,,,,,,11/04/2018,11/04/2018,0.00,,9.49,,"-1,756.61"
,IN,AR,30312199,1005,100,,Invoice,,,,,,11/04/2018,11/04/2018,0.00,,17.80,,"-1,774.41"
,IN,AR,30312280,1005,100,,Invoice,,,,,,11/04/2018,11/04/2018,0.00,,9.49,,"-1,783.90"
,IN,AR,30312492,1005,100,,Invoice,,,,,,11/04/2018,11/04/2018,0.00,,9.49,,"-1,793.39"
,CN,AR,31017790,1005,100,,Credit Note,,,,,,12/04/2018,12/04/2018,9.49,,0.00,,"-1,783.90"
,CS,AR,32003073,1005,100,,Cash sale,,,,,,12/04/2018,12/04/2018,0.00,,11.86,,"-1,795.76"
,CS,AR,32003253,1005,100,,Cash sale,,,,,,12/04/2018,12/04/2018,0.00,,4.75,,"-1,800.51"
,IN,AR,30313918,1005,100,,Invoice,,,,,,12/04/2018,12/04/2018,0.00,,7.12,,"-1,807.63"
,CS,AR,32003093,1005,100,,Cash sale,,,,,,13/04/2018,13/04/2018,0.00,,7.12,,"-1,814.75"
,IN,AR,30311416,1005,100,,Invoice,,,,,,13/04/2018,13/04/2018,0.00,,18.51,,"-1,833.26"
,IN,AR,30312281,1005,100,,Invoice,,,,,,13/04/2018,13/04/2018,0.00,,9.49,,"-1,842.75"
,IN,AR,30312849,1005,100,,Invoice,,,,,,13/04/2018,13/04/2018,0.00,,18.98,,"-1,861.73"
,IN,AR,30313097,1005,100,,Invoice,,,,,,13/04/2018,13/04/2018,0.00,,18.98,,"-1,880.71"
,IN,AR,30313076,1005,100,,Invoice,,,,,,14/04/2018,14/04/2018,0.00,,18.98,,"-1,899.69"
,CS,AR,32002670,1005,100,,Cash sale,,,,,,16/04/2018,16/04/2018,0.00,,9.49,,"-1,909.18"
,IN,AR,30312638,1005,100,,Invoice,,,,,,16/04/2018,16/04/2018,0.00,,13.36,,"-1,922.54"
,CS,AR,32003412,1005,100,,Cash sale,,,,,,17/04/2018,17/04/2018,0.00,,4.75,,"-1,927.29"
,IN,AR,30312839,1005,100,,Invoice,,,,,,18/04/2018,18/04/2018,0.00,,9.49,,"-1,936.78"
,CS,AR,32002709,1005,100,,Cash sale,,,,,,19/04/2018,19/04/2018,0.00,,7.12,,"-1,943.90"
,CS,AR,32003254,1005,100,,Cash sale,,,,,,19/04/2018,19/04/2018,0.00,,7.12,,"-1,951.02"
,IN,AR,30312352,1005,100,,Invoice,,,,,,19/04/2018,19/04/2018,0.00,,7.12,,"-1,958.14"
,CS,AR,32003094,1005,100,,Cash sale,,,,,,20/04/2018,20/04/2018,0.00,,7.12,,"-1,965.26"
,IN,AR,30312021,1005,100,,Invoice,,,,,,20/04/2018,20/04/2018,0.00,,9.49,,"-1,974.75"
,CS,AR,32002781,1005,100,,Cash sale,,,,,,23/04/2018,23/04/2018,0.00,,7.12,,"-1,981.87"
,IN,AR,30311477,1005,100,,Invoice,,,,,,24/04/2018,24/04/2018,0.00,,14.24,,"-1,996.11"
,IN,AR,30312098,1005,100,,Invoice,,,,,,24/04/2018,24/04/2018,0.00,,7.12,,"-2,003.23"
,IN,AR,30312124,1005,100,,Invoice,,,,,,24/04/2018,24/04/2018,0.00,,11.86,,"-2,015.09"
,CS,AR,32003069,1005,100,,Cash sale,,,,,,26/04/2018,26/04/2018,0.00,,9.49,,"-2,024.58"
,CS,AR,32003255,1005,100,,Cash sale,,,,,,26/04/2018,26/04/2018,0.00,,9.49,,"-2,034.07"
,IN,AR,30311509,1005,100,,Invoice,,,,,,26/04/2018,26/04/2018,0.00,,4.75,,"-2,038.82"
,CS,AR,32003095,1005,100,,Cash sale,,,,,,27/04/2018,27/04/2018,0.00,,7.12,,"-2,045.94"
,IN,AR,30312282,1005,100,,Invoice,,,,,,27/04/2018,27/04/2018,0.00,,7.12,,"-2,053.06"
,CS,AR,32003569,1005,100,,Cash sale,,,,,,27/04/2018,27/04/2018,0.00,,2.37,,"-2,055.43"
,IN,AR,30313173,1005,100,,Invoice,,,,,,27/04/2018,27/04/2018,0.00,,9.49,,"-2,064.92"
,IN,AR,30314464,1005,100,,Invoice,,,,,,27/04/2018,27/04/2018,0.00,,11.86,,"-2,076.78"
,IN,AR,30313643,1005,100,,Invoice,,,,,,30/04/2018,30/04/2018,0.00,,22.25,,"-2,099.03"
,IN,AR,30314211,1005,100,,Invoice,,,,,,30/04/2018,30/04/2018,0.00,,118.64,,"-2,217.67"
,CS,AR,32003857,1005,100,,Cash sale,,,,,,03/05/2018,03/05/2018,0.00,,4.75,,"-2,222.42"
,CS,AR,32003933,1005,100,,Cash sale,,,,,,03/05/2018,03/05/2018,0.00,,4.75,,"-2,227.17"
,CS,AR,32004625,1005,100,,Cash sale,,,,,,03/05/2018,03/05/2018,0.00,,4.75,,"-2,231.92"
,CS,AR,32003462,1005,100,,Cash sale,,,,,,04/05/2018,04/05/2018,0.00,,14.24,,"-2,246.16"
,CS,AR,32003476,1005,100,,Cash sale,,,,,,04/05/2018,04/05/2018,0.00,,4.75,,"-2,250.91"
,CS,AR,32003760,1005,100,,Cash sale,,,,,,04/05/2018,04/05/2018,0.00,,7.12,,"-2,258.03"
,IN,AR,30313187,1005,100,,Invoice,,,,,,05/05/2018,05/05/2018,0.00,,11.86,,"-2,269.89"
,CS,AR,32003477,1005,100,,Cash sale,,,,,,07/05/2018,07/05/2018,0.00,,7.12,,"-2,277.01"
,IN,AR,30313959,1005,100,,Invoice,,,,,,07/05/2018,07/05/2018,0.00,,7.12,,"-2,284.13"
,CS,AR,32003461,1005,100,,Cash sale,,,,,,08/05/2018,08/05/2018,0.00,,11.86,,"-2,295.99"
,IN,AR,30313390,1005,100,,Invoice,,,,,,08/05/2018,08/05/2018,0.00,,35.59,,"-2,331.58"
,IN,AR,30313919,1005,100,,Invoice,,,,,,08/05/2018,08/05/2018,0.00,,7.12,,"-2,338.70"
,IN,AR,30313960,1005,100,,Invoice,,,,,,09/05/2018,09/05/2018,0.00,,9.49,,"-2,348.19"
,IN,AR,30314013,1005,100,,Invoice,,,,,,09/05/2018,09/05/2018,0.00,,7.12,,"-2,355.31"
,IN,AR,30314565,1005,100,,Invoice,,,,,,09/05/2018,09/05/2018,0.00,,5.14,,"-2,360.45"
,CS,AR,32003858,1005,100,,Cash sale,,,,,,10/05/2018,10/05/2018,0.00,,4.75,,"-2,365.20"
,CS,AR,32003570,1005,100,,Cash sale,,,,,,11/05/2018,11/05/2018,0.00,,2.37,,"-2,367.57"
,CS,AR,32003761,1005,100,,Cash sale,,,,,,11/05/2018,11/05/2018,0.00,,7.12,,"-2,374.69"
,CS,AR,32003959,1005,100,,Cash sale,,,,,,11/05/2018,11/05/2018,0.00,,4.97,,"-2,379.66"
,CS,AR,32003749,1005,100,,Cash sale,,,,,,14/05/2018,14/05/2018,0.00,,14.24,,"-2,393.90"
,IN,AR,30314194,1005,100,,Invoice,,,,,,14/05/2018,14/05/2018,0.00,,13.36,,"-2,407.26"
,CS,AR,32004072,1005,100,,Cash sale,,,,,,16/05/2018,16/05/2018,0.00,,4.75,,"-2,412.01"
,IN,AR,30315101,1005,100,,Invoice,,,,,,16/05/2018,16/05/2018,0.00,,7.12,,"-2,419.13"
,IN,AR,30315367,1005,100,,Invoice,,,,,,16/05/2018,16/05/2018,0.00,,7.12,,"-2,426.25"
,CS,AR,32004296,1005,100,,Cash sale,,,,,,17/05/2018,17/05/2018,0.00,,4.75,,"-2,431.00"
,IN,AR,30314593,1005,100,,Invoice,,,,,,17/05/2018,17/05/2018,0.00,,4.75,,"-2,435.75"
,CS,AR,32004037,1005,100,,Cash sale,,,,,,18/05/2018,18/05/2018,0.00,,9.49,,"-2,445.24"
,CS,AR,32004051,1005,100,,Cash sale,,,,,,18/05/2018,18/05/2018,0.00,,7.12,,"-2,452.36"
,CS,AR,32004232,1005,100,,Cash sale,,,,,,18/05/2018,18/05/2018,0.00,,7.12,,"-2,459.48"
,IN,AR,30315369,1005,100,,Invoice,,,,,,18/05/2018,18/05/2018,0.00,,18.98,,"-2,478.46"
,IN,AR,30315429,1005,100,,Invoice,,,,,,18/05/2018,18/05/2018,0.00,,11.86,,"-2,490.32"
,IN,AR,30315266,1005,100,,Invoice,,,,,,21/05/2018,21/05/2018,0.00,,35.59,,"-2,525.91"
,IN,AR,30314736,1005,100,,Invoice,,,,,,22/05/2018,22/05/2018,0.00,,55.53,,"-2,581.44"
,IN,AR,30315025,1005,100,,Invoice,,,,,,22/05/2018,22/05/2018,0.00,,7.12,,"-2,588.56"
,CS,AR,32004116,1005,100,,Cash sale,,,,,,24/05/2018,24/05/2018,0.00,,2.37,,"-2,590.93"
,CS,AR,32004297,1005,100,,Cash sale,,,,,,24/05/2018,24/05/2018,0.00,,4.75,,"-2,595.68"
,IN,AR,30314994,1005,100,,Invoice,,,,,,24/05/2018,24/05/2018,0.00,,18.98,,"-2,614.66"
,IN,AR,30315137,1005,100,,Invoice,,,,,,24/05/2018,24/05/2018,0.00,,14.24,,"-2,628.90"
,IN,AR,30315201,1005,100,,Invoice,,,,,,24/05/2018,24/05/2018,0.00,,9.49,,"-2,638.39"
,CS,AR,32004233,1005,100,,Cash sale,,,,,,25/05/2018,25/05/2018,0.00,,7.12,,"-2,645.51"
,IN,AR,30315102,1005,100,,Invoice,,,,,,25/05/2018,25/05/2018,0.00,,7.12,,"-2,652.63"
,IN,AR,30316103,1005,100,,Invoice,,,,,,25/05/2018,25/05/2018,0.00,,23.73,,"-2,676.36"
,CS,AR,32004550,1005,100,,Cash sale,,,,,,29/05/2018,29/05/2018,0.00,,2.37,,"-2,678.73"
,CS,AR,32004568,1005,100,,Cash sale,,,,,,29/05/2018,29/05/2018,0.00,,7.12,,"-2,685.85"
,CS,AR,32004451,1005,100,,Cash sale,,,,,,31/05/2018,31/05/2018,0.00,,11.86,,"-2,697.71"
,CS,AR,32004554,1005,100,,Cash sale,,,,,,31/05/2018,31/05/2018,0.00,,9.49,,"-2,707.20"
,CS,AR,32004626,1005,100,,Cash sale,,,,,,31/05/2018,31/05/2018,0.00,,4.75,,"-2,711.95"
,IN,AR,30315732,1005,100,,Invoice,,,,,,31/05/2018,31/05/2018,0.00,,10.38,,"-2,722.33"
,IN,AR,30315758,1005,100,,Invoice,,,,,,31/05/2018,31/05/2018,0.00,,56.95,,"-2,779.28"
,IN,AR,30315818,1005,100,,Invoice,,,,,,31/05/2018,31/05/2018,0.00,,14.24,,"-2,793.52"
,CS,AR,32004677,1005,100,,Cash sale,,,,,,01/06/2018,01/06/2018,0.00,,7.12,,"-2,800.64"
,CS,AR,32004704,1005,100,,Cash sale,,,,,,01/06/2018,01/06/2018,0.00,,14.24,,"-2,814.88"
,CS,AR,32004791,1005,100,,Cash sale,,,,,,01/06/2018,01/06/2018,0.00,,7.12,,"-2,822.00"
,IN,AR,30316399,1005,100,,Invoice,,,,,,01/06/2018,01/06/2018,0.00,,7.12,,"-2,829.12"
,IN,AR,30316505,1005,100,,Invoice,,,,,,01/06/2018,01/06/2018,0.00,,39.49,,"-2,868.61"
,CS,AR,32004673,1005,100,,Cash sale,,,,,,04/06/2018,04/06/2018,0.00,,9.49,,"-2,878.10"
,IN,AR,30316163,1005,100,,Invoice,,,,,,04/06/2018,04/06/2018,0.00,,118.64,,"-2,996.74"
,CS,AR,32004782,1005,100,,Cash sale,,,,,,05/06/2018,05/06/2018,0.00,,4.75,,"-3,001.49"
,IN,AR,30316525,1005,100,,Invoice,,,,,,05/06/2018,05/06/2018,0.00,,2.37,,"-3,003.86"
,CS,AR,32004936,1005,100,,Cash sale,,,,,,08/06/2018,08/06/2018,0.00,,7.12,,"-3,010.98"
,CS,AR,32004949,1005,100,,Cash sale,,,,,,08/06/2018,08/06/2018,0.00,,7.12,,"-3,018.10"
,CS,AR,32004950,1005,100,,Cash sale,,,,,,08/06/2018,08/06/2018,0.00,,4.75,,"-3,022.85"
,CS,AR,32004963,1005,100,,Cash sale,,,,,,08/06/2018,08/06/2018,0.00,,9.49,,"-3,032.34"
,IN,AR,30316660,1005,100,,Invoice,,,,,,08/06/2018,08/06/2018,0.00,,7.12,,"-3,039.46"
,CS,AR,32005192,1005,100,,Cash sale,,,,,,11/06/2018,11/06/2018,0.00,,11.45,,"-3,050.91"
,CS,AR,32005225,1005,100,,Cash sale,,,,,,11/06/2018,11/06/2018,0.00,,7.12,,"-3,058.03"
,CN,AR,31018208,1005,100,,Credit Note,,,,,,12/06/2018,12/06/2018,23.73,,0.00,,"-3,034.30"
,CS,AR,32004991,1005,100,,Cash sale,,,,,,12/06/2018,12/06/2018,0.00,,7.12,,"-3,041.42"
,IN,AR,30316792,1005,100,,Invoice,,,,,,12/06/2018,12/06/2018,0.00,,35.59,,"-3,077.01"
,CS,AR,32004997,1005,100,,Cash sale,,,,,,13/06/2018,13/06/2018,0.00,,7.12,,"-3,084.13"
,CS,AR,32005228,1005,100,,Cash sale,,,,,,13/06/2018,13/06/2018,0.00,,2.37,,"-3,086.50"
,IN,AR,30317219,1005,100,,Invoice,,,,,,13/06/2018,13/06/2018,0.00,,7.12,,"-3,093.62"
,CS,AR,32005143,1005,100,,Cash sale,,,,,,14/06/2018,14/06/2018,0.00,,7.12,,"-3,100.74"
,CS,AR,32005180,1005,100,,Cash sale,,,,,,14/06/2018,14/06/2018,0.00,,4.75,,"-3,105.49"
,CS,AR,32004992,1005,100,,Cash sale,,,,,,15/06/2018,15/06/2018,0.00,,11.86,,"-3,117.35"
,CS,AR,32005046,1005,100,,Cash sale,,,,,,15/06/2018,15/06/2018,0.00,,2.37,,"-3,119.72"
,CS,AR,32005136,1005,100,,Cash sale,,,,,,15/06/2018,15/06/2018,0.00,,7.12,,"-3,126.84"
,IN,AR,30316793,1005,100,,Invoice,,,,,,15/06/2018,15/06/2018,0.00,,35.59,,"-3,162.43"
,CS,AR,32005718,1005,100,,Cash sale,,,,,,18/06/2018,18/06/2018,0.00,,23.73,,"-3,186.16"
,IN,AR,30318461,1005,100,,Invoice,,,,,,18/06/2018,18/06/2018,0.00,,11.86,,"-3,198.02"
,CS,AR,32005322,1005,100,,Cash sale,,,,,,19/06/2018,19/06/2018,0.00,,7.12,,"-3,205.14"
,IN,AR,30317956,1005,100,,Invoice,,,,,,19/06/2018,19/06/2018,0.00,,7.12,,"-3,212.26"
,CS,AR,32005720,1005,100,,Cash sale,,,,,,20/06/2018,20/06/2018,0.00,,7.12,,"-3,219.38"
,IN,AR,30317440,1005,100,,Invoice,,,,,,20/06/2018,20/06/2018,0.00,,11.86,,"-3,231.24"
,IN,AR,30318055,1005,100,,Invoice,,,,,,20/06/2018,20/06/2018,0.00,,9.49,,"-3,240.73"
,IN,AR,30318098,1005,100,,Invoice,,,,,,20/06/2018,20/06/2018,0.00,,9.49,,"-3,250.22"
,CS,AR,32005371,1005,100,,Cash sale,,,,,,21/06/2018,21/06/2018,0.00,,11.86,,"-3,262.08"
,IN,AR,30318179,1005,100,,Invoice,,,,,,21/06/2018,21/06/2018,0.00,,2.37,,"-3,264.45"
,CS,AR,32005537,1005,100,,Cash sale,,,,,,22/06/2018,22/06/2018,0.00,,9.49,,"-3,273.94"
,IN,AR,30318379,1005,100,,Invoice,,,,,,22/06/2018,22/06/2018,0.00,,18.98,,"-3,292.92"
,CS,AR,32005279,1005,100,,Cash sale,,,,,,25/06/2018,25/06/2018,0.00,,9.49,,"-3,302.41"
,IN,AR,30318235,1005,100,,Invoice,,,,,,25/06/2018,25/06/2018,0.00,,35.59,,"-3,338.00"
,CS,AR,32005517,1005,100,,Cash sale,,,,,,26/06/2018,26/06/2018,0.00,,7.12,,"-3,345.12"
,CS,AR,32005756,1005,100,,Cash sale,,,,,,26/06/2018,26/06/2018,0.00,,9.49,,"-3,354.61"
,IN,AR,30317470,1005,100,,Invoice,,,,,,26/06/2018,26/06/2018,0.00,,11.86,,"-3,366.47"
,IN,AR,30318380,1005,100,,Invoice,,,,,,26/06/2018,26/06/2018,0.00,,18.98,,"-3,385.45"
,CS,AR,32005268,1005,100,,Cash sale,,,,,,27/06/2018,27/06/2018,0.00,,4.75,,"-3,390.20"
,CS,AR,32005392,1005,100,,Cash sale,,,,,,27/06/2018,27/06/2018,0.00,,2.37,,"-3,392.57"
,CS,AR,32005525,1005,100,,Cash sale,,,,,,27/06/2018,27/06/2018,0.00,,11.86,,"-3,404.43"
,CS,AR,32005625,1005,100,,Cash sale,,,,,,27/06/2018,27/06/2018,0.00,,4.75,,"-3,409.18"
,CS,AR,32005699,1005,100,,Cash sale,,,,,,27/06/2018,27/06/2018,0.00,,7.12,,"-3,416.30"
,IN,AR,30318056,1005,100,,Invoice,,,,,,27/06/2018,27/06/2018,0.00,,7.12,,"-3,423.42"
,IN,AR,30318523,1005,100,,Invoice,,,,,,28/06/2018,28/06/2018,0.00,,5.14,,"-3,428.56"
,IN,AR,30317784,1005,100,,Invoice,,,,,,30/06/2018,30/06/2018,0.00,,11.86,,"-3,440.42"
,CS,AR,32005779,1005,100,,Cash sale,,,,,,02/07/2018,02/07/2018,0.00,,9.49,,"-3,449.91"
,IN,AR,30318608,1005,100,,Invoice,,,,,,02/07/2018,02/07/2018,0.00,,35.59,,"-3,485.50"
,IN,AR,30318714,1005,100,,Invoice,,,,,,02/07/2018,02/07/2018,0.00,,9.49,,"-3,494.99"
,CS,AR,32006003,1005,100,,Cash sale,,,,,,03/07/2018,03/07/2018,0.00,,7.12,,"-3,502.11"
,CS,AR,32006013,1005,100,,Cash sale,,,,,,03/07/2018,03/07/2018,0.00,,7.45,,"-3,509.56"
,IN,AR,30319123,1005,100,,Invoice,,,,,,03/07/2018,03/07/2018,0.00,,35.59,,"-3,545.15"
,IN,AR,30318953,1005,100,,Invoice,,,,,,04/07/2018,04/07/2018,0.00,,7.12,,"-3,552.27"
,IN,AR,30319129,1005,100,,Invoice,,,,,,04/07/2018,04/07/2018,0.00,,47.39,,"-3,599.66"
,CS,AR,32005916,1005,100,,Cash sale,,,,,,05/07/2018,05/07/2018,0.00,,7.12,,"-3,606.78"
,CS,AR,32005960,1005,100,,Cash sale,,,,,,05/07/2018,05/07/2018,0.00,,4.75,,"-3,611.53"
,IN,AR,30318700,1005,100,,Invoice,,,,,,05/07/2018,05/07/2018,0.00,,2.37,,"-3,613.90"
,IN,AR,30318981,1005,100,,Invoice,,,,,,05/07/2018,05/07/2018,0.00,,14.24,,"-3,628.14"
,IN,AR,30319020,1005,100,,Invoice,,,,,,05/07/2018,05/07/2018,0.00,,9.49,,"-3,637.63"
,CN,AR,31018346,1005,100,,Credit Note,,,,,,06/07/2018,06/07/2018,18.98,,0.00,,"-3,618.65"
,CS,AR,32005771,1005,100,,Cash sale,,,,,,06/07/2018,06/07/2018,0.00,,9.49,,"-3,628.14"
,CS,AR,32005909,1005,100,,Cash sale,,,,,,06/07/2018,06/07/2018,0.00,,7.12,,"-3,635.26"
,IN,AR,30318692,1005,100,,Invoice,,,,,,06/07/2018,06/07/2018,0.00,,14.24,,"-3,649.50"
,CS,AR,32006044,1005,100,,Cash sale,,,,,,09/07/2018,09/07/2018,0.00,,7.12,,"-3,656.62"
,CS,AR,32006059,1005,100,,Cash sale,,,,,,09/07/2018,09/07/2018,0.00,,14.24,,"-3,670.86"
,CS,AR,32006095,1005,100,,Cash sale,,,,,,09/07/2018,09/07/2018,0.00,,13.36,,"-3,684.22"
,IN,AR,30319340,1005,100,,Invoice,,,,,,09/07/2018,09/07/2018,0.00,,7.12,,"-3,691.34"
,CS,AR,32006353,1005,100,,Cash sale,,,,,,10/07/2018,10/07/2018,0.00,,7.12,,"-3,698.46"
,CS,AR,32006123,1005,100,,Cash sale,,,,,,11/07/2018,11/07/2018,0.00,,9.49,,"-3,707.95"
,IN,AR,30319923,1005,100,,Invoice,,,,,,11/07/2018,11/07/2018,0.00,,7.12,,"-3,715.07"
,IN,AR,30320305,1005,100,,Invoice,,,,,,11/07/2018,11/07/2018,0.00,,4.75,,"-3,719.82"
,CS,AR,32006451,1005,100,,Cash sale,,,,,,12/07/2018,12/07/2018,0.00,,2.37,,"-3,722.19"
,CS,AR,32006514,1005,100,,Cash sale,,,,,,12/07/2018,12/07/2018,0.00,,7.12,,"-3,729.31"
,IN,AR,30320241,1005,100,,Invoice,,,,,,12/07/2018,12/07/2018,0.00,,14.24,,"-3,743.55"
,IN,AP,40002433,9000,900,,Invoice,,,,,SB,12/07/2018,12/07/2018,29.64,,0.00,,"-3,713.91"
,CS,AR,32006138,1005,100,,Cash sale,,,,,,13/07/2018,13/07/2018,0.00,,21.36,,"-3,735.27"
,CS,AR,32006371,1005,100,,Cash sale,,,,,,13/07/2018,13/07/2018,0.00,,7.12,,"-3,742.39"
,CN,AR,31018390,1005,100,,Credit Note,,,,,,16/07/2018,16/07/2018,18.98,,0.00,,"-3,723.41"
,CS,AR,32006361,1005,100,,Cash sale,,,,,,16/07/2018,16/07/2018,0.00,,14.24,,"-3,737.65"
,CS,AR,32006447,1005,100,,Cash sale,,,,,,16/07/2018,16/07/2018,0.00,,18.98,,"-3,756.63"
,IN,AR,30319605,1005,100,,Invoice,,,,,,16/07/2018,16/07/2018,0.00,,7.12,,"-3,763.75"
,CS,AR,32006155,1005,100,,Cash sale,,,,,,17/07/2018,17/07/2018,0.00,,9.49,,"-3,773.24"
,CS,AR,32006239,1005,100,,Cash sale,,,,,,17/07/2018,17/07/2018,0.00,,2.37,,"-3,775.61"
,CS,AR,32006354,1005,100,,Cash sale,,,,,,17/07/2018,17/07/2018,0.00,,7.12,,"-3,782.73"
,IN,AP,40002439,9000,900,,Invoice,,,,,SB,17/07/2018,17/07/2018,46.80,,0.00,,"-3,735.93"
,CS,AR,32006134,1005,100,,Cash sale,,,,,,18/07/2018,18/07/2018,0.00,,7.12,,"-3,743.05"
,CS,AR,32006503,1005,100,,Cash sale,,,,,,18/07/2018,18/07/2018,0.00,,7.12,,"-3,750.17"
,IN,AR,30319377,1005,100,,Invoice,,,,,,18/07/2018,18/07/2018,0.00,,7.12,,"-3,757.29"
,IN,AR,30319895,1005,100,,Invoice,,,,,,19/07/2018,19/07/2018,0.00,,7.12,,"-3,764.41"
,IN,AR,30320014,1005,100,,Invoice,,,,,,19/07/2018,19/07/2018,0.00,,4.75,,"-3,769.16"
,CS,AR,32006841,1005,100,,Cash sale,,,,,,20/07/2018,20/07/2018,0.00,,9.49,,"-3,778.65"
,CS,AR,32007010,1005,100,,Cash sale,,,,,,20/07/2018,20/07/2018,0.00,,23.73,,"-3,802.38"
,CS,AR,32007035,1005,100,,Cash sale,,,,,,20/07/2018,20/07/2018,0.00,,5.14,,"-3,807.52"
,IN,AR,30320530,1005,100,,Invoice,,,,,,20/07/2018,20/07/2018,0.00,,35.59,,"-3,843.11"
,IN,AR,30320959,1005,100,,Invoice,,,,,,20/07/2018,20/07/2018,0.00,,7.12,,"-3,850.23"
,IN,AR,30321063,1005,100,,Invoice,,,,,,20/07/2018,20/07/2018,0.00,,18.98,,"-3,869.21"
,IN,AR,30321234,1005,100,,Invoice,,,,,,20/07/2018,20/07/2018,0.00,,18.98,,"-3,888.19"
,IN,AR,30321389,1005,100,,Invoice,,,,,,20/07/2018,20/07/2018,0.00,,9.49,,"-3,897.68"
,IN,AR,30321415,1005,100,,Invoice,,,,,,20/07/2018,20/07/2018,0.00,,7.12,,"-3,904.80"
,IN,AP,40002446,9000,900,,Invoice,,,,,SB,20/07/2018,20/07/2018,28.86,,0.00,,"-3,875.94"
,CN,AR,31018487,1005,100,,Credit Note,,,,,,21/07/2018,21/07/2018,9.49,,0.00,,"-3,866.45"
,CN,AR,31018488,1005,100,,Credit Note,,,,,,21/07/2018,21/07/2018,37.97,,0.00,,"-3,828.48"
,IN,AR,30321229,1005,100,,Invoice,,,,,,21/07/2018,21/07/2018,0.00,,7.12,,"-3,835.60"
,IN,AR,30321391,1005,100,,Invoice,,,,,,21/07/2018,21/07/2018,0.00,,9.49,,"-3,845.09"
,IN,AR,30321392,1005,100,,Invoice,,,,,,21/07/2018,21/07/2018,0.00,,9.49,,"-3,854.58"
,IN,AR,30321393,1005,100,,Invoice,,,,,,21/07/2018,21/07/2018,0.00,,9.49,,"-3,864.07"
,IN,AR,30321394,1005,100,,Invoice,,,,,,21/07/2018,21/07/2018,0.00,,9.49,,"-3,873.56"
,IN,AR,30321395,1005,100,,Invoice,,,,,,21/07/2018,21/07/2018,0.00,,9.49,,"-3,883.05"
,IN,AR,30320456,1005,100,,Invoice,,,,,,23/07/2018,23/07/2018,0.00,,11.86,,"-3,894.91"
,CS,AR,32006802,1005,100,,Cash sale,,,,,,25/07/2018,25/07/2018,0.00,,4.75,,"-3,899.66"
,IN,AR,30321230,1005,100,,Invoice,,,,,,25/07/2018,25/07/2018,0.00,,9.49,,"-3,909.15"
,IN,AP,40002454,9000,900,,Invoice,,,,,SB,25/07/2018,25/07/2018,47.58,,0.00,,"-3,861.57"
,CS,AR,32006569,1005,100,,Cash sale,,,,,,26/07/2018,26/07/2018,0.00,,7.12,,"-3,868.69"
,CS,AR,32006923,1005,100,,Cash sale,,,,,,26/07/2018,26/07/2018,0.00,,2.37,,"-3,871.06"
,IN,AR,30320874,1005,100,,Invoice,,,,,,26/07/2018,26/07/2018,0.00,,14.24,,"-3,885.30"
,IN,AR,30321416,1005,100,,Invoice,,,,,,26/07/2018,26/07/2018,0.00,,18.98,,"-3,904.28"
,CS,AR,32006584,1005,100,,Cash sale,,,,,,27/07/2018,27/07/2018,0.00,,11.86,,"-3,916.14"
,CS,AR,32006664,1005,100,,Cash sale,,,,,,27/07/2018,27/07/2018,0.00,,11.86,,"-3,928.00"
,CS,AR,32006687,1005,100,,Cash sale,,,,,,27/07/2018,27/07/2018,0.00,,2.37,,"-3,930.37"
,CS,AR,32006842,1005,100,,Cash sale,,,,,,27/07/2018,27/07/2018,0.00,,9.49,,"-3,939.86"
,IN,AR,30321233,1005,100,,Invoice,,,,,,27/07/2018,27/07/2018,0.00,,39.49,,"-3,979.35"
,CS,AR,32006579,1005,100,,Cash sale,,,,,,30/07/2018,30/07/2018,0.00,,2.37,,"-3,981.72"
,CS,AR,32006938,1005,100,,Cash sale,,,,,,30/07/2018,30/07/2018,0.00,,15.26,,"-3,996.98"
,IN,AR,30320960,1005,100,,Invoice,,,,,,30/07/2018,30/07/2018,0.00,,7.12,,"-4,004.10"
,CS,AR,32006823,1005,100,,Cash sale,,,,,,31/07/2018,31/07/2018,0.00,,7.12,,"-4,011.22"
,IN,AR,30321711,1005,100,,Invoice,,,,,,31/07/2018,31/07/2018,0.00,,23.73,,"-4,034.95"
,IN,AP,40002463,9000,900,,Invoice,,,,,SB,31/07/2018,31/07/2018,28.08,,0.00,,"-4,006.87"
,CS,AR,32007069,1005,100,,Cash sale,,,,,,01/08/2018,01/08/2018,0.00,,7.12,,"-4,013.99"
,CS,AR,32007306,1005,100,,Cash sale,,,,,,01/08/2018,01/08/2018,0.00,,7.12,,"-4,021.11"
,IN,AP,40002465,9000,900,,Invoice,,,,,SB,01/08/2018,01/08/2018,37.44,,0.00,,"-3,983.67"
,CS,AR,32007082,1005,100,,Cash sale,,,,,,02/08/2018,02/08/2018,0.00,,9.49,,"-3,993.16"
,CS,AR,32007250,1005,100,,Cash sale,,,,,,02/08/2018,02/08/2018,0.00,,4.75,,"-3,997.91"
,IN,AR,30321999,1005,100,,Invoice,,,,,,02/08/2018,02/08/2018,0.00,,18.98,,"-4,016.89"
,CS,AR,32007132,1005,100,,Cash sale,,,,,,03/08/2018,03/08/2018,0.00,,2.37,,"-4,019.26"
,CS,AR,32007205,1005,100,,Cash sale,,,,,,03/08/2018,03/08/2018,0.00,,9.49,,"-4,028.75"
,CS,AR,32007211,1005,100,,Cash sale,,,,,,03/08/2018,03/08/2018,0.00,,7.12,,"-4,035.87"
,CS,AR,32007285,1005,100,,Cash sale,,,,,,03/08/2018,03/08/2018,0.00,,7.12,,"-4,042.99"
,IN,AR,30321809,1005,100,,Invoice,,,,,,03/08/2018,03/08/2018,0.00,,14.24,,"-4,057.23"
,IN,AR,30322120,1005,100,,Invoice,,,,,,03/08/2018,03/08/2018,0.00,,14.24,,"-4,071.47"
,CN,AR,31018541,1005,100,,Credit Note,,,,,,06/08/2018,06/08/2018,9.49,,0.00,,"-4,061.98"
,IN,AR,30322087,1005,100,,Invoice,,,,,,06/08/2018,06/08/2018,0.00,,9.49,,"-4,071.47"
,CS,AR,32007342,1005,100,,Cash sale,,,,,,07/08/2018,07/08/2018,0.00,,5.14,,"-4,076.61"
,IN,AR,30322208,1005,100,,Invoice,,,,,,07/08/2018,07/08/2018,0.00,,7.12,,"-4,083.73"
,IN,AR,30322353,1005,100,,Invoice,,,,,,08/08/2018,08/08/2018,0.00,,9.49,,"-4,093.22"
,IN,AR,30322934,1005,100,,Invoice,,,,,,08/08/2018,08/08/2018,0.00,,9.49,,"-4,102.71"
,IN,AR,30323298,1005,100,,Invoice,,,,,,08/08/2018,08/08/2018,0.00,,2.37,,"-4,105.08"
,IN,AR,30323303,1005,100,,Invoice,,,,,,08/08/2018,08/08/2018,0.00,,2.37,,"-4,107.45"
,IN,AR,30323305,1005,100,,Invoice,,,,,,08/08/2018,08/08/2018,0.00,,2.37,,"-4,109.82"
,IN,AR,30323309,1005,100,,Invoice,,,,,,08/08/2018,08/08/2018,0.00,,4.75,,"-4,114.57"
,CS,AR,32007654,1005,100,,Cash sale,,,,,,10/08/2018,10/08/2018,0.00,,7.12,,"-4,121.69"
,IN,AR,30323042,1005,100,,Invoice,,,,,,10/08/2018,10/08/2018,0.00,,35.59,,"-4,157.28"
,IN,AR,30323130,1005,100,,Invoice,,,,,,10/08/2018,10/08/2018,0.00,,35.59,,"-4,192.87"
,IN,AR,30323263,1005,100,,Invoice,,,,,,10/08/2018,10/08/2018,0.00,,9.49,,"-4,202.36"
,IN,AR,30323451,1005,100,,Invoice,,,,,,10/08/2018,10/08/2018,0.00,,9.49,,"-4,211.85"
,IN,AR,30323452,1005,100,,Invoice,,,,,,10/08/2018,10/08/2018,0.00,,9.49,,"-4,221.34"
,CN,AR,31018617,1005,100,,Credit Note,,,,,,11/08/2018,11/08/2018,9.49,,0.00,,"-4,211.85"
,CN,AR,31018635,1005,100,,Credit Note,,,,,,11/08/2018,11/08/2018,9.49,,0.00,,"-4,202.36"
,CN,AR,31018636,1005,100,,Credit Note,,,,,,11/08/2018,11/08/2018,9.49,,0.00,,"-4,192.87"
,CS,AR,32007743,1005,100,,Cash sale,,,,,,11/08/2018,11/08/2018,0.00,,7.12,,"-4,199.99"
,IN,AR,30322370,1005,100,,Invoice,,,,,,11/08/2018,11/08/2018,0.00,,7.12,,"-4,207.11"
,CS,AR,32007366,1005,100,,Cash sale,,,,,,13/08/2018,13/08/2018,0.00,,9.49,,"-4,216.60"
,CS,AR,32007850,1005,100,,Cash sale,,,,,,13/08/2018,13/08/2018,0.00,,9.49,,"-4,226.09"
,IN,AR,30323475,1005,100,,Invoice,,,,,,13/08/2018,13/08/2018,0.00,,35.59,,"-4,261.68"
,CS,AR,32007867,1005,100,,Cash sale,,,,,,14/08/2018,14/08/2018,0.00,,7.12,,"-4,268.80"
,IN,AR,30322498,1005,100,,Invoice,,,,,,14/08/2018,14/08/2018,0.00,,7.12,,"-4,275.92"
,CS,AR,32007386,1005,100,,Cash sale,,,,,,16/08/2018,16/08/2018,0.00,,9.49,,"-4,285.41"
,CS,AR,32007744,1005,100,,Cash sale,,,,,,16/08/2018,16/08/2018,0.00,,7.12,,"-4,292.53"
,CS,AR,32007814,1005,100,,Cash sale,,,,,,16/08/2018,16/08/2018,0.00,,7.12,,"-4,299.65"
,IN,AR,30322244,1005,100,,Invoice,,,,,,16/08/2018,16/08/2018,0.00,,9.49,,"-4,309.14"
,CS,AR,32007488,1005,100,,Cash sale,,,,,,17/08/2018,17/08/2018,0.00,,2.37,,"-4,311.51"
,CS,AR,32007655,1005,100,,Cash sale,,,,,,17/08/2018,17/08/2018,0.00,,7.12,,"-4,318.63"
,CS,AR,32007804,1005,100,,Cash sale,,,,,,17/08/2018,17/08/2018,0.00,,7.12,,"-4,325.75"
,IN,AR,30322448,1005,100,,Invoice,,,,,,17/08/2018,17/08/2018,0.00,,14.24,,"-4,339.99"
,CS,AR,32007644,1005,100,,Cash sale,,,,,,20/08/2018,20/08/2018,0.00,,14.24,,"-4,354.23"
,CS,AR,32007764,1005,100,,Cash sale,,,,,,20/08/2018,20/08/2018,0.00,,19.08,,"-4,373.31"
,IN,AR,30322465,1005,100,,Invoice,,,,,,20/08/2018,20/08/2018,0.00,,118.64,,"-4,491.95"
,IN,AR,30322660,1005,100,,Invoice,,,,,,20/08/2018,20/08/2018,0.00,,9.49,,"-4,501.44"
,IN,AR,30322935,1005,100,,Invoice,,,,,,20/08/2018,20/08/2018,0.00,,11.86,,"-4,513.30"
,IN,AR,30323005,1005,100,,Invoice,,,,,,20/08/2018,20/08/2018,0.00,,2.37,,"-4,515.67"
,CS,AR,32007802,1005,100,,Cash sale,,,,,,21/08/2018,21/08/2018,0.00,,7.12,,"-4,522.79"
,CS,AR,32008852,1005,100,,Cash sale,,,,,,22/08/2018,22/08/2018,0.00,,4.75,,"-4,527.54"
,CS,AR,32008868,1005,100,,Cash sale,,,,,,22/08/2018,22/08/2018,0.00,,4.75,,"-4,532.29"
,IN,AR,30325404,1005,100,,Invoice,,,,,,22/08/2018,22/08/2018,0.00,,4.75,,"-4,537.04"
,IN,AR,30325724,1005,100,,Invoice,,,,,,22/08/2018,22/08/2018,0.00,,7.12,,"-4,544.16"
,CS,AR,32008613,1005,100,,Cash sale,,,,,,23/08/2018,23/08/2018,0.00,,4.75,,"-4,548.91"
,IN,AR,30323702,1005,100,,Invoice,,,,,,23/08/2018,23/08/2018,0.00,,14.24,,"-4,563.15"
,CS,AR,32008773,1005,100,,Cash sale,,,,,,24/08/2018,24/08/2018,0.00,,6.21,,"-4,569.36"
,CS,AR,32007975,1005,100,,Cash sale,,,,,,27/08/2018,27/08/2018,0.00,,11.86,,"-4,581.22"
,CS,AR,32008084,1005,100,,Cash sale,,,,,,27/08/2018,27/08/2018,0.00,,14.24,,"-4,595.46"
,CS,AR,32008842,1005,100,,Cash sale,,,,,,27/08/2018,27/08/2018,0.00,,7.12,,"-4,602.58"
,CS,AR,32007962,1005,100,,Cash sale,,,,,,28/08/2018,28/08/2018,0.00,,9.49,,"-4,612.07"
,IN,AR,30324754,1005,100,,Invoice,,,,,,28/08/2018,28/08/2018,0.00,,7.12,,"-4,619.19"
,IN,AR,30325839,1005,100,,Invoice,,,,,,28/08/2018,28/08/2018,0.00,,2.37,,"-4,621.56"
,CS,AR,32007921,1005,100,,Cash sale,,,,,,29/08/2018,29/08/2018,0.00,,7.12,,"-4,628.68"
,CS,AR,32008836,1005,100,,Cash sale,,,,,,29/08/2018,29/08/2018,0.00,,6.43,,"-4,635.11"
,IN,AR,30323579,1005,100,,Invoice,,,,,,29/08/2018,29/08/2018,0.00,,118.64,,"-4,753.75"
,IN,AR,30323922,1005,100,,Invoice,,,,,,29/08/2018,29/08/2018,0.00,,35.59,,"-4,789.34"
,IN,AR,30325234,1005,100,,Invoice,,,,,,29/08/2018,29/08/2018,0.00,,35.59,,"-4,824.93"
,CS,AR,32008614,1005,100,,Cash sale,,,,,,30/08/2018,30/08/2018,0.00,,4.75,,"-4,829.68"
,IN,AR,30324015,1005,100,,Invoice,,,,,,30/08/2018,30/08/2018,0.00,,9.49,,"-4,839.17"
,IN,AR,30325360,1005,100,,Invoice,,,,,,30/08/2018,30/08/2018,0.00,,118.64,,"-4,957.81"
,IN,AR,30325986,1005,100,,Invoice,,,,,,30/08/2018,30/08/2018,0.00,,18.98,,"-4,976.79"
,CN,AR,31018916,1005,100,,Credit Note,,,,,,31/08/2018,31/08/2018,18.98,,0.00,,"-4,957.81"
,CS,AR,32007930,1005,100,,Cash sale,,,,,,31/08/2018,31/08/2018,0.00,,14.24,,"-4,972.05"
,CS,AR,32008145,1005,100,,Cash sale,,,,,,31/08/2018,31/08/2018,0.00,,2.37,,"-4,974.42"
,CS,AR,32008450,1005,100,,Cash sale,,,,,,31/08/2018,31/08/2018,0.00,,7.12,,"-4,981.54"
,CS,AR,32008775,1005,100,,Cash sale,,,,,,31/08/2018,31/08/2018,0.00,,7.12,,"-4,988.66"
,IN,AR,30324449,1005,100,,Invoice,,,,,,31/08/2018,31/08/2018,0.00,,11.86,,"-5,000.52"
,IN,AR,30325037,1005,100,,Invoice,,,,,,31/08/2018,31/08/2018,0.00,,9.49,,"-5,010.01"
,IN,AR,30325730,1005,100,,Invoice,,,,,,31/08/2018,31/08/2018,0.00,,18.98,,"-5,028.99"
,IN,AR,30325877,1005,100,,Invoice,,,,,,31/08/2018,31/08/2018,0.00,,14.24,,"-5,043.23"
,IN,AR,30325974,1005,100,,Invoice,,,,,,31/08/2018,31/08/2018,0.00,,23.73,,"-5,066.96"
,IN,AR,30326053,1005,100,,Invoice,,,,,,31/08/2018,31/08/2018,0.00,,9.49,,"-5,076.45"
,CS,AR,32008433,1005,100,,Cash sale,,,,,,03/09/2018,03/09/2018,0.00,,14.24,,"-5,090.69"
,IN,AR,30326228,1005,100,,Invoice,,,,,,03/09/2018,03/09/2018,0.00,,2.37,,"-5,093.06"
,CS,AR,32008431,1005,100,,Cash sale,,,,,,04/09/2018,04/09/2018,0.00,,11.86,,"-5,104.92"
,CS,AR,32008862,1005,100,,Cash sale,,,,,,04/09/2018,04/09/2018,0.00,,9.49,,"-5,114.41"
,CS,AR,32008869,1005,100,,Cash sale,,,,,,05/09/2018,05/09/2018,0.00,,7.12,,"-5,121.53"
,IN,AR,30323918,1005,100,,Invoice,,,,,,05/09/2018,05/09/2018,0.00,,18.51,,"-5,140.04"
,CS,AR,32008000,1005,100,,Cash sale,,,,,,06/09/2018,06/09/2018,0.00,,7.12,,"-5,147.16"
,CS,AR,32008615,1005,100,,Cash sale,,,,,,06/09/2018,06/09/2018,0.00,,4.75,,"-5,151.91"
,CS,AR,32008451,1005,100,,Cash sale,,,,,,07/09/2018,07/09/2018,0.00,,9.49,,"-5,161.40"
,CS,AR,32008548,1005,100,,Cash sale,,,,,,07/09/2018,07/09/2018,0.00,,4.75,,"-5,166.15"
,CN,AR,31018692,1005,100,,Credit Note,,,,,,10/09/2018,10/09/2018,35.59,,0.00,,"-5,130.56"
,CN,AR,31018879,1005,100,,Credit Note,,,,,,10/09/2018,10/09/2018,118.64,,0.00,,"-5,011.92"
,CS,AR,32008478,1005,100,,Cash sale,,,,,,10/09/2018,10/09/2018,0.00,,9.49,,"-5,021.41"
,IN,AR,30324038,1005,100,,Invoice,,,,,,10/09/2018,10/09/2018,0.00,,35.59,,"-5,057.00"
,IN,AR,30324039,1005,100,,Invoice,,,,,,10/09/2018,10/09/2018,0.00,,35.59,,"-5,092.59"
,CS,AR,32008652,1005,100,,Cash sale,,,,,,11/09/2018,11/09/2018,0.00,,13.36,,"-5,105.95"
,CS,AR,32008734,1005,100,,Cash sale,,,,,,11/09/2018,11/09/2018,0.00,,7.12,,"-5,113.07"
,CS,AR,32008776,1005,100,,Cash sale,,,,,,12/09/2018,12/09/2018,0.00,,7.12,,"-5,120.19"
,IN,AR,30323588,1005,100,,Invoice,,,,,,12/09/2018,12/09/2018,0.00,,7.12,,"-5,127.31"
,IN,AR,30323653,1005,100,,Invoice,,,,,,12/09/2018,12/09/2018,0.00,,4.75,,"-5,132.06"
,IN,AR,30325038,1005,100,,Invoice,,,,,,12/09/2018,12/09/2018,0.00,,9.49,,"-5,141.55"
,CS,AR,32008616,1005,100,,Cash sale,,,,,,13/09/2018,13/09/2018,0.00,,4.75,,"-5,146.30"
,CS,AR,32008108,1005,100,,Cash sale,,,,,,14/09/2018,14/09/2018,0.00,,11.86,,"-5,158.16"
,CS,AR,32008146,1005,100,,Cash sale,,,,,,14/09/2018,14/09/2018,0.00,,2.37,,"-5,160.53"
,CS,AR,32008452,1005,100,,Cash sale,,,,,,14/09/2018,14/09/2018,0.00,,7.12,,"-5,167.65"
,CS,AR,32008743,1005,100,,Cash sale,,,,,,14/09/2018,14/09/2018,0.00,,7.12,,"-5,174.77"
,IN,AR,30325114,1005,100,,Invoice,,,,,,14/09/2018,14/09/2018,0.00,,7.12,,"-5,181.89"
,IN,AR,30325731,1005,100,,Invoice,,,,,,14/09/2018,14/09/2018,0.00,,21.36,,"-5,203.25"
,IN,AR,30325973,1005,100,,Invoice,,,,,,14/09/2018,14/09/2018,0.00,,3.73,,"-5,206.98"
,IN,AR,30326011,1005,100,,Invoice,,,,,,14/09/2018,14/09/2018,0.00,,6.43,,"-5,213.41"
,CS,AR,32009194,1005,100,,Cash sale,,,,,,17/09/2018,17/09/2018,0.00,,11.86,,"-5,225.27"
,IN,AR,30327455,1005,100,,Invoice,,,,,,17/09/2018,17/09/2018,0.00,,37.52,,"-5,262.79"
,IN,AR,30327642,1005,100,,Invoice,,,,,,18/09/2018,18/09/2018,0.00,,35.59,,"-5,298.38"
,CS,AR,32008936,1005,100,,Cash sale,,,,,,19/09/2018,19/09/2018,0.00,,11.86,,"-5,310.24"
,CS,AR,32009287,1005,100,,Cash sale,,,,,,20/09/2018,20/09/2018,0.00,,7.12,,"-5,317.36"
,IN,AR,30326926,1005,100,,Invoice,,,,,,20/09/2018,20/09/2018,0.00,,9.49,,"-5,326.85"
,CS,AR,32009326,1005,100,,Cash sale,,,,,,22/09/2018,22/09/2018,0.00,,2.37,,"-5,329.22"
,IN,AR,30327059,1005,100,,Invoice,,,,,,22/09/2018,22/09/2018,0.00,,7.12,,"-5,336.34"
,CS,AR,32009378,1005,100,,Cash sale,,,,,,24/09/2018,24/09/2018,0.00,,26.10,,"-5,362.44"
,IN,AR,30326355,1005,100,,Invoice,,,,,,24/09/2018,24/09/2018,0.00,,14.24,,"-5,376.68"
,IN,AR,30327272,1005,100,,Invoice,,,,,,24/09/2018,24/09/2018,0.00,,11.45,,"-5,388.13"
,CS,AR,32009219,1005,100,,Cash sale,,,,,,26/09/2018,26/09/2018,0.00,,7.12,,"-5,395.25"
,CS,AR,32009379,1005,100,,Cash sale,,,,,,26/09/2018,26/09/2018,0.00,,2.37,,"-5,397.62"
,IN,AR,30326428,1005,100,,Invoice,,,,,,26/09/2018,26/09/2018,0.00,,18.98,,"-5,416.60"
,IN,AR,30326483,1005,100,,Invoice,,,,,,26/09/2018,26/09/2018,0.00,,92.54,,"-5,509.14"
,IN,AR,30327452,1005,100,,Invoice,,,,,,26/09/2018,26/09/2018,0.00,,7.12,,"-5,516.26"
,CS,AR,32009288,1005,100,,Cash sale,,,,,,27/09/2018,27/09/2018,0.00,,4.75,,"-5,521.01"
,IN,AR,30327585,1005,100,,Invoice,,,,,,27/09/2018,27/09/2018,0.00,,3.73,,"-5,524.74"
,CR,AR,33000274,1005,100,,Cash Return,,,,,,28/09/2018,28/09/2018,2.37,,0.00,,"-5,522.37"
,CS,AR,32008944,1005,100,,Cash sale,,,,,,28/09/2018,28/09/2018,0.00,,11.86,,"-5,534.23"
,CS,AR,32009205,1005,100,,Cash sale,,,,,,28/09/2018,28/09/2018,0.00,,7.12,,"-5,541.35"
,IN,AR,30326293,1005,100,,Invoice,,,,,,28/09/2018,28/09/2018,0.00,,7.12,,"-5,548.47"
,IN,AR,30326347,1005,100,,Invoice,,,,,,28/09/2018,28/09/2018,0.00,,4.75,,"-5,553.22"
,IN,AR,30326420,1005,100,,Invoice,,,,,,28/09/2018,28/09/2018,0.00,,7.12,,"-5,560.34"
,IN,AR,30327287,1005,100,,Invoice,,,,,,28/09/2018,28/09/2018,0.00,,2.37,,"-5,562.71"
,CS,AR,32009360,1005,100,,Cash sale,,,,,,29/09/2018,29/09/2018,0.00,,7.12,,"-5,569.83"
,IN,AR,30326777,1005,100,,Invoice,,,,,,30/09/2018,30/09/2018,0.00,,11.86,,"-5,581.69"
,IN,AR,30328100,1005,100,,Invoice,,,,,,01/10/2018,01/10/2018,0.00,,7.63,,"-5,589.32"
,CS,AR,32009689,1005,100,,Cash sale,,,,,,02/10/2018,02/10/2018,0.00,,5.14,,"-5,594.46"
,IN,AR,30327912,1005,100,,Invoice,,,,,,02/10/2018,02/10/2018,0.00,,14.24,,"-5,608.70"
,CS,AR,32009518,1005,100,,Cash sale,,,,,,03/10/2018,03/10/2018,0.00,,2.37,,"-5,611.07"
,CS,AR,32009678,1005,100,,Cash sale,,,,,,03/10/2018,03/10/2018,0.00,,7.12,,"-5,618.19"
,CS,AR,32009696,1005,100,,Cash sale,,,,,,03/10/2018,03/10/2018,0.00,,4.75,,"-5,622.94"
,IN,AR,30327817,1005,100,,Invoice,,,,,,03/10/2018,03/10/2018,0.00,,11.86,,"-5,634.80"
,CS,AR,32009639,1005,100,,Cash sale,,,,,,04/10/2018,04/10/2018,0.00,,4.75,,"-5,639.55"
,IN,AR,30327748,1005,100,,Invoice,,,,,,04/10/2018,04/10/2018,0.00,,9.49,,"-5,649.04"
,IN,AR,30327818,1005,100,,Invoice,,,,,,04/10/2018,04/10/2018,0.00,,4.75,,"-5,653.79"
,IN,AR,30328042,1005,100,,Invoice,,,,,,04/10/2018,04/10/2018,0.00,,4.75,,"-5,658.54"
,IN,AR,30328291,1005,100,,Invoice,,,,,,04/10/2018,04/10/2018,0.00,,7.12,,"-5,665.66"
,IN,AR,30328303,1005,100,,Invoice,,,,,,04/10/2018,04/10/2018,0.00,,18.98,,"-5,684.64"
,CS,AR,32009497,1005,100,,Cash sale,,,,,,05/10/2018,05/10/2018,0.00,,14.24,,"-5,698.88"
,IN,AR,30327978,1005,100,,Invoice,,,,,,05/10/2018,05/10/2018,0.00,,7.12,,"-5,706.00"
,IN,AR,30328010,1005,100,,Invoice,,,,,,05/10/2018,05/10/2018,0.00,,11.86,,"-5,717.86"
,IN,AR,30328211,1005,100,,Invoice,,,,,,05/10/2018,05/10/2018,0.00,,7.12,,"-5,724.98"
,CS,AR,32009459,1005,100,,Cash sale,,,,,,06/10/2018,06/10/2018,0.00,,16.61,,"-5,741.59"
,CS,AR,32010183,1005,100,,Cash sale,,,,,,08/10/2018,08/10/2018,0.00,,14.24,,"-5,755.83"
,CS,AR,32010118,1005,100,,Cash sale,,,,,,10/10/2018,10/10/2018,0.00,,23.73,,"-5,779.56"
,CS,AR,32010560,1005,100,,Cash sale,,,,,,10/10/2018,10/10/2018,0.00,,3.86,,"-5,783.42"
,IN,AR,30328350,1005,100,,Invoice,,,,,,10/10/2018,10/10/2018,0.00,,7.12,,"-5,790.54"
,CS,AR,32010348,1005,100,,Cash sale,,,,,,11/10/2018,11/10/2018,0.00,,4.75,,"-5,795.29"
,CS,AR,32010176,1005,100,,Cash sale,,,,,,12/10/2018,12/10/2018,0.00,,11.86,,"-5,807.15"
,CS,AR,32010204,1005,100,,Cash sale,,,,,,12/10/2018,12/10/2018,0.00,,7.12,,"-5,814.27"
,IN,AR,30330269,1005,100,,Invoice,,,,,,12/10/2018,12/10/2018,0.00,,14.24,,"-5,828.51"
,IN,AR,30330633,1005,100,,Invoice,,,,,,12/10/2018,12/10/2018,0.00,,35.59,,"-5,864.10"
,IN,AR,30328847,1005,100,,Invoice,,,,,,13/10/2018,13/10/2018,0.00,,2.37,,"-5,866.47"
,CN,AR,31019289,1005,100,,Credit Note,,,,,,15/10/2018,15/10/2018,2.37,,0.00,,"-5,864.10"
,CS,AR,32010388,1005,100,,Cash sale,,,,,,15/10/2018,15/10/2018,0.00,,11.45,,"-5,875.55"
,IN,AR,30329577,1005,100,,Invoice,,,,,,15/10/2018,15/10/2018,0.00,,9.49,,"-5,885.04"
,CS,AR,32010461,1005,100,,Cash sale,,,,,,16/10/2018,16/10/2018,0.00,,7.12,,"-5,892.16"
,CN,AR,31019376,1005,100,,Credit Note,,,,,,17/10/2018,17/10/2018,28.47,,0.00,,"-5,863.69"
,IN,AR,30329662,1005,100,,Invoice,,,,,,17/10/2018,17/10/2018,0.00,,14.24,,"-5,877.93"
,IN,AR,30330496,1005,100,,Invoice,,,,,,17/10/2018,17/10/2018,0.00,,28.47,,"-5,906.40"
,IN,AR,30330497,1005,100,,Invoice,,,,,,17/10/2018,17/10/2018,0.00,,18.98,,"-5,925.38"
,CS,AR,32009781,1005,100,,Cash sale,,,,,,18/10/2018,18/10/2018,0.00,,9.49,,"-5,934.87"
,CS,AR,32010349,1005,100,,Cash sale,,,,,,18/10/2018,18/10/2018,0.00,,4.75,,"-5,939.62"
,IN,AR,30329317,1005,100,,Invoice,,,,,,18/10/2018,18/10/2018,0.00,,2.37,,"-5,941.99"
,CS,AR,32010205,1005,100,,Cash sale,,,,,,19/10/2018,19/10/2018,0.00,,7.12,,"-5,949.11"
,CS,AR,32010223,1005,100,,Cash sale,,,,,,19/10/2018,19/10/2018,0.00,,9.49,,"-5,958.60"
,IN,AR,30329690,1005,100,,Invoice,,,,,,19/10/2018,19/10/2018,0.00,,2.37,,"-5,960.97"
,IN,AR,30330632,1005,100,,Invoice,,,,,,19/10/2018,19/10/2018,0.00,,118.64,,"-6,079.61"
,CS,AR,32010561,1005,100,,Cash sale,,,,,,22/10/2018,22/10/2018,0.00,,6.43,,"-6,086.04"
,IN,AR,30329578,1005,100,,Invoice,,,,,,22/10/2018,22/10/2018,0.00,,9.49,,"-6,095.53"
,IN,AR,30330608,1005,100,,Invoice,,,,,,23/10/2018,23/10/2018,0.00,,118.64,,"-6,214.17"
,CS,AR,32009722,1005,100,,Cash sale,,,,,,24/10/2018,24/10/2018,0.00,,7.12,,"-6,221.29"
,CS,AR,32010469,1005,100,,Cash sale,,,,,,24/10/2018,24/10/2018,0.00,,7.12,,"-6,228.41"
,CS,AR,32010503,1005,100,,Cash sale,,,,,,24/10/2018,24/10/2018,0.00,,7.12,,"-6,235.53"
,CS,AR,32010350,1005,100,,Cash sale,,,,,,25/10/2018,25/10/2018,0.00,,4.75,,"-6,240.28"
,CS,AR,32009936,1005,100,,Cash sale,,,,,,26/10/2018,26/10/2018,0.00,,2.37,,"-6,242.65"
,CS,AR,32010206,1005,100,,Cash sale,,,,,,26/10/2018,26/10/2018,0.00,,4.75,,"-6,247.40"
,IN,AR,30328689,1005,100,,Invoice,,,,,,26/10/2018,26/10/2018,0.00,,11.86,,"-6,259.26"
,IN,AR,30328766,1005,100,,Invoice,,,,,,26/10/2018,26/10/2018,0.00,,11.86,,"-6,271.12"
,IN,AR,30329338,1005,100,,Invoice,,,,,,26/10/2018,26/10/2018,0.00,,9.49,,"-6,280.61"
,IN,AR,30330146,1005,100,,Invoice,,,,,,26/10/2018,26/10/2018,0.00,,21.36,,"-6,301.97"
,IN,AR,30330356,1005,100,,Invoice,,,,,,26/10/2018,26/10/2018,0.00,,11.86,,"-6,313.83"
,IN,AR,30330571,1005,100,,Invoice,,,,,,26/10/2018,26/10/2018,0.00,,35.59,,"-6,349.42"
,CS,AR,32010059,1005,100,,Cash sale,,,,,,27/10/2018,27/10/2018,0.00,,2.37,,"-6,351.79"
,CS,AR,32010389,1005,100,,Cash sale,,,,,,29/10/2018,29/10/2018,0.00,,9.54,,"-6,361.33"
,CS,AR,32010502,1005,100,,Cash sale,,,,,,29/10/2018,29/10/2018,0.00,,14.24,,"-6,375.57"
,CN,AR,31019359,1005,100,,Credit Note,,,,,,30/10/2018,30/10/2018,26.10,,0.00,,"-6,349.47"
,IN,AR,30328462,1005,100,,Invoice,,,,,,30/10/2018,30/10/2018,0.00,,14.24,,"-6,363.71"
,IN,AR,30330357,1005,100,,Invoice,,,,,,30/10/2018,30/10/2018,0.00,,26.10,,"-6,389.81"
,IN,AR,30329096,1005,100,,Invoice,,,,,,31/10/2018,31/10/2018,0.00,,23.73,,"-6,413.54"
,IN,AR,30329579,1005,100,,Invoice,,,,,,31/10/2018,31/10/2018,0.00,,9.49,,"-6,423.03"
,IN,AR,30330199,1005,100,,Invoice,,,,,,31/10/2018,31/10/2018,0.00,,2.37,,"-6,425.40"
,IN,AR,30330710,1005,100,,Invoice,,,,,,31/10/2018,31/10/2018,0.00,,35.59,,"-6,460.99"
,CS,AR,32010664,1005,100,,Cash sale,,,,,,01/11/2018,01/11/2018,0.00,,9.49,,"-6,470.48"
,CS,AR,32010682,1005,100,,Cash sale,,,,,,01/11/2018,01/11/2018,0.00,,7.12,,"-6,477.60"
,CS,AR,32010908,1005,100,,Cash sale,,,,,,01/11/2018,01/11/2018,0.00,,9.49,,"-6,487.09"
,CS,AR,32010730,1005,100,,Cash sale,,,,,,02/11/2018,02/11/2018,0.00,,2.37,,"-6,489.46"
,CS,AR,32010846,1005,100,,Cash sale,,,,,,05/11/2018,05/11/2018,0.00,,7.12,,"-6,496.58"
,IN,AR,30331357,1005,100,,Invoice,,,,,,06/11/2018,06/11/2018,0.00,,35.59,,"-6,532.17"
,CS,AR,32010906,1005,100,,Cash sale,,,,,,07/11/2018,07/11/2018,0.00,,16.61,,"-6,548.78"
,IN,AR,30331306,1005,100,,Invoice,,,,,,07/11/2018,07/11/2018,0.00,,7.12,,"-6,555.90"
,CS,AR,32010909,1005,100,,Cash sale,,,,,,08/11/2018,08/11/2018,0.00,,4.75,,"-6,560.65"
,IN,AR,30331322,1005,100,,Invoice,,,,,,08/11/2018,08/11/2018,0.00,,2.37,,"-6,563.02"
,IN,AR,30330950,1005,100,,Invoice,,,,,,09/11/2018,09/11/2018,0.00,,9.49,,"-6,572.51"
,IN,AR,30331570,1005,100,,Invoice,,,,,,09/11/2018,09/11/2018,0.00,,7.12,,"-6,579.63"
,CS,AR,32010645,1005,100,,Cash sale,,,,,,10/11/2018,10/11/2018,0.00,,7.12,,"-6,586.75"
,CS,AR,32011744,1005,100,,Cash sale,,,,,,12/11/2018,12/11/2018,0.00,,2.37,,"-6,589.12"
,CS,AR,32011686,1005,100,,Cash sale,,,,,,13/11/2018,13/11/2018,0.00,,9.49,,"-6,598.61"
,IN,AR,30333479,1005,100,,Invoice,,,,,,13/11/2018,13/11/2018,0.00,,2.37,,"-6,600.98"
,IN,AR,30333509,1005,100,,Invoice,,,,,,13/11/2018,13/11/2018,0.00,,28.47,,"-6,629.45"
,IN,AR,30333390,1005,100,,Invoice,,,,,,14/11/2018,14/11/2018,0.00,,9.49,,"-6,638.94"
,CS,AR,32011714,1005,100,,Cash sale,,,,,,15/11/2018,15/11/2018,0.00,,9.49,,"-6,648.43"
,IN,AR,30333419,1005,100,,Invoice,,,,,,15/11/2018,15/11/2018,0.00,,4.75,,"-6,653.18"
,IN,AR,30333497,1005,100,,Invoice,,,,,,15/11/2018,15/11/2018,0.00,,4.97,,"-6,658.15"
,CN,AR,31019626,1005,100,,Credit Note,,,,,,16/11/2018,16/11/2018,2.37,,0.00,,"-6,655.78"
,CR,AR,33000319,1005,100,,Cash Return,,,,,,16/11/2018,16/11/2018,2.37,,0.00,,"-6,653.41"
,CS,AR,32011697,1005,100,,Cash sale,,,,,,16/11/2018,16/11/2018,0.00,,2.37,,"-6,655.78"
,CS,AR,32011698,1005,100,,Cash sale,,,,,,16/11/2018,16/11/2018,0.00,,2.37,,"-6,658.15"
,CS,AR,32011715,1005,100,,Cash sale,,,,,,16/11/2018,16/11/2018,0.00,,7.12,,"-6,665.27"
,CS,AR,32011739,1005,100,,Cash sale,,,,,,19/11/2018,19/11/2018,0.00,,6.43,,"-6,671.70"
,IN,AR,30333477,1005,100,,Invoice,,,,,,20/11/2018,20/11/2018,0.00,,49.36,,"-6,721.06"
,CS,AR,32011682,1005,100,,Cash sale,,,,,,21/11/2018,21/11/2018,0.00,,7.12,,"-6,728.18"
,CS,AR,32011740,1005,100,,Cash sale,,,,,,21/11/2018,21/11/2018,0.00,,4.75,,"-6,732.93"
,CN,AR,31019624,1005,100,,Credit Note,,,,,,22/11/2018,22/11/2018,18.98,,0.00,,"-6,713.95"
,IN,AR,30333235,1005,100,,Invoice,,,,,,22/11/2018,22/11/2018,0.00,,18.98,,"-6,732.93"
,CS,AR,32011726,1005,100,,Cash sale,,,,,,22/11/2018,22/11/2018,0.00,,4.75,,"-6,737.68"
,CS,AR,32011716,1005,100,,Cash sale,,,,,,23/11/2018,23/11/2018,0.00,,4.75,,"-6,742.43"
,CS,AR,32011737,1005,100,,Cash sale,,,,,,23/11/2018,23/11/2018,0.00,,7.12,,"-6,749.55"
,IN,AR,30333248,1005,100,,Invoice,,,,,,23/11/2018,23/11/2018,0.00,,4.75,,"-6,754.30"
,IN,AR,30333391,1005,100,,Invoice,,,,,,23/11/2018,23/11/2018,0.00,,9.49,,"-6,763.79"
,IN,AR,30333490,1005,100,,Invoice,,,,,,23/11/2018,23/11/2018,0.00,,14.24,,"-6,778.03"
,IN,AR,30333498,1005,100,,Invoice,,,,,,23/11/2018,23/11/2018,0.00,,9.49,,"-6,787.52"
,CS,AR,32011688,1005,100,,Cash sale,,,,,,24/11/2018,24/11/2018,0.00,,11.86,,"-6,799.38"
,IN,AR,30333268,1005,100,,Invoice,,,,,,24/11/2018,24/11/2018,0.00,,14.24,,"-6,813.62"
,IN,AR,30333499,1005,100,,Invoice,,,,,,26/11/2018,26/11/2018,0.00,,16.61,,"-6,830.23"
,CS,AR,32011687,1005,100,,Cash sale,,,,,,27/11/2018,27/11/2018,0.00,,9.49,,"-6,839.72"
,IN,AR,30333412,1005,100,,Invoice,,,,,,28/11/2018,28/11/2018,0.00,,2.37,,"-6,842.09"
,CS,AR,32011727,1005,100,,Cash sale,,,,,,29/11/2018,29/11/2018,0.00,,4.75,,"-6,846.84"
,IN,AR,30333271,1005,100,,Invoice,,,,,,29/11/2018,29/11/2018,0.00,,9.49,,"-6,856.33"
,CS,AR,32011699,1005,100,,Cash sale,,,,,,30/11/2018,30/11/2018,0.00,,2.37,,"-6,858.70"
,IN,AR,30333338,1005,100,,Invoice,,,,,,30/11/2018,30/11/2018,0.00,,23.73,,"-6,882.43"
,IN,AR,30333370,1005,100,,Invoice,,,,,,30/11/2018,30/11/2018,0.00,,4.75,,"-6,887.18"
,CN,AR,31019763,1005,100,,Credit Note,,,,,,03/12/2018,03/12/2018,26.10,,0.00,,"-6,861.08"
,CS,AR,32012289,1005,100,,Cash sale,,,,,,03/12/2018,03/12/2018,0.00,,17.17,,"-6,878.25"
,CS,AR,32012452,1005,100,,Cash sale,,,,,,03/12/2018,03/12/2018,0.00,,5.14,,"-6,883.39"
,IN,AR,30335171,1005,100,,Invoice,,,,,,03/12/2018,03/12/2018,0.00,,26.10,,"-6,909.49"
,IN,AR,30333645,1005,100,,Invoice,,,,,,04/12/2018,04/12/2018,0.00,,9.49,,"-6,918.98"
,IN,AR,30335354,1005,100,,Invoice,,,,,,04/12/2018,04/12/2018,0.00,,4.75,,"-6,923.73"
,IN,AR,30333687,1005,100,,Invoice,,,,,,05/12/2018,05/12/2018,0.00,,35.59,,"-6,959.32"
,IN,AR,30334482,1005,100,,Invoice,,,,,,05/12/2018,05/12/2018,0.00,,9.49,,"-6,968.81"
,CS,AR,32012267,1005,100,,Cash sale,,,,,,06/12/2018,06/12/2018,0.00,,4.75,,"-6,973.56"
,IN,AR,30334967,1005,100,,Invoice,,,,,,06/12/2018,06/12/2018,0.00,,4.75,,"-6,978.31"
,IN,AR,30333547,1005,100,,Invoice,,,,,,07/12/2018,07/12/2018,0.00,,7.12,,"-6,985.43"
,IN,AR,30334645,1005,100,,Invoice,,,,,,07/12/2018,07/12/2018,0.00,,18.98,,"-7,004.41"
,IN,AR,30334545,1005,100,,Invoice,,,,,,10/12/2018,10/12/2018,0.00,,7.12,,"-7,011.53"
,IN,AR,30334958,1005,100,,Invoice,,,,,,10/12/2018,10/12/2018,0.00,,9.49,,"-7,021.02"
,CS,AR,32012147,1005,100,,Cash sale,,,,,,12/12/2018,12/12/2018,0.00,,7.12,,"-7,028.14"
,CS,AR,32012355,1005,100,,Cash sale,,,,,,12/12/2018,12/12/2018,0.00,,7.12,,"-7,035.26"
,IN,AR,30334483,1005,100,,Invoice,,,,,,12/12/2018,12/12/2018,0.00,,9.49,,"-7,044.75"
,CS,AR,32011788,1005,100,,Cash sale,,,,,,14/12/2018,14/12/2018,0.00,,21.36,,"-7,066.11"
,CS,AR,32011932,1005,100,,Cash sale,,,,,,14/12/2018,14/12/2018,0.00,,2.37,,"-7,068.48"
,IN,AR,30335355,1005,100,,Invoice,,,,,,14/12/2018,14/12/2018,0.00,,4.75,,"-7,073.23"
,CS,AR,32012268,1005,100,,Cash sale,,,,,,15/12/2018,15/12/2018,0.00,,7.12,,"-7,080.35"
,CN,AR,31019723,1005,100,,Credit Note,,,,,,17/12/2018,17/12/2018,9.77,,0.00,,"-7,070.58"
,IN,AR,30335005,1005,100,,Invoice,,,,,,17/12/2018,17/12/2018,0.00,,2.46,,"-7,073.04"
,IN,AR,30335008,1005,100,,Invoice,,,,,,17/12/2018,17/12/2018,0.00,,2.46,,"-7,075.50"
,IN,AR,30335010,1005,100,,Invoice,,,,,,17/12/2018,17/12/2018,0.00,,2.46,,"-7,077.96"
,IN,AR,30335016,1005,100,,Invoice,,,,,,17/12/2018,17/12/2018,0.00,,4.92,,"-7,082.88"
,IN,AR,30335029,1005,100,,Invoice,,,,,,17/12/2018,17/12/2018,0.00,,2.46,,"-7,085.34"
,IN,AR,30335172,1005,100,,Invoice,,,,,,17/12/2018,17/12/2018,0.00,,23.73,,"-7,109.07"
,CS,AR,32012495,1005,100,,Cash sale,,,,,,18/12/2018,18/12/2018,0.00,,2.37,,"-7,111.44"
,IN,AR,30333646,1005,100,,Invoice,,,,,,18/12/2018,18/12/2018,0.00,,9.49,,"-7,120.93"
,CS,AR,32012148,1005,100,,Cash sale,,,,,,19/12/2018,19/12/2018,0.00,,7.12,,"-7,128.05"
,CS,AR,32012382,1005,100,,Cash sale,,,,,,19/12/2018,19/12/2018,0.00,,7.12,,"-7,135.17"
,CS,AR,32012132,1005,100,,Cash sale,,,,,,20/12/2018,20/12/2018,0.00,,9.49,,"-7,144.66"
,IN,AR,30333877,1005,100,,Invoice,,,,,,20/12/2018,20/12/2018,0.00,,14.24,,"-7,158.90"
,IN,AR,30335385,1005,100,,Invoice,,,,,,20/12/2018,20/12/2018,0.00,,118.64,,"-7,277.54"
,CS,AR,32012454,1005,100,,Cash sale,,,,,,21/12/2018,21/12/2018,0.00,,7.71,,"-7,285.25"
,IN,AR,30333548,1005,100,,Invoice,,,,,,21/12/2018,21/12/2018,0.00,,7.12,,"-7,292.37"
,IN,AR,30334646,1005,100,,Invoice,,,,,,21/12/2018,21/12/2018,0.00,,4.75,,"-7,297.12"
,IN,AR,30335170,1005,100,,Invoice,,,,,,21/12/2018,21/12/2018,0.00,,3.73,,"-7,300.85"
,IN,AR,30334484,1005,100,,Invoice,,,,,,24/12/2018,24/12/2018,0.00,,9.49,,"-7,310.34"
,IN,AR,30335656,1005,100,,Invoice,,,,,,27/12/2018,27/12/2018,0.00,,118.64,,"-7,428.98"
,IN,AR,30335707,1005,100,,Invoice,,,,,,27/12/2018,27/12/2018,0.00,,4.75,,"-7,433.73"
,IN,AR,30335829,1005,100,,Invoice,,,,,,27/12/2018,27/12/2018,0.00,,6.21,,"-7,439.94"
,IN,AR,30335860,1005,100,,Invoice,,,,,,27/12/2018,27/12/2018,0.00,,4.75,,"-7,444.69"
,IN,AR,30335861,1005,100,,Invoice,,,,,,27/12/2018,27/12/2018,0.00,,2.37,,"-7,447.06"
,IN,AR,30335862,1005,100,,Invoice,,,,,,27/12/2018,27/12/2018,0.00,,2.37,,"-7,449.43"
,CS,AR,32012607,1005,100,,Cash sale,,,,,,28/12/2018,28/12/2018,0.00,,7.12,,"-7,456.55"
,IN,AR,30335731,1005,100,,Invoice,,,,,,28/12/2018,28/12/2018,0.00,,15.26,,"-7,471.81"
,IN,AR,30335869,1005,100,,Invoice,,,,,,29/12/2018,29/12/2018,0.00,,4.75,,"-7,476.56"
,CS,AR,32012541,1005,100,,Cash sale,,,,,,31/12/2018,31/12/2018,0.00,,11.86,,"-7,488.42"
,IN,AR,30335797,1005,100,,Invoice,,,,,,31/12/2018,31/12/2018,0.00,,7.12,,"-7,495.54"
,,,,,,,,,,,,,,,,,,,
,Account: 1000120 - Sales - 5ltr Water,,,,,,,,,,,,,,,,,,
,Pr.,Mod.,Reference,Dept,Div,Suffix,Details,,,Cheque,,User,Doc Date,Post Date,Debit,,Credit,,Balance
,IN,AR,30308382,1005,100,,Invoice,,,,,,05/02/2018,05/02/2018,0.00,,336.00,,-336.00
,IN,AR,30308397,1005,100,,Invoice,,,,,,27/02/2018,27/02/2018,0.00,,252.00,,-588.00
,IN,AR,30312692,1005,100,,Invoice,,,,,,18/04/2018,18/04/2018,0.00,,420.00,,"-1,008.00"
,IN,AR,30312694,1005,100,,Invoice,,,,,,23/04/2018,23/04/2018,0.00,,84.00,,"-1,092.00"
,IN,AR,30314229,1005,100,,Invoice,,,,,,07/05/2018,07/05/2018,0.00,,252.00,,"-1,344.00"
,IN,AR,30315293,1005,100,,Invoice,,,,,,18/05/2018,18/05/2018,0.00,,252.00,,"-1,596.00"
,IN,AR,30316470,1005,100,,Invoice,,,,,,01/06/2018,01/06/2018,0.00,,420.00,,"-2,016.00"
,IN,AR,30319333,1005,100,,Invoice,,,,,,09/07/2018,09/07/2018,0.00,,420.00,,"-2,436.00"
,IN,AR,30319334,1005,100,,Invoice,,,,,,09/07/2018,09/07/2018,0.00,,336.00,,"-2,772.00"
,IN,AR,30321986,1005,100,,Invoice,,,,,,03/08/2018,03/08/2018,0.00,,47.00,,"-2,819.00"
,IN,AR,30323165,1005,100,,Invoice,,,,,,16/08/2018,16/08/2018,0.00,,336.00,,"-3,155.00"
,IN,AR,30325499,1005,100,,Invoice,,,,,,11/09/2018,11/09/2018,0.00,,252.00,,"-3,407.00"
,IN,AR,30327297,1005,100,,Invoice,,,,,,17/09/2018,17/09/2018,0.00,,168.00,,"-3,575.00"
,IN,AR,30327305,1005,100,,Invoice,,,,,,24/09/2018,24/09/2018,0.00,,84.00,,"-3,659.00"
,IN,AR,30328124,1005,100,,Invoice,,,,,,05/10/2018,05/10/2018,0.00,,168.00,,"-3,827.00"
,IN,AR,30330641,1005,100,,Invoice,,,,,,12/10/2018,12/10/2018,0.00,,420.00,,"-4,247.00"
,IN,AR,30330654,1005,100,,Invoice,,,,,,25/10/2018,25/10/2018,0.00,,168.00,,"-4,415.00"
,IN,AR,30331461,1005,100,,Invoice,,,,,,09/11/2018,09/11/2018,0.00,,168.00,,"-4,583.00"
,IN,AR,30334789,1005,100,,Invoice,,,,,,03/12/2018,03/12/2018,0.00,,252.00,,"-4,835.00"
,IN,AR,30334807,1005,100,,Invoice,,,,,,19/12/2018,19/12/2018,0.00,,504.00,,"-5,339.00"
,,,,,,,,,,,,,,,,,,,
,Account: 1000130 - Sales - 2ltr Water,,,,,,,,,,,,,,,,,,
,Pr.,Mod.,Reference,Dept,Div,Suffix,Details,,,Cheque,,User,Doc Date,Post Date,Debit,,Credit,,Balance
,IN,AR,30306325,1005,100,,Invoice,,,,,,08/01/2018,08/01/2018,0.00,,786.56,,-786.56
,IN,AR,30306327,1005,100,,Invoice,,,,,,16/01/2018,16/01/2018,0.00,,786.56,,"-1,573.12"
,IN,AR,30306329,1005,100,,Invoice,,,,,,17/01/2018,17/01/2018,0.00,,393.22,,"-1,966.34"
,IN,AR,30306330,1005,100,,Invoice,,,,,,17/01/2018,17/01/2018,0.00,,235.97,,"-2,202.31"
,IN,AR,30308381,1005,100,,Invoice,,,,,,05/02/2018,05/02/2018,0.00,,786.44,,"-2,988.75"
,IN,AR,30308384,1005,100,,Invoice,,,,,,07/02/2018,07/02/2018,0.00,,78.66,,"-3,067.41"
,IN,AR,30308385,1005,100,,Invoice,,,,,,07/02/2018,07/02/2018,0.00,,"3,618.18",,"-6,685.59"
,IN,AR,30308386,1005,100,,Invoice,,,,,,08/02/2018,08/02/2018,0.00,,314.62,,"-7,000.21"
,IN,AR,30308388,1005,100,,Invoice,,,,,,13/02/2018,13/02/2018,0.00,,943.87,,"-7,944.08"
,IN,AR,30308389,1005,100,,Invoice,,,,,,14/02/2018,14/02/2018,0.00,,78.66,,"-8,022.74"
,IN,AR,30308390,1005,100,,Invoice,,,,,,17/02/2018,17/02/2018,0.00,,78.66,,"-8,101.40"
,IN,AR,30308391,1005,100,,Invoice,,,,,,19/02/2018,19/02/2018,0.00,,786.56,,"-8,887.96"
,IN,AR,30308392,1005,100,,Invoice,,,,,,19/02/2018,19/02/2018,0.00,,393.28,,"-9,281.24"
,IN,AR,30308394,1005,100,,Invoice,,,,,,22/02/2018,22/02/2018,0.00,,786.56,,"-10,067.80"
,IN,AR,30308395,1005,100,,Invoice,,,,,,23/02/2018,23/02/2018,0.00,,78.66,,"-10,146.46"
,IN,AR,30308396,1005,100,,Invoice,,,,,,26/02/2018,26/02/2018,0.00,,786.56,,"-10,933.02"
,IN,AR,30308397,1005,100,,Invoice,,,,,,27/02/2018,27/02/2018,0.00,,786.44,,"-11,719.46"
,IN,AR,30308398,1005,100,,Invoice,,,,,,27/02/2018,27/02/2018,0.00,,157.31,,"-11,876.77"
,IN,AR,30308399,1005,100,,Invoice,,,,,,27/02/2018,27/02/2018,0.00,,78.66,,"-11,955.43"
,IN,AR,30308401,1005,100,,Invoice,,,,,,27/02/2018,27/02/2018,0.00,,78.66,,"-12,034.09"
,IN,AR,30308402,1005,100,,Invoice,,,,,,28/02/2018,28/02/2018,0.00,,786.56,,"-12,820.65"
,IN,AR,30310633,1005,100,,Invoice,,,,,,06/03/2018,06/03/2018,0.00,,393.28,,"-13,213.93"
,IN,AR,30310634,1005,100,,Invoice,,,,,,06/03/2018,06/03/2018,0.00,,"1,179.84",,"-14,393.77"
,IN,AR,30310636,1005,100,,Invoice,,,,,,09/03/2018,09/03/2018,0.00,,"1,337.15",,"-15,730.92"
,IN,AR,30310637,1005,100,,Invoice,,,,,,12/03/2018,12/03/2018,0.00,,786.56,,"-16,517.48"
,IN,AR,30310639,1005,100,,Invoice,,,,,,20/03/2018,20/03/2018,0.00,,629.25,,"-17,146.73"
,IN,AR,30310640,1005,100,,Invoice,,,,,,21/03/2018,21/03/2018,0.00,,786.44,,"-17,933.17"
,IN,AR,30310642,1005,100,,Invoice,,,,,,28/03/2018,28/03/2018,0.00,,"1,887.74",,"-19,820.91"
,CN,AR,31017822,1005,100,,Credit Note,,,,,,14/04/2018,14/04/2018,17.20,,0.00,,"-19,803.71"
,IN,AR,30312690,1005,100,,Invoice,,,,,,16/04/2018,16/04/2018,0.00,,"2,123.71",,"-21,927.42"
,IN,AR,30312692,1005,100,,Invoice,,,,,,18/04/2018,18/04/2018,0.00,,786.44,,"-22,713.86"
,IN,AR,30312693,1005,100,,Invoice,,,,,,23/04/2018,23/04/2018,0.00,,"2,045.06",,"-24,758.92"
,IN,AR,30312694,1005,100,,Invoice,,,,,,23/04/2018,23/04/2018,0.00,,471.94,,"-25,230.86"
,IN,AR,30314227,1005,100,,Invoice,,,,,,30/04/2018,30/04/2018,0.00,,"2,045.06",,"-27,275.92"
,CN,AR,31017976,1005,100,,Credit Note,,,,,,04/05/2018,04/05/2018,786.44,,0.00,,"-26,489.48"
,IN,AR,30314429,1005,100,,Invoice,,,,,,04/05/2018,04/05/2018,0.00,,786.44,,"-27,275.92"
,IN,AR,30314231,1005,100,,Invoice,,,,,,08/05/2018,08/05/2018,0.00,,786.44,,"-28,062.36"
,IN,AR,30314232,1005,100,,Invoice,,,,,,08/05/2018,08/05/2018,0.00,,786.44,,"-28,848.80"
,CN,AR,31017977,1005,100,,Credit Note,,,,,,10/05/2018,10/05/2018,786.44,,0.00,,"-28,062.36"
,IN,AR,30314234,1005,100,,Invoice,,,,,,10/05/2018,10/05/2018,0.00,,"2,045.06",,"-30,107.42"
,IN,AR,30314235,1005,100,,Invoice,,,,,,10/05/2018,10/05/2018,0.00,,"3,067.58",,"-33,175.00"
,IN,AR,30314433,1005,100,,Invoice,,,,,,10/05/2018,10/05/2018,0.00,,786.44,,"-33,961.44"
,IN,AR,30314236,1005,100,,Invoice,,,,,,14/05/2018,14/05/2018,0.00,,707.90,,"-34,669.34"
,IN,AR,30314237,1005,100,,Invoice,,,,,,14/05/2018,14/05/2018,0.00,,"1,573.12",,"-36,242.46"
,IN,AR,30315295,1005,100,,Invoice,,,,,,23/05/2018,23/05/2018,0.00,,"1,179.84",,"-37,422.30"
,IN,AR,30315296,1005,100,,Invoice,,,,,,23/05/2018,23/05/2018,0.00,,"1,022.53",,"-38,444.83"
,IN,AR,30316468,1005,100,,Invoice,,,,,,01/06/2018,01/06/2018,0.00,,"2,438.34",,"-40,883.17"
,IN,AR,30316469,1005,100,,Invoice,,,,,,01/06/2018,01/06/2018,0.00,,314.62,,"-41,197.79"
,IN,AR,30316471,1005,100,,Invoice,,,,,,01/06/2018,01/06/2018,0.00,,786.44,,"-41,984.23"
,IN,AR,30317172,1005,100,,Invoice,,,,,,11/06/2018,11/06/2018,0.00,,"1,022.53",,"-43,006.76"
,IN,AR,30317173,1005,100,,Invoice,,,,,,11/06/2018,11/06/2018,0.00,,865.22,,"-43,871.98"
,IN,AR,30318268,1005,100,,Invoice,,,,,,19/06/2018,19/06/2018,0.00,,865.22,,"-44,737.20"
,IN,AR,30319080,1005,100,,Invoice,,,,,,03/07/2018,03/07/2018,0.00,,786.44,,"-45,523.64"
,IN,AR,30319081,1005,100,,Invoice,,,,,,06/07/2018,06/07/2018,0.00,,"1,887.74",,"-47,411.38"
,IN,AR,30319082,1005,100,,Invoice,,,,,,06/07/2018,06/07/2018,0.00,,"1,258.50",,"-48,669.88"
,IN,AR,30319083,1005,100,,Invoice,,,,,,06/07/2018,06/07/2018,0.00,,471.94,,"-49,141.82"
,IN,AR,30319084,1005,100,,Invoice,,,,,,06/07/2018,06/07/2018,0.00,,"2,202.37",,"-51,344.19"
,IN,AR,30319332,1005,100,,Invoice,,,,,,09/07/2018,09/07/2018,0.00,,786.44,,"-52,130.63"
,IN,AR,30320099,1005,100,,Invoice,,,,,,19/07/2018,19/07/2018,0.00,,"1,494.46",,"-53,625.09"
,IN,AR,30320100,1005,100,,Invoice,,,,,,19/07/2018,19/07/2018,0.00,,"2,202.37",,"-55,827.46"
,IN,AR,30320101,1005,100,,Invoice,,,,,,19/07/2018,19/07/2018,0.00,,"1,179.84",,"-57,007.30"
,IN,AR,30320102,1005,100,,Invoice,,,,,,19/07/2018,19/07/2018,0.00,,"1,809.09",,"-58,816.39"
,IN,AR,30320103,1005,100,,Invoice,,,,,,19/07/2018,19/07/2018,0.00,,314.62,,"-59,131.01"
,IN,AR,30320104,1005,100,,Invoice,,,,,,19/07/2018,19/07/2018,0.00,,786.44,,"-59,917.45"
,IN,AR,30321146,1005,100,,Invoice,,,,,,26/07/2018,26/07/2018,0.00,,"2,359.68",,"-62,277.13"
,IN,AR,30321147,1005,100,,Invoice,,,,,,26/07/2018,26/07/2018,0.00,,"1,258.50",,"-63,535.63"
,IN,AR,30321148,1005,100,,Invoice,,,,,,26/07/2018,26/07/2018,0.00,,"1,966.40",,"-65,502.03"
,IN,AR,30321150,1005,100,,Invoice,,,,,,31/07/2018,31/07/2018,0.00,,"1,415.59",,"-66,917.62"
,IN,AR,30322050,1005,100,,Invoice,,,,,,03/08/2018,03/08/2018,0.00,,786.44,,"-67,704.06"
,IN,AR,30321987,1005,100,,Invoice,,,,,,06/08/2018,06/08/2018,0.00,,"3,067.58",,"-70,771.64"
,IN,AR,30321988,1005,100,,Invoice,,,,,,06/08/2018,06/08/2018,0.00,,"1,022.53",,"-71,794.17"
,IN,AR,30321989,1005,100,,Invoice,,,,,,06/08/2018,06/08/2018,0.00,,"2,910.27",,"-74,704.44"
,IN,AR,30321990,1005,100,,Invoice,,,,,,06/08/2018,06/08/2018,0.00,,474.39,,"-75,178.83"
,IN,AR,30323159,1005,100,,Invoice,,,,,,13/08/2018,13/08/2018,0.00,,"1,572.88",,"-76,751.71"
,IN,AR,30323161,1005,100,,Invoice,,,,,,14/08/2018,14/08/2018,0.00,,"1,179.84",,"-77,931.55"
,IN,AR,30323162,1005,100,,Invoice,,,,,,14/08/2018,14/08/2018,0.00,,786.56,,"-78,718.11"
,IN,AR,30323163,1005,100,,Invoice,,,,,,14/08/2018,14/08/2018,0.00,,550.59,,"-79,268.70"
,IN,AR,30323164,1005,100,,Invoice,,,,,,14/08/2018,14/08/2018,0.00,,550.59,,"-79,819.29"
,IN,AR,30325482,1005,100,,Invoice,,,,,,24/08/2018,24/08/2018,0.00,,786.56,,"-80,605.85"
,IN,AR,30325483,1005,100,,Invoice,,,,,,24/08/2018,24/08/2018,0.00,,"1,101.18",,"-81,707.03"
,IN,AR,30325484,1005,100,,Invoice,,,,,,24/08/2018,24/08/2018,0.00,,943.87,,"-82,650.90"
,IN,AR,30325485,1005,100,,Invoice,,,,,,24/08/2018,24/08/2018,0.00,,550.59,,"-83,201.49"
,IN,AR,30325486,1005,100,,Invoice,,,,,,24/08/2018,24/08/2018,0.00,,550.59,,"-83,752.08"
,IN,AR,30325487,1005,100,,Invoice,,,,,,24/08/2018,24/08/2018,0.00,,"1,258.50",,"-85,010.58"
,IN,AR,30325488,1005,100,,Invoice,,,,,,27/08/2018,27/08/2018,0.00,,"1,336.95",,"-86,347.53"
,IN,AR,30325491,1005,100,,Invoice,,,,,,07/09/2018,07/09/2018,0.00,,550.59,,"-86,898.12"
,IN,AR,30325492,1005,100,,Invoice,,,,,,07/09/2018,07/09/2018,0.00,,"1,651.78",,"-88,549.90"
,IN,AR,30325493,1005,100,,Invoice,,,,,,07/09/2018,07/09/2018,0.00,,629.25,,"-89,179.15"
,IN,AR,30325494,1005,100,,Invoice,,,,,,07/09/2018,07/09/2018,0.00,,786.56,,"-89,965.71"
,IN,AR,30325495,1005,100,,Invoice,,,,,,07/09/2018,07/09/2018,0.00,,786.56,,"-90,752.27"
,IN,AR,30325496,1005,100,,Invoice,,,,,,07/09/2018,07/09/2018,0.00,,550.59,,"-91,302.86"
,IN,AR,30325497,1005,100,,Invoice,,,,,,07/09/2018,07/09/2018,0.00,,707.90,,"-92,010.76"
,IN,AR,30325498,1005,100,,Invoice,,,,,,07/09/2018,07/09/2018,0.00,,157.31,,"-92,168.07"
,IN,AR,30325499,1005,100,,Invoice,,,,,,11/09/2018,11/09/2018,0.00,,393.22,,"-92,561.29"
,IN,AR,30327297,1005,100,,Invoice,,,,,,17/09/2018,17/09/2018,0.00,,786.44,,"-93,347.73"
,IN,AR,30327298,1005,100,,Invoice,,,,,,18/09/2018,18/09/2018,0.00,,"1,651.78",,"-94,999.51"
,IN,AR,30327299,1005,100,,Invoice,,,,,,18/09/2018,18/09/2018,0.00,,"1,022.53",,"-96,022.04"
,IN,AR,30327300,1005,100,,Invoice,,,,,,18/09/2018,18/09/2018,0.00,,786.56,,"-96,808.60"
,IN,AR,30327301,1005,100,,Invoice,,,,,,18/09/2018,18/09/2018,0.00,,629.25,,"-97,437.85"
,IN,AR,30327302,1005,100,,Invoice,,,,,,18/09/2018,18/09/2018,0.00,,"1,573.12",,"-99,010.97"
,IN,AR,30327304,1005,100,,Invoice,,,,,,20/09/2018,20/09/2018,0.00,,786.44,,"-99,797.41"
,IN,AR,30327510,1005,100,,Invoice,,,,,,23/09/2018,23/09/2018,0.00,,314.58,,"-100,111.99"
,IN,AR,30327307,1005,100,,Invoice,,,,,,29/09/2018,29/09/2018,0.00,,"1,179.84",,"-101,291.83"
,IN,AR,30327308,1005,100,,Invoice,,,,,,29/09/2018,29/09/2018,0.00,,707.90,,"-101,999.73"
,IN,AR,30327309,1005,100,,Invoice,,,,,,29/09/2018,29/09/2018,0.00,,"1,101.18",,"-103,100.91"
,IN,AR,30327310,1005,100,,Invoice,,,,,,29/09/2018,29/09/2018,0.00,,707.90,,"-103,808.81"
,IN,AR,30327311,1005,100,,Invoice,,,,,,29/09/2018,29/09/2018,0.00,,"1,101.18",,"-104,909.99"
,IN,AR,30328109,1005,100,,Invoice,,,,,,01/10/2018,01/10/2018,0.00,,78.64,,"-104,988.63"
,IN,AR,30328111,1005,100,,Invoice,,,,,,01/10/2018,01/10/2018,0.00,,78.64,,"-105,067.27"
,CN,AR,31019162,1005,100,,Credit Note,,,,,,02/10/2018,02/10/2018,"1,101.18",,0.00,,"-103,966.09"
,IN,AR,30328113,1005,100,,Invoice,,,,,,02/10/2018,02/10/2018,0.00,,157.29,,"-104,123.38"
,IN,AR,30328114,1005,100,,Invoice,,,,,,02/10/2018,02/10/2018,0.00,,786.44,,"-104,909.82"
,IN,AR,30328115,1005,100,,Invoice,,,,,,02/10/2018,02/10/2018,0.00,,471.86,,"-105,381.68"
,IN,AR,30328116,1005,100,,Invoice,,,,,,02/10/2018,02/10/2018,0.00,,"1,101.18",,"-106,482.86"
,IN,AR,30328117,1005,100,,Invoice,,,,,,03/10/2018,03/10/2018,0.00,,235.93,,"-106,718.79"
,CN,AR,31019163,1005,100,,Credit Note,,,,,,04/10/2018,04/10/2018,235.93,,0.00,,"-106,482.86"
,IN,AR,30328118,1005,100,,Invoice,,,,,,04/10/2018,04/10/2018,0.00,,78.64,,"-106,561.50"
,IN,AR,30328119,1005,100,,Invoice,,,,,,04/10/2018,04/10/2018,0.00,,157.29,,"-106,718.79"
,IN,AR,30328120,1005,100,,Invoice,,,,,,04/10/2018,04/10/2018,0.00,,157.29,,"-106,876.08"
,IN,AR,30328121,1005,100,,Invoice,,,,,,04/10/2018,04/10/2018,0.00,,157.29,,"-107,033.37"
,IN,AR,30328122,1005,100,,Invoice,,,,,,04/10/2018,04/10/2018,0.00,,235.93,,"-107,269.30"
,IN,AR,30328123,1005,100,,Invoice,,,,,,05/10/2018,05/10/2018,0.00,,786.44,,"-108,055.74"
,IN,AR,30328125,1005,100,,Invoice,,,,,,05/10/2018,05/10/2018,0.00,,550.51,,"-108,606.25"
,IN,AR,30328126,1005,100,,Invoice,,,,,,06/10/2018,06/10/2018,0.00,,235.93,,"-108,842.18"
,IN,AR,30330635,1005,100,,Invoice,,,,,,08/10/2018,08/10/2018,0.00,,471.86,,"-109,314.04"
,CN,AR,31019385,1005,100,,Credit Note,,,,,,09/10/2018,09/10/2018,"2,516.61",,0.00,,"-106,797.43"
,IN,AR,30330636,1005,100,,Invoice,,,,,,09/10/2018,09/10/2018,0.00,,786.56,,"-107,583.99"
,IN,AR,30330637,1005,100,,Invoice,,,,,,09/10/2018,09/10/2018,0.00,,"2,516.61",,"-110,100.60"
,IN,AR,30330638,1005,100,,Invoice,,,,,,09/10/2018,09/10/2018,0.00,,"1,101.02",,"-111,201.62"
,IN,AR,30330639,1005,100,,Invoice,,,,,,10/10/2018,10/10/2018,0.00,,78.66,,"-111,280.28"
,IN,AR,30330640,1005,100,,Invoice,,,,,,11/10/2018,11/10/2018,0.00,,786.44,,"-112,066.72"
,IN,AR,30330642,1005,100,,Invoice,,,,,,12/10/2018,12/10/2018,0.00,,314.58,,"-112,381.30"
,IN,AR,30330643,1005,100,,Invoice,,,,,,15/10/2018,15/10/2018,0.00,,393.22,,"-112,774.52"
,IN,AR,30330644,1005,100,,Invoice,,,,,,15/10/2018,15/10/2018,0.00,,786.44,,"-113,560.96"
,IN,AR,30330645,1005,100,,Invoice,,,,,,16/10/2018,16/10/2018,0.00,,"1,179.66",,"-114,740.62"
,IN,AR,30330646,1005,100,,Invoice,,,,,,17/10/2018,17/10/2018,0.00,,471.86,,"-115,212.48"
,IN,AR,30330647,1005,100,,Invoice,,,,,,18/10/2018,18/10/2018,0.00,,707.80,,"-115,920.28"
,IN,AR,30330648,1005,100,,Invoice,,,,,,19/10/2018,19/10/2018,0.00,,393.22,,"-116,313.50"
,IN,AR,30330649,1005,100,,Invoice,,,,,,20/10/2018,20/10/2018,0.00,,157.29,,"-116,470.79"
,IN,AR,30330650,1005,100,,Invoice,,,,,,22/10/2018,22/10/2018,0.00,,235.93,,"-116,706.72"
,IN,AR,30330651,1005,100,,Invoice,,,,,,23/10/2018,23/10/2018,0.00,,629.15,,"-117,335.87"
,IN,AR,30330652,1005,100,,Invoice,,,,,,24/10/2018,24/10/2018,0.00,,235.93,,"-117,571.80"
,IN,AR,30330653,1005,100,,Invoice,,,,,,25/10/2018,25/10/2018,0.00,,314.58,,"-117,886.38"
,IN,AR,30330654,1005,100,,Invoice,,,,,,25/10/2018,25/10/2018,0.00,,786.44,,"-118,672.82"
,IN,AR,30330655,1005,100,,Invoice,,,,,,26/10/2018,26/10/2018,0.00,,629.15,,"-119,301.97"
,IN,AR,30330682,1005,100,,Invoice,,,,,,26/10/2018,26/10/2018,0.00,,"1,415.59",,"-120,717.56"
,IN,AR,30330683,1005,100,,Invoice,,,,,,26/10/2018,26/10/2018,0.00,,"1,415.59",,"-122,133.15"
,CN,AR,31019390,1005,100,,Credit Note,,,,,,27/10/2018,27/10/2018,"2,831.62",,0.00,,"-119,301.53"
,IN,AR,30330656,1005,100,,Invoice,,,,,,29/10/2018,29/10/2018,0.00,,550.51,,"-119,852.04"
,IN,AR,30330657,1005,100,,Invoice,,,,,,30/10/2018,30/10/2018,0.00,,78.66,,"-119,930.70"
,IN,AR,30330658,1005,100,,Invoice,,,,,,30/10/2018,30/10/2018,0.00,,314.62,,"-120,245.32"
,IN,AR,30330659,1005,100,,Invoice,,,,,,30/10/2018,30/10/2018,0.00,,393.22,,"-120,638.54"
,IN,AR,30330660,1005,100,,Invoice,,,,,,31/10/2018,31/10/2018,0.00,,393.22,,"-121,031.76"
,IN,AR,30331452,1005,100,,Invoice,,,,,,01/11/2018,01/11/2018,0.00,,393.22,,"-121,424.98"
,IN,AR,30331453,1005,100,,Invoice,,,,,,02/11/2018,02/11/2018,0.00,,314.58,,"-121,739.56"
,IN,AR,30331455,1005,100,,Invoice,,,,,,05/11/2018,05/11/2018,0.00,,786.44,,"-122,526.00"
,IN,AR,30331457,1005,100,,Invoice,,,,,,07/11/2018,07/11/2018,0.00,,314.58,,"-122,840.58"
,IN,AR,30331458,1005,100,,Invoice,,,,,,07/11/2018,07/11/2018,0.00,,157.29,,"-122,997.87"
,IN,AR,30331459,1005,100,,Invoice,,,,,,07/11/2018,07/11/2018,0.00,,"1,179.66",,"-124,177.53"
,IN,AR,30331460,1005,100,,Invoice,,,,,,08/11/2018,08/11/2018,0.00,,393.22,,"-124,570.75"
,IN,AR,30331462,1005,100,,Invoice,,,,,,09/11/2018,09/11/2018,0.00,,78.64,,"-124,649.39"
,IN,AR,30331463,1005,100,,Invoice,,,,,,09/11/2018,09/11/2018,0.00,,629.15,,"-125,278.54"
,CN,AR,31019588,1005,100,,Credit Note,,,,,,12/11/2018,12/11/2018,"1,415.59",,0.00,,"-123,862.95"
,IN,AR,30332801,1005,100,,Invoice,,,,,,12/11/2018,12/11/2018,0.00,,235.93,,"-124,098.88"
,IN,AR,30332881,1005,100,,Invoice,,,,,,12/11/2018,12/11/2018,0.00,,"1,415.59",,"-125,514.47"
,IN,AR,30332802,1005,100,,Invoice,,,,,,13/11/2018,13/11/2018,0.00,,"1,022.37",,"-126,536.84"
,IN,AR,30332804,1005,100,,Invoice,,,,,,15/11/2018,15/11/2018,0.00,,786.44,,"-127,323.28"
,IN,AR,30332805,1005,100,,Invoice,,,,,,15/11/2018,15/11/2018,0.00,,314.58,,"-127,637.86"
,IN,AR,30332806,1005,100,,Invoice,,,,,,15/11/2018,15/11/2018,0.00,,314.58,,"-127,952.44"
,CN,AR,31019589,1005,100,,Credit Note,,,,,,16/11/2018,16/11/2018,471.86,,0.00,,"-127,480.58"
,IN,AR,30332807,1005,100,,Invoice,,,,,,16/11/2018,16/11/2018,0.00,,78.64,,"-127,559.22"
,IN,AR,30332887,1005,100,,Invoice,,,,,,16/11/2018,16/11/2018,0.00,,471.86,,"-128,031.08"
,IN,AR,30332808,1005,100,,Invoice,,,,,,19/11/2018,19/11/2018,0.00,,78.64,,"-128,109.72"
,IN,AR,30332810,1005,100,,Invoice,,,,,,20/11/2018,20/11/2018,0.00,,943.73,,"-129,053.45"
,IN,AR,30332811,1005,100,,Invoice,,,,,,22/11/2018,22/11/2018,0.00,,393.22,,"-129,446.67"
,IN,AR,30332812,1005,100,,Invoice,,,,,,22/11/2018,22/11/2018,0.00,,157.29,,"-129,603.96"
,IN,AR,30332813,1005,100,,Invoice,,,,,,23/11/2018,23/11/2018,0.00,,157.29,,"-129,761.25"
,IN,AR,30332814,1005,100,,Invoice,,,,,,26/11/2018,26/11/2018,0.00,,78.64,,"-129,839.89"
,IN,AR,30332816,1005,100,,Invoice,,,,,,27/11/2018,27/11/2018,0.00,,393.22,,"-130,233.11"
,IN,AR,30332817,1005,100,,Invoice,,,,,,28/11/2018,28/11/2018,0.00,,235.93,,"-130,469.04"
,IN,AR,30332818,1005,100,,Invoice,,,,,,28/11/2018,28/11/2018,0.00,,393.22,,"-130,862.26"
,IN,AR,30332819,1005,100,,Invoice,,,,,,29/11/2018,29/11/2018,0.00,,314.58,,"-131,176.84"
,IN,AR,30334789,1005,100,,Invoice,,,,,,03/12/2018,03/12/2018,0.00,,"1,101.02",,"-132,277.86"
,IN,AR,30334790,1005,100,,Invoice,,,,,,03/12/2018,03/12/2018,0.00,,78.64,,"-132,356.50"
,IN,AR,30334792,1005,100,,Invoice,,,,,,03/12/2018,03/12/2018,0.00,,"1,022.37",,"-133,378.87"
,IN,AR,30334794,1005,100,,Invoice,,,,,,04/12/2018,04/12/2018,0.00,,78.64,,"-133,457.51"
,CN,AR,31019644,1005,100,,Credit Note,,,,,,05/12/2018,05/12/2018,78.64,,0.00,,"-133,378.87"
,IN,AR,30333800,1005,100,,Invoice,,,,,,05/12/2018,05/12/2018,0.00,,78.64,,"-133,457.51"
,IN,AR,30334796,1005,100,,Invoice,,,,,,05/12/2018,05/12/2018,0.00,,471.86,,"-133,929.37"
,IN,AR,30334797,1005,100,,Invoice,,,,,,06/12/2018,06/12/2018,0.00,,943.73,,"-134,873.10"
,IN,AR,30334798,1005,100,,Invoice,,,,,,06/12/2018,06/12/2018,0.00,,314.58,,"-135,187.68"
,IN,AR,30334799,1005,100,,Invoice,,,,,,07/12/2018,07/12/2018,0.00,,157.29,,"-135,344.97"
,IN,AR,30334800,1005,100,,Invoice,,,,,,11/12/2018,11/12/2018,0.00,,314.58,,"-135,659.55"
,IN,AR,30334801,1005,100,,Invoice,,,,,,12/12/2018,12/12/2018,0.00,,314.58,,"-135,974.13"
,IN,AR,30334802,1005,100,,Invoice,,,,,,17/12/2018,17/12/2018,0.00,,629.15,,"-136,603.28"
,IN,AR,30334803,1005,100,,Invoice,,,,,,17/12/2018,17/12/2018,0.00,,157.29,,"-136,760.57"
,IN,AR,30334805,1005,100,,Invoice,,,,,,18/12/2018,18/12/2018,0.00,,314.58,,"-137,075.15"
,IN,AR,30334806,1005,100,,Invoice,,,,,,18/12/2018,18/12/2018,0.00,,157.29,,"-137,232.44"
,IN,AR,30334910,1005,100,,Invoice,,,,,,18/12/2018,18/12/2018,0.00,,"1,415.59",,"-138,648.03"
,CN,AR,31019856,1005,100,,Credit Note,,,,,,18/12/2018,18/12/2018,"1,415.81",,0.00,,"-137,232.22"
,CN,AR,31019711,1005,100,,Credit Note,,,,,,19/12/2018,19/12/2018,393.28,,0.00,,"-136,838.94"
,CN,AR,31019712,1005,100,,Credit Note,,,,,,19/12/2018,19/12/2018,471.94,,0.00,,"-136,367.00"
,IN,AR,30334808,1005,100,,Invoice,,,,,,19/12/2018,19/12/2018,0.00,,157.29,,"-136,524.29"
,IN,AR,30334809,1005,100,,Invoice,,,,,,20/12/2018,20/12/2018,0.00,,865.08,,"-137,389.37"
,IN,AR,30334810,1005,100,,Invoice,,,,,,20/12/2018,20/12/2018,0.00,,78.64,,"-137,468.01"
,IN,AR,30335319,1005,100,,Invoice,,,,,,20/12/2018,20/12/2018,0.00,,157.29,,"-137,625.30"
,IN,AR,30334811,1005,100,,Invoice,,,,,,21/12/2018,21/12/2018,0.00,,157.29,,"-137,782.59"
,IN,AR,30334812,1005,100,,Invoice,,,,,,24/12/2018,24/12/2018,0.00,,"1,336.95",,"-139,119.54"
,IN,AR,30334813,1005,100,,Invoice,,,,,,24/12/2018,24/12/2018,0.00,,393.22,,"-139,512.76"
,IN,AR,30335741,1005,100,,Invoice,,,,,,28/12/2018,28/12/2018,0.00,,78.64,,"-139,591.40"
,,,,,,,,,,,,,,,,,,,
,Account: 1000300 - Sales - Coffee,,,,,,,,,,,,,,,,,,
,Pr.,Mod.,Reference,Dept,Div,Suffix,Details,,,Cheque,,User,Doc Date,Post Date,Debit,,Credit,,Balance
,CS,AR,32000460,1006,100,,Cash sale,,,,,,02/01/2018,02/01/2018,0.00,,35.00,,-35.00
,IN,AR,30306211,1006,100,,Invoice,,,,,,03/01/2018,03/01/2018,0.00,,70.00,,-105.00
,IN,AR,30305591,1006,100,,Invoice,,,,,,05/01/2018,05/01/2018,0.00,,35.00,,-140.00
,IN,AR,30305478,1006,100,,Invoice,,,,,,08/01/2018,08/01/2018,0.00,,35.00,,-175.00
,CS,AR,32000182,1006,100,,Cash sale,,,,,,09/01/2018,09/01/2018,0.00,,35.00,,-210.00
,IN,AR,30305354,1006,100,,Invoice,,,,,,09/01/2018,09/01/2018,0.00,,35.00,,-245.00
,IN,AR,30305689,1006,100,,Invoice,,,,,,09/01/2018,09/01/2018,0.00,,31.50,,-276.50
,IN,AR,30304561,1006,100,,Invoice,,,,,,10/01/2018,10/01/2018,0.00,,70.00,,-346.50
,IN,AR,30306569,1006,100,,Invoice,,,,,,10/01/2018,10/01/2018,0.00,,35.00,,-381.50
,IN,AR,30304386,1006,100,,Invoice,,,,,,12/01/2018,12/01/2018,0.00,,35.00,,-416.50
,IN,AR,30304696,1006,100,,Invoice,,,,,,12/01/2018,12/01/2018,0.00,,70.00,,-486.50
,IN,AR,30305238,1006,100,,Invoice,,,,,,12/01/2018,12/01/2018,0.00,,70.00,,-556.50
,IN,AR,30304539,1006,100,,Invoice,,,,,,15/01/2018,15/01/2018,0.00,,70.00,,-626.50
,IN,AR,30304585,1006,100,,Invoice,,,,,,15/01/2018,15/01/2018,0.00,,100.00,,-726.50
,IN,AR,30305479,1006,100,,Invoice,,,,,,15/01/2018,15/01/2018,0.00,,35.00,,-761.50
,IN,AR,30304727,1006,100,,Invoice,,,,,,17/01/2018,17/01/2018,0.00,,178.50,,-940.00
,IN,AR,30305384,1006,100,,Invoice,,,,,,17/01/2018,17/01/2018,0.00,,78.75,,"-1,018.75"
,CS,AR,32000371,1006,100,,Cash sale,,,,,,18/01/2018,18/01/2018,0.00,,70.00,,"-1,088.75"
,CS,AR,32000570,1006,100,,Cash sale,,,,,,18/01/2018,18/01/2018,0.00,,30.00,,"-1,118.75"
,IN,AR,30305503,1006,100,,Invoice,,,,,,18/01/2018,18/01/2018,0.00,,35.00,,"-1,153.75"
,IN,AR,30304586,1006,100,,Invoice,,,,,,19/01/2018,19/01/2018,0.00,,70.00,,"-1,223.75"
,CS,AR,32000444,1006,100,,Cash sale,,,,,,23/01/2018,23/01/2018,0.00,,70.00,,"-1,293.75"
,IN,AR,30305240,1006,100,,Invoice,,,,,,23/01/2018,23/01/2018,0.00,,70.00,,"-1,363.75"
,IN,AR,30305738,1006,100,,Invoice,,,,,,23/01/2018,23/01/2018,0.00,,30.00,,"-1,393.75"
,CS,AR,32000461,1006,100,,Cash sale,,,,,,25/01/2018,25/01/2018,0.00,,35.00,,"-1,428.75"
,IN,AR,30305693,1006,100,,Invoice,,,,,,25/01/2018,25/01/2018,0.00,,35.00,,"-1,463.75"
,IN,AR,30306160,1006,100,,Invoice,,,,,,25/01/2018,25/01/2018,0.00,,52.50,,"-1,516.25"
,IN,AR,30306475,1006,100,,Invoice,,,,,,25/01/2018,25/01/2018,0.00,,60.00,,"-1,576.25"
,CS,AR,32000723,1006,100,,Cash sale,,,,,,26/01/2018,26/01/2018,0.00,,35.00,,"-1,611.25"
,IN,AR,30304540,1006,100,,Invoice,,,,,,26/01/2018,26/01/2018,0.00,,70.00,,"-1,681.25"
,IN,AR,30304562,1006,100,,Invoice,,,,,,29/01/2018,29/01/2018,0.00,,105.00,,"-1,786.25"
,IN,AR,30305006,1006,100,,Invoice,,,,,,29/01/2018,29/01/2018,0.00,,70.00,,"-1,856.25"
,IN,AR,30305702,1006,100,,Invoice,,,,,,30/01/2018,30/01/2018,0.00,,70.00,,"-1,926.25"
,IN,AR,30305386,1006,100,,Invoice,,,,,,31/01/2018,31/01/2018,0.00,,78.75,,"-2,005.00"
,CS,AR,32001396,1006,100,,Cash sale,,,,,,02/02/2018,02/02/2018,0.00,,30.00,,"-2,035.00"
,IN,AR,30307786,1006,100,,Invoice,,,,,,02/02/2018,02/02/2018,0.00,,30.00,,"-2,065.00"
,IN,AR,30307803,1006,100,,Invoice,,,,,,02/02/2018,02/02/2018,0.00,,30.00,,"-2,095.00"
,CS,AR,32000926,1006,100,,Cash sale,,,,,,03/02/2018,03/02/2018,0.00,,49.00,,"-2,144.00"
,IN,AR,30306847,1006,100,,Invoice,,,,,,05/02/2018,05/02/2018,0.00,,70.00,,"-2,214.00"
,CS,AR,32001094,1006,100,,Cash sale,,,,,,09/02/2018,09/02/2018,0.00,,30.00,,"-2,244.00"
,IN,AR,30306665,1006,100,,Invoice,,,,,,09/02/2018,09/02/2018,0.00,,30.00,,"-2,274.00"
,IN,AR,30307013,1006,100,,Invoice,,,,,,12/02/2018,12/02/2018,0.00,,60.00,,"-2,334.00"
,IN,AR,30308637,1006,100,,Invoice,,,,,,12/02/2018,12/02/2018,0.00,,90.00,,"-2,424.00"
,IN,AR,30307790,1006,100,,Invoice,,,,,,15/02/2018,15/02/2018,0.00,,30.00,,"-2,454.00"
,IN,AR,30307793,1006,100,,Invoice,,,,,,15/02/2018,15/02/2018,0.00,,60.00,,"-2,514.00"
,IN,AR,30307441,1006,100,,Invoice,,,,,,16/02/2018,16/02/2018,0.00,,30.00,,"-2,544.00"
,IN,AR,30308540,1006,100,,Invoice,,,,,,19/02/2018,19/02/2018,0.00,,70.00,,"-2,614.00"
,IN,AR,30306890,1006,100,,Invoice,,,,,,20/02/2018,20/02/2018,0.00,,70.00,,"-2,684.00"
,IN,AR,30307552,1006,100,,Invoice,,,,,,20/02/2018,20/02/2018,0.00,,78.75,,"-2,762.75"
,IN,AR,30307594,1006,100,,Invoice,,,,,,20/02/2018,20/02/2018,0.00,,30.00,,"-2,792.75"
,IN,AR,30307795,1006,100,,Invoice,,,,,,20/02/2018,20/02/2018,0.00,,140.00,,"-2,932.75"
,CN,AR,31017216,1006,100,,Credit Note,,,,,,21/02/2018,21/02/2018,35.00,,0.00,,"-2,897.75"
,CS,AR,32001125,1006,100,,Cash sale,,,,,,21/02/2018,21/02/2018,0.00,,35.00,,"-2,932.75"
,IN,AR,30306851,1006,100,,Invoice,,,,,,21/02/2018,21/02/2018,0.00,,175.00,,"-3,107.75"
,IN,AR,30307442,1006,100,,Invoice,,,,,,21/02/2018,21/02/2018,0.00,,105.00,,"-3,212.75"
,IN,AR,30308279,1006,100,,Invoice,,,,,,21/02/2018,21/02/2018,0.00,,86.00,,"-3,298.75"
,CN,AR,31017314,1006,100,,Credit Note,,,,,,22/02/2018,22/02/2018,30.00,,0.00,,"-3,268.75"
,CS,AR,32000927,1006,100,,Cash sale,,,,,,22/02/2018,22/02/2018,0.00,,49.00,,"-3,317.75"
,IN,AR,30307816,1006,100,,Invoice,,,,,,22/02/2018,22/02/2018,0.00,,30.00,,"-3,347.75"
,IN,AR,30307443,1006,100,,Invoice,,,,,,23/02/2018,23/02/2018,0.00,,35.00,,"-3,382.75"
,IN,AR,30307024,1006,100,,Invoice,,,,,,24/02/2018,24/02/2018,0.00,,178.50,,"-3,561.25"
,CS,AR,32001071,1006,100,,Cash sale,,,,,,27/02/2018,27/02/2018,0.00,,35.00,,"-3,596.25"
,IN,AR,30307788,1006,100,,Invoice,,,,,,27/02/2018,27/02/2018,0.00,,31.50,,"-3,627.75"
,IN,AR,30306871,1006,100,,Invoice,,,,,,28/02/2018,28/02/2018,0.00,,70.00,,"-3,697.75"
,IN,AR,30307219,1006,100,,Invoice,,,,,,28/02/2018,28/02/2018,0.00,,35.00,,"-3,732.75"
,IN,AR,30309280,1006,100,,Invoice,,,,,,01/03/2018,01/03/2018,0.00,,70.00,,"-3,802.75"
,IN,AR,30310754,1006,100,,Invoice,,,,,,05/03/2018,05/03/2018,0.00,,35.00,,"-3,837.75"
,IN,AR,30309729,1006,100,,Invoice,,,,,,06/03/2018,06/03/2018,0.00,,131.25,,"-3,969.00"
,IN,AR,30310507,1006,100,,Invoice,,,,,,07/03/2018,07/03/2018,0.00,,19.80,,"-3,988.80"
,IN,AR,30310882,1006,100,,Invoice,,,,,,08/03/2018,08/03/2018,0.00,,70.00,,"-4,058.80"
,CS,AR,32002111,1006,100,,Cash sale,,,,,,12/03/2018,12/03/2018,0.00,,35.00,,"-4,093.80"
,CS,AR,32002224,1006,100,,Cash sale,,,,,,15/03/2018,15/03/2018,0.00,,30.00,,"-4,123.80"
,IN,AR,30309347,1006,100,,Invoice,,,,,,15/03/2018,15/03/2018,0.00,,35.00,,"-4,158.80"
,IN,AR,30309800,1006,100,,Invoice,,,,,,15/03/2018,15/03/2018,0.00,,70.00,,"-4,228.80"
,IN,AR,30310820,1006,100,,Invoice,,,,,,15/03/2018,15/03/2018,0.00,,70.00,,"-4,298.80"
,IN,AR,30308833,1006,100,,Invoice,,,,,,16/03/2018,16/03/2018,0.00,,140.00,,"-4,438.80"
,IN,AR,30309160,1006,100,,Invoice,,,,,,19/03/2018,19/03/2018,0.00,,178.50,,"-4,617.30"
,CS,AR,32001920,1006,100,,Cash sale,,,,,,20/03/2018,20/03/2018,0.00,,35.00,,"-4,652.30"
,CS,AR,32002127,1006,100,,Cash sale,,,,,,20/03/2018,20/03/2018,0.00,,140.00,,"-4,792.30"
,IN,AR,30309140,1006,100,,Invoice,,,,,,20/03/2018,20/03/2018,0.00,,70.00,,"-4,862.30"
,IN,AR,30309609,1006,100,,Invoice,,,,,,20/03/2018,20/03/2018,0.00,,70.00,,"-4,932.30"
,IN,AR,30309531,1006,100,,Invoice,,,,,,22/03/2018,22/03/2018,0.00,,35.00,,"-4,967.30"
,IN,AR,30309980,1006,100,,Invoice,,,,,,22/03/2018,22/03/2018,0.00,,35.00,,"-5,002.30"
,CN,AR,31017453,1006,100,,Credit Note,,,,,,23/03/2018,23/03/2018,30.00,,0.00,,"-4,972.30"
,IN,AR,30309417,1006,100,,Invoice,,,,,,26/03/2018,26/03/2018,0.00,,70.00,,"-5,042.30"
,CS,AR,32002123,1006,100,,Cash sale,,,,,,27/03/2018,27/03/2018,0.00,,35.00,,"-5,077.30"
,IN,AR,30309732,1006,100,,Invoice,,,,,,27/03/2018,27/03/2018,0.00,,155.25,,"-5,232.55"
,IN,AR,30309978,1006,100,,Invoice,,,,,,27/03/2018,27/03/2018,0.00,,31.50,,"-5,264.05"
,IN,AR,30310462,1006,100,,Invoice,,,,,,27/03/2018,27/03/2018,0.00,,78.75,,"-5,342.80"
,CS,AR,32001702,1006,100,,Cash sale,,,,,,29/03/2018,29/03/2018,0.00,,19.80,,"-5,362.60"
,CS,AR,32002406,1006,100,,Cash sale,,,,,,29/03/2018,29/03/2018,0.00,,26.25,,"-5,388.85"
,IN,AR,30308786,1006,100,,Invoice,,,,,,29/03/2018,29/03/2018,0.00,,35.00,,"-5,423.85"
,IN,AR,30309608,1006,100,,Invoice,,,,,,29/03/2018,29/03/2018,0.00,,70.00,,"-5,493.85"
,IN,AR,30312106,1006,100,,Invoice,,,,,,03/04/2018,03/04/2018,0.00,,31.50,,"-5,525.35"
,IN,AR,30312590,1006,100,,Invoice,,,,,,04/04/2018,04/04/2018,0.00,,78.00,,"-5,603.35"
,IN,AR,30312000,1006,100,,Invoice,,,,,,05/04/2018,05/04/2018,0.00,,30.00,,"-5,633.35"
,IN,AR,30312110,1006,100,,Invoice,,,,,,05/04/2018,05/04/2018,0.00,,105.00,,"-5,738.35"
,IN,AR,30312832,1006,100,,Invoice,,,,,,05/04/2018,05/04/2018,0.00,,70.00,,"-5,808.35"
,CS,AR,32002801,1006,100,,Cash sale,,,,,,06/04/2018,06/04/2018,0.00,,35.00,,"-5,843.35"
,IN,AR,30311474,1006,100,,Invoice,,,,,,09/04/2018,09/04/2018,0.00,,43.00,,"-5,886.35"
,IN,AR,30311269,1006,100,,Invoice,,,,,,11/04/2018,11/04/2018,0.00,,70.00,,"-5,956.35"
,IN,AR,30311289,1006,100,,Invoice,,,,,,12/04/2018,12/04/2018,0.00,,105.00,,"-6,061.35"
,IN,AR,30311452,1006,100,,Invoice,,,,,,12/04/2018,12/04/2018,0.00,,35.00,,"-6,096.35"
,IN,AR,30312902,1006,100,,Invoice,,,,,,12/04/2018,12/04/2018,0.00,,35.00,,"-6,131.35"
,CS,AR,32002980,1006,100,,Cash sale,,,,,,13/04/2018,13/04/2018,0.00,,35.00,,"-6,166.35"
,IN,AR,30311868,1006,100,,Invoice,,,,,,18/04/2018,18/04/2018,0.00,,131.25,,"-6,297.60"
,IN,AR,30312881,1006,100,,Invoice,,,,,,18/04/2018,18/04/2018,0.00,,35.00,,"-6,332.60"
,IN,AR,30311400,1006,100,,Invoice,,,,,,19/04/2018,19/04/2018,0.00,,70.00,,"-6,402.60"
,IN,AR,30312112,1006,100,,Invoice,,,,,,19/04/2018,19/04/2018,0.00,,175.00,,"-6,577.60"
,CS,AR,32002590,1006,100,,Cash sale,,,,,,20/04/2018,20/04/2018,0.00,,24.50,,"-6,602.10"
,CS,AR,32003429,1006,100,,Cash sale,,,,,,27/04/2018,27/04/2018,0.00,,30.00,,"-6,632.10"
,IN,AR,30313688,1006,100,,Invoice,,,,,,27/04/2018,27/04/2018,0.00,,54.00,,"-6,686.10"
,CS,AR,32003694,1006,100,,Cash sale,,,,,,30/04/2018,30/04/2018,0.00,,35.00,,"-6,721.10"
,IN,AR,30313473,1006,100,,Invoice,,,,,,02/05/2018,02/05/2018,0.00,,35.00,,"-6,756.10"
,CS,AR,32003558,1006,100,,Cash sale,,,,,,04/05/2018,04/05/2018,0.00,,35.00,,"-6,791.10"
,CN,AR,31017876,1006,100,,Credit Note,,,,,,07/05/2018,07/05/2018,76.50,,0.00,,"-6,714.60"
,IN,AR,30313328,1006,100,,Invoice,,,,,,07/05/2018,07/05/2018,0.00,,178.50,,"-6,893.10"
,IN,AR,30313605,1006,100,,Invoice,,,,,,08/05/2018,08/05/2018,0.00,,105.00,,"-6,998.10"
,IN,AR,30314397,1006,100,,Invoice,,,,,,08/05/2018,08/05/2018,0.00,,30.00,,"-7,028.10"
,IN,AR,30313234,1006,100,,Invoice,,,,,,09/05/2018,09/05/2018,0.00,,70.00,,"-7,098.10"
,CS,AR,32003757,1006,100,,Cash sale,,,,,,10/05/2018,10/05/2018,0.00,,35.00,,"-7,133.10"
,IN,AR,30313690,1006,100,,Invoice,,,,,,10/05/2018,10/05/2018,0.00,,78.75,,"-7,211.85"
,IN,AR,30314355,1006,100,,Invoice,,,,,,11/05/2018,11/05/2018,0.00,,90.00,,"-7,301.85"
,IN,AR,30313806,1006,100,,Invoice,,,,,,14/05/2018,14/05/2018,0.00,,35.00,,"-7,336.85"
,IN,AR,30313845,1006,100,,Invoice,,,,,,15/05/2018,15/05/2018,0.00,,140.00,,"-7,476.85"
,CS,AR,32004009,1006,100,,Cash sale,,,,,,18/05/2018,18/05/2018,0.00,,49.00,,"-7,525.85"
,IN,AR,30314904,1006,100,,Invoice,,,,,,18/05/2018,18/05/2018,0.00,,70.00,,"-7,595.85"
,IN,AR,30315214,1006,100,,Invoice,,,,,,18/05/2018,18/05/2018,0.00,,78.75,,"-7,674.60"
,IN,AR,30314661,1006,100,,Invoice,,,,,,21/05/2018,21/05/2018,0.00,,35.00,,"-7,709.60"
,IN,AR,30314736,1006,100,,Invoice,,,,,,22/05/2018,22/05/2018,0.00,,89.25,,"-7,798.85"
,IN,AR,30314776,1006,100,,Invoice,,,,,,22/05/2018,22/05/2018,0.00,,35.00,,"-7,833.85"
,IN,AR,30315028,1006,100,,Invoice,,,,,,22/05/2018,22/05/2018,0.00,,31.50,,"-7,865.35"
,IN,AR,30314682,1006,100,,Invoice,,,,,,23/05/2018,23/05/2018,0.00,,70.00,,"-7,935.35"
,IN,AR,30314683,1006,100,,Invoice,,,,,,23/05/2018,23/05/2018,0.00,,70.00,,"-8,005.35"
,IN,AR,30314833,1006,100,,Invoice,,,,,,23/05/2018,23/05/2018,0.00,,35.00,,"-8,040.35"
,IN,AR,30315247,1006,100,,Invoice,,,,,,23/05/2018,23/05/2018,0.00,,70.00,,"-8,110.35"
,CS,AR,32004288,1006,100,,Cash sale,,,,,,24/05/2018,24/05/2018,0.00,,35.00,,"-8,145.35"
,IN,AR,30314698,1006,100,,Invoice,,,,,,24/05/2018,24/05/2018,0.00,,31.50,,"-8,176.85"
,IN,AR,30314800,1006,100,,Invoice,,,,,,24/05/2018,24/05/2018,0.00,,35.00,,"-8,211.85"
,IN,AR,30314946,1006,100,,Invoice,,,,,,24/05/2018,24/05/2018,0.00,,102.75,,"-8,314.60"
,IN,AR,30314970,1006,100,,Invoice,,,,,,24/05/2018,24/05/2018,0.00,,35.00,,"-8,349.60"
,IN,AR,30315031,1006,100,,Invoice,,,,,,24/05/2018,24/05/2018,0.00,,35.00,,"-8,384.60"
,CS,AR,32004487,1006,100,,Cash sale,,,,,,28/05/2018,28/05/2018,0.00,,70.00,,"-8,454.60"
,IN,AR,30315771,1006,100,,Invoice,,,,,,29/05/2018,29/05/2018,0.00,,70.00,,"-8,524.60"
,IN,AR,30315796,1006,100,,Invoice,,,,,,29/05/2018,29/05/2018,0.00,,70.00,,"-8,594.60"
,IN,AR,30315559,1006,100,,Invoice,,,,,,30/05/2018,30/05/2018,0.00,,70.00,,"-8,664.60"
,IN,AR,30315751,1006,100,,Invoice,,,,,,31/05/2018,31/05/2018,0.00,,35.00,,"-8,699.60"
,IN,AR,30315756,1006,100,,Invoice,,,,,,31/05/2018,31/05/2018,0.00,,78.75,,"-8,778.35"
,IN,AR,30315769,1006,100,,Invoice,,,,,,31/05/2018,31/05/2018,0.00,,70.00,,"-8,848.35"
,IN,AR,30316056,1006,100,,Invoice,,,,,,31/05/2018,31/05/2018,0.00,,70.00,,"-8,918.35"
,IN,AR,30316196,1006,100,,Invoice,,,,,,05/06/2018,05/06/2018,0.00,,70.00,,"-8,988.35"
,IN,AR,30316363,1006,100,,Invoice,,,,,,05/06/2018,05/06/2018,0.00,,105.00,,"-9,093.35"
,CS,AR,32004788,1006,100,,Cash sale,,,,,,06/06/2018,06/06/2018,0.00,,70.00,,"-9,163.35"
,IN,AR,30316487,1006,100,,Invoice,,,,,,06/06/2018,06/06/2018,0.00,,35.00,,"-9,198.35"
,IN,AR,30316786,1006,100,,Invoice,,,,,,11/06/2018,11/06/2018,0.00,,70.00,,"-9,268.35"
,IN,AR,30317026,1006,100,,Invoice,,,,,,12/06/2018,12/06/2018,0.00,,31.50,,"-9,299.85"
,IN,AR,30316798,1006,100,,Invoice,,,,,,15/06/2018,15/06/2018,0.00,,105.00,,"-9,404.85"
,IN,AR,30317217,1006,100,,Invoice,,,,,,15/06/2018,15/06/2018,0.00,,60.00,,"-9,464.85"
,IN,AR,30316937,1006,100,,Invoice,,,,,,16/06/2018,16/06/2018,0.00,,120.00,,"-9,584.85"
,IN,AR,30317744,1006,100,,Invoice,,,,,,18/06/2018,18/06/2018,0.00,,105.00,,"-9,689.85"
,IN,AR,30317822,1006,100,,Invoice,,,,,,18/06/2018,18/06/2018,0.00,,78.75,,"-9,768.60"
,IN,AR,30317747,1006,100,,Invoice,,,,,,19/06/2018,19/06/2018,0.00,,70.00,,"-9,838.60"
,IN,AR,30317502,1006,100,,Invoice,,,,,,20/06/2018,20/06/2018,0.00,,178.50,,"-10,017.10"
,IN,AR,30317629,1006,100,,Invoice,,,,,,22/06/2018,22/06/2018,0.00,,70.00,,"-10,087.10"
,IN,AR,30317690,1006,100,,Invoice,,,,,,22/06/2018,22/06/2018,0.00,,35.00,,"-10,122.10"
,IN,AR,30317950,1006,100,,Invoice,,,,,,26/06/2018,26/06/2018,0.00,,140.00,,"-10,262.10"
,IN,AR,30318186,1006,100,,Invoice,,,,,,26/06/2018,26/06/2018,0.00,,26.25,,"-10,288.35"
,CS,AR,32005347,1006,100,,Cash sale,,,,,,27/06/2018,27/06/2018,0.00,,35.00,,"-10,323.35"
,IN,AR,30317432,1006,100,,Invoice,,,,,,27/06/2018,27/06/2018,0.00,,70.00,,"-10,393.35"
,IN,AR,30317537,1006,100,,Invoice,,,,,,27/06/2018,27/06/2018,0.00,,35.00,,"-10,428.35"
,IN,AR,30317825,1006,100,,Invoice,,,,,,27/06/2018,27/06/2018,0.00,,78.75,,"-10,507.10"
,IN,AR,30319049,1006,100,,Invoice,,,,,,02/07/2018,02/07/2018,0.00,,70.00,,"-10,577.10"
,IN,AR,30318946,1006,100,,Invoice,,,,,,03/07/2018,03/07/2018,0.00,,35.00,,"-10,612.10"
,IN,AR,30318575,1006,100,,Invoice,,,,,,05/07/2018,05/07/2018,0.00,,35.00,,"-10,647.10"
,CS,AR,32005759,1006,100,,Cash sale,,,,,,06/07/2018,06/07/2018,0.00,,49.00,,"-10,696.10"
,IN,AR,30319143,1006,100,,Invoice,,,,,,06/07/2018,06/07/2018,0.00,,78.00,,"-10,774.10"
,IN,AR,30319243,1006,100,,Invoice,,,,,,09/07/2018,09/07/2018,0.00,,70.00,,"-10,844.10"
,CS,AR,32006316,1006,100,,Cash sale,,,,,,10/07/2018,10/07/2018,0.00,,70.00,,"-10,914.10"
,IN,AR,30319838,1006,100,,Invoice,,,,,,11/07/2018,11/07/2018,0.00,,105.00,,"-11,019.10"
,CS,AR,32006367,1006,100,,Cash sale,,,,,,12/07/2018,12/07/2018,0.00,,35.00,,"-11,054.10"
,IN,AR,30319355,1006,100,,Invoice,,,,,,13/07/2018,13/07/2018,0.00,,35.00,,"-11,089.10"
,IN,AR,30319513,1006,100,,Invoice,,,,,,13/07/2018,13/07/2018,0.00,,70.00,,"-11,159.10"
,IN,AR,30319542,1006,100,,Invoice,,,,,,13/07/2018,13/07/2018,0.00,,35.00,,"-11,194.10"
,IN,AR,30319687,1006,100,,Invoice,,,,,,17/07/2018,17/07/2018,0.00,,35.00,,"-11,229.10"
,IN,AR,30319833,1006,100,,Invoice,,,,,,17/07/2018,17/07/2018,0.00,,31.50,,"-11,260.60"
,IN,AR,30320172,1006,100,,Invoice,,,,,,17/07/2018,17/07/2018,0.00,,120.00,,"-11,380.60"
,IN,AR,30319616,1006,100,,Invoice,,,,,,18/07/2018,18/07/2018,0.00,,70.00,,"-11,450.60"
,IN,AR,30319725,1006,100,,Invoice,,,,,,19/07/2018,19/07/2018,0.00,,78.75,,"-11,529.35"
,IN,AR,30319761,1006,100,,Invoice,,,,,,19/07/2018,19/07/2018,0.00,,35.00,,"-11,564.35"
,IN,AR,30319835,1006,100,,Invoice,,,,,,19/07/2018,19/07/2018,0.00,,35.00,,"-11,599.35"
,IN,AR,30320526,1006,100,,Invoice,,,,,,25/07/2018,25/07/2018,0.00,,178.50,,"-11,777.85"
,IN,AR,30320655,1006,100,,Invoice,,,,,,25/07/2018,25/07/2018,0.00,,70.00,,"-11,847.85"
,CS,AR,32006925,1006,100,,Cash sale,,,,,,26/07/2018,26/07/2018,0.00,,30.00,,"-11,877.85"
,CS,AR,32006671,1006,100,,Cash sale,,,,,,27/07/2018,27/07/2018,0.00,,30.00,,"-11,907.85"
,IN,AR,30320870,1006,100,,Invoice,,,,,,31/07/2018,31/07/2018,0.00,,30.00,,"-11,937.85"
,CS,AR,32007207,1006,100,,Cash sale,,,,,,02/08/2018,02/08/2018,0.00,,30.00,,"-11,967.85"
,IN,AR,30321687,1006,100,,Invoice,,,,,,03/08/2018,03/08/2018,0.00,,60.00,,"-12,027.85"
,IN,AR,30323107,1006,100,,Invoice,,,,,,08/08/2018,08/08/2018,0.00,,30.00,,"-12,057.85"
,IN,AR,30323294,1006,100,,Invoice,,,,,,16/08/2018,16/08/2018,0.00,,30.00,,"-12,087.85"
,IN,AR,30323259,1006,100,,Invoice,,,,,,17/08/2018,17/08/2018,0.00,,70.00,,"-12,157.85"
,CS,AR,32007476,1006,100,,Cash sale,,,,,,20/08/2018,20/08/2018,0.00,,35.00,,"-12,192.85"
,IN,AR,30322428,1006,100,,Invoice,,,,,,20/08/2018,20/08/2018,0.00,,238.00,,"-12,430.85"
,IN,AR,30322651,1006,100,,Invoice,,,,,,21/08/2018,21/08/2018,0.00,,70.00,,"-12,500.85"
,IN,AR,30322827,1006,100,,Invoice,,,,,,21/08/2018,21/08/2018,0.00,,31.50,,"-12,532.35"
,IN,AR,30325282,1006,100,,Invoice,,,,,,21/08/2018,21/08/2018,0.00,,105.00,,"-12,637.35"
,IN,AR,30323779,1006,100,,Invoice,,,,,,22/08/2018,22/08/2018,0.00,,105.00,,"-12,742.35"
,IN,AR,30323794,1006,100,,Invoice,,,,,,22/08/2018,22/08/2018,0.00,,70.00,,"-12,812.35"
,IN,AR,30324534,1006,100,,Invoice,,,,,,22/08/2018,22/08/2018,0.00,,210.00,,"-13,022.35"
,IN,AR,30325356,1006,100,,Invoice,,,,,,22/08/2018,22/08/2018,0.00,,70.00,,"-13,092.35"
,CS,AR,32008348,1006,100,,Cash sale,,,,,,23/08/2018,23/08/2018,0.00,,35.00,,"-13,127.35"
,IN,AR,30323590,1006,100,,Invoice,,,,,,23/08/2018,23/08/2018,0.00,,70.00,,"-13,197.35"
,IN,AR,30324830,1006,100,,Invoice,,,,,,24/08/2018,24/08/2018,0.00,,105.00,,"-13,302.35"
,IN,AR,30324111,1006,100,,Invoice,,,,,,30/08/2018,30/08/2018,0.00,,35.00,,"-13,337.35"
,IN,AR,30323795,1006,100,,Invoice,,,,,,31/08/2018,31/08/2018,0.00,,35.00,,"-13,372.35"
,IN,AR,30323906,1006,100,,Invoice,,,,,,03/09/2018,03/09/2018,0.00,,70.00,,"-13,442.35"
,IN,AR,30323796,1006,100,,Invoice,,,,,,04/09/2018,04/09/2018,0.00,,43.00,,"-13,485.35"
,IN,AR,30323831,1006,100,,Invoice,,,,,,04/09/2018,04/09/2018,0.00,,39.50,,"-13,524.85"
,IN,AR,30325789,1006,100,,Invoice,,,,,,04/09/2018,04/09/2018,0.00,,70.00,,"-13,594.85"
,CS,AR,32008087,1006,100,,Cash sale,,,,,,05/09/2018,05/09/2018,0.00,,35.00,,"-13,629.85"
,CS,AR,32008119,1006,100,,Cash sale,,,,,,05/09/2018,05/09/2018,0.00,,35.00,,"-13,664.85"
,IN,AR,30324405,1006,100,,Invoice,,,,,,07/09/2018,07/09/2018,0.00,,105.00,,"-13,769.85"
,CS,AR,32008120,1006,100,,Cash sale,,,,,,10/09/2018,10/09/2018,0.00,,70.00,,"-13,839.85"
,IN,AR,30324821,1006,100,,Invoice,,,,,,11/09/2018,11/09/2018,0.00,,31.50,,"-13,871.35"
,CS,AR,32008318,1006,100,,Cash sale,,,,,,12/09/2018,12/09/2018,0.00,,35.00,,"-13,906.35"
,IN,AR,30323757,1006,100,,Invoice,,,,,,12/09/2018,12/09/2018,0.00,,70.00,,"-13,976.35"
,CS,AR,32008439,1006,100,,Cash sale,,,,,,13/09/2018,13/09/2018,0.00,,35.00,,"-14,011.35"
,IN,AR,30327446,1006,100,,Invoice,,,,,,17/09/2018,17/09/2018,0.00,,70.00,,"-14,081.35"
,IN,AR,30326480,1006,100,,Invoice,,,,,,18/09/2018,18/09/2018,0.00,,89.25,,"-14,170.60"
,IN,AR,30327088,1006,100,,Invoice,,,,,,18/09/2018,18/09/2018,0.00,,35.00,,"-14,205.60"
,IN,AR,30326822,1006,100,,Invoice,,,,,,19/09/2018,19/09/2018,0.00,,131.25,,"-14,336.85"
,IN,AR,30327237,1006,100,,Invoice,,,,,,19/09/2018,19/09/2018,0.00,,70.00,,"-14,406.85"
,CS,AR,32008895,1006,100,,Cash sale,,,,,,20/09/2018,20/09/2018,0.00,,49.00,,"-14,455.85"
,IN,AR,30326474,1006,100,,Invoice,,,,,,20/09/2018,20/09/2018,0.00,,70.00,,"-14,525.85"
,IN,AR,30327690,1006,100,,Invoice,,,,,,20/09/2018,20/09/2018,0.00,,35.00,,"-14,560.85"
,IN,AR,30326546,1006,100,,Invoice,,,,,,25/09/2018,25/09/2018,0.00,,70.00,,"-14,630.85"
,IN,AR,30326607,1006,100,,Invoice,,,,,,26/09/2018,26/09/2018,0.00,,54.60,,"-14,685.45"
,IN,AR,30326632,1006,100,,Invoice,,,,,,26/09/2018,26/09/2018,0.00,,70.00,,"-14,755.45"
,IN,AR,30326419,1006,100,,Invoice,,,,,,28/09/2018,28/09/2018,0.00,,70.00,,"-14,825.45"
,IN,AR,30326861,1006,100,,Invoice,,,,,,30/09/2018,30/09/2018,0.00,,35.00,,"-14,860.45"
,IN,AR,30327763,1006,100,,Invoice,,,,,,01/10/2018,01/10/2018,0.00,,70.00,,"-14,930.45"
,IN,AR,30327894,1006,100,,Invoice,,,,,,02/10/2018,02/10/2018,0.00,,70.00,,"-15,000.45"
,IN,AR,30327967,1006,100,,Invoice,,,,,,05/10/2018,05/10/2018,0.00,,31.50,,"-15,031.95"
,IN,AR,30328174,1006,100,,Invoice,,,,,,05/10/2018,05/10/2018,0.00,,105.00,,"-15,136.95"
,IN,AR,30328197,1006,100,,Invoice,,,,,,05/10/2018,05/10/2018,0.00,,70.00,,"-15,206.95"
,CS,AR,32009539,1006,100,,Cash sale,,,,,,06/10/2018,06/10/2018,0.00,,70.00,,"-15,276.95"
,IN,AR,30327893,1006,100,,Invoice,,,,,,06/10/2018,06/10/2018,0.00,,105.00,,"-15,381.95"
,IN,AR,30328070,1006,100,,Invoice,,,,,,06/10/2018,06/10/2018,0.00,,105.00,,"-15,486.95"
,IN,AR,30328306,1006,100,,Invoice,,,,,,08/10/2018,08/10/2018,0.00,,35.00,,"-15,521.95"
,IN,AR,30329784,1006,100,,Invoice,,,,,,09/10/2018,09/10/2018,0.00,,26.25,,"-15,548.20"
,IN,AR,30329785,1006,100,,Invoice,,,,,,09/10/2018,09/10/2018,0.00,,35.00,,"-15,583.20"
,IN,AR,30330064,1006,100,,Invoice,,,,,,09/10/2018,09/10/2018,0.00,,35.00,,"-15,618.20"
,IN,AR,30328720,1006,100,,Invoice,,,,,,10/10/2018,10/10/2018,0.00,,35.00,,"-15,653.20"
,CS,AR,32010194,1006,100,,Cash sale,,,,,,11/10/2018,11/10/2018,0.00,,35.00,,"-15,688.20"
,IN,AR,30329162,1006,100,,Invoice,,,,,,11/10/2018,11/10/2018,0.00,,78.75,,"-15,766.95"
,IN,AR,30328517,1006,100,,Invoice,,,,,,18/10/2018,18/10/2018,0.00,,70.00,,"-15,836.95"
,IN,AR,30328989,1006,100,,Invoice,,,,,,18/10/2018,18/10/2018,0.00,,35.00,,"-15,871.95"
,IN,AR,30329163,1006,100,,Invoice,,,,,,18/10/2018,18/10/2018,0.00,,26.25,,"-15,898.20"
,IN,AR,30329404,1006,100,,Invoice,,,,,,18/10/2018,18/10/2018,0.00,,105.00,,"-16,003.20"
,IN,AR,30329860,1006,100,,Invoice,,,,,,19/10/2018,19/10/2018,0.00,,35.00,,"-16,038.20"
,IN,AR,30330133,1006,100,,Invoice,,,,,,19/10/2018,19/10/2018,0.00,,35.00,,"-16,073.20"
,IN,AR,30328310,1006,100,,Invoice,,,,,,20/10/2018,20/10/2018,0.00,,24.50,,"-16,097.70"
,IN,AR,30328813,1006,100,,Invoice,,,,,,20/10/2018,20/10/2018,0.00,,35.00,,"-16,132.70"
,IN,AR,30330192,1006,100,,Invoice,,,,,,22/10/2018,22/10/2018,0.00,,70.00,,"-16,202.70"
,IN,AR,30328705,1006,100,,Invoice,,,,,,24/10/2018,24/10/2018,0.00,,70.00,,"-16,272.70"
,CS,AR,32010100,1006,100,,Cash sale,,,,,,25/10/2018,25/10/2018,0.00,,70.00,,"-16,342.70"
,IN,AR,30328858,1006,100,,Invoice,,,,,,25/10/2018,25/10/2018,0.00,,70.00,,"-16,412.70"
,IN,AR,30329014,1006,100,,Invoice,,,,,,25/10/2018,25/10/2018,0.00,,70.00,,"-16,482.70"
,IN,AR,30329257,1006,100,,Invoice,,,,,,25/10/2018,25/10/2018,0.00,,35.00,,"-16,517.70"
,IN,AR,30330193,1006,100,,Invoice,,,,,,26/10/2018,26/10/2018,0.00,,35.00,,"-16,552.70"
,IN,AR,30328548,1006,100,,Invoice,,,,,,30/10/2018,30/10/2018,0.00,,70.00,,"-16,622.70"
,IN,AR,30328845,1006,100,,Invoice,,,,,,30/10/2018,30/10/2018,0.00,,35.00,,"-16,657.70"
,IN,AR,30329015,1006,100,,Invoice,,,,,,30/10/2018,30/10/2018,0.00,,140.00,,"-16,797.70"
,IN,AR,30329401,1006,100,,Invoice,,,,,,30/10/2018,30/10/2018,0.00,,31.50,,"-16,829.20"
,IN,AR,30328889,1006,100,,Invoice,,,,,,31/10/2018,31/10/2018,0.00,,70.00,,"-16,899.20"
,IN,AR,30329239,1006,100,,Invoice,,,,,,31/10/2018,31/10/2018,0.00,,70.00,,"-16,969.20"
,IN,AR,30330832,1006,100,,Invoice,,,,,,02/11/2018,02/11/2018,0.00,,70.00,,"-17,039.20"
,IN,AR,30331402,1006,100,,Invoice,,,,,,02/11/2018,02/11/2018,0.00,,70.00,,"-17,109.20"
,CS,AR,32010703,1006,100,,Cash sale,,,,,,06/11/2018,06/11/2018,0.00,,35.00,,"-17,144.20"
,IN,AR,30331533,1006,100,,Invoice,,,,,,07/11/2018,07/11/2018,0.00,,105.00,,"-17,249.20"
,IN,AR,30331098,1006,100,,Invoice,,,,,,08/11/2018,08/11/2018,0.00,,183.75,,"-17,432.95"
,IN,AR,30331388,1006,100,,Invoice,,,,,,08/11/2018,08/11/2018,0.00,,55.00,,"-17,487.95"
,IN,AR,30330988,1006,100,,Invoice,,,,,,09/11/2018,09/11/2018,0.00,,70.00,,"-17,557.95"
,IN,AR,30331067,1006,100,,Invoice,,,,,,09/11/2018,09/11/2018,0.00,,105.00,,"-17,662.95"
,IN,AR,30331562,1006,100,,Invoice,,,,,,09/11/2018,09/11/2018,0.00,,70.00,,"-17,732.95"
,CN,AR,31019458,1006,100,,Credit Note,,,,,,12/11/2018,12/11/2018,55.00,,0.00,,"-17,677.95"
,IN,AR,30332231,1006,100,,Invoice,,,,,,13/11/2018,13/11/2018,0.00,,70.00,,"-17,747.95"
,CS,AR,32011377,1006,100,,Cash sale,,,,,,15/11/2018,15/11/2018,0.00,,35.00,,"-17,782.95"
,IN,AR,30331962,1006,100,,Invoice,,,,,,15/11/2018,15/11/2018,0.00,,178.50,,"-17,961.45"
,CN,AR,31019507,1006,100,,Credit Note,,,,,,16/11/2018,16/11/2018,29.75,,0.00,,"-17,931.70"
,CS,AR,32011178,1006,100,,Cash sale,,,,,,16/11/2018,16/11/2018,0.00,,70.00,,"-18,001.70"
,CS,AR,32011297,1006,100,,Cash sale,,,,,,17/11/2018,17/11/2018,0.00,,35.00,,"-18,036.70"
,CS,AR,32011294,1006,100,,Cash sale,,,,,,20/11/2018,20/11/2018,0.00,,35.00,,"-18,071.70"
,IN,AR,30332428,1006,100,,Invoice,,,,,,20/11/2018,20/11/2018,0.00,,31.50,,"-18,103.20"
,IN,AR,30332680,1006,100,,Invoice,,,,,,20/11/2018,20/11/2018,0.00,,35.00,,"-18,138.20"
,IN,AR,30331883,1006,100,,Invoice,,,,,,21/11/2018,21/11/2018,0.00,,105.00,,"-18,243.20"
,IN,AR,30332728,1006,100,,Invoice,,,,,,21/11/2018,21/11/2018,0.00,,70.00,,"-18,313.20"
,IN,AR,30332431,1006,100,,Invoice,,,,,,22/11/2018,22/11/2018,0.00,,105.00,,"-18,418.20"
,IN,AR,30332046,1006,100,,Invoice,,,,,,23/11/2018,23/11/2018,0.00,,35.00,,"-18,453.20"
,IN,AR,30332689,1006,100,,Invoice,,,,,,23/11/2018,23/11/2018,0.00,,78.75,,"-18,531.95"
,CS,AR,32011344,1006,100,,Cash sale,,,,,,27/11/2018,27/11/2018,0.00,,70.00,,"-18,601.95"
,IN,AR,30332872,1006,100,,Invoice,,,,,,28/11/2018,28/11/2018,0.00,,70.00,,"-18,671.95"
,IN,AR,30332256,1006,100,,Invoice,,,,,,29/11/2018,29/11/2018,0.00,,70.00,,"-18,741.95"
,IN,AR,30332970,1006,100,,Invoice,,,,,,29/11/2018,29/11/2018,0.00,,35.00,,"-18,776.95"
,IN,AR,30332971,1006,100,,Invoice,,,,,,30/11/2018,30/11/2018,0.00,,70.00,,"-18,846.95"
,IN,AR,30333697,1006,100,,Invoice,,,,,,05/12/2018,05/12/2018,0.00,,70.00,,"-18,916.95"
,IN,AR,30334952,1006,100,,Invoice,,,,,,05/12/2018,05/12/2018,0.00,,105.00,,"-19,021.95"
,IN,AR,30333698,1006,100,,Invoice,,,,,,07/12/2018,07/12/2018,0.00,,70.00,,"-19,091.95"
,IN,AR,30334161,1006,100,,Invoice,,,,,,07/12/2018,07/12/2018,0.00,,105.00,,"-19,196.95"
,IN,AR,30334107,1006,100,,Invoice,,,,,,11/12/2018,11/12/2018,0.00,,70.00,,"-19,266.95"
,IN,AR,30333550,1006,100,,Invoice,,,,,,12/12/2018,12/12/2018,0.00,,70.00,,"-19,336.95"
,IN,AR,30333732,1006,100,,Invoice,,,,,,12/12/2018,12/12/2018,0.00,,31.50,,"-19,368.45"
,IN,AR,30334067,1006,100,,Invoice,,,,,,12/12/2018,12/12/2018,0.00,,35.00,,"-19,403.45"
,IN,AR,30334103,1006,100,,Invoice,,,,,,14/12/2018,14/12/2018,0.00,,105.00,,"-19,508.45"
,IN,AR,30334104,1006,100,,Invoice,,,,,,14/12/2018,14/12/2018,0.00,,24.00,,"-19,532.45"
,CN,AR,31019655,1006,100,,Credit Note,,,,,,19/12/2018,19/12/2018,70.00,,0.00,,"-19,462.45"
,IN,AR,30333981,1006,100,,Invoice,,,,,,19/12/2018,19/12/2018,0.00,,70.00,,"-19,532.45"
,IN,AR,30333982,1006,100,,Invoice,,,,,,21/12/2018,21/12/2018,0.00,,35.00,,"-19,567.45"
,CS,AR,32012506,1006,100,,Cash sale,,,,,,31/12/2018,31/12/2018,0.00,,49.00,,"-19,616.45"
,IN,AR,30335634,1006,100,,Invoice,,,,,,31/12/2018,31/12/2018,0.00,,31.50,,"-19,647.95"
,,,,,,,,,,,,,,,,,,,
,Account: 1000310 - Sales - Coffee Machines And Coffee Accessories,,,,,,,,,,,,,,,,,,
,Pr.,Mod.,Reference,Dept,Div,Suffix,Details,,,Cheque,,User,Doc Date,Post Date,Debit,,Credit,,Balance
,CS,AR,32000910,1007,100,,Cash sale,,,,,,09/01/2018,09/01/2018,0.00,,135.59,,-135.59
,IN,AR,30305898,1007,100,,Invoice,,,,,,12/01/2018,12/01/2018,0.00,,135.59,,-271.18
,IN,AR,30304482,1007,100,,Invoice,,,,,,16/01/2018,16/01/2018,0.00,,135.59,,-406.77
,IN,AR,30306648,1007,100,,Invoice,,,,,,19/01/2018,19/01/2018,0.00,,135.59,,-542.36
,CN,AR,31017221,1007,100,,Credit Note,,,,,,02/02/2018,02/02/2018,135.59,,0.00,,-406.77
,IN,AR,30307552,1007,100,,Invoice,,,,,,20/02/2018,20/02/2018,0.00,,7.00,,-413.77
,IN,AR,30307553,1007,100,,Invoice,,,,,,21/02/2018,21/02/2018,0.00,,14.00,,-427.77
,IN,AR,30306923,1007,100,,Invoice,,,,,,22/02/2018,22/02/2018,0.00,,7.00,,-434.77
,CS,AR,32001698,1007,100,,Cash sale,,,,,,28/02/2018,28/02/2018,0.00,,135.59,,-570.36
,CS,AR,32002574,1007,100,,Cash sale,,,,,,06/03/2018,06/03/2018,0.00,,135.59,,-705.95
,CS,AR,32002578,1007,100,,Cash sale,,,,,,14/03/2018,14/03/2018,0.00,,135.59,,-841.54
,IN,AR,30311035,1007,100,,Invoice,,,,,,14/03/2018,14/03/2018,0.00,,135.59,,-977.13
,IN,AR,30311044,1007,100,,Invoice,,,,,,14/03/2018,14/03/2018,0.00,,135.59,,"-1,112.72"
,CS,AR,32002584,1007,100,,Cash sale,,,,,,15/03/2018,15/03/2018,0.00,,135.59,,"-1,248.31"
,IN,AR,30309531,1007,100,,Invoice,,,,,,22/03/2018,22/03/2018,0.00,,7.00,,"-1,255.31"
,IN,AR,30311069,1007,100,,Invoice,,,,,,27/03/2018,27/03/2018,0.00,,122.03,,"-1,377.34"
,CS,AR,32003407,1007,100,,Cash sale,,,,,,02/04/2018,02/04/2018,0.00,,135.59,,"-1,512.93"
,IN,AR,30313091,1007,100,,Invoice,,,,,,16/04/2018,16/04/2018,0.00,,135.59,,"-1,648.52"
,CN,AR,31017854,1007,100,,Credit Note,,,,,,18/04/2018,18/04/2018,135.59,,0.00,,"-1,512.93"
,IN,AR,30313103,1007,100,,Invoice,,,,,,19/04/2018,19/04/2018,0.00,,135.59,,"-1,648.52"
,IN,AR,30313108,1007,100,,Invoice,,,,,,23/04/2018,23/04/2018,0.00,,244.07,,"-1,892.59"
,IN,AR,30311348,1007,100,,Invoice,,,,,,26/04/2018,26/04/2018,0.00,,135.59,,"-2,028.18"
,CR,AR,33000135,1007,100,,Cash Return,,,,,,30/04/2018,30/04/2018,135.59,,0.00,,"-1,892.59"
,IN,AR,30314519,1007,100,,Invoice,,,,,,30/04/2018,30/04/2018,0.00,,135.59,,"-2,028.18"
,CN,AR,31017993,1007,100,,Credit Note,,,,,,07/05/2018,07/05/2018,135.59,,0.00,,"-1,892.59"
,IN,AR,30314560,1007,100,,Invoice,,,,,,07/05/2018,07/05/2018,0.00,,135.59,,"-2,028.18"
,IN,AR,30313969,1007,100,,Invoice,,,,,,10/05/2018,10/05/2018,0.00,,135.59,,"-2,163.77"
,IN,AR,30315247,1007,100,,Invoice,,,,,,23/05/2018,23/05/2018,0.00,,7.00,,"-2,170.77"
,IN,AR,30314698,1007,100,,Invoice,,,,,,24/05/2018,24/05/2018,0.00,,7.00,,"-2,177.77"
,IN,AR,30316056,1007,100,,Invoice,,,,,,31/05/2018,31/05/2018,0.00,,7.00,,"-2,184.77"
,CS,AR,32005753,1007,100,,Cash sale,,,,,,26/06/2018,26/06/2018,0.00,,271.19,,"-2,455.96"
,CS,AR,32005754,1007,100,,Cash sale,,,,,,26/06/2018,26/06/2018,0.00,,135.59,,"-2,591.55"
,IN,AR,30318521,1007,100,,Invoice,,,,,,26/06/2018,26/06/2018,0.00,,135.59,,"-2,727.14"
,CN,AR,31018303,1007,100,,Credit Note,,,,,,27/06/2018,27/06/2018,135.59,,0.00,,"-2,591.55"
,CN,AR,31018308,1007,100,,Credit Note,,,,,,27/06/2018,27/06/2018,135.59,,0.00,,"-2,455.96"
,IN,AR,30317537,1007,100,,Invoice,,,,,,27/06/2018,27/06/2018,0.00,,7.00,,"-2,462.96"
,IN,AR,30319685,1007,100,,Invoice,,,,,,10/07/2018,10/07/2018,0.00,,14.00,,"-2,476.96"
,IN,AR,30323484,1007,100,,Invoice,,,,,,10/08/2018,10/08/2018,0.00,,135.59,,"-2,612.55"
,CS,AR,32007872,1007,100,,Cash sale,,,,,,14/08/2018,14/08/2018,0.00,,135.59,,"-2,748.14"
,CS,AR,32007865,1007,100,,Cash sale,,,,,,16/08/2018,16/08/2018,0.00,,135.59,,"-2,883.73"
,CS,AR,32007868,1007,100,,Cash sale,,,,,,16/08/2018,16/08/2018,0.00,,135.59,,"-3,019.32"
,IN,AR,30323449,1007,100,,Invoice,,,,,,17/08/2018,17/08/2018,0.00,,271.19,,"-3,290.51"
,IN,AR,30324534,1007,100,,Invoice,,,,,,22/08/2018,22/08/2018,0.00,,28.00,,"-3,318.51"
,IN,AR,30326157,1007,100,,Invoice,,,,,,23/08/2018,23/08/2018,0.00,,135.59,,"-3,454.10"
,IN,AR,30326169,1007,100,,Invoice,,,,,,23/08/2018,23/08/2018,0.00,,135.59,,"-3,589.69"
,CR,AR,33000269,1007,100,,Cash Return,,,,,,28/08/2018,28/08/2018,135.59,,0.00,,"-3,454.10"
,IN,AR,30323850,1007,100,,Invoice,,,,,,28/08/2018,28/08/2018,0.00,,135.59,,"-3,589.69"
,IN,AR,30326045,1007,100,,Invoice,,,,,,28/08/2018,28/08/2018,0.00,,135.59,,"-3,725.28"
,IN,AR,30326213,1007,100,,Invoice,,,,,,29/08/2018,29/08/2018,0.00,,135.59,,"-3,860.87"
,IN,AR,30326188,1007,100,,Invoice,,,,,,30/08/2018,30/08/2018,0.00,,135.59,,"-3,996.46"
,CR,AR,33000271,1007,100,,Cash Return,,,,,,03/09/2018,03/09/2018,135.59,,0.00,,"-3,860.87"
,CS,AR,32008885,1007,100,,Cash sale,,,,,,03/09/2018,03/09/2018,0.00,,135.59,,"-3,996.46"
,CN,AR,31018979,1007,100,,Credit Note,,,,,,04/09/2018,04/09/2018,135.59,,0.00,,"-3,860.87"
,IN,AR,30326153,1007,100,,Invoice,,,,,,04/09/2018,04/09/2018,0.00,,135.59,,"-3,996.46"
,IN,AR,30324840,1007,100,,Invoice,,,,,,06/09/2018,06/09/2018,0.00,,7.00,,"-4,003.46"
,IN,AR,30325444,1007,100,,Invoice,,,,,,14/09/2018,14/09/2018,0.00,,135.59,,"-4,139.05"
,IN,AR,30327676,1007,100,,Invoice,,,,,,17/09/2018,17/09/2018,0.00,,135.59,,"-4,274.64"
,IN,AR,30327678,1007,100,,Invoice,,,,,,17/09/2018,17/09/2018,0.00,,135.59,,"-4,410.23"
,CS,AR,32009436,1007,100,,Cash sale,,,,,,20/09/2018,20/09/2018,0.00,,135.59,,"-4,545.82"
,IN,AR,30326861,1007,100,,Invoice,,,,,,30/09/2018,30/09/2018,0.00,,14.00,,"-4,559.82"
,IN,AR,30327893,1007,100,,Invoice,,,,,,06/10/2018,06/10/2018,0.00,,21.00,,"-4,580.82"
,IN,AR,30329162,1007,100,,Invoice,,,,,,11/10/2018,11/10/2018,0.00,,21.00,,"-4,601.82"
,IN,AR,30328989,1007,100,,Invoice,,,,,,18/10/2018,18/10/2018,0.00,,7.00,,"-4,608.82"
,IN,AR,30328705,1007,100,,Invoice,,,,,,24/10/2018,24/10/2018,0.00,,7.00,,"-4,615.82"
,IN,AR,30331402,1007,100,,Invoice,,,,,,02/11/2018,02/11/2018,0.00,,14.00,,"-4,629.82"
,IN,AR,30330803,1007,100,,Invoice,,,,,,05/11/2018,05/11/2018,0.00,,135.59,,"-4,765.41"
,IN,AR,30331098,1007,100,,Invoice,,,,,,08/11/2018,08/11/2018,0.00,,35.00,,"-4,800.41"
,IN,AR,30331067,1007,100,,Invoice,,,,,,09/11/2018,09/11/2018,0.00,,14.00,,"-4,814.41"
,IN,AR,30332728,1007,100,,Invoice,,,,,,21/11/2018,21/11/2018,0.00,,7.00,,"-4,821.41"
,CS,AR,32011344,1007,100,,Cash sale,,,,,,27/11/2018,27/11/2018,0.00,,7.00,,"-4,828.41"
,IN,AR,30331917,1007,100,,Invoice,,,,,,27/11/2018,27/11/2018,0.00,,7.00,,"-4,835.41"
,,,,,,,,,,,,,,,,,,,
,Account: 1000400 - Sales - Water Dispensers And Water Accessories,,,,,,,,,,,,,,,,,,
,Pr.,Mod.,Reference,Dept,Div,Suffix,Details,,,Cheque,,User,Doc Date,Post Date,Debit,,Credit,,Balance
,IN,AR,30306136,1007,100,,Invoice,,,,,,04/01/2018,04/01/2018,0.00,,8.47,,-8.47
,IN,AR,30306618,1007,100,,Invoice,,,,,,04/01/2018,04/01/2018,0.00,,177.97,,-186.44
,CS,AR,32000539,1007,100,,Cash sale,,,,,,08/01/2018,08/01/2018,0.00,,8.47,,-194.91
,CS,AR,32000204,1007,100,,Cash sale,,,,,,10/01/2018,10/01/2018,0.00,,21.19,,-216.10
,IN,AR,30306638,1007,100,,Invoice,,,,,,10/01/2018,10/01/2018,0.00,,42.37,,-258.47
,CS,AR,32000558,1007,100,,Cash sale,,,,,,11/01/2018,11/01/2018,0.00,,42.37,,-300.84
,CS,AR,32000559,1007,100,,Cash sale,,,,,,11/01/2018,11/01/2018,0.00,,42.37,,-343.21
,CS,AR,32000795,1007,100,,Cash sale,,,,,,11/01/2018,11/01/2018,0.00,,21.19,,-364.40
,CN,AR,31016996,1007,100,,Credit Note,,,,,,12/01/2018,12/01/2018,8.48,,0.00,,-355.92
,CR,AR,33000015,1007,100,,Cash Return,,,,,,15/01/2018,15/01/2018,42.37,,0.00,,-313.55
,CS,AR,32000907,1007,100,,Cash sale,,,,,,15/01/2018,15/01/2018,0.00,,10.17,,-323.72
,CS,AR,32000855,1007,100,,Cash sale,,,,,,16/01/2018,16/01/2018,0.00,,10.17,,-333.89
,CS,AR,32000176,1007,100,,Cash sale,,,,,,18/01/2018,18/01/2018,0.00,,161.02,,-494.91
,CS,AR,32000407,1007,100,,Cash sale,,,,,,19/01/2018,19/01/2018,0.00,,10.17,,-505.08
,IN,AR,30304483,1007,100,,Invoice,,,,,,19/01/2018,19/01/2018,0.00,,10.17,,-515.25
,IN,AR,30304678,1007,100,,Invoice,,,,,,24/01/2018,24/01/2018,0.00,,8.47,,-523.72
,IN,AR,30305856,1007,100,,Invoice,,,,,,24/01/2018,24/01/2018,0.00,,42.37,,-566.09
,CS,AR,32000922,1007,100,,Cash sale,,,,,,25/01/2018,25/01/2018,0.00,,161.02,,-727.11
,IN,AR,30306485,1007,100,,Invoice,,,,,,26/01/2018,26/01/2018,0.00,,12.71,,-739.82
,IN,AR,30305421,1007,100,,Invoice,,,,,,30/01/2018,30/01/2018,0.00,,8.47,,-748.29
,IN,AR,30306190,1007,100,,Invoice,,,,,,30/01/2018,30/01/2018,0.00,,8.47,,-756.76
,IN,AR,30304435,1007,100,,Invoice,,,,,,31/01/2018,31/01/2018,0.00,,144.92,,-901.68
,IN,AR,30306319,1007,100,,Invoice,,,,,,31/01/2018,31/01/2018,0.00,,355.93,,"-1,257.61"
,IN,AR,30306824,1007,100,,Invoice,,,,,,02/02/2018,02/02/2018,0.00,,8.47,,"-1,266.08"
,IN,AR,30307449,1007,100,,Invoice,,,,,,02/02/2018,02/02/2018,0.00,,355.93,,"-1,622.01"
,IN,AR,30307078,1007,100,,Invoice,,,,,,07/02/2018,07/02/2018,0.00,,10.17,,"-1,632.18"
,IN,AR,30308385,1007,100,,Invoice,,,,,,07/02/2018,07/02/2018,0.00,,14.00,,"-1,646.18"
,CR,AR,33000061,1007,100,,Cash Return,,,,,,08/02/2018,08/02/2018,21.19,,0.00,,"-1,624.99"
,CS,AR,32001687,1007,100,,Cash sale,,,,,,08/02/2018,08/02/2018,0.00,,21.19,,"-1,646.18"
,IN,AR,30306711,1007,100,,Invoice,,,,,,08/02/2018,08/02/2018,0.00,,21.19,,"-1,667.37"
,IN,AR,30306961,1007,100,,Invoice,,,,,,08/02/2018,08/02/2018,0.00,,8.47,,"-1,675.84"
,IN,AR,30308238,1007,100,,Invoice,,,,,,08/02/2018,08/02/2018,0.00,,42.37,,"-1,718.21"
,CN,AR,31017438,1007,100,,Credit Note,,,,,,12/02/2018,12/02/2018,21.19,,0.00,,"-1,697.02"
,CS,AR,32001281,1007,100,,Cash sale,,,,,,12/02/2018,12/02/2018,0.00,,161.02,,"-1,858.04"
,CS,AR,32001690,1007,100,,Cash sale,,,,,,12/02/2018,12/02/2018,0.00,,177.97,,"-2,036.01"
,IN,AR,30307467,1007,100,,Invoice,,,,,,12/02/2018,12/02/2018,0.00,,8.47,,"-2,044.48"
,IN,AR,30308715,1007,100,,Invoice,,,,,,12/02/2018,12/02/2018,0.00,,21.19,,"-2,065.67"
,CS,AR,32001243,1007,100,,Cash sale,,,,,,14/02/2018,14/02/2018,0.00,,8.47,,"-2,074.14"
,CS,AR,32001440,1007,100,,Cash sale,,,,,,16/02/2018,16/02/2018,0.00,,63.56,,"-2,137.70"
,IN,AR,30306920,1007,100,,Invoice,,,,,,16/02/2018,16/02/2018,0.00,,161.02,,"-2,298.72"
,IN,AR,30307002,1007,100,,Invoice,,,,,,19/02/2018,19/02/2018,0.00,,8.47,,"-2,307.19"
,IN,AR,30307562,1007,100,,Invoice,,,,,,19/02/2018,19/02/2018,0.00,,8.47,,"-2,315.66"
,IN,AR,30307008,1007,100,,Invoice,,,,,,22/02/2018,22/02/2018,0.00,,8.47,,"-2,324.13"
,IN,AR,30307226,1007,100,,Invoice,,,,,,22/02/2018,22/02/2018,0.00,,84.75,,"-2,408.88"
,IN,AR,30307522,1007,100,,Invoice,,,,,,22/02/2018,22/02/2018,0.00,,8.47,,"-2,417.35"
,CS,AR,32001692,1007,100,,Cash sale,,,,,,23/02/2018,23/02/2018,0.00,,25.42,,"-2,442.77"
,IN,AR,30308376,1007,100,,Invoice,,,,,,23/02/2018,23/02/2018,0.00,,12.71,,"-2,455.48"
,CS,AR,32001697,1007,100,,Cash sale,,,,,,26/02/2018,26/02/2018,0.00,,21.19,,"-2,476.67"
,CS,AR,32001647,1007,100,,Cash sale,,,,,,27/02/2018,27/02/2018,0.00,,10.17,,"-2,486.84"
,IN,AR,30307257,1007,100,,Invoice,,,,,,28/02/2018,28/02/2018,0.00,,21.19,,"-2,508.03"
,IN,AR,30307989,1007,100,,Invoice,,,,,,28/02/2018,28/02/2018,0.00,,8.47,,"-2,516.50"
,IN,AR,30308280,1007,100,,Invoice,,,,,,28/02/2018,28/02/2018,0.00,,16.94,,"-2,533.44"
,IN,AR,30308785,1007,100,,Invoice,,,,,,28/02/2018,28/02/2018,0.00,,25.42,,"-2,558.86"
,IN,AR,30309710,1007,100,,Invoice,,,,,,01/03/2018,01/03/2018,0.00,,8.47,,"-2,567.33"
,CS,AR,32002573,1007,100,,Cash sale,,,,,,02/03/2018,02/03/2018,0.00,,177.97,,"-2,745.30"
,IN,AR,30310996,1007,100,,Invoice,,,,,,02/03/2018,02/03/2018,0.00,,10.17,,"-2,755.47"
,CS,AR,32002251,1007,100,,Cash sale,,,,,,05/03/2018,05/03/2018,0.00,,177.97,,"-2,933.44"
,IN,AR,30309864,1007,100,,Invoice,,,,,,05/03/2018,05/03/2018,0.00,,16.95,,"-2,950.39"
,IN,AR,30311004,1007,100,,Invoice,,,,,,06/03/2018,06/03/2018,0.00,,177.97,,"-3,128.36"
,CS,AR,32002563,1007,100,,Cash sale,,,,,,08/03/2018,08/03/2018,0.00,,21.19,,"-3,149.55"
,IN,AR,30310698,1007,100,,Invoice,,,,,,12/03/2018,12/03/2018,0.00,,8.47,,"-3,158.02"
,IN,AR,30311054,1007,100,,Invoice,,,,,,15/03/2018,15/03/2018,0.00,,21.19,,"-3,179.21"
,CS,AR,32002583,1007,100,,Cash sale,,,,,,20/03/2018,20/03/2018,0.00,,21.19,,"-3,200.40"
,CN,AR,31017684,1007,100,,Credit Note,,,,,,21/03/2018,21/03/2018,21.19,,0.00,,"-3,179.21"
,IN,AR,30311059,1007,100,,Invoice,,,,,,21/03/2018,21/03/2018,0.00,,10.17,,"-3,189.38"
,CS,AR,32002586,1007,100,,Cash sale,,,,,,22/03/2018,22/03/2018,0.00,,21.19,,"-3,210.57"
,IN,AR,30309033,1007,100,,Invoice,,,,,,22/03/2018,22/03/2018,0.00,,20.34,,"-3,230.91"
,CS,AR,32002290,1007,100,,Cash sale,,,,,,23/03/2018,23/03/2018,0.00,,145.76,,"-3,376.67"
,IN,AR,30311061,1007,100,,Invoice,,,,,,24/03/2018,24/03/2018,0.00,,21.19,,"-3,397.86"
,CN,AR,31017686,1007,100,,Credit Note,,,,,,27/03/2018,27/03/2018,10.17,,0.00,,"-3,387.69"
,IN,AR,30311055,1007,100,,Invoice,,,,,,27/03/2018,27/03/2018,0.00,,21.19,,"-3,408.88"
,IN,AR,30311060,1007,100,,Invoice,,,,,,27/03/2018,27/03/2018,0.00,,10.17,,"-3,419.05"
,IN,AR,30310528,1007,100,,Invoice,,,,,,28/03/2018,28/03/2018,0.00,,42.37,,"-3,461.42"
,IN,AR,30310307,1007,100,,Invoice,,,,,,31/03/2018,31/03/2018,0.00,,21.19,,"-3,482.61"
,IN,AR,30313075,1007,100,,Invoice,,,,,,03/04/2018,03/04/2018,0.00,,21.19,,"-3,503.80"
,IN,AR,30313082,1007,100,,Invoice,,,,,,05/04/2018,05/04/2018,0.00,,46.61,,"-3,550.41"
,IN,AR,30311199,1007,100,,Invoice,,,,,,06/04/2018,06/04/2018,0.00,,8.47,,"-3,558.88"
,CS,AR,32003418,1007,100,,Cash sale,,,,,,12/04/2018,12/04/2018,0.00,,84.75,,"-3,643.63"
,IN,AR,30312686,1007,100,,Invoice,,,,,,12/04/2018,12/04/2018,0.00,,8.47,,"-3,652.10"
,IN,AR,30311416,1007,100,,Invoice,,,,,,13/04/2018,13/04/2018,0.00,,135.60,,"-3,787.70"
,IN,AR,30313094,1007,100,,Invoice,,,,,,14/04/2018,14/04/2018,0.00,,10.17,,"-3,797.87"
,IN,AR,30311417,1007,100,,Invoice,,,,,,16/04/2018,16/04/2018,0.00,,144.92,,"-3,942.79"
,CN,AR,31017808,1007,100,,Credit Note,,,,,,17/04/2018,17/04/2018,42.38,,0.00,,"-3,900.41"
,CN,AR,31017836,1007,100,,Credit Note,,,,,,18/04/2018,18/04/2018,10.17,,0.00,,"-3,890.24"
,IN,AR,30313102,1007,100,,Invoice,,,,,,18/04/2018,18/04/2018,0.00,,161.02,,"-4,051.26"
,CN,AR,31017855,1007,100,,Credit Note,,,,,,19/04/2018,19/04/2018,161.02,,0.00,,"-3,890.24"
,CS,AR,32002818,1007,100,,Cash sale,,,,,,19/04/2018,19/04/2018,0.00,,8.47,,"-3,898.71"
,CS,AR,32003417,1007,100,,Cash sale,,,,,,24/04/2018,24/04/2018,0.00,,21.19,,"-3,919.90"
,CN,AR,31017990,1007,100,,Credit Note,,,,,,04/05/2018,04/05/2018,21.19,,0.00,,"-3,898.71"
,CS,AR,32003786,1007,100,,Cash sale,,,,,,04/05/2018,04/05/2018,0.00,,8.47,,"-3,907.18"
,CS,AR,32003998,1007,100,,Cash sale,,,,,,04/05/2018,04/05/2018,0.00,,21.19,,"-3,928.37"
,CN,AR,31017988,1007,100,,Credit Note,,,,,,07/05/2018,07/05/2018,21.19,,0.00,,"-3,907.18"
,CN,AR,31017993,1007,100,,Credit Note,,,,,,07/05/2018,07/05/2018,177.97,,0.00,,"-3,729.21"
,IN,AR,30314538,1007,100,,Invoice,,,,,,07/05/2018,07/05/2018,0.00,,21.19,,"-3,750.40"
,IN,AR,30314560,1007,100,,Invoice,,,,,,07/05/2018,07/05/2018,0.00,,177.97,,"-3,928.37"
,IN,AR,30314025,1007,100,,Invoice,,,,,,11/05/2018,11/05/2018,0.00,,8.47,,"-3,936.84"
,CN,AR,31017994,1007,100,,Credit Note,,,,,,14/05/2018,14/05/2018,20.34,,0.00,,"-3,916.50"
,IN,AR,30314573,1007,100,,Invoice,,,,,,14/05/2018,14/05/2018,0.00,,10.17,,"-3,926.67"
,IN,AR,30314574,1007,100,,Invoice,,,,,,14/05/2018,14/05/2018,0.00,,10.17,,"-3,936.84"
,CS,AR,32004327,1007,100,,Cash sale,,,,,,17/05/2018,17/05/2018,0.00,,8.47,,"-3,945.31"
,CS,AR,32004424,1007,100,,Cash sale,,,,,,18/05/2018,18/05/2018,0.00,,12.71,,"-3,958.02"
,IN,AR,30315497,1007,100,,Invoice,,,,,,19/05/2018,19/05/2018,0.00,,10.17,,"-3,968.19"
,IN,AR,30314693,1007,100,,Invoice,,,,,,21/05/2018,21/05/2018,0.00,,8.47,,"-3,976.66"
,IN,AR,30315501,1007,100,,Invoice,,,,,,21/05/2018,21/05/2018,0.00,,161.02,,"-4,137.68"
,CN,AR,31018073,1007,100,,Credit Note,,,,,,22/05/2018,22/05/2018,10.17,,0.00,,"-4,127.51"
,IN,AR,30314623,1007,100,,Invoice,,,,,,24/05/2018,24/05/2018,0.00,,8.47,,"-4,135.98"
,IN,AR,30314848,1007,100,,Invoice,,,,,,25/05/2018,25/05/2018,0.00,,84.75,,"-4,220.73"
,IN,AR,30315981,1007,100,,Invoice,,,,,,29/05/2018,29/05/2018,0.00,,8.47,,"-4,229.20"
,IN,AR,30315669,1007,100,,Invoice,,,,,,31/05/2018,31/05/2018,0.00,,8.47,,"-4,237.67"
,IN,AR,30315686,1007,100,,Invoice,,,,,,31/05/2018,31/05/2018,0.00,,8.47,,"-4,246.14"
,IN,AR,30316373,1007,100,,Invoice,,,,,,01/06/2018,01/06/2018,0.00,,10.17,,"-4,256.31"
,CS,AR,32004724,1007,100,,Cash sale,,,,,,05/06/2018,05/06/2018,0.00,,10.17,,"-4,266.48"
,IN,AR,30316651,1007,100,,Invoice,,,,,,08/06/2018,08/06/2018,0.00,,25.42,,"-4,291.90"
,CS,AR,32005081,1007,100,,Cash sale,,,,,,11/06/2018,11/06/2018,0.00,,8.47,,"-4,300.37"
,CS,AR,32005253,1007,100,,Cash sale,,,,,,11/06/2018,11/06/2018,0.00,,46.61,,"-4,346.98"
,IN,AR,30316794,1007,100,,Invoice,,,,,,12/06/2018,12/06/2018,0.00,,161.02,,"-4,508.00"
,IN,AR,30317044,1007,100,,Invoice,,,,,,15/06/2018,15/06/2018,0.00,,16.94,,"-4,524.94"
,IN,AR,30317132,1007,100,,Invoice,,,,,,15/06/2018,15/06/2018,0.00,,33.90,,"-4,558.84"
,CS,AR,32005404,1007,100,,Cash sale,,,,,,19/06/2018,19/06/2018,0.00,,16.95,,"-4,575.79"
,IN,AR,30318015,1007,100,,Invoice,,,,,,20/06/2018,20/06/2018,0.00,,8.47,,"-4,584.26"
,IN,AR,30317365,1007,100,,Invoice,,,,,,21/06/2018,21/06/2018,0.00,,8.47,,"-4,592.73"
,CN,AR,31018302,1007,100,,Credit Note,,,,,,26/06/2018,26/06/2018,21.19,,0.00,,"-4,571.54"
,IN,AR,30318387,1007,100,,Invoice,,,,,,26/06/2018,26/06/2018,0.00,,161.02,,"-4,732.56"
,IN,AR,30318399,1007,100,,Invoice,,,,,,26/06/2018,26/06/2018,0.00,,84.74,,"-4,817.30"
,IN,AR,30318516,1007,100,,Invoice,,,,,,26/06/2018,26/06/2018,0.00,,21.19,,"-4,838.49"
,IN,AR,30318528,1007,100,,Invoice,,,,,,26/06/2018,26/06/2018,0.00,,46.61,,"-4,885.10"
,IN,AR,30318546,1007,100,,Invoice,,,,,,26/06/2018,26/06/2018,0.00,,10.17,,"-4,895.27"
,CN,AR,31018305,1007,100,,Credit Note,,,,,,27/06/2018,27/06/2018,46.61,,0.00,,"-4,848.66"
,CN,AR,31018307,1007,100,,Credit Note,,,,,,27/06/2018,27/06/2018,10.17,,0.00,,"-4,838.49"
,CN,AR,31018311,1007,100,,Credit Note,,,,,,27/06/2018,27/06/2018,25.42,,0.00,,"-4,813.07"
,IN,AR,30318113,1007,100,,Invoice,,,,,,27/06/2018,27/06/2018,0.00,,50.84,,"-4,863.91"
,IN,AR,30318555,1007,100,,Invoice,,,,,,27/06/2018,27/06/2018,0.00,,25.42,,"-4,889.33"
,IN,AR,30318002,1007,100,,Invoice,,,,,,28/06/2018,28/06/2018,0.00,,8.47,,"-4,897.80"
,CS,AR,32005748,1007,100,,Cash sale,,,,,,29/06/2018,29/06/2018,0.00,,21.19,,"-4,918.99"
,IN,AR,30317579,1007,100,,Invoice,,,,,,30/06/2018,30/06/2018,0.00,,8.47,,"-4,927.46"
,CN,AR,31018325,1007,100,,Credit Note,,,,,,02/07/2018,02/07/2018,8.48,,0.00,,"-4,918.98"
,CN,AR,31018349,1007,100,,Credit Note,,,,,,02/07/2018,02/07/2018,21.19,,0.00,,"-4,897.79"
,IN,AR,30318811,1007,100,,Invoice,,,,,,02/07/2018,02/07/2018,0.00,,8.47,,"-4,906.26"
,IN,AR,30318768,1007,100,,Invoice,,,,,,03/07/2018,03/07/2018,0.00,,8.47,,"-4,914.73"
,IN,AR,30319212,1007,100,,Invoice,,,,,,03/07/2018,03/07/2018,0.00,,135.59,,"-5,050.32"
,IN,AR,30319193,1007,100,,Invoice,,,,,,04/07/2018,04/07/2018,0.00,,8.47,,"-5,058.79"
,IN,AR,30319836,1007,100,,Invoice,,,,,,11/07/2018,11/07/2018,0.00,,16.94,,"-5,075.73"
,IN,AR,30319834,1007,100,,Invoice,,,,,,12/07/2018,12/07/2018,0.00,,8.47,,"-5,084.20"
,CN,AR,31018373,1007,100,,Credit Note,,,,,,13/07/2018,13/07/2018,8.48,,0.00,,"-5,075.72"
,CN,AR,31018409,1007,100,,Credit Note,,,,,,13/07/2018,13/07/2018,10.17,,0.00,,"-5,065.55"
,CS,AR,32006555,1007,100,,Cash sale,,,,,,13/07/2018,13/07/2018,0.00,,10.17,,"-5,075.72"
,IN,AR,30320043,1007,100,,Invoice,,,,,,13/07/2018,13/07/2018,0.00,,8.47,,"-5,084.19"
,IN,AR,30320052,1007,100,,Invoice,,,,,,16/07/2018,16/07/2018,0.00,,8.47,,"-5,092.66"
,IN,AR,30319754,1007,100,,Invoice,,,,,,18/07/2018,18/07/2018,0.00,,8.47,,"-5,101.13"
,CN,AR,31018492,1007,100,,Credit Note,,,,,,23/07/2018,23/07/2018,56.78,,0.00,,"-5,044.35"
,IN,AR,30320454,1007,100,,Invoice,,,,,,23/07/2018,23/07/2018,0.00,,8.47,,"-5,052.82"
,IN,AR,30321406,1007,100,,Invoice,,,,,,23/07/2018,23/07/2018,0.00,,56.78,,"-5,109.60"
,CS,AR,32006752,1007,100,,Cash sale,,,,,,24/07/2018,24/07/2018,0.00,,8.47,,"-5,118.07"
,CN,AR,31018438,1007,100,,Credit Note,,,,,,25/07/2018,25/07/2018,10.17,,0.00,,"-5,107.90"
,IN,AR,30320954,1007,100,,Invoice,,,,,,30/07/2018,30/07/2018,0.00,,8.47,,"-5,116.37"
,CN,AR,31018463,1007,100,,Credit Note,,,,,,31/07/2018,31/07/2018,8.47,,0.00,,"-5,107.90"
,CN,AR,31018644,1007,100,,Credit Note,,,,,,08/08/2018,08/08/2018,42.37,,0.00,,"-5,065.53"
,IN,AR,30323485,1007,100,,Invoice,,,,,,08/08/2018,08/08/2018,0.00,,21.19,,"-5,086.72"
,IN,AR,30323486,1007,100,,Invoice,,,,,,08/08/2018,08/08/2018,0.00,,21.19,,"-5,107.91"
,CS,AR,32007844,1007,100,,Cash sale,,,,,,10/08/2018,10/08/2018,0.00,,46.61,,"-5,154.52"
,IN,AR,30322446,1007,100,,Invoice,,,,,,10/08/2018,10/08/2018,0.00,,8.47,,"-5,162.99"
,CN,AR,31018633,1007,100,,Credit Note,,,,,,11/08/2018,11/08/2018,46.61,,0.00,,"-5,116.38"
,IN,AR,30323496,1007,100,,Invoice,,,,,,14/08/2018,14/08/2018,0.00,,21.19,,"-5,137.57"
,IN,AR,30323504,1007,100,,Invoice,,,,,,14/08/2018,14/08/2018,0.00,,161.02,,"-5,298.59"
,CS,AR,32007670,1007,100,,Cash sale,,,,,,17/08/2018,17/08/2018,0.00,,122.03,,"-5,420.62"
,CS,AR,32007560,1007,100,,Cash sale,,,,,,20/08/2018,20/08/2018,0.00,,8.47,,"-5,429.09"
,IN,AR,30322875,1007,100,,Invoice,,,,,,21/08/2018,21/08/2018,0.00,,161.02,,"-5,590.11"
,CS,AR,32008852,1007,100,,Cash sale,,,,,,22/08/2018,22/08/2018,0.00,,21.19,,"-5,611.30"
,IN,AR,30326170,1007,100,,Invoice,,,,,,23/08/2018,23/08/2018,0.00,,171.19,,"-5,782.49"
,CS,AR,32008858,1007,100,,Cash sale,,,,,,28/08/2018,28/08/2018,0.00,,135.59,,"-5,918.08"
,IN,AR,30325395,1007,100,,Invoice,,,,,,28/08/2018,28/08/2018,0.00,,8.47,,"-5,926.55"
,IN,AR,30326147,1007,100,,Invoice,,,,,,29/08/2018,29/08/2018,0.00,,46.61,,"-5,973.16"
,CN,AR,31018658,1007,100,,Credit Note,,,,,,30/08/2018,30/08/2018,8.48,,0.00,,"-5,964.68"
,CS,AR,32008634,1007,100,,Cash sale,,,,,,30/08/2018,30/08/2018,0.00,,177.97,,"-6,142.65"
,CS,AR,32008854,1007,100,,Cash sale,,,,,,30/08/2018,30/08/2018,0.00,,177.97,,"-6,320.62"
,IN,AR,30324790,1007,100,,Invoice,,,,,,30/08/2018,30/08/2018,0.00,,10.17,,"-6,330.79"
,IN,AR,30323646,1007,100,,Invoice,,,,,,31/08/2018,31/08/2018,0.00,,41.95,,"-6,372.74"
,CS,AR,32008867,1007,100,,Cash sale,,,,,,03/09/2018,03/09/2018,0.00,,177.97,,"-6,550.71"
,IN,AR,30326124,1007,100,,Invoice,,,,,,03/09/2018,03/09/2018,0.00,,8.47,,"-6,559.18"
,IN,AR,30324207,1007,100,,Invoice,,,,,,05/09/2018,05/09/2018,0.00,,8.47,,"-6,567.65"
,CS,AR,32008875,1007,100,,Cash sale,,,,,,06/09/2018,06/09/2018,0.00,,8.47,,"-6,576.12"
,IN,AR,30323919,1007,100,,Invoice,,,,,,06/09/2018,06/09/2018,0.00,,38.14,,"-6,614.26"
,CS,AR,32008674,1007,100,,Cash sale,,,,,,07/09/2018,07/09/2018,0.00,,8.47,,"-6,622.73"
,CS,AR,32008851,1007,100,,Cash sale,,,,,,07/09/2018,07/09/2018,0.00,,177.97,,"-6,800.70"
,IN,AR,30325064,1007,100,,Invoice,,,,,,10/09/2018,10/09/2018,0.00,,8.47,,"-6,809.17"
,IN,AR,30326253,1007,100,,Invoice,,,,,,10/09/2018,10/09/2018,0.00,,177.97,,"-6,987.14"
,CN,AR,31018726,1007,100,,Credit Note,,,,,,11/09/2018,11/09/2018,8.47,,0.00,,"-6,978.67"
,CS,AR,32008276,1007,100,,Cash sale,,,,,,11/09/2018,11/09/2018,0.00,,144.92,,"-7,123.59"
,IN,AR,30324407,1007,100,,Invoice,,,,,,11/09/2018,11/09/2018,0.00,,8.47,,"-7,132.06"
,IN,AR,30326255,1007,100,,Invoice,,,,,,12/09/2018,12/09/2018,0.00,,161.02,,"-7,293.08"
,IN,AR,30323799,1007,100,,Invoice,,,,,,13/09/2018,13/09/2018,0.00,,10.17,,"-7,303.25"
,IN,AR,30324502,1007,100,,Invoice,,,,,,13/09/2018,13/09/2018,0.00,,8.47,,"-7,311.72"
,IN,AR,30325731,1007,100,,Invoice,,,,,,14/09/2018,14/09/2018,0.00,,10.17,,"-7,321.89"
,IN,AR,30327219,1007,100,,Invoice,,,,,,17/09/2018,17/09/2018,0.00,,16.95,,"-7,338.84"
,IN,AR,30327636,1007,100,,Invoice,,,,,,17/09/2018,17/09/2018,0.00,,161.02,,"-7,499.86"
,IN,AR,30327613,1007,100,,Invoice,,,,,,18/09/2018,18/09/2018,0.00,,8.47,,"-7,508.33"
,CS,AR,32009437,1007,100,,Cash sale,,,,,,20/09/2018,20/09/2018,0.00,,21.19,,"-7,529.52"
,CS,AR,32009438,1007,100,,Cash sale,,,,,,20/09/2018,20/09/2018,0.00,,25.42,,"-7,554.94"
,CS,AR,32009441,1007,100,,Cash sale,,,,,,20/09/2018,20/09/2018,0.00,,177.97,,"-7,732.91"
,IN,AR,30326405,1007,100,,Invoice,,,,,,24/09/2018,24/09/2018,0.00,,8.47,,"-7,741.38"
,IN,AR,30327688,1007,100,,Invoice,,,,,,24/09/2018,24/09/2018,0.00,,21.19,,"-7,762.57"
,CN,AR,31019073,1007,100,,Credit Note,,,,,,25/09/2018,25/09/2018,16.95,,0.00,,"-7,745.62"
,IN,AR,30326871,1007,100,,Invoice,,,,,,25/09/2018,25/09/2018,0.00,,8.47,,"-7,754.09"
,IN,AR,30326415,1007,100,,Invoice,,,,,,26/09/2018,26/09/2018,0.00,,8.47,,"-7,762.56"
,CS,AR,32009352,1007,100,,Cash sale,,,,,,27/09/2018,27/09/2018,0.00,,8.47,,"-7,771.03"
,IN,AR,30326323,1007,100,,Invoice,,,,,,30/09/2018,30/09/2018,0.00,,25.42,,"-7,796.45"
,IN,AR,30326725,1007,100,,Invoice,,,,,,30/09/2018,30/09/2018,0.00,,8.47,,"-7,804.92"
,IN,AR,30326755,1007,100,,Invoice,,,,,,30/09/2018,30/09/2018,0.00,,8.47,,"-7,813.39"
,IN,AR,30326903,1007,100,,Invoice,,,,,,30/09/2018,30/09/2018,0.00,,8.47,,"-7,821.86"
,IN,AR,30327773,1007,100,,Invoice,,,,,,01/10/2018,01/10/2018,0.00,,135.59,,"-7,957.45"
,IN,AR,30327797,1007,100,,Invoice,,,,,,03/10/2018,03/10/2018,0.00,,19.07,,"-7,976.52"
,IN,AR,30328120,1007,100,,Invoice,,,,,,04/10/2018,04/10/2018,0.00,,3.50,,"-7,980.02"
,CN,AR,31019164,1007,100,,Credit Note,,,,,,05/10/2018,05/10/2018,3.50,,0.00,,"-7,976.52"
,CS,AR,32009637,1007,100,,Cash sale,,,,,,05/10/2018,05/10/2018,0.00,,46.61,,"-8,023.13"
,IN,AR,30327767,1007,100,,Invoice,,,,,,05/10/2018,05/10/2018,0.00,,177.97,,"-8,201.10"
,IN,AR,30328296,1007,100,,Invoice,,,,,,05/10/2018,05/10/2018,0.00,,177.97,,"-8,379.07"
,IN,AR,30328212,1007,100,,Invoice,,,,,,06/10/2018,06/10/2018,0.00,,8.47,,"-8,387.54"
,IN,AR,30328298,1007,100,,Invoice,,,,,,06/10/2018,06/10/2018,0.00,,21.19,,"-8,408.73"
,IN,AR,30329585,1007,100,,Invoice,,,,,,09/10/2018,09/10/2018,0.00,,161.02,,"-8,569.75"
,IN,AR,30329786,1007,100,,Invoice,,,,,,09/10/2018,09/10/2018,0.00,,177.97,,"-8,747.72"
,CN,AR,31019385,1007,100,,Credit Note,,,,,,09/10/2018,09/10/2018,35.00,,0.00,,"-8,712.72"
,IN,AR,30330600,1007,100,,Invoice,,,,,,09/10/2018,09/10/2018,0.00,,8.47,,"-8,721.19"
,IN,AR,30330637,1007,100,,Invoice,,,,,,09/10/2018,09/10/2018,0.00,,35.00,,"-8,756.19"
,IN,AR,30330638,1007,100,,Invoice,,,,,,09/10/2018,09/10/2018,0.00,,35.00,,"-8,791.19"
,CN,AR,31019382,1007,100,,Credit Note,,,,,,10/10/2018,10/10/2018,8.47,,0.00,,"-8,782.72"
,IN,AR,30330487,1007,100,,Invoice,,,,,,11/10/2018,11/10/2018,0.00,,21.19,,"-8,803.91"
,IN,AR,30330630,1007,100,,Invoice,,,,,,11/10/2018,11/10/2018,0.00,,8.47,,"-8,812.38"
,IN,AR,30330640,1007,100,,Invoice,,,,,,11/10/2018,11/10/2018,0.00,,3.50,,"-8,815.88"
,CN,AR,31019377,1007,100,,Credit Note,,,,,,12/10/2018,12/10/2018,21.19,,0.00,,"-8,794.69"
,IN,AR,30328341,1007,100,,Invoice,,,,,,12/10/2018,12/10/2018,0.00,,144.92,,"-8,939.61"
,IN,AR,30330498,1007,100,,Invoice,,,,,,12/10/2018,12/10/2018,0.00,,21.19,,"-8,960.80"
,IN,AR,30330644,1007,100,,Invoice,,,,,,15/10/2018,15/10/2018,0.00,,3.50,,"-8,964.30"
,CS,AR,32010581,1007,100,,Cash sale,,,,,,16/10/2018,16/10/2018,0.00,,21.19,,"-8,985.49"
,CS,AR,32010625,1007,100,,Cash sale,,,,,,16/10/2018,16/10/2018,0.00,,8.47,,"-8,993.96"
,IN,AR,30330564,1007,100,,Invoice,,,,,,16/10/2018,16/10/2018,0.00,,8.47,,"-9,002.43"
,IN,AR,30330712,1007,100,,Invoice,,,,,,16/10/2018,16/10/2018,0.00,,8.47,,"-9,010.90"
,IN,AR,30330647,1007,100,,Invoice,,,,,,18/10/2018,18/10/2018,0.00,,10.50,,"-9,021.40"
,IN,AR,30330648,1007,100,,Invoice,,,,,,19/10/2018,19/10/2018,0.00,,3.50,,"-9,024.90"
,CS,AR,32010619,1007,100,,Cash sale,,,,,,23/10/2018,23/10/2018,0.00,,177.97,,"-9,202.87"
,CS,AR,32010626,1007,100,,Cash sale,,,,,,26/10/2018,26/10/2018,0.00,,8.47,,"-9,211.34"
,CS,AR,32010615,1007,100,,Cash sale,,,,,,29/10/2018,29/10/2018,0.00,,21.19,,"-9,232.53"
,CS,AR,32010623,1007,100,,Cash sale,,,,,,31/10/2018,31/10/2018,0.00,,42.37,,"-9,274.90"
,CS,AR,32010624,1007,100,,Cash sale,,,,,,31/10/2018,31/10/2018,0.00,,177.97,,"-9,452.87"
,CS,AR,32011015,1007,100,,Cash sale,,,,,,01/11/2018,01/11/2018,0.00,,177.97,,"-9,630.84"
,IN,AR,30331626,1007,100,,Invoice,,,,,,01/11/2018,01/11/2018,0.00,,8.47,,"-9,639.31"
,IN,AR,30331453,1007,100,,Invoice,,,,,,02/11/2018,02/11/2018,0.00,,3.50,,"-9,642.81"
,CN,AR,31019486,1007,100,,Credit Note,,,,,,07/11/2018,07/11/2018,21.19,,0.00,,"-9,621.62"
,CS,AR,32011018,1007,100,,Cash sale,,,,,,08/11/2018,08/11/2018,0.00,,25.42,,"-9,647.04"
,IN,AR,30331463,1007,100,,Invoice,,,,,,09/11/2018,09/11/2018,0.00,,17.50,,"-9,664.54"
,IN,AR,30331722,1007,100,,Invoice,,,,,,09/11/2018,09/11/2018,0.00,,21.19,,"-9,685.73"
,IN,AR,30333213,1007,100,,Invoice,,,,,,14/11/2018,14/11/2018,0.00,,10.17,,"-9,695.90"
,IN,AR,30332310,1007,100,,Invoice,,,,,,15/11/2018,15/11/2018,0.00,,161.02,,"-9,856.92"
,IN,AR,30332805,1007,100,,Invoice,,,,,,15/11/2018,15/11/2018,0.00,,7.00,,"-9,863.92"
,IN,AR,30332806,1007,100,,Invoice,,,,,,15/11/2018,15/11/2018,0.00,,7.00,,"-9,870.92"
,IN,AR,30332007,1001,100,,Invoice,,,,,,16/11/2018,16/11/2018,0.00,,177.97,,"-10,048.89"
,IN,AR,30332124,1007,100,,Invoice,,,,,,19/11/2018,19/11/2018,0.00,,8.47,,"-10,057.36"
,IN,AR,30332449,1007,100,,Invoice,,,,,,19/11/2018,19/11/2018,0.00,,8.47,,"-10,065.83"
,CS,AR,32011631,1007,100,,Cash sale,,,,,,20/11/2018,20/11/2018,0.00,,10.17,,"-10,076.00"
,CN,AR,31019622,1007,100,,Credit Note,,,,,,22/11/2018,22/11/2018,177.97,,0.00,,"-9,898.03"
,CS,AR,32011673,1007,100,,Cash sale,,,,,,22/11/2018,22/11/2018,0.00,,177.97,,"-10,076.00"
,IN,AR,30332602,1007,100,,Invoice,,,,,,23/11/2018,23/11/2018,0.00,,16.94,,"-10,092.94"
,IN,AR,30333127,1007,100,,Invoice,,,,,,23/11/2018,23/11/2018,0.00,,42.37,,"-10,135.31"
,IN,AR,30333227,1007,100,,Invoice,,,,,,24/11/2018,24/11/2018,0.00,,10.17,,"-10,145.48"
,IN,AR,30332107,1007,100,,Invoice,,,,,,26/11/2018,26/11/2018,0.00,,8.47,,"-10,153.95"
,IN,AR,30332816,1007,100,,Invoice,,,,,,27/11/2018,27/11/2018,0.00,,3.50,,"-10,157.45"
,CN,AR,31019583,1007,100,,Credit Note,,,,,,28/11/2018,28/11/2018,3.50,,0.00,,"-10,153.95"
,CS,AR,32011679,1007,100,,Cash sale,,,,,,28/11/2018,28/11/2018,0.00,,161.02,,"-10,314.97"
,IN,AR,30331966,1007,100,,Invoice,,,,,,28/11/2018,28/11/2018,0.00,,177.97,,"-10,492.94"
,IN,AR,30332185,1007,100,,Invoice,,,,,,29/11/2018,29/11/2018,0.00,,177.97,,"-10,670.91"
,IN,AR,30332298,1007,100,,Invoice,,,,,,29/11/2018,29/11/2018,0.00,,135.59,,"-10,806.50"
,IN,AR,30332619,1007,100,,Invoice,,,,,,30/11/2018,30/11/2018,0.00,,16.94,,"-10,823.44"
,IN,AR,30334392,1007,100,,Invoice,,,,,,01/12/2018,01/12/2018,0.00,,42.37,,"-10,865.81"
,IN,AR,30333798,1007,100,,Invoice,,,,,,03/12/2018,03/12/2018,0.00,,69.92,,"-10,935.73"
,IN,AR,30334791,1007,100,,Invoice,,,,,,03/12/2018,03/12/2018,0.00,,3.50,,"-10,939.23"
,IN,AR,30335255,1007,100,,Invoice,,,,,,04/12/2018,04/12/2018,0.00,,8.47,,"-10,947.70"
,IN,AR,30335358,1007,100,,Invoice,,,,,,05/12/2018,05/12/2018,0.00,,10.17,,"-10,957.87"
,IN,AR,30335361,1007,100,,Invoice,,,,,,05/12/2018,05/12/2018,0.00,,10.17,,"-10,968.04"
,IN,AR,30335197,1007,100,,Invoice,,,,,,06/12/2018,06/12/2018,0.00,,16.95,,"-10,984.99"
,IN,AR,30334114,1007,100,,Invoice,,,,,,10/12/2018,10/12/2018,0.00,,177.97,,"-11,162.96"
,IN,AR,30334455,1007,100,,Invoice,,,,,,11/12/2018,11/12/2018,0.00,,8.47,,"-11,171.43"
,IN,AR,30334800,1007,100,,Invoice,,,,,,11/12/2018,11/12/2018,0.00,,14.00,,"-11,185.43"
,IN,AR,30334079,1007,100,,Invoice,,,,,,12/12/2018,12/12/2018,0.00,,46.61,,"-11,232.04"
,CS,AR,32011997,1007,100,,Cash sale,,,,,,17/12/2018,17/12/2018,0.00,,16.94,,"-11,248.98"
,IN,AR,30335380,1007,100,,Invoice,,,,,,17/12/2018,17/12/2018,0.00,,177.97,,"-11,426.95"
,IN,AR,30333883,1007,100,,Invoice,,,,,,21/12/2018,21/12/2018,0.00,,8.47,,"-11,435.42"
,CN,AR,31019713,1007,100,,Credit Note,,,,,,24/12/2018,24/12/2018,7.00,,0.00,,"-11,428.42"
,IN,AR,30335869,1007,100,,Invoice,,,,,,29/12/2018,29/12/2018,0.00,,10.17,,"-11,438.59"
,IN,AR,30335595,1007,100,,Invoice,,,,,,31/12/2018,31/12/2018,0.00,,"2,275.43",,"-13,714.02"
,,,,,,,,,,,,,,,,,,,
,Account: 1000410 - Sales - Aquani Water Cups,,,,,,,,,,,,,,,,,,
,Pr.,Mod.,Reference,Dept,Div,Suffix,Details,,,Cheque,,User,Doc Date,Post Date,Debit,,Credit,,Balance
,IN,AR,30305591,1007,100,,Invoice,,,,,,05/01/2018,05/01/2018,0.00,,5.08,,-5.08
,IN,AR,30306569,1007,100,,Invoice,,,,,,10/01/2018,10/01/2018,0.00,,2.54,,-7.62
,IN,AR,30305963,1007,100,,Invoice,,,,,,11/01/2018,11/01/2018,0.00,,5.08,,-12.70
,IN,AR,30306138,1007,100,,Invoice,,,,,,11/01/2018,11/01/2018,0.00,,152.54,,-165.24
,IN,AR,30304700,1007,100,,Invoice,,,,,,12/01/2018,12/01/2018,0.00,,7.63,,-172.87
,IN,AR,30304701,1007,100,,Invoice,,,,,,12/01/2018,12/01/2018,0.00,,7.63,,-180.50
,IN,AR,30305568,1007,100,,Invoice,,,,,,22/01/2018,22/01/2018,0.00,,5.08,,-185.58
,IN,AR,30306570,1007,100,,Invoice,,,,,,23/01/2018,23/01/2018,0.00,,7.63,,-193.21
,IN,AR,30306506,1007,100,,Invoice,,,,,,24/01/2018,24/01/2018,0.00,,22.88,,-216.09
,CS,AR,32000454,1007,100,,Cash sale,,,,,,26/01/2018,26/01/2018,0.00,,7.63,,-223.72
,IN,AR,30304702,1007,100,,Invoice,,,,,,26/01/2018,26/01/2018,0.00,,15.25,,-238.97
,IN,AR,30305964,1007,100,,Invoice,,,,,,26/01/2018,26/01/2018,0.00,,2.80,,-241.77
,IN,AR,30306817,1007,100,,Invoice,,,,,,02/02/2018,02/02/2018,0.00,,12.71,,-254.48
,IN,AR,30307007,1007,100,,Invoice,,,,,,02/02/2018,02/02/2018,0.00,,15.25,,-269.73
,IN,AR,30307233,1007,100,,Invoice,,,,,,06/02/2018,06/02/2018,0.00,,2.54,,-272.27
,IN,AR,30307619,1007,100,,Invoice,,,,,,07/02/2018,07/02/2018,0.00,,2.54,,-274.81
,IN,AR,30308368,1007,100,,Invoice,,,,,,09/02/2018,09/02/2018,0.00,,7.63,,-282.44
,IN,AR,30308637,1007,100,,Invoice,,,,,,12/02/2018,12/02/2018,0.00,,15.25,,-297.69
,IN,AR,30307683,1007,100,,Invoice,,,,,,15/02/2018,15/02/2018,0.00,,7.63,,-305.32
,CS,AR,32000999,1007,100,,Cash sale,,,,,,19/02/2018,19/02/2018,0.00,,25.42,,-330.74
,IN,AR,30308045,1007,100,,Invoice,,,,,,19/02/2018,19/02/2018,0.00,,7.63,,-338.37
,IN,AR,30308311,1007,100,,Invoice,,,,,,26/02/2018,26/02/2018,0.00,,2.54,,-340.91
,IN,AR,30309822,1007,100,,Invoice,,,,,,06/03/2018,06/03/2018,0.00,,5.08,,-345.99
,IN,AR,30310564,1007,100,,Invoice,,,,,,08/03/2018,08/03/2018,0.00,,76.27,,-422.26
,IN,AR,30309872,1007,100,,Invoice,,,,,,12/03/2018,12/03/2018,0.00,,12.71,,-434.97
,IN,AR,30309356,1007,100,,Invoice,,,,,,14/03/2018,14/03/2018,0.00,,2.54,,-437.51
,IN,AR,30310061,1007,100,,Invoice,,,,,,14/03/2018,14/03/2018,0.00,,2.54,,-440.05
,IN,AR,30309262,1007,100,,Invoice,,,,,,15/03/2018,15/03/2018,0.00,,2.54,,-442.59
,IN,AR,30310440,1007,100,,Invoice,,,,,,15/03/2018,15/03/2018,0.00,,7.63,,-450.22
,IN,AR,30309263,1007,100,,Invoice,,,,,,17/03/2018,17/03/2018,0.00,,2.54,,-452.76
,CS,AR,32002249,1007,100,,Cash sale,,,,,,20/03/2018,20/03/2018,0.00,,2.54,,-455.30
,CN,AR,31017567,1007,100,,Credit Note,,,,,,21/03/2018,21/03/2018,2.54,,0.00,,-452.76
,CS,AR,32002290,1007,100,,Cash sale,,,,,,23/03/2018,23/03/2018,0.00,,10.17,,-462.93
,IN,AR,30310265,1007,100,,Invoice,,,,,,23/03/2018,23/03/2018,0.00,,7.63,,-470.56
,IN,AR,30309143,1007,100,,Invoice,,,,,,29/03/2018,29/03/2018,0.00,,20.34,,-490.90
,IN,AR,30311005,1007,100,,Invoice,,,,,,29/03/2018,29/03/2018,0.00,,5.08,,-495.98
,IN,AR,30310749,1007,100,,Invoice,,,,,,31/03/2018,31/03/2018,0.00,,"1,144.07",,"-1,640.05"
,IN,AR,30311619,1007,100,,Invoice,,,,,,17/04/2018,17/04/2018,0.00,,5.08,,"-1,645.13"
,IN,AR,30312881,1007,100,,Invoice,,,,,,18/04/2018,18/04/2018,0.00,,2.54,,"-1,647.67"
,IN,AR,30312352,1007,100,,Invoice,,,,,,19/04/2018,19/04/2018,0.00,,7.63,,"-1,655.30"
,IN,AR,30314224,1007,100,,Invoice,,,,,,27/04/2018,27/04/2018,0.00,,7.63,,"-1,662.93"
,IN,AR,30313700,1007,100,,Invoice,,,,,,02/05/2018,02/05/2018,0.00,,25.42,,"-1,688.35"
,IN,AR,30313730,1007,100,,Invoice,,,,,,02/05/2018,02/05/2018,0.00,,2.54,,"-1,690.89"
,IN,AR,30314375,1007,100,,Invoice,,,,,,02/05/2018,02/05/2018,0.00,,10.17,,"-1,701.06"
,IN,AR,30314465,1007,100,,Invoice,,,,,,03/05/2018,03/05/2018,0.00,,2.54,,"-1,703.60"
,IN,AR,30314013,1007,100,,Invoice,,,,,,09/05/2018,09/05/2018,0.00,,15.25,,"-1,718.85"
,CS,AR,32003959,1007,100,,Cash sale,,,,,,11/05/2018,11/05/2018,0.00,,5.08,,"-1,723.93"
,IN,AR,30314466,1007,100,,Invoice,,,,,,11/05/2018,11/05/2018,0.00,,12.71,,"-1,736.64"
,IN,AR,30313710,1007,100,,Invoice,,,,,,12/05/2018,12/05/2018,0.00,,2.54,,"-1,739.18"
,IN,AR,30314997,1007,100,,Invoice,,,,,,16/05/2018,16/05/2018,0.00,,2.54,,"-1,741.72"
,IN,AR,30314989,1007,100,,Invoice,,,,,,17/05/2018,17/05/2018,0.00,,2.54,,"-1,744.26"
,CN,AR,31018005,1007,100,,Credit Note,,,,,,18/05/2018,18/05/2018,20.34,,0.00,,"-1,723.92"
,IN,AR,30314729,1007,100,,Invoice,,,,,,18/05/2018,18/05/2018,0.00,,10.17,,"-1,734.09"
,IN,AR,30314730,1007,100,,Invoice,,,,,,18/05/2018,18/05/2018,0.00,,10.17,,"-1,744.26"
,IN,AR,30316194,1007,100,,Invoice,,,,,,01/06/2018,01/06/2018,0.00,,10.17,,"-1,754.43"
,IN,AR,30316828,1007,100,,Invoice,,,,,,12/06/2018,12/06/2018,0.00,,12.71,,"-1,767.14"
,CS,AR,32005880,1007,100,,Cash sale,,,,,,06/07/2018,06/07/2018,0.00,,7.63,,"-1,774.77"
,IN,AR,30319763,1007,100,,Invoice,,,,,,10/07/2018,10/07/2018,0.00,,15.25,,"-1,790.02"
,IN,AR,30320073,1007,100,,Invoice,,,,,,12/07/2018,12/07/2018,0.00,,76.27,,"-1,866.29"
,IN,AR,30319516,1007,100,,Invoice,,,,,,13/07/2018,13/07/2018,0.00,,25.42,,"-1,891.71"
,IN,AR,30320011,1007,100,,Invoice,,,,,,13/07/2018,13/07/2018,0.00,,5.08,,"-1,896.79"
,IN,AR,30319518,1007,100,,Invoice,,,,,,19/07/2018,19/07/2018,0.00,,12.71,,"-1,909.50"
,CN,AR,31018417,1007,100,,Credit Note,,,,,,21/07/2018,21/07/2018,10.17,,0.00,,"-1,899.33"
,IN,AR,30320520,1007,100,,Invoice,,,,,,21/07/2018,21/07/2018,0.00,,10.17,,"-1,909.50"
,CS,AR,32006834,1007,100,,Cash sale,,,,,,25/07/2018,25/07/2018,0.00,,2.54,,"-1,912.04"
,IN,AR,30322014,1007,100,,Invoice,,,,,,31/07/2018,31/07/2018,0.00,,76.27,,"-1,988.31"
,IN,AR,30322122,1007,100,,Invoice,,,,,,02/08/2018,02/08/2018,0.00,,12.71,,"-2,001.02"
,IN,AR,30321781,1007,100,,Invoice,,,,,,03/08/2018,03/08/2018,0.00,,5.08,,"-2,006.10"
,IN,AR,30322120,1007,100,,Invoice,,,,,,03/08/2018,03/08/2018,0.00,,2.54,,"-2,008.64"
,IN,AR,30323346,1007,100,,Invoice,,,,,,16/08/2018,16/08/2018,0.00,,10.17,,"-2,018.81"
,CS,AR,32007468,1007,100,,Cash sale,,,,,,17/08/2018,17/08/2018,0.00,,5.08,,"-2,023.89"
,IN,AR,30323060,1007,100,,Invoice,,,,,,17/08/2018,17/08/2018,0.00,,5.08,,"-2,028.97"
,IN,AR,30325269,1007,100,,Invoice,,,,,,23/08/2018,23/08/2018,0.00,,76.27,,"-2,105.24"
,IN,AR,30326170,1007,100,,Invoice,,,,,,23/08/2018,23/08/2018,0.00,,2.54,,"-2,107.78"
,CS,AR,32008773,1007,100,,Cash sale,,,,,,24/08/2018,24/08/2018,0.00,,2.54,,"-2,110.32"
,IN,AR,30324562,1007,100,,Invoice,,,,,,27/08/2018,27/08/2018,0.00,,2.54,,"-2,112.86"
,IN,AR,30324647,1007,100,,Invoice,,,,,,29/08/2018,29/08/2018,0.00,,10.17,,"-2,123.03"
,IN,AR,30324790,1007,100,,Invoice,,,,,,30/08/2018,30/08/2018,0.00,,5.08,,"-2,128.11"
,IN,AR,30324563,1007,100,,Invoice,,,,,,14/09/2018,14/09/2018,0.00,,7.63,,"-2,135.74"
,IN,AR,30325114,1007,100,,Invoice,,,,,,14/09/2018,14/09/2018,0.00,,7.63,,"-2,143.37"
,IN,AR,30325973,1007,100,,Invoice,,,,,,14/09/2018,14/09/2018,0.00,,7.63,,"-2,151.00"
,IN,AR,30326619,1007,100,,Invoice,,,,,,26/09/2018,26/09/2018,0.00,,15.25,,"-2,166.25"
,IN,AR,30327294,1007,100,,Invoice,,,,,,26/09/2018,26/09/2018,0.00,,2.54,,"-2,168.79"
,IN,AR,30327447,1007,100,,Invoice,,,,,,27/09/2018,27/09/2018,0.00,,15.25,,"-2,184.04"
,CS,AR,32009135,1007,100,,Cash sale,,,,,,28/09/2018,28/09/2018,0.00,,2.54,,"-2,186.58"
,IN,AR,30328066,1007,100,,Invoice,,,,,,05/10/2018,05/10/2018,0.00,,5.08,,"-2,191.66"
,IN,AR,30328522,1007,100,,Invoice,,,,,,08/10/2018,08/10/2018,0.00,,25.42,,"-2,217.08"
,IN,AR,30330269,1007,100,,Invoice,,,,,,12/10/2018,12/10/2018,0.00,,5.08,,"-2,222.16"
,IN,AR,30329662,1007,100,,Invoice,,,,,,17/10/2018,17/10/2018,0.00,,15.25,,"-2,237.41"
,IN,AR,30330273,1007,100,,Invoice,,,,,,20/10/2018,20/10/2018,0.00,,12.71,,"-2,250.12"
,IN,AR,30329852,1007,100,,Invoice,,,,,,24/10/2018,24/10/2018,0.00,,5.08,,"-2,255.20"
,IN,AR,30329264,1007,100,,Invoice,,,,,,29/10/2018,29/10/2018,0.00,,12.71,,"-2,267.91"
,IN,AR,30330029,1007,100,,Invoice,,,,,,31/10/2018,31/10/2018,0.00,,76.27,,"-2,344.18"
,IN,AR,30331306,1007,100,,Invoice,,,,,,07/11/2018,07/11/2018,0.00,,20.34,,"-2,364.52"
,IN,AR,30330943,1007,100,,Invoice,,,,,,08/11/2018,08/11/2018,0.00,,2.54,,"-2,367.06"
,IN,AR,30332728,1007,100,,Invoice,,,,,,21/11/2018,21/11/2018,0.00,,2.54,,"-2,369.60"
,IN,AR,30332597,1007,100,,Invoice,,,,,,23/11/2018,23/11/2018,0.00,,15.25,,"-2,384.85"
,CS,AR,32011344,1007,100,,Cash sale,,,,,,27/11/2018,27/11/2018,0.00,,2.54,,"-2,387.39"
,IN,AR,30332453,1007,100,,Invoice,,,,,,29/11/2018,29/11/2018,0.00,,5.08,,"-2,392.47"
,IN,AR,30332593,1007,100,,Invoice,,,,,,29/11/2018,29/11/2018,0.00,,5.08,,"-2,397.55"
,IN,AR,30332867,1007,100,,Invoice,,,,,,30/11/2018,30/11/2018,0.00,,762.71,,"-3,160.26"
,IN,AR,30335351,1007,100,,Invoice,,,,,,04/12/2018,04/12/2018,0.00,,2.54,,"-3,162.80"
,IN,AR,30334545,1007,100,,Invoice,,,,,,10/12/2018,10/12/2018,0.00,,10.17,,"-3,172.97"
,IN,AR,30334264,1007,100,,Invoice,,,,,,12/12/2018,12/12/2018,0.00,,5.08,,"-3,178.05"
,IN,AR,30335169,1007,100,,Invoice,,,,,,14/12/2018,14/12/2018,0.00,,7.63,,"-3,185.68"
,IN,AR,30334180,1007,100,,Invoice,,,,,,17/12/2018,17/12/2018,0.00,,12.71,,"-3,198.39"
,,,,,,,,,,,,,,,,,,,
,Account: 1000415 - Sales - Repairs & Maintainance,,,,,,,,,,,,,,,,,,
,Pr.,Mod.,Reference,Dept,Div,Suffix,Details,,,Cheque,,User,Doc Date,Post Date,Debit,,Credit,,Balance
,CS,AR,32002780,1007,100,,Cash sale,,,,,,19/04/2018,19/04/2018,0.00,,25.42,,-25.42
,CS,AR,32003561,1007,100,,Cash sale,,,,,,04/05/2018,04/05/2018,0.00,,25.42,,-50.84
,IN,AR,30313169,1007,100,,Invoice,,,,,,04/05/2018,04/05/2018,0.00,,25.42,,-76.26
,CS,AR,32005082,1007,100,,Cash sale,,,,,,12/06/2018,12/06/2018,0.00,,16.95,,-93.21
,CS,AR,32005498,1007,100,,Cash sale,,,,,,27/06/2018,27/06/2018,0.00,,21.19,,-114.40
,IN,AR,30321260,1007,100,,Invoice,,,,,,23/07/2018,23/07/2018,0.00,,16.95,,-131.35
,IN,AR,30330541,1007,100,,Invoice,,,,,,24/10/2018,24/10/2018,0.00,,25.42,,-156.77
,,,,,,,,,,,,,,,,,,,
,Account: 1000430 - Sales - Co2 Refill 2.5ltr,,,,,,,,,,,,,,,,,,
,Pr.,Mod.,Reference,Dept,Div,Suffix,Details,,,Cheque,,User,Doc Date,Post Date,Debit,,Credit,,Balance
,IN,AR,30326861,1005,100,,Invoice,,,,,,30/09/2018,30/09/2018,0.00,,8.05,,-8.05
,IN,AR,30335251,1005,100,,Invoice,,,,,,12/12/2018,12/12/2018,0.00,,8.05,,-16.10
,,,,,,,,,,,,,,,,,,,
,Account: 1000460 - Sales 2ltr - Pama,,,,,,,,,,,,,,,,,,
,Pr.,Mod.,Reference,Dept,Div,Suffix,Details,,,Cheque,,User,Doc Date,Post Date,Debit,,Credit,,Balance
,IN,AR,30310771,1005,100,,Invoice,,,,,,14/03/2018,14/03/2018,0.00,,672.54,,-672.54
,IN,AR,30310938,1005,100,,Invoice,,,,,,14/03/2018,14/03/2018,0.00,,672.54,,"-1,345.08"
,IN,AR,30310939,1005,100,,Invoice,,,,,,14/03/2018,14/03/2018,0.00,,672.54,,"-2,017.62"
,IN,AR,30310773,1005,100,,Invoice,,,,,,15/03/2018,15/03/2018,0.00,,672.54,,"-2,690.16"
,IN,AR,30310940,1005,100,,Invoice,,,,,,15/03/2018,15/03/2018,0.00,,672.54,,"-3,362.70"
,IN,AR,30310774,1005,100,,Invoice,,,,,,17/03/2018,17/03/2018,0.00,,"2,152.14",,"-5,514.84"
,IN,AR,30310941,1005,100,,Invoice,,,,,,17/03/2018,17/03/2018,0.00,,470.78,,"-5,985.62"
,IN,AR,30310942,1005,100,,Invoice,,,,,,17/03/2018,17/03/2018,0.00,,470.78,,"-6,456.40"
,IN,AR,30310943,1005,100,,Invoice,,,,,,22/03/2018,22/03/2018,0.00,,672.54,,"-7,128.94"
,IN,AR,30310944,1005,100,,Invoice,,,,,,23/03/2018,23/03/2018,0.00,,605.29,,"-7,734.23"
,IN,AR,30312951,1005,100,,Invoice,,,,,,10/04/2018,10/04/2018,0.00,,672.54,,"-8,406.77"
,IN,AR,30312785,1005,100,,Invoice,,,,,,11/04/2018,11/04/2018,0.00,,672.54,,"-9,079.31"
,IN,AR,30312787,1005,100,,Invoice,,,,,,12/04/2018,12/04/2018,0.00,,672.54,,"-9,751.85"
,IN,AR,30312952,1005,100,,Invoice,,,,,,12/04/2018,12/04/2018,0.00,,672.54,,"-10,424.39"
,IN,AR,30312788,1005,100,,Invoice,,,,,,14/04/2018,14/04/2018,0.00,,"2,152.14",,"-12,576.53"
,IN,AR,30312953,1005,100,,Invoice,,,,,,14/04/2018,14/04/2018,0.00,,672.54,,"-13,249.07"
,IN,AR,30312954,1005,100,,Invoice,,,,,,16/04/2018,16/04/2018,0.00,,378.31,,"-13,627.38"
,IN,AR,30312955,1005,100,,Invoice,,,,,,16/04/2018,16/04/2018,0.00,,294.24,,"-13,921.62"
,IN,AR,30312956,1005,100,,Invoice,,,,,,16/04/2018,16/04/2018,0.00,,672.54,,"-14,594.16"
,,,,,,,,,,,,,,,,,,,
,IN,AR,30312957,1005,100,,Invoice,,,,,,17/04/2018,17/04/2018,0.00,,672.54,,"-15,266.70"
,IN,AR,30312789,1005,100,,Invoice,,,,,,18/04/2018,18/04/2018,0.00,,672.54,,"-15,939.24"
,IN,AR,30312790,1005,100,,Invoice,,,,,,19/04/2018,19/04/2018,0.00,,672.54,,"-16,611.78"
,IN,AR,30312958,1005,100,,Invoice,,,,,,19/04/2018,19/04/2018,0.00,,672.54,,"-17,284.32"
,IN,AR,30312959,1005,100,,Invoice,,,,,,20/04/2018,20/04/2018,0.00,,672.54,,"-17,956.86"
,IN,AR,30312792,1005,100,,Invoice,,,,,,21/04/2018,21/04/2018,0.00,,"2,152.14",,"-20,109.00"
,IN,AR,30312960,1005,100,,Invoice,,,,,,21/04/2018,21/04/2018,0.00,,672.54,,"-20,781.54"
,CN,AR,31017843,1005,100,,Credit Note,,,,,,23/04/2018,23/04/2018,672.54,,0.00,,"-20,109.00"
,IN,AR,30312961,1005,100,,Invoice,,,,,,23/04/2018,23/04/2018,0.00,,672.54,,"-20,781.54"
,IN,AR,30312962,1005,100,,Invoice,,,,,,23/04/2018,23/04/2018,0.00,,672.54,,"-21,454.08"
,IN,AR,30312963,1005,100,,Invoice,,,,,,24/04/2018,24/04/2018,0.00,,672.54,,"-22,126.62"
,IN,AR,30312794,1005,100,,Invoice,,,,,,25/04/2018,25/04/2018,0.00,,672.54,,"-22,799.16"
,IN,AR,30312796,1005,100,,Invoice,,,,,,26/04/2018,26/04/2018,0.00,,672.54,,"-23,471.70"
,IN,AR,30312964,1005,100,,Invoice,,,,,,26/04/2018,26/04/2018,0.00,,672.54,,"-24,144.24"
,IN,AR,30312965,1005,100,,Invoice,,,,,,27/04/2018,27/04/2018,0.00,,403.53,,"-24,547.77"
,IN,AR,30314317,1005,100,,Invoice,,,,,,28/04/2018,28/04/2018,0.00,,"2,152.14",,"-26,699.91"
,IN,AR,30314423,1005,100,,Invoice,,,,,,28/04/2018,28/04/2018,0.00,,672.54,,"-27,372.45"
,IN,AR,30314318,1005,100,,Invoice,,,,,,30/04/2018,30/04/2018,0.00,,672.54,,"-28,044.99"
,IN,AR,30314425,1005,100,,Invoice,,,,,,30/04/2018,30/04/2018,0.00,,672.54,,"-28,717.53"
,IN,AR,30314426,1005,100,,Invoice,,,,,,30/04/2018,30/04/2018,0.00,,672.54,,"-29,390.07"
,IN,AR,30314319,1005,100,,Invoice,,,,,,02/05/2018,02/05/2018,0.00,,672.54,,"-30,062.61"
,IN,AR,30314427,1005,100,,Invoice,,,,,,02/05/2018,02/05/2018,0.00,,672.54,,"-30,735.15"
,IN,AR,30314321,1005,100,,Invoice,,,,,,03/05/2018,03/05/2018,0.00,,672.54,,"-31,407.69"
,IN,AR,30314428,1005,100,,Invoice,,,,,,03/05/2018,03/05/2018,0.00,,672.54,,"-32,080.23"
,IN,AR,30314430,1005,100,,Invoice,,,,,,04/05/2018,04/05/2018,0.00,,672.54,,"-32,752.77"
,IN,AR,30314322,1005,100,,Invoice,,,,,,05/05/2018,05/05/2018,0.00,,"2,152.14",,"-34,904.91"
,IN,AR,30314431,1005,100,,Invoice,,,,,,07/05/2018,07/05/2018,0.00,,672.54,,"-35,577.45"
,CN,AR,31017955,1005,100,,Credit Note,,,,,,08/05/2018,08/05/2018,672.54,,0.00,,"-34,904.91"
,IN,AR,30314230,1005,100,,Invoice,,,,,,08/05/2018,08/05/2018,0.00,,672.54,,"-35,577.45"
,IN,AR,30314432,1005,100,,Invoice,,,,,,08/05/2018,08/05/2018,0.00,,672.54,,"-36,249.99"
,IN,AR,30314323,1005,100,,Invoice,,,,,,09/05/2018,09/05/2018,0.00,,672.54,,"-36,922.53"
,IN,AR,30314434,1005,100,,Invoice,,,,,,10/05/2018,10/05/2018,0.00,,672.54,,"-37,595.07"
,IN,AR,30314435,1005,100,,Invoice,,,,,,11/05/2018,11/05/2018,0.00,,403.53,,"-37,998.60"
,CN,AR,31017963,1005,100,,Credit Note,,,,,,12/05/2018,12/05/2018,"2,152.14",,0.00,,"-35,846.46"
,IN,AR,30314325,1005,100,,Invoice,,,,,,12/05/2018,12/05/2018,0.00,,"2,152.14",,"-37,998.60"
,IN,AR,30314326,1005,100,,Invoice,,,,,,12/05/2018,12/05/2018,0.00,,"2,152.14",,"-40,150.74"
,IN,AR,30314436,1005,100,,Invoice,,,,,,12/05/2018,12/05/2018,0.00,,470.78,,"-40,621.52"
,IN,AR,30314437,1005,100,,Invoice,,,,,,14/05/2018,14/05/2018,0.00,,672.54,,"-41,294.06"
,IN,AR,30314438,1005,100,,Invoice,,,,,,15/05/2018,15/05/2018,0.00,,672.54,,"-41,966.60"
,IN,AR,30315338,1005,100,,Invoice,,,,,,16/05/2018,16/05/2018,0.00,,672.54,,"-42,639.14"
,IN,AR,30315411,1005,100,,Invoice,,,,,,17/05/2018,17/05/2018,0.00,,672.54,,"-43,311.68"
,IN,AR,30315412,1005,100,,Invoice,,,,,,18/05/2018,18/05/2018,0.00,,470.78,,"-43,782.46"
,IN,AR,30315340,1005,100,,Invoice,,,,,,19/05/2018,19/05/2018,0.00,,672.54,,"-44,455.00"
,IN,AR,30315341,1005,100,,Invoice,,,,,,19/05/2018,19/05/2018,0.00,,672.54,,"-45,127.54"
,IN,AR,30315414,1005,100,,Invoice,,,,,,19/05/2018,19/05/2018,0.00,,672.54,,"-45,800.08"
,IN,AR,30315415,1005,100,,Invoice,,,,,,21/05/2018,21/05/2018,0.00,,672.54,,"-46,472.62"
,IN,AR,30315342,1005,100,,Invoice,,,,,,22/05/2018,22/05/2018,0.00,,672.54,,"-47,145.16"
,IN,AR,30315416,1005,100,,Invoice,,,,,,22/05/2018,22/05/2018,0.00,,672.54,,"-47,817.70"
,IN,AR,30315417,1005,100,,Invoice,,,,,,24/05/2018,24/05/2018,0.00,,470.78,,"-48,288.48"
,IN,AR,30315418,1005,100,,Invoice,,,,,,25/05/2018,25/05/2018,0.00,,672.54,,"-48,961.02"
,IN,AR,30315345,1005,100,,Invoice,,,,,,26/05/2018,26/05/2018,0.00,,"2,152.14",,"-51,113.16"
,IN,AR,30315419,1005,100,,Invoice,,,,,,26/05/2018,26/05/2018,0.00,,672.54,,"-51,785.70"
,CN,AR,31018113,1005,100,,Credit Note,,,,,,28/05/2018,28/05/2018,672.54,,0.00,,"-51,113.16"
,IN,AR,30316065,1005,100,,Invoice,,,,,,28/05/2018,28/05/2018,0.00,,672.54,,"-51,785.70"
,IN,AR,30316066,1005,100,,Invoice,,,,,,28/05/2018,28/05/2018,0.00,,672.54,,"-52,458.24"
,IN,AR,30316067,1005,100,,Invoice,,,,,,29/05/2018,29/05/2018,0.00,,672.54,,"-53,130.78"
,IN,AR,30316024,1005,100,,Invoice,,,,,,30/05/2018,30/05/2018,0.00,,672.54,,"-53,803.32"
,IN,AR,30316068,1005,100,,Invoice,,,,,,31/05/2018,31/05/2018,0.00,,672.54,,"-54,475.86"
,IN,AR,30316526,1005,100,,Invoice,,,,,,01/06/2018,01/06/2018,0.00,,538.03,,"-55,013.89"
,IN,AR,30316492,1005,100,,Invoice,,,,,,02/06/2018,02/06/2018,0.00,,"2,152.14",,"-57,166.03"
,IN,AR,30316527,1005,100,,Invoice,,,,,,02/06/2018,02/06/2018,0.00,,672.54,,"-57,838.57"
,IN,AR,30316528,1005,100,,Invoice,,,,,,04/06/2018,04/06/2018,0.00,,672.54,,"-58,511.11"
,IN,AR,30316529,1005,100,,Invoice,,,,,,05/06/2018,05/06/2018,0.00,,672.54,,"-59,183.65"
,IN,AR,30316493,1005,100,,Invoice,,,,,,06/06/2018,06/06/2018,0.00,,470.78,,"-59,654.43"
,IN,AR,30319106,1005,100,,Invoice,,,,,,02/07/2018,02/07/2018,0.00,,"2,152.14",,"-61,806.57"
,IN,AR,30319155,1005,100,,Invoice,,,,,,02/07/2018,02/07/2018,0.00,,672.54,,"-62,479.11"
,IN,AR,30319157,1005,100,,Invoice,,,,,,03/07/2018,03/07/2018,0.00,,672.54,,"-63,151.65"
,IN,AR,30319158,1005,100,,Invoice,,,,,,05/07/2018,05/07/2018,0.00,,672.54,,"-63,824.19"
,IN,AR,30319109,1005,100,,Invoice,,,,,,06/07/2018,06/07/2018,0.00,,672.54,,"-64,496.73"
,IN,AR,30319159,1005,100,,Invoice,,,,,,06/07/2018,06/07/2018,0.00,,672.54,,"-65,169.27"
,IN,AR,30319110,1005,100,,Invoice,,,,,,07/07/2018,07/07/2018,0.00,,"2,152.14",,"-67,321.41"
,IN,AR,30319160,1005,100,,Invoice,,,,,,07/07/2018,07/07/2018,0.00,,672.54,,"-67,993.95"
,IN,AR,30319344,1005,100,,Invoice,,,,,,09/07/2018,09/07/2018,0.00,,672.54,,"-68,666.49"
,IN,AR,30320217,1005,100,,Invoice,,,,,,10/07/2018,10/07/2018,0.00,,672.54,,"-69,339.03"
,IN,AR,30320149,1005,100,,Invoice,,,,,,13/07/2018,13/07/2018,0.00,,"1,210.58",,"-70,549.61"
,IN,AR,30320218,1005,100,,Invoice,,,,,,13/07/2018,13/07/2018,0.00,,"1,210.58",,"-71,760.19"
,IN,AR,30320220,1005,100,,Invoice,,,,,,17/07/2018,17/07/2018,0.00,,672.54,,"-72,432.73"
,IN,AR,30320221,1005,100,,Invoice,,,,,,19/07/2018,19/07/2018,0.00,,672.54,,"-73,105.27"
,IN,AR,30321192,1005,100,,Invoice,,,,,,20/07/2018,20/07/2018,0.00,,"1,210.58",,"-74,315.85"
,IN,AR,30321278,1005,100,,Invoice,,,,,,20/07/2018,20/07/2018,0.00,,672.54,,"-74,988.39"
,IN,AR,30322216,1005,100,,Invoice,,,,,,20/07/2018,20/07/2018,0.00,,"1,210.58",,"-76,198.97"
,IN,AR,30321193,1005,100,,Invoice,,,,,,21/07/2018,21/07/2018,0.00,,"1,210.58",,"-77,409.55"
,IN,AR,30321279,1005,100,,Invoice,,,,,,21/07/2018,21/07/2018,0.00,,672.54,,"-78,082.09"
,IN,AR,30321280,1005,100,,Invoice,,,,,,23/07/2018,23/07/2018,0.00,,672.54,,"-78,754.63"
,IN,AR,30321281,1005,100,,Invoice,,,,,,24/07/2018,24/07/2018,0.00,,672.54,,"-79,427.17"
,IN,AR,30321283,1005,100,,Invoice,,,,,,26/07/2018,26/07/2018,0.00,,672.54,,"-80,099.71"
,IN,AR,30321196,1005,100,,Invoice,,,,,,28/07/2018,28/07/2018,0.00,,"1,210.58",,"-81,310.29"
,IN,AR,30321284,1005,100,,Invoice,,,,,,28/07/2018,28/07/2018,0.00,,672.54,,"-81,982.83"
,IN,AR,30321285,1005,100,,Invoice,,,,,,30/07/2018,30/07/2018,0.00,,672.54,,"-82,655.37"
,IN,AR,30321287,1005,100,,Invoice,,,,,,31/07/2018,31/07/2018,0.00,,672.54,,"-83,327.91"
,IN,AR,30322104,1005,100,,Invoice,,,,,,01/08/2018,01/08/2018,0.00,,"1,210.58",,"-84,538.49"
,IN,AR,30322105,1005,100,,Invoice,,,,,,02/08/2018,02/08/2018,0.00,,672.54,,"-85,211.03"
,IN,AR,30322051,1005,100,,Invoice,,,,,,03/08/2018,03/08/2018,0.00,,403.53,,"-85,614.56"
,IN,AR,30322106,1005,100,,Invoice,,,,,,03/08/2018,03/08/2018,0.00,,470.78,,"-86,085.34"
,IN,AR,30322052,1005,100,,Invoice,,,,,,04/08/2018,04/08/2018,0.00,,672.54,,"-86,757.88"
,IN,AR,30322107,1005,100,,Invoice,,,,,,06/08/2018,06/08/2018,0.00,,672.54,,"-87,430.42"
,IN,AR,30322218,1005,100,,Invoice,,,,,,07/08/2018,07/08/2018,0.00,,672.54,,"-88,102.96"
,IN,AR,30323334,1005,100,,Invoice,,,,,,08/08/2018,08/08/2018,0.00,,"1,210.58",,"-89,313.54"
,IN,AR,30323220,1005,100,,Invoice,,,,,,11/08/2018,11/08/2018,0.00,,672.54,,"-89,986.08"
,IN,AR,30323337,1005,100,,Invoice,,,,,,11/08/2018,11/08/2018,0.00,,672.54,,"-90,658.62"
,IN,AR,30323338,1005,100,,Invoice,,,,,,13/08/2018,13/08/2018,0.00,,672.54,,"-91,331.16"
,IN,AR,30323222,1005,100,,Invoice,,,,,,14/08/2018,14/08/2018,0.00,,"1,210.58",,"-92,541.74"
,IN,AR,30323223,1005,100,,Invoice,,,,,,14/08/2018,14/08/2018,0.00,,"1,210.58",,"-93,752.32"
,IN,AR,30323339,1005,100,,Invoice,,,,,,14/08/2018,14/08/2018,0.00,,"1,210.58",,"-94,962.90"
,IN,AR,30323340,1005,100,,Invoice,,,,,,16/08/2018,16/08/2018,0.00,,672.54,,"-95,635.44"
,IN,AR,30323341,1005,100,,Invoice,,,,,,16/08/2018,16/08/2018,0.00,,672.54,,"-96,307.98"
,IN,AR,30323225,1005,100,,Invoice,,,,,,18/08/2018,18/08/2018,0.00,,"1,210.58",,"-97,518.56"
,IN,AR,30323226,1005,100,,Invoice,,,,,,18/08/2018,18/08/2018,0.00,,874.31,,"-98,392.87"
,IN,AR,30323342,1005,100,,Invoice,,,,,,18/08/2018,18/08/2018,0.00,,"1,210.58",,"-99,603.45"
,IN,AR,30323227,1005,100,,Invoice,,,,,,20/08/2018,20/08/2018,0.00,,672.54,,"-100,275.99"
,IN,AR,30323228,1005,100,,Invoice,,,,,,20/08/2018,20/08/2018,0.00,,672.54,,"-100,948.53"
,IN,AR,30323343,1005,100,,Invoice,,,,,,20/08/2018,20/08/2018,0.00,,672.54,,"-101,621.07"
,IN,AR,30325628,1005,100,,Invoice,,,,,,21/08/2018,21/08/2018,0.00,,"1,210.58",,"-102,831.65"
,IN,AR,30325629,1005,100,,Invoice,,,,,,21/08/2018,21/08/2018,0.00,,"1,210.58",,"-104,042.23"
,IN,AR,30325630,1005,100,,Invoice,,,,,,22/08/2018,22/08/2018,0.00,,"1,210.58",,"-105,252.81"
,IN,AR,30325632,1005,100,,Invoice,,,,,,23/08/2018,23/08/2018,0.00,,"1,210.58",,"-106,463.39"
,IN,AR,30325633,1005,100,,Invoice,,,,,,23/08/2018,23/08/2018,0.00,,"1,210.58",,"-107,673.97"
,IN,AR,30325634,1005,100,,Invoice,,,,,,25/08/2018,25/08/2018,0.00,,"1,210.58",,"-108,884.55"
,IN,AR,30325636,1005,100,,Invoice,,,,,,28/08/2018,28/08/2018,0.00,,"1,152.00",,"-110,036.55"
,IN,AR,30325637,1005,100,,Invoice,,,,,,28/08/2018,28/08/2018,0.00,,"1,152.00",,"-111,188.55"
,IN,AR,30325638,1005,100,,Invoice,,,,,,29/08/2018,29/08/2018,0.00,,"1,152.00",,"-112,340.55"
,IN,AR,30325639,1005,100,,Invoice,,,,,,29/08/2018,29/08/2018,0.00,,"1,152.00",,"-113,492.55"
,IN,AR,30325641,1005,100,,Invoice,,,,,,30/08/2018,30/08/2018,0.00,,640.00,,"-114,132.55"
,IN,AR,30325642,1005,100,,Invoice,,,,,,31/08/2018,31/08/2018,0.00,,"1,152.00",,"-115,284.55"
,IN,AR,30325643,1005,100,,Invoice,,,,,,31/08/2018,31/08/2018,0.00,,384.00,,"-115,668.55"
,IN,AR,30325644,1005,100,,Invoice,,,,,,01/09/2018,01/09/2018,0.00,,"1,152.00",,"-116,820.55"
,IN,AR,30325645,1005,100,,Invoice,,,,,,01/09/2018,01/09/2018,0.00,,"1,152.00",,"-117,972.55"
,IN,AR,30325646,1005,100,,Invoice,,,,,,03/09/2018,03/09/2018,0.00,,"1,152.00",,"-119,124.55"
,IN,AR,30325648,1005,100,,Invoice,,,,,,04/09/2018,04/09/2018,0.00,,640.00,,"-119,764.55"
,IN,AR,30325649,1005,100,,Invoice,,,,,,04/09/2018,04/09/2018,0.00,,384.00,,"-120,148.55"
,IN,AR,30325650,1005,100,,Invoice,,,,,,04/09/2018,04/09/2018,0.00,,640.00,,"-120,788.55"
,IN,AR,30325651,1005,100,,Invoice,,,,,,05/09/2018,05/09/2018,0.00,,384.00,,"-121,172.55"
,IN,AR,30325652,1005,100,,Invoice,,,,,,05/09/2018,05/09/2018,0.00,,640.00,,"-121,812.55"
,IN,AR,30330661,1005,100,,Invoice,,,,,,05/09/2018,05/09/2018,0.00,,384.00,,"-122,196.55"
,IN,AR,30325654,1005,100,,Invoice,,,,,,06/09/2018,06/09/2018,0.00,,640.00,,"-122,836.55"
,IN,AR,30325655,1005,100,,Invoice,,,,,,07/09/2018,07/09/2018,0.00,,640.00,,"-123,476.55"
,IN,AR,30325656,1005,100,,Invoice,,,,,,07/09/2018,07/09/2018,0.00,,"1,152.00",,"-124,628.55"
,CN,AR,31018895,1005,100,,Credit Note,,,,,,10/09/2018,10/09/2018,36.00,,0.00,,"-124,592.55"
,CN,AR,31018896,1005,100,,Credit Note,,,,,,10/09/2018,10/09/2018,21.00,,0.00,,"-124,571.55"
,CN,AR,31018897,1005,100,,Credit Note,,,,,,10/09/2018,10/09/2018,24.00,,0.00,,"-124,547.55"
,CN,AR,31018898,1005,100,,Credit Note,,,,,,10/09/2018,10/09/2018,16.00,,0.00,,"-124,531.55"
,CN,AR,31018899,1005,100,,Credit Note,,,,,,10/09/2018,10/09/2018,6.00,,0.00,,"-124,525.55"
,CN,AR,31018900,1005,100,,Credit Note,,,,,,10/09/2018,10/09/2018,6.00,,0.00,,"-124,519.55"
,CN,AR,31018901,1005,100,,Credit Note,,,,,,10/09/2018,10/09/2018,15.00,,0.00,,"-124,504.55"
,CN,AR,31018902,1005,100,,Credit Note,,,,,,10/09/2018,10/09/2018,21.00,,0.00,,"-124,483.55"
,CN,AR,31018903,1005,100,,Credit Note,,,,,,10/09/2018,10/09/2018,9.00,,0.00,,"-124,474.55"
,CN,AR,31018904,1005,100,,Credit Note,,,,,,10/09/2018,10/09/2018,5.00,,0.00,,"-124,469.55"
,CN,AR,31018905,1005,100,,Credit Note,,,,,,10/09/2018,10/09/2018,10.00,,0.00,,"-124,459.55"
,CN,AR,31018906,1005,100,,Credit Note,,,,,,10/09/2018,10/09/2018,5.00,,0.00,,"-124,454.55"
,CN,AR,31018907,1005,100,,Credit Note,,,,,,10/09/2018,10/09/2018,8.00,,0.00,,"-124,446.55"
,IN,AR,30325657,1005,100,,Invoice,,,,,,10/09/2018,10/09/2018,0.00,,"1,152.00",,"-125,598.55"
,IN,AR,30325658,1005,100,,Invoice,,,,,,10/09/2018,10/09/2018,0.00,,"1,152.00",,"-126,750.55"
,IN,AR,30325659,1005,100,,Invoice,,,,,,10/09/2018,10/09/2018,0.00,,640.00,,"-127,390.55"
,IN,AR,30325660,1005,100,,Invoice,,,,,,10/09/2018,10/09/2018,0.00,,640.00,,"-128,030.55"
,IN,AR,30325662,1005,100,,Invoice,,,,,,11/09/2018,11/09/2018,0.00,,640.00,,"-128,670.55"
,IN,AR,30325663,1005,100,,Invoice,,,,,,11/09/2018,11/09/2018,0.00,,640.00,,"-129,310.55"
,IN,AR,30325664,1005,100,,Invoice,,,,,,12/09/2018,12/09/2018,0.00,,640.00,,"-129,950.55"
,IN,AR,30325665,1005,100,,Invoice,,,,,,12/09/2018,12/09/2018,0.00,,448.00,,"-130,398.55"
,IN,AR,30325666,1005,100,,Invoice,,,,,,12/09/2018,12/09/2018,0.00,,640.00,,"-131,038.55"
,CN,AR,31018908,1005,100,,Credit Note,,,,,,13/09/2018,13/09/2018,43.00,,0.00,,"-130,995.55"
,IN,AR,30325668,1005,100,,Invoice,,,,,,13/09/2018,13/09/2018,0.00,,"1,152.00",,"-132,147.55"
,IN,AR,30325669,1005,100,,Invoice,,,,,,13/09/2018,13/09/2018,0.00,,"1,152.00",,"-133,299.55"
,IN,AR,30325670,1005,100,,Invoice,,,,,,14/09/2018,14/09/2018,0.00,,"1,152.00",,"-134,451.55"
,IN,AR,30325671,1005,100,,Invoice,,,,,,14/09/2018,14/09/2018,0.00,,"1,152.00",,"-135,603.55"
,IN,AR,30327392,1005,100,,Invoice,,,,,,17/09/2018,17/09/2018,0.00,,384.00,,"-135,987.55"
,IN,AR,30327393,1005,100,,Invoice,,,,,,17/09/2018,17/09/2018,0.00,,"1,152.00",,"-137,139.55"
,IN,AR,30327395,1005,100,,Invoice,,,,,,18/09/2018,18/09/2018,0.00,,"1,152.00",,"-138,291.55"
,IN,AR,30327396,1005,100,,Invoice,,,,,,18/09/2018,18/09/2018,0.00,,"1,152.00",,"-139,443.55"
,IN,AR,30327397,1005,100,,Invoice,,,,,,19/09/2018,19/09/2018,0.00,,"1,152.00",,"-140,595.55"
,IN,AR,30327398,1005,100,,Invoice,,,,,,19/09/2018,19/09/2018,0.00,,"1,152.00",,"-141,747.55"
,IN,AR,30327400,1005,100,,Invoice,,,,,,20/09/2018,20/09/2018,0.00,,640.00,,"-142,387.55"
,IN,AR,30327401,1005,100,,Invoice,,,,,,23/09/2018,23/09/2018,0.00,,"1,152.00",,"-143,539.55"
,IN,AR,30327402,1005,100,,Invoice,,,,,,23/09/2018,23/09/2018,0.00,,"1,152.00",,"-144,691.55"
,IN,AR,30327403,1005,100,,Invoice,,,,,,23/09/2018,23/09/2018,0.00,,"1,152.00",,"-145,843.55"
,IN,AR,30327507,1005,100,,Invoice,,,,,,23/09/2018,23/09/2018,0.00,,640.00,,"-146,483.55"
,IN,AR,30327508,1005,100,,Invoice,,,,,,23/09/2018,23/09/2018,0.00,,640.00,,"-147,123.55"
,IN,AR,30327509,1005,100,,Invoice,,,,,,23/09/2018,23/09/2018,0.00,,640.00,,"-147,763.55"
,CN,AR,31019085,1005,100,,Credit Note,,,,,,24/09/2018,24/09/2018,36.00,,0.00,,"-147,727.55"
,IN,AR,30327305,1005,100,,Invoice,,,,,,24/09/2018,24/09/2018,0.00,,640.00,,"-148,367.55"
,IN,AR,30327404,1005,100,,Invoice,,,,,,24/09/2018,24/09/2018,0.00,,"1,152.00",,"-149,519.55"
,IN,AR,30327405,1005,100,,Invoice,,,,,,24/09/2018,24/09/2018,0.00,,"1,152.00",,"-150,671.55"
,IN,AR,30327406,1005,100,,Invoice,,,,,,24/09/2018,24/09/2018,0.00,,"1,152.00",,"-151,823.55"
,IN,AR,30327407,1005,100,,Invoice,,,,,,24/09/2018,24/09/2018,0.00,,"1,152.00",,"-152,975.55"
,IN,AR,30327408,1005,100,,Invoice,,,,,,24/09/2018,24/09/2018,0.00,,"1,152.00",,"-154,127.55"
,IN,AR,30327410,1005,100,,Invoice,,,,,,25/09/2018,25/09/2018,0.00,,"1,152.00",,"-155,279.55"
,CN,AR,31019386,1005,100,,Credit Note,,,,,,25/09/2018,25/09/2018,26.00,,0.00,,"-155,253.55"
,IN,AR,30327411,1005,100,,Invoice,,,,,,26/09/2018,26/09/2018,0.00,,"1,152.00",,"-156,405.55"
,IN,AR,30327412,1005,100,,Invoice,,,,,,26/09/2018,26/09/2018,0.00,,"1,152.00",,"-157,557.55"
,IN,AR,30327414,1005,100,,Invoice,,,,,,27/09/2018,27/09/2018,0.00,,"1,152.00",,"-158,709.55"
,IN,AR,30327415,1005,100,,Invoice,,,,,,27/09/2018,27/09/2018,0.00,,"1,152.00",,"-159,861.55"
,IN,AR,30327512,1005,100,,Invoice,,,,,,27/09/2018,27/09/2018,0.00,,640.00,,"-160,501.55"
,IN,AR,30327416,1005,100,,Invoice,,,,,,28/09/2018,28/09/2018,0.00,,"1,152.00",,"-161,653.55"
,IN,AR,30327513,1005,100,,Invoice,,,,,,28/09/2018,28/09/2018,0.00,,640.00,,"-162,293.55"
,IN,AR,30327417,1005,100,,Invoice,,,,,,29/09/2018,29/09/2018,0.00,,"1,152.00",,"-163,445.55"
,IN,AR,30327418,1005,100,,Invoice,,,,,,29/09/2018,29/09/2018,0.00,,"1,152.00",,"-164,597.55"
,IN,AR,30327419,1005,100,,Invoice,,,,,,29/09/2018,29/09/2018,0.00,,"1,152.00",,"-165,749.55"
,IN,AR,30327515,1005,100,,Invoice,,,,,,29/09/2018,29/09/2018,0.00,,640.00,,"-166,389.55"
,IN,AR,30327516,1005,100,,Invoice,,,,,,29/09/2018,29/09/2018,0.00,,640.00,,"-167,029.55"
,IN,AR,30327517,1005,100,,Invoice,,,,,,29/09/2018,29/09/2018,0.00,,640.00,,"-167,669.55"
,IN,AR,30328110,1005,100,,Invoice,,,,,,01/10/2018,01/10/2018,0.00,,128.00,,"-167,797.55"
,IN,AR,30328151,1005,100,,Invoice,,,,,,01/10/2018,01/10/2018,0.00,,"1,152.00",,"-168,949.55"
,IN,AR,30328152,1005,100,,Invoice,,,,,,01/10/2018,01/10/2018,0.00,,640.00,,"-169,589.55"
,IN,AR,30328153,1005,100,,Invoice,,,,,,01/10/2018,01/10/2018,0.00,,512.00,,"-170,101.55"
,IN,AR,30328154,1005,100,,Invoice,,,,,,01/10/2018,01/10/2018,0.00,,"1,152.00",,"-171,253.55"
,IN,AR,30328207,1005,100,,Invoice,,,,,,01/10/2018,01/10/2018,0.00,,512.00,,"-171,765.55"
,CN,AR,31019161,1005,100,,Credit Note,,,,,,02/10/2018,02/10/2018,128.00,,0.00,,"-171,637.55"
,IN,AR,30328156,1005,100,,Invoice,,,,,,02/10/2018,02/10/2018,0.00,,896.00,,"-172,533.55"
,IN,AR,30328157,1005,100,,Invoice,,,,,,02/10/2018,02/10/2018,0.00,,"1,152.00",,"-173,685.55"
,IN,AR,30328159,1005,100,,Invoice,,,,,,03/10/2018,03/10/2018,0.00,,"2,304.00",,"-175,989.55"
,IN,AR,30328160,1005,100,,Invoice,,,,,,04/10/2018,04/10/2018,0.00,,"1,152.00",,"-177,141.55"
,IN,AR,30328162,1005,100,,Invoice,,,,,,05/10/2018,05/10/2018,0.00,,640.00,,"-177,781.55"
,CN,AR,31019384,1005,100,,Credit Note,,,,,,09/10/2018,09/10/2018,640.00,,0.00,,"-177,141.55"
,IN,AR,30330662,1005,100,,Invoice,,,,,,09/10/2018,09/10/2018,0.00,,"1,152.00",,"-178,293.55"
,IN,AR,30330663,1005,100,,Invoice,,,,,,09/10/2018,09/10/2018,0.00,,"1,152.00",,"-179,445.55"
,IN,AR,30330664,1005,100,,Invoice,,,,,,09/10/2018,09/10/2018,0.00,,"1,152.00",,"-180,597.55"
,IN,AR,30330665,1005,100,,Invoice,,,,,,10/10/2018,10/10/2018,0.00,,"1,152.00",,"-181,749.55"
,IN,AR,30330666,1005,100,,Invoice,,,,,,11/10/2018,11/10/2018,0.00,,"1,152.00",,"-182,901.55"
,IN,AR,30330667,1005,100,,Invoice,,,,,,12/10/2018,12/10/2018,0.00,,"1,152.00",,"-184,053.55"
,IN,AR,30330697,1005,100,,Invoice,,,,,,12/10/2018,12/10/2018,0.00,,"1,152.00",,"-185,205.55"
,IN,AR,30330668,1005,100,,Invoice,,,,,,13/10/2018,13/10/2018,0.00,,"1,152.00",,"-186,357.55"
,CN,AR,31019387,1005,100,,Credit Note,,,,,,15/10/2018,15/10/2018,4.20,,0.00,,"-186,353.35"
,CN,AR,31019388,1005,100,,Credit Note,,,,,,15/10/2018,15/10/2018,24.00,,0.00,,"-186,329.35"
,CN,AR,31019393,1005,100,,Credit Note,,,,,,15/10/2018,15/10/2018,"1,152.00",,0.00,,"-185,177.35"
,IN,AR,30330669,1005,100,,Invoice,,,,,,15/10/2018,15/10/2018,0.00,,"1,152.00",,"-186,329.35"
,IN,AR,30330670,1005,100,,Invoice,,,,,,15/10/2018,15/10/2018,0.00,,"1,152.00",,"-187,481.35"
,IN,AR,30330671,1005,100,,Invoice,,,,,,16/10/2018,16/10/2018,0.00,,"1,152.00",,"-188,633.35"
,IN,AR,30330672,1005,100,,Invoice,,,,,,16/10/2018,16/10/2018,0.00,,"1,152.00",,"-189,785.35"
,IN,AR,30330673,1005,100,,Invoice,,,,,,17/10/2018,17/10/2018,0.00,,"1,152.00",,"-190,937.35"
,IN,AR,30330674,1005,100,,Invoice,,,,,,18/10/2018,18/10/2018,0.00,,"1,152.00",,"-192,089.35"
,IN,AR,30330675,1005,100,,Invoice,,,,,,19/10/2018,19/10/2018,0.00,,"1,152.00",,"-193,241.35"
,IN,AR,30330676,1005,100,,Invoice,,,,,,20/10/2018,20/10/2018,0.00,,"2,304.00",,"-195,545.35"
,CN,AR,31019389,1005,100,,Credit Note,,,,,,22/10/2018,22/10/2018,512.00,,0.00,,"-195,033.35"
,CN,AR,31019394,1005,100,,Credit Note,,,,,,22/10/2018,22/10/2018,640.00,,0.00,,"-194,393.35"
,IN,AR,30330677,1005,100,,Invoice,,,,,,22/10/2018,22/10/2018,0.00,,"1,152.00",,"-195,545.35"
,IN,AR,30330678,1005,100,,Invoice,,,,,,22/10/2018,22/10/2018,0.00,,640.00,,"-196,185.35"
,IN,AR,30330698,1005,100,,Invoice,,,,,,22/10/2018,22/10/2018,0.00,,512.00,,"-196,697.35"
,IN,AR,30330679,1005,100,,Invoice,,,,,,23/10/2018,23/10/2018,0.00,,"1,152.00",,"-197,849.35"
,IN,AR,30330680,1005,100,,Invoice,,,,,,24/10/2018,24/10/2018,0.00,,"1,152.00",,"-199,001.35"
,IN,AR,30330681,1005,100,,Invoice,,,,,,25/10/2018,25/10/2018,0.00,,"1,152.00",,"-200,153.35"
,IN,AR,30330684,1005,100,,Invoice,,,,,,27/10/2018,27/10/2018,0.00,,"1,152.00",,"-201,305.35"
,IN,AR,30330685,1005,100,,Invoice,,,,,,27/10/2018,27/10/2018,0.00,,"1,152.00",,"-202,457.35"
,IN,AR,30330686,1005,100,,Invoice,,,,,,27/10/2018,27/10/2018,0.00,,"1,152.00",,"-203,609.35"
,IN,AR,30330687,1005,100,,Invoice,,,,,,29/10/2018,29/10/2018,0.00,,"1,152.00",,"-204,761.35"
,CN,AR,31019391,1005,100,,Credit Note,,,,,,30/10/2018,30/10/2018,34.00,,0.00,,"-204,727.35"
,CN,AR,31019392,1005,100,,Credit Note,,,,,,30/10/2018,30/10/2018,15.00,,0.00,,"-204,712.35"
,IN,AR,30330688,1005,100,,Invoice,,,,,,30/10/2018,30/10/2018,0.00,,"1,152.00",,"-205,864.35"
,IN,AR,30330689,1005,100,,Invoice,,,,,,30/10/2018,30/10/2018,0.00,,"1,152.00",,"-207,016.35"
,IN,AR,30331500,1005,100,,Invoice,,,,,,01/11/2018,01/11/2018,0.00,,"1,152.00",,"-208,168.35"
,IN,AR,30331501,1005,100,,Invoice,,,,,,01/11/2018,01/11/2018,0.00,,"1,152.00",,"-209,320.35"
,IN,AR,30331502,1005,100,,Invoice,,,,,,01/11/2018,01/11/2018,0.00,,"1,152.00",,"-210,472.35"
,IN,AR,30331503,1005,100,,Invoice,,,,,,03/11/2018,03/11/2018,0.00,,"1,152.00",,"-211,624.35"
,CN,AR,31019462,1005,100,,Credit Note,,,,,,05/11/2018,05/11/2018,"1,152.00",,0.00,,"-210,472.35"
,IN,AR,30331454,1005,100,,Invoice,,,,,,05/11/2018,05/11/2018,0.00,,"1,152.00",,"-211,624.35"
,IN,AR,30331504,1005,100,,Invoice,,,,,,05/11/2018,05/11/2018,0.00,,"1,152.00",,"-212,776.35"
,IN,AR,30331505,1005,100,,Invoice,,,,,,05/11/2018,05/11/2018,0.00,,"1,152.00",,"-213,928.35"
,IN,AR,30331507,1005,100,,Invoice,,,,,,06/11/2018,06/11/2018,0.00,,"1,152.00",,"-215,080.35"
,IN,AR,30331508,1005,100,,Invoice,,,,,,07/11/2018,07/11/2018,0.00,,"1,152.00",,"-216,232.35"
,IN,AR,30331509,1005,100,,Invoice,,,,,,07/11/2018,07/11/2018,0.00,,640.00,,"-216,872.35"
,IN,AR,30331511,1005,100,,Invoice,,,,,,08/11/2018,08/11/2018,0.00,,640.00,,"-217,512.35"
,IN,AR,30331512,1005,100,,Invoice,,,,,,09/11/2018,09/11/2018,0.00,,640.00,,"-218,152.35"
,IN,AR,30331513,1005,100,,Invoice,,,,,,09/11/2018,09/11/2018,0.00,,"1,152.00",,"-219,304.35"
,IN,AR,30331514,1005,100,,Invoice,,,,,,09/11/2018,09/11/2018,0.00,,"1,152.00",,"-220,456.35"
,IN,AR,30331515,1005,100,,Invoice,,,,,,09/11/2018,09/11/2018,0.00,,"1,152.00",,"-221,608.35"
,IN,AR,30331516,1005,100,,Invoice,,,,,,10/11/2018,10/11/2018,0.00,,"1,152.00",,"-222,760.35"
,IN,AR,30332882,1005,100,,Invoice,,,,,,12/11/2018,12/11/2018,0.00,,"1,152.00",,"-223,912.35"
,IN,AR,30332884,1005,100,,Invoice,,,,,,13/11/2018,13/11/2018,0.00,,"2,304.00",,"-226,216.35"
,IN,AR,30332885,1005,100,,Invoice,,,,,,14/11/2018,14/11/2018,0.00,,640.00,,"-226,856.35"
,IN,AR,30332888,1005,100,,Invoice,,,,,,16/11/2018,16/11/2018,0.00,,384.00,,"-227,240.35"
,IN,AR,30332889,1005,100,,Invoice,,,,,,16/11/2018,16/11/2018,0.00,,384.00,,"-227,624.35"
,IN,AR,30332890,1005,100,,Invoice,,,,,,16/11/2018,16/11/2018,0.00,,384.00,,"-228,008.35"
,IN,AR,30332891,1005,100,,Invoice,,,,,,17/11/2018,17/11/2018,0.00,,"1,152.00",,"-229,160.35"
,IN,AR,30332892,1005,100,,Invoice,,,,,,17/11/2018,17/11/2018,0.00,,"1,152.00",,"-230,312.35"
,IN,AR,30332893,1005,100,,Invoice,,,,,,17/11/2018,17/11/2018,0.00,,"1,152.00",,"-231,464.35"
,IN,AR,30332894,1005,100,,Invoice,,,,,,19/11/2018,19/11/2018,0.00,,"1,152.00",,"-232,616.35"
,IN,AR,30332895,1005,100,,Invoice,,,,,,19/11/2018,19/11/2018,0.00,,"1,792.00",,"-234,408.35"
,IN,AR,30332897,1005,100,,Invoice,,,,,,20/11/2018,20/11/2018,0.00,,"1,152.00",,"-235,560.35"
,IN,AR,30332898,1005,100,,Invoice,,,,,,21/11/2018,21/11/2018,0.00,,640.00,,"-236,200.35"
,IN,AR,30332900,1005,100,,Invoice,,,,,,22/11/2018,22/11/2018,0.00,,"3,456.00",,"-239,656.35"
,IN,AR,30332901,1005,100,,Invoice,,,,,,23/11/2018,23/11/2018,0.00,,"1,152.00",,"-240,808.35"
,IN,AR,30332902,1005,100,,Invoice,,,,,,24/11/2018,24/11/2018,0.00,,"2,304.00",,"-243,112.35"
,IN,AR,30332998,1005,100,,Invoice,,,,,,24/11/2018,24/11/2018,0.00,,"1,920.00",,"-245,032.35"
,IN,AR,30332903,1005,100,,Invoice,,,,,,26/11/2018,26/11/2018,0.00,,"1,152.00",,"-246,184.35"
,IN,AR,30332904,1005,100,,Invoice,,,,,,26/11/2018,26/11/2018,0.00,,"1,152.00",,"-247,336.35"
,IN,AR,30332906,1005,100,,Invoice,,,,,,28/11/2018,28/11/2018,0.00,,"2,304.00",,"-249,640.35"
,IN,AR,30332907,1005,100,,Invoice,,,,,,28/11/2018,28/11/2018,0.00,,"1,152.00",,"-250,792.35"
,IN,AR,30333000,1005,100,,Invoice,,,,,,28/11/2018,28/11/2018,0.00,,"1,152.00",,"-251,944.35"
,IN,AR,30332908,1005,100,,Invoice,,,,,,29/11/2018,29/11/2018,0.00,,"1,152.00",,"-253,096.35"
,IN,AR,30333001,1005,100,,Invoice,,,,,,30/11/2018,30/11/2018,0.00,,640.00,,"-253,736.35"
,IN,AR,30334878,1005,100,,Invoice,,,,,,01/12/2018,01/12/2018,0.00,,"1,152.00",,"-254,888.35"
,IN,AR,30334879,1005,100,,Invoice,,,,,,01/12/2018,01/12/2018,0.00,,640.00,,"-255,528.35"
,IN,AR,30334880,1005,100,,Invoice,,,,,,01/12/2018,01/12/2018,0.00,,"1,152.00",,"-256,680.35"
,IN,AR,30335063,1005,100,,Invoice,,,,,,01/12/2018,01/12/2018,0.00,,640.00,,"-257,320.35"
,IN,AR,30335064,1005,100,,Invoice,,,,,,01/12/2018,01/12/2018,0.00,,"1,152.00",,"-258,472.35"
,IN,AR,30334881,1005,100,,Invoice,,,,,,02/12/2018,02/12/2018,0.00,,"1,152.00",,"-259,624.35"
,IN,AR,30335065,1005,100,,Invoice,,,,,,02/12/2018,02/12/2018,0.00,,"1,152.00",,"-260,776.35"
,IN,AR,30334882,1005,100,,Invoice,,,,,,03/12/2018,03/12/2018,0.00,,"2,304.00",,"-263,080.35"
,IN,AR,30335066,1005,100,,Invoice,,,,,,03/12/2018,03/12/2018,0.00,,384.00,,"-263,464.35"
,IN,AR,30334884,1005,100,,Invoice,,,,,,05/12/2018,05/12/2018,0.00,,"2,304.00",,"-265,768.35"
,IN,AR,30335067,1005,100,,Invoice,,,,,,05/12/2018,05/12/2018,0.00,,"1,152.00",,"-266,920.35"
,IN,AR,30334886,1005,100,,Invoice,,,,,,06/12/2018,06/12/2018,0.00,,"2,304.00",,"-269,224.35"
,IN,AR,30334887,1005,100,,Invoice,,,,,,07/12/2018,07/12/2018,0.00,,"2,304.00",,"-271,528.35"
,IN,AR,30335068,1005,100,,Invoice,,,,,,07/12/2018,07/12/2018,0.00,,"1,280.00",,"-272,808.35"
,IN,AR,30334888,1005,100,,Invoice,,,,,,08/12/2018,08/12/2018,0.00,,640.00,,"-273,448.35"
,IN,AR,30334889,1005,100,,Invoice,,,,,,08/12/2018,08/12/2018,0.00,,640.00,,"-274,088.35"
,IN,AR,30334890,1005,100,,Invoice,,,,,,08/12/2018,08/12/2018,0.00,,"1,152.00",,"-275,240.35"
,IN,AR,30334891,1005,100,,Invoice,,,,,,08/12/2018,08/12/2018,0.00,,"1,152.00",,"-276,392.35"
,IN,AR,30335069,1005,100,,Invoice,,,,,,08/12/2018,08/12/2018,0.00,,640.00,,"-277,032.35"
,IN,AR,30335070,1005,100,,Invoice,,,,,,08/12/2018,08/12/2018,0.00,,640.00,,"-277,672.35"
,IN,AR,30334892,1005,100,,Invoice,,,,,,10/12/2018,10/12/2018,0.00,,640.00,,"-278,312.35"
,IN,AR,30334893,1005,100,,Invoice,,,,,,10/12/2018,10/12/2018,0.00,,640.00,,"-278,952.35"
,IN,AR,30334894,1005,100,,Invoice,,,,,,10/12/2018,10/12/2018,0.00,,640.00,,"-279,592.35"
,IN,AR,30334895,1005,100,,Invoice,,,,,,10/12/2018,10/12/2018,0.00,,"1,152.00",,"-280,744.35"
,IN,AR,30335071,1005,100,,Invoice,,,,,,10/12/2018,10/12/2018,0.00,,640.00,,"-281,384.35"
,IN,AR,30334898,1005,100,,Invoice,,,,,,11/12/2018,11/12/2018,0.00,,"1,152.00",,"-282,536.35"
,IN,AR,30335073,1005,100,,Invoice,,,,,,11/12/2018,11/12/2018,0.00,,"1,152.00",,"-283,688.35"
,IN,AR,30334899,1005,100,,Invoice,,,,,,12/12/2018,12/12/2018,0.00,,640.00,,"-284,328.35"
,IN,AR,30334900,1005,100,,Invoice,,,,,,12/12/2018,12/12/2018,0.00,,"2,304.00",,"-286,632.35"
,IN,AR,30334901,1005,100,,Invoice,,,,,,14/12/2018,14/12/2018,0.00,,"1,920.00",,"-288,552.35"
,IN,AR,30334902,1005,100,,Invoice,,,,,,15/12/2018,15/12/2018,0.00,,"1,152.00",,"-289,704.35"
,IN,AR,30334903,1005,100,,Invoice,,,,,,17/12/2018,17/12/2018,0.00,,"1,152.00",,"-290,856.35"
,IN,AR,30334904,1005,100,,Invoice,,,,,,17/12/2018,17/12/2018,0.00,,640.00,,"-291,496.35"
,IN,AR,30334905,1005,100,,Invoice,,,,,,17/12/2018,17/12/2018,0.00,,"1,152.00",,"-292,648.35"
,IN,AR,30334906,1005,100,,Invoice,,,,,,17/12/2018,17/12/2018,0.00,,640.00,,"-293,288.35"
,IN,AR,30334907,1005,100,,Invoice,,,,,,17/12/2018,17/12/2018,0.00,,"1,152.00",,"-294,440.35"
,IN,AR,30335075,1005,100,,Invoice,,,,,,17/12/2018,17/12/2018,0.00,,"1,152.00",,"-295,592.35"
,IN,AR,30334909,1005,100,,Invoice,,,,,,18/12/2018,18/12/2018,0.00,,"1,152.00",,"-296,744.35"
,IN,AR,30335077,1005,100,,Invoice,,,,,,18/12/2018,18/12/2018,0.00,,"1,152.00",,"-297,896.35"
,IN,AR,30337128,1005,100,,Invoice,,,,,,18/12/2018,18/12/2018,0.00,,"1,152.00",,"-299,048.35"
,IN,AR,30334911,1005,100,,Invoice,,,,,,19/12/2018,19/12/2018,0.00,,"2,304.00",,"-301,352.35"
,IN,AR,30334913,1005,100,,Invoice,,,,,,20/12/2018,20/12/2018,0.00,,"2,304.00",,"-303,656.35"
,IN,AR,30335078,1005,100,,Invoice,,,,,,20/12/2018,20/12/2018,0.00,,"1,152.00",,"-304,808.35"
,IN,AR,30334914,1005,100,,Invoice,,,,,,21/12/2018,21/12/2018,0.00,,"1,152.00",,"-305,960.35"
,IN,AR,30335079,1005,100,,Invoice,,,,,,21/12/2018,21/12/2018,0.00,,"1,152.00",,"-307,112.35"
,IN,AR,30334915,1005,100,,Invoice,,,,,,22/12/2018,22/12/2018,0.00,,"1,152.00",,"-308,264.35"
,IN,AR,30334916,1005,100,,Invoice,,,,,,24/12/2018,24/12/2018,0.00,,"1,152.00",,"-309,416.35"
,IN,AR,30334918,1005,100,,Invoice,,,,,,24/12/2018,24/12/2018,0.00,,384.00,,"-309,800.35"
,,,,,,,,,,,,,,,,,,,
,Account: 1000470 - Sales - Water Per Ltr,,,,,,,,,,,,,,,,,,
,Pr.,Mod.,Reference,Dept,Div,Suffix,Details,,,Cheque,,User,Doc Date,Post Date,Debit,,Credit,,Balance
,IN,AR,30307089,1005,100,,Invoice,,,,,,16/02/2018,16/02/2018,0.00,,280.00,,-280.00
,IN,AR,30308782,1005,100,,Invoice,,,,,,23/02/2018,23/02/2018,0.00,,"1,400.00",,"-1,680.00"
,IN,AR,30309236,1005,100,,Invoice,,,,,,29/03/2018,29/03/2018,0.00,,140.00,,"-1,820.00"
,IN,AR,30314763,1005,100,,Invoice,,,,,,17/05/2018,17/05/2018,0.00,,280.00,,"-2,100.00"
,IN,AR,30314733,1005,100,,Invoice,,,,,,18/05/2018,18/05/2018,0.00,,280.00,,"-2,380.00"
,IN,AR,30316076,1005,100,,Invoice,,,,,,30/05/2018,30/05/2018,0.00,,280.00,,"-2,660.00"
,IN,AR,30321562,1005,100,,Invoice,,,,,,01/08/2018,01/08/2018,0.00,,280.00,,"-2,940.00"
,IN,AR,30322474,1005,100,,Invoice,,,,,,16/08/2018,16/08/2018,0.00,,280.00,,"-3,220.00"
,IN,AR,30331889,1005,100,,Invoice,,,,,,16/11/2018,16/11/2018,0.00,,98.00,,"-3,318.00"
,IN,AR,30332554,1005,100,,Invoice,,,,,,16/11/2018,16/11/2018,0.00,,280.00,,"-3,598.00"
,CN,AR,31019561,1005,100,,Credit Note,,,,,,28/11/2018,28/11/2018,280.00,,0.00,,"-3,318.00"
,IN,AR,30332016,1005,100,,Invoice,,,,,,28/11/2018,28/11/2018,0.00,,280.00,,"-3,598.00"
,IN,AR,30333797,1005,100,,Invoice,,,,,,19/12/2018,19/12/2018,0.00,,140.00,,"-3,738.00"
,,,,,,,,,,,,,,,,,,,
,Account: 1000502 - Sales - Gas Cylinders 12kg,,,,,,,,,,,,,,,,,,
,Pr.,Mod.,Reference,Dept,Div,Suffix,Details,,,Cheque,,User,Doc Date,Post Date,Debit,,Credit,,Balance
,IN,AP,40002290,9000,900,,35 X 12kgs,,,,,SB,15/02/2018,15/02/2018,400.26,,0.00,,400.26
,CS,AR,32003419,1001,100,,Cash sale,,,,,,25/04/2018,25/04/2018,0.00,,257.63,,142.63
,CS,AR,32003420,1001,100,,Cash sale,,,,,,26/04/2018,26/04/2018,0.00,,13.56,,129.07
,CS,AR,32003421,1001,100,,Cash sale,,,,,,26/04/2018,26/04/2018,0.00,,13.56,,115.51
,CS,AR,32003422,1001,100,,Cash sale,,,,,,26/04/2018,26/04/2018,0.00,,13.56,,101.95
,CS,AR,32003423,1001,100,,Cash sale,,,,,,26/04/2018,26/04/2018,0.00,,13.56,,88.39
,CS,AR,32003424,1001,100,,Cash sale,,,,,,26/04/2018,26/04/2018,0.00,,13.56,,74.83
,CS,AR,32003425,1001,100,,Cash sale,,,,,,26/04/2018,26/04/2018,0.00,,13.56,,61.27
,CS,AR,32003426,1001,100,,Cash sale,,,,,,26/04/2018,26/04/2018,0.00,,13.56,,47.71
,IN,AR,30313106,1001,100,,Invoice,,,,,,26/04/2018,26/04/2018,0.00,,13.56,,34.15
,IN,AR,30313107,1001,100,,Invoice,,,,,,26/04/2018,26/04/2018,0.00,,13.56,,20.59
,CS,AR,32003962,1001,100,,Cash sale,,,,,,27/04/2018,27/04/2018,0.00,,27.12,,-6.53
,,,,,,,,,,,,,,,,,,,
,CS,AR,32003963,1001,100,,Cash sale,,,,,,27/04/2018,27/04/2018,0.00,,13.56,,-20.09
,CS,AR,32003964,1001,100,,Cash sale,,,,,,30/04/2018,30/04/2018,0.00,,13.56,,-33.65
,CS,AR,32003965,1001,100,,Cash sale,,,,,,30/04/2018,30/04/2018,0.00,,27.12,,-60.77
,CS,AR,32003966,1001,100,,Cash sale,,,,,,30/04/2018,30/04/2018,0.00,,13.56,,-74.33
,CS,AR,32003967,1001,100,,Cash sale,,,,,,30/04/2018,30/04/2018,0.00,,13.56,,-87.89
,CS,AR,32003968,1001,100,,Cash sale,,,,,,30/04/2018,30/04/2018,0.00,,27.12,,-115.01
,CS,AR,32003969,1001,100,,Cash sale,,,,,,30/04/2018,30/04/2018,0.00,,13.56,,-128.57
,CS,AR,32003970,1001,100,,Cash sale,,,,,,30/04/2018,30/04/2018,0.00,,13.56,,-142.13
,CS,AR,32003971,1001,100,,Cash sale,,,,,,30/04/2018,30/04/2018,0.00,,13.56,,-155.69
,CS,AR,32003972,1001,100,,Cash sale,,,,,,30/04/2018,30/04/2018,0.00,,13.56,,-169.25
,CS,AR,32003973,1001,100,,Cash sale,,,,,,02/05/2018,02/05/2018,0.00,,27.12,,-196.37
,CS,AR,32003974,1001,100,,Cash sale,,,,,,02/05/2018,02/05/2018,0.00,,13.56,,-209.93
,IN,AP,40002255,9000,900,,35x 12kgs,,,,,SB,02/05/2018,02/05/2018,400.26,,0.00,,190.33
,CS,AR,32003976,1001,100,,Cash sale,,,,,,03/05/2018,03/05/2018,0.00,,13.56,,176.77
,CS,AR,32003977,1001,100,,Cash sale,,,,,,03/05/2018,03/05/2018,0.00,,40.68,,136.09
,CS,AR,32003978,1001,100,,Cash sale,,,,,,03/05/2018,03/05/2018,0.00,,13.56,,122.53
,CS,AR,32003979,1001,100,,Cash sale,,,,,,03/05/2018,03/05/2018,0.00,,13.56,,108.97
,CS,AR,32003980,1001,100,,Cash sale,,,,,,04/05/2018,04/05/2018,0.00,,13.56,,95.41
,CS,AR,32003981,1001,100,,Cash sale,,,,,,05/05/2018,05/05/2018,0.00,,13.56,,81.85
,IN,AR,30314532,1001,100,,Invoice,,,,,,06/05/2018,06/05/2018,0.00,,13.56,,68.29
,IN,AR,30314533,1001,100,,Invoice,,,,,,06/05/2018,06/05/2018,0.00,,13.56,,54.73
,IN,AR,30314534,1001,100,,Invoice,,,,,,06/05/2018,06/05/2018,0.00,,13.56,,41.17
,CS,AR,32003982,1001,100,,Cash sale,,,,,,07/05/2018,07/05/2018,0.00,,27.12,,14.05
,CS,AR,32003983,1001,100,,Cash sale,,,,,,07/05/2018,07/05/2018,0.00,,13.56,,0.49
,CS,AR,32003984,1001,100,,Cash sale,,,,,,08/05/2018,08/05/2018,0.00,,13.56,,-13.07
,CS,AR,32003985,1001,100,,Cash sale,,,,,,09/05/2018,09/05/2018,0.00,,13.56,,-26.63
,CS,AR,32003986,1001,100,,Cash sale,,,,,,09/05/2018,09/05/2018,0.00,,13.56,,-40.19
,CS,AR,32003987,1001,100,,Cash sale,,,,,,09/05/2018,09/05/2018,0.00,,13.56,,-53.75
,CS,AR,32003988,1001,100,,Cash sale,,,,,,09/05/2018,09/05/2018,0.00,,13.56,,-67.31
,CS,AR,32003989,1001,100,,Cash sale,,,,,,11/05/2018,11/05/2018,0.00,,13.56,,-80.87
,CS,AR,32003990,1001,100,,Cash sale,,,,,,11/05/2018,11/05/2018,0.00,,13.56,,-94.43
,IN,AP,40002254,9000,900,,70 X 12kgs,,,,,SB,13/05/2018,13/05/2018,800.86,,0.00,,706.43
,CS,AR,32003991,1001,100,,Cash sale,,,,,,14/05/2018,14/05/2018,0.00,,13.56,,692.87
,CS,AR,32003992,1001,100,,Cash sale,,,,,,14/05/2018,14/05/2018,0.00,,13.56,,679.31
,CS,AR,32004378,1001,100,,Cash sale,,,,,,15/05/2018,15/05/2018,0.00,,13.56,,665.75
,CS,AR,32004379,1001,100,,Cash sale,,,,,,15/05/2018,15/05/2018,0.00,,13.56,,652.19
,CS,AR,32004380,1001,100,,Cash sale,,,,,,15/05/2018,15/05/2018,0.00,,13.56,,638.63
,IN,AP,40002256,9000,900,,43 X 12kgs,,,,,SB,16/05/2018,16/05/2018,491.95,,0.00,,"1,130.58"
,CN,AR,31018072,1001,100,,Credit Note,,,,,,17/05/2018,17/05/2018,13.56,,0.00,,"1,144.14"
,CS,AR,32004382,1001,100,,Cash sale,,,,,,17/05/2018,17/05/2018,0.00,,27.12,,"1,117.02"
,CS,AR,32004383,1001,100,,Cash sale,,,,,,17/05/2018,17/05/2018,0.00,,13.56,,"1,103.46"
,CS,AR,32004384,1001,100,,Cash sale,,,,,,17/05/2018,17/05/2018,0.00,,13.56,,"1,089.90"
,CS,AR,32004385,1001,100,,Cash sale,,,,,,17/05/2018,17/05/2018,0.00,,40.68,,"1,049.22"
,CS,AR,32004386,1001,100,,Cash sale,,,,,,17/05/2018,17/05/2018,0.00,,13.56,,"1,035.66"
,CS,AR,32004387,1001,100,,Cash sale,,,,,,17/05/2018,17/05/2018,0.00,,13.56,,"1,022.10"
,CS,AR,32004388,1001,100,,Cash sale,,,,,,17/05/2018,17/05/2018,0.00,,13.56,,"1,008.54"
,CS,AR,32004389,1001,100,,Cash sale,,,,,,17/05/2018,17/05/2018,0.00,,13.56,,994.98
,CS,AR,32004390,1001,100,,Cash sale,,,,,,17/05/2018,17/05/2018,0.00,,13.56,,981.42
,CS,AR,32004391,1001,100,,Cash sale,,,,,,17/05/2018,17/05/2018,0.00,,13.56,,967.86
,CS,AR,32004392,1001,100,,Cash sale,,,,,,17/05/2018,17/05/2018,0.00,,13.56,,954.30
,IN,AR,30315481,1001,100,,Invoice,,,,,,17/05/2018,17/05/2018,0.00,,13.56,,940.74
,CS,AR,32004393,1001,100,,Cash sale,,,,,,18/05/2018,18/05/2018,0.00,,13.56,,927.18
,CS,AR,32004394,1001,100,,Cash sale,,,,,,21/05/2018,21/05/2018,0.00,,13.56,,913.62
,CS,AR,32004395,1001,100,,Cash sale,,,,,,21/05/2018,21/05/2018,0.00,,13.56,,900.06
,CS,AR,32004396,1001,100,,Cash sale,,,,,,21/05/2018,21/05/2018,0.00,,13.56,,886.50
,CS,AR,32004397,1001,100,,Cash sale,,,,,,21/05/2018,21/05/2018,0.00,,13.56,,872.94
,CS,AR,32004398,1001,100,,Cash sale,,,,,,21/05/2018,21/05/2018,0.00,,13.56,,859.38
,CS,AR,32004399,1001,100,,Cash sale,,,,,,21/05/2018,21/05/2018,0.00,,13.56,,845.82
,CS,AR,32004400,1001,100,,Cash sale,,,,,,21/05/2018,21/05/2018,0.00,,13.56,,832.26
,CS,AR,32004401,1001,100,,Cash sale,,,,,,22/05/2018,22/05/2018,0.00,,13.56,,818.70
,CS,AR,32004402,1001,100,,Cash sale,,,,,,22/05/2018,22/05/2018,0.00,,13.56,,805.14
,CS,AR,32004403,1001,100,,Cash sale,,,,,,23/05/2018,23/05/2018,0.00,,13.56,,791.58
,CS,AR,32004404,1001,100,,Cash sale,,,,,,23/05/2018,23/05/2018,0.00,,13.56,,778.02
,CS,AR,32004405,1001,100,,Cash sale,,,,,,23/05/2018,23/05/2018,0.00,,13.56,,764.46
,CS,AR,32004406,1001,100,,Cash sale,,,,,,24/05/2018,24/05/2018,0.00,,13.56,,750.90
,CS,AR,32004407,1001,100,,Cash sale,,,,,,24/05/2018,24/05/2018,0.00,,27.12,,723.78
,CS,AR,32004408,1001,100,,Cash sale,,,,,,25/05/2018,25/05/2018,0.00,,13.56,,710.22
,CS,AR,32004409,1001,100,,Cash sale,,,,,,25/05/2018,25/05/2018,0.00,,27.12,,683.10
,CS,AR,32004410,1001,100,,Cash sale,,,,,,25/05/2018,25/05/2018,0.00,,27.12,,655.98
,CS,AR,32004411,1001,100,,Cash sale,,,,,,25/05/2018,25/05/2018,0.00,,13.56,,642.42
,CS,AR,32004412,1001,100,,Cash sale,,,,,,25/05/2018,25/05/2018,0.00,,27.12,,615.30
,CS,AR,32004413,1001,100,,Cash sale,,,,,,25/05/2018,25/05/2018,0.00,,27.12,,588.18
,CS,AR,32004414,1001,100,,Cash sale,,,,,,26/05/2018,26/05/2018,0.00,,13.56,,574.62
,CS,AR,32004415,1001,100,,Cash sale,,,,,,26/05/2018,26/05/2018,0.00,,13.56,,561.06
,CS,AR,32004416,1001,100,,Cash sale,,,,,,26/05/2018,26/05/2018,0.00,,13.56,,547.50
,CS,AR,32004417,1001,100,,Cash sale,,,,,,26/05/2018,26/05/2018,0.00,,40.68,,506.82
,CS,AR,32004418,1001,100,,Cash sale,,,,,,26/05/2018,26/05/2018,0.00,,27.12,,479.70
,CS,AR,32004419,1001,100,,Cash sale,,,,,,26/05/2018,26/05/2018,0.00,,13.56,,466.14
,IN,AR,30315482,1001,100,,Invoice,,,,,,26/05/2018,26/05/2018,0.00,,40.68,,425.46
,CS,AR,32004627,1001,100,,Cash sale,,,,,,28/05/2018,28/05/2018,0.00,,13.56,,411.90
,CS,AR,32004628,1001,100,,Cash sale,,,,,,28/05/2018,28/05/2018,0.00,,13.56,,398.34
,CS,AR,32004631,1001,100,,Cash sale,,,,,,29/05/2018,29/05/2018,0.00,,13.56,,384.78
,CS,AR,32004632,1001,100,,Cash sale,,,,,,29/05/2018,29/05/2018,0.00,,13.56,,371.22
,IN,AP,40002253,9000,900,,35 X 12kgs 5 X 15kgs,,,,,SB,30/05/2018,30/05/2018,400.26,,0.00,,771.48
,CS,AR,32004633,1001,100,,Cash sale,,,,,,30/05/2018,30/05/2018,0.00,,13.56,,757.92
,CS,AR,32004634,1001,100,,Cash sale,,,,,,30/05/2018,30/05/2018,0.00,,27.12,,730.80
,CS,AR,32004636,1001,100,,Cash sale,,,,,,30/05/2018,30/05/2018,0.00,,27.12,,703.68
,CS,AR,32004637,1001,100,,Cash sale,,,,,,30/05/2018,30/05/2018,0.00,,27.12,,676.56
,CS,AR,32004638,1001,100,,Cash sale,,,,,,30/05/2018,30/05/2018,0.00,,40.68,,635.88
,CS,AR,32004639,1001,100,,Cash sale,,,,,,30/05/2018,30/05/2018,0.00,,13.56,,622.32
,CS,AR,32004640,1001,100,,Cash sale,,,,,,30/05/2018,30/05/2018,0.00,,13.56,,608.76
,CS,AR,32004641,1001,100,,Cash sale,,,,,,30/05/2018,30/05/2018,0.00,,27.12,,581.64
,CS,AR,32004642,1001,100,,Cash sale,,,,,,30/05/2018,30/05/2018,0.00,,13.56,,568.08
,CS,AR,32004643,1001,100,,Cash sale,,,,,,30/05/2018,30/05/2018,0.00,,13.56,,554.52
,CS,AR,32004644,1001,100,,Cash sale,,,,,,30/05/2018,30/05/2018,0.00,,13.56,,540.96
,CS,AR,32004645,1001,100,,Cash sale,,,,,,30/05/2018,30/05/2018,0.00,,13.56,,527.40
,CS,AR,32004647,1001,100,,Cash sale,,,,,,31/05/2018,31/05/2018,0.00,,13.56,,513.84
,CS,AR,32004648,1001,100,,Cash sale,,,,,,31/05/2018,31/05/2018,0.00,,27.12,,486.72
,CS,AR,32004649,1001,100,,Cash sale,,,,,,31/05/2018,31/05/2018,0.00,,13.56,,473.16
,CS,AR,32004651,1001,100,,Cash sale,,,,,,31/05/2018,31/05/2018,0.00,,13.56,,459.60
,CS,AR,32004652,1001,100,,Cash sale,,,,,,31/05/2018,31/05/2018,0.00,,13.56,,446.04
,CS,AR,32004653,1001,100,,Cash sale,,,,,,31/05/2018,31/05/2018,0.00,,13.56,,432.48
,CS,AR,32004654,1001,100,,Cash sale,,,,,,31/05/2018,31/05/2018,0.00,,13.56,,418.92
,CS,AR,32004876,1001,100,,Cash sale,,,,,,01/06/2018,01/06/2018,0.00,,13.56,,405.36
,CS,AR,32004878,1001,100,,Cash sale,,,,,,04/06/2018,04/06/2018,0.00,,13.56,,391.80
,CS,AR,32004879,1001,100,,Cash sale,,,,,,04/06/2018,04/06/2018,0.00,,13.56,,378.24
,CS,AR,32004880,1001,100,,Cash sale,,,,,,05/06/2018,05/06/2018,0.00,,13.56,,364.68
,CS,AR,32004882,1001,100,,Cash sale,,,,,,05/06/2018,05/06/2018,0.00,,13.56,,351.12
,IN,AP,40002289,9000,900,,29 X 12kgs,,,,,SB,06/06/2018,06/06/2018,331.64,,0.00,,682.76
,CR,AR,33000161,1001,100,,Cash Return,,,,,,06/06/2018,06/06/2018,13.56,,0.00,,696.32
,CS,AR,32004883,1001,100,,Cash sale,,,,,,06/06/2018,06/06/2018,0.00,,13.56,,682.76
,CS,AR,32004884,1001,100,,Cash sale,,,,,,06/06/2018,06/06/2018,0.00,,13.56,,669.20
,CS,AR,32004885,1001,100,,Cash sale,,,,,,06/06/2018,06/06/2018,0.00,,13.56,,655.64
,CS,AR,32004886,1001,100,,Cash sale,,,,,,06/06/2018,06/06/2018,0.00,,13.56,,642.08
,CS,AR,32004887,1001,100,,Cash sale,,,,,,06/06/2018,06/06/2018,0.00,,13.56,,628.52
,CS,AR,32004967,1001,100,,Cash sale,,,,,,08/06/2018,08/06/2018,0.00,,13.56,,614.96
,CS,AR,32004968,1001,100,,Cash sale,,,,,,08/06/2018,08/06/2018,0.00,,13.56,,601.40
,CS,AR,32005242,1001,100,,Cash sale,,,,,,11/06/2018,11/06/2018,0.00,,13.56,,587.84
,CS,AR,32005243,1001,100,,Cash sale,,,,,,11/06/2018,11/06/2018,0.00,,13.56,,574.28
,CS,AR,32005244,1001,100,,Cash sale,,,,,,12/06/2018,12/06/2018,0.00,,13.56,,560.72
,CS,AR,32005245,1001,100,,Cash sale,,,,,,13/06/2018,13/06/2018,0.00,,67.80,,492.92
,CS,AR,32005246,1001,100,,Cash sale,,,,,,16/06/2018,16/06/2018,0.00,,13.56,,479.36
,CS,AR,32005723,1001,100,,Cash sale,,,,,,21/06/2018,21/06/2018,0.00,,13.56,,465.80
,CS,AR,32005724,1001,100,,Cash sale,,,,,,21/06/2018,21/06/2018,0.00,,352.54,,113.26
,CS,AR,32005725,1001,100,,Cash sale,,,,,,21/06/2018,21/06/2018,0.00,,13.56,,99.70
,CS,AR,32005726,1001,100,,Cash sale,,,,,,21/06/2018,21/06/2018,0.00,,27.12,,72.58
,CS,AR,32005660,1001,100,,Cash sale,,,,,,22/06/2018,22/06/2018,0.00,,13.56,,59.02
,CS,AR,32005727,1001,100,,Cash sale,,,,,,22/06/2018,22/06/2018,0.00,,13.56,,45.46
,CS,AR,32005728,1001,100,,Cash sale,,,,,,23/06/2018,23/06/2018,0.00,,40.68,,4.78
,CS,AR,32005729,1001,100,,Cash sale,,,,,,27/06/2018,27/06/2018,0.00,,13.56,,-8.78
,CS,AR,32005730,1001,100,,Cash sale,,,,,,27/06/2018,27/06/2018,0.00,,27.12,,-35.90
,CS,AR,32005731,1001,100,,Cash sale,,,,,,27/06/2018,27/06/2018,0.00,,27.12,,-63.02
,CS,AR,32005732,1001,100,,Cash sale,,,,,,28/06/2018,28/06/2018,0.00,,27.12,,-90.14
,CS,AR,32005736,1001,100,,Cash sale,,,,,,30/06/2018,30/06/2018,0.00,,27.12,,-117.26
,CS,AR,32006015,1001,100,,Cash sale,,,,,,02/07/2018,02/07/2018,0.00,,13.56,,-130.82
,IN,AP,40002334,9000,900,,35x12kg,,,,,SB,02/07/2018,02/07/2018,400.26,,0.00,,269.44
,CS,AR,32006016,1001,100,,Cash sale,,,,,,04/07/2018,04/07/2018,0.00,,13.56,,255.88
,CS,AR,32006017,1001,100,,Cash sale,,,,,,04/07/2018,04/07/2018,0.00,,27.12,,228.76
,CS,AR,32006018,1001,100,,Cash sale,,,,,,04/07/2018,04/07/2018,0.00,,13.56,,215.20
,CS,AR,32006019,1001,100,,Cash sale,,,,,,04/07/2018,04/07/2018,0.00,,13.56,,201.64
,CS,AR,32006020,1001,100,,Cash sale,,,,,,04/07/2018,04/07/2018,0.00,,13.56,,188.08
,CS,AR,32006021,1001,100,,Cash sale,,,,,,04/07/2018,04/07/2018,0.00,,27.12,,160.96
,CS,AR,32006022,1001,100,,Cash sale,,,,,,04/07/2018,04/07/2018,0.00,,40.68,,120.28
,CS,AR,32006023,1001,100,,Cash sale,,,,,,04/07/2018,04/07/2018,0.00,,40.68,,79.60
,CS,AR,32006024,1001,100,,Cash sale,,,,,,04/07/2018,04/07/2018,0.00,,13.56,,66.04
,CS,AR,32006025,1001,100,,Cash sale,,,,,,04/07/2018,04/07/2018,0.00,,13.56,,52.48
,CS,AR,32006026,1001,100,,Cash sale,,,,,,04/07/2018,04/07/2018,0.00,,13.56,,38.92
,CS,AR,32006027,1001,100,,Cash sale,,,,,,05/07/2018,05/07/2018,0.00,,13.56,,25.36
,CS,AR,32006028,1001,100,,Cash sale,,,,,,05/07/2018,05/07/2018,0.00,,13.56,,11.80
,CS,AR,32006029,1001,100,,Cash sale,,,,,,05/07/2018,05/07/2018,0.00,,13.56,,-1.76
,CS,AR,32006030,1001,100,,Cash sale,,,,,,06/07/2018,06/07/2018,0.00,,13.56,,-15.32
,CS,AR,32006101,1001,100,,Cash sale,,,,,,09/07/2018,09/07/2018,0.00,,13.56,,-28.88
,CS,AR,32006102,1001,100,,Cash sale,,,,,,09/07/2018,09/07/2018,0.00,,27.12,,-56.00
,CS,AR,32006103,1001,100,,Cash sale,,,,,,09/07/2018,09/07/2018,0.00,,27.12,,-83.12
,CS,AR,32006104,1001,100,,Cash sale,,,,,,09/07/2018,09/07/2018,0.00,,13.56,,-96.68
,IN,AP,40002354,9000,900,,12kgs X35,,,,,SB,09/07/2018,09/07/2018,400.26,,0.00,,303.58
,IN,AP,40002355,9000,900,,12kgs X 35,,,,,SB,10/07/2018,10/07/2018,400.26,,0.00,,703.84
,CS,AR,32006516,1001,100,,Cash sale,,,,,,10/07/2018,10/07/2018,0.00,,13.56,,690.28
,CS,AR,32006517,1001,100,,Cash sale,,,,,,10/07/2018,10/07/2018,0.00,,13.56,,676.72
,CS,AR,32006518,1001,100,,Cash sale,,,,,,10/07/2018,10/07/2018,0.00,,13.56,,663.16
,CS,AR,32006519,1001,100,,Cash sale,,,,,,10/07/2018,10/07/2018,0.00,,13.56,,649.60
,IN,AR,30320283,1001,100,,Invoice,,,,,,10/07/2018,10/07/2018,0.00,,406.78,,242.82
,CS,AR,32006520,1001,100,,Cash sale,,,,,,11/07/2018,11/07/2018,0.00,,27.12,,215.70
,CS,AR,32006522,1001,100,,Cash sale,,,,,,12/07/2018,12/07/2018,0.00,,13.56,,202.14
,CS,AR,32006524,1001,100,,Cash sale,,,,,,12/07/2018,12/07/2018,0.00,,13.56,,188.58
,CS,AR,32006525,1001,100,,Cash sale,,,,,,12/07/2018,12/07/2018,0.00,,13.56,,175.02
,CS,AR,32006526,1001,100,,Cash sale,,,,,,13/07/2018,13/07/2018,0.00,,13.56,,161.46
,CS,AR,32006527,1001,100,,Cash sale,,,,,,13/07/2018,13/07/2018,0.00,,13.56,,147.90
,CS,AR,32006528,1001,100,,Cash sale,,,,,,16/07/2018,16/07/2018,0.00,,27.12,,120.78
,CS,AR,32006529,1001,100,,Cash sale,,,,,,16/07/2018,16/07/2018,0.00,,13.56,,107.22
,CS,AR,32006530,1001,100,,Cash sale,,,,,,16/07/2018,16/07/2018,0.00,,13.56,,93.66
,CS,AR,32006531,1001,100,,Cash sale,,,,,,16/07/2018,16/07/2018,0.00,,13.56,,80.10
,CS,AR,32006532,1001,100,,Cash sale,,,,,,17/07/2018,17/07/2018,0.00,,13.56,,66.54
,CS,AR,32006533,1001,100,,Cash sale,,,,,,17/07/2018,17/07/2018,0.00,,13.56,,52.98
,CS,AR,32006534,1001,100,,Cash sale,,,,,,19/07/2018,19/07/2018,0.00,,13.56,,39.42
,CS,AR,32006536,1001,100,,Cash sale,,,,,,19/07/2018,19/07/2018,0.00,,13.56,,25.86
,CS,AR,32006537,1001,100,,Cash sale,,,,,,19/07/2018,19/07/2018,0.00,,13.56,,12.30
,CS,AR,32007012,1001,100,,Cash sale,,,,,,20/07/2018,20/07/2018,0.00,,13.56,,-1.26
,CS,AR,32007013,1001,100,,Cash sale,,,,,,20/07/2018,20/07/2018,0.00,,13.56,,-14.82
,CS,AR,32007014,1001,100,,Cash sale,,,,,,24/07/2018,24/07/2018,0.00,,13.56,,-28.38
,CS,AR,32007015,1001,100,,Cash sale,,,,,,25/07/2018,25/07/2018,0.00,,13.56,,-41.94
,CS,AR,32007016,1001,100,,Cash sale,,,,,,26/07/2018,26/07/2018,0.00,,13.56,,-55.50
,CS,AR,32007017,1001,100,,Cash sale,,,,,,27/07/2018,27/07/2018,0.00,,27.12,,-82.62
,CS,AR,32007018,1001,100,,Cash sale,,,,,,27/07/2018,27/07/2018,0.00,,13.56,,-96.18
,CS,AR,32007019,1001,100,,Cash sale,,,,,,27/07/2018,27/07/2018,0.00,,27.12,,-123.30
,CS,AR,32007020,1001,100,,Cash sale,,,,,,28/07/2018,28/07/2018,0.00,,13.56,,-136.86
,CS,AR,32007021,1001,100,,Cash sale,,,,,,30/07/2018,30/07/2018,0.00,,13.56,,-150.42
,CS,AR,32007022,1001,100,,Cash sale,,,,,,31/07/2018,31/07/2018,0.00,,13.56,,-163.98
,CS,AR,32007023,1001,100,,Cash sale,,,,,,31/07/2018,31/07/2018,0.00,,13.56,,-177.54
,CS,AR,32007307,1001,100,,Cash sale,,,,,,01/08/2018,01/08/2018,0.00,,13.56,,-191.10
,CS,AR,32007308,1001,100,,Cash sale,,,,,,01/08/2018,01/08/2018,0.00,,13.56,,-204.66
,CS,AR,32007309,1001,100,,Cash sale,,,,,,01/08/2018,01/08/2018,0.00,,13.56,,-218.22
,CS,AR,32007310,1001,100,,Cash sale,,,,,,01/08/2018,01/08/2018,0.00,,13.56,,-231.78
,CS,AR,32007311,1001,100,,Cash sale,,,,,,01/08/2018,01/08/2018,0.00,,40.68,,-272.46
,CS,AR,32007312,1001,100,,Cash sale,,,,,,02/08/2018,02/08/2018,0.00,,27.12,,-299.58
,CS,AR,32007313,1001,100,,Cash sale,,,,,,06/08/2018,06/08/2018,0.00,,13.56,,-313.14
,CS,AR,32007314,1001,100,,Cash sale,,,,,,06/08/2018,06/08/2018,0.00,,13.56,,-326.70
,CS,AR,32007315,1001,100,,Cash sale,,,,,,06/08/2018,06/08/2018,0.00,,27.12,,-353.82
,CS,AR,32007316,1001,100,,Cash sale,,,,,,06/08/2018,06/08/2018,0.00,,27.12,,-380.94
,IN,AP,40002427,9000,900,,12KGS X 35,,,,,SB,07/08/2018,07/08/2018,400.26,,0.00,,19.32
,CS,AR,32007318,1001,100,,Cash sale,,,,,,07/08/2018,07/08/2018,0.00,,27.12,,-7.80
,CS,AR,32007815,1001,100,,Cash sale,,,,,,08/08/2018,08/08/2018,0.00,,13.56,,-21.36
,CS,AR,32007816,1001,100,,Cash sale,,,,,,09/08/2018,09/08/2018,0.00,,13.56,,-34.92
,CS,AR,32007817,1001,100,,Cash sale,,,,,,09/08/2018,09/08/2018,0.00,,13.56,,-48.48
,CS,AR,32007818,1001,100,,Cash sale,,,,,,09/08/2018,09/08/2018,0.00,,13.56,,-62.04
,CS,AR,32007819,1001,100,,Cash sale,,,,,,10/08/2018,10/08/2018,0.00,,13.56,,-75.60
,CS,AR,32007820,1001,100,,Cash sale,,,,,,10/08/2018,10/08/2018,0.00,,27.12,,-102.72
,CS,AR,32007822,1001,100,,Cash sale,,,,,,11/08/2018,11/08/2018,0.00,,13.56,,-116.28
,CS,AR,32007823,1001,100,,Cash sale,,,,,,13/08/2018,13/08/2018,0.00,,13.56,,-129.84
,CS,AR,32007824,1001,100,,Cash sale,,,,,,13/08/2018,13/08/2018,0.00,,13.56,,-143.40
,CS,AR,32007825,1001,100,,Cash sale,,,,,,14/08/2018,14/08/2018,0.00,,13.56,,-156.96
,CS,AR,32007826,1001,100,,Cash sale,,,,,,14/08/2018,14/08/2018,0.00,,27.12,,-184.08
,CS,AR,32007827,1001,100,,Cash sale,,,,,,16/08/2018,16/08/2018,0.00,,27.12,,-211.20
,CS,AR,32007828,1001,100,,Cash sale,,,,,,16/08/2018,16/08/2018,0.00,,13.56,,-224.76
,CS,AR,32007829,1001,100,,Cash sale,,,,,,17/08/2018,17/08/2018,0.00,,13.56,,-238.32
,CS,AR,32007830,1001,100,,Cash sale,,,,,,17/08/2018,17/08/2018,0.00,,13.56,,-251.88
,CS,AR,32007831,1001,100,,Cash sale,,,,,,17/08/2018,17/08/2018,0.00,,13.56,,-265.44
,CS,AR,32007832,1001,100,,Cash sale,,,,,,17/08/2018,17/08/2018,0.00,,13.56,,-279.00
,CS,AR,32007833,1001,100,,Cash sale,,,,,,17/08/2018,17/08/2018,0.00,,13.56,,-292.56
,CS,AR,32007834,1001,100,,Cash sale,,,,,,18/08/2018,18/08/2018,0.00,,27.12,,-319.68
,CS,AR,32007835,1001,100,,Cash sale,,,,,,20/08/2018,20/08/2018,0.00,,27.12,,-346.80
,CS,AR,32007836,1001,100,,Cash sale,,,,,,21/08/2018,21/08/2018,0.00,,13.56,,-360.36
,CS,AR,32008780,1001,100,,Cash sale,,,,,,22/08/2018,22/08/2018,0.00,,13.56,,-373.92
,CS,AR,32008781,1001,100,,Cash sale,,,,,,22/08/2018,22/08/2018,0.00,,13.56,,-387.48
,CS,AR,32008782,1001,100,,Cash sale,,,,,,22/08/2018,22/08/2018,0.00,,13.56,,-401.04
,CS,AR,32008783,1001,100,,Cash sale,,,,,,23/08/2018,23/08/2018,0.00,,13.56,,-414.60
,CS,AR,32008784,1001,100,,Cash sale,,,,,,23/08/2018,23/08/2018,0.00,,13.56,,-428.16
,CS,AR,32008785,1001,100,,Cash sale,,,,,,23/08/2018,23/08/2018,0.00,,13.56,,-441.72
,CS,AR,32008786,1001,100,,Cash sale,,,,,,24/08/2018,24/08/2018,0.00,,13.56,,-455.28
,CS,AR,32008788,1001,100,,Cash sale,,,,,,24/08/2018,24/08/2018,0.00,,13.56,,-468.84
,IN,AP,40002536,9000,900,,35x12kgs,,,,,SB,27/08/2018,27/08/2018,400.26,,0.00,,-68.58
,CS,AR,32008789,1001,100,,Cash sale,,,,,,27/08/2018,27/08/2018,0.00,,13.56,,-82.14
,CS,AR,32008790,1001,100,,Cash sale,,,,,,27/08/2018,27/08/2018,0.00,,13.56,,-95.70
,CS,AR,32008791,1001,100,,Cash sale,,,,,,28/08/2018,28/08/2018,0.00,,13.56,,-109.26
,CS,AR,32008792,1001,100,,Cash sale,,,,,,28/08/2018,28/08/2018,0.00,,13.56,,-122.82
,CS,AR,32008793,1001,100,,Cash sale,,,,,,28/08/2018,28/08/2018,0.00,,13.56,,-136.38
,CS,AR,32008794,1001,100,,Cash sale,,,,,,28/08/2018,28/08/2018,0.00,,13.56,,-149.94
,CS,AR,32008795,1001,100,,Cash sale,,,,,,29/08/2018,29/08/2018,0.00,,13.56,,-163.50
,CS,AR,32008796,1001,100,,Cash sale,,,,,,29/08/2018,29/08/2018,0.00,,13.56,,-177.06
,CS,AR,32008797,1001,100,,Cash sale,,,,,,30/08/2018,30/08/2018,0.00,,27.12,,-204.18
,CS,AR,32008798,1001,100,,Cash sale,,,,,,30/08/2018,30/08/2018,0.00,,13.56,,-217.74
,CS,AR,32008799,1001,100,,Cash sale,,,,,,30/08/2018,30/08/2018,0.00,,13.56,,-231.30
,CS,AR,32008800,1001,100,,Cash sale,,,,,,30/08/2018,30/08/2018,0.00,,13.56,,-244.86
,CS,AR,32008801,1001,100,,Cash sale,,,,,,31/08/2018,31/08/2018,0.00,,27.12,,-271.98
,CS,AR,32008802,1001,100,,Cash sale,,,,,,31/08/2018,31/08/2018,0.00,,13.56,,-285.54
,CS,AR,32008803,1001,100,,Cash sale,,,,,,31/08/2018,31/08/2018,0.00,,27.12,,-312.66
,CS,AR,32008805,1001,100,,Cash sale,,,,,,03/09/2018,03/09/2018,0.00,,13.56,,-326.22
,CS,AR,32008806,1001,100,,Cash sale,,,,,,03/09/2018,03/09/2018,0.00,,13.56,,-339.78
,CS,AR,32008807,1001,100,,Cash sale,,,,,,03/09/2018,03/09/2018,0.00,,13.56,,-353.34
,CR,AR,33000265,1001,100,,Cash Return,,,,,,04/09/2018,04/09/2018,13.56,,0.00,,-339.78
,CS,AR,32008808,1001,100,,Cash sale,,,,,,04/09/2018,04/09/2018,0.00,,13.56,,-353.34
,CS,AR,32008809,1001,100,,Cash sale,,,,,,04/09/2018,04/09/2018,0.00,,13.56,,-366.90
,CS,AR,32008810,1001,100,,Cash sale,,,,,,04/09/2018,04/09/2018,0.00,,13.56,,-380.46
,CS,AR,32008812,1001,100,,Cash sale,,,,,,04/09/2018,04/09/2018,0.00,,27.12,,-407.58
,CS,AR,32008813,1001,100,,Cash sale,,,,,,05/09/2018,05/09/2018,0.00,,27.12,,-434.70
,IN,AR,30325988,1001,100,,Invoice,,,,,,06/09/2018,06/09/2018,0.00,,13.56,,-448.26
,CS,AR,32008814,1001,100,,Cash sale,,,,,,07/09/2018,07/09/2018,0.00,,13.56,,-461.82
,CS,AR,32008815,1001,100,,Cash sale,,,,,,07/09/2018,07/09/2018,0.00,,13.56,,-475.38
,CS,AR,32008816,1001,100,,Cash sale,,,,,,07/09/2018,07/09/2018,0.00,,13.56,,-488.94
,CS,AR,32008817,1001,100,,Cash sale,,,,,,10/09/2018,10/09/2018,0.00,,13.56,,-502.50
,IN,AP,40002595,9000,900,,35 X12KGS,,,,,SB,11/09/2018,11/09/2018,400.26,,0.00,,-102.24
,CS,AR,32008818,1001,100,,Cash sale,,,,,,11/09/2018,11/09/2018,0.00,,13.56,,-115.80
,CS,AR,32008819,1001,100,,Cash sale,,,,,,11/09/2018,11/09/2018,0.00,,13.56,,-129.36
,CS,AR,32008820,1001,100,,Cash sale,,,,,,12/09/2018,12/09/2018,0.00,,13.56,,-142.92
,CS,AR,32008821,1001,100,,Cash sale,,,,,,12/09/2018,12/09/2018,0.00,,13.56,,-156.48
,IN,AR,30325989,1001,100,,Invoice,,,,,,13/09/2018,13/09/2018,0.00,,27.12,,-183.60
,CS,AR,32008822,1001,100,,Cash sale,,,,,,14/09/2018,14/09/2018,0.00,,27.12,,-210.72
,CS,AR,32008824,1001,100,,Cash sale,,,,,,15/09/2018,15/09/2018,0.00,,13.56,,-224.28
,CS,AR,32008825,1001,100,,Cash sale,,,,,,15/09/2018,15/09/2018,0.00,,13.56,,-237.84
,CS,AR,32009381,1001,100,,Cash sale,,,,,,17/09/2018,17/09/2018,0.00,,27.12,,-264.96
,CS,AR,32009382,1001,100,,Cash sale,,,,,,17/09/2018,17/09/2018,0.00,,13.56,,-278.52
,CS,AR,32009383,1001,100,,Cash sale,,,,,,17/09/2018,17/09/2018,0.00,,13.56,,-292.08
,CS,AR,32009384,1001,100,,Cash sale,,,,,,18/09/2018,18/09/2018,0.00,,13.56,,-305.64
,CS,AR,32009385,1001,100,,Cash sale,,,,,,19/09/2018,19/09/2018,0.00,,13.56,,-319.20
,CS,AR,32009386,1001,100,,Cash sale,,,,,,19/09/2018,19/09/2018,0.00,,27.12,,-346.32
,CS,AR,32009387,1001,100,,Cash sale,,,,,,19/09/2018,19/09/2018,0.00,,27.12,,-373.44
,CS,AR,32009388,1001,100,,Cash sale,,,,,,19/09/2018,19/09/2018,0.00,,13.56,,-387.00
,CS,AR,32009389,1001,100,,Cash sale,,,,,,20/09/2018,20/09/2018,0.00,,27.12,,-414.12
,CS,AR,32009390,1001,100,,Cash sale,,,,,,20/09/2018,20/09/2018,0.00,,13.56,,-427.68
,IN,AP,40002642,9000,900,,12KGS X35,,,,,SB,25/09/2018,25/09/2018,400.26,,0.00,,-27.42
,CS,AR,32009392,1001,100,,Cash sale,,,,,,25/09/2018,25/09/2018,0.00,,27.12,,-54.54
,CS,AR,32009393,1001,100,,Cash sale,,,,,,25/09/2018,25/09/2018,0.00,,27.12,,-81.66
,CS,AR,32009394,1001,100,,Cash sale,,,,,,26/09/2018,26/09/2018,0.00,,13.56,,-95.22
,CS,AR,32009395,1001,100,,Cash sale,,,,,,26/09/2018,26/09/2018,0.00,,40.68,,-135.90
,CS,AR,32009396,1001,100,,Cash sale,,,,,,26/09/2018,26/09/2018,0.00,,13.56,,-149.46
,CS,AR,32009397,1001,100,,Cash sale,,,,,,28/09/2018,28/09/2018,0.00,,27.12,,-176.58
,CS,AR,32009399,1001,100,,Cash sale,,,,,,28/09/2018,28/09/2018,0.00,,13.56,,-190.14
,CS,AR,32009401,1001,100,,Cash sale,,,,,,29/09/2018,29/09/2018,0.00,,13.56,,-203.70
,CS,AR,32009402,1001,100,,Cash sale,,,,,,29/09/2018,29/09/2018,0.00,,13.56,,-217.26
,CS,AR,32009403,1001,100,,Cash sale,,,,,,29/09/2018,29/09/2018,0.00,,13.56,,-230.82
,CS,AR,32009404,1001,100,,Cash sale,,,,,,29/09/2018,29/09/2018,0.00,,13.56,,-244.38
,CS,AR,32009405,1001,100,,Cash sale,,,,,,30/09/2018,30/09/2018,0.00,,244.07,,-488.45
,CS,AR,32009679,1001,100,,Cash sale,,,,,,01/10/2018,01/10/2018,0.00,,27.12,,-515.57
,CS,AR,32009680,1001,100,,Cash sale,,,,,,01/10/2018,01/10/2018,0.00,,13.56,,-529.13
,CS,AR,32009681,1001,100,,Cash sale,,,,,,01/10/2018,01/10/2018,0.00,,13.56,,-542.69
,CS,AR,32009682,1001,100,,Cash sale,,,,,,02/10/2018,02/10/2018,0.00,,13.56,,-556.25
,CS,AR,32009683,1001,100,,Cash sale,,,,,,02/10/2018,02/10/2018,0.00,,54.24,,-610.49
,CS,AR,32009684,1001,100,,Cash sale,,,,,,03/10/2018,03/10/2018,0.00,,13.56,,-624.05
,CS,AR,32009666,1001,100,,Cash sale,,,,,,04/10/2018,04/10/2018,0.00,,13.56,,-637.61
,CS,AR,32009685,1001,100,,Cash sale,,,,,,04/10/2018,04/10/2018,0.00,,13.56,,-651.17
,CS,AR,32010506,1001,100,,Cash sale,,,,,,08/10/2018,08/10/2018,0.00,,13.56,,-664.73
,CS,AR,32010507,1001,100,,Cash sale,,,,,,08/10/2018,08/10/2018,0.00,,13.56,,-678.29
,CS,AR,32010508,1001,100,,Cash sale,,,,,,08/10/2018,08/10/2018,0.00,,13.56,,-691.85
,CS,AR,32010509,1001,100,,Cash sale,,,,,,09/10/2018,09/10/2018,0.00,,13.56,,-705.41
,CS,AR,32010510,1001,100,,Cash sale,,,,,,09/10/2018,09/10/2018,0.00,,13.56,,-718.97
,CS,AR,32010511,1001,100,,Cash sale,,,,,,10/10/2018,10/10/2018,0.00,,27.12,,-746.09
,CS,AR,32010512,1001,100,,Cash sale,,,,,,12/10/2018,12/10/2018,0.00,,13.56,,-759.65
,CS,AR,32010513,1001,100,,Cash sale,,,,,,12/10/2018,12/10/2018,0.00,,13.56,,-773.21
,CS,AR,32010514,1001,100,,Cash sale,,,,,,12/10/2018,12/10/2018,0.00,,13.56,,-786.77
,CS,AR,32010515,1001,100,,Cash sale,,,,,,15/10/2018,15/10/2018,0.00,,13.56,,-800.33
,CS,AR,32010516,1001,100,,Cash sale,,,,,,15/10/2018,15/10/2018,0.00,,13.56,,-813.89
,CS,AR,32010517,1001,100,,Cash sale,,,,,,15/10/2018,15/10/2018,0.00,,40.68,,-854.57
,CS,AR,32010518,1001,100,,Cash sale,,,,,,16/10/2018,16/10/2018,0.00,,13.56,,-868.13
,CS,AR,32010519,1001,100,,Cash sale,,,,,,16/10/2018,16/10/2018,0.00,,13.56,,-881.69
,CS,AR,32010520,1001,100,,Cash sale,,,,,,17/10/2018,17/10/2018,0.00,,27.12,,-908.81
,CS,AR,32010521,1001,100,,Cash sale,,,,,,17/10/2018,17/10/2018,0.00,,13.56,,-922.37
,CS,AR,32010522,1001,100,,Cash sale,,,,,,18/10/2018,18/10/2018,0.00,,13.56,,-935.93
,CS,AR,32010523,1001,100,,Cash sale,,,,,,18/10/2018,18/10/2018,0.00,,40.68,,-976.61
,CS,AR,32010524,1001,100,,Cash sale,,,,,,19/10/2018,19/10/2018,0.00,,13.56,,-990.17
,CS,AR,32010526,1001,100,,Cash sale,,,,,,22/10/2018,22/10/2018,0.00,,13.56,,"-1,003.73"
,CS,AR,32010527,1001,100,,Cash sale,,,,,,23/10/2018,23/10/2018,0.00,,13.56,,"-1,017.29"
,CS,AR,32010528,1001,100,,Cash sale,,,,,,23/10/2018,23/10/2018,0.00,,13.56,,"-1,030.85"
,CS,AR,32010529,1001,100,,Cash sale,,,,,,23/10/2018,23/10/2018,0.00,,13.56,,"-1,044.41"
,CS,AR,32010422,1001,100,,Cash sale,,,,,,24/10/2018,24/10/2018,0.00,,13.56,,"-1,057.97"
,CS,AR,32010530,1001,100,,Cash sale,,,,,,24/10/2018,24/10/2018,0.00,,13.56,,"-1,071.53"
,CS,AR,32010531,1001,100,,Cash sale,,,,,,24/10/2018,24/10/2018,0.00,,27.12,,"-1,098.65"
,CS,AR,32010532,1001,100,,Cash sale,,,,,,25/10/2018,25/10/2018,0.00,,13.56,,"-1,112.21"
,CS,AR,32010533,1001,100,,Cash sale,,,,,,25/10/2018,25/10/2018,0.00,,40.68,,"-1,152.89"
,CS,AR,32010534,1001,100,,Cash sale,,,,,,25/10/2018,25/10/2018,0.00,,13.56,,"-1,166.45"
,CS,AR,32010535,1001,100,,Cash sale,,,,,,26/10/2018,26/10/2018,0.00,,13.56,,"-1,180.01"
,CS,AR,32010536,1001,100,,Cash sale,,,,,,27/10/2018,27/10/2018,0.00,,13.56,,"-1,193.57"
,CS,AR,32010538,1001,100,,Cash sale,,,,,,29/10/2018,29/10/2018,0.00,,13.56,,"-1,207.13"
,CS,AR,32010539,1001,100,,Cash sale,,,,,,30/10/2018,30/10/2018,0.00,,13.56,,"-1,220.69"
,CS,AR,32010540,1001,100,,Cash sale,,,,,,30/10/2018,30/10/2018,0.00,,13.56,,"-1,234.25"
,CS,AR,32010541,1001,100,,Cash sale,,,,,,30/10/2018,30/10/2018,0.00,,27.12,,"-1,261.37"
,CS,AR,32010542,1001,100,,Cash sale,,,,,,31/10/2018,31/10/2018,0.00,,13.56,,"-1,274.93"
,CS,AR,32010543,1001,100,,Cash sale,,,,,,31/10/2018,31/10/2018,0.00,,27.12,,"-1,302.05"
,CS,AR,32010544,1001,100,,Cash sale,,,,,,31/10/2018,31/10/2018,0.00,,13.56,,"-1,315.61"
,CS,AR,32010972,1001,100,,Cash sale,,,,,,01/11/2018,01/11/2018,0.00,,27.12,,"-1,342.73"
,CS,AR,32010973,1001,100,,Cash sale,,,,,,02/11/2018,02/11/2018,0.00,,28.14,,"-1,370.87"
,CS,AR,32010974,1001,100,,Cash sale,,,,,,02/11/2018,02/11/2018,0.00,,14.07,,"-1,384.94"
,CR,AR,33000307,1001,100,,Cash Return,,,,,,05/11/2018,05/11/2018,14.07,,0.00,,"-1,370.87"
,CS,AR,32010975,1001,100,,Cash sale,,,,,,05/11/2018,05/11/2018,0.00,,14.07,,"-1,384.94"
,CS,AR,32010976,1001,100,,Cash sale,,,,,,05/11/2018,05/11/2018,0.00,,14.07,,"-1,399.01"
,CS,AR,32010977,1001,100,,Cash sale,,,,,,05/11/2018,05/11/2018,0.00,,56.27,,"-1,455.28"
,CS,AR,32010978,1001,100,,Cash sale,,,,,,05/11/2018,05/11/2018,0.00,,14.07,,"-1,469.35"
,CS,AR,32010979,1001,100,,Cash sale,,,,,,06/11/2018,06/11/2018,0.00,,28.14,,"-1,497.49"
,CS,AR,32010981,1001,100,,Cash sale,,,,,,09/11/2018,09/11/2018,0.00,,28.14,,"-1,525.63"
,CS,AR,32010982,1001,100,,Cash sale,,,,,,10/11/2018,10/11/2018,0.00,,14.07,,"-1,539.70"
,CS,AR,32010983,1001,100,,Cash sale,,,,,,10/11/2018,10/11/2018,0.00,,14.07,,"-1,553.77"
,CS,AR,32010984,1001,100,,Cash sale,,,,,,12/11/2018,12/11/2018,0.00,,14.07,,"-1,567.84"
,CS,AR,32010985,1001,100,,Cash sale,,,,,,12/11/2018,12/11/2018,0.00,,28.14,,"-1,595.98"
,CS,AR,32010986,1001,100,,Cash sale,,,,,,12/11/2018,12/11/2018,0.00,,14.07,,"-1,610.05"
,CS,AR,32011590,1001,100,,Cash sale,,,,,,13/11/2018,13/11/2018,0.00,,14.07,,"-1,624.12"
,CS,AR,32011591,1001,100,,Cash sale,,,,,,13/11/2018,13/11/2018,0.00,,28.14,,"-1,652.26"
,CS,AR,32011592,1001,100,,Cash sale,,,,,,14/11/2018,14/11/2018,0.00,,14.07,,"-1,666.33"
,CS,AR,32011593,1001,100,,Cash sale,,,,,,14/11/2018,14/11/2018,0.00,,14.07,,"-1,680.40"
,CS,AR,32011594,1001,100,,Cash sale,,,,,,14/11/2018,14/11/2018,0.00,,14.07,,"-1,694.47"
,CS,AR,32011595,1001,100,,Cash sale,,,,,,14/11/2018,14/11/2018,0.00,,14.07,,"-1,708.54"
,CS,AR,32011596,1001,100,,Cash sale,,,,,,16/11/2018,16/11/2018,0.00,,28.14,,"-1,736.68"
,CS,AR,32011597,1001,100,,Cash sale,,,,,,16/11/2018,16/11/2018,0.00,,14.07,,"-1,750.75"
,CS,AR,32011598,1001,100,,Cash sale,,,,,,19/11/2018,19/11/2018,0.00,,14.07,,"-1,764.82"
,CS,AR,32011599,1001,100,,Cash sale,,,,,,19/11/2018,19/11/2018,0.00,,42.20,,"-1,807.02"
,CS,AR,32011600,1001,100,,Cash sale,,,,,,19/11/2018,19/11/2018,0.00,,28.14,,"-1,835.16"
,CS,AR,32011601,1001,100,,Cash sale,,,,,,20/11/2018,20/11/2018,0.00,,14.07,,"-1,849.23"
,CS,AR,32011602,1001,100,,Cash sale,,,,,,21/11/2018,21/11/2018,0.00,,28.14,,"-1,877.37"
,CS,AR,32011603,1001,100,,Cash sale,,,,,,21/11/2018,21/11/2018,0.00,,14.07,,"-1,891.44"
,CS,AR,32011604,1001,100,,Cash sale,,,,,,22/11/2018,22/11/2018,0.00,,42.20,,"-1,933.64"
,IN,AR,30333093,1001,100,,Invoice,,,,,,22/11/2018,22/11/2018,0.00,,14.07,,"-1,947.71"
,CS,AR,32011605,1001,100,,Cash sale,,,,,,23/11/2018,23/11/2018,0.00,,14.07,,"-1,961.78"
,CS,AR,32011606,1001,100,,Cash sale,,,,,,26/11/2018,26/11/2018,0.00,,14.07,,"-1,975.85"
,CS,AR,32011607,1001,100,,Cash sale,,,,,,26/11/2018,26/11/2018,0.00,,14.07,,"-1,989.92"
,CS,AR,32011608,1001,100,,Cash sale,,,,,,27/11/2018,27/11/2018,0.00,,14.07,,"-2,003.99"
,CS,AR,32011609,1001,100,,Cash sale,,,,,,27/11/2018,27/11/2018,0.00,,14.07,,"-2,018.06"
,CS,AR,32011610,1001,100,,Cash sale,,,,,,27/11/2018,27/11/2018,0.00,,14.07,,"-2,032.13"
,CS,AR,32011611,1001,100,,Cash sale,,,,,,28/11/2018,28/11/2018,0.00,,14.07,,"-2,046.20"
,CS,AR,32011612,1001,100,,Cash sale,,,,,,28/11/2018,28/11/2018,0.00,,14.07,,"-2,060.27"
,CS,AR,32011614,1001,100,,Cash sale,,,,,,28/11/2018,28/11/2018,0.00,,14.07,,"-2,074.34"
,CS,AR,32011615,1001,100,,Cash sale,,,,,,28/11/2018,28/11/2018,0.00,,14.07,,"-2,088.41"
,CS,AR,32011616,1001,100,,Cash sale,,,,,,29/11/2018,29/11/2018,0.00,,42.20,,"-2,130.61"
,IN,AR,30333094,1001,100,,Invoice,,,,,,29/11/2018,29/11/2018,0.00,,14.07,,"-2,144.68"
,IN,AR,30333095,1001,100,,Invoice,,,,,,29/11/2018,29/11/2018,0.00,,14.07,,"-2,158.75"
,CS,AR,32011617,1001,100,,Cash sale,,,,,,30/11/2018,30/11/2018,0.00,,14.07,,"-2,172.82"
,CS,AR,32011618,1001,100,,Cash sale,,,,,,30/11/2018,30/11/2018,0.00,,14.07,,"-2,186.89"
,CS,AR,32011619,1001,100,,Cash sale,,,,,,30/11/2018,30/11/2018,0.00,,14.07,,"-2,200.96"
,CS,AR,32011620,1001,100,,Cash sale,,,,,,30/11/2018,30/11/2018,0.00,,14.07,,"-2,215.03"
,CS,AR,32012383,1001,100,,Cash sale,,,,,,03/12/2018,03/12/2018,0.00,,14.07,,"-2,229.10"
,CS,AR,32012384,1001,100,,Cash sale,,,,,,03/12/2018,03/12/2018,0.00,,28.14,,"-2,257.24"
,IN,AR,30335180,1001,100,,Invoice,,,,,,03/12/2018,03/12/2018,0.00,,14.07,,"-2,271.31"
,CS,AR,32012385,1001,100,,Cash sale,,,,,,04/12/2018,04/12/2018,0.00,,14.07,,"-2,285.38"
,CS,AR,32012387,1001,100,,Cash sale,,,,,,05/12/2018,05/12/2018,0.00,,14.07,,"-2,299.45"
,CS,AR,32012388,1001,100,,Cash sale,,,,,,05/12/2018,05/12/2018,0.00,,14.07,,"-2,313.52"
,CS,AR,32012389,1001,100,,Cash sale,,,,,,05/12/2018,05/12/2018,0.00,,14.07,,"-2,327.59"
,CS,AR,32012390,1001,100,,Cash sale,,,,,,05/12/2018,05/12/2018,0.00,,14.07,,"-2,341.66"
,CS,AR,32012391,1001,100,,Cash sale,,,,,,06/12/2018,06/12/2018,0.00,,42.20,,"-2,383.86"
,CS,AR,32012392,1001,100,,Cash sale,,,,,,06/12/2018,06/12/2018,0.00,,14.07,,"-2,397.93"
,CS,AR,32012393,1001,100,,Cash sale,,,,,,06/12/2018,06/12/2018,0.00,,14.07,,"-2,412.00"
,CS,AR,32012394,1001,100,,Cash sale,,,,,,06/12/2018,06/12/2018,0.00,,42.20,,"-2,454.20"
,CS,AR,32012395,1001,100,,Cash sale,,,,,,06/12/2018,06/12/2018,0.00,,14.07,,"-2,468.27"
,CS,AR,32012396,1001,100,,Cash sale,,,,,,07/12/2018,07/12/2018,0.00,,28.14,,"-2,496.41"
,CS,AR,32012397,1001,100,,Cash sale,,,,,,07/12/2018,07/12/2018,0.00,,14.07,,"-2,510.48"
,CS,AR,32012398,1001,100,,Cash sale,,,,,,07/12/2018,07/12/2018,0.00,,14.07,,"-2,524.55"
,CS,AR,32012399,1001,100,,Cash sale,,,,,,07/12/2018,07/12/2018,0.00,,14.07,,"-2,538.62"
,CS,AR,32012400,1001,100,,Cash sale,,,,,,07/12/2018,07/12/2018,0.00,,14.07,,"-2,552.69"
,CS,AR,32012401,1001,100,,Cash sale,,,,,,07/12/2018,07/12/2018,0.00,,14.07,,"-2,566.76"
,CS,AR,32012402,1001,100,,Cash sale,,,,,,07/12/2018,07/12/2018,0.00,,28.14,,"-2,594.90"
,CS,AR,32012403,1001,100,,Cash sale,,,,,,10/12/2018,10/12/2018,0.00,,28.14,,"-2,623.04"
,CS,AR,32012404,1001,100,,Cash sale,,,,,,10/12/2018,10/12/2018,0.00,,28.14,,"-2,651.18"
,CS,AR,32012405,1001,100,,Cash sale,,,,,,10/12/2018,10/12/2018,0.00,,14.07,,"-2,665.25"
,CS,AR,32012406,1001,100,,Cash sale,,,,,,10/12/2018,10/12/2018,0.00,,14.07,,"-2,679.32"
,IN,AR,30335181,1001,100,,Invoice,,,,,,10/12/2018,10/12/2018,0.00,,14.07,,"-2,693.39"
,CS,AR,32012407,1001,100,,Cash sale,,,,,,11/12/2018,11/12/2018,0.00,,28.14,,"-2,721.53"
,CS,AR,32012408,1001,100,,Cash sale,,,,,,11/12/2018,11/12/2018,0.00,,14.07,,"-2,735.60"
,CS,AR,32012409,1001,100,,Cash sale,,,,,,12/12/2018,12/12/2018,0.00,,42.20,,"-2,777.80"
,CS,AR,32012411,1001,100,,Cash sale,,,,,,14/12/2018,14/12/2018,0.00,,14.07,,"-2,791.87"
,CS,AR,32012412,1001,100,,Cash sale,,,,,,14/12/2018,14/12/2018,0.00,,14.07,,"-2,805.94"
,CS,AR,32012413,1001,100,,Cash sale,,,,,,14/12/2018,14/12/2018,0.00,,14.07,,"-2,820.01"
,CS,AR,32012414,1001,100,,Cash sale,,,,,,14/12/2018,14/12/2018,0.00,,14.07,,"-2,834.08"
,CS,AR,32012415,1001,100,,Cash sale,,,,,,14/12/2018,14/12/2018,0.00,,14.07,,"-2,848.15"
,CS,AR,32012416,1001,100,,Cash sale,,,,,,14/12/2018,14/12/2018,0.00,,28.14,,"-2,876.29"
,CS,AR,32012417,1001,100,,Cash sale,,,,,,14/12/2018,14/12/2018,0.00,,14.07,,"-2,890.36"
,CS,AR,32012418,1001,100,,Cash sale,,,,,,17/12/2018,17/12/2018,0.00,,14.07,,"-2,904.43"
,CS,AR,32012419,1001,100,,Cash sale,,,,,,17/12/2018,17/12/2018,0.00,,28.14,,"-2,932.57"
,CS,AR,32012420,1001,100,,Cash sale,,,,,,17/12/2018,17/12/2018,0.00,,14.07,,"-2,946.64"
,CS,AR,32012421,1001,100,,Cash sale,,,,,,17/12/2018,17/12/2018,0.00,,14.07,,"-2,960.71"
,CS,AR,32012422,1001,100,,Cash sale,,,,,,17/12/2018,17/12/2018,0.00,,42.20,,"-3,002.91"
,CS,AR,32012423,1001,100,,Cash sale,,,,,,18/12/2018,18/12/2018,0.00,,28.14,,"-3,031.05"
,IN,AR,30335182,1001,100,,Invoice,,,,,,18/12/2018,18/12/2018,0.00,,14.07,,"-3,045.12"
,CS,AR,32012424,1001,100,,Cash sale,,,,,,19/12/2018,19/12/2018,0.00,,28.14,,"-3,073.26"
,CS,AR,32012426,1001,100,,Cash sale,,,,,,19/12/2018,19/12/2018,0.00,,14.07,,"-3,087.33"
,CN,AR,31019764,1001,100,,Credit Note,,,,,,20/12/2018,20/12/2018,14.07,,0.00,,"-3,073.26"
,CS,AR,32012427,1001,100,,Cash sale,,,,,,20/12/2018,20/12/2018,0.00,,42.20,,"-3,115.46"
,CS,AR,32012428,1001,100,,Cash sale,,,,,,20/12/2018,20/12/2018,0.00,,14.07,,"-3,129.53"
,CS,AR,32012429,1001,100,,Cash sale,,,,,,20/12/2018,20/12/2018,0.00,,14.07,,"-3,143.60"
,CS,AR,32012430,1001,100,,Cash sale,,,,,,20/12/2018,20/12/2018,0.00,,14.07,,"-3,157.67"
,CS,AR,32012431,1001,100,,Cash sale,,,,,,20/12/2018,20/12/2018,0.00,,14.07,,"-3,171.74"
,CS,AR,32012432,1001,100,,Cash sale,,,,,,20/12/2018,20/12/2018,0.00,,14.07,,"-3,185.81"
,IN,AR,30335184,1001,100,,Invoice,,,,,,20/12/2018,20/12/2018,0.00,,14.07,,"-3,199.88"
,CS,AR,32012433,1001,100,,Cash sale,,,,,,21/12/2018,21/12/2018,0.00,,14.07,,"-3,213.95"
,CS,AR,32012434,1001,100,,Cash sale,,,,,,21/12/2018,21/12/2018,0.00,,14.07,,"-3,228.02"
,CS,AR,32012435,1001,100,,Cash sale,,,,,,21/12/2018,21/12/2018,0.00,,28.14,,"-3,256.16"
,CS,AR,32012436,1001,100,,Cash sale,,,,,,22/12/2018,22/12/2018,0.00,,14.07,,"-3,270.23"
,IN,AR,30335185,1001,100,,Invoice,,,,,,22/12/2018,22/12/2018,0.00,,14.07,,"-3,284.30"
,IN,AR,30335186,1001,100,,Invoice,,,,,,22/12/2018,22/12/2018,0.00,,28.14,,"-3,312.44"
,CS,AR,32012437,1001,100,,Cash sale,,,,,,24/12/2018,24/12/2018,0.00,,14.07,,"-3,326.51"
,CS,AR,32012438,1001,100,,Cash sale,,,,,,24/12/2018,24/12/2018,0.00,,14.07,,"-3,340.58"
,CS,AR,32012439,1001,100,,Cash sale,,,,,,24/12/2018,24/12/2018,0.00,,14.07,,"-3,354.65"
,CS,AR,32012440,1001,100,,Cash sale,,,,,,24/12/2018,24/12/2018,0.00,,14.07,,"-3,368.72"
,CS,AR,32012663,1001,100,,Cash sale,,,,,,26/12/2018,26/12/2018,0.00,,28.14,,"-3,396.86"
,CS,AR,32012664,1001,100,,Cash sale,,,,,,26/12/2018,26/12/2018,0.00,,28.14,,"-3,425.00"
,CS,AR,32012665,1001,100,,Cash sale,,,,,,27/12/2018,27/12/2018,0.00,,14.07,,"-3,439.07"
,CS,AR,32012666,1001,100,,Cash sale,,,,,,27/12/2018,27/12/2018,0.00,,14.07,,"-3,453.14"
,CS,AR,32012667,1001,100,,Cash sale,,,,,,27/12/2018,27/12/2018,0.00,,14.07,,"-3,467.21"
,CS,AR,32012668,1001,100,,Cash sale,,,,,,27/12/2018,27/12/2018,0.00,,14.07,,"-3,481.28"
,CS,AR,32012669,1001,100,,Cash sale,,,,,,28/12/2018,28/12/2018,0.00,,14.07,,"-3,495.35"
,CS,AR,32012670,1001,100,,Cash sale,,,,,,28/12/2018,28/12/2018,0.00,,14.07,,"-3,509.42"
,CS,AR,32012671,1001,100,,Cash sale,,,,,,28/12/2018,28/12/2018,0.00,,14.07,,"-3,523.49"
,CS,AR,32012672,1001,100,,Cash sale,,,,,,28/12/2018,28/12/2018,0.00,,14.07,,"-3,537.56"
,CS,AR,32012673,1001,100,,Cash sale,,,,,,28/12/2018,28/12/2018,0.00,,28.14,,"-3,565.70"
,CS,AR,32012674,1001,100,,Cash sale,,,,,,28/12/2018,28/12/2018,0.00,,14.07,,"-3,579.77"
,CS,AR,32012675,1001,100,,Cash sale,,,,,,28/12/2018,28/12/2018,0.00,,14.07,,"-3,593.84"
,CS,AR,32012676,1001,100,,Cash sale,,,,,,29/12/2018,29/12/2018,0.00,,14.07,,"-3,607.91"
,CS,AR,32012677,1001,100,,Cash sale,,,,,,29/12/2018,29/12/2018,0.00,,14.07,,"-3,621.98"
,CS,AR,32012678,1001,100,,Cash sale,,,,,,29/12/2018,29/12/2018,0.00,,14.07,,"-3,636.05"
,CS,AR,32012680,1001,100,,Cash sale,,,,,,31/12/2018,31/12/2018,0.00,,42.20,,"-3,678.25"
,,,,,,,,,,,,,,,,,,,
,Account: 1000503 - Sales - Gas Cylinders 15kg,,,,,,,,,,,,,,,,,,
,Pr.,Mod.,Reference,Dept,Div,Suffix,Details,,,Cheque,,User,Doc Date,Post Date,Debit,,Credit,,Balance
,IN,AP,40002290,9000,900,,5 X 15kgs,,,,,SB,15/02/2018,15/02/2018,71.10,,0.00,,71.10
,IN,AP,40002256,9000,900,,5 X 15kgs,,,,,SB,16/05/2018,16/05/2018,60.26,,0.00,,131.36
,CS,AR,32004630,1001,100,,Cash sale,,,,,,29/05/2018,29/05/2018,0.00,,84.75,,46.61
,IN,AP,40002253,9000,900,,35 X 12kgs 5 X 15kgs,,,,,SB,30/05/2018,30/05/2018,71.10,,0.00,,117.71
,CS,AR,32004636,1001,100,,Cash sale,,,,,,30/05/2018,30/05/2018,0.00,,16.95,,100.76
,CS,AR,32004875,1001,100,,Cash sale,,,,,,01/06/2018,01/06/2018,0.00,,16.95,,83.81
,CS,AR,32004877,1001,100,,Cash sale,,,,,,04/06/2018,04/06/2018,0.00,,33.90,,49.91
,CS,AR,32004881,1001,100,,Cash sale,,,,,,05/06/2018,05/06/2018,0.00,,16.95,,32.96
,IN,AP,40002289,9000,900,,3 X 15 Kgs,,,,,SB,06/06/2018,06/06/2018,42.66,,0.00,,75.62
,CS,AR,32005241,1001,100,,Cash sale,,,,,,11/06/2018,11/06/2018,0.00,,16.95,,58.67
,CS,AR,32005724,1001,100,,Cash sale,,,,,,21/06/2018,21/06/2018,0.00,,16.95,,41.72
,CS,AR,32005731,1001,100,,Cash sale,,,,,,27/06/2018,27/06/2018,0.00,,16.95,,24.77
,CS,AR,32005733,1001,100,,Cash sale,,,,,,28/06/2018,28/06/2018,0.00,,16.95,,7.82
,CS,AR,32005735,1001,100,,Cash sale,,,,,,30/06/2018,30/06/2018,0.00,,33.90,,-26.08
,CS,AR,32006014,1001,100,,Cash sale,,,,,,02/07/2018,02/07/2018,0.00,,16.95,,-43.03
,IN,AP,40002334,9000,900,,5x15kgs,,,,,SB,02/07/2018,02/07/2018,71.10,,0.00,,28.07
,IN,AR,30320283,1001,100,,Invoice,,,,,,10/07/2018,10/07/2018,0.00,,33.90,,-5.83
,CS,AR,32006521,1001,100,,Cash sale,,,,,,12/07/2018,12/07/2018,0.00,,16.95,,-22.78
,IN,AR,30321364,1001,100,,Invoice,,,,,,21/07/2018,21/07/2018,0.00,,16.95,,-39.73
,CS,AR,32007317,1001,100,,Cash sale,,,,,,07/08/2018,07/08/2018,0.00,,16.95,,-56.68
,CS,AR,32007823,1001,100,,Cash sale,,,,,,13/08/2018,13/08/2018,0.00,,16.95,,-73.63
,IN,AP,40002647,9000,900,,15kgs X 5,,,,,SB,18/09/2018,18/09/2018,71.10,,0.00,,-2.53
,CS,AR,32009391,1001,100,,Cash sale,,,,,,25/09/2018,25/09/2018,0.00,,16.95,,-19.48
,CS,AR,32009398,1001,100,,Cash sale,,,,,,28/09/2018,28/09/2018,0.00,,16.95,,-36.43
,CS,AR,32009400,1001,100,,Cash sale,,,,,,28/09/2018,28/09/2018,0.00,,16.95,,-53.38
,CS,AR,32010525,1001,100,,Cash sale,,,,,,19/10/2018,19/10/2018,0.00,,16.95,,-70.33
,CS,AR,32010537,1001,100,,Cash sale,,,,,,29/10/2018,29/10/2018,0.00,,16.95,,-87.28
,CS,AR,32010974,1001,100,,Cash sale,,,,,,02/11/2018,02/11/2018,0.00,,17.71,,-104.99
,IN,AR,30331690,1001,100,,Invoice,,,,,,06/11/2018,06/11/2018,0.00,,17.71,,-122.70
,CN,AR,31019489,1001,100,,Credit Note,,,,,,07/11/2018,07/11/2018,17.71,,0.00,,-104.99
,CS,AR,32010980,1001,100,,Cash sale,,,,,,07/11/2018,07/11/2018,0.00,,17.71,,-122.70
,CS,AR,32011613,1001,100,,Cash sale,,,,,,28/11/2018,28/11/2018,0.00,,17.71,,-140.41
,CS,AR,32012384,1001,100,,Cash sale,,,,,,03/12/2018,03/12/2018,0.00,,17.71,,-158.12
,CS,AR,32012386,1001,100,,Cash sale,,,,,,04/12/2018,04/12/2018,0.00,,35.42,,-193.54
,CS,AR,32012410,1001,100,,Cash sale,,,,,,12/12/2018,12/12/2018,0.00,,17.71,,-211.25
,IN,AR,30335183,1001,100,,Invoice,,,,,,18/12/2018,18/12/2018,0.00,,17.71,,-228.96
,CS,AR,32012424,1001,100,,Cash sale,,,,,,19/12/2018,19/12/2018,0.00,,17.71,,-246.67
,CS,AR,32012669,1001,100,,Cash sale,,,,,,28/12/2018,28/12/2018,0.00,,17.71,,-264.38
,CS,AR,32012679,1001,100,,Cash sale,,,,,,31/12/2018,31/12/2018,0.00,,35.42,,-299.80
,,,,,,,,,,,,,,,,,,,
,Account: 1000504 - Sales - Gas Cylinders 25kg,,,,,,,,,,,,,,,,,,
,Pr.,Mod.,Reference,Dept,Div,Suffix,Details,,,Cheque,,User,Doc Date,Post Date,Debit,,Credit,,Balance
,IN,AP,40002255,9000,900,,5 X25kgs,,,,,SB,02/05/2018,02/05/2018,117.70,,0.00,,117.70
,CS,AR,32004629,1001,100,,Cash sale,,,,,,29/05/2018,29/05/2018,0.00,,56.44,,61.26
,CS,AR,32004646,1001,100,,Cash sale,,,,,,31/05/2018,31/05/2018,0.00,,28.22,,33.04
,CS,AR,32004650,1001,100,,Cash sale,,,,,,31/05/2018,31/05/2018,0.00,,28.22,,4.82
,CS,AR,32004875,1001,100,,Cash sale,,,,,,01/06/2018,01/06/2018,0.00,,28.22,,-23.40
,IN,AP,40002289,9000,900,,3 X 25kgs,,,,,SB,06/06/2018,06/06/2018,70.62,,0.00,,47.22
,CS,AR,32005724,1001,100,,Cash sale,,,,,,21/06/2018,21/06/2018,0.00,,56.44,,-9.22
,IN,AP,40002334,9000,900,,5x25kgs,,,,,SB,02/07/2018,02/07/2018,117.70,,0.00,,108.48
,IN,AR,30320283,1001,100,,Invoice,,,,,,10/07/2018,10/07/2018,0.00,,28.22,,80.26
,CS,AR,32006535,1001,100,,Cash sale,,,,,,19/07/2018,19/07/2018,0.00,,28.22,,52.04
,CS,AR,32007821,1001,100,,Cash sale,,,,,,11/08/2018,11/08/2018,0.00,,56.44,,-4.40
,CS,AR,32008787,1001,100,,Cash sale,,,,,,24/08/2018,24/08/2018,0.00,,28.22,,-32.62
,CR,AR,33000265,1001,100,,Cash Return,,,,,,04/09/2018,04/09/2018,56.44,,0.00,,23.82
,CS,AR,32008810,1001,100,,Cash sale,,,,,,04/09/2018,04/09/2018,0.00,,56.44,,-32.62
,CS,AR,32008812,1001,100,,Cash sale,,,,,,04/09/2018,04/09/2018,0.00,,28.22,,-60.84
,CS,AR,32012425,1001,100,,Cash sale,,,,,,19/12/2018,19/12/2018,0.00,,29.58,,-90.42
,,,,,,,,,,,,,,,,,,,
,Account: 1000600 - Sales - Other - New Item - QUERY - GAS CYLINDER,,,,,,,,,,,,,,,,,,
,Pr.,Mod.,Reference,Dept,Div,Suffix,Details,,,Cheque,,User,Doc Date,Post Date,Debit,,Credit,,Balance
,IN,AR,30313109,1001,100,,Invoice,,,,,,18/04/2018,18/04/2018,0.00,,419.07,,-419.07
,,,,,,,,,,,,,,,,,,,
,CS,AR,32003962,1001,100,,Cash sale,,,,,,27/04/2018,27/04/2018,0.00,,30.00,,-449.07
,CR,AR,33000137,1001,100,,Cash Return,,,,,,30/04/2018,30/04/2018,30.00,,0.00,,-419.07
,CS,AR,32003968,1001,100,,Cash sale,,,,,,30/04/2018,30/04/2018,0.00,,15.00,,-434.07
,CS,AR,32003973,1001,100,,Cash sale,,,,,,02/05/2018,02/05/2018,0.00,,15.00,,-449.07
,IN,AR,30314532,1001,100,,Invoice,,,,,,06/05/2018,06/05/2018,0.00,,15.00,,-464.07
,CS,AR,32003987,1001,100,,Cash sale,,,,,,09/05/2018,09/05/2018,0.00,,15.00,,-479.07
,CS,AR,32003990,1001,100,,Cash sale,,,,,,11/05/2018,11/05/2018,0.00,,15.00,,-494.07
,CS,AR,32004380,1001,100,,Cash sale,,,,,,15/05/2018,15/05/2018,0.00,,15.00,,-509.07
,CS,AR,32004381,1001,100,,Cash sale,,,,,,15/05/2018,15/05/2018,0.00,,15.00,,-524.07
,CS,AR,32004387,1001,100,,Cash sale,,,,,,17/05/2018,17/05/2018,0.00,,15.00,,-539.07
,CR,AR,33000147,1001,100,,Cash Return,,,,,,21/05/2018,21/05/2018,30.00,,0.00,,-509.07
,CS,AR,32004397,1001,100,,Cash sale,,,,,,21/05/2018,21/05/2018,0.00,,15.00,,-524.07
,CR,AR,33000148,1001,100,,Cash Return,,,,,,22/05/2018,22/05/2018,30.00,,0.00,,-494.07
,CS,AR,32004409,1001,100,,Cash sale,,,,,,25/05/2018,25/05/2018,0.00,,30.00,,-524.07
,CS,AR,32004632,1001,100,,Cash sale,,,,,,29/05/2018,29/05/2018,0.00,,15.00,,-539.07
,CR,AR,33000153,1001,100,,Cash Return,,,,,,30/05/2018,30/05/2018,15.00,,0.00,,-524.07
,CS,AR,32004635,1001,100,,Cash sale,,,,,,30/05/2018,30/05/2018,0.00,,15.00,,-539.07
,CS,AR,32004648,1001,100,,Cash sale,,,,,,31/05/2018,31/05/2018,0.00,,15.00,,-554.07
,CS,AR,32004654,1001,100,,Cash sale,,,,,,31/05/2018,31/05/2018,0.00,,15.00,,-569.07
,CS,AR,32004878,1001,100,,Cash sale,,,,,,04/06/2018,04/06/2018,0.00,,15.00,,-584.07
,CR,AR,33000159,1001,100,,Cash Return,,,,,,05/06/2018,05/06/2018,30.00,,0.00,,-554.07
,CR,AR,33000160,1001,100,,Cash Return,,,,,,06/06/2018,06/06/2018,15.00,,0.00,,-539.07
,CR,AR,33000161,1001,100,,Cash Return,,,,,,06/06/2018,06/06/2018,60.00,,0.00,,-479.07
,CS,AR,32004885,1001,100,,Cash sale,,,,,,06/06/2018,06/06/2018,0.00,,15.00,,-494.07
,CS,AR,32005244,1001,100,,Cash sale,,,,,,12/06/2018,12/06/2018,0.00,,15.00,,-509.07
,CR,AR,33000172,1001,100,,Cash Return,,,,,,13/06/2018,13/06/2018,15.00,,0.00,,-494.07
,CS,AR,32005245,1001,100,,Cash sale,,,,,,13/06/2018,13/06/2018,0.00,,15.00,,-509.07
,CR,AR,33000173,1001,100,,Cash Return,,,,,,16/06/2018,16/06/2018,30.00,,0.00,,-479.07
,IN,AR,30318548,1001,100,,Invoice,,,,,,20/06/2018,20/06/2018,0.00,,"1,093.22",,"-1,572.29"
,CR,AR,33000192,1001,100,,Cash Return,,,,,,21/06/2018,21/06/2018,15.00,,0.00,,"-1,557.29"
,CS,AR,32005724,1001,100,,Cash sale,,,,,,21/06/2018,21/06/2018,0.00,,45.00,,"-1,602.29"
,CS,AR,32005730,1001,100,,Cash sale,,,,,,27/06/2018,27/06/2018,0.00,,15.00,,"-1,617.29"
,CS,AR,32006101,1001,100,,Cash sale,,,,,,09/07/2018,09/07/2018,0.00,,15.00,,"-1,632.29"
,CS,AR,32006527,1001,100,,Cash sale,,,,,,13/07/2018,13/07/2018,0.00,,15.00,,"-1,647.29"
,CS,AR,32006532,1001,100,,Cash sale,,,,,,17/07/2018,17/07/2018,0.00,,15.00,,"-1,662.29"
,CR,AR,33000211,1001,100,,Cash Return,,,,,,19/07/2018,19/07/2018,15.00,,0.00,,"-1,647.29"
,CS,AR,32006535,1001,100,,Cash sale,,,,,,19/07/2018,19/07/2018,0.00,,15.00,,"-1,662.29"
,CR,AR,33000220,1001,100,,Cash Return,,,,,,20/07/2018,20/07/2018,15.00,,0.00,,"-1,647.29"
,CS,AR,32007311,1001,100,,Cash sale,,,,,,01/08/2018,01/08/2018,0.00,,15.00,,"-1,662.29"
,CS,AR,32007312,1001,100,,Cash sale,,,,,,02/08/2018,02/08/2018,0.00,,30.00,,"-1,692.29"
,CS,AR,32007822,1001,100,,Cash sale,,,,,,11/08/2018,11/08/2018,0.00,,15.00,,"-1,707.29"
,CR,AR,33000235,1001,100,,Cash Return,,,,,,17/08/2018,17/08/2018,15.00,,0.00,,"-1,692.29"
,CS,AR,32007831,1001,100,,Cash sale,,,,,,17/08/2018,17/08/2018,0.00,,15.00,,"-1,707.29"
,CR,AR,33000262,1001,100,,Cash Return,,,,,,22/08/2018,22/08/2018,15.00,,0.00,,"-1,692.29"
,CS,AR,32008781,1001,100,,Cash sale,,,,,,22/08/2018,22/08/2018,0.00,,15.00,,"-1,707.29"
,CS,AR,32008785,1001,100,,Cash sale,,,,,,23/08/2018,23/08/2018,0.00,,15.00,,"-1,722.29"
,CR,AR,33000263,1001,100,,Cash Return,,,,,,24/08/2018,24/08/2018,15.00,,0.00,,"-1,707.29"
,CS,AR,32008786,1001,100,,Cash sale,,,,,,24/08/2018,24/08/2018,0.00,,15.00,,"-1,722.29"
,CS,AR,32008787,1001,100,,Cash sale,,,,,,24/08/2018,24/08/2018,0.00,,15.00,,"-1,737.29"
,CR,AR,33000264,1001,100,,Cash Return,,,,,,04/09/2018,04/09/2018,30.00,,0.00,,"-1,707.29"
,CR,AR,33000265,1001,100,,Cash Return,,,,,,04/09/2018,04/09/2018,30.00,,0.00,,"-1,677.29"
,CR,AR,33000266,1001,100,,Cash Return,,,,,,04/09/2018,04/09/2018,15.00,,0.00,,"-1,662.29"
,CS,AR,32008810,1001,100,,Cash sale,,,,,,04/09/2018,04/09/2018,0.00,,30.00,,"-1,692.29"
,CS,AR,32008811,1001,100,,Cash sale,,,,,,04/09/2018,04/09/2018,0.00,,30.00,,"-1,722.29"
,CS,AR,32008812,1001,100,,Cash sale,,,,,,04/09/2018,04/09/2018,0.00,,15.00,,"-1,737.29"
,CS,AR,32008814,1001,100,,Cash sale,,,,,,07/09/2018,07/09/2018,0.00,,15.00,,"-1,752.29"
,CR,AR,33000267,1001,100,,Cash Return,,,,,,12/09/2018,12/09/2018,15.00,,0.00,,"-1,737.29"
,CS,AR,32008821,1001,100,,Cash sale,,,,,,12/09/2018,12/09/2018,0.00,,15.00,,"-1,752.29"
,IN,AR,30324077,1007,100,,Invoice,,,,,,14/09/2018,14/09/2018,0.00,,455.51,,"-2,207.80"
,CR,AR,33000278,1001,100,,Cash Return,,,,,,25/09/2018,25/09/2018,15.00,,0.00,,"-2,192.80"
,CS,AR,32009391,1001,100,,Cash sale,,,,,,25/09/2018,25/09/2018,0.00,,15.00,,"-2,207.80"
,CR,AR,33000279,1001,100,,Cash Return,,,,,,28/09/2018,28/09/2018,15.00,,0.00,,"-2,192.80"
,CS,AR,32009398,1001,100,,Cash sale,,,,,,28/09/2018,28/09/2018,0.00,,15.00,,"-2,207.80"
,IN,AR,30328266,1007,100,,Invoice,,,,,,04/10/2018,04/10/2018,0.00,,455.51,,"-2,663.31"
,CR,AR,33000295,1001,100,,Cash Return,,,,,,12/10/2018,12/10/2018,15.00,,0.00,,"-2,648.31"
,CS,AR,32010514,1001,100,,Cash sale,,,,,,12/10/2018,12/10/2018,0.00,,15.00,,"-2,663.31"
,CR,AR,33000296,1001,100,,Cash Return,,,,,,29/10/2018,29/10/2018,45.00,,0.00,,"-2,618.31"
,CS,AR,32010543,1001,100,,Cash sale,,,,,,31/10/2018,31/10/2018,0.00,,30.00,,"-2,648.31"
,CN,AR,31019488,1001,100,,Credit Note,,,,,,06/11/2018,06/11/2018,15.00,,0.00,,"-2,633.31"
,IN,AR,30331690,1001,100,,Invoice,,,,,,06/11/2018,06/11/2018,0.00,,15.00,,"-2,648.31"
,CS,AR,32011594,1001,100,,Cash sale,,,,,,14/11/2018,14/11/2018,0.00,,15.00,,"-2,663.31"
,IN,AR,30333198,1001,100,,Invoice,,,,,,22/11/2018,22/11/2018,0.00,,516.34,,"-3,179.65"
,IN,AR,30333199,1001,100,,Invoice,,,,,,22/11/2018,22/11/2018,0.00,,442.58,,"-3,622.23"
,CS,AR,32011608,1001,100,,Cash sale,,,,,,27/11/2018,27/11/2018,0.00,,15.00,,"-3,637.23"
,CS,AR,32011615,1001,100,,Cash sale,,,,,,28/11/2018,28/11/2018,0.00,,15.00,,"-3,652.23"
,IN,AR,30333094,1001,100,,Invoice,,,,,,29/11/2018,29/11/2018,0.00,,15.00,,"-3,667.23"
,IN,AR,30333200,1001,100,,Invoice,,,,,,29/11/2018,29/11/2018,0.00,,295.05,,"-3,962.28"
,CR,AR,33000317,1001,100,,Cash Return,,,,,,30/11/2018,30/11/2018,15.00,,0.00,,"-3,947.28"
,CS,AR,32011619,1001,100,,Cash sale,,,,,,30/11/2018,30/11/2018,0.00,,15.00,,"-3,962.28"
,IN,AR,30333201,1001,100,,Invoice,,,,,,30/11/2018,30/11/2018,0.00,,295.05,,"-4,257.33"
,IN,AR,30335310,1001,100,,Invoice,,,,,,01/12/2018,01/12/2018,0.00,,442.58,,"-4,699.91"
,IN,AR,30334969,1001,100,,Invoice,,,,,,03/12/2018,03/12/2018,0.00,,272.29,,"-4,972.20"
,CR,AR,33000330,1001,100,,Cash Return,,,,,,04/12/2018,04/12/2018,30.00,,0.00,,"-4,942.20"
,CS,AR,32012385,1001,100,,Cash sale,,,,,,04/12/2018,04/12/2018,0.00,,15.00,,"-4,957.20"
,CS,AR,32012386,1001,100,,Cash sale,,,,,,04/12/2018,04/12/2018,0.00,,30.00,,"-4,987.20"
,IN,AR,30335311,1001,100,,Invoice,,,,,,04/12/2018,04/12/2018,0.00,,221.29,,"-5,208.49"
,CS,AR,32012392,1001,100,,Cash sale,,,,,,06/12/2018,06/12/2018,0.00,,15.00,,"-5,223.49"
,IN,AR,30335312,1001,100,,Invoice,,,,,,06/12/2018,06/12/2018,0.00,,73.76,,"-5,297.25"
,IN,AR,30335313,1001,100,,Invoice,,,,,,07/12/2018,07/12/2018,0.00,,368.81,,"-5,666.06"
,IN,AR,30335314,1001,100,,Invoice,,,,,,07/12/2018,07/12/2018,0.00,,"1,180.20",,"-6,846.26"
,IN,AR,30335181,1001,100,,Invoice,,,,,,10/12/2018,10/12/2018,0.00,,15.00,,"-6,861.26"
,IN,AR,30335315,1001,100,,Invoice,,,,,,11/12/2018,11/12/2018,0.00,,737.63,,"-7,598.89"
,IN,AR,30335316,1001,100,,Invoice,,,,,,12/12/2018,12/12/2018,0.00,,442.58,,"-8,041.47"
,IN,AR,30335317,1001,100,,Invoice,,,,,,14/12/2018,14/12/2018,0.00,,442.58,,"-8,484.05"
,IN,AR,30335318,1001,100,,Invoice,,,,,,18/12/2018,18/12/2018,0.00,,442.58,,"-8,926.63"
,CS,AR,32012426,1001,100,,Cash sale,,,,,,19/12/2018,19/12/2018,0.00,,15.00,,"-8,941.63"
,CN,AR,31019764,1001,100,,Credit Note,,,,,,20/12/2018,20/12/2018,15.00,,0.00,,"-8,926.63"
,CS,AR,32012428,1001,100,,Cash sale,,,,,,20/12/2018,20/12/2018,0.00,,15.00,,"-8,941.63"
,CS,AR,32012429,1001,100,,Cash sale,,,,,,20/12/2018,20/12/2018,0.00,,15.00,,"-8,956.63"
,IN,AR,30335319,1001,100,,Invoice,,,,,,20/12/2018,20/12/2018,0.00,,295.05,,"-9,251.68"
,IN,AR,30335320,1001,100,,Invoice,,,,,,22/12/2018,22/12/2018,0.00,,442.58,,"-9,694.26"
,IN,AR,30335321,1001,100,,Invoice,,,,,,22/12/2018,22/12/2018,0.00,,442.58,,"-10,136.84"
,IN,AR,30335322,1001,100,,Invoice,,,,,,24/12/2018,24/12/2018,0.00,,295.05,,"-10,431.89"
,CR,AR,33000334,1001,100,,Cash Return,,,,,,31/12/2018,31/12/2018,15.00,,0.00,,"-10,416.89"
,CS,AR,32012679,1001,100,,Cash sale,,,,,,31/12/2018,31/12/2018,0.00,,15.00,,"-10,431.89"
,,,,,,,,,,,,,,,,,,,
,Account: 1000605 - Sales Receipts In Advance Adjustment,,,,,,,,,,,,,,,,,,
,Pr.,Mod.,Reference,Dept,Div,Suffix,Details,,,Cheque,,User,Doc Date,Post Date,Debit,,Credit,,Balance
,JN,GL,22000451,1001,100,,Journal Entry,,,,,,01/01/2018,01/01/2018,0.00,,"131,323.11",,"-131,323.11"
,JN,GL,22000452,1001,100,,Y/E Adj,,,,,,31/12/2018,31/12/2018,"131,487.49",,0.00,,164.38
,,,,,,,,,,,,,,,,,,,
,Account: 1100001 - Inventory Adjustment Account,,,,,,,,,,,,,,,,,,
,Pr.,Mod.,Reference,Dept,Div,Suffix,Details,,,Cheque,,User,Doc Date,Post Date,Debit,,Credit,,Balance
,JN,GL,22000453,1001,100,,Opening Stock,,,,,,01/01/2018,01/01/2018,"15,804.84",,0.00,,"15,804.84"
,JN,GL,22000454,1001,100,,Closing Stock,,,,,,31/12/2018,31/12/2018,0.00,,"8,742.03",,"7,062.81"
,,,,,,,,,,,,,,,,,,,
,Account: 1100100 - Purchases - 19ltr Water,,,,,,,,,,,,,,,,,,
,Pr.,Mod.,Reference,Dept,Div,Suffix,Details,,,Cheque,,User,Doc Date,Post Date,Debit,,Credit,,Balance
,IN,AP,40001904,9000,900,,Invoice,,,,,SB,02/01/2018,02/01/2018,"1,638.90",,0.00,,"1,638.90"
,IN,AP,40001905,9000,900,,Invoice,,,,,SB,03/01/2018,03/01/2018,"2,679.75",,0.00,,"4,318.65"
,,,,,,,,,,,,,,,,,,,
,IN,AP,40001906,9000,900,,Invoice,,,,,SB,04/01/2018,04/01/2018,"1,745.55",,0.00,,"6,064.20"
,IN,AP,40001908,9000,900,,Invoice,,,,,SB,05/01/2018,05/01/2018,"1,393.20",,0.00,,"7,457.40"
,IN,AP,40001909,9000,900,,Invoice,,,,,SB,06/01/2018,06/01/2018,"1,656.45",,0.00,,"9,113.85"
,IN,AP,40001911,9000,900,,Invoice,,,,,SB,08/01/2018,08/01/2018,"2,384.10",,0.00,,"11,497.95"
,IN,AP,40001912,9000,900,,Invoice,,,,,SB,09/01/2018,09/01/2018,"1,867.05",,0.00,,"13,365.00"
,IN,AP,40001913,9000,900,,Invoice,,,,,SB,10/01/2018,10/01/2018,"2,835.00",,0.00,,"16,200.00"
,IN,AP,40001915,9000,900,,Invoice,,,,,SB,11/01/2018,11/01/2018,"1,949.40",,0.00,,"18,149.40"
,IN,AP,40001917,9000,900,,Invoice,,,,,SB,12/01/2018,12/01/2018,"1,923.75",,0.00,,"20,073.15"
,IN,AP,40001918,9000,900,,Invoice,,,,,SB,13/01/2018,13/01/2018,432.00,,0.00,,"20,505.15"
,IN,AP,40001920,9000,900,,Invoice,,,,,SB,15/01/2018,15/01/2018,"2,282.85",,0.00,,"22,788.00"
,IN,AP,40001921,9000,900,,Invoice,,,,,SB,16/01/2018,16/01/2018,"2,570.40",,0.00,,"25,358.40"
,IN,AP,40001923,9000,900,,Invoice,,,,,SB,17/01/2018,17/01/2018,"2,195.10",,0.00,,"27,553.50"
,IN,AP,40001924,9000,900,,Invoice,,,,,SB,18/01/2018,18/01/2018,"1,914.30",,0.00,,"29,467.80"
,IN,AP,40001926,9000,900,,Invoice,,,,,SB,19/01/2018,19/01/2018,"2,505.60",,0.00,,"31,973.40"
,IN,AP,40001928,9000,900,,Invoice,,,,,SB,22/01/2018,22/01/2018,"1,444.50",,0.00,,"33,417.90"
,IN,AP,40001930,9000,900,,Invoice,,,,,SB,23/01/2018,23/01/2018,"3,018.60",,0.00,,"36,436.50"
,IN,AP,40001932,9000,900,,Invoice,,,,,SB,24/01/2018,24/01/2018,"2,494.80",,0.00,,"38,931.30"
,IN,AP,40001934,9000,900,,Invoice,,,,,SB,25/01/2018,25/01/2018,"2,134.35",,0.00,,"41,065.65"
,IN,AP,40001936,9000,900,,Invoice,,,,,SB,26/01/2018,26/01/2018,"2,274.75",,0.00,,"43,340.40"
,IN,AP,40001939,9000,900,,Invoice,,,,,SB,29/01/2018,29/01/2018,"3,013.20",,0.00,,"46,353.60"
,IN,AP,40001941,9000,900,,Invoice,,,,,SB,30/01/2018,30/01/2018,"1,529.55",,0.00,,"47,883.15"
,IN,AP,40001942,9000,900,,Invoice,,,,,SB,31/01/2018,31/01/2018,"3,154.95",,0.00,,"51,038.10"
,IN,AP,40001944,9000,900,,Invoice,,,,,SB,01/02/2018,01/02/2018,"1,964.25",,0.00,,"53,002.35"
,IN,AP,40001946,9000,900,,Invoice,,,,,SB,02/02/2018,02/02/2018,"2,619.00",,0.00,,"55,621.35"
,IN,AP,40001949,9000,900,,Invoice,,,,,SB,05/02/2018,05/02/2018,"2,188.35",,0.00,,"57,809.70"
,IN,AP,40001951,9000,900,,Invoice,,,,,SB,06/02/2018,06/02/2018,"2,398.95",,0.00,,"60,208.65"
,IN,AP,40001953,9000,900,,Invoice,,,,,SB,07/02/2018,07/02/2018,"2,640.60",,0.00,,"62,849.25"
,IN,AP,40001955,9000,900,,Invoice,,,,,SB,09/02/2018,09/02/2018,"2,062.80",,0.00,,"64,912.05"
,IN,AP,40001957,9000,900,,Invoice,,,,,SB,12/02/2018,12/02/2018,"2,282.85",,0.00,,"67,194.90"
,IN,AP,40001958,9000,900,,Invoice,,,,,SB,13/02/2018,13/02/2018,"1,605.15",,0.00,,"68,800.05"
,IN,AP,40001961,9000,900,,Invoice,,,,,SB,15/02/2018,15/02/2018,"2,604.15",,0.00,,"71,404.20"
,IN,AP,40001963,9000,900,,Invoice,,,,,SB,16/02/2018,16/02/2018,"2,227.50",,0.00,,"73,631.70"
,IN,AP,40001966,9000,900,,Invoice,,,,,SB,20/02/2018,20/02/2018,"2,856.60",,0.00,,"76,488.30"
,IN,AP,40001968,9000,900,,Invoice,,,,,SB,21/02/2018,21/02/2018,"2,355.75",,0.00,,"78,844.05"
,IN,AP,40001970,9000,900,,Invoice,,,,,SB,22/02/2018,22/02/2018,"1,618.65",,0.00,,"80,462.70"
,IN,AP,40001972,9000,900,,Invoice,,,,,SB,23/02/2018,23/02/2018,"2,261.25",,0.00,,"82,723.95"
,IN,AP,40001974,9000,900,,Invoice,,,,,SB,26/02/2018,26/02/2018,"2,675.70",,0.00,,"85,399.65"
,IN,AP,40001975,9000,900,,Invoice,,,,,SB,27/02/2018,27/02/2018,"2,731.05",,0.00,,"88,130.70"
,IN,AP,40001978,9000,900,,Invoice,,,,,SB,28/02/2018,28/02/2018,"1,676.70",,0.00,,"89,807.40"
,IN,AP,40001980,9000,900,,Invoice,,,,,SB,01/03/2018,01/03/2018,"3,335.85",,0.00,,"93,143.25"
,IN,AP,40001981,9000,900,,Invoice,,,,,SB,02/03/2018,02/03/2018,"3,103.65",,0.00,,"96,246.90"
,IN,AP,40001984,9000,900,,Invoice,,,,,SB,06/03/2018,06/03/2018,"2,728.35",,0.00,,"98,975.25"
,IN,AP,40001986,9000,900,,Invoice,,,,,SB,07/03/2018,07/03/2018,"1,787.40",,0.00,,"100,762.65"
,IN,AP,40001988,9000,900,,Invoice,,,,,SB,08/03/2018,08/03/2018,"2,771.55",,0.00,,"103,534.20"
,IN,AP,40001989,9000,900,,Invoice,,,,,SB,09/03/2018,09/03/2018,"1,328.40",,0.00,,"104,862.60"
,IN,AP,40001991,9000,900,,Invoice,,,,,SB,12/03/2018,12/03/2018,"2,616.30",,0.00,,"107,478.90"
,IN,AP,40001993,9000,900,,Invoice,,,,,SB,13/03/2018,13/03/2018,"2,616.30",,0.00,,"110,095.20"
,IN,AP,40001994,9000,900,,Invoice,,,,,SB,14/03/2018,14/03/2018,"3,380.40",,0.00,,"113,475.60"
,IN,AP,40001995,9000,900,,Invoice,,,,,SB,15/03/2018,15/03/2018,"1,634.85",,0.00,,"115,110.45"
,IN,AP,40001997,9000,900,,Invoice,,,,,SB,16/03/2018,16/03/2018,"3,505.95",,0.00,,"118,616.40"
,IN,AP,40001998,9000,900,,Invoice,,,,,SB,20/03/2018,20/03/2018,"2,906.55",,0.00,,"121,522.95"
,IN,AP,40001999,9000,900,,Invoice,,,,,SB,21/03/2018,21/03/2018,"2,513.70",,0.00,,"124,036.65"
,IN,AP,40002002,9000,900,,Invoice,,,,,SB,22/03/2018,22/03/2018,"2,887.65",,0.00,,"126,924.30"
,IN,AP,40002003,9000,900,,Invoice,,,,,SB,23/03/2018,23/03/2018,"3,190.05",,0.00,,"130,114.35"
,IN,AP,40002005,9000,900,,Invoice,,,,,SB,26/03/2018,26/03/2018,"3,018.60",,0.00,,"133,132.95"
,IN,AP,40002006,9000,900,,Invoice,,,,,SB,27/03/2018,27/03/2018,"2,149.20",,0.00,,"135,282.15"
,IN,AP,40002007,9000,900,,Invoice,,,,,SB,28/03/2018,28/03/2018,"3,886.65",,0.00,,"139,168.80"
,IN,AP,40002008,9000,900,,Invoice,,,,,SB,29/03/2018,29/03/2018,"2,478.60",,0.00,,"141,647.40"
,IN,AP,40002009,9000,900,,Invoice,,,,,SB,02/04/2018,02/04/2018,"3,186.00",,0.00,,"144,833.40"
,IN,AP,40002011,9000,900,,Invoice,,,,,SB,03/04/2018,03/04/2018,"1,660.50",,0.00,,"146,493.90"
,IN,AP,40002013,9000,900,,Invoice,,,,,SB,04/04/2018,04/04/2018,"3,545.10",,0.00,,"150,039.00"
,IN,AP,40002015,9000,900,,Invoice,,,,,SB,05/04/2018,05/04/2018,"1,602.45",,0.00,,"151,641.45"
,IN,AP,40002016,9000,900,,Invoice,,,,,SB,06/04/2018,06/04/2018,"3,865.05",,0.00,,"155,506.50"
,IN,AP,40002022,9000,900,,Invoice,,,,,SB,09/04/2018,09/04/2018,"2,619.00",,0.00,,"158,125.50"
,IN,AP,40002023,9000,900,,Invoice,,,,,SB,10/04/2018,10/04/2018,"1,119.15",,0.00,,"159,244.65"
,IN,AP,40002025,9000,900,,Invoice,,,,,SB,11/04/2018,11/04/2018,"3,385.80",,0.00,,"162,630.45"
,IN,AP,40002027,9000,900,,Invoice,,,,,SB,13/04/2018,13/04/2018,"2,529.90",,0.00,,"165,160.35"
,IN,AP,40002030,9000,900,,Invoice,,,,,SB,15/04/2018,15/04/2018,"3,126.60",,0.00,,"168,286.95"
,IN,AP,40002031,9000,900,,Invoice,,,,,SB,16/04/2018,16/04/2018,"1,059.75",,0.00,,"169,346.70"
,IN,AP,40002033,9000,900,,Invoice,,,,,SB,17/04/2018,17/04/2018,"4,531.95",,0.00,,"173,878.65"
,IN,AP,40002034,9000,900,,Invoice,,,,,SB,18/04/2018,18/04/2018,"1,486.35",,0.00,,"175,365.00"
,IN,AP,40002036,9000,900,,Invoice,,,,,SB,19/04/2018,19/04/2018,"2,612.25",,0.00,,"177,977.25"
,IN,AP,40002038,9000,900,,Invoice,,,,,SB,20/04/2018,20/04/2018,"2,141.10",,0.00,,"180,118.35"
,IN,AP,40002069,9000,900,,Invoice,,,,,SB,23/04/2018,23/04/2018,"4,168.80",,0.00,,"184,287.15"
,IN,AP,40002070,9000,900,,Invoice,,,,,SB,24/04/2018,24/04/2018,"2,033.10",,0.00,,"186,320.25"
,IN,AP,40002072,9000,900,,Invoice,,,,,SB,25/04/2018,25/04/2018,"2,505.60",,0.00,,"188,825.85"
,IN,AP,40002075,9000,900,,Invoice,,,,,SB,26/04/2018,26/04/2018,"2,627.10",,0.00,,"191,452.95"
,IN,AP,40002077,9000,900,,Invoice,,,,,SB,27/04/2018,27/04/2018,849.15,,0.00,,"192,302.10"
,IN,AP,40002080,9000,900,,Invoice,,,,,SB,29/04/2018,29/04/2018,"3,141.45",,0.00,,"195,443.55"
,IN,AP,40002082,9000,900,,Invoice,,,,,SB,30/04/2018,30/04/2018,"3,092.85",,0.00,,"198,536.40"
,IN,AP,40002085,9000,900,,Invoice,,,,,SB,02/05/2018,02/05/2018,"3,732.75",,0.00,,"202,269.15"
,IN,AP,40002086,9000,900,,Invoice,,,,,SB,03/05/2018,03/05/2018,"3,102.30",,0.00,,"205,371.45"
,IN,AP,40002165,9000,900,,Invoice,,,,,SB,06/05/2018,06/05/2018,"3,595.05",,0.00,,"208,966.50"
,IN,AP,40002166,9000,900,,Invoice,,,,,SB,08/05/2018,08/05/2018,"2,610.90",,0.00,,"211,577.40"
,IN,AP,40002167,9000,900,,Invoice,,,,,SB,09/05/2018,09/05/2018,"1,807.65",,0.00,,"213,385.05"
,IN,AP,40002169,9000,900,,Invoice,,,,,SB,10/05/2018,10/05/2018,"2,270.70",,0.00,,"215,655.75"
,IN,AP,40002171,9000,900,,Invoice,,,,,SB,11/05/2018,11/05/2018,"3,526.20",,0.00,,"219,181.95"
,IN,AP,40002173,9000,900,,Invoice,,,,,SB,14/05/2018,14/05/2018,"2,914.65",,0.00,,"222,096.60"
,IN,AP,40002174,9000,900,,Invoice,,,,,SB,15/05/2018,15/05/2018,"3,871.80",,0.00,,"225,968.40"
,IN,AP,40002175,9000,900,,Invoice,,,,,SB,16/05/2018,16/05/2018,"3,281.85",,0.00,,"229,250.25"
,IN,AP,40002178,9000,900,,Invoice,,,,,SB,17/05/2018,17/05/2018,"2,511.00",,0.00,,"231,761.25"
,IN,AP,40002180,9000,900,,Invoice,,,,,SB,18/05/2018,18/05/2018,"2,037.15",,0.00,,"233,798.40"
,IN,AP,40002182,9000,900,,Invoice,,,,,SB,21/05/2018,21/05/2018,"1,490.40",,0.00,,"235,288.80"
,IN,AP,40002185,9000,900,,Invoice,,,,,SB,22/05/2018,22/05/2018,"3,564.00",,0.00,,"238,852.80"
,IN,AP,40002186,9000,900,,Invoice,,,,,SB,23/05/2018,23/05/2018,"1,782.00",,0.00,,"240,634.80"
,IN,AP,40002188,9000,900,,Invoice,,,,,SB,24/05/2018,24/05/2018,"3,672.00",,0.00,,"244,306.80"
,IN,AP,40002190,9000,900,,Invoice,,,,,SB,25/05/2018,25/05/2018,"1,860.30",,0.00,,"246,167.10"
,IN,AP,40002228,9000,900,,Invoice,,,,,SB,28/05/2018,28/05/2018,"3,362.85",,0.00,,"249,529.95"
,IN,AP,40002230,9000,900,,Invoice,,,,,SB,29/05/2018,29/05/2018,"2,106.00",,0.00,,"251,635.95"
,IN,AP,40002232,9000,900,,Invoice,,,,,SB,30/05/2018,30/05/2018,"4,104.00",,0.00,,"255,739.95"
,IN,AP,40002233,9000,900,,Invoice,,,,,SB,31/05/2018,31/05/2018,"3,618.00",,0.00,,"259,357.95"
,IN,AP,40002235,9000,900,,Invoice,,,,,SB,01/06/2018,01/06/2018,"1,890.00",,0.00,,"261,247.95"
,IN,AP,40002238,9000,900,,Invoice,,,,,SB,02/06/2018,02/06/2018,"2,322.00",,0.00,,"263,569.95"
,IN,AP,40002239,9000,900,,Invoice,,,,,SB,04/06/2018,04/06/2018,"2,376.00",,0.00,,"265,945.95"
,IN,AP,40002240,9000,900,,Invoice,,,,,SB,05/06/2018,05/06/2018,"3,186.00",,0.00,,"269,131.95"
,IN,AP,40002243,9000,900,,Invoice,,,,,SB,06/06/2018,06/06/2018,"2,327.40",,0.00,,"271,459.35"
,IN,AP,40002246,9000,900,,Invoice,,,,,SB,07/06/2018,07/06/2018,"1,296.00",,0.00,,"272,755.35"
,IN,AP,40002247,9000,900,,Invoice,,,,,SB,08/06/2018,08/06/2018,"2,430.00",,0.00,,"275,185.35"
,IN,AP,40002249,9000,900,,Invoice,,,,,SB,09/06/2018,09/06/2018,"3,402.00",,0.00,,"278,587.35"
,IN,AP,40002250,9000,900,,Invoice,,,,,SB,11/06/2018,11/06/2018,"1,944.00",,0.00,,"280,531.35"
,IN,AP,40002251,9000,900,,Invoice,,,,,SB,12/06/2018,12/06/2018,"1,836.00",,0.00,,"282,367.35"
,IN,AP,40002252,9000,900,,Invoice,,,,,SB,13/06/2018,13/06/2018,"2,484.00",,0.00,,"284,851.35"
,IN,AP,40002262,9000,900,,Invoice,,,,,SB,14/06/2018,14/06/2018,"4,050.00",,0.00,,"288,901.35"
,IN,AP,40002263,9000,900,,Invoice,,,,,SB,15/06/2018,15/06/2018,"1,512.00",,0.00,,"290,413.35"
,IN,AP,40002264,9000,900,,Invoice,,,,,SB,16/06/2018,16/06/2018,"3,348.00",,0.00,,"293,761.35"
,IN,AP,40002266,9000,900,,Invoice,,,,,SB,18/06/2018,18/06/2018,"1,998.00",,0.00,,"295,759.35"
,IN,AP,40002291,9000,900,,Invoice,,,,,SB,20/06/2018,20/06/2018,"3,618.00",,0.00,,"299,377.35"
,IN,AP,40002294,9000,900,,Invoice,,,,,SB,21/06/2018,21/06/2018,"2,538.00",,0.00,,"301,915.35"
,IN,AP,40002296,9000,900,,Invoice,,,,,SB,22/06/2018,22/06/2018,"4,212.00",,0.00,,"306,127.35"
,IN,AP,40002297,9000,900,,Invoice,,,,,SB,25/06/2018,25/06/2018,"1,512.00",,0.00,,"307,639.35"
,IN,AP,40002308,9000,900,,Invoice,,,,,SB,26/06/2018,26/06/2018,"2,430.00",,0.00,,"310,069.35"
,IN,AP,40002310,9000,900,,Invoice,,,,,SB,26/06/2018,26/06/2018,"1,836.00",,0.00,,"311,905.35"
,IN,AP,40002312,9000,900,,Invoice,,,,,SB,27/06/2018,27/06/2018,"2,430.00",,0.00,,"314,335.35"
,IN,AP,40002314,9000,900,,Invoice,,,,,SB,28/06/2018,28/06/2018,"2,376.00",,0.00,,"316,711.35"
,IN,AP,40002317,9000,900,,Invoice,,,,,SB,01/07/2018,01/07/2018,"2,700.00",,0.00,,"319,411.35"
,IN,AP,40002318,9000,900,,Invoice,,,,,SB,02/07/2018,02/07/2018,"3,024.00",,0.00,,"322,435.35"
,IN,AP,40002320,9000,900,,Invoice,,,,,SB,03/07/2018,03/07/2018,"2,106.00",,0.00,,"324,541.35"
,IN,AP,40002356,9000,900,,Invoice,,,,,SB,04/07/2018,04/07/2018,"3,942.00",,0.00,,"328,483.35"
,IN,AP,40002359,9000,900,,Invoice,,,,,SB,05/07/2018,05/07/2018,"2,160.00",,0.00,,"330,643.35"
,IN,AP,40002360,9000,900,,Invoice,,,,,SB,06/07/2018,06/07/2018,"1,404.00",,0.00,,"332,047.35"
,IN,AP,40002364,9000,900,,Invoice,,,,,SB,08/07/2018,08/07/2018,"3,078.00",,0.00,,"335,125.35"
,IN,AP,40002365,9000,900,,Invoice,,,,,SB,09/07/2018,09/07/2018,"2,808.00",,0.00,,"337,933.35"
,IN,AP,40002366,9000,900,,Invoice,,,,,SB,10/07/2018,10/07/2018,"2,484.00",,0.00,,"340,417.35"
,IN,AP,40002431,9000,900,,Invoice,,,,,SB,11/07/2018,11/07/2018,"3,726.00",,0.00,,"344,143.35"
,IN,AP,40002432,9000,900,,Invoice,,,,,SB,12/07/2018,12/07/2018,"2,916.00",,0.00,,"347,059.35"
,IN,AP,40002434,9000,900,,Invoice,,,,,SB,13/07/2018,13/07/2018,"3,186.00",,0.00,,"350,245.35"
,IN,AP,40002435,9000,900,,Invoice,,,,,SB,14/07/2018,14/07/2018,432.00,,0.00,,"350,677.35"
,IN,AP,40002437,9000,900,,Invoice,,,,,SB,16/07/2018,16/07/2018,"1,566.00",,0.00,,"352,243.35"
,IN,AP,40002441,9000,900,,Invoice,,,,,SB,17/07/2018,17/07/2018,"3,132.00",,0.00,,"355,375.35"
,IN,AP,40002443,9000,900,,Invoice,,,,,SB,18/07/2018,18/07/2018,"3,942.00",,0.00,,"359,317.35"
,IN,AP,40002444,9000,900,,Invoice,,,,,SB,19/07/2018,19/07/2018,"3,996.00",,0.00,,"363,313.35"
,IN,AP,40002445,9000,900,,Invoice,,,,,SB,20/07/2018,20/07/2018,"3,618.00",,0.00,,"366,931.35"
,IN,AP,40002447,9000,900,,Invoice,,,,,SB,21/07/2018,21/07/2018,648.00,,0.00,,"367,579.35"
,IN,AP,40002449,9000,900,,Invoice,,,,,SB,23/07/2018,23/07/2018,"2,916.00",,0.00,,"370,495.35"
,IN,AP,40002450,9000,900,,Invoice,,,,,SB,24/07/2018,24/07/2018,"2,970.00",,0.00,,"373,465.35"
,IN,AP,40002453,9000,900,,Invoice,,,,,SB,25/07/2018,25/07/2018,"3,942.00",,0.00,,"377,407.35"
,IN,AP,40002455,9000,900,,Invoice,,,,,SB,26/07/2018,26/07/2018,"2,700.00",,0.00,,"380,107.35"
,IN,AP,40002457,9000,900,,Invoice,,,,,SB,27/07/2018,27/07/2018,"3,132.00",,0.00,,"383,239.35"
,IN,AP,40002459,9000,900,,Invoice,,,,,SB,29/07/2018,29/07/2018,"1,782.00",,0.00,,"385,021.35"
,IN,AP,40002460,9000,900,,Invoice,,,,,SB,30/07/2018,30/07/2018,"2,430.00",,0.00,,"387,451.35"
,IN,AP,40002462,9000,900,,Invoice,,,,,SB,31/07/2018,31/07/2018,"3,348.00",,0.00,,"390,799.35"
,IN,AP,40002466,9000,900,,Invoice,,,,,SB,01/08/2018,01/08/2018,"3,186.00",,0.00,,"393,985.35"
,IN,AP,40002467,9000,900,,Invoice,,,,,SB,02/08/2018,02/08/2018,"3,996.00",,0.00,,"397,981.35"
,IN,AP,40002469,9000,900,,Invoice,,,,,SB,03/08/2018,03/08/2018,"1,674.00",,0.00,,"399,655.35"
,IN,AP,40002474,9000,900,,Invoice,,,,,SB,05/08/2018,05/08/2018,"2,916.00",,0.00,,"402,571.35"
,IN,AP,40002475,9000,900,,Invoice,,,,,SB,06/08/2018,06/08/2018,"3,348.00",,0.00,,"405,919.35"
,IN,AP,40002596,9000,900,,Invoice,,,,,SB,07/08/2018,07/08/2018,"3,510.00",,0.00,,"409,429.35"
,IN,AP,40002597,9000,900,,Invoice,,,,,SB,08/08/2018,08/08/2018,"3,240.00",,0.00,,"412,669.35"
,IN,AP,40002598,9000,900,,Invoice,,,,,SB,09/08/2018,09/08/2018,"3,564.00",,0.00,,"416,233.35"
,IN,AP,40002601,9000,900,,Invoice,,,,,SB,10/08/2018,10/08/2018,"2,700.00",,0.00,,"418,933.35"
,IN,AP,40002602,9000,900,,Invoice,,,,,SB,11/08/2018,11/08/2018,"1,620.00",,0.00,,"420,553.35"
,IN,AP,40002603,9000,900,,Invoice,,,,,SB,13/08/2018,13/08/2018,"2,592.00",,0.00,,"423,145.35"
,IN,AP,40002605,9000,900,,Invoice,,,,,SB,14/08/2018,14/08/2018,"1,674.00",,0.00,,"424,819.35"
,IN,AP,40002612,9000,900,,Invoice,,,,,SB,16/08/2018,16/08/2018,"2,970.00",,0.00,,"427,789.35"
,IN,AP,40002613,9000,900,,Invoice,,,,,SB,17/08/2018,17/08/2018,"1,404.00",,0.00,,"429,193.35"
,IN,AP,40002615,9000,900,,Invoice,,,,,SB,18/08/2018,18/08/2018,"1,296.00",,0.00,,"430,489.35"
,IN,AP,40002617,9000,900,,Invoice,,,,,SB,19/08/2018,19/08/2018,"3,968.58",,0.00,,"434,457.93"
,IN,AP,40002618,9000,900,,Invoice,,,,,SB,19/08/2018,19/08/2018,"2,214.00",,0.00,,"436,671.93"
,IN,AP,40002620,9000,900,,Invoice,,,,,SB,21/08/2018,21/08/2018,"2,106.00",,0.00,,"438,777.93"
,IN,AP,40002621,9000,900,,Invoice,,,,,SB,22/08/2018,22/08/2018,"3,510.00",,0.00,,"442,287.93"
,IN,AP,40002623,9000,900,,Invoice,,,,,SB,23/08/2018,23/08/2018,"3,024.00",,0.00,,"445,311.93"
,IN,AP,40002626,9000,900,,Invoice,,,,,SB,24/08/2018,24/08/2018,"2,884.00",,0.00,,"448,195.93"
,IN,AP,40002628,9000,900,,Invoice,,,,,SB,25/08/2018,25/08/2018,"2,646.00",,0.00,,"450,841.93"
,IN,AP,40002630,9000,900,,Invoice,,,,,SB,27/08/2018,27/08/2018,"2,052.00",,0.00,,"452,893.93"
,IN,AP,40002632,9000,900,,Invoice,,,,,SB,28/08/2018,28/08/2018,"2,970.00",,0.00,,"455,863.93"
,IN,AP,40002633,9000,900,,Invoice,,,,,SB,29/08/2018,29/08/2018,"2,916.00",,0.00,,"458,779.93"
,IN,AP,40002637,9000,900,,Invoice,,,,,SB,30/08/2018,30/08/2018,"2,970.00",,0.00,,"461,749.93"
,IN,AP,40002638,9000,900,,Invoice,,,,,SB,31/08/2018,31/08/2018,"2,592.00",,0.00,,"464,341.93"
,IN,AP,40002666,9000,900,,Production for 010918,,,,,SB,01/09/2018,01/09/2018,"1,728.00",,0.00,,"466,069.93"
,IN,AP,40002668,9000,900,,Production for 030918,,,,,SB,03/09/2018,03/09/2018,"1,998.00",,0.00,,"468,067.93"
,IN,AP,40002671,9000,900,,Production for 040918,,,,,SB,04/09/2018,04/09/2018,"1,998.00",,0.00,,"470,065.93"
,IN,AP,40002672,9000,900,,Production for 050918,,,,,SB,05/09/2018,05/09/2018,"2,430.00",,0.00,,"472,495.93"
,IN,AP,40002673,9000,900,,Production for 060918,,,,,SB,06/09/2018,06/09/2018,"4,698.00",,0.00,,"477,193.93"
,IN,AP,40002674,9000,900,,Production for 070918,,,,,SB,07/09/2018,07/09/2018,"2,916.00",,0.00,,"480,109.93"
,IN,AP,40002675,9000,900,,Production for 080918,,,,,SB,08/09/2018,08/09/2018,"2,862.00",,0.00,,"482,971.93"
,IN,AP,40002677,9000,900,,Production for 100918,,,,,SB,10/09/2018,10/09/2018,"1,512.00",,0.00,,"484,483.93"
,IN,AP,40002680,9000,900,,Production for 110918,,,,,SB,11/09/2018,11/09/2018,"3,132.00",,0.00,,"487,615.93"
,IN,AP,40002682,9000,900,,Production for 120918,,,,,SB,12/09/2018,12/09/2018,"3,294.00",,0.00,,"490,909.93"
,IN,AP,40002685,9000,900,,Production for 130918,,,,,SB,13/09/2018,13/09/2018,"2,916.00",,0.00,,"493,825.93"
,IN,AP,40002687,9000,900,,Production for 140918,,,,,SB,14/09/2018,14/09/2018,"1,998.00",,0.00,,"495,823.93"
,IN,AP,40002691,9000,900,,Production for 160918,,,,,SB,16/09/2018,16/09/2018,"1,890.00",,0.00,,"497,713.93"
,IN,AP,40002692,9000,900,,Production for 170918,,,,,SB,17/09/2018,17/09/2018,"2,970.00",,0.00,,"500,683.93"
,IN,AP,40002695,9000,900,,Production for 180918,,,,,SB,18/09/2018,18/09/2018,"3,618.00",,0.00,,"504,301.93"
,IN,AP,40002696,9000,900,,Production for 190918,,,,,SB,19/09/2018,19/09/2018,"3,402.00",,0.00,,"507,703.93"
,IN,AP,40002698,9000,900,,Production for 200918,,,,,SB,20/09/2018,20/09/2018,"3,564.00",,0.00,,"511,267.93"
,IN,AP,40002699,9000,900,,Production for 210918,,,,,SB,21/09/2018,21/09/2018,"2,106.00",,0.00,,"513,373.93"
,IN,AP,40002703,9000,900,,Production for 240918,,,,,SB,24/09/2018,24/09/2018,"2,376.00",,0.00,,"515,749.93"
,IN,AP,40002704,9000,900,,Production for 250918,,,,,SB,25/09/2018,25/09/2018,"2,916.00",,0.00,,"518,665.93"
,IN,AP,40002708,9000,900,,Production for 260918,,,,,SB,26/09/2018,26/09/2018,"2,862.00",,0.00,,"521,527.93"
,IN,AP,40002709,9000,900,,Production for 270918,,,,,SB,27/09/2018,27/09/2018,"2,808.00",,0.00,,"524,335.93"
,IN,AP,40002712,9000,900,,Production for 280918,,,,,SB,28/09/2018,28/09/2018,"3,078.00",,0.00,,"527,413.93"
,IN,AP,40002713,9000,900,,Production for 290918,,,,,SB,29/09/2018,29/09/2018,"2,700.00",,0.00,,"530,113.93"
,IN,AP,40002973,9000,900,,Production for 011018,,,,,SB,01/10/2018,01/10/2018,"2,052.00",,0.00,,"532,165.93"
,IN,AP,40002975,9000,900,,Production for 021018,,,,,SB,02/10/2018,02/10/2018,"2,862.00",,0.00,,"535,027.93"
,IN,AP,40002977,9000,900,,Production for 031018,,,,,SB,03/10/2018,03/10/2018,"2,268.00",,0.00,,"537,295.93"
,IN,AP,40002981,9000,900,,Production for 041018,,,,,SB,04/10/2018,04/10/2018,"3,294.00",,0.00,,"540,589.93"
,IN,AP,40002985,9000,900,,Production for 051018,,,,,SB,05/10/2018,05/10/2018,"2,754.00",,0.00,,"543,343.93"
,IN,AP,40002988,9000,900,,Production for 061018,,,,,SB,07/10/2018,07/10/2018,"1,620.00",,0.00,,"544,963.93"
,IN,AP,40002991,9000,900,,Production for 081018,,,02/10/2018,,SB,08/10/2018,08/10/2018,"2,052.00",,0.00,,"547,015.93"
,IN,AP,40002993,9000,900,,Production for 091018,,,02/10/2018,,SB,09/10/2018,09/10/2018,"2,700.00",,0.00,,"549,715.93"
,IN,AP,40002995,9000,900,,Production for 101018,,,03/10/2018,,SB,10/10/2018,10/10/2018,"2,430.00",,0.00,,"552,145.93"
,CN,AP,41000098,9000,900,,Customer Return Mcast,,,04/10/2018,,SB,11/10/2018,11/10/2018,0.00,,14.85,,"552,131.08"
,IN,AP,40002998,9000,900,,Production for 111018,,,05/10/2018,,SB,11/10/2018,11/10/2018,"2,538.00",,0.00,,"554,669.08"
,IN,AP,40003001,9000,900,,Production for 121018,,,06/10/2018,,SB,12/10/2018,12/10/2018,"3,024.00",,0.00,,"557,693.08"
,CN,AP,41000101,9000,900,,Customer Return Mcast,,,07/10/2018,,SB,13/10/2018,13/10/2018,0.00,,21.60,,"557,671.48"
,IN,AP,40003003,9000,900,,Production for 131018,,,08/10/2018,,SB,13/10/2018,13/10/2018,"3,132.00",,0.00,,"560,803.48"
,IN,AP,40003005,9000,900,,Production for 151018,,,09/10/2018,,SB,15/10/2018,15/10/2018,"1,836.00",,0.00,,"562,639.48"
,IN,AP,40003008,9000,900,,Production for 171018,,,10/10/2018,,SB,17/10/2018,17/10/2018,"2,430.00",,0.00,,"565,069.48"
,IN,AP,40003012,9000,900,,Production for 181018,,,11/10/2018,,SB,18/10/2018,18/10/2018,"2,646.00",,0.00,,"567,715.48"
,IN,AP,40003014,9000,900,,Production for 191018,,,11/10/2018,,SB,19/10/2018,19/10/2018,"2,700.00",,0.00,,"570,415.48"
,IN,AP,40003017,9000,900,,Production for 201018,,,13/10/2018,,SB,20/10/2018,20/10/2018,"2,106.00",,0.00,,"572,521.48"
,IN,AP,40003019,9000,900,,Production for 221018,,,13/10/2018,,SB,22/10/2018,22/10/2018,"2,160.00",,0.00,,"574,681.48"
,IN,AP,40003020,9000,900,,Production for 231018,,,13/10/2018,,SB,23/10/2018,23/10/2018,"2,646.00",,0.00,,"577,327.48"
,IN,AP,40003022,9000,900,,Production for 241018,,,15/10/2018,,SB,24/10/2018,24/10/2018,"2,430.00",,0.00,,"579,757.48"
,IN,AP,40003025,9000,900,,Production for 251018,,,17/10/2018,,SB,25/10/2018,25/10/2018,"2,862.00",,0.00,,"582,619.48"
,IN,AP,40003027,9000,900,,Production for 261018,,,18/10/2018,,SB,26/10/2018,26/10/2018,"1,890.00",,0.00,,"584,509.48"
,IN,AP,40003030,9000,900,,Production for 281018,,,18/10/2018,,SB,28/10/2018,28/10/2018,"1,890.00",,0.00,,"586,399.48"
,IN,AP,40003033,9000,900,,Production for 291018,,,19/10/2018,,SB,29/10/2018,29/10/2018,"2,862.00",,0.00,,"589,261.48"
,IN,AP,40003036,9000,900,,Production for 301018,,,20/10/2018,,SB,30/10/2018,30/10/2018,"2,700.00",,0.00,,"591,961.48"
,IN,AP,40003037,9000,900,,Production for 311018,,,23/10/2018,,SB,31/10/2018,31/10/2018,"1,458.00",,0.00,,"593,419.48"
,IN,AP,40003040,9000,900,,Production for 011118,,,24/10/2018,,SB,01/11/2018,01/11/2018,"2,862.00",,0.00,,"596,281.48"
,IN,AP,40003041,9000,900,,Production for 021118,,,24/10/2018,,SB,02/11/2018,02/11/2018,"2,484.00",,0.00,,"598,765.48"
,IN,AP,40003043,9000,900,,Production for 031118,,,25/10/2018,,SB,03/11/2018,03/11/2018,"2,592.00",,0.00,,"601,357.48"
,IN,AP,40003045,9000,900,,Production for 051118,,,25/10/2018,,SB,05/11/2018,05/11/2018,"2,484.00",,0.00,,"603,841.48"
,IN,AP,40003046,9000,900,,Production for 061118,,,26/10/2018,,SB,06/11/2018,06/11/2018,"3,024.00",,0.00,,"606,865.48"
,IN,AP,40003047,9000,900,,Production for 071118,,,27/10/2018,,SB,07/11/2018,07/11/2018,"2,376.00",,0.00,,"609,241.48"
,IN,AP,40003050,9000,900,,Production for 081118,,,28/10/2018,,SB,08/11/2018,08/11/2018,"2,916.00",,0.00,,"612,157.48"
,IN,AP,40003051,9000,900,,Production for 091118,,,30/10/2018,,SB,09/11/2018,09/11/2018,"2,106.00",,0.00,,"614,263.48"
,IN,AP,40003054,9000,900,,Production for 101118,,,30/10/2018,,SB,10/11/2018,10/11/2018,"1,836.00",,0.00,,"616,099.48"
,IN,AP,40003055,9000,900,,Production for 121118,,,31/10/2018,,SB,12/11/2018,12/11/2018,"2,592.00",,0.00,,"618,691.48"
,IN,AP,40003057,9000,900,,Production for 131118,,,02/11/2018,,SB,13/11/2018,13/11/2018,"2,160.00",,0.00,,"620,851.48"
,IN,AP,40003059,9000,900,,Production for 141118,,,03/11/2018,,SB,14/11/2018,14/11/2018,"1,512.00",,0.00,,"622,363.48"
,IN,AP,40003061,9000,900,,Production for 151118,,,05/11/2018,,SB,15/11/2018,15/11/2018,"2,916.00",,0.00,,"625,279.48"
,IN,AP,40003062,9000,900,,Production for 161118,,,06/11/2018,,SB,16/11/2018,16/11/2018,"2,322.00",,0.00,,"627,601.48"
,IN,AP,40003065,9000,900,,Production for 171118,,,07/11/2018,,SB,17/11/2018,17/11/2018,"1,458.00",,0.00,,"629,059.48"
,IN,AP,40003066,9000,900,,Production for 181118,,,08/11/2018,,SB,18/11/2018,18/11/2018,"1,944.00",,0.00,,"631,003.48"
,IN,AP,40003068,9000,900,,Production for 191118,,,09/11/2018,,SB,19/11/2018,19/11/2018,"2,484.00",,0.00,,"633,487.48"
,IN,AP,40003070,9000,900,,Production for 201118,,,10/11/2018,,SB,20/11/2018,20/11/2018,"2,430.00",,0.00,,"635,917.48"
,IN,AP,40003073,9000,900,,Production for 211118,,,13/11/2018,,SB,21/11/2018,21/11/2018,"2,862.00",,0.00,,"638,779.48"
,IN,AP,40003076,9000,900,,Production for 221118,,,13/11/2018,,SB,22/11/2018,22/11/2018,"1,890.00",,0.00,,"640,669.48"
,IN,AP,40002906,9000,900,,Production for 231118,,,,,SB,23/11/2018,23/11/2018,"2,646.00",,0.00,,"643,315.48"
,IN,AP,40002909,9000,900,,Production for 241118,,,,,SB,24/11/2018,24/11/2018,"2,808.00",,0.00,,"646,123.48"
,IN,AP,40002910,9000,900,,,,,,,SB,26/11/2018,26/11/2018,"2,052.00",,0.00,,"648,175.48"
,IN,AP,40002913,9000,900,,Production for 271118,,,,,SB,27/11/2018,27/11/2018,"2,538.00",,0.00,,"650,713.48"
,IN,AP,40002914,9000,900,,Production for 281118,,,,,SB,28/11/2018,28/11/2018,"1,944.00",,0.00,,"652,657.48"
,IN,AP,40002918,9000,900,,Production for 291118,,,,,SB,29/11/2018,29/11/2018,"1,890.00",,0.00,,"654,547.48"
,IN,AP,40002920,9000,900,,Production for 301118,,,,,SB,30/11/2018,30/11/2018,"1,674.00",,0.00,,"656,221.48"
,IN,AP,40002921,9000,900,,Production for 011218,,,,,SB,01/12/2018,01/12/2018,"2,754.00",,0.00,,"658,975.48"
,IN,AP,40001903,9000,900,,Invoice,,,,,SB,02/12/2018,02/12/2018,"1,638.90",,0.00,,"660,614.38"
,IN,AP,40002922,9000,900,,Production for 031218,,,,,SB,03/12/2018,03/12/2018,"2,970.00",,0.00,,"663,584.38"
,IN,AP,40002923,9000,900,,Production for 041218,,,,,SB,04/12/2018,04/12/2018,"2,916.00",,0.00,,"666,500.38"
,IN,AP,40002926,9000,900,,Production for 051218,,,,,SB,05/12/2018,05/12/2018,"1,188.00",,0.00,,"667,688.38"
,IN,AP,40002928,9000,900,,Production for 061218,,,,,SB,06/12/2018,06/12/2018,"2,214.00",,0.00,,"669,902.38"
,IN,AP,40002930,9000,900,,Production for 071218,,,,,SB,07/12/2018,07/12/2018,"1,200.15",,0.00,,"671,102.53"
,IN,AP,40002932,9000,900,,Production for 081218,,,,,SB,08/12/2018,08/12/2018,"1,566.00",,0.00,,"672,668.53"
,IN,AP,40002934,9000,900,,Production for 101218,,,,,SB,10/12/2018,10/12/2018,"2,376.00",,0.00,,"675,044.53"
,IN,AP,40002938,9000,900,,Production for 111218,,,,,SB,11/12/2018,11/12/2018,"2,160.00",,0.00,,"677,204.53"
,IN,AP,40002940,9000,900,,Production for 121218,,,,,SB,12/12/2018,12/12/2018,"1,836.00",,0.00,,"679,040.53"
,IN,AP,40002943,9000,900,,Production for 131218,,,,,SB,13/12/2018,13/12/2018,"1,620.00",,0.00,,"680,660.53"
,IN,AP,40002944,9000,900,,Production for 141218,,,,,SB,14/12/2018,14/12/2018,"1,944.00",,0.00,,"682,604.53"
,IN,AP,40002945,9000,900,,Production for 151218,,,,,SB,15/12/2018,15/12/2018,"1,512.00",,0.00,,"684,116.53"
,IN,AP,40002948,9000,900,,Production for 161218,,,,,SB,16/12/2018,16/12/2018,"1,134.00",,0.00,,"685,250.53"
,IN,AP,40002952,9000,900,,Production for 171218,,,,,SB,17/12/2018,17/12/2018,"2,052.00",,0.00,,"687,302.53"
,IN,AP,40002956,9000,900,,Production for 181218,,,,,SB,18/12/2018,18/12/2018,"2,214.00",,0.00,,"689,516.53"
,IN,AP,40002957,9000,900,,Production for 191218,,,,,SB,19/12/2018,19/12/2018,"1,674.00",,0.00,,"691,190.53"
,IN,AP,40002960,9000,900,,Production for 201218,,,,,SB,20/12/2018,20/12/2018,"2,322.00",,0.00,,"693,512.53"
,IN,AP,40002962,9000,900,,Production for 211218,,,,,SB,21/12/2018,21/12/2018,"1,620.00",,0.00,,"695,132.53"
,IN,AP,40002963,9000,900,,Production for 221218,,,,,SB,22/12/2018,22/12/2018,"1,404.00",,0.00,,"696,536.53"
,IN,AP,40002966,9000,900,,Production for 231218,,,,,SB,23/12/2018,23/12/2018,"1,836.00",,0.00,,"698,372.53"
,IN,AP,40002967,9000,900,,Production for 241218,,,,,SB,24/12/2018,24/12/2018,"1,404.00",,0.00,,"699,776.53"
,IN,AP,40002968,9000,900,,Production for 261218,,,,,SB,26/12/2018,26/12/2018,"2,754.00",,0.00,,"702,530.53"
,IN,AP,40002970,9000,900,,Production for 271218,,,,,SB,27/12/2018,27/12/2018,"1,998.00",,0.00,,"704,528.53"
,IN,AP,40002971,9000,900,,Production for 281218,,,,,SB,28/12/2018,28/12/2018,"1,296.00",,0.00,,"705,824.53"
,IN,AP,40002972,9000,900,,Production for 291218,,,,,SB,29/12/2018,29/12/2018,"2,430.00",,0.00,,"708,254.53"
,,,,,,,,,,,,,,,,,,,
,Account: 1100110 - Purchases - 11ltr Water,,,,,,,,,,,,,,,,,,
,,,,,,,,,,,,,,,,,,,
,Pr.,Mod.,Reference,Dept,Div,Suffix,Details,,,Cheque,,User,Doc Date,Post Date,Debit,,Credit,,Balance
,IN,AP,40001907,9000,900,,Invoice,,,,,SB,04/01/2018,04/01/2018,24.96,,0.00,,24.96
,IN,AP,40001910,9000,900,,Invoice,,,,,SB,06/01/2018,06/01/2018,9.36,,0.00,,34.32
,IN,AP,40001914,9000,900,,Invoice,,,,,SB,10/01/2018,10/01/2018,20.28,,0.00,,54.60
,IN,AP,40001916,9000,900,,Invoice,,,,,SB,11/01/2018,11/01/2018,30.42,,0.00,,85.02
,IN,AP,40001919,9000,900,,Invoice,,,,,SB,13/01/2018,13/01/2018,15.60,,0.00,,100.62
,IN,AP,40001922,9000,900,,Invoice,,,,,SB,16/01/2018,16/01/2018,18.72,,0.00,,119.34
,IN,AP,40001925,9000,900,,Invoice,,,,,SB,18/01/2018,18/01/2018,16.38,,0.00,,135.72
,IN,AP,40001927,9000,900,,Invoice,,,,,SB,19/01/2018,19/01/2018,14.82,,0.00,,150.54
,IN,AP,40001929,9000,900,,Invoice,,,,,SB,22/01/2018,22/01/2018,9.36,,0.00,,159.90
,IN,AP,40001931,9000,900,,Invoice,,,,,SB,23/01/2018,23/01/2018,10.14,,0.00,,170.04
,IN,AP,40001933,9000,900,,Invoice,,,,,SB,24/01/2018,24/01/2018,6.24,,0.00,,176.28
,IN,AP,40001935,9000,900,,Invoice,,,,,SB,25/01/2018,25/01/2018,3.90,,0.00,,180.18
,IN,AP,40001937,9000,900,,Invoice,,,,,SB,26/01/2018,26/01/2018,6.24,,0.00,,186.42
,IN,AP,40001940,9000,900,,Invoice,,,,,SB,29/01/2018,29/01/2018,5.46,,0.00,,191.88
,IN,AP,40001943,9000,900,,Invoice,,,,,SB,31/01/2018,31/01/2018,3.12,,0.00,,195.00
,IN,AP,40001945,9000,900,,Invoice,,,,,SB,01/02/2018,01/02/2018,1.56,,0.00,,196.56
,IN,AP,40001947,9000,900,,Invoice,,,,,SB,02/02/2018,02/02/2018,1.56,,0.00,,198.12
,IN,AP,40001950,9000,900,,Invoice,,,,,SB,05/02/2018,05/02/2018,29.64,,0.00,,227.76
,IN,AP,40001952,9000,900,,Invoice,,,,,SB,06/02/2018,06/02/2018,7.02,,0.00,,234.78
,IN,AP,40001954,9000,900,,Invoice,,,,,SB,07/02/2018,07/02/2018,19.50,,0.00,,254.28
,IN,AP,40001956,9000,900,,Invoice,,,,,SB,09/02/2018,09/02/2018,8.58,,0.00,,262.86
,IN,AP,40001959,9000,900,,Invoice,,,,,SB,14/02/2018,14/02/2018,"3,304.80",,0.00,,"3,567.66"
,IN,AP,40001960,9000,900,,Invoice,,,,,SB,14/02/2018,14/02/2018,11.70,,0.00,,"3,579.36"
,IN,AP,40001962,9000,900,,Invoice,,,,,SB,15/02/2018,15/02/2018,11.70,,0.00,,"3,591.06"
,IN,AP,40001964,9000,900,,Invoice,,,,,SB,16/02/2018,16/02/2018,7.80,,0.00,,"3,598.86"
,IN,AP,40001965,9000,900,,Invoice,,,,,SB,19/02/2018,19/02/2018,10.92,,0.00,,"3,609.78"
,IN,AP,40001967,9000,900,,Invoice,,,,,SB,20/02/2018,20/02/2018,6.24,,0.00,,"3,616.02"
,IN,AP,40001969,9000,900,,Invoice,,,,,SB,21/02/2018,21/02/2018,10.14,,0.00,,"3,626.16"
,IN,AP,40001971,9000,900,,Invoice,,,,,SB,22/02/2018,22/02/2018,6.24,,0.00,,"3,632.40"
,IN,AP,40001973,9000,900,,Invoice,,,,,SB,23/02/2018,23/02/2018,21.06,,0.00,,"3,653.46"
,IN,AP,40001976,9000,900,,Invoice,,,,,SB,27/02/2018,27/02/2018,21.06,,0.00,,"3,674.52"
,IN,AP,40001979,9000,900,,Invoice,,,,,SB,28/02/2018,28/02/2018,22.62,,0.00,,"3,697.14"
,IN,AP,40001982,9000,900,,Invoice,,,,,SB,02/03/2018,02/03/2018,53.82,,0.00,,"3,750.96"
,IN,AP,40001987,9000,900,,Invoice,,,,,SB,07/03/2018,07/03/2018,10.14,,0.00,,"3,761.10"
,IN,AP,40001992,9000,900,,Invoice,,,,,SB,12/03/2018,12/03/2018,24.18,,0.00,,"3,785.28"
,IN,AP,40001996,9000,900,,Invoice,,,,,SB,15/03/2018,15/03/2018,24.96,,0.00,,"3,810.24"
,IN,AP,40002004,9000,900,,Invoice,,,,,SB,23/03/2018,23/03/2018,63.96,,0.00,,"3,874.20"
,IN,AP,40002010,9000,900,,Invoice,,,,,SB,02/04/2018,02/04/2018,28.08,,0.00,,"3,902.28"
,IN,AP,40002012,9000,900,,Invoice,,,,,SB,03/04/2018,03/04/2018,28.08,,0.00,,"3,930.36"
,IN,AP,40002014,9000,900,,Invoice,,,,,SB,04/04/2018,04/04/2018,46.80,,0.00,,"3,977.16"
,IN,AP,40002017,9000,900,,Invoice,,,,,SB,06/04/2018,06/04/2018,57.72,,0.00,,"4,034.88"
,IN,AP,40002028,9000,900,,Invoice,,,,,SB,13/04/2018,13/04/2018,28.08,,0.00,,"4,062.96"
,IN,AP,40002037,9000,900,,Invoice,,,,,SB,19/04/2018,19/04/2018,27.30,,0.00,,"4,090.26"
,IN,AP,40002081,9000,900,,Invoice,,,,,SB,29/04/2018,29/04/2018,46.80,,0.00,,"4,137.06"
,IN,AP,40002083,9000,900,,Invoice,,,,,SB,30/04/2018,30/04/2018,46.80,,0.00,,"4,183.86"
,IN,AP,40002176,9000,900,,Invoice,,,,,SB,16/05/2018,16/05/2018,74.88,,0.00,,"4,258.74"
,IN,AP,40002179,9000,900,,Invoice,,,,,SB,17/05/2018,17/05/2018,28.08,,0.00,,"4,286.82"
,IN,AP,40002183,9000,900,,Invoice,,,,,SB,21/05/2018,21/05/2018,46.80,,0.00,,"4,333.62"
,IN,AP,40002229,9000,900,,Invoice,,,,,SB,28/05/2018,28/05/2018,28.08,,0.00,,"4,361.70"
,IN,AP,40002234,9000,900,,Invoice,,,,,SB,31/05/2018,31/05/2018,28.08,,0.00,,"4,389.78"
,IN,AP,40002241,9000,900,,Invoice,,,,,SB,05/06/2018,05/06/2018,28.08,,0.00,,"4,417.86"
,IN,AP,40002242,9000,900,,Invoice,,,,,SB,06/06/2018,06/06/2018,35.10,,0.00,,"4,452.96"
,IN,AP,40002265,9000,900,,Invoice,,,,,SB,18/06/2018,18/06/2018,46.80,,0.00,,"4,499.76"
,IN,AP,40002292,9000,900,,Invoice,,,,,SB,20/06/2018,20/06/2018,28.08,,0.00,,"4,527.84"
,IN,AP,40002295,9000,900,,Invoice,,,,,SB,21/06/2018,21/06/2018,28.08,,0.00,,"4,555.92"
,IN,AP,40002311,9000,900,,Invoice,,,,,SB,27/06/2018,27/06/2018,45.24,,0.00,,"4,601.16"
,IN,AP,40002361,9000,900,,Invoice,,,,,SB,06/07/2018,06/07/2018,28.08,,0.00,,"4,629.24"
,IN,AP,40002367,9000,900,,Invoice,,,,,SB,10/07/2018,10/07/2018,46.02,,0.00,,"4,675.26"
,IN,AP,40002599,9000,900,,Invoice,,,,,SB,09/08/2018,09/08/2018,28.08,,0.00,,"4,703.34"
,IN,AP,40002607,9000,900,,Invoice,,,,,SB,15/08/2018,15/08/2018,"2,700.00",,0.00,,"7,403.34"
,IN,AP,40002610,9000,900,,Invoice,,,,,SB,15/08/2018,15/08/2018,97.50,,0.00,,"7,500.84"
,IN,AP,40002627,9000,900,,Invoice,,,,,SB,24/08/2018,24/08/2018,46.80,,0.00,,"7,547.64"
,IN,AP,40002631,9000,900,,Invoice,,,,,SB,28/08/2018,28/08/2018,28.08,,0.00,,"7,575.72"
,IN,AP,40002664,9000,900,,Production for 010918,,,,,SB,01/09/2018,01/09/2018,14.04,,0.00,,"7,589.76"
,IN,AP,40002667,9000,900,,Production for 030918,,,,,SB,03/09/2018,03/09/2018,46.80,,0.00,,"7,636.56"
,IN,AP,40002678,9000,900,,Production for 100918,,,,,SB,10/09/2018,10/09/2018,61.62,,0.00,,"7,698.18"
,IN,AP,40002689,9000,900,,Production for 140918,,,,,SB,14/09/2018,14/09/2018,31.20,,0.00,,"7,729.38"
,IN,AP,40002693,9000,900,,Production for 170918,,,,,SB,17/09/2018,17/09/2018,58.50,,0.00,,"7,787.88"
,IN,AP,40002705,9000,900,,Production for 250918,,,,,SB,25/09/2018,25/09/2018,58.50,,0.00,,"7,846.38"
,IN,AP,40002714,9000,900,,Production for 290918,,,,,SB,29/09/2018,29/09/2018,43.68,,0.00,,"7,890.06"
,IN,AP,40002978,9000,900,,Production for 031018,,,,,SB,03/10/2018,03/10/2018,14.82,,0.00,,"7,904.88"
,IN,AP,40002980,9000,900,,Production for 041018,,,,,SB,04/10/2018,04/10/2018,24.18,,0.00,,"7,929.06"
,IN,AP,40002987,9000,900,,Production for 061018,,,,,SB,06/10/2018,06/10/2018,15.60,,0.00,,"7,944.66"
,IN,AP,40002996,9000,900,,Production for 101018,,,03/10/2018,,SB,10/10/2018,10/10/2018,4.68,,0.00,,"7,949.34"
,IN,AP,40002999,9000,900,,Production for 111018,,,04/10/2018,,SB,11/10/2018,11/10/2018,23.40,,0.00,,"7,972.74"
,IN,AP,40003006,9000,900,,Production for 151018,,,08/10/2018,,SB,15/10/2018,15/10/2018,4.68,,0.00,,"7,977.42"
,IN,AP,40003007,9000,900,,Production for 161018,,,10/10/2018,,SB,16/10/2018,16/10/2018,21.84,,0.00,,"7,999.26"
,IN,AP,40003013,9000,900,,Production for 191018,,,11/10/2018,,SB,19/10/2018,19/10/2018,7.80,,0.00,,"8,007.06"
,IN,AP,40003018,9000,900,,Production for 201018,,,12/10/2018,,SB,20/10/2018,20/10/2018,24.18,,0.00,,"8,031.24"
,IN,AP,40003023,9000,900,,Production for 241018,,,15/10/2018,,SB,24/10/2018,24/10/2018,21.84,,0.00,,"8,053.08"
,IN,AP,40003029,9000,900,,Production for 271018,,,18/10/2018,,SB,27/10/2018,27/10/2018,18.72,,0.00,,"8,071.80"
,IN,AP,40003034,9000,900,,Production for 291018,,,19/10/2018,,SB,29/10/2018,29/10/2018,3.12,,0.00,,"8,074.92"
,IN,AP,40003035,9000,900,,Production for 301018,,,20/10/2018,,SB,30/10/2018,30/10/2018,20.28,,0.00,,"8,095.20"
,IN,AP,40003039,9000,900,,Production for 011118,,,23/10/2018,,SB,01/11/2018,01/11/2018,17.16,,0.00,,"8,112.36"
,IN,AP,40003042,9000,900,,Production for 031118,,,24/10/2018,,SB,03/11/2018,03/11/2018,27.30,,0.00,,"8,139.66"
,IN,AP,40003049,9000,900,,Production for 081118,,,29/10/2018,,SB,08/11/2018,08/11/2018,2.34,,0.00,,"8,142.00"
,IN,AP,40003053,9000,900,,Production for 091118,,,29/10/2018,,SB,09/11/2018,09/11/2018,24.96,,0.00,,"8,166.96"
,IN,AP,40003058,9000,900,,Production for 131118,,,01/11/2018,,SB,13/11/2018,13/11/2018,29.64,,0.00,,"8,196.60"
,IN,AP,40003060,9000,900,,Production for 151118,,,03/11/2018,,SB,15/11/2018,15/11/2018,12.48,,0.00,,"8,209.08"
,IN,AP,40003067,9000,900,,Production for 191118,,,09/11/2018,,SB,19/11/2018,19/11/2018,49.92,,0.00,,"8,259.00"
,IN,AP,40003071,9000,900,,Production for 201118,,,09/11/2018,,SB,20/11/2018,20/11/2018,78.66,,0.00,,"8,337.66"
,IN,AP,40002907,9000,900,,Production for 231118,,,,,SB,23/11/2018,23/11/2018,42.90,,0.00,,"8,380.56"
,IN,AP,40002915,9000,900,,Production for 281118,,,,,SB,28/11/2018,28/11/2018,27.30,,0.00,,"8,407.86"
,IN,AP,40002927,9000,900,,Production for 051218,,,,,SB,05/12/2018,05/12/2018,41.34,,0.00,,"8,449.20"
,IN,AP,40002942,9000,900,,Production for 131218,,,,,SB,13/12/2018,13/12/2018,6.24,,0.00,,"8,455.44"
,IN,AP,40002946,9000,900,,Production for 151218,,,,,SB,15/12/2018,15/12/2018,28.08,,0.00,,"8,483.52"
,IN,AP,40002959,9000,900,,Production for 201218,,,,,SB,20/12/2018,20/12/2018,60.84,,0.00,,"8,544.36"
,IN,AP,40002969,9000,900,,Production for 271218,,,,,SB,27/12/2018,27/12/2018,25.74,,0.00,,"8,570.10"
,,,,,,,,,,,,,,,,,,,
,Account: 1100120 - Purchases - 5ltr Water,,,,,,,,,,,,,,,,,,
,Pr.,Mod.,Reference,Dept,Div,Suffix,Details,,,Cheque,,User,Doc Date,Post Date,Debit,,Credit,,Balance
,IN,AP,40001977,9000,900,,Invoice,,,,,SB,27/02/2018,27/02/2018,168.00,,0.00,,168.00
,IN,AP,40002245,9000,900,,Invoice,,,,,SB,07/06/2018,07/06/2018,252.00,,0.00,,420.00
,IN,AP,40002248,9000,900,,Invoice,,,,,SB,08/06/2018,08/06/2018,228.00,,0.00,,648.00
,IN,AP,40002319,9000,900,,Invoice,,,,,SB,02/07/2018,02/07/2018,336.00,,0.00,,984.00
,IN,AP,40002440,9000,900,,Invoice,,,,,SB,17/07/2018,17/07/2018,336.00,,0.00,,"1,320.00"
,IN,AP,40002461,9000,900,,Invoice,,,,,SB,30/07/2018,30/07/2018,420.00,,0.00,,"1,740.00"
,IN,AP,40002464,9000,900,,Invoice,,,,,SB,31/07/2018,31/07/2018,588.00,,0.00,,"2,328.00"
,IN,AP,40002634,9000,900,,Invoice,,,,,SB,29/08/2018,29/08/2018,924.00,,0.00,,"3,252.00"
,IN,AP,40002982,9000,900,,Production for 041018,,,,,SB,04/10/2018,04/10/2018,64.00,,0.00,,"3,316.00"
,,,,,,,,,,,,,,,,,,,
,Account: 1100121 - Purchases - Excise,,,,,,,,,,,,,,,,,,
,Pr.,Mod.,Reference,Dept,Div,Suffix,Details,,,Cheque,,User,Doc Date,Post Date,Debit,,Credit,,Balance
,,,,,,Opening Balance as at :01/01/2018,,,,,,,,,0.00,,0.00,,0.00
,IN,AP,40001812,9000,900,,Invoice,,,,,SB,31/01/2018,31/01/2018,522.00,,0.00,,522.00
,,,,,,,,,,,,,,,,,,,
,Account: 1100130 - Purchases - 2ltr Water,,,,,,,,,,,,,,,,,,
,Pr.,Mod.,Reference,Dept,Div,Suffix,Details,,,Cheque,,User,Doc Date,Post Date,Debit,,Credit,,Balance
,IN,AP,40001938,9000,900,,Invoice,,,,,SB,28/01/2018,28/01/2018,"1,258.50",,0.00,,"1,258.50"
,,,,,,,,,,,,,,,,,,,
,IN,AP,40001948,9000,900,,Invoice,,,,,SB,03/02/2018,03/02/2018,"3,618.18",,0.00,,"4,876.68"
,IN,AP,40001983,9000,900,,Invoice,,,,,SB,05/03/2018,05/03/2018,865.22,,0.00,,"5,741.90"
,IN,AP,40001985,9000,900,,Invoice,,,,,SB,06/03/2018,06/03/2018,"1,101.18",,0.00,,"6,843.08"
,IN,AP,40001990,9000,900,,Invoice,,,,,SB,09/03/2018,09/03/2018,"1,883.39",,0.00,,"8,726.47"
,IN,AP,40002000,9000,900,,Invoice,,,,,SB,21/03/2018,21/03/2018,943.87,,0.00,,"9,670.34"
,IN,AP,40002018,9000,900,,Invoice,,,,,SB,07/04/2018,07/04/2018,"4,483.39",,0.00,,"14,153.73"
,IN,AP,40002020,9000,900,,Invoice,,,,,SB,08/04/2018,08/04/2018,235.97,,0.00,,"14,389.70"
,IN,AP,40002032,9000,900,,Invoice,,,,,SB,16/04/2018,16/04/2018,"2,988.93",,0.00,,"17,378.63"
,IN,AP,40002035,9000,900,,Invoice,,,,,SB,18/04/2018,18/04/2018,"2,988.93",,0.00,,"20,367.56"
,IN,AP,40002071,9000,900,,Invoice,,,,,SB,24/04/2018,24/04/2018,707.90,,0.00,,"21,075.46"
,IN,AP,40002074,9000,900,,Invoice,,,,,SB,25/04/2018,25/04/2018,78.66,,0.00,,"21,154.12"
,IN,AP,40002170,9000,900,,Invoice,,,,,SB,10/05/2018,10/05/2018,786.56,,0.00,,"21,940.68"
,IN,AP,40002172,9000,900,,Invoice,,,,,SB,12/05/2018,12/05/2018,"5,820.54",,0.00,,"27,761.22"
,IN,AP,40002236,9000,900,,Invoice,,,,,SB,01/06/2018,01/06/2018,"1,730.43",,0.00,,"29,491.65"
,IN,AP,40002244,9000,900,,Invoice,,,,,SB,06/06/2018,06/06/2018,78.66,,0.00,,"29,570.31"
,IN,AP,40002293,9000,900,,Invoice,,,,,SB,20/06/2018,20/06/2018,78.66,,0.00,,"29,648.97"
,IN,AP,40002298,9000,900,,Invoice,,,,,SB,25/06/2018,25/06/2018,"5,112.64",,0.00,,"34,761.61"
,IN,AP,40002309,9000,900,,Invoice,,,,,SB,26/06/2018,26/06/2018,"4,247.42",,0.00,,"39,009.03"
,IN,AP,40002363,9000,900,,Invoice,,,,,SB,07/07/2018,07/07/2018,"4,090.11",,0.00,,"43,099.14"
,IN,AP,40002368,9000,900,,Invoice,,,,,SB,10/07/2018,10/07/2018,"2,438.34",,0.00,,"45,537.48"
,IN,AP,40002436,9000,900,,Invoice,,,,,SB,14/07/2018,14/07/2018,"3,382.21",,0.00,,"48,919.69"
,IN,AP,40002451,9000,900,,Invoice,,,,,SB,24/07/2018,24/07/2018,"3,303.55",,0.00,,"52,223.24"
,IN,AP,40002456,9000,900,,Invoice,,,,,SB,26/07/2018,26/07/2018,"1,887.74",,0.00,,"54,110.98"
,IN,AP,40002458,9000,900,,Invoice,,,,,SB,28/07/2018,28/07/2018,"4,090.11",,0.00,,"58,201.09"
,IN,AP,40002468,9000,900,,Invoice,,,,,SB,03/08/2018,03/08/2018,78.66,,0.00,,"58,279.75"
,IN,AP,40002471,9000,900,,Invoice,,,,,SB,04/08/2018,04/08/2018,"4,011.46",,0.00,,"62,291.21"
,IN,AP,40002600,9000,900,,Invoice,,,,,SB,09/08/2018,09/08/2018,"1,887.74",,0.00,,"64,178.95"
,IN,AP,40002606,9000,900,,Invoice,,,,,SB,14/08/2018,14/08/2018,"1,887.74",,0.00,,"66,066.69"
,IN,AP,40002609,9000,900,,Invoice,,,,,SB,15/08/2018,15/08/2018,"2,752.96",,0.00,,"68,819.65"
,IN,AP,40002622,9000,900,,Invoice,,,,,SB,22/08/2018,22/08/2018,"2,674.30",,0.00,,"71,493.95"
,IN,AP,40002624,9000,900,,Invoice,,,,,SB,23/08/2018,23/08/2018,"1,730.00",,0.00,,"73,223.95"
,IN,AP,40002636,9000,900,,Invoice,,,,,SB,30/08/2018,30/08/2018,"2,595.65",,0.00,,"75,819.60"
,IN,AP,40002670,9000,900,,Production for 030918,,,,,SB,03/09/2018,03/09/2018,"3,382.21",,0.00,,"79,201.81"
,CN,AP,41000087,9000,900,,Customer Return,,,,,SB,04/09/2018,04/09/2018,0.00,,39.33,,"79,162.48"
,CN,AP,41000088,9000,900,,Customer Return,,,,,SB,07/09/2018,07/09/2018,0.00,,78.66,,"79,083.82"
,IN,AP,40002679,9000,900,,Production for 110918,,,,,SB,11/09/2018,11/09/2018,"4,090.11",,0.00,,"83,173.93"
,IN,AP,40002684,9000,900,,Production for 120918,,,,,SB,12/09/2018,12/09/2018,78.66,,0.00,,"83,252.59"
,IN,AP,40002694,9000,900,,Production for 170918,,,,,SB,17/09/2018,17/09/2018,"4,168.77",,0.00,,"87,421.36"
,IN,AP,40002697,9000,900,,Production for 190918,,,,,SB,19/09/2018,19/09/2018,"4,640.70",,0.00,,"92,062.06"
,IN,AP,40002701,9000,900,,Production for 210918,,,,,SB,21/09/2018,21/09/2018,78.66,,0.00,,"92,140.72"
,CN,AP,41000091,9000,900,,Customer Return Nectar,,,,,SB,27/09/2018,27/09/2018,0.00,,78.66,,"92,062.06"
,IN,AP,40002984,9000,900,,Production for 051018,,,,,SB,05/10/2018,05/10/2018,"1,809.09",,0.00,,"93,871.15"
,CN,AP,41000094,9000,900,,Customer Return Richard GBS948,,,,,SB,06/10/2018,06/10/2018,0.00,,78.66,,"93,792.49"
,IN,AP,40002992,9000,900,,Production for 081018,,,01/10/2018,,SB,09/10/2018,09/10/2018,"2,438.34",,0.00,,"96,230.83"
,CN,AP,41000096,9000,900,,Customer Return Zebbug Philip IBX943,,,03/10/2018,,SB,10/10/2018,10/10/2018,0.00,,78.66,,"96,152.17"
,IN,AP,40002994,9000,900,,Production for 101018,,,04/10/2018,,SB,10/10/2018,10/10/2018,"4,876.67",,0.00,,"101,028.84"
,CN,AP,41000099,9000,900,,Customer Return Nectar,,,05/10/2018,,SB,12/10/2018,12/10/2018,0.00,,78.66,,"100,950.18"
,IN,AP,40003002,9000,900,,Production for 131018,,,08/10/2018,,SB,13/10/2018,13/10/2018,157.31,,0.00,,"101,107.49"
,IN,AP,40003009,9000,900,,Production for 171018,,,10/10/2018,,SB,17/10/2018,17/10/2018,"4,011.46",,0.00,,"105,118.95"
,IN,AP,40003010,9000,900,,Production for 181018,,,11/10/2018,,SB,18/10/2018,18/10/2018,"3,382.21",,0.00,,"108,501.16"
,IN,AP,40003016,9000,900,,Production for 191018,,,12/10/2018,,SB,19/10/2018,19/10/2018,550.59,,0.00,,"109,051.75"
,IN,AP,40003021,9000,900,,Production for 231018,,,13/10/2018,,SB,23/10/2018,23/10/2018,"2,281.02",,0.00,,"111,332.77"
,CN,AP,41000103,9000,900,,Customer Return Richard BBW476,,,17/10/2018,,SB,26/10/2018,26/10/2018,0.00,,157.31,,"111,175.46"
,IN,AP,40003031,9000,900,,Production for 291018,,,19/10/2018,,SB,29/10/2018,29/10/2018,157.31,,0.00,,"111,332.77"
,IN,AP,40003038,9000,900,,Production for 311018,,,22/10/2018,,SB,31/10/2018,31/10/2018,"4,483.39",,0.00,,"115,816.16"
,CN,AP,41000104,9000,900,,Customer Return Richard BBW-476,,,29/10/2018,,SB,09/11/2018,09/11/2018,0.00,,78.66,,"115,737.50"
,IN,AP,40002917,9000,900,,Production for 281118,,,,,SB,28/11/2018,28/11/2018,"2,359.68",,0.00,,"118,097.18"
,IN,AP,40002950,9000,900,,Production for 161218,,,,,SB,16/12/2018,16/12/2018,"1,573.12",,0.00,,"119,670.30"
,IN,AP,40002953,9000,900,,Production for 181218,,,,,SB,18/12/2018,18/12/2018,"1,844.80",,0.00,,"121,515.10"
,IN,AP,40002954,9000,900,,Production for 181218,,,,,SB,18/12/2018,18/12/2018,"1,651.78",,0.00,,"123,166.88"
,IN,AP,40002964,9000,900,,Production for 221218,,,,,SB,22/12/2018,22/12/2018,"1,258.50",,0.00,,"124,425.38"
,,,,,,,,,,,,,,,,,,,
,Account: 1100140 - Purchases - PAVI 2ltr Water,,,,,,,,,,,,,,,,,,
,Pr.,Mod.,Reference,Dept,Div,Suffix,Details,,,Cheque,,User,Doc Date,Post Date,Debit,,Credit,,Balance
,IN,AP,40002001,9000,900,,Invoice,,,,,SB,21/03/2018,21/03/2018,"1,076.22",,0.00,,"1,076.22"
,IN,AP,40002019,9000,900,,Invoice,,,,,SB,07/04/2018,07/04/2018,403.58,,0.00,,"1,479.80"
,IN,AP,40002021,9000,900,,Invoice,,,,,SB,08/04/2018,08/04/2018,"3,295.94",,0.00,,"4,775.74"
,IN,AP,40002024,9000,900,,Invoice,,,,,SB,10/04/2018,10/04/2018,"2,085.18",,0.00,,"6,860.92"
,IN,AP,40002026,9000,900,,Invoice,,,,,SB,11/04/2018,11/04/2018,"2,152.45",,0.00,,"9,013.37"
,IN,AP,40002029,9000,900,,Invoice,,,,,SB,14/04/2018,14/04/2018,"7,197.25",,0.00,,"16,210.62"
,IN,AP,40002073,9000,900,,Invoice,,,,,SB,25/04/2018,25/04/2018,"1,748.86",,0.00,,"17,959.48"
,IN,AP,40002076,9000,900,,Invoice,,,,,SB,26/04/2018,26/04/2018,"1,076.22",,0.00,,"19,035.70"
,IN,AP,40002078,9000,900,,Invoice,,,,,SB,27/04/2018,27/04/2018,"1,748.86",,0.00,,"20,784.56"
,IN,AP,40002079,9000,900,,Invoice,,,,,SB,28/04/2018,28/04/2018,"4,641.22",,0.00,,"25,425.78"
,IN,AP,40002084,9000,900,,Invoice,,,,,SB,01/05/2018,01/05/2018,"1,143.49",,0.00,,"26,569.27"
,IN,AP,40002087,9000,900,,Invoice,,,,,SB,04/05/2018,04/05/2018,"3,699.52",,0.00,,"30,268.79"
,IN,AP,40002164,9000,900,,Invoice,,,,,SB,05/05/2018,05/05/2018,"5,033.98",,0.00,,"35,302.77"
,IN,AP,40002189,9000,900,,Invoice,,,,,SB,07/05/2018,07/05/2018,"1,479.81",,0.00,,"36,782.58"
,IN,AP,40002168,9000,900,,Invoice,,,,,SB,09/05/2018,09/05/2018,"3,026.88",,0.00,,"39,809.46"
,IN,AP,40002177,9000,900,,Invoice,,,,,SB,16/05/2018,16/05/2018,134.53,,0.00,,"39,943.99"
,IN,AP,40002181,9000,900,,Invoice,,,,,SB,18/05/2018,18/05/2018,"2,690.56",,0.00,,"42,634.55"
,IN,AP,40002184,9000,900,,Invoice,,,,,SB,21/05/2018,21/05/2018,"2,825.09",,0.00,,"45,459.64"
,IN,AP,40002187,9000,900,,Invoice,,,,,SB,23/05/2018,23/05/2018,"1,278.02",,0.00,,"46,737.66"
,IN,AP,40002191,9000,900,,Invoice,,,,,SB,25/05/2018,25/05/2018,"2,959.62",,0.00,,"49,697.28"
,IN,AP,40002231,9000,900,,Invoice,,,,,SB,29/05/2018,29/05/2018,"3,497.73",,0.00,,"53,195.01"
,IN,AP,40002237,9000,900,,Invoice,,,,,SB,01/06/2018,01/06/2018,"2,085.18",,0.00,,"55,280.19"
,IN,AP,40002313,9000,900,,Invoice,,,,,SB,27/06/2018,27/06/2018,"2,152.45",,0.00,,"57,432.64"
,IN,AP,40002315,9000,900,,Invoice,,,,,SB,29/06/2018,29/06/2018,"4,439.42",,0.00,,"61,872.06"
,IN,AP,40002316,9000,900,,Invoice,,,,,SB,30/06/2018,30/06/2018,"3,699.52",,0.00,,"65,571.58"
,IN,AP,40002321,9000,900,,Invoice,,,,,SB,03/07/2018,03/07/2018,"1,681.60",,0.00,,"67,253.18"
,IN,AP,40002357,9000,900,,Invoice,,,,,SB,05/07/2018,05/07/2018,"2,152.45",,0.00,,"69,405.63"
,IN,AP,40002358,9000,900,,Invoice,,,,,SB,05/07/2018,05/07/2018,336.32,,0.00,,"69,741.95"
,IN,AP,40002362,9000,900,,Invoice,,,,,SB,06/07/2018,06/07/2018,"3,834.05",,0.00,,"73,576.00"
,IN,AP,40002438,9000,900,,Invoice,,,,,SB,16/07/2018,16/07/2018,"4,304.90",,0.00,,"77,880.90"
,IN,AP,40002442,9000,900,,Invoice,,,,,SB,17/07/2018,17/07/2018,672.64,,0.00,,"78,553.54"
,IN,AP,40002448,9000,900,,Invoice,,,,,SB,21/07/2018,21/07/2018,"2,488.77",,0.00,,"81,042.31"
,IN,AP,40002452,9000,900,,Invoice,,,,,SB,24/07/2018,24/07/2018,67.26,,0.00,,"81,109.57"
,IN,AP,40002470,9000,900,,Invoice,,,,,SB,03/08/2018,03/08/2018,"2,421.50",,0.00,,"83,531.07"
,IN,AP,40002472,9000,900,,Invoice,,,,,SB,04/08/2018,04/08/2018,269.06,,0.00,,"83,800.13"
,IN,AP,40002473,9000,900,,Invoice,,,,,SB,05/08/2018,05/08/2018,"3,094.14",,0.00,,"86,894.27"
,IN,AP,40002604,9000,900,,Invoice,,,,,SB,13/08/2018,13/08/2018,"2,959.62",,0.00,,"89,853.89"
,IN,AP,40002608,9000,900,,Invoice,,,,,SB,15/08/2018,15/08/2018,"2,085.18",,0.00,,"91,939.07"
,IN,AP,40002611,9000,900,,Invoice,,,,,SB,16/08/2018,16/08/2018,78.66,,0.00,,"92,017.73"
,IN,AP,40002614,9000,900,,Invoice,,,,,SB,17/08/2018,17/08/2018,941.70,,0.00,,"92,959.43"
,IN,AP,40002616,9000,900,,Invoice,,,,,SB,18/08/2018,18/08/2018,"2,556.03",,0.00,,"95,515.46"
,IN,AP,40002619,9000,900,,Invoice,,,,,SB,20/08/2018,20/08/2018,"3,564.99",,0.00,,"99,080.45"
,IN,AP,40002625,9000,900,,Invoice,,,,,SB,23/08/2018,23/08/2018,"2,892.35",,0.00,,"101,972.80"
,IN,AP,40002629,9000,900,,Invoice,,,,,SB,26/08/2018,26/08/2018,"3,968.58",,0.00,,"105,941.38"
,IN,AP,40002635,9000,900,,Invoice,,,,,SB,30/08/2018,30/08/2018,"1,614.34",,0.00,,"107,555.72"
,IN,AP,40002639,9000,900,,Invoice,,,,,SB,31/08/2018,31/08/2018,"3,228.67",,0.00,,"110,784.39"
,IN,AP,40002665,9000,900,,Production for 010918,,,,,SB,01/09/2018,01/09/2018,"4,103.10",,0.00,,"114,887.49"
,IN,AP,40002669,9000,900,,Production for 030918,,,,,SB,03/09/2018,03/09/2018,"1,950.66",,0.00,,"116,838.15"
,IN,AP,40002676,9000,900,,Production for 080918,,,,,SB,08/09/2018,08/09/2018,"5,381.12",,0.00,,"122,219.27"
,IN,AP,40002681,9000,900,,Production for 110918,,,,,SB,11/09/2018,11/09/2018,"1,681.60",,0.00,,"123,900.87"
,CN,AP,41000089,9000,900,,Customer Return,,,,,SB,12/09/2018,12/09/2018,0.00,,45.19,,"123,855.68"
,IN,AP,40002683,9000,900,,Production for 120918,,,,,SB,12/09/2018,12/09/2018,"3,228.67",,0.00,,"127,084.35"
,IN,AP,40002686,9000,900,,Production for 130918,,,,,SB,13/09/2018,13/09/2018,"2,623.30",,0.00,,"129,707.65"
,IN,AP,40002688,9000,900,,Production for 140918,,,,,SB,14/09/2018,14/09/2018,"3,901.31",,0.00,,"133,608.96"
,IN,AP,40002690,9000,900,,Production for 160918,,,,,SB,16/09/2018,16/09/2018,"5,044.80",,0.00,,"138,653.76"
,IN,AP,40002700,9000,900,,Production for 210918,,,,,SB,21/09/2018,21/09/2018,"4,843.01",,0.00,,"143,496.77"
,CN,AP,41000090,9000,900,,Customer Return Pama Mosta,,,,,SB,22/09/2018,22/09/2018,0.00,,37.84,,"143,458.93"
,IN,AP,40002702,9000,900,,Production for 220918,,,,,SB,22/09/2018,22/09/2018,"4,910.27",,0.00,,"148,369.20"
,IN,AP,40002706,9000,900,,Production for 250918,,,,,SB,25/09/2018,25/09/2018,"3,564.99",,0.00,,"151,934.19"
,IN,AP,40002707,9000,900,,Production for 260918,,,,,SB,26/09/2018,26/09/2018,"2,825.09",,0.00,,"154,759.28"
,IN,AP,40002710,9000,900,,Production for 270918,,,,,SB,27/09/2018,27/09/2018,"3,564.99",,0.00,,"158,324.27"
,IN,AP,40002711,9000,900,,Production for 280918,,,,,SB,28/09/2018,28/09/2018,"2,818.78",,0.00,,"161,143.05"
,CN,AP,41000092,9000,900,,Customer Return Pama Mosta,,,,,SB,29/09/2018,29/09/2018,0.00,,24.17,,"161,118.88"
,IN,AP,40002974,9000,900,,Production for 011018,,,,,SB,01/10/2018,01/10/2018,"2,825.09",,0.00,,"163,943.97"
,IN,AP,40002976,9000,900,,Production for 021018,,,,,SB,02/10/2018,02/10/2018,"3,094.14",,0.00,,"167,038.11"
,IN,AP,40002979,9000,900,,Production for 031018,,,,,SB,03/10/2018,03/10/2018,"2,488.77",,0.00,,"169,526.88"
,IN,AP,40002983,9000,900,,Production for 041018,,,,,SB,04/10/2018,04/10/2018,672.64,,0.00,,"170,199.52"
,IN,AP,40002986,9000,900,,Production for 051018,,,,,SB,05/10/2018,05/10/2018,807.17,,0.00,,"171,006.69"
,IN,AP,40002989,9000,900,,Production for 061018,,,,,SB,07/10/2018,07/10/2018,"4,237.63",,0.00,,"175,244.32"
,CN,AP,41000095,9000,900,,Customer Return Pama Mosta,,,,,SB,08/10/2018,08/10/2018,0.00,,35.73,,"175,208.59"
,IN,AP,40002990,9000,900,,Production for 071018,,,01/10/2018,,SB,08/10/2018,08/10/2018,"3,766.78",,0.00,,"178,975.37"
,CN,AP,41000097,9000,900,,Customer Return Pama Mosta,,,04/10/2018,,SB,11/10/2018,11/10/2018,0.00,,9.46,,"178,965.91"
,IN,AP,40002997,9000,900,,Production for 111018,,,05/10/2018,,SB,11/10/2018,11/10/2018,"3,775.49",,0.00,,"182,741.40"
,IN,AP,40003000,9000,900,,Production for 121018,,,06/10/2018,,SB,12/10/2018,12/10/2018,"2,690.56",,0.00,,"185,431.96"
,CN,AP,41000100,9000,900,,Customer Return Pama Mosta,,,07/10/2018,,SB,13/10/2018,13/10/2018,0.00,,7.36,,"185,424.60"
,IN,AP,40003004,9000,900,,Production for 151018,,,09/10/2018,,SB,15/10/2018,15/10/2018,"3,497.73",,0.00,,"188,922.33"
,CN,AP,41000102,9000,900,,Customer Return Pama Mosta,,,10/10/2018,,SB,18/10/2018,18/10/2018,0.00,,15.76,,"188,906.57"
,IN,AP,40003011,9000,900,,Production for 181018,,,11/10/2018,,SB,18/10/2018,18/10/2018,"1,547.07",,0.00,,"190,453.64"
,IN,AP,40003015,9000,900,,Production for 191018,,,12/10/2018,,SB,19/10/2018,19/10/2018,"1,816.13",,0.00,,"192,269.77"
,IN,AP,40003024,9000,900,,Production for 241018,,,15/10/2018,,SB,24/10/2018,24/10/2018,"3,901.31",,0.00,,"196,171.08"
,IN,AP,40003026,9000,900,,Production for 251018,,,16/10/2018,,SB,25/10/2018,25/10/2018,"2,488.77",,0.00,,"198,659.85"
,IN,AP,40003028,9000,900,,Production for 261018,,,18/10/2018,,SB,26/10/2018,26/10/2018,"3,901.31",,0.00,,"202,561.16"
,IN,AP,40003032,9000,900,,Production for 291018,,,19/10/2018,,SB,29/10/2018,29/10/2018,"2,959.62",,0.00,,"205,520.78"
,IN,AP,40003044,9000,900,,Production for 051118,,,26/10/2018,,SB,05/11/2018,05/11/2018,"3,968.58",,0.00,,"209,489.36"
,IN,AP,40003048,9000,900,,Production for 071118,,,26/10/2018,,SB,07/11/2018,07/11/2018,"3,548.00",,0.00,,"213,037.36"
,IN,AP,40003052,9000,900,,Production for 091118,,,29/10/2018,,SB,09/11/2018,09/11/2018,"1,408.00",,0.00,,"214,445.36"
,IN,AP,40003056,9000,900,,Production for 121118,,,31/10/2018,,SB,12/11/2018,12/11/2018,"4,288.00",,0.00,,"218,733.36"
,CN,AP,41000105,9000,900,,Customer Return Pama,,,01/11/2018,,SB,13/11/2018,13/11/2018,0.00,,11.00,,"218,722.36"
,IN,AP,40003063,9000,900,,Production for 161118,,,05/11/2018,,SB,16/11/2018,16/11/2018,"2,112.00",,0.00,,"220,834.36"
,IN,AP,40003064,9000,900,,Production for 171118,,,07/11/2018,,SB,17/11/2018,17/11/2018,"4,224.00",,0.00,,"225,058.36"
,IN,AP,40003069,9000,900,,Production for 191118,,,08/11/2018,,SB,19/11/2018,19/11/2018,"2,496.00",,0.00,,"227,554.36"
,IN,AP,40003072,9000,900,,Production for 201118,,,09/11/2018,,SB,20/11/2018,20/11/2018,"3,584.00",,0.00,,"231,138.36"
,IN,AP,40003074,9000,900,,Production for 211118,,,12/11/2018,,SB,21/11/2018,21/11/2018,"3,200.00",,0.00,,"234,338.36"
,IN,AP,40003075,9000,900,,Production for 211118,,,12/11/2018,,SB,21/11/2018,21/11/2018,512.00,,0.00,,"234,850.36"
,IN,AP,40003077,9000,900,,Production for 221118,,,13/11/2018,,SB,22/11/2018,22/11/2018,"3,904.00",,0.00,,"238,754.36"
,IN,AP,40002908,9000,900,,Production for 231118,,,,,SB,23/11/2018,23/11/2018,"3,904.00",,0.00,,"242,658.36"
,CN,AP,41000106,9000,900,,Customer Return Pama,,,14/11/2018,,SB,23/11/2018,23/11/2018,0.00,,34.00,,"242,624.36"
,IN,AP,40002911,9000,900,,Production for 261118,,,,,SB,26/11/2018,26/11/2018,"3,712.00",,0.00,,"246,336.36"
,IN,AP,40002912,9000,900,,Production for 271118,,,,,SB,27/11/2018,27/11/2018,"4,928.00",,0.00,,"251,264.36"
,IN,AP,40002916,9000,900,,Production for 281118,,,,,SB,28/11/2018,28/11/2018,"1,216.00",,0.00,,"252,480.36"
,IN,AP,40002919,9000,900,,Production for 301118,,,,,SB,30/11/2018,30/11/2018,"5,568.00",,0.00,,"258,048.36"
,IN,AP,40002924,9000,900,,Production for 041218,,,,,SB,04/12/2018,04/12/2018,"2,816.00",,0.00,,"260,864.36"
,IN,AP,40002925,9000,900,,Production for 051218,,,,,SB,05/12/2018,05/12/2018,"2,944.00",,0.00,,"263,808.36"
,IN,AP,40002929,9000,900,,Production for 061218,,,,,SB,06/12/2018,06/12/2018,"2,496.00",,0.00,,"266,304.36"
,IN,AP,40002931,9000,900,,Production for 071218,,,,,SB,07/12/2018,07/12/2018,"1,728.00",,0.00,,"268,032.36"
,IN,AP,40002933,9000,900,,Production for 081218,,,,,SB,08/12/2018,08/12/2018,"6,080.00",,0.00,,"274,112.36"
,IN,AP,40002935,9000,900,,Production for 101218,,,,,SB,10/12/2018,10/12/2018,704.00,,0.00,,"274,816.36"
,IN,AP,40002936,9000,900,,Production for 101218,,,,,SB,10/12/2018,10/12/2018,"3,200.00",,0.00,,"278,016.36"
,IN,AP,40002937,9000,900,,Production for 111218,,,,,SB,11/12/2018,11/12/2018,"1,920.00",,0.00,,"279,936.36"
,IN,AP,40002939,9000,900,,Production for 121218,,,,,SB,12/12/2018,12/12/2018,"1,472.00",,0.00,,"281,408.36"
,IN,AP,40002941,9000,900,,Production for 131218,,,,,SB,13/12/2018,13/12/2018,"1,856.00",,0.00,,"283,264.36"
,IN,AP,40002947,9000,900,,Production for 151218,,,,,SB,15/12/2018,15/12/2018,"3,648.00",,0.00,,"286,912.36"
,IN,AP,40002949,9000,900,,Production for 161218,,,,,SB,16/12/2018,16/12/2018,"1,920.00",,0.00,,"288,832.36"
,IN,AP,40002951,9000,900,,Production for 171218,,,,,SB,17/12/2018,17/12/2018,"5,568.00",,0.00,,"294,400.36"
,IN,AP,40002955,9000,900,,Production for 181218,,,,,SB,18/12/2018,18/12/2018,"2,240.00",,0.00,,"296,640.36"
,IN,AP,40002958,9000,900,,Production for 191218,,,,,SB,19/12/2018,19/12/2018,"2,240.00",,0.00,,"298,880.36"
,IN,AP,40002961,9000,900,,Production for 201218,,,,,SB,20/12/2018,20/12/2018,"4,160.00",,0.00,,"303,040.36"
,IN,AP,40002965,9000,900,,Production for 221218,,,,,SB,22/12/2018,22/12/2018,"1,280.00",,0.00,,"304,320.36"
,,,,,,,,,,,,,,,,,,,
,Account: 1100300 - Purchases - Aquani Cups,,,,,,,,,,,,,,,,,,
,Pr.,Mod.,Reference,Dept,Div,Suffix,Details,,,Cheque,,User,Doc Date,Post Date,Debit,,Credit,,Balance
,IN,AP,40002327,9000,900,,PLASTIC CUPS CLEAR 200CC,,,,,SB,03/07/2018,03/07/2018,47.09,,0.00,,47.09
,IN,AP,40002328,9000,900,,PLASTIC CUPS CLEAR 200CC,,,,,SB,04/07/2018,04/07/2018,94.18,,0.00,,141.27
,,,,,,,,,,,,,,,,,,,
,Account: 1100400 - Purchases - Coffee,,,,,,,,,,,,,,,,,,
,Pr.,Mod.,Reference,Dept,Div,Suffix,Details,,,Cheque,,User,Doc Date,Post Date,Debit,,Credit,,Balance
,,,,,,Opening Balance as at :01/01/2018,,,,,,,,,0.00,,0.00,,0.00
,IN,AP,40002115,9000,900,,Pellini Top QTY 157 & Decaffe QTY 5,,,,,SB,05/04/2018,05/04/2018,"2,921.97",,0.00,,"2,921.97"
,IN,AP,40002499,9000,900,,126BXS PELLINI TOP 100 CAPSULE (5.05% DISCOUNT),,,,,SB,07/08/2018,07/08/2018,"2,187.19",,0.00,,"5,109.16"
,,,,,,,,,,,,,,,,,,,
,Account: 1100450 - Purchases - Water Equipment,,,,,,,,,,,,,,,,,,
,Pr.,Mod.,Reference,Dept,Div,Suffix,Details,,,Cheque,,User,Doc Date,Post Date,Debit,,Credit,,Balance
,IN,AP,40001826,9000,900,,Invoice,,,,,SB,02/01/2018,02/01/2018,"7,200.00",,0.00,,"7,200.00"
,IN,AP,40001813,9000,900,,Invoice,,,,,SB,05/01/2018,05/01/2018,"26,390.83",,0.00,,"33,590.83"
,IN,AP,40001812,9000,900,,Invoice,,,,,SB,31/01/2018,31/01/2018,0.01,,0.00,,"33,590.84"
,IN,AP,40001833,9000,900,,Invoice,,,,,SB,26/02/2018,26/02/2018,948.96,,0.00,,"34,539.80"
,IN,AP,40002114,9000,900,,"Water Dispensers, Ceramic Dispenser",,,,,SB,25/04/2018,25/04/2018,"27,503.48",,0.00,,"62,043.28"
,,,,,,,,,,,,,,,,,,,
,IN,AP,40002110,9000,900,,113 H/C FREE STANDING CLR,,,,,SB,10/05/2018,10/05/2018,"5,650.00",,0.00,,"67,693.28"
,IN,AP,40002521,9000,900,,Water Dispeners,,,,,SB,10/08/2018,10/08/2018,"14,667.37",,0.00,,"82,360.65"
,IN,AP,40003644,9000,900,,Duty & Vat,,,,,SB,13/08/2018,13/08/2018,0.01,,0.00,,"82,360.66"
,IN,AP,40002522,9000,900,,Stainless Steel Dispensers,,,,,SB,24/08/2018,24/08/2018,"18,192.86",,0.00,,"100,553.52"
,,,,,,,,,,,,,,,,,,,
,Account: 1100500 - Purchases - Chemicals,,,,,,,,,,,,,,,,,,
,Pr.,Mod.,Reference,Dept,Div,Suffix,Details,,,Cheque,,User,Doc Date,Post Date,Debit,,Credit,,Balance
,,,,,,Opening Balance as at :01/01/2018,,,,,,,,,0.00,,0.00,,0.00
,IN,AP,40002157,9000,900,,CO2 X14LTRS &1 CYL RENT,,,,,SB,08/05/2018,08/05/2018,21.89,,0.00,,21.89
,IN,AP,40002306,9000,900,,Co 2,,,,,SB,20/06/2018,20/06/2018,12.02,,0.00,,33.91
,IN,AP,40002535,9000,900,,Co2 Cylinders,,,,,SB,24/08/2018,24/08/2018,16.32,,0.00,,50.23
,IN,AP,40002549,9000,900,,Co2 Cylinders X2,,,,,SB,12/09/2018,12/09/2018,32.65,,0.00,,82.88
,CN,AP,41000086,9000,900,,Co2 Cylinder,,,,,SB,12/09/2018,12/09/2018,0.00,,9.75,,73.13
,IN,AP,40002791,9000,900,,Invoice,,,,,,31/10/2018,31/10/2018,97.96,,0.00,,171.09
,IN,AP,40002792,9000,900,,Invoice,,,,,,06/11/2018,06/11/2018,65.31,,0.00,,236.40
,,,,,,,,,,,,,,,,,,,
,Account: 1100550 - Purchases - Gas Cylinder,,,,,,,,,,,,,,,,,,
,Pr.,Mod.,Reference,Dept,Div,Suffix,Details,,,Cheque,,User,Doc Date,Post Date,Debit,,Credit,,Balance
,IN,AP,40002794,9000,900,,Invoice,,,,,,16/10/2018,16/10/2018,961.48,,0.00,,961.48
,IN,AP,40002795,9000,900,,Invoice,,,,,,20/11/2018,20/11/2018,74.75,,0.00,,"1,036.23"
,IN,AP,40002796,9000,900,,Invoice,,,,,,20/11/2018,20/11/2018,433.44,,0.00,,"1,469.67"
,IN,AP,40002797,9000,900,,Invoice,,,,,,05/12/2018,05/12/2018,478.29,,0.00,,"1,947.96"
,IN,AP,40002798,9000,900,,Invoice,,,,,,14/12/2018,14/12/2018,418.49,,0.00,,"2,366.45"
,IN,AP,40003080,9000,900,,Invoice,,,,,,20/12/2018,20/12/2018,498.14,,0.00,,"2,864.59"
,,,,,,,,,,,,,,,,,,,
,Account: 1400120 - Writeoff,,,,,,,,,,,,,,,,,,
,Pr.,Mod.,Reference,Dept,Div,Suffix,Details,,,Cheque,,User,Doc Date,Post Date,Debit,,Credit,,Balance
,PY,AP,44000355,1001,900,,Settlement Allocations,,,ALLOCATE,,SB,19/06/2018,19/06/2018,44.20,,0.00,,44.20
,,,,,,,,,,,,,,,,,,,
,Account: 1400130 - Advertising And Promotional Expenses,,,,,,,,,,,,,,,,,,
,Pr.,Mod.,Reference,Dept,Div,Suffix,Details,,,Cheque,,User,Doc Date,Post Date,Debit,,Credit,,Balance
,,,,,,Opening Balance as at :01/01/2018,,,,,,,,,0.00,,0.00,,0.00
,IN,AP,40001810,9000,900,,Invoice,,,,,SB,22/03/2018,22/03/2018,"1,047.00",,0.00,,"1,047.00"
,IN,AP,40001832,9000,900,,Invoice,,,,,SB,31/03/2018,31/03/2018,50.00,,0.00,,"1,097.00"
,JN,GL,22000046,1001,100,,Advert - Skolarinu,,,3274,,SB,05/06/2018,05/06/2018,45.00,,0.00,,"1,142.00"
,IN,AP,40002852,9000,900,,Invoice,,,,,,07/07/2018,07/07/2018,483.05,,0.00,,"1,625.05"
,IN,AP,40002651,9000,900,,Photography Pellini & Nimex,,,,,SB,20/09/2018,20/09/2018,300.00,,0.00,,"1,925.05"
,,,,,,,,,,,,,,,,,,,
,,,,,,,,,,,,,,,,,,,
,Account: 1500055 - Gas Cylinder Deposit,,,,,,,,,,,,,,,,,,
,Pr.,Mod.,Reference,Dept,Div,Suffix,Details,,,Cheque,,User,Doc Date,Post Date,Debit,,Credit,,Balance
,IN,AP,40002255,0000,100,,3x Deposit Fibre Cylinders,,,,,SB,02/05/2018,02/05/2018,127.12,,0.00,,127.12
,,,,,,,,,,,,,,,,,,,
,Account: 1501001 - Gozo Delivery Charges,,,,,,,,,,,,,,,,,,
,Pr.,Mod.,Reference,Dept,Div,Suffix,Details,,,Cheque,,User,Doc Date,Post Date,Debit,,Credit,,Balance
,,,,,,Opening Balance as at :01/01/2018,,,,,,,,,0.00,,0.00,,0.00
,IN,AP,40001633,9000,900,,Invoice,,,,,SB,09/01/2018,09/01/2018,33.52,,0.00,,33.52
,IN,AP,40001623,9000,900,,Invoice,,,,,SB,17/01/2018,17/01/2018,33.52,,0.00,,67.04
,IN,AP,40001624,9000,900,,Invoice,,,,,SB,19/01/2018,19/01/2018,33.52,,0.00,,100.56
,IN,AP,40002049,9000,900,,Commission On Delivery 1196 Aquani 18.9ltrs (Jan'18),,,,,SB,31/01/2018,31/01/2018,818.30,,0.00,,918.86
,IN,AP,40001732,9000,900,,Invoice,,,,,SB,12/02/2018,12/02/2018,33.52,,0.00,,952.38
,IN,AP,40001733,9000,900,,Invoice,,,,,SB,17/02/2018,17/02/2018,33.52,,0.00,,985.90
,IN,AP,40001767,9000,900,,Invoice,,,,,SB,23/02/2018,23/02/2018,37.46,,0.00,,"1,023.36"
,IN,AP,40001782,9000,900,,Invoice,,,,,SB,28/02/2018,28/02/2018,33.52,,0.00,,"1,056.88"
,IN,AP,40002057,9000,900,,Commission Delviery 1105 Aquani 18.9ltrs (Feb'18),,,,,SB,28/02/2018,28/02/2018,773.50,,0.00,,"1,830.38"
,IN,AP,40001783,9000,900,,Invoice,,,,,SB,02/03/2018,02/03/2018,33.52,,0.00,,"1,863.90"
,IN,AP,40001784,9000,900,,Invoice,,,,,SB,02/03/2018,02/03/2018,23.64,,0.00,,"1,887.54"
,IN,AP,40001801,9000,900,,Invoice,,,,,SB,10/03/2018,10/03/2018,23.64,,0.00,,"1,911.18"
,IN,AP,40002045,9000,900,,Commission On Delivery For 1050 Aquani 18.9Ltrs (Oct'17),,,,,SB,14/03/2018,14/03/2018,735.00,,0.00,,"2,646.18"
,IN,AP,40002046,9000,900,,Commission On Delivery For 777 Aquani 18.9Ltrs (Nov'17),,,,,SB,14/03/2018,14/03/2018,543.90,,0.00,,"3,190.08"
,IN,AP,40002047,9000,900,,Commission On Delivery For 777 Aquani 18.9Ltrs (Dec'17),,,,,SB,14/03/2018,14/03/2018,543.90,,0.00,,"3,733.98"
,IN,AP,40001802,9000,900,,Invoice,,,,,SB,17/03/2018,17/03/2018,33.52,,0.00,,"3,767.50"
,IN,AP,40001820,9000,900,,Invoice,,,,,SB,24/03/2018,24/03/2018,33.52,,0.00,,"3,801.02"
,IN,AP,40001821,9000,900,,Invoice,,,,,SB,29/03/2018,29/03/2018,33.52,,0.00,,"3,834.54"
,IN,AP,40001829,9000,900,,Invoice,,,,,SB,06/04/2018,06/04/2018,33.52,,0.00,,"3,868.06"
,IN,AP,40002133,9000,900,,Vehicle 6.5-8m & Driver,,,,,SB,13/04/2018,13/04/2018,33.52,,0.00,,"3,901.58"
,IN,AP,40002134,9000,900,,Passanger,,,,,SB,13/04/2018,13/04/2018,3.94,,0.00,,"3,905.52"
,IN,AP,40002135,9000,900,,Vehicle 6.5-8m & Driver,,,,,SB,13/04/2018,13/04/2018,33.52,,0.00,,"3,939.04"
,IN,AP,40002146,9000,900,,Vehicle 6.5m -8m,,,,,SB,20/04/2018,20/04/2018,33.52,,0.00,,"3,972.56"
,IN,AP,40002127,9000,900,,Passenger,,,,,SB,27/04/2018,27/04/2018,3.94,,0.00,,"3,976.50"
,IN,AP,40002128,9000,900,,Vehicle 6.5-8m & Driver,,,,,SB,27/04/2018,27/04/2018,33.52,,0.00,,"4,010.02"
,IN,AP,40002199,9000,900,,Vehicle 5.3-6.5m & Driver,,,,,SB,05/05/2018,05/05/2018,23.64,,0.00,,"4,033.66"
,IN,AP,40002155,9000,900,,Vehicle 6.5m-8m & Driver,,,,,SB,11/05/2018,11/05/2018,33.52,,0.00,,"4,067.18"
,IN,AP,40002156,9000,900,,Vehicle 6.5m-8m & Driver,,,,,SB,12/05/2018,12/05/2018,33.52,,0.00,,"4,100.70"
,IN,AP,40002121,9000,900,,Vehicle 6.5-8m & Driver,,,,,SB,18/05/2018,18/05/2018,33.52,,0.00,,"4,134.22"
,IN,AP,40002122,9000,900,,Standard Fare,,,,,SB,18/05/2018,18/05/2018,3.94,,0.00,,"4,138.16"
,IN,AP,40002205,9000,900,,Vehicle 6.5m-8m & Driver,,,,,SB,24/05/2018,24/05/2018,33.52,,0.00,,"4,171.68"
,IN,AP,40002274,9000,900,,Vehicle 6.5-8m & Driver,,,,,SB,01/06/2018,01/06/2018,33.52,,0.00,,"4,205.20"
,IN,AP,40002269,9000,900,,Vehicle 6.5m-8m & Driver,,,,,SB,05/06/2018,05/06/2018,33.52,,0.00,,"4,238.72"
,IN,AP,40002285,9000,900,,Vehicle 6.5-8m & Driver,,,,,SB,13/06/2018,13/06/2018,33.52,,0.00,,"4,272.24"
,IN,AP,40002304,9000,900,,Standard Car + Driver,,,,,SB,19/06/2018,19/06/2018,13.31,,0.00,,"4,285.55"
,IN,AP,40002340,9000,900,,Commecial Vehicle & Driver,,,,,SB,23/06/2018,23/06/2018,23.64,,0.00,,"4,309.19"
,IN,AP,40002325,9000,900,,GOZO CHANNEL TICKETS,,,,,SB,26/06/2018,26/06/2018,30.55,,0.00,,"4,339.74"
,IN,AP,40002341,9000,900,,Commecial Vehicle & Driver,,,,,SB,27/06/2018,27/06/2018,33.52,,0.00,,"4,373.26"
,IN,AP,40002350,9000,900,,Commercial Vehicle 6.5-8m & Driver,,,,,SB,04/07/2018,04/07/2018,33.52,,0.00,,"4,406.78"
,IN,AP,40002375,9000,900,,Commercial Vehicle 6.5-8m & Driver,,,,,SB,04/07/2018,04/07/2018,33.52,,0.00,,"4,440.30"
,IN,AP,40002376,9000,900,,Standard Fare,,,,,SB,04/07/2018,04/07/2018,3.94,,0.00,,"4,444.24"
,IN,AP,40002377,9000,900,,Commercial Vehicle 8-10m & Driver,,,,,SB,04/07/2018,04/07/2018,49.32,,0.00,,"4,493.56"
,IN,AP,40002378,9000,900,,Commercial Vehicle 8-10m & Driver,,,,,SB,06/07/2018,06/07/2018,49.32,,0.00,,"4,542.88"
,IN,AP,40002379,9000,900,,Standard Fare,,,,,SB,06/07/2018,06/07/2018,3.94,,0.00,,"4,546.82"
,IN,AP,40002415,9000,900,,Commecial Vehicle 8-10m & Driver,,,,,SB,20/07/2018,20/07/2018,49.32,,0.00,,"4,596.14"
,IN,AP,40002416,9000,900,,Commerical Vehicle 5.3-6.5m & Driver,,,,,SB,20/07/2018,20/07/2018,23.64,,0.00,,"4,619.78"
,IN,AP,40002417,9000,900,,Standard Fare,,,,,SB,20/07/2018,20/07/2018,3.94,,0.00,,"4,623.72"
,IN,AP,40002493,9000,900,,VEHICLE 8-10M & DRIVER,,,,,SB,01/08/2018,01/08/2018,49.32,,0.00,,"4,673.04"
,IN,AP,40002503,9000,900,,5.3-6.5M & DRIVER,,,,,SB,07/08/2018,07/08/2018,23.64,,0.00,,"4,696.68"
,IN,AP,40002494,9000,900,,VEHICLE 8-10M & DRIVER,,,,,SB,08/08/2018,08/08/2018,49.32,,0.00,,"4,746.00"
,IN,AP,40002485,9000,900,,Vehicle 6.5-8m & Driver,,,,,SB,11/08/2018,11/08/2018,33.52,,0.00,,"4,779.52"
,IN,AP,40002527,9000,900,,6.5-8m & Driver,,,,,SB,17/08/2018,17/08/2018,33.52,,0.00,,"4,813.04"
,IN,AP,40002528,9000,900,,6.5-8m & Driver,,,,,SB,18/08/2018,18/08/2018,33.52,,0.00,,"4,846.56"
,IN,AP,40002734,9000,900,,6.5-8m & Driver,,,,,SB,01/09/2018,01/09/2018,33.52,,0.00,,"4,880.08"
,IN,AP,40002735,9000,900,,6.5-8m & Driver,,,,,SB,01/09/2018,01/09/2018,33.52,,0.00,,"4,913.60"
,IN,AP,40002550,9000,900,,6.5-8m & Driver,,,,,SB,05/09/2018,05/09/2018,33.52,,0.00,,"4,947.12"
,IN,AP,40002660,9000,900,,6.5M & 8M & Driver,,,,,SB,10/09/2018,10/09/2018,33.52,,0.00,,"4,980.64"
,IN,AP,40002661,9000,900,,6.5M & 8M & Driver,,,,,SB,13/09/2018,13/09/2018,33.52,,0.00,,"5,014.16"
,IN,AP,40002723,9000,900,,6.5-8m & Driver,,,,,SB,18/09/2018,18/09/2018,33.52,,0.00,,"5,047.68"
,IN,AP,40002748,9000,900,,6.5m-8m &Driver,,,,,SB,22/09/2018,22/09/2018,33.52,,0.00,,"5,081.20"
,IN,AP,40002749,9000,900,,6.5m-8m &Driver,,,,,SB,26/09/2018,26/09/2018,33.52,,0.00,,"5,114.72"
,IN,AP,40002755,9000,900,,6.5m-8m &Driver,,,,,SB,02/10/2018,02/10/2018,33.52,,0.00,,"5,148.24"
,IN,AP,40002756,9000,900,,6.5m-8m &Driver,,,,,SB,03/10/2018,03/10/2018,33.52,,0.00,,"5,181.76"
,IN,AP,40002761,9000,900,,5.3m-6.5m & Driver,,,,,SB,06/10/2018,06/10/2018,23.64,,0.00,,"5,205.40"
,IN,AP,40002762,9000,900,,6.5m-8m & Driver,,,,,SB,11/10/2018,11/10/2018,33.52,,0.00,,"5,238.92"
,IN,AP,40002853,9000,900,,Invoice,,,,,,17/10/2018,17/10/2018,33.52,,0.00,,"5,272.44"
,IN,AP,40002864,9000,900,,Invoice,,,,,,24/10/2018,24/10/2018,37.46,,0.00,,"5,309.90"
,IN,AP,40002865,9000,900,,Invoice,,,,,,29/10/2018,29/10/2018,37.46,,0.00,,"5,347.36"
,IN,AP,40002805,9000,900,,Invoice,,,,,,31/10/2018,31/10/2018,"1,196.30",,0.00,,"6,543.66"
,IN,AP,40002880,9000,900,,Invoice,,,,,,31/10/2018,31/10/2018,27.58,,0.00,,"6,571.24"
,IN,AP,40002866,9000,900,,Invoice,,,,,,03/11/2018,03/11/2018,33.52,,0.00,,"6,604.76"
,IN,AP,40002887,9000,900,,Invoice,,,,,,16/11/2018,16/11/2018,37.46,,0.00,,"6,642.22"
,IN,AP,40002888,9000,900,,Invoice,,,,,,20/11/2018,20/11/2018,37.46,,0.00,,"6,679.68"
,IN,AP,40003148,9000,900,,Invoice,,,,,,21/11/2018,21/11/2018,37.46,,0.00,,"6,717.14"
,IN,AP,40002889,9000,900,,Invoice,,,,,,22/11/2018,22/11/2018,41.40,,0.00,,"6,758.54"
,IN,AP,40002899,9000,900,,Invoice,,,,,,05/12/2018,05/12/2018,33.52,,0.00,,"6,792.06"
,IN,AP,40002900,9000,900,,Invoice,,,,,,11/12/2018,11/12/2018,33.52,,0.00,,"6,825.58"
,IN,AP,40002901,9000,900,,Invoice,,,,,,15/12/2018,15/12/2018,33.52,,0.00,,"6,859.10"
,IN,AP,40003246,9000,900,,Invoice,,,,,,27/12/2018,27/12/2018,33.52,,0.00,,"6,892.62"
,,,,,,,,,,,,,,,,,,,
,Account: 1501002 - Axon Delivery Charges,,,,,,,,,,,,,,,,,,
,Pr.,Mod.,Reference,Dept,Div,Suffix,Details,,,Cheque,,User,Doc Date,Post Date,Debit,,Credit,,Balance
,IN,AP,40002052,9000,900,,Delivery Service Charge For Sales Inv 10757506,,,,,SB,21/04/2018,21/04/2018,50.00,,0.00,,50.00
,IN,AP,40002088,9000,900,,Delivery Service Charge For Sales Inv 10759783,,,,,SB,28/04/2018,28/04/2018,50.00,,0.00,,100.00
,IN,AP,40002089,9000,900,,Delivery Service Charge For Sales Inv 10761965,,,,,SB,05/05/2018,05/05/2018,50.00,,0.00,,150.00
,IN,AP,40002208,9000,900,,Pama Delivery Service Charge 10769085,,,,,SB,26/05/2018,26/05/2018,50.00,,0.00,,200.00
,IN,AP,40002398,9000,900,,2June 2018,,,,,SB,02/06/2018,02/06/2018,50.00,,0.00,,250.00
,,,,,,,,,,,,,,,,,,,
,Account: 1700140 - Propane Gas,,,,,,,,,,,,,,,,,,
,Pr.,Mod.,Reference,Dept,Div,Suffix,Details,,,Cheque,,User,Doc Date,Post Date,Debit,,Credit,,Balance
,IN,AP,40002255,9000,900,,3 X 12kgs Fibre,,,,,SB,02/05/2018,02/05/2018,34.31,,0.00,,34.31
,,,,,,,,,,,,,,,,,,,
,Account: 1700150 - Oil,,,,,,,,,,,,,,,,,,
,Pr.,Mod.,Reference,Dept,Div,Suffix,Details,,,Cheque,,User,Doc Date,Post Date,Debit,,Credit,,Balance
,,,,,,Opening Balance as at :01/01/2018,,,,,,,,,0.00,,0.00,,0.00
,,,,,,,,,,,,,,,,,,,
,Account: 1900121 - Equipment Hire,,,,,,,,,,,,,,,,,,
,Pr.,Mod.,Reference,Dept,Div,Suffix,Details,,,Cheque,,User,Doc Date,Post Date,Debit,,Credit,,Balance
,,,,,,Opening Balance as at :01/01/2018,,,,,,,,,0.00,,0.00,,0.00
,,,,,,,,,,,,,,,,,,,
,Account: 2000100 - Repairs & Maintenance  - Buildings,,,,,,,,,,,,,,,,,,
,Pr.,Mod.,Reference,Dept,Div,Suffix,Details,,,Cheque,,User,Doc Date,Post Date,Debit,,Credit,,Balance
,,,,,,Opening Balance as at :01/01/2018,,,,,,,,,0.00,,0.00,,0.00
,IN,AP,40001627,9000,900,,Invoice,,,,,SB,15/01/2018,15/01/2018,12.29,,0.00,,12.29
,IN,AP,40001758,9000,900,,Invoice,,,,,SB,09/03/2018,09/03/2018,"1,025.00",,0.00,,"1,037.29"
,IN,AP,40001759,9000,900,,Invoice,,,,,SB,09/03/2018,09/03/2018,420.00,,0.00,,"1,457.29"
,IN,AP,40003156,9000,900,,Invoice,,,,,,28/11/2018,28/11/2018,5.81,,0.00,,"1,463.10"
,IN,AP,40003160,9000,900,,Invoice,,,,,,03/12/2018,03/12/2018,34.42,,0.00,,"1,497.52"
,IN,AP,40003161,9000,900,,Invoice,,,,,,03/12/2018,03/12/2018,8.39,,0.00,,"1,505.91"
,IN,AP,40003157,9000,900,,Invoice,,,,,,04/12/2018,04/12/2018,5.39,,0.00,,"1,511.30"
,IN,AP,40003158,9000,900,,Invoice,,,,,,11/12/2018,11/12/2018,19.49,,0.00,,"1,530.79"
,,,,,,,,,,,,,,,,,,,
,Account: 2000110 - Repairs & Maintenance - Plant & Machinery,,,,,,,,,,,,,,,,,,
,Pr.,Mod.,Reference,Dept,Div,Suffix,Details,,,Cheque,,User,Doc Date,Post Date,Debit,,Credit,,Balance
,,,,,,Opening Balance as at :01/01/2018,,,,,,,,,0.00,,0.00,,0.00
,IN,AP,40003637,9000,900,,Invoice,,,,,,15/01/2018,15/01/2018,54.00,,0.00,,54.00
,IN,AP,40001804,9000,900,,Invoice,,,,,SB,14/03/2018,14/03/2018,6.24,,0.00,,60.24
,IN,AP,40002509,9000,900,,Chemical,,,,,SB,08/08/2018,08/08/2018,45.76,,0.00,,106.00
,IN,AP,40002730,9000,900,,Parts,,,,,SB,30/09/2018,30/09/2018,26.36,,0.00,,132.36
,,,,,,,,,,,,,,,,,,,
,Account: 2000120 - Pallets,,,,,,,,,,,,,,,,,,
,Pr.,Mod.,Reference,Dept,Div,Suffix,Details,,,Cheque,,User,Doc Date,Post Date,Debit,,Credit,,Balance
,IN,AP,40001765,9000,900,,Invoice,,,,,SB,20/02/2018,20/02/2018,5.93,,0.00,,5.93
,IN,AP,40002554,9000,900,,Invoice,,,,,SB,16/08/2018,16/08/2018,5.93,,0.00,,11.86
,,,,,,,,,,,,,,,,,,,
,Account: 2000130 - Consumables,,,,,,,,,,,,,,,,,,
,Pr.,Mod.,Reference,Dept,Div,Suffix,Details,,,Cheque,,User,Doc Date,Post Date,Debit,,Credit,,Balance
,,,,,,Opening Balance as at :01/01/2018,,,,,,,,,0.00,,0.00,,0.00
,IN,AP,40001775,9000,900,,Invoice,,,,,SB,08/03/2018,08/03/2018,5.85,,0.00,,5.85
,IN,AP,40002411,9000,900,,Invoice,,,,,SB,25/07/2018,25/07/2018,76.30,,0.00,,82.15
,IN,AP,40002650,9000,900,,"Co2 Unit, Pressure Regulator",,,,,SB,12/09/2018,12/09/2018,"1,200.00",,0.00,,"1,282.15"
,,,,,,,,,,,,,,,,,,,
,Account: 2000140 - Pest Control,,,,,,,,,,,,,,,,,,
,Pr.,Mod.,Reference,Dept,Div,Suffix,Details,,,Cheque,,User,Doc Date,Post Date,Debit,,Credit,,Balance
,,,,,,Opening Balance as at :01/01/2018,,,,,,,,,0.00,,0.00,,0.00
,,,,,,,,,,,,,,,,,,,
,Account: 2000160 - Cleaning Expenses,,,,,,,,,,,,,,,,,,
,Pr.,Mod.,Reference,Dept,Div,Suffix,Details,,,Cheque,,User,Doc Date,Post Date,Debit,,Credit,,Balance
,,,,,,Opening Balance as at :01/01/2018,,,,,,,,,0.00,,0.00,,0.00
,IN,AP,40003159,9000,900,,Invoice,,,,,,03/12/2018,03/12/2018,6.78,,0.00,,6.78
,,,,,,,,,,,,,,,,,,,
,Account: 2100100 - Repairs & Maintenance - Heavy Vehicles,,,,,,,,,,,,,,,,,,
,Pr.,Mod.,Reference,Dept,Div,Suffix,Details,,,Cheque,,User,Doc Date,Post Date,Debit,,Credit,,Balance
,,,,,,Opening Balance as at :01/01/2018,,,,,,,,,0.00,,0.00,,0.00
,IN,AP,40001748,9000,900,,Invoice,,,,,SB,02/01/2018,02/01/2018,157.83,,0.00,,157.83
,IN,AP,40001749,9000,900,,Invoice,,,,,SB,02/01/2018,02/01/2018,41.81,,0.00,,199.64
,IN,AP,40001791,9000,900,,Invoice,,,,,SB,02/01/2018,02/01/2018,22.57,,0.00,,222.21
,IN,AP,40001792,9000,900,,Invoice,,,,,SB,02/01/2018,02/01/2018,13.73,,0.00,,235.94
,IN,AP,40001651,9000,900,,Invoice,,,,,SB,04/01/2018,04/01/2018,31.22,,0.00,,267.16
,IN,AP,40001634,9000,900,TFJ 053,Invoice,,,,,SB,08/01/2018,08/01/2018,79.66,,0.00,,346.82
,IN,AP,40003667,9000,900,,Invoice,,,,,,08/01/2018,08/01/2018,79.66,,0.00,,426.48
,IN,AP,40001647,9000,900,TFJ 053,Invoice,,,,,SB,09/01/2018,09/01/2018,559.00,,0.00,,985.48
,IN,AP,40001648,9000,900,BBW476,Invoice,,,,,SB,11/01/2018,11/01/2018,276.01,,0.00,,"1,261.49"
,IN,AP,40001618,9000,900,EBS039,1,,,,,SB,17/01/2018,17/01/2018,79.66,,0.00,,"1,341.15"
,IN,AP,40001746,9000,900,GBS948,Air Filter,,,,,SB,17/01/2018,17/01/2018,722.33,,0.00,,"2,063.48"
,IN,AP,40001747,9000,900,GBS948,Labour,,,,,SB,17/01/2018,17/01/2018,235.00,,0.00,,"2,298.48"
,IN,AP,40001619,9000,900,EBS039,1,,,,,SB,18/01/2018,18/01/2018,79.66,,0.00,,"2,378.14"
,IN,AP,40001649,9000,900,EBS039,Invoice,,,,,SB,18/01/2018,18/01/2018,585.00,,0.00,,"2,963.14"
,IN,AP,40001650,9000,900,IBT012,Invoice,,,,,SB,19/01/2018,19/01/2018,54.00,,0.00,,"3,017.14"
,IN,AP,40001707,9000,900,JBG585,Invoice,,,,,SB,30/01/2018,30/01/2018,40.00,,0.00,,"3,057.14"
,IN,AP,40002060,9000,900,,Invoice,,,,,SB,31/01/2018,31/01/2018,318.25,,0.00,,"3,375.39"
,IN,AP,40001743,9000,900,JBG585,Engine Oil 15/40,,,,,SB,01/02/2018,01/02/2018,542.77,,0.00,,"3,918.16"
,IN,AP,40001709,9000,900,IBT012,Invoice,,,,,SB,03/02/2018,03/02/2018,11.30,,0.00,,"3,929.46"
,IN,AP,40001760,9000,900,,Invoice,,,,,SB,03/02/2018,03/02/2018,322.03,,0.00,,"4,251.49"
,IN,AP,40001744,9000,900,JBG585,Modification on Gearbox Leaver,,,,,SB,05/02/2018,05/02/2018,285.00,,0.00,,"4,536.49"
,IN,AP,40001761,9000,900,,Invoice,,,,,SB,07/02/2018,07/02/2018,133.86,,0.00,,"4,670.35"
,IN,AP,40001723,9000,900,IBX943,Invoice,,,,,SB,12/02/2018,12/02/2018,240.00,,0.00,,"4,910.35"
,IN,AP,40001735,9000,900,JBG585,Invoice,,,,,SB,12/02/2018,12/02/2018,5.08,,0.00,,"4,915.43"
,IN,AP,40001787,9000,900,,Invoice,,,,,SB,19/02/2018,19/02/2018,152.54,,0.00,,"5,067.97"
,IN,AP,40001745,9000,900,IBT012,"Brake Down Service at Zabbar, Fix of hand brake Leaver",,,,,SB,22/02/2018,22/02/2018,38.00,,0.00,,"5,105.97"
,IN,AP,40001762,9000,900,,Invoice,,,,,SB,26/02/2018,26/02/2018,35.00,,0.00,,"5,140.97"
,IN,AP,40001769,9000,900,IBT012,Invoice,,,,,SB,05/03/2018,05/03/2018,47.00,,0.00,,"5,187.97"
,IN,AP,40001757,9000,900,,Invoice,,,,,SB,12/03/2018,12/03/2018,93.22,,0.00,,"5,281.19"
,IN,AP,40001790,9000,900,IBX943,Invoice,,,,,SB,14/03/2018,14/03/2018,80.51,,0.00,,"5,361.70"
,IN,AP,40001815,9000,900,IBX943,Invoice,,,,,SB,15/03/2018,15/03/2018,778.67,,0.00,,"6,140.37"
,IN,AP,40001797,9000,900,,Invoice,,,,,SB,17/03/2018,17/03/2018,58.38,,0.00,,"6,198.75"
,IN,AP,40001816,9000,900,TFJ 053,Invoice,,,,,SB,20/03/2018,20/03/2018,241.90,,0.00,,"6,440.65"
,IN,AP,40001902,9000,900,IBT012,Invoice,,,,,SB,16/04/2018,16/04/2018,99.00,,0.00,,"6,539.65"
,IN,AP,40002147,9000,900,JBG585,Puncture,,,,,SB,20/04/2018,20/04/2018,4.66,,0.00,,"6,544.31"
,IN,AP,40002055,9000,900,BBW476,Tyre X1,,,,,SB,23/04/2018,23/04/2018,169.49,,0.00,,"6,713.80"
,IN,AP,40002053,9000,900,GBS948,Invoice,,,,,SB,24/04/2018,24/04/2018,"1,842.92",,0.00,,"8,556.72"
,IN,AP,40002059,9000,900,,Invoice,,,,,SB,24/04/2018,24/04/2018,63.88,,0.00,,"8,620.60"
,CN,AP,41000084,9000,900,,Credit Note,,,,,SB,24/04/2018,24/04/2018,0.00,,23.86,,"8,596.74"
,IN,AP,40002159,9000,900,JBG585,Toyota Starter Repairs,,,,,SB,22/05/2018,22/05/2018,140.00,,0.00,,"8,736.74"
,IN,AP,40002192,9000,900,,Repairs On BLC 638,,,,,SB,23/05/2018,23/05/2018,261.90,,0.00,,"8,998.64"
,IN,AP,40002193,9000,900,GBW 876,Repairs On GBW 876,,,,,SB,23/05/2018,23/05/2018,894.43,,0.00,,"9,893.07"
,IN,AP,40002322,9000,900,EBS039,EBS 039,,,,,SB,31/05/2018,31/05/2018,394.98,,0.00,,"10,288.05"
,IN,AP,40002323,9000,900,TFJ 053,Tfj 053,,,,,SB,31/05/2018,31/05/2018,561.96,,0.00,,"10,850.01"
,IN,AP,40002332,9000,900,,Protable Belt Dispenser,,,,,SB,21/06/2018,21/06/2018,245.76,,0.00,,"11,095.77"
,IN,AP,40003638,9000,900,,Invoice,,,,,SB,25/06/2018,25/06/2018,407.10,,0.00,,"11,502.87"
,IN,AP,40002403,9000,900,,GBN 146 - Original Parts,,,,,SB,11/07/2018,11/07/2018,"1,517.36",,0.00,,"13,020.23"
,IN,AP,40002404,9000,900,,TFJ 053,,,,,SB,11/07/2018,11/07/2018,70.00,,0.00,,"13,090.23"
,IN,AP,40002371,9000,900,,Towing Service,,,,,SB,12/07/2018,12/07/2018,152.54,,0.00,,"13,242.77"
,IN,AP,40002369,9000,900,,IBC 943,,,,,SB,16/07/2018,16/07/2018,502.50,,0.00,,"13,745.27"
,IN,AP,40002400,9000,900,,Retal DAF HBI476,,,,,SB,17/07/2018,17/07/2018,"1,227.00",,0.00,,"14,972.27"
,IN,AP,40002396,9000,900,,Repairs,,,,,SB,18/07/2018,18/07/2018,75.00,,0.00,,"15,047.27"
,IN,AP,40002397,9000,900,,Starter,,,,,SB,18/07/2018,18/07/2018,313.56,,0.00,,"15,360.83"
,IN,AP,40002426,9000,900,,Gbs 948 Isuzu - Gear Box,,,,,SB,21/07/2018,21/07/2018,225.00,,0.00,,"15,585.83"
,IN,AP,40002409,9000,900,,IBX 943,,,,,SB,25/07/2018,25/07/2018,171.05,,0.00,,"15,756.88"
,IN,AP,40002405,9000,900,,GBN 146 - Injector Repairs,,,,,SB,26/07/2018,26/07/2018,160.00,,0.00,,"15,916.88"
,IN,AP,40002410,9000,900,,GBS 948,,,,,SB,26/07/2018,26/07/2018,533.64,,0.00,,"16,450.52"
,IN,AP,40002412,9000,900,,Invoice,,,,,SB,31/07/2018,31/07/2018,"1,196.00",,0.00,,"17,646.52"
,IN,AP,40002406,9000,900,,BBW 476 Starter Repair,,,,,SB,01/08/2018,01/08/2018,70.00,,0.00,,"17,716.52"
,IN,AP,40002497,9000,900,,GBS 948,,,,,SB,01/08/2018,01/08/2018,31.10,,0.00,,"17,747.62"
,IN,AP,40002423,9000,900,,Invoice,,,,,SB,03/08/2018,03/08/2018,100.91,,0.00,,"17,848.53"
,IN,AP,40002514,9000,900,,Vrt,,,,,SB,03/08/2018,03/08/2018,23.73,,0.00,,"17,872.26"
,IN,AP,40002504,9000,900,,Invoice,,,,,SB,05/08/2018,05/08/2018,59.32,,0.00,,"17,931.58"
,IN,AP,40002407,9000,900,,JBG 585,,,,,SB,06/08/2018,06/08/2018,469.18,,0.00,,"18,400.76"
,IN,AP,40002429,9000,900,,To Pay Mario Garage,,,,,SB,06/08/2018,06/08/2018,67.80,,0.00,,"18,468.56"
,IN,AP,40002512,9000,900,,Moulding Clips Berlingo,,,,,SB,08/08/2018,08/08/2018,3.60,,0.00,,"18,472.16"
,IN,AP,40002476,9000,900,,4 X Tyres ( GBN 146),,,,,SB,09/08/2018,09/08/2018,201.82,,0.00,,"18,673.98"
,IN,AP,40002501,9000,900,,Invoice,,,,,SB,09/08/2018,09/08/2018,59.18,,0.00,,"18,733.16"
,IN,AP,40002478,9000,900,,Fuel Cap Missing - HBI 476,,,,,SB,13/08/2018,13/08/2018,15.00,,0.00,,"18,748.16"
,IN,AP,40002525,9000,900,,Invoice,,,,,SB,14/08/2018,14/08/2018,12.71,,0.00,,"18,760.87"
,IN,AP,40002479,9000,900,,JBG 585,,,,,SB,17/08/2018,17/08/2018,280.00,,0.00,,"19,040.87"
,IN,AP,40002480,9000,900,,DCB 204,,,,,SB,17/08/2018,17/08/2018,"1,649.00",,0.00,,"20,689.87"
,IN,AP,40002481,9000,900,,JBG 585,,,,,SB,17/08/2018,17/08/2018,846.42,,0.00,,"21,536.29"
,IN,AP,40002482,9000,900,,BCL 638,,,,,SB,17/08/2018,17/08/2018,808.03,,0.00,,"22,344.32"
,IN,AP,40002534,9000,900,,Invoice,,,,,SB,21/08/2018,21/08/2018,245.30,,0.00,,"22,589.62"
,IN,AP,40002552,9000,900,,BBW -476,,,,,SB,24/08/2018,24/08/2018,185.58,,0.00,,"22,775.20"
,IN,AP,40002741,9000,900,,Clips,,,,,SB,01/09/2018,01/09/2018,6.10,,0.00,,"22,781.30"
,IN,AP,40002548,9000,900,TFJ 053,TFJ 053 (Marsaskala),,,,,SB,05/09/2018,05/09/2018,820.75,,0.00,,"23,602.05"
,IN,AP,40002738,9000,900,,Invoice,,,,,SB,06/09/2018,06/09/2018,13.56,,0.00,,"23,615.61"
,IN,AP,40002751,9000,900,,Gbs948,,,,,SB,06/09/2018,06/09/2018,6.78,,0.00,,"23,622.39"
,IN,AP,40002716,9000,900,,Repairs On BCM 113,,,,,SB,17/09/2018,17/09/2018,534.39,,0.00,,"24,156.78"
,CN,AP,41000093,9000,900,,Credit Note,,,,,SB,28/09/2018,28/09/2018,0.00,,935.00,,"23,221.78"
,IN,AP,40002643,9000,900,,Invoice,,,,,SB,29/09/2018,29/09/2018,92.49,,0.00,,"23,314.27"
,IN,AP,40002758,9000,900,,Bcm 113 -Clamping,,,,,SB,03/10/2018,03/10/2018,72.03,,0.00,,"23,386.30"
,IN,AP,40002765,9000,900,IBT012,IBT 012,,,,,SB,03/10/2018,03/10/2018,"1,789.99",,0.00,,"25,176.29"
,IN,AP,40002766,9000,900,GBW 876,GBW 876,,,,,SB,11/10/2018,11/10/2018,295.50,,0.00,,"25,471.79"
,IN,AP,40002715,9000,900,,Towing Toyota Dyna JBG 585,,,,,SB,16/10/2018,16/10/2018,79.66,,0.00,,"25,551.45"
,IN,AP,40002767,9000,900,,BCM 113,,,,,SB,07/11/2018,07/11/2018,100.00,,0.00,,"25,651.45"
,IN,AP,40002768,9000,900,EBS039,EBS 039,,,,,SB,07/11/2018,07/11/2018,320.00,,0.00,,"25,971.45"
,IN,AP,40002886,9000,900,,Invoice,,,,,,21/11/2018,21/11/2018,26.36,,0.00,,"25,997.81"
,IN,AP,40002790,9000,900,,Invoice,,,,,,22/11/2018,22/11/2018,92.49,,0.00,,"26,090.30"
,IN,AP,40003090,9000,900,,Invoice,,,,,,22/11/2018,22/11/2018,"1,150.00",,0.00,,"27,240.30"
,IN,AP,40003091,9000,900,,Invoice,,,,,,23/11/2018,23/11/2018,287.00,,0.00,,"27,527.30"
,IN,AP,40002892,9000,900,,Invoice,,,,,,30/11/2018,30/11/2018,50.85,,0.00,,"27,578.15"
,IN,AP,40002893,9000,900,,Invoice,,,,,,05/12/2018,05/12/2018,59.32,,0.00,,"27,637.47"
,IN,AP,40002897,9000,900,,Invoice,,,,,,05/12/2018,05/12/2018,207.63,,0.00,,"27,845.10"
,IN,AP,40002816,9000,900,,Invoice,,,,,,10/12/2018,10/12/2018,338.98,,0.00,,"28,184.08"
,IN,AP,40002905,9000,900,,Invoice,,,,,,11/12/2018,11/12/2018,25.42,,0.00,,"28,209.50"
,IN,AP,40003088,9000,900,,Invoice,,,,,,15/12/2018,15/12/2018,675.89,,0.00,,"28,885.39"
,IN,AP,40002814,9000,900,,Invoice,,,,,,17/12/2018,17/12/2018,80.51,,0.00,,"28,965.90"
,IN,AP,40002898,9000,900,,Invoice,,,,,,17/12/2018,17/12/2018,4.24,,0.00,,"28,970.14"
,IN,AP,40003092,9000,900,,Invoice,,,,,,20/12/2018,20/12/2018,707.97,,0.00,,"29,678.11"
,,,,,,,,,,,,,,,,,,,
,Account: 2100110 - Fuel - Heavy Vehicles,,,,,,,,,,,,,,,,,,
,Pr.,Mod.,Reference,Dept,Div,Suffix,Details,,,Cheque,,User,Doc Date,Post Date,Debit,,Credit,,Balance
,,,,,,Opening Balance as at :01/01/2018,,,,,,,,,0.00,,0.00,,0.00
,IN,AP,40001646,9000,900,,Invoice,,,,,SB,04/01/2018,04/01/2018,"2,330.51",,0.00,,"2,330.51"
,IN,AP,40001628,9000,900,,Invoice,,,,,SB,10/01/2018,10/01/2018,16.95,,0.00,,"2,347.46"
,IN,AP,40001713,9000,900,,Invoice,,,,,SB,24/01/2018,24/01/2018,"2,245.76",,0.00,,"4,593.22"
,IN,AP,40001643,9000,900,BBW476,Invoice,,,,,SB,29/01/2018,29/01/2018,16.95,,0.00,,"4,610.17"
,IN,AP,40001719,9000,900,,Invoice,,,,,SB,07/02/2018,07/02/2018,16.95,,0.00,,"4,627.12"
,IN,AP,40001756,9000,900,,Invoice,,,,,SB,28/02/2018,28/02/2018,"2,748.81",,0.00,,"7,375.93"
,IN,AP,40001776,9000,900,,Invoice,,,,,SB,01/03/2018,01/03/2018,16.95,,0.00,,"7,392.88"
,IN,AP,40001803,9000,900,,Invoice,,,,,SB,09/03/2018,09/03/2018,16.95,,0.00,,"7,409.83"
,IN,AP,40001811,9000,900,,Invoice,,,,,SB,28/03/2018,28/03/2018,"2,561.07",,0.00,,"9,970.90"
,IN,AP,40002194,9000,900,,Diesel,,,,,SB,01/05/2018,01/05/2018,16.95,,0.00,,"9,987.85"
,IN,AP,40002195,9000,900,JBG585,Diesel,,,,,SB,01/05/2018,01/05/2018,16.95,,0.00,,"10,004.80"
,IN,AP,40002200,9000,900,IBT012,Invoice,,,,,SB,01/05/2018,01/05/2018,12.71,,0.00,,"10,017.51"
,IN,AP,40002107,9000,900,,3000 Litres Diesel @ €1.08,,,,,SB,02/05/2018,02/05/2018,"2,745.76",,0.00,,"12,763.27"
,IN,AP,40002196,9000,900,IBT012,Diesel,,,,,SB,05/05/2018,05/05/2018,25.42,,0.00,,"12,788.69"
,IN,AP,40002197,9000,900,,Invoice,,,,,SB,05/05/2018,05/05/2018,16.95,,0.00,,"12,805.64"
,IN,AP,40002201,9000,900,,Invoice,,,,,SB,05/05/2018,05/05/2018,16.95,,0.00,,"12,822.59"
,IN,AP,40002151,9000,900,,Diesel - BCL,,,,,SB,14/05/2018,14/05/2018,16.95,,0.00,,"12,839.54"
,IN,AP,40002225,9000,900,,Fuel - 3000Litre,,,,,SB,30/05/2018,30/05/2018,"2,436.44",,0.00,,"15,275.98"
,IN,AP,40002307,9000,900,,Adjustment 500ltr,,,,,SB,30/05/2018,30/05/2018,487.29,,0.00,,"15,763.27"
,IN,AP,40002275,9000,900,,Fuel - IBT-012,,,,,SB,01/06/2018,01/06/2018,16.95,,0.00,,"15,780.22"
,IN,AP,40002276,9000,900,,Invoice,,,,,SB,01/06/2018,01/06/2018,16.95,,0.00,,"15,797.17"
,IN,AP,40002277,9000,900,,Invoice,,,,,SB,01/06/2018,01/06/2018,16.95,,0.00,,"15,814.12"
,IN,AP,40002278,9000,900,GBS948,GBS 948,,,,,SB,01/06/2018,01/06/2018,16.95,,0.00,,"15,831.07"
,IN,AP,40002305,9000,900,,Invoice,,,,,SB,19/06/2018,19/06/2018,16.95,,0.00,,"15,848.02"
,IN,AP,40002342,9000,900,,Invoice,,,,,SB,21/06/2018,21/06/2018,25.42,,0.00,,"15,873.44"
,IN,AP,40002337,9000,900,,Invoice,,,,,SB,22/06/2018,22/06/2018,16.95,,0.00,,"15,890.39"
,IN,AP,40002346,9000,900,,Invoice,,,,,SB,22/06/2018,22/06/2018,33.90,,0.00,,"15,924.29"
,IN,AP,40002338,9000,900,,Invoice,,,,,SB,23/06/2018,23/06/2018,16.95,,0.00,,"15,941.24"
,IN,AP,40002345,9000,900,,Invoice,,,,,SB,23/06/2018,23/06/2018,16.95,,0.00,,"15,958.19"
,IN,AP,40002348,9000,900,,Invoice,,,,,SB,23/06/2018,23/06/2018,8.47,,0.00,,"15,966.66"
,IN,AP,40002324,9000,900,,3000LTRS,,,,,SB,25/06/2018,25/06/2018,"2,477.74",,0.00,,"18,444.40"
,IN,AP,40002343,9000,900,,Invoice,,,,,SB,25/06/2018,25/06/2018,16.95,,0.00,,"18,461.35"
,IN,AP,40002347,9000,900,,Invoice,,,,,SB,25/06/2018,25/06/2018,16.95,,0.00,,"18,478.30"
,IN,AP,40002336,9000,900,,Invoice,,,,,SB,26/06/2018,26/06/2018,16.95,,0.00,,"18,495.25"
,IN,AP,40002381,9000,900,,Invoice,,,,,SB,09/07/2018,09/07/2018,16.95,,0.00,,"18,512.20"
,IN,AP,40002370,9000,900,,Invoice,,,,,SB,16/07/2018,16/07/2018,"2,923.73",,0.00,,"21,435.93"
,IN,AP,40002418,9000,900,,Invoice,,,,,SB,16/07/2018,16/07/2018,16.95,,0.00,,"21,452.88"
,IN,AP,40002421,9000,900,,Invoice,,,,,SB,16/07/2018,16/07/2018,16.95,,0.00,,"21,469.83"
,IN,AP,40002419,9000,900,,Invoice,,,,,SB,18/07/2018,18/07/2018,16.95,,0.00,,"21,486.78"
,IN,AP,40002413,9000,900,,TO AMEND MISTAKE,,,,,SB,25/07/2018,25/07/2018,445.99,,0.00,,"21,932.77"
,IN,AP,40002495,9000,900,,FUEL,,,,,SB,01/08/2018,01/08/2018,8.47,,0.00,,"21,941.24"
,IN,AP,40002506,9000,900,,JBG-585,,,,,SB,03/08/2018,03/08/2018,16.95,,0.00,,"21,958.19"
,IN,AP,40002513,9000,900,,Invoice,,,,,SB,03/08/2018,03/08/2018,16.95,,0.00,,"21,975.14"
,IN,AP,40002428,9000,900,,2947 Litre Diesel X 1.19,,,,,SB,06/08/2018,06/08/2018,"2,971.97",,0.00,,"24,947.11"
,IN,AP,40002500,9000,900,,Invoice,,,,,SB,06/08/2018,06/08/2018,12.71,,0.00,,"24,959.82"
,IN,AP,40002502,9000,900,,Invoice,,,,,SB,06/08/2018,06/08/2018,42.37,,0.00,,"25,002.19"
,IN,AP,40002505,9000,900,,Invoice,,,,,SB,06/08/2018,06/08/2018,16.95,,0.00,,"25,019.14"
,IN,AP,40002507,9000,900,,Invoice,,,,,SB,06/08/2018,06/08/2018,16.95,,0.00,,"25,036.09"
,IN,AP,40002508,9000,900,,Invoice,,,,,SB,06/08/2018,06/08/2018,16.95,,0.00,,"25,053.04"
,IN,AP,40002531,9000,900,,Invoice,,,,,SB,11/08/2018,11/08/2018,8.47,,0.00,,"25,061.51"
,IN,AP,40002478,9000,900,,Fuel - HBI 476,,,,,SB,13/08/2018,13/08/2018,112.71,,0.00,,"25,174.22"
,IN,AP,40002524,9000,900,,Invoice,,,,,SB,14/08/2018,14/08/2018,16.95,,0.00,,"25,191.17"
,IN,AP,40002532,9000,900,,16.34ltrs X 1.230,,,,,SB,16/08/2018,16/08/2018,16.95,,0.00,,"25,208.12"
,IN,AP,40002533,9000,900,,16.30 X1.230,,,,,SB,17/08/2018,17/08/2018,16.95,,0.00,,"25,225.07"
,IN,AP,40002553,9000,900,,3000 Ltrs,,,,,SB,23/08/2018,23/08/2018,"3,026.43",,0.00,,"28,251.50"
,IN,AP,40002736,9000,900,,Invoice,,,,,SB,01/09/2018,01/09/2018,16.95,,0.00,,"28,268.45"
,IN,AP,40002737,9000,900,,Invoice,,,,,SB,01/09/2018,01/09/2018,16.95,,0.00,,"28,285.40"
,IN,AP,40002743,9000,900,,Invoice,,,,,SB,03/09/2018,03/09/2018,25.42,,0.00,,"28,310.82"
,IN,AP,40002657,9000,900,,Invoice,,,,,SB,13/09/2018,13/09/2018,16.95,,0.00,,"28,327.77"
,IN,AP,40002658,9000,900,,Invoice,,,,,SB,14/09/2018,14/09/2018,16.95,,0.00,,"28,344.72"
,IN,AP,40002659,9000,900,,Invoice,,,,,SB,14/09/2018,14/09/2018,8.47,,0.00,,"28,353.19"
,IN,AP,40002662,9000,900,,Invoice,,,,,SB,14/09/2018,14/09/2018,16.95,,0.00,,"28,370.14"
,IN,AP,40002663,9000,900,,Invoice,,,,,SB,14/09/2018,14/09/2018,25.42,,0.00,,"28,395.56"
,IN,AP,40002725,9000,900,,Invoice,,,,,SB,14/09/2018,14/09/2018,16.95,,0.00,,"28,412.51"
,IN,AP,40002728,9000,900,,Invoice,,,,,SB,14/09/2018,14/09/2018,42.37,,0.00,,"28,454.88"
,IN,AP,40002719,9000,900,,Invoice,,,,,SB,15/09/2018,15/09/2018,16.95,,0.00,,"28,471.83"
,IN,AP,40002720,9000,900,,Invoice,,,,,SB,15/09/2018,15/09/2018,16.95,,0.00,,"28,488.78"
,IN,AP,40002721,9000,900,,Invoice,,,,,SB,15/09/2018,15/09/2018,16.95,,0.00,,"28,505.73"
,IN,AP,40002744,9000,900,,Invoice,,,,,SB,15/09/2018,15/09/2018,8.47,,0.00,,"28,514.20"
,IN,AP,40002745,9000,900,,Invoice,,,,,SB,15/09/2018,15/09/2018,33.90,,0.00,,"28,548.10"
,IN,AP,40002649,9000,900,,3000ltr @1.19,,,,,SB,17/09/2018,17/09/2018,"3,025.42",,0.00,,"31,573.52"
,IN,AP,40002718,9000,900,,Invoice,,,,,SB,17/09/2018,17/09/2018,16.95,,0.00,,"31,590.47"
,IN,AP,40002724,9000,900,,Invoice,,,,,SB,17/09/2018,17/09/2018,16.95,,0.00,,"31,607.42"
,IN,AP,40002726,9000,900,,Invoice,,,,,SB,17/09/2018,17/09/2018,25.42,,0.00,,"31,632.84"
,IN,AP,40002727,9000,900,,Invoice,,,,,SB,17/09/2018,17/09/2018,16.95,,0.00,,"31,649.79"
,IN,AP,40002729,9000,900,,Invoice,,,,,SB,17/09/2018,17/09/2018,16.95,,0.00,,"31,666.74"
,IN,AP,40002750,9000,900,,Invoice,,,,,SB,17/09/2018,17/09/2018,16.95,,0.00,,"31,683.69"
,IN,AP,40002722,9000,900,,Invoice,,,,,SB,20/09/2018,20/09/2018,8.47,,0.00,,"31,692.16"
,IN,AP,40002656,9000,900,,Diesel,,,,,SB,22/09/2018,22/09/2018,8.47,,0.00,,"31,700.63"
,IN,AP,40002793,9000,900,,Invoice,,,,,,05/10/2018,05/10/2018,"3,166.61",,0.00,,"34,867.24"
,IN,AP,40002801,9000,900,,Invoice,,,,,,19/10/2018,19/10/2018,"2,974.58",,0.00,,"37,841.82"
,IN,AP,40002802,9000,900,,Invoice,,,,,,13/11/2018,13/11/2018,"2,974.58",,0.00,,"40,816.40"
,IN,AP,40003179,9000,900,,Invoice,,,,,,23/11/2018,23/11/2018,113.08,,0.00,,"40,929.48"
,IN,AP,40002803,9000,900,,Invoice,,,,,,05/12/2018,05/12/2018,"2,974.58",,0.00,,"43,904.06"
,IN,AP,40002904,9000,900,,Invoice,,,,,,05/12/2018,05/12/2018,25.42,,0.00,,"43,929.48"
,IN,AP,40002902,9000,900,,Invoice,,,,,,07/12/2018,07/12/2018,16.95,,0.00,,"43,946.43"
,CN,AP,41000113,9000,900,,Credit Note,,,,,,31/12/2018,31/12/2018,0.00,,10.00,,"43,936.43"
,IN,AP,40003640,9000,900,,Invoice,,,,,,31/12/2018,31/12/2018,10.00,,0.00,,"43,946.43"
,,,,,,,,,,,,,,,,,,,
,Account: 2100111 - Fuel - Light Vehicles,,,,,,,,,,,,,,,,,,
,Pr.,Mod.,Reference,Dept,Div,Suffix,Details,,,Cheque,,User,Doc Date,Post Date,Debit,,Credit,,Balance
,,,,,,Opening Balance as at :01/01/2018,,,,,,,,,0.00,,0.00,,0.00
,IN,AP,40001626,9000,900,,Invoice,,,,,SB,16/01/2018,16/01/2018,33.90,,0.00,,33.90
,IN,AP,40001644,9000,900,LDB269,Invoice,,,,,SB,26/01/2018,26/01/2018,25.42,,0.00,,59.32
,IN,AP,40001720,9000,900,,Invoice,,,,,SB,06/02/2018,06/02/2018,33.90,,0.00,,93.22
,IN,AP,40001754,9000,900,,Fuel - Petrol Rizzo Service,,,,,SB,09/02/2018,09/02/2018,15.25,,0.00,,108.47
,IN,AP,40001766,9000,900,,Invoice,,,,,SB,21/02/2018,21/02/2018,16.95,,0.00,,125.42
,IN,AP,40001768,9000,900,LDB269,Invoice,,,,,SB,21/02/2018,21/02/2018,25.42,,0.00,,150.84
,IN,AP,40001788,9000,900,,Invoice,,,,,SB,05/03/2018,05/03/2018,25.42,,0.00,,176.26
,IN,AP,40001805,9000,900,,Invoice,,,,,SB,15/03/2018,15/03/2018,33.90,,0.00,,210.16
,IN,AP,40002207,9000,900,,Invoice,,,,,SB,24/05/2018,24/05/2018,25.42,,0.00,,235.58
,IN,AP,40002420,9000,900,,Invoice,,,,,SB,03/07/2018,03/07/2018,8.47,,0.00,,244.05
,IN,AP,40002380,9000,900,,Invoice,,,,,SB,09/07/2018,09/07/2018,25.42,,0.00,,269.47
,IN,AP,40002422,9000,900,,Diesel,,,,,SB,18/07/2018,18/07/2018,25.42,,0.00,,294.89
,IN,AP,40002530,9000,900,,Invoice,,,,,SB,21/08/2018,21/08/2018,25.42,,0.00,,320.31
,IN,AP,40002742,9000,900,,Invoice,,,,,SB,01/09/2018,01/09/2018,25.42,,0.00,,345.73
,IN,AP,40002753,9000,900,,Invoice,,,,,SB,26/09/2018,26/09/2018,25.42,,0.00,,371.15
,IN,AP,40002760,9000,900,,Invoice,,,,,SB,05/10/2018,05/10/2018,25.42,,0.00,,396.57
,IN,AP,40002764,9000,900,,Invoice,,,,,SB,15/10/2018,15/10/2018,33.90,,0.00,,430.47
,,,,,,,,,,,,,,,,,,,
,Account: 2100120 - License - Heavy Vehicles,,,,,,,,,,,,,,,,,,
,Pr.,Mod.,Reference,Dept,Div,Suffix,Details,,,Cheque,,User,Doc Date,Post Date,Debit,,Credit,,Balance
,,,,,,Opening Balance as at :01/01/2018,,,,,,,,,0.00,,0.00,,0.00
,IN,AP,40001777,9000,900,,Invoice,,,,,SB,28/02/2018,28/02/2018,31.10,,0.00,,31.10
,IN,AP,40002773,9000,900,,Policy Renewal BBW 476,,,,,SB,28/02/2018,28/02/2018,248.00,,0.00,,279.10
,IN,AP,40002775,9000,900,,Policy Renewal DCB204,,,,,SB,27/04/2018,27/04/2018,285.86,,0.00,,564.96
,IN,AP,40002777,9000,900,,Policy Renewal EBS039,,,,,SB,31/05/2018,31/05/2018,141.00,,0.00,,705.96
,IN,AP,40002778,9000,900,,Policy Renewal GBS948,,,,,SB,31/07/2018,31/07/2018,256.65,,0.00,,962.61
,IN,AP,40002779,9000,900,,Policy Renewal GBN685,,,,,SB,31/07/2018,31/07/2018,268.72,,0.00,,"1,231.33"
,IN,AP,40002780,9000,900,,Policy Renewal GBN146,,,,,SB,31/07/2018,31/07/2018,402.64,,0.00,,"1,633.97"
,IN,AP,40002781,9000,900,,Policy Renewal GBW876,,,,,SB,31/07/2018,31/07/2018,187.00,,0.00,,"1,820.97"
,IN,AP,40002518,9000,900,,GBW876,,,,,SB,16/08/2018,16/08/2018,15.55,,0.00,,"1,836.52"
,IN,AP,40002782,9000,900,,Policy Renewal TFJ053,,,,,SB,28/08/2018,28/08/2018,300.00,,0.00,,"2,136.52"
,IN,AP,40002644,9000,900,,Service IBL 613,,,,,SB,26/09/2018,26/09/2018,67.80,,0.00,,"2,204.32"
,IN,AP,40002652,9000,900,,Vrt IBL 613,,,,,SB,27/09/2018,27/09/2018,17.18,,0.00,,"2,221.50"
,IN,AP,40002653,9000,900,,Vrt IBL 613,,,,,SB,27/09/2018,27/09/2018,8.25,,0.00,,"2,229.75"
,IN,AP,40002654,9000,900,,Vrt IBL 613,,,,,SB,27/09/2018,27/09/2018,1.69,,0.00,,"2,231.44"
,IN,AP,40002784,9000,900,,Policy Renewal IBT012,,,,,SB,01/10/2018,01/10/2018,407.30,,0.00,,"2,638.74"
,IN,AP,40002785,9000,900,,Policy Renewal IBX943,,,,,SB,01/10/2018,01/10/2018,256.65,,0.00,,"2,895.39"
,,,,,,,,,,,,,,,,,,,
,Account: 2100121 - Duty On Licences/Insurances,,,,,,,,,,,,,,,,,,
,Pr.,Mod.,Reference,Dept,Div,Suffix,Details,,,Cheque,,User,Doc Date,Post Date,Debit,,Credit,,Balance
,IN,AP,40002772,9000,900,,Non Motor Policy,,,,,SB,16/02/2018,16/02/2018,13.00,,0.00,,13.00
,IN,AP,40002773,9000,900,,Policy Renewal BBW 476,,,,,SB,28/02/2018,28/02/2018,65.50,,0.00,,78.50
,IN,AP,40002774,9000,900,,New Policy LK10HJC,,,,,SB,21/03/2018,21/03/2018,68.91,,0.00,,147.41
,IN,AP,40002775,9000,900,,Policy Renewal DCB204,,,,,SB,27/04/2018,27/04/2018,76.39,,0.00,,223.80
,IN,AP,40002776,9000,900,,New Policy 7623,,,,,SB,22/05/2018,22/05/2018,65.94,,0.00,,289.74
,IN,AP,40002777,9000,900,,Policy Renewal EBS039,,,,,SB,31/05/2018,31/05/2018,58.02,,0.00,,347.76
,IN,AP,40002778,9000,900,,Policy Renewal GBS948,,,,,SB,31/07/2018,31/07/2018,67.26,,0.00,,415.02
,IN,AP,40002779,9000,900,,Policy Renewal GBN685,,,,,SB,31/07/2018,31/07/2018,80.13,,0.00,,495.15
,IN,AP,40002780,9000,900,,Policy Renewal GBN146,,,,,SB,31/07/2018,31/07/2018,52.85,,0.00,,548.00
,IN,AP,40002781,9000,900,,Policy Renewal GBW876,,,,,SB,31/07/2018,31/07/2018,76.39,,0.00,,624.39
,IN,AP,40003643,9000,900,,Duty & Vat,,,,,SB,10/08/2018,10/08/2018,427.01,,0.00,,"1,051.40"
,IN,AP,40003644,9000,900,,Duty & Vat,,,,,SB,13/08/2018,13/08/2018,495.00,,0.00,,"1,546.40"
,IN,AP,40002782,9000,900,,Policy Renewal TFJ053,,,,,SB,28/08/2018,28/08/2018,52.96,,0.00,,"1,599.36"
,IN,AP,40002784,9000,900,,Policy Renewal IBT012,,,,,SB,01/10/2018,01/10/2018,48.89,,0.00,,"1,648.25"
,IN,AP,40002785,9000,900,,Policy Renewal IBX943,,,,,SB,01/10/2018,01/10/2018,53.95,,0.00,,"1,702.20"
,IN,AP,40002787,9000,900,,Policy Renewal JBG585,,,,,SB,30/10/2018,30/10/2018,30.41,,0.00,,"1,732.61"
,,,,,,,,,,,,,,,,,,,
,Account: 2100122 - Peak Admin Charges,,,,,,,,,,,,,,,,,,
,Pr.,Mod.,Reference,Dept,Div,Suffix,Details,,,Cheque,,User,Doc Date,Post Date,Debit,,Credit,,Balance
,IN,AP,40002772,9000,900,,Non Motor Policy,,,,,SB,16/02/2018,16/02/2018,2.00,,0.00,,2.00
,IN,AP,40002773,9000,900,,Policy Renewal BBW 476,,,,,SB,28/02/2018,28/02/2018,5.00,,0.00,,7.00
,IN,AP,40002774,9000,900,,New Policy LK10HJC,,,,,SB,21/03/2018,21/03/2018,5.00,,0.00,,12.00
,IN,AP,40002775,9000,900,,Policy Renewal DCB204,,,,,SB,27/04/2018,27/04/2018,5.00,,0.00,,17.00
,IN,AP,40002776,9000,900,,New Policy 7623,,,,,SB,22/05/2018,22/05/2018,5.00,,0.00,,22.00
,IN,AP,40002777,9000,900,,Policy Renewal EBS039,,,,,SB,31/05/2018,31/05/2018,5.00,,0.00,,27.00
,IN,AP,40002778,9000,900,,Policy Renewal GBS948,,,,,SB,31/07/2018,31/07/2018,5.00,,0.00,,32.00
,IN,AP,40002779,9000,900,,Policy Renewal GBN685,,,,,SB,31/07/2018,31/07/2018,5.00,,0.00,,37.00
,IN,AP,40002780,9000,900,,Policy Renewal GBN146,,,,,SB,31/07/2018,31/07/2018,5.00,,0.00,,42.00
,IN,AP,40002781,9000,900,,Policy Renewal GBW876,,,,,SB,31/07/2018,31/07/2018,5.00,,0.00,,47.00
,IN,AP,40002782,9000,900,,Policy Renewal TFJ053,,,,,SB,28/08/2018,28/08/2018,5.00,,0.00,,52.00
,IN,AP,40002784,9000,900,,Policy Renewal IBT012,,,,,SB,01/10/2018,01/10/2018,5.00,,0.00,,57.00
,IN,AP,40002785,9000,900,,Policy Renewal IBX943,,,,,SB,01/10/2018,01/10/2018,5.00,,0.00,,62.00
,IN,AP,40002787,9000,900,,Policy Renewal JBG585,,,,,SB,30/10/2018,30/10/2018,5.00,,0.00,,67.00
,,,,,,,,,,,,,,,,,,,
,Account: 2100130 - Insurance - Heavy Vehicles,,,,,,,,,,,,,,,,,,
,Pr.,Mod.,Reference,Dept,Div,Suffix,Details,,,Cheque,,User,Doc Date,Post Date,Debit,,Credit,,Balance
,IN,AP,40002769,9000,900,TFJ 053,TFJ 053 06/10/17,,,,,SB,11/01/2018,11/01/2018,55.00,,0.00,,55.00
,IN,AP,40002770,9000,900,TFJ 053,TFJ 053 05/10/17,,,,,SB,11/01/2018,11/01/2018,55.00,,0.00,,110.00
,IN,AP,40002771,9000,900,GBW 876,GBW 876 01/12/17,,,,,SB,23/01/2018,23/01/2018,55.00,,0.00,,165.00
,IN,AP,40002773,9000,900,,Policy Renewal BBW 476,,,,,SB,28/02/2018,28/02/2018,549.64,,0.00,,714.64
,IN,AP,40002774,9000,900,,New Policy LK10HJC,,,,,SB,21/03/2018,21/03/2018,580.59,,0.00,,"1,295.23"
,IN,AP,40002775,9000,900,,Policy Renewal DCB204,,,,,SB,27/04/2018,27/04/2018,648.75,,0.00,,"1,943.98"
,,,,,,,,,,,,,,,,,,,
,IN,AP,40002776,9000,900,,New Policy 7623,,,,,SB,22/05/2018,22/05/2018,553.59,,0.00,,"2,497.57"
,IN,AP,40002777,9000,900,,Policy Renewal EBS039,,,,,SB,31/05/2018,31/05/2018,481.38,,0.00,,"2,978.95"
,IN,AP,40002778,9000,900,,Policy Renewal GBS948,,,,,SB,31/07/2018,31/07/2018,565.82,,0.00,,"3,544.77"
,IN,AP,40002779,9000,900,,Policy Renewal GBN685,,,,,SB,31/07/2018,31/07/2018,682.97,,0.00,,"4,227.74"
,IN,AP,40002780,9000,900,,Policy Renewal GBN146,,,,,SB,31/07/2018,31/07/2018,434.81,,0.00,,"4,662.55"
,IN,AP,40002781,9000,900,,Policy Renewal GBW876,,,,,SB,31/07/2018,31/07/2018,648.75,,0.00,,"5,311.30"
,IN,AP,40002556,9000,900,,V.R.T,,,,,SB,13/08/2018,13/08/2018,22.03,,0.00,,"5,333.33"
,IN,AP,40002782,9000,900,,Policy Renewal TFJ053,,,,,SB,28/08/2018,28/08/2018,435.09,,0.00,,"5,768.42"
,IN,AP,40002783,9000,900,,BBW476 29/08/18,,,,,SB,26/09/2018,26/09/2018,155.00,,0.00,,"5,923.42"
,IN,AP,40002784,9000,900,,Policy Renewal IBT012,,,,,SB,01/10/2018,01/10/2018,398.03,,0.00,,"6,321.45"
,IN,AP,40002785,9000,900,,Policy Renewal IBX943,,,,,SB,01/10/2018,01/10/2018,444.50,,0.00,,"6,765.95"
,IN,AP,40002786,9000,900,,Claim GBW876 18/09/17,,,,,SB,01/10/2018,01/10/2018,55.00,,0.00,,"6,820.95"
,IN,AP,40002787,9000,900,,Policy Renewal JBG585,,,,,SB,30/10/2018,30/10/2018,230.74,,0.00,,"7,051.69"
,IN,AP,40003629,9000,900,,Invoice,,,,,SB,30/11/2018,30/11/2018,43.85,,0.00,,"7,095.54"
,IN,AP,40003630,9000,900,,Invoice,,,,,SB,03/12/2018,03/12/2018,43.85,,0.00,,"7,139.39"
,IN,AP,40003631,9000,900,,Invoice,,,,,SB,03/12/2018,03/12/2018,43.85,,0.00,,"7,183.24"
,IN,AP,40003632,9000,900,,Invoice,,,,,SB,03/12/2018,03/12/2018,43.85,,0.00,,"7,227.09"
,CN,AP,41000111,9000,900,,Credit Note,,,,,SB,31/12/2018,31/12/2018,0.00,,175.40,,"7,051.69"
,IN,AP,40003627,9000,900,,Invoice,,,,,SB,31/12/2018,31/12/2018,175.40,,0.00,,"7,227.09"
,,,,,,,,,,,,,,,,,,,
,Account: 2300100 - Refreshments - Food,,,,,,,,,,,,,,,,,,
,Pr.,Mod.,Reference,Dept,Div,Suffix,Details,,,Cheque,,User,Doc Date,Post Date,Debit,,Credit,,Balance
,IN,AP,40001763,9000,900,,Invoice,,,,,SB,21/02/2018,21/02/2018,1.37,,0.00,,1.37
,IN,AP,40001764,9000,900,,Invoice,,,,,SB,22/02/2018,22/02/2018,0.70,,0.00,,2.07
,IN,AP,40001778,9000,900,,Invoice,,,,,SB,26/02/2018,26/02/2018,3.24,,0.00,,5.31
,IN,AP,40001779,9000,900,,Invoice,,,,,SB,28/02/2018,28/02/2018,1.62,,0.00,,6.93
,IN,AP,40001780,9000,900,,Invoice,,,,,SB,01/03/2018,01/03/2018,2.43,,0.00,,9.36
,IN,AP,40001781,9000,900,,Invoice,,,,,SB,05/03/2018,05/03/2018,1.62,,0.00,,10.98
,IN,AP,40001771,9000,900,,Invoice,,,,,SB,06/03/2018,06/03/2018,1.62,,0.00,,12.60
,IN,AP,40001772,9000,900,,Invoice,,,,,SB,07/03/2018,07/03/2018,1.62,,0.00,,14.22
,IN,AP,40001773,9000,900,,Invoice,,,,,SB,08/03/2018,08/03/2018,1.62,,0.00,,15.84
,IN,AP,40001774,9000,900,,Invoice,,,,,SB,12/03/2018,12/03/2018,1.62,,0.00,,17.46
,IN,AP,40002144,9000,900,,Invoice,,,,,SB,01/04/2018,01/04/2018,6.10,,0.00,,23.56
,IN,AP,40002143,9000,900,,Invoice,,,,,SB,02/04/2018,02/04/2018,113.77,,0.00,,137.33
,IN,AP,40002123,9000,900,,Invoice,,,,,SB,24/04/2018,24/04/2018,4.41,,0.00,,141.74
,IN,AP,40002862,9000,900,,Invoice,,,,,,16/10/2018,16/10/2018,1.62,,0.00,,143.36
,IN,AP,40002863,9000,900,,Invoice,,,,,,26/10/2018,26/10/2018,1.62,,0.00,,144.98
,IN,AP,40002856,9000,900,,Invoice,,,,,,29/10/2018,29/10/2018,0.81,,0.00,,145.79
,IN,AP,40002857,9000,900,,Invoice,,,,,,30/10/2018,30/10/2018,1.62,,0.00,,147.41
,IN,AP,40002851,9000,900,,Invoice,,,,,,10/11/2018,10/11/2018,50.21,,0.00,,197.62
,IN,AP,40003130,9000,900,,Invoice,,,,,,12/11/2018,12/11/2018,2.88,,0.00,,200.50
,IN,AP,40003131,9000,900,,Invoice,,,,,,19/11/2018,19/11/2018,1.62,,0.00,,202.12
,IN,AP,40003132,9000,900,,Invoice,,,,,,26/11/2018,26/11/2018,0.81,,0.00,,202.93
,IN,AP,40003110,9000,900,,Invoice,,,,,,21/12/2018,21/12/2018,3.24,,0.00,,206.17
,IN,AP,40003114,9000,900,,Invoice,,,,,,24/12/2018,24/12/2018,34.92,,0.00,,241.09
,,,,,,,,,,,,,,,,,,,
,Account: 2300110 - Consumables - Staff Expenses,,,,,,,,,,,,,,,,,,
,Pr.,Mod.,Reference,Dept,Div,Suffix,Details,,,Cheque,,User,Doc Date,Post Date,Debit,,Credit,,Balance
,IN,AP,40002111,9000,900,,Invoice,,,,,SB,15/05/2018,15/05/2018,41.24,,0.00,,41.24
,IN,AP,40002333,9000,900,,Invoice,,,,,SB,17/05/2018,17/05/2018,55.80,,0.00,,97.04
,,,,,,,,,,,,,,,,,,,
,Account: 2300120 - Uniforms,,,,,,,,,,,,,,,,,,
,Pr.,Mod.,Reference,Dept,Div,Suffix,Details,,,Cheque,,User,Doc Date,Post Date,Debit,,Credit,,Balance
,,,,,,Opening Balance as at :01/01/2018,,,,,,,,,0.00,,0.00,,0.00
,IN,AP,40001645,9000,900,,Invoice,,,,,SB,15/01/2018,15/01/2018,22.00,,0.00,,22.00
,IN,AP,40001807,9000,900,,Invoice,,,,,SB,15/03/2018,15/03/2018,169.50,,0.00,,191.50
,IN,AP,40002054,9000,900,,Invoice,,,,,SB,19/04/2018,19/04/2018,173.87,,0.00,,365.37
,IN,AP,40002257,9000,900,,27 X Bermudas/ 17 X Trousers,,,,,SB,12/06/2018,12/06/2018,544.65,,0.00,,910.02
,IN,AP,40002326,9000,900,,T-SHIRTS WITH LOGO,,,,,SB,30/06/2018,30/06/2018,567.00,,0.00,,"1,477.02"
,IN,AP,40002335,9000,900,,T-Shirts (M) 53 Pcs,,,,,SB,30/06/2018,30/06/2018,185.50,,0.00,,"1,662.52"
,IN,AP,40002806,9000,900,,Invoice,,,,,,09/11/2018,09/11/2018,273.25,,0.00,,"1,935.77"
,IN,AP,40002809,9000,900,,Invoice,,,,,,26/11/2018,26/11/2018,678.00,,0.00,,"2,613.77"
,IN,AP,40002810,9000,900,,Invoice,,,,,,30/11/2018,30/11/2018,"1,719.48",,0.00,,"4,333.25"
,IN,AP,40002788,9000,900,,Invoice,,,,,,03/12/2018,03/12/2018,550.00,,0.00,,"4,883.25"
,,,,,,,,,,,,,,,,,,,
,Account: 2400100 - Gifts,,,,,,,,,,,,,,,,,,
,Pr.,Mod.,Reference,Dept,Div,Suffix,Details,,,Cheque,,User,Doc Date,Post Date,Debit,,Credit,,Balance
,,,,,,Opening Balance as at :01/01/2018,,,,,,,,,0.00,,0.00,,0.00
,IN,AP,40002056,9000,900,,Wedding Gift Elisha & Alan,,,,,SB,08/04/2018,08/04/2018,215.25,,0.00,,215.25
,IN,AP,40003670,9000,900,,Invoice,,,,,SB,15/11/2018,15/11/2018,335.52,,0.00,,550.77
,IN,AP,40003086,9000,900,,Invoice,,,,,,21/12/2018,21/12/2018,127.12,,0.00,,677.89
,,,,,,,,,,,,,,,,,,,
,Account: 2500100 - Insurance - Employees,,,,,,,,,,,,,,,,,,
,Pr.,Mod.,Reference,Dept,Div,Suffix,Details,,,Cheque,,User,Doc Date,Post Date,Debit,,Credit,,Balance
,IN,AP,40002772,9000,900,,Non Motor Policy,,,,,SB,16/02/2018,16/02/2018,74.00,,0.00,,74.00
,,,,,,,,,,,,,,,,,,,
,,,,,,,,,,,,,,,,,,,
,Account: 4050110 - Staff Expenses - Licenses,,,,,,,,,,,,,,,,,,
,Pr.,Mod.,Reference,Dept,Div,Suffix,Details,,,Cheque,,User,Doc Date,Post Date,Debit,,Credit,,Balance
,,,,,,Opening Balance as at :01/01/2018,,,,,,,,,0.00,,0.00,,0.00
,IN,AP,40003666,9000,900,,Invoice,,,,,,19/07/2018,19/07/2018,208.00,,0.00,,208.00
,JN,GL,22000063,1001,100,,Excess On Accident,,,2420,,SB,10/10/2018,10/10/2018,190.00,,0.00,,398.00
,,,,,,,,,,,,,,,,,,,
,Account: 4050120 - Staff Expenses - Functions,,,,,,,,,,,,,,,,,,
,Pr.,Mod.,Reference,Dept,Div,Suffix,Details,,,Cheque,,User,Doc Date,Post Date,Debit,,Credit,,Balance
,IN,AP,40002544,9000,900,,PORK CHEEKS,,,,,SB,17/08/2018,17/08/2018,14.79,,0.00,,14.79
,IN,AP,40002519,9000,900,,Invoice,,,,,SB,20/08/2018,20/08/2018,321.46,,0.00,,336.25
,IN,AP,40002545,9000,900,,PORK BELLIES,,,,,SB,20/08/2018,20/08/2018,13.08,,0.00,,349.33
,IN,AP,40002546,9000,900,,FOOD,,,,,SB,20/08/2018,20/08/2018,159.55,,0.00,,508.88
,IN,AP,40002541,9000,900,,HOG CASINGS,,,,,SB,21/08/2018,21/08/2018,10.00,,0.00,,518.88
,IN,AP,40002542,9000,900,,PORK CHEEKS,,,,,SB,21/08/2018,21/08/2018,26.68,,0.00,,545.56
,IN,AP,40002543,9000,900,,PORK BELLY RIBS,,,,,SB,21/08/2018,21/08/2018,113.41,,0.00,,658.97
,IN,AP,40002537,9000,900,,Food Function,,,,,SB,22/08/2018,22/08/2018,33.20,,0.00,,692.17
,IN,AP,40002557,9000,900,,Invoice,,,,,SB,24/08/2018,24/08/2018,20.00,,0.00,,712.17
,IN,AP,40002558,9000,900,,Butcher,,,,,SB,24/08/2018,24/08/2018,15.05,,0.00,,727.22
,,,,,,,,,,,,,,,,,,,
,Account: 4050130 - Staff Expenses - Medical,,,,,,,,,,,,,,,,,,
,Pr.,Mod.,Reference,Dept,Div,Suffix,Details,,,Cheque,,User,Doc Date,Post Date,Debit,,Credit,,Balance
,IN,AP,40002740,9000,900,,Panadol Advance Qty 2boxes,,,,,SB,01/09/2018,01/09/2018,5.70,,0.00,,5.70
,IN,AP,40002871,9000,900,,Invoice,,,,,,16/10/2018,16/10/2018,5.50,,0.00,,11.20
,,,,,,,,,,,,,,,,,,,
,Account: 4050140 - Staff Expenses - Toiletries,,,,,,,,,,,,,,,,,,
,Pr.,Mod.,Reference,Dept,Div,Suffix,Details,,,Cheque,,User,Doc Date,Post Date,Debit,,Credit,,Balance
,,,,,,Opening Balance as at :01/01/2018,,,,,,,,,0.00,,0.00,,0.00
,IN,AP,40003646,9000,900,,Invoice,,,,,,31/12/2018,31/12/2018,1.30,,0.00,,1.30
,,,,,,,,,,,,,,,,,,,
,Account: 4050141 - Refreshments - Beverages,,,,,,,,,,,,,,,,,,
,Pr.,Mod.,Reference,Dept,Div,Suffix,Details,,,Cheque,,User,Doc Date,Post Date,Debit,,Credit,,Balance
,,,,,,Opening Balance as at :01/01/2018,,,,,,,,,0.00,,0.00,,0.00
,IN,AP,40001630,9000,900,,Invoice,,,,,SB,09/01/2018,09/01/2018,1.62,,0.00,,1.62
,IN,AP,40001631,9000,900,,Invoice,,,,,SB,15/01/2018,15/01/2018,0.95,,0.00,,2.57
,IN,AP,40001632,9000,900,,Invoice,,,,,SB,15/01/2018,15/01/2018,1.62,,0.00,,4.19
,IN,AP,40001620,9000,900,,Invoice,,,,,SB,18/01/2018,18/01/2018,1.62,,0.00,,5.81
,,,,,,,,,,,,,,,,,,,
,IN,AP,40001621,9000,900,,Invoice,,,,,SB,18/01/2018,18/01/2018,1.62,,0.00,,7.43
,IN,AP,40001622,9000,900,,Invoice,,,,,SB,20/01/2018,20/01/2018,1.62,,0.00,,9.05
,IN,AP,40001637,9000,900,,Invoice,,,,,SB,23/01/2018,23/01/2018,7.85,,0.00,,16.90
,IN,AP,40001638,9000,900,,Invoice,,,,,SB,23/01/2018,23/01/2018,1.62,,0.00,,18.52
,IN,AP,40001639,9000,900,,Invoice,,,,,SB,24/01/2018,24/01/2018,1.62,,0.00,,20.14
,IN,AP,40001640,9000,900,,Invoice,,,,,SB,25/01/2018,25/01/2018,1.62,,0.00,,21.76
,IN,AP,40001702,9000,900,,Invoice,,,,,SB,30/01/2018,30/01/2018,1.62,,0.00,,23.38
,IN,AP,40001703,9000,900,,Invoice,,,,,SB,01/02/2018,01/02/2018,1.62,,0.00,,25.00
,IN,AP,40001704,9000,900,,Invoice,,,,,SB,02/02/2018,02/02/2018,1.62,,0.00,,26.62
,IN,AP,40001705,9000,900,,Invoice,,,,,SB,05/02/2018,05/02/2018,1.62,,0.00,,28.24
,IN,AP,40001706,9000,900,,Invoice,,,,,SB,06/02/2018,06/02/2018,1.62,,0.00,,29.86
,IN,AP,40001714,9000,900,,Invoice,,,,,SB,06/02/2018,06/02/2018,12.66,,0.00,,42.52
,IN,AP,40001715,9000,900,,Invoice,,,,,SB,06/02/2018,06/02/2018,0.47,,0.00,,42.99
,IN,AP,40001716,9000,900,,Invoice,,,,,SB,07/02/2018,07/02/2018,0.81,,0.00,,43.80
,IN,AP,40001717,9000,900,,Invoice,,,,,SB,08/02/2018,08/02/2018,2.43,,0.00,,46.23
,IN,AP,40001718,9000,900,,Invoice,,,,,SB,12/02/2018,12/02/2018,1.64,,0.00,,47.87
,IN,AP,40001727,9000,900,,Invoice,,,,,SB,13/02/2018,13/02/2018,2.43,,0.00,,50.30
,IN,AP,40001728,9000,900,,Invoice,,,,,SB,14/02/2018,14/02/2018,0.81,,0.00,,51.11
,IN,AP,40001729,9000,900,,Invoice,,,,,SB,15/02/2018,15/02/2018,2.43,,0.00,,53.54
,IN,AP,40001730,9000,900,,Invoice,,,,,SB,16/02/2018,16/02/2018,1.62,,0.00,,55.16
,IN,AP,40001731,9000,900,,Invoice,,,,,SB,19/02/2018,19/02/2018,1.66,,0.00,,56.82
,IN,AP,40001798,9000,900,,Invoice,,,,,SB,14/03/2018,14/03/2018,2.43,,0.00,,59.25
,IN,AP,40001799,9000,900,,Invoice,,,,,SB,21/03/2018,21/03/2018,1.62,,0.00,,60.87
,IN,AP,40001800,9000,900,,Invoice,,,,,SB,23/03/2018,23/03/2018,1.62,,0.00,,62.49
,IN,AP,40001817,9000,900,,Invoice,,,,,SB,26/03/2018,26/03/2018,1.62,,0.00,,64.11
,IN,AP,40001818,9000,900,,Invoice,,,,,SB,26/03/2018,26/03/2018,1.62,,0.00,,65.73
,IN,AP,40001819,9000,900,,Invoice,,,,,SB,26/03/2018,26/03/2018,1.64,,0.00,,67.37
,IN,AP,40001827,9000,900,,Invoice,,,,,SB,05/04/2018,05/04/2018,1.62,,0.00,,68.99
,IN,AP,40001828,9000,900,,Invoice,,,,,SB,05/04/2018,05/04/2018,1.62,,0.00,,70.61
,CN,AP,41000026,9000,900,,Credit Note,,,,,SB,05/04/2018,05/04/2018,0.00,,1.62,,68.99
,CN,AP,41000027,9000,900,,Credit Note,,,,,SB,05/04/2018,05/04/2018,0.00,,1.62,,67.37
,IN,AP,40001830,9000,900,,Invoice,,,,,SB,05/04/2018,05/04/2018,1.62,,0.00,,68.99
,IN,AP,40001831,9000,900,,Invoice,,,,,SB,05/04/2018,05/04/2018,1.62,,0.00,,70.61
,IN,AP,40002131,9000,900,,Invoice,,,,,SB,10/04/2018,10/04/2018,1.64,,0.00,,72.25
,IN,AP,40002132,9000,900,,Invoice,,,,,SB,16/04/2018,16/04/2018,2.43,,0.00,,74.68
,IN,AP,40002145,9000,900,,Invoice,,,,,SB,17/04/2018,17/04/2018,1.62,,0.00,,76.30
,IN,AP,40002140,9000,900,,Invoice,,,,,SB,20/04/2018,20/04/2018,1.62,,0.00,,77.92
,IN,AP,40002124,9000,900,,Invoice,,,,,SB,23/04/2018,23/04/2018,0.92,,0.00,,78.84
,IN,AP,40002125,9000,900,,Invoice,,,,,SB,24/04/2018,24/04/2018,1.62,,0.00,,80.46
,IN,AP,40002126,9000,900,,Invoice,,,,,SB,24/04/2018,24/04/2018,1.62,,0.00,,82.08
,IN,AP,40002198,9000,900,,Invoice,,,,,SB,05/05/2018,05/05/2018,1.62,,0.00,,83.70
,IN,AP,40002152,9000,900,,Invoice,,,,,SB,07/05/2018,07/05/2018,1.62,,0.00,,85.32
,IN,AP,40003580,9000,900,,Invoice,,,,,SB,10/05/2018,10/05/2018,0.81,,0.00,,86.13
,IN,AP,40002153,9000,900,,Invoice,,,,,SB,11/05/2018,11/05/2018,1.62,,0.00,,87.75
,IN,AP,40002154,9000,900,,Invoice,,,,,SB,11/05/2018,11/05/2018,1.62,,0.00,,89.37
,IN,AP,40002117,9000,900,,Invoice,,,,,SB,14/05/2018,14/05/2018,1.62,,0.00,,90.99
,IN,AP,40002118,9000,900,,Invoice,,,,,SB,15/05/2018,15/05/2018,0.81,,0.00,,91.80
,IN,AP,40002119,9000,900,,Invoice,,,,,SB,16/05/2018,16/05/2018,1.62,,0.00,,93.42
,IN,AP,40002120,9000,900,,Invoice,,,,,SB,21/05/2018,21/05/2018,1.62,,0.00,,95.04
,IN,AP,40002202,9000,900,,Invoice,,,,,SB,22/05/2018,22/05/2018,1.62,,0.00,,96.66
,IN,AP,40002203,9000,900,,Invoice,,,,,SB,24/05/2018,24/05/2018,1.62,,0.00,,98.28
,IN,AP,40002204,9000,900,,Invoice,,,,,SB,28/05/2018,28/05/2018,2.47,,0.00,,100.75
,IN,AP,40002272,9000,900,,Invoice,,,,,SB,01/06/2018,01/06/2018,1.62,,0.00,,102.37
,IN,AP,40002273,9000,900,,Invoice,,,,,SB,01/06/2018,01/06/2018,1.62,,0.00,,103.99
,IN,AP,40002267,9000,900,,Invoice,,,,,SB,06/06/2018,06/06/2018,1.62,,0.00,,105.61
,IN,AP,40002268,9000,900,,Invoice,,,,,SB,06/06/2018,06/06/2018,1.62,,0.00,,107.23
,IN,AP,40002281,9000,900,,Invoice,,,,,SB,08/06/2018,08/06/2018,1.62,,0.00,,108.85
,IN,AP,40002282,9000,900,,Invoice,,,,,SB,11/06/2018,11/06/2018,1.66,,0.00,,110.51
,IN,AP,40002283,9000,900,,Invoice,,,,,SB,12/06/2018,12/06/2018,1.62,,0.00,,112.13
,IN,AP,40002284,9000,900,,Invoice,,,,,SB,14/06/2018,14/06/2018,0.92,,0.00,,113.05
,IN,AP,40002300,9000,900,,Invoice,,,,,SB,20/06/2018,20/06/2018,2.45,,0.00,,115.50
,IN,AP,40002301,9000,900,,Invoice,,,,,SB,20/06/2018,20/06/2018,1.62,,0.00,,117.12
,IN,AP,40002302,9000,900,,Invoice,,,,,SB,21/06/2018,21/06/2018,1.62,,0.00,,118.74
,IN,AP,40002303,9000,900,,Invoice,,,,,SB,22/06/2018,22/06/2018,1.64,,0.00,,120.38
,IN,AP,40002339,9000,900,,Invoice,,,,,SB,27/06/2018,27/06/2018,1.27,,0.00,,121.65
,IN,AP,40002349,9000,900,,Invoice,,,,,SB,04/07/2018,04/07/2018,0.81,,0.00,,122.46
,IN,AP,40002372,9000,900,,Invoice,,,,,SB,09/07/2018,09/07/2018,0.81,,0.00,,123.27
,IN,AP,40002373,9000,900,,Invoice,,,,,SB,11/07/2018,11/07/2018,2.43,,0.00,,125.70
,IN,AP,40002374,9000,900,,Invoice,,,,,SB,12/07/2018,12/07/2018,1.66,,0.00,,127.36
,IN,AP,40002414,9000,900,,Invoice,,,,,SB,18/07/2018,18/07/2018,1.62,,0.00,,128.98
,IN,AP,40002486,9000,900,,Invoice,,,,,SB,01/08/2018,01/08/2018,1.62,,0.00,,130.60
,IN,AP,40002487,9000,900,,Invoice,,,,,SB,01/08/2018,01/08/2018,1.62,,0.00,,132.22
,IN,AP,40002488,9000,900,,Invoice,,,,,SB,01/08/2018,01/08/2018,1.62,,0.00,,133.84
,IN,AP,40002489,9000,900,,Invoice,,,,,SB,02/08/2018,02/08/2018,1.62,,0.00,,135.46
,IN,AP,40002490,9000,900,,Invoice,,,,,SB,03/08/2018,03/08/2018,1.62,,0.00,,137.08
,IN,AP,40002491,9000,900,,Invoice,,,,,SB,08/08/2018,08/08/2018,1.62,,0.00,,138.70
,IN,AP,40002555,9000,900,,Invoice,,,,,SB,08/08/2018,08/08/2018,10.08,,0.00,,148.78
,IN,AP,40002492,9000,900,,Invoice,,,,,SB,09/08/2018,09/08/2018,1.62,,0.00,,150.40
,IN,AP,40002483,9000,900,,Invoice,,,,,SB,13/08/2018,13/08/2018,0.81,,0.00,,151.21
,IN,AP,40002484,9000,900,,Invoice,,,,,SB,14/08/2018,14/08/2018,1.62,,0.00,,152.83
,IN,AP,40002526,9000,900,,Invoice,,,,,SB,22/08/2018,22/08/2018,1.62,,0.00,,154.45
,IN,AP,40002731,9000,900,,Invoice,,,,,SB,01/09/2018,01/09/2018,1.62,,0.00,,156.07
,IN,AP,40002732,9000,900,,Invoice,,,,,SB,01/09/2018,01/09/2018,1.62,,0.00,,157.69
,IN,AP,40002733,9000,900,,Invoice,,,,,SB,01/09/2018,01/09/2018,1.62,,0.00,,159.31
,IN,AP,40002746,9000,900,,Invoice,,,,,SB,18/09/2018,18/09/2018,0.81,,0.00,,160.12
,IN,AP,40002747,9000,900,,Invoice,,,,,SB,24/09/2018,24/09/2018,0.81,,0.00,,160.93
,IN,AP,40002655,9000,900,,Invoice,,,,,SB,28/09/2018,28/09/2018,1.39,,0.00,,162.32
,IN,AP,40002754,9000,900,,Invoice,,,,,SB,01/10/2018,01/10/2018,1.66,,0.00,,163.98
,,,,,,,,,,,,,,,,,,,
,Account: 4050150 - Consumables,,,,,,,,,,,,,,,,,,
,Pr.,Mod.,Reference,Dept,Div,Suffix,Details,,,Cheque,,User,Doc Date,Post Date,Debit,,Credit,,Balance
,IN,AP,40001722,9000,900,,First Aid Medium,,,,,SB,18/01/2018,18/01/2018,91.20,,0.00,,91.20
,CN,AP,41000025,9000,900,,Credit Note,,,,,SB,31/01/2018,31/01/2018,0.00,,25.64,,65.56
,,,,,,,,,,,,,,,,,,,
,Account: 4050180 - CVA Charges,,,,,,,,,,,,,,,,,,
,Pr.,Mod.,Reference,Dept,Div,Suffix,Details,,,Cheque,,User,Doc Date,Post Date,Debit,,Credit,,Balance
,,,,,,Opening Balance as at :01/01/2018,,,,,,,,,0.00,,0.00,,0.00
,IN,AP,40001751,9000,900,DAI696,Oct - Dec 2017,,,,,SB,01/01/2018,01/01/2018,0.82,,0.00,,0.82
,JN,GL,22000070,1001,100,,Opening Balance Adjustment,,,,,,01/01/2018,01/01/2018,0.00,,0.82,,0.00
,IN,AP,40001725,9000,900,ZQZ173,Invoice,,,,,SB,08/02/2018,08/02/2018,8.20,,0.00,,8.20
,IN,AP,40002162,9000,900,DCB204,Period - 01-012018 - 31/03/2018,,,,,SB,01/04/2018,01/04/2018,4.92,,0.00,,13.12
,IN,AP,40002163,9000,900,DCB204,Period - 01-03-2018 - 31-03-2018,,,,,SB,01/04/2018,01/04/2018,20.50,,0.00,,33.62
,IN,AP,40002161,9000,900,,CVA Charges On ZQZ084,,,,,SB,23/05/2018,23/05/2018,13.94,,0.00,,47.56
,IN,AP,40002818,9000,900,,Invoice,,,,,,01/06/2018,01/06/2018,13.20,,0.00,,60.76
,IN,AP,40002819,9000,900,,Invoice,,,,,,01/06/2018,01/06/2018,20.15,,0.00,,80.91
,IN,AP,40002820,9000,900,,Invoice,,,,,,01/06/2018,01/06/2018,1.39,,0.00,,82.30
,IN,AP,40002399,9000,900,,March & April,,,,,SB,26/06/2018,26/06/2018,54.08,,0.00,,136.38
,IN,AP,40002821,9000,900,,Invoice,,,,,,01/07/2018,01/07/2018,2.78,,0.00,,139.16
,IN,AP,40002822,9000,900,,Invoice,,,,,,01/07/2018,01/07/2018,9.73,,0.00,,148.89
,IN,AP,40002823,9000,900,,Invoice,,,,,,01/07/2018,01/07/2018,33.36,,0.00,,182.25
,IN,AP,40002824,9000,900,,Invoice,,,,,,01/08/2018,01/08/2018,6.95,,0.00,,189.20
,IN,AP,40002825,9000,900,,Invoice,,,,,,01/08/2018,01/08/2018,21.54,,0.00,,210.74
,IN,AP,40002826,9000,900,,Invoice,,,,,,01/08/2018,01/08/2018,6.25,,0.00,,216.99
,IN,AP,40002827,9000,900,,Invoice,,,,,,01/08/2018,01/08/2018,18.07,,0.00,,235.06
,IN,AP,40002477,9000,900,,CVA ZQZ084,,,,,SB,13/08/2018,13/08/2018,22.20,,0.00,,257.26
,IN,AP,40002828,9000,900,,Invoice,,,,,,01/10/2018,01/10/2018,16.68,,0.00,,273.94
,IN,AP,40002829,9000,900,,Invoice,,,,,,01/10/2018,01/10/2018,18.07,,0.00,,292.01
,IN,AP,40002830,9000,900,,Invoice,,,,,,01/10/2018,01/10/2018,4.86,,0.00,,296.87
,IN,AP,40002831,9000,900,,Invoice,,,,,,01/10/2018,01/10/2018,21.54,,0.00,,318.41
,IN,AP,40002832,9000,900,,Invoice,,,,,,01/10/2018,01/10/2018,0.69,,0.00,,319.10
,IN,AP,40002833,9000,900,,Invoice,,,,,,01/10/2018,01/10/2018,4.17,,0.00,,323.27
,IN,AP,40002834,9000,900,,Invoice,,,,,,01/10/2018,01/10/2018,0.69,,0.00,,323.96
,IN,AP,40002835,9000,900,,Invoice,,,,,,01/10/2018,01/10/2018,13.90,,0.00,,337.86
,IN,AP,40002836,9000,900,,Invoice,,,,,,01/10/2018,01/10/2018,10.42,,0.00,,348.28
,IN,AP,40002837,9000,900,,Invoice,,,,,,01/10/2018,01/10/2018,3.47,,0.00,,351.75
,IN,AP,40002838,9000,900,,Invoice,,,,,,01/10/2018,01/10/2018,3.47,,0.00,,355.22
,IN,AP,40002839,9000,900,,Invoice,,,,,,01/10/2018,01/10/2018,3.47,,0.00,,358.69
,,,,,,,,,,,,,,,,,,,
,Account: 4100100 - Postage,,,,,,,,,,,,,,,,,,
,Pr.,Mod.,Reference,Dept,Div,Suffix,Details,,,Cheque,,User,Doc Date,Post Date,Debit,,Credit,,Balance
,,,,,,Opening Balance as at :01/01/2018,,,,,,,,,0.00,,0.00,,0.00
,IN,AP,40001625,9000,900,,Invoice,,,,,SB,16/01/2018,16/01/2018,1.16,,0.00,,1.16
,IN,AP,40001708,9000,900,,Invoice,,,,,SB,01/02/2018,01/02/2018,1.16,,0.00,,2.32
,IN,AP,40001721,9000,900,,Invoice,,,,,SB,08/02/2018,08/02/2018,141.84,,0.00,,144.16
,IN,AP,40001806,9000,900,,Invoice,,,,,SB,21/03/2018,21/03/2018,293.28,,0.00,,437.44
,IN,AP,40002227,9000,900,,Bulk Post,,,,,SB,11/06/2018,11/06/2018,196.56,,0.00,,634.00
,IN,AP,40002287,9000,900,,Bulk Post (Statements 362),,,,,SB,19/06/2018,19/06/2018,86.88,,0.00,,720.88
,IN,AP,40002559,9000,900,,BULK POST,,,,,SB,29/08/2018,29/08/2018,144.00,,0.00,,864.88
,IN,AP,40002560,9000,900,,Invoice,,,,,SB,01/09/2018,01/09/2018,192.00,,0.00,,"1,056.88"
,IN,AP,40002757,9000,900,,Invoice,,,,,SB,01/10/2018,01/10/2018,7.20,,0.00,,"1,064.08"
,IN,AP,40002842,9000,900,,Invoice,,,,,,05/11/2018,05/11/2018,78.00,,0.00,,"1,142.08"
,IN,AP,40003119,9000,900,,Invoice,,,,,,18/12/2018,18/12/2018,2.52,,0.00,,"1,144.60"
,IN,AP,40003099,9000,900,,Invoice,,,,,,31/12/2018,31/12/2018,181.68,,0.00,,"1,326.28"
,IN,AP,40003645,9000,900,,Invoice,,,,,,31/12/2018,31/12/2018,44.64,,0.00,,"1,370.92"
,,,,,,,,,,,,,,,,,,,
,Account: 4200100 - Leasing - Motor Vehicles,,,,,,,,,,,,,,,,,,
,Pr.,Mod.,Reference,Dept,Div,Suffix,Details,,,Cheque,,User,Doc Date,Post Date,Debit,,Credit,,Balance
,,,,,,Opening Balance as at :01/01/2018,,,,,,,,,0.00,,0.00,,0.00
,IN,AP,40001725,9000,900,ZQZ173,Invoice,,,,,SB,08/02/2018,08/02/2018,991.53,,0.00,,991.53
,IN,AP,40002113,9000,900,ZQZ173,Ford Fiesta,,,,,SB,08/05/2018,08/05/2018,991.53,,0.00,,"1,983.06"
,IN,AP,40002408,9000,900,,Lease Ford Fiesta ZQZ-173,,,,,SB,26/07/2018,26/07/2018,991.53,,0.00,,"2,974.59"
,IN,AP,40002430,9000,900,,Rental DAF LF 45 - HBI 476,,,,,SB,31/07/2018,31/07/2018,"1,615.00",,0.00,,"4,589.59"
,IN,AP,40002804,9000,900,,Invoice,,,,,,29/11/2018,29/11/2018,"1,019.67",,0.00,,"5,609.26"
,,,,,,,,,,,,,,,,,,,
,Account: 4250100 - Repairs & Maintenance  - Hardware,,,,,,,,,,,,,,,,,,
,Pr.,Mod.,Reference,Dept,Div,Suffix,Details,,,Cheque,,User,Doc Date,Post Date,Debit,,Credit,,Balance
,,,,,,Opening Balance as at :01/01/2018,,,,,,,,,0.00,,0.00,,0.00
,IN,AP,40002108,9000,900,,ADJ,,,,,SB,31/01/2018,31/01/2018,18.00,,0.00,,18.00
,JN,GL,22000443,1001,100,,Journal Entry,,,,,,31/01/2018,31/01/2018,337.00,,0.00,,355.00
,IN,AP,40002112,9000,900,,Invoice,,,,,SB,02/03/2018,02/03/2018,500.00,,0.00,,855.00
,IN,AP,40001814,9000,900,,Invoice,,,,,SB,31/03/2018,31/03/2018,200.00,,0.00,,"1,055.00"
,IN,AP,40002090,9000,900,,Invoice,,,,,SB,30/04/2018,30/04/2018,297.00,,0.00,,"1,352.00"
,IN,AP,40002402,9000,900,,Replacement Of Parts (Printer),,,,,SB,10/07/2018,10/07/2018,504.64,,0.00,,"1,856.64"
,CN,AP,41000114,9000,900,,Credit Note,,,,,,31/12/2018,31/12/2018,0.00,,613.73,,"1,242.91"
,IN,AP,40003668,9000,900,,Invoice,,,,,,31/12/2018,31/12/2018,613.73,,0.00,,"1,856.64"
,,,,,,,,,,,,,,,,,,,
,Account: 4250110 - IT Services,,,,,,,,,,,,,,,,,,
,Pr.,Mod.,Reference,Dept,Div,Suffix,Details,,,Cheque,,User,Doc Date,Post Date,Debit,,Credit,,Balance
,IN,AP,40001793,9000,900,,Invoice,,,,,SB,02/01/2018,02/01/2018,40.00,,0.00,,40.00
,IN,AP,40001794,9000,900,,Invoice,,,,,SB,02/01/2018,02/01/2018,387.00,,0.00,,427.00
,IN,AP,40001795,9000,900,,Invoice,,,,,SB,28/02/2018,28/02/2018,407.00,,0.00,,834.00
,IN,AP,40002160,9000,900,,06-10-2017,,,,,SB,06/04/2018,06/04/2018,700.00,,0.00,,"1,534.00"
,IN,AP,40003287,9000,900,,Invoice,,,,,,31/05/2018,31/05/2018,348.00,,0.00,,"1,882.00"
,IN,AP,40003288,9000,900,,Invoice,,,,,,30/06/2018,30/06/2018,193.00,,0.00,,"2,075.00"
,IN,AP,40003289,9000,900,,Invoice,,,,,,31/07/2018,31/07/2018,194.00,,0.00,,"2,269.00"
,IN,AP,40003290,9000,900,,Invoice,,,,,,31/08/2018,31/08/2018,408.00,,0.00,,"2,677.00"
,IN,AP,40002645,9000,900,,Annual Acess Fee - September 2018 To August 2019,,,,,SB,19/09/2018,19/09/2018,180.00,,0.00,,"2,857.00"
,IN,AP,40003291,9000,900,,Invoice,,,,,,30/09/2018,30/09/2018,120.00,,0.00,,"2,977.00"
,IN,AP,40003292,9000,900,,Invoice,,,,,,31/10/2018,31/10/2018,213.00,,0.00,,"3,190.00"
,IN,AP,40003293,9000,900,,Invoice,,,,,,30/11/2018,30/11/2018,440.00,,0.00,,"3,630.00"
,IN,AP,40003294,9000,900,,Invoice,,,,,,31/12/2018,31/12/2018,163.00,,0.00,,"3,793.00"
,,,,,,,,,,,,,,,,,,,
,Account: 4350110 - Travelling Expenses - Accomodation,,,,,,,,,,,,,,,,,,
,Pr.,Mod.,Reference,Dept,Div,Suffix,Details,,,Cheque,,User,Doc Date,Post Date,Debit,,Credit,,Balance
,JN,GL,22000342,1001,100,,Journal Entry,,,,,,07/11/2018,07/11/2018,0.00,,348.00,,-348.00
,,,,,,,,,,,,,,,,,,,
,Account: 4350130 - Travelling Expenes - Other,,,,,,,,,,,,,,,,,,
,Pr.,Mod.,Reference,Dept,Div,Suffix,Details,,,Cheque,,User,Doc Date,Post Date,Debit,,Credit,,Balance
,JN,GL,22000343,1001,100,,Journal Entry,,,,,,07/11/2018,07/11/2018,696.00,,0.00,,696.00
,,,,,,,,,,,,,,,,,,,
,Account: 4400100 - Printing Expenses,,,,,,,,,,,,,,,,,,
,Pr.,Mod.,Reference,Dept,Div,Suffix,Details,,,Cheque,,User,Doc Date,Post Date,Debit,,Credit,,Balance
,,,,,,Opening Balance as at :01/01/2018,,,,,,,,,0.00,,0.00,,0.00
,IN,AP,40001834,9000,900,,Invoice,,,,,SB,03/04/2018,03/04/2018,142.50,,0.00,,142.50
,,,,,,,,,,,,,,,,,,,
,,,,,,,,,,,,,,,,,,,
,Account: 4400110 - Stationery,,,,,,,,,,,,,,,,,,
,Pr.,Mod.,Reference,Dept,Div,Suffix,Details,,,Cheque,,User,Doc Date,Post Date,Debit,,Credit,,Balance
,,,,,,Opening Balance as at :01/01/2018,,,,,,,,,0.00,,0.00,,0.00
,IN,AP,40001653,9000,900,,Invoice,,,,,SB,08/01/2018,08/01/2018,95.20,,0.00,,95.20
,IN,AP,40001712,9000,900,,Invoice,,,,,SB,19/01/2018,19/01/2018,265.00,,0.00,,360.20
,IN,AP,40001710,9000,900,,Invoice,,,,,SB,24/01/2018,24/01/2018,62.00,,0.00,,422.20
,IN,AP,40001711,9000,900,,Invoice,,,,,SB,24/01/2018,24/01/2018,185.15,,0.00,,607.35
,IN,AP,40001741,9000,900,,Black Pens x10,,,,,SB,19/02/2018,19/02/2018,65.84,,0.00,,673.19
,IN,AP,40001742,9000,900,,Correcting Mouse x 10,,,,,SB,21/02/2018,21/02/2018,24.52,,0.00,,697.71
,IN,AP,40001752,9000,900,,Invoice,,,,,SB,26/02/2018,26/02/2018,1.00,,0.00,,698.71
,IN,AP,40001770,9000,900,,Invoice,,,,,SB,09/03/2018,09/03/2018,130.00,,0.00,,828.71
,IN,AP,40001835,9000,900,,Invoice,,,,,SB,03/04/2018,03/04/2018,26.30,,0.00,,855.01
,IN,AP,40002051,9000,900,,Invoice,,,,,SB,23/04/2018,23/04/2018,232.58,,0.00,,"1,087.59"
,CN,AP,41000083,9000,900,,Credit Note,,,,,SB,24/04/2018,24/04/2018,0.00,,3.00,,"1,084.59"
,IN,AP,40002149,9000,900,,Sharp Toner Black X2,,,,,SB,21/05/2018,21/05/2018,110.00,,0.00,,"1,194.59"
,IN,AP,40002226,9000,900,,Invoice,,,,,SB,04/06/2018,04/06/2018,150.63,,0.00,,"1,345.22"
,IN,AP,40002270,9000,900,,Steering Cover,,,,,SB,05/06/2018,05/06/2018,7.50,,0.00,,"1,352.72"
,IN,AP,40002299,9000,900,,Conan Toner X2,,,,,SB,25/06/2018,25/06/2018,171.00,,0.00,,"1,523.72"
,IN,AP,40002351,9000,900,,Invoice,,,,,SB,09/07/2018,09/07/2018,28.81,,0.00,,"1,552.53"
,IN,AP,40002401,9000,900,,Stamps Qty 400,,,,,SB,19/07/2018,19/07/2018,104.00,,0.00,,"1,656.53"
,IN,AP,40002424,9000,900,,Invoice,,,,,SB,01/08/2018,01/08/2018,173.85,,0.00,,"1,830.38"
,IN,AP,40002517,9000,900,,Invoice,,,,,SB,10/08/2018,10/08/2018,22.28,,0.00,,"1,852.66"
,IN,AP,40002538,9000,900,,Ink Conan,,,,,SB,20/08/2018,20/08/2018,26.30,,0.00,,"1,878.96"
,IN,AP,40002539,9000,900,,Invoice,,,,,SB,20/08/2018,20/08/2018,42.36,,0.00,,"1,921.32"
,IN,AP,40002540,9000,900,,Invoice,,,,,SB,27/08/2018,27/08/2018,90.00,,0.00,,"2,011.32"
,IN,AP,40002646,9000,900,,Invoice,,,,,SB,18/09/2018,18/09/2018,151.44,,0.00,,"2,162.76"
,IN,AP,40002807,9000,900,,Invoice,,,,,,05/10/2018,05/10/2018,110.00,,0.00,,"2,272.76"
,IN,AP,40002811,9000,900,,Invoice,,,,,,09/10/2018,09/10/2018,43.00,,0.00,,"2,315.76"
,IN,AP,40002808,9000,900,,Invoice,,,,,,11/10/2018,11/10/2018,77.50,,0.00,,"2,393.26"
,IN,AP,40002812,9000,900,,Invoice,,,,,,06/11/2018,06/11/2018,465.49,,0.00,,"2,858.75"
,IN,AP,40002840,9000,900,,Invoice,,,,,,09/11/2018,09/11/2018,107.63,,0.00,,"2,966.38"
,IN,AP,40002813,9000,900,,Invoice,,,,,,20/12/2018,20/12/2018,97.86,,0.00,,"3,064.24"
,,,,,,,,,,,,,,,,,,,
,Account: 4400140 - Books,,,,,,,,,,,,,,,,,,
,Pr.,Mod.,Reference,Dept,Div,Suffix,Details,,,Cheque,,User,Doc Date,Post Date,Debit,,Credit,,Balance
,IN,AP,40003648,9000,900,,Invoice,,,,,SB,05/01/2018,05/01/2018,552.24,,0.00,,552.24
,,,,,,,,,,,,,,,,,,,
,Account: 4450100 - Telephone And Internet Expenses,,,,,,,,,,,,,,,,,,
,Pr.,Mod.,Reference,Dept,Div,Suffix,Details,,,Cheque,,User,Doc Date,Post Date,Debit,,Credit,,Balance
,,,,,,Opening Balance as at :01/01/2018,,,,,,,,,0.00,,0.00,,0.00
,IN,AP,40001837,9000,900,,Invoice,,,,,SB,04/01/2018,04/01/2018,127.32,,0.00,,127.32
,IN,AP,40001838,9000,900,,Invoice,,,,,SB,03/02/2018,03/02/2018,131.65,,0.00,,258.97
,IN,AP,40001839,9000,900,,Invoice,,,,,SB,03/03/2018,03/03/2018,174.56,,0.00,,433.53
,IN,AP,40001840,9000,900,,Invoice,,,,,SB,04/03/2018,04/03/2018,187.72,,0.00,,621.25
,IN,AP,40002099,9000,900,,Landline,,,,,SB,03/05/2018,03/05/2018,167.72,,0.00,,788.97
,IN,AP,40002217,9000,900,,Landline,,,,,SB,03/06/2018,03/06/2018,176.20,,0.00,,965.17
,IN,AP,40002382,9000,900,,Landline,,,,,SB,03/07/2018,03/07/2018,170.11,,0.00,,"1,135.28"
,IN,AP,40002561,9000,900,,79753655 - Alarm,,,,,SB,03/08/2018,03/08/2018,0.63,,0.00,,"1,135.91"
,IN,AP,40002562,9000,900,,Telephone,,,,,SB,03/08/2018,03/08/2018,177.82,,0.00,,"1,313.73"
,IN,AP,40002578,9000,900,,Invoice,,,,,SB,03/09/2018,03/09/2018,202.60,,0.00,,"1,516.33"
,IN,AP,40002583,9000,900,,Invoice,,,,,SB,03/09/2018,03/09/2018,94.40,,0.00,,"1,610.73"
,JN,GL,22000457,1001,100,,Internet Charge,,,,,,31/12/2018,31/12/2018,174.05,,0.00,,"1,784.78"
,,,,,,,,,,,,,,,,,,,
,Account: 4450110 - Telephone And Mobile Expenses,,,,,,,,,,,,,,,,,,
,Pr.,Mod.,Reference,Dept,Div,Suffix,Details,,,Cheque,,User,Doc Date,Post Date,Debit,,Credit,,Balance
,,,,,,Opening Balance as at :01/01/2018,,,,,,,,,0.00,,0.00,,0.00
,JN,GL,22000456,1001,100,,Opening Balance,,,,,,01/01/2018,01/01/2018,0.00,,570.00,,-570.00
,IN,AP,40001841,9000,900,,Invoice,,,,,SB,04/01/2018,04/01/2018,13.22,,0.00,,-556.78
,IN,AP,40001842,9000,900,,Invoice,,,,,SB,04/01/2018,04/01/2018,16.24,,0.00,,-540.54
,IN,AP,40001843,9000,900,,Invoice,,,,,SB,04/01/2018,04/01/2018,57.28,,0.00,,-483.26
,IN,AP,40001844,9000,900,,Invoice,,,,,SB,04/01/2018,04/01/2018,13.50,,0.00,,-469.76
,IN,AP,40001845,9000,900,,Invoice,,,,,SB,04/01/2018,04/01/2018,24.73,,0.00,,-445.03
,IN,AP,40001846,9000,900,,Invoice,,,,,SB,04/01/2018,04/01/2018,15.39,,0.00,,-429.64
,IN,AP,40001847,9000,900,,Invoice,,,,,SB,04/01/2018,04/01/2018,68.08,,0.00,,-361.56
,IN,AP,40001848,9000,900,,Invoice,,,,,SB,04/01/2018,04/01/2018,38.33,,0.00,,-323.23
,IN,AP,40001849,9000,900,,Invoice,,,,,SB,04/01/2018,04/01/2018,21.59,,0.00,,-301.64
,IN,AP,40001850,9000,900,,Invoice,,,,,SB,04/01/2018,04/01/2018,17.57,,0.00,,-284.07
,IN,AP,40001851,9000,900,,Invoice,,,,,SB,04/01/2018,04/01/2018,20.02,,0.00,,-264.05
,IN,AP,40001852,9000,900,,Invoice,,,,,SB,04/01/2018,04/01/2018,13.22,,0.00,,-250.83
,IN,AP,40001853,9000,900,,Invoice,,,,,SB,04/01/2018,04/01/2018,16.69,,0.00,,-234.14
,IN,AP,40001854,9000,900,,Invoice,,,,,SB,04/01/2018,04/01/2018,0.14,,0.00,,-234.00
,IN,AP,40001855,9000,900,,Invoice,,,,,SB,04/01/2018,04/01/2018,15.37,,0.00,,-218.63
,IN,AP,40001856,9000,900,,Invoice,,,,,SB,03/02/2018,03/02/2018,28.56,,0.00,,-190.07
,IN,AP,40001857,9000,900,,Invoice,,,,,SB,03/02/2018,03/02/2018,17.96,,0.00,,-172.11
,IN,AP,40001858,9000,900,,Invoice,,,,,SB,03/02/2018,03/02/2018,57.28,,0.00,,-114.83
,IN,AP,40001859,9000,900,,Invoice,,,,,SB,03/02/2018,03/02/2018,15.34,,0.00,,-99.49
,IN,AP,40001860,9000,900,,Invoice,,,,,SB,03/02/2018,03/02/2018,20.94,,0.00,,-78.55
,IN,AP,40001861,9000,900,,Invoice,,,,,SB,03/02/2018,03/02/2018,14.73,,0.00,,-63.82
,,,,,,,,,,,,,,,,,,,
,IN,AP,40001862,9000,900,,Invoice,,,,,SB,03/02/2018,03/02/2018,59.48,,0.00,,-4.34
,IN,AP,40001863,9000,900,,Invoice,,,,,SB,03/02/2018,03/02/2018,37.25,,0.00,,32.91
,IN,AP,40001864,9000,900,,Invoice,,,,,SB,03/02/2018,03/02/2018,17.65,,0.00,,50.56
,IN,AP,40001865,9000,900,,Invoice,,,,,SB,03/02/2018,03/02/2018,16.58,,0.00,,67.14
,IN,AP,40001866,9000,900,,Invoice,,,,,SB,03/02/2018,03/02/2018,16.29,,0.00,,83.43
,IN,AP,40001867,9000,900,,Invoice,,,,,SB,03/02/2018,03/02/2018,14.07,,0.00,,97.50
,IN,AP,40001868,9000,900,,Invoice,,,,,SB,03/02/2018,03/02/2018,17.10,,0.00,,114.60
,IN,AP,40001869,9000,900,,Invoice,,,,,SB,03/02/2018,03/02/2018,0.59,,0.00,,115.19
,IN,AP,40001870,9000,900,,Invoice,,,,,SB,03/02/2018,03/02/2018,16.40,,0.00,,131.59
,IN,AP,40001871,9000,900,,Invoice,,,,,SB,03/02/2018,03/02/2018,25.00,,0.00,,156.59
,IN,AP,40001872,9000,900,,Invoice,,,,,SB,03/03/2018,03/03/2018,30.91,,0.00,,187.50
,IN,AP,40001873,9000,900,,Invoice,,,,,SB,03/03/2018,03/03/2018,21.62,,0.00,,209.12
,IN,AP,40001874,9000,900,,Invoice,,,,,SB,03/03/2018,03/03/2018,57.28,,0.00,,266.40
,IN,AP,40001875,9000,900,,Invoice,,,,,SB,03/03/2018,03/03/2018,14.81,,0.00,,281.21
,IN,AP,40001876,9000,900,,Invoice,,,,,SB,03/03/2018,03/03/2018,27.83,,0.00,,309.04
,IN,AP,40001877,9000,900,,Invoice,,,,,SB,03/03/2018,03/03/2018,15.41,,0.00,,324.45
,IN,AP,40001878,9000,900,,Invoice,,,,,SB,03/03/2018,03/03/2018,62.76,,0.00,,387.21
,IN,AP,40001879,9000,900,,Invoice,,,,,SB,03/03/2018,03/03/2018,35.45,,0.00,,422.66
,IN,AP,40001880,9000,900,,Invoice,,,,,SB,03/03/2018,03/03/2018,16.42,,0.00,,439.08
,IN,AP,40001881,9000,900,,Invoice,,,,,SB,03/03/2018,03/03/2018,14.82,,0.00,,453.90
,IN,AP,40001882,9000,900,,Invoice,,,,,SB,03/03/2018,03/03/2018,15.58,,0.00,,469.48
,IN,AP,40001883,9000,900,,Invoice,,,,,SB,03/03/2018,03/03/2018,13.22,,0.00,,482.70
,IN,AP,40001884,9000,900,,Invoice,,,,,SB,03/03/2018,03/03/2018,17.66,,0.00,,500.36
,IN,AP,40001885,9000,900,,Invoice,,,,,SB,03/03/2018,03/03/2018,0.40,,0.00,,500.76
,IN,AP,40001886,9000,900,,Invoice,,,,,SB,03/03/2018,03/03/2018,15.38,,0.00,,516.14
,IN,AP,40001887,9000,900,,Invoice,,,,,SB,03/03/2018,03/03/2018,27.20,,0.00,,543.34
,IN,AP,40001888,9000,900,,Invoice,,,,,SB,03/03/2018,03/03/2018,24.89,,0.00,,568.23
,IN,AP,40001889,9000,900,,Invoice,,,,,SB,03/03/2018,03/03/2018,57.28,,0.00,,625.51
,IN,AP,40001890,9000,900,,Invoice,,,,,SB,03/03/2018,03/03/2018,17.19,,0.00,,642.70
,IN,AP,40001892,9000,900,,Invoice,,,,,SB,03/03/2018,03/03/2018,16.90,,0.00,,659.60
,IN,AP,40001893,9000,900,,Invoice,,,,,SB,03/03/2018,03/03/2018,111.91,,0.00,,771.51
,IN,AP,40001894,9000,900,,Invoice,,,,,SB,03/03/2018,03/03/2018,35.26,,0.00,,806.77
,IN,AP,40001895,9000,900,,Invoice,,,,,SB,03/03/2018,03/03/2018,17.97,,0.00,,824.74
,IN,AP,40001897,9000,900,,Invoice,,,,,SB,03/03/2018,03/03/2018,14.85,,0.00,,839.59
,IN,AP,40001898,9000,900,,Invoice,,,,,SB,03/03/2018,03/03/2018,13.22,,0.00,,852.81
,IN,AP,40001899,9000,900,,Invoice,,,,,SB,03/03/2018,03/03/2018,47.07,,0.00,,899.88
,IN,AP,40001900,9000,900,,Invoice,,,,,SB,03/03/2018,03/03/2018,0.40,,0.00,,900.28
,IN,AP,40001901,9000,900,,Invoice,,,,,SB,03/03/2018,03/03/2018,14.92,,0.00,,915.20
,IN,AP,40001891,9000,900,,Invoice,,,,,SB,04/04/2018,04/04/2018,55.46,,0.00,,970.66
,IN,AP,40001896,9000,900,,Invoice,,,,,SB,04/04/2018,04/04/2018,16.58,,0.00,,987.24
,IN,AP,40002091,9000,900,,99046999,,,,,SB,03/05/2018,03/05/2018,26.94,,0.00,,"1,014.18"
,IN,AP,40002092,9000,900,,79753637,,,,,SB,03/05/2018,03/05/2018,20.84,,0.00,,"1,035.02"
,IN,AP,40002093,9000,900,,79753638,,,,,SB,03/05/2018,03/05/2018,17.68,,0.00,,"1,052.70"
,IN,AP,40002094,9000,900,,79753636,,,,,SB,03/05/2018,03/05/2018,14.25,,0.00,,"1,066.95"
,IN,AP,40002095,9000,900,,79753639,,,,,SB,03/05/2018,03/05/2018,27.02,,0.00,,"1,093.97"
,IN,AP,40002096,9000,900,,79753645,,,,,SB,03/05/2018,03/05/2018,15.05,,0.00,,"1,109.02"
,IN,AP,40002097,9000,900,,79322138,,,,,SB,03/05/2018,03/05/2018,61.69,,0.00,,"1,170.71"
,IN,AP,40002098,9000,900,,79284264,,,,,SB,03/05/2018,03/05/2018,35.25,,0.00,,"1,205.96"
,IN,AP,40002100,9000,900,,79753641,,,,,SB,03/05/2018,03/05/2018,16.75,,0.00,,"1,222.71"
,IN,AP,40002101,9000,900,,79753642,,,,,SB,03/05/2018,03/05/2018,13.45,,0.00,,"1,236.16"
,IN,AP,40002102,9000,900,,79753643,,,,,SB,03/05/2018,03/05/2018,13.83,,0.00,,"1,249.99"
,IN,AP,40002103,9000,900,,79753635,,,,,SB,03/05/2018,03/05/2018,15.05,,0.00,,"1,265.04"
,IN,AP,40002104,9000,900,,79753644,,,,,SB,03/05/2018,03/05/2018,55.27,,0.00,,"1,320.31"
,IN,AP,40002105,9000,900,,79753655,,,,,SB,03/05/2018,03/05/2018,0.59,,0.00,,"1,320.90"
,IN,AP,40002106,9000,900,,79753640,,,,,SB,03/05/2018,03/05/2018,14.77,,0.00,,"1,335.67"
,IN,AP,40002209,9000,900,,99046999,,,,,SB,03/06/2018,03/06/2018,33.42,,0.00,,"1,369.09"
,IN,AP,40002210,9000,900,,79753637,,,,,SB,03/06/2018,03/06/2018,40.38,,0.00,,"1,409.47"
,IN,AP,40002211,9000,900,,79753638,,,,,SB,03/06/2018,03/06/2018,55.33,,0.00,,"1,464.80"
,IN,AP,40002212,9000,900,,79753636,,,,,SB,03/06/2018,03/06/2018,14.56,,0.00,,"1,479.36"
,IN,AP,40002213,9000,900,,79753639,,,,,SB,03/06/2018,03/06/2018,24.65,,0.00,,"1,504.01"
,IN,AP,40002214,9000,900,,79753645,,,,,SB,03/06/2018,03/06/2018,16.36,,0.00,,"1,520.37"
,IN,AP,40002215,9000,900,,79322138,,,,,SB,03/06/2018,03/06/2018,104.29,,0.00,,"1,624.66"
,IN,AP,40002216,9000,900,,79284264,,,,,SB,03/06/2018,03/06/2018,35.25,,0.00,,"1,659.91"
,IN,AP,40002218,9000,900,,79753641,,,,,SB,03/06/2018,03/06/2018,15.09,,0.00,,"1,675.00"
,IN,AP,40002219,9000,900,,79753642,,,,,SB,03/06/2018,03/06/2018,15.61,,0.00,,"1,690.61"
,IN,AP,40002220,9000,900,,79753643,,,,,SB,03/06/2018,03/06/2018,14.03,,0.00,,"1,704.64"
,IN,AP,40002221,9000,900,,79753635,,,,,SB,03/06/2018,03/06/2018,17.16,,0.00,,"1,721.80"
,IN,AP,40002222,9000,900,,79753644,,,,,SB,03/06/2018,03/06/2018,21.16,,0.00,,"1,742.96"
,IN,AP,40002223,9000,900,,Alarm,,,,,SB,03/06/2018,03/06/2018,0.33,,0.00,,"1,743.29"
,IN,AP,40002224,9000,900,,79753640,,,,,SB,03/06/2018,03/06/2018,22.53,,0.00,,"1,765.82"
,IN,AP,40002383,9000,900,,79753637,,,,,SB,03/07/2018,03/07/2018,46.38,,0.00,,"1,812.20"
,IN,AP,40002384,9000,900,,79753638,,,,,SB,03/07/2018,03/07/2018,53.96,,0.00,,"1,866.16"
,IN,AP,40002385,9000,900,,79753636,,,,,SB,03/07/2018,03/07/2018,14.65,,0.00,,"1,880.81"
,IN,AP,40002386,9000,900,,79753639,,,,,SB,03/07/2018,03/07/2018,21.98,,0.00,,"1,902.79"
,IN,AP,40002387,9000,900,,79322138,,,,,SB,03/07/2018,03/07/2018,111.91,,0.00,,"2,014.70"
,IN,AP,40002388,9000,900,,99046999,,,,,SB,03/07/2018,03/07/2018,27.64,,0.00,,"2,042.34"
,IN,AP,40002389,9000,900,,79753645,,,,,SB,03/07/2018,03/07/2018,16.33,,0.00,,"2,058.67"
,IN,AP,40002390,9000,900,,79284264,,,,,SB,03/07/2018,03/07/2018,35.25,,0.00,,"2,093.92"
,IN,AP,40002391,9000,900,,79753641,,,,,SB,03/07/2018,03/07/2018,16.42,,0.00,,"2,110.34"
,IN,AP,40002392,9000,900,,79753643,,,,,SB,03/07/2018,03/07/2018,14.83,,0.00,,"2,125.17"
,IN,AP,40002393,9000,900,,79753635,,,,,SB,03/07/2018,03/07/2018,17.14,,0.00,,"2,142.31"
,IN,AP,40002394,9000,900,,79753644,,,,,SB,03/07/2018,03/07/2018,17.64,,0.00,,"2,159.95"
,IN,AP,40002395,9000,900,,79753655 - ALARM,,,,,SB,03/07/2018,03/07/2018,0.18,,0.00,,"2,160.13"
,IN,AP,40002563,9000,900,,79753639,,,,,SB,03/08/2018,03/08/2018,24.07,,0.00,,"2,184.20"
,IN,AP,40002564,9000,900,,79753636,,,,,SB,03/08/2018,03/08/2018,14.20,,0.00,,"2,198.40"
,IN,AP,40002565,9000,900,,79753638,,,,,SB,03/08/2018,03/08/2018,44.66,,0.00,,"2,243.06"
,IN,AP,40002566,9000,900,,79753637,,,,,SB,03/08/2018,03/08/2018,69.03,,0.00,,"2,312.09"
,IN,AP,40002567,9000,900,,,,,,,SB,03/08/2018,03/08/2018,149.84,,0.00,,"2,461.93"
,IN,AP,40002568,9000,900,,79753646,,,,,SB,03/08/2018,03/08/2018,13.56,,0.00,,"2,475.49"
,IN,AP,40002569,9000,900,,79284264,,,,,SB,03/08/2018,03/08/2018,35.25,,0.00,,"2,510.74"
,IN,AP,40002570,9000,900,,79753642,,,,,SB,03/08/2018,03/08/2018,15.99,,0.00,,"2,526.73"
,IN,AP,40002571,9000,900,,79753641,,,,,SB,03/08/2018,03/08/2018,16.86,,0.00,,"2,543.59"
,IN,AP,40002572,9000,900,,79753640,,,,,SB,03/08/2018,03/08/2018,16.51,,0.00,,"2,560.10"
,IN,AP,40002573,9000,900,,99046999,,,,,SB,03/08/2018,03/08/2018,48.57,,0.00,,"2,608.67"
,IN,AP,40002574,9000,900,,79753643,,,,,SB,03/08/2018,03/08/2018,13.62,,0.00,,"2,622.29"
,IN,AP,40002575,9000,900,,79753635,,,,,SB,03/08/2018,03/08/2018,13.22,,0.00,,"2,635.51"
,IN,AP,40002576,9000,900,,79753645,,,,,SB,03/08/2018,03/08/2018,15.88,,0.00,,"2,651.39"
,IN,AP,40002577,9000,900,,79753644,,,,,SB,03/08/2018,03/08/2018,26.78,,0.00,,"2,678.17"
,IN,AP,40002579,9000,900,,79753639,,,,,SB,03/09/2018,03/09/2018,24.81,,0.00,,"2,702.98"
,IN,AP,40002580,9000,900,,79753636,,,,,SB,03/09/2018,03/09/2018,14.26,,0.00,,"2,717.24"
,IN,AP,40002581,9000,900,,79753638,,,,,SB,03/09/2018,03/09/2018,56.73,,0.00,,"2,773.97"
,IN,AP,40002582,9000,900,,79753637,,,,,SB,03/09/2018,03/09/2018,42.71,,0.00,,"2,816.68"
,IN,AP,40002584,9000,900,,79284264,,,,,SB,03/09/2018,03/09/2018,44.06,,0.00,,"2,860.74"
,IN,AP,40002585,9000,900,,79753642,,,,,SB,03/09/2018,03/09/2018,16.29,,0.00,,"2,877.03"
,IN,AP,40002586,9000,900,,79753640,,,,,SB,03/09/2018,03/09/2018,20.41,,0.00,,"2,897.44"
,IN,AP,40002587,9000,900,,79753641,,,,,SB,03/09/2018,03/09/2018,19.21,,0.00,,"2,916.65"
,IN,AP,40002588,9000,900,,99046999,,,,,SB,03/09/2018,03/09/2018,32.08,,0.00,,"2,948.73"
,IN,AP,40002589,9000,900,,79753646,,,,,SB,03/09/2018,03/09/2018,14.34,,0.00,,"2,963.07"
,IN,AP,40002590,9000,900,,79753635,,,,,SB,03/09/2018,03/09/2018,29.11,,0.00,,"2,992.18"
,IN,AP,40002591,9000,900,,79753645,,,,,SB,03/09/2018,03/09/2018,16.50,,0.00,,"3,008.68"
,IN,AP,40002592,9000,900,,79753655,,,,,SB,03/09/2018,03/09/2018,6.32,,0.00,,"3,015.00"
,IN,AP,40002593,9000,900,,79753644,,,,,SB,03/09/2018,03/09/2018,13.50,,0.00,,"3,028.50"
,IN,AP,40002594,9000,900,,79753643,,,,,SB,03/09/2018,03/09/2018,14.48,,0.00,,"3,042.98"
,IN,AP,40003649,9000,900,,Invoice,,,,,,31/12/2018,31/12/2018,66.60,,0.00,,"3,109.58"
,IN,AP,40003650,9000,900,,Invoice,,,,,,31/12/2018,31/12/2018,40.14,,0.00,,"3,149.72"
,IN,AP,40003651,9000,900,,Invoice,,,,,,31/12/2018,31/12/2018,133.09,,0.00,,"3,282.81"
,IN,AP,40003652,9000,900,,Invoice,,,,,,31/12/2018,31/12/2018,33.14,,0.00,,"3,315.95"
,IN,AP,40003653,9000,900,,Invoice,,,,,,31/12/2018,31/12/2018,10.31,,0.00,,"3,326.26"
,IN,AP,40003654,9000,900,,Invoice,,,,,,31/12/2018,31/12/2018,84.34,,0.00,,"3,410.60"
,IN,AP,40003655,9000,900,,Invoice,,,,,,31/12/2018,31/12/2018,29.69,,0.00,,"3,440.29"
,IN,AP,40003656,9000,900,,Invoice,,,,,,31/12/2018,31/12/2018,248.90,,0.00,,"3,689.19"
,IN,AP,40003657,9000,900,,Invoice,,,,,,31/12/2018,31/12/2018,70.50,,0.00,,"3,759.69"
,IN,AP,40003658,9000,900,,Invoice,,,,,,31/12/2018,31/12/2018,354.94,,0.00,,"4,114.63"
,IN,AP,40003659,9000,900,,Invoice,,,,,,31/12/2018,31/12/2018,37.20,,0.00,,"4,151.83"
,IN,AP,40003660,9000,900,,Invoice,,,,,,31/12/2018,31/12/2018,52.36,,0.00,,"4,204.19"
,IN,AP,40003661,9000,900,,Invoice,,,,,,31/12/2018,31/12/2018,33.17,,0.00,,"4,237.36"
,IN,AP,40003662,9000,900,,Invoice,,,,,,31/12/2018,31/12/2018,81.62,,0.00,,"4,318.98"
,IN,AP,40003663,9000,900,,Invoice,,,,,,31/12/2018,31/12/2018,52.17,,0.00,,"4,371.15"
,IN,AP,40003664,9000,900,,Invoice,,,,,,31/12/2018,31/12/2018,2.10,,0.00,,"4,373.25"
,IN,AP,40003665,9000,900,,Invoice,,,,,,31/12/2018,31/12/2018,82.41,,0.00,,"4,455.66"
,JN,GL,22000457,1001,100,,Mobile Charge,,,,,,31/12/2018,31/12/2018,464.58,,0.00,,"4,920.24"
,,,,,,,,,,,,,,,,,,,
,Account: 4450160 - Communications - Other,,,,,,,,,,,,,,,,,,
,Pr.,Mod.,Reference,Dept,Div,Suffix,Details,,,Cheque,,User,Doc Date,Post Date,Debit,,Credit,,Balance
,,,,,,Opening Balance as at :01/01/2018,,,,,,,,,0.00,,0.00,,0.00
,,,,,,,,,,,,,,,,,,,
,Account: 4500101 - Carpark Expenses,,,,,,,,,,,,,,,,,,
,Pr.,Mod.,Reference,Dept,Div,Suffix,Details,,,Cheque,,User,Doc Date,Post Date,Debit,,Credit,,Balance
,,,,,,Opening Balance as at :01/01/2018,,,,,,,,,0.00,,0.00,,0.00
,IN,AP,40001785,9000,900,,Invoice,,,,,SB,27/02/2018,27/02/2018,2.12,,0.00,,2.12
,IN,AP,40001786,9000,900,,Invoice,,,,,SB,02/03/2018,02/03/2018,2.12,,0.00,,4.24
,IN,AP,40001796,9000,900,,Invoice,,,,,SB,15/03/2018,15/03/2018,1.69,,0.00,,5.93
,IN,AP,40002142,9000,900,,Invoice,,,,,SB,12/04/2018,12/04/2018,8.47,,0.00,,14.40
,IN,AP,40002206,9000,900,,Invoice,,,,,SB,25/05/2018,25/05/2018,2.12,,0.00,,16.52
,IN,AP,40002286,9000,900,,Invoice,,,,,SB,01/06/2018,01/06/2018,4.24,,0.00,,20.76
,IN,AP,40002344,9000,900,,Invoice,,,,,SB,23/06/2018,23/06/2018,1.02,,0.00,,21.78
,IN,AP,40002529,9000,900,,Invoice,,,,,SB,21/08/2018,21/08/2018,2.12,,0.00,,23.90
,IN,AP,40002739,9000,900,,Car Park,,,,,SB,01/09/2018,01/09/2018,1.69,,0.00,,25.59
,IN,AP,40002752,9000,900,,Invoice,,,,,SB,18/09/2018,18/09/2018,1.69,,0.00,,27.28
,IN,AP,40002759,9000,900,,Invoice,,,,,SB,04/10/2018,04/10/2018,1.69,,0.00,,28.97
,IN,AP,40002763,9000,900,,Invoice,,,,,SB,10/10/2018,10/10/2018,2.54,,0.00,,31.51
,IN,AP,40002855,9000,900,,Invoice,,,,,,18/10/2018,18/10/2018,2.54,,0.00,,34.05
,IN,AP,40002870,9000,900,,Invoice,,,,,,06/11/2018,06/11/2018,2.54,,0.00,,36.59
,IN,AP,40002869,9000,900,,Invoice,,,,,,07/11/2018,07/11/2018,5.93,,0.00,,42.52
,IN,AP,40002903,9000,900,,Invoice,,,,,,07/12/2018,07/12/2018,3.39,,0.00,,45.91
,IN,AP,40003129,9000,900,,Invoice,,,,,,17/12/2018,17/12/2018,3.73,,0.00,,49.64
,,,,,,,,,,,,,,,,,,,
,Account: 4500110 - License - Light Vehicles,,,,,,,,,,,,,,,,,,
,Pr.,Mod.,Reference,Dept,Div,Suffix,Details,,,Cheque,,User,Doc Date,Post Date,Debit,,Credit,,Balance
,,,,,,Opening Balance as at :01/01/2018,,,,,,,,,0.00,,0.00,,0.00
,,,,,,,,,,,,,,,,,,,
,,,,,,,,,,,,,,,,,,,
,Account: 4500120 - Fuel - Light Vehicles,,,,,,,,,,,,,,,,,,
,Pr.,Mod.,Reference,Dept,Div,Suffix,Details,,,Cheque,,User,Doc Date,Post Date,Debit,,Credit,,Balance
,IN,AP,40001736,9000,900,LDB269,Invoice,,,,,SB,15/02/2018,15/02/2018,25.42,,0.00,,25.42
,IN,AP,40001823,9000,900,,Invoice,,,,,SB,22/03/2018,22/03/2018,16.95,,0.00,,42.37
,IN,AP,40001824,9000,900,,Invoice,,,,,SB,27/03/2018,27/03/2018,25.42,,0.00,,67.79
,IN,AP,40001825,9000,900,,Invoice,,,,,SB,28/03/2018,28/03/2018,16.95,,0.00,,84.74
,IN,AP,40002136,9000,900,,Fuel,,,,,SB,09/04/2018,09/04/2018,33.90,,0.00,,118.64
,IN,AP,40002137,9000,900,LDB269,Fuel,,,,,SB,13/04/2018,13/04/2018,16.95,,0.00,,135.59
,IN,AP,40002148,9000,900,LDB269,Invoice,,,,,SB,19/04/2018,19/04/2018,25.42,,0.00,,161.01
,IN,AP,40002129,9000,900,LDB269,Diesel,,,,,SB,30/04/2018,30/04/2018,33.90,,0.00,,194.91
,IN,AP,40003639,9000,900,,Invoice,,,,,,01/05/2018,01/05/2018,10.00,,0.00,,204.91
,IN,AP,40002158,9000,900,LDB269,Invoice,,,,,SB,11/05/2018,11/05/2018,25.42,,0.00,,230.33
,IN,AP,40002279,9000,900,LDB269,Invoice,,,,,SB,01/06/2018,01/06/2018,25.42,,0.00,,255.75
,IN,AP,40002271,9000,900,,Invoice,,,,,SB,08/06/2018,08/06/2018,25.42,,0.00,,281.17
,IN,AP,40002280,9000,900,LDB269,Invoice,,,,,SB,19/06/2018,19/06/2018,25.42,,0.00,,306.59
,IN,AP,40002353,9000,900,LDB269,Invoice,,,,,SB,09/07/2018,09/07/2018,25.42,,0.00,,332.01
,IN,AP,40002496,9000,900,,JOE,,,,,SB,01/08/2018,01/08/2018,16.95,,0.00,,348.96
,IN,AP,40002498,9000,900,,JOE,,,,,SB,01/08/2018,01/08/2018,25.42,,0.00,,374.38
,IN,AP,40002515,9000,900,,Invoice,,,,,SB,03/08/2018,03/08/2018,25.42,,0.00,,399.80
,IN,AP,40002551,9000,900,,Invoice,,,,,SB,07/08/2018,07/08/2018,25.42,,0.00,,425.22
,IN,AP,40002510,9000,900,,Joe,,,,,SB,10/08/2018,10/08/2018,29.66,,0.00,,454.88
,IN,AP,40002511,9000,900,,,,,,,SB,10/08/2018,10/08/2018,16.95,,0.00,,471.83
,IN,AP,40002860,9000,900,,Invoice,,,,,,01/10/2018,01/10/2018,26.36,,0.00,,498.19
,IN,AP,40002868,9000,900,,Invoice,,,,,,18/10/2018,18/10/2018,8.47,,0.00,,506.66
,IN,AP,40002873,9000,900,,Invoice,,,,,,22/10/2018,22/10/2018,25.42,,0.00,,532.08
,IN,AP,40002859,9000,900,,Invoice,,,,,,26/10/2018,26/10/2018,16.95,,0.00,,549.03
,IN,AP,40002858,9000,900,,Invoice,,,,,,27/10/2018,27/10/2018,8.47,,0.00,,557.50
,IN,AP,40002874,9000,900,,Invoice,,,,,,30/10/2018,30/10/2018,25.42,,0.00,,582.92
,IN,AP,40002867,9000,900,,Invoice,,,,,,06/11/2018,06/11/2018,8.47,,0.00,,591.39
,IN,AP,40002876,9000,900,,Invoice,,,,,,08/11/2018,08/11/2018,25.42,,0.00,,616.81
,IN,AP,40002878,9000,900,,Invoice,,,,,,12/11/2018,12/11/2018,8.47,,0.00,,625.28
,IN,AP,40002879,9000,900,,Invoice,,,,,,12/11/2018,12/11/2018,16.95,,0.00,,642.23
,IN,AP,40002881,9000,900,,Invoice,,,,,,12/11/2018,12/11/2018,16.95,,0.00,,659.18
,IN,AP,40002882,9000,900,,Invoice,,,,,,13/11/2018,13/11/2018,16.95,,0.00,,676.13
,IN,AP,40002883,9000,900,,Invoice,,,,,,13/11/2018,13/11/2018,16.95,,0.00,,693.08
,IN,AP,40002884,9000,900,,Invoice,,,,,,13/11/2018,13/11/2018,25.42,,0.00,,718.50
,IN,AP,40003134,9000,900,,Invoice,,,,,,15/11/2018,15/11/2018,25.42,,0.00,,743.92
,IN,AP,40002890,9000,900,,Invoice,,,,,,22/11/2018,22/11/2018,24.58,,0.00,,768.50
,IN,AP,40002891,9000,900,,Invoice,,,,,,22/11/2018,22/11/2018,25.42,,0.00,,793.92
,IN,AP,40002894,9000,900,,Invoice,,,,,,29/11/2018,29/11/2018,37.46,,0.00,,831.38
,IN,AP,40002895,9000,900,,Invoice,,,,,,30/11/2018,30/11/2018,25.42,,0.00,,856.80
,IN,AP,40002896,9000,900,,Invoice,,,,,,30/11/2018,30/11/2018,16.95,,0.00,,873.75
,IN,AP,40003106,9000,900,,Invoice,,,,,,18/12/2018,18/12/2018,16.95,,0.00,,890.70
,IN,AP,40003135,9000,900,,Invoice,,,,,,19/12/2018,19/12/2018,25.42,,0.00,,916.12
,IN,AP,40003234,9000,900,,Invoice,,,,,,24/12/2018,24/12/2018,16.95,,0.00,,933.07
,IN,AP,40003253,9000,900,,Invoice,,,,,,27/12/2018,27/12/2018,16.95,,0.00,,950.02
,,,,,,,,,,,,,,,,,,,
,Account: 4500130 - Repairs & Maintainence - Light Vehicles,,,,,,,,,,,,,,,,,,
,Pr.,Mod.,Reference,Dept,Div,Suffix,Details,,,Cheque,,User,Doc Date,Post Date,Debit,,Credit,,Balance
,,,,,,Opening Balance as at :01/01/2018,,,,,,,,,0.00,,0.00,,0.00
,IN,AP,40003669,9000,900,,Invoice,,,,,,02/01/2018,02/01/2018,80.00,,0.00,,80.00
,IN,AP,40001734,9000,900,GBN146,Front Wipers,,,,,SB,12/02/2018,12/02/2018,22.03,,0.00,,102.03
,IN,AP,40001822,9000,900,,Invoice,,,,,SB,03/04/2018,03/04/2018,4.24,,0.00,,106.27
,IN,AP,40002139,9000,900,,Invoice,,,,,SB,04/04/2018,04/04/2018,6.10,,0.00,,112.37
,IN,AP,40002130,9000,900,,Puncher,,,,,SB,09/04/2018,09/04/2018,11.86,,0.00,,124.23
,IN,AP,40002109,9000,900,LDB269,Invoice,,,,,SB,02/05/2018,02/05/2018,402.39,,0.00,,526.62
,IN,AP,40002331,9000,900,,Repair -,,,,,SB,03/05/2018,03/05/2018,240.00,,0.00,,766.62
,IN,AP,40002330,9000,900,,Skoda Felicia,,,,,SB,04/06/2018,04/06/2018,266.95,,0.00,,"1,033.57"
,IN,AP,40002849,9000,900,,Invoice,,,,,,19/06/2018,19/06/2018,65.00,,0.00,,"1,098.57"
,IN,AP,40003103,9000,900,,Invoice,,,,,,21/06/2018,21/06/2018,340.10,,0.00,,"1,438.67"
,IN,AP,40002641,9000,900,,Repair On Toyota Vitz BBV359,,,,,SB,02/08/2018,02/08/2018,450.00,,0.00,,"1,888.67"
,IN,AP,40002817,9000,900,,Invoice,,,,,,07/08/2018,07/08/2018,144.07,,0.00,,"2,032.74"
,IN,AP,40003104,9000,900,,Invoice,,,,,,13/08/2018,13/08/2018,979.92,,0.00,,"3,012.66"
,IN,AP,40002815,9000,900,,Invoice,,,,,,13/09/2018,13/09/2018,280.00,,0.00,,"3,292.66"
,IN,AP,40002640,9000,900,,Panel Beating (Hyundai Lantra PIC035),,,,,SB,27/09/2018,27/09/2018,118.64,,0.00,,"3,411.30"
,IN,AP,40002848,9000,900,,Invocie,,,,,,11/10/2018,11/10/2018,250.00,,0.00,,"3,661.30"
,IN,AP,40002846,9000,900,,Invoice,,,,,,16/10/2018,16/10/2018,347.99,,0.00,,"4,009.29"
,IN,AP,40002850,9000,900,,Invoice,,,,,,17/10/2018,17/10/2018,7.63,,0.00,,"4,016.92"
,IN,AP,40002854,9000,900,,Invoice,,,,,,17/10/2018,17/10/2018,33.90,,0.00,,"4,050.82"
,IN,AP,40002843,9000,900,,Invoice,,,,,,22/10/2018,22/10/2018,274.44,,0.00,,"4,325.26"
,IN,AP,40002847,9000,900,,Invoice,,,,,,24/10/2018,24/10/2018,150.00,,0.00,,"4,475.26"
,IN,AP,40002841,9000,900,,Invoice,,,,,,01/11/2018,01/11/2018,28.85,,0.00,,"4,504.11"
,IN,AP,40002875,9000,900,,Invoice,,,,,,03/11/2018,03/11/2018,6.36,,0.00,,"4,510.47"
,IN,AP,40002872,9000,900,,Invoice,,,,,,05/11/2018,05/11/2018,4.24,,0.00,,"4,514.71"
,IN,AP,40002877,9000,900,,Invoice,,,,,,06/11/2018,06/11/2018,30.00,,0.00,,"4,544.71"
,IN,AP,40002789,9000,900,,Invoice,,,,,,07/11/2018,07/11/2018,21.65,,0.00,,"4,566.36"
,IN,AP,40002845,9000,900,,Invoice,,,,,,08/11/2018,08/11/2018,275.00,,0.00,,"4,841.36"
,IN,AP,40002885,9000,900,,Invoice,,,,,,21/11/2018,21/11/2018,50.85,,0.00,,"4,892.21"
,IN,AP,40002844,9000,900,,Invoice,,,,,,22/11/2018,22/11/2018,21.19,,0.00,,"4,913.40"
,IN,AP,40003108,9000,900,,Invoice,,,,,,19/12/2018,19/12/2018,42.37,,0.00,,"4,955.77"
,IN,AP,40003101,9000,900,,Invoice,,,,,,20/12/2018,20/12/2018,233.05,,0.00,,"5,188.82"
,IN,AP,40003107,9000,900,,Invoice,,,,,,21/12/2018,21/12/2018,60.00,,0.00,,"5,248.82"
,IN,AP,40003097,9000,900,,Invoice,,,,,,24/12/2018,24/12/2018,234.00,,0.00,,"5,482.82"
,IN,AP,40003100,9000,900,,Invoice,,,,,,27/12/2018,27/12/2018,67.80,,0.00,,"5,550.62"
,,,,,,,,,,,,,,,,,,,
,Account: 4500140 - Repairs & Maintainence - General,,,,,,,,,,,,,,,,,,
,Pr.,Mod.,Reference,Dept,Div,Suffix,Details,,,Cheque,,User,Doc Date,Post Date,Debit,,Credit,,Balance
,,,,,,Opening Balance as at :01/01/2018,,,,,,,,,0.00,,0.00,,0.00
,IN,AP,40002138,9000,900,,Grinding Paste,,,,,SB,02/04/2018,02/04/2018,3.05,,0.00,,3.05
,IN,AP,40002141,9000,900,,Pedal Bin,,,,,SB,02/04/2018,02/04/2018,10.93,,0.00,,13.98
,,,,,,,,,,,,,,,,,,,
,Account: 4500141 - Fines - Traffic Contraventions,,,,,,,,,,,,,,,,,,
,Pr.,Mod.,Reference,Dept,Div,Suffix,Details,,,Cheque,,User,Doc Date,Post Date,Debit,,Credit,,Balance
,,,,,,Opening Balance as at :01/01/2018,,,,,,,,,0.00,,0.00,,0.00
,IN,AP,40001737,9000,900,GBN685,Contravening Traffic Sign,,,,,SB,02/01/2018,02/01/2018,58.00,,0.00,,58.00
,IN,AP,40001738,9000,900,IBL613,Parking Within 5mtr Of Corner,,,,,SB,02/01/2018,02/01/2018,23.29,,0.00,,81.29
,IN,AP,40001739,9000,900,GBN685,Parking On The Pavement,,,,,SB,02/01/2018,02/01/2018,23.29,,0.00,,104.58
,JN,GL,22000019,9000,900,,Fines,,,1900,,SB,22/02/2018,22/02/2018,378.82,,0.00,,483.40
,IN,AP,40003642,9000,900,,Invoice,,,,,,12/03/2018,12/03/2018,23.30,,0.00,,506.70
,IN,AP,40002259,9000,900,,Gbn 685,,,,,SB,14/05/2018,14/05/2018,23.29,,0.00,,529.99
,IN,AP,40002260,9000,900,,Andrej - Paid From Last Wage,,,,,SB,01/06/2018,01/06/2018,23.29,,0.00,,553.28
,IN,AP,40002261,9000,900,,Gbn 685,,,,,SB,01/06/2018,01/06/2018,34.94,,0.00,,588.22
,IN,AP,40002258,9000,900,IBL613,Invoice,,,,,SB,09/06/2018,09/06/2018,19.74,,0.00,,607.96
,IN,AP,40002648,9000,900,,608-74115-7 Zqz84,,,,,SB,31/08/2018,31/08/2018,56.43,,0.00,,664.39
,,,,,,,,,,,,,,,,,,,
,Account: 4550100 - Audit Fees,,,,,,,,,,,,,,,,,,
,Pr.,Mod.,Reference,Dept,Div,Suffix,Details,,,Cheque,,User,Doc Date,Post Date,Debit,,Credit,,Balance
,JN,GL,22000457,1001,100,,Audit Fee Accrual,,,,,,31/12/2018,31/12/2018,"1,200.00",,0.00,,"1,200.00"
,,,,,,,,,,,,,,,,,,,
,Account: 4550110 - Accountancy Fees,,,,,,,,,,,,,,,,,,
,Pr.,Mod.,Reference,Dept,Div,Suffix,Details,,,Cheque,,User,Doc Date,Post Date,Debit,,Credit,,Balance
,,,,,,Opening Balance as at :01/01/2018,,,,,,,,,0.00,,0.00,,0.00
,JN,GL,22000456,1001,100,,Opening Balance,,,,,,01/01/2018,01/01/2018,0.00,,"1,400.00",,"-1,400.00"
,JN,GL,22000456,1001,100,,Opening Balance,,,,,,01/01/2018,01/01/2018,0.00,,"1,200.00",,"-2,600.00"
,IN,AP,40001724,9000,900,,Invoice,,,,,SB,29/01/2018,29/01/2018,"1,400.00",,0.00,,"-1,200.00"
,IN,AP,40002150,9000,900,,June 2018 - May 2019,,,,,SB,14/05/2018,14/05/2018,220.00,,0.00,,-980.00
,IN,AP,40002352,9000,900,,Certificates,,,,,SB,05/07/2018,05/07/2018,5.00,,0.00,,-975.00
,IN,AP,40002799,9000,900,,Invoice,,,,,,31/10/2018,31/10/2018,"1,500.00",,0.00,,525.00
,JN,GL,22000458,1001,100,,Journal Entry,,,,,,31/10/2018,31/10/2018,"1,660.00",,0.00,,"2,185.00"
,,,,,,,,,,,,,,,,,,,
,Account: 4550131 - Legal Fees,,,,,,,,,,,,,,,,,,
,Pr.,Mod.,Reference,Dept,Div,Suffix,Details,,,Cheque,,User,Doc Date,Post Date,Debit,,Credit,,Balance
,IN,AP,40001726,9000,900,,Invoice,,,,,SB,16/02/2018,16/02/2018,200.00,,0.00,,200.00
,IN,AP,40002717,9000,900,,Fees And Disbursements For Legal Services,,,,,SB,12/10/2018,12/10/2018,620.00,,0.00,,820.00
,,,,,,,,,,,,,,,,,,,
,Account: 4600130 - Fines,,,,,,,,,,,,,,,,,,
,Pr.,Mod.,Reference,Dept,Div,Suffix,Details,,,Cheque,,User,Doc Date,Post Date,Debit,,Credit,,Balance
,IN,AP,40002547,9000,900,,Invoice,,,,,SB,22/08/2018,22/08/2018,23.29,,0.00,,23.29
,,,,,,,,,,,,,,,,,,,
,Account: 4650100 - Sponsorships,,,,,,,,,,,,,,,,,,
,Pr.,Mod.,Reference,Dept,Div,Suffix,Details,,,Cheque,,User,Doc Date,Post Date,Debit,,Credit,,Balance
,IN,AP,40001836,9000,900,,Invoice,,,,,SB,10/04/2018,10/04/2018,250.00,,0.00,,250.00
,,,,,,,,,,,,,,,,,,,
,Account: 4650130 - Subscriptions,,,,,,,,,,,,,,,,,,
,Pr.,Mod.,Reference,Dept,Div,Suffix,Details,,,Cheque,,User,Doc Date,Post Date,Debit,,Credit,,Balance
,JN,GL,22000456,1001,100,,Opening Balance,,,,,,01/01/2018,01/01/2018,0.00,,400.00,,-400.00
,IN,AP,40001808,9000,900,,2017-2018,,,,,SB,02/01/2018,02/01/2018,23.29,,0.00,,-376.71
,IN,AP,40001809,9000,900,,2016-2017,,,,,SB,02/01/2018,02/01/2018,23.29,,0.00,,-353.42
,IN,AP,40001789,9000,900,,Invoice,,,,,SB,26/02/2018,26/02/2018,127.65,,0.00,,-225.77
,IN,AP,40003647,9000,900,,Invoice,,,,,,21/05/2018,21/05/2018,400.00,,0.00,,174.23
,JN,GL,22000457,1001,100,,Annual Return,,,,,,31/12/2018,31/12/2018,400.00,,0.00,,574.23
,,,,,,,,,,,,,,,,,,,
,Account: 4800100 - Freight,,,,,,,,,,,,,,,,,,
,Pr.,Mod.,Reference,Dept,Div,Suffix,Details,,,Cheque,,User,Doc Date,Post Date,Debit,,Credit,,Balance
,,,,,,Opening Balance as at :01/01/2018,,,,,,,,,0.00,,0.00,,0.00
,IN,AP,40001753,9000,900,,Invoice,,,,,SB,24/01/2018,24/01/2018,254.25,,0.00,,254.25
,JN,GL,22000017,1001,100,,Container Deposit,,,2978,,SB,25/01/2018,25/01/2018,360.00,,0.00,,614.25
,IN,AP,40002048,9000,900,,Invoice,,,,,SB,31/01/2018,31/01/2018,617.38,,0.00,,"1,231.63"
,IN,AP,40001755,9000,900,,Invoice,,,,,SB,27/02/2018,27/02/2018,404.26,,0.00,,"1,635.89"
,IN,AP,40002050,9000,900,,Invoice,,,,,SB,28/02/2018,28/02/2018,268.00,,0.00,,"1,903.89"
,IN,AP,40002043,9000,900,,Invoice,,,,,SB,14/03/2018,14/03/2018,250.00,,0.00,,"2,153.89"
,IN,AP,40002044,9000,900,,Invoice,,,,,SB,14/03/2018,14/03/2018,10.00,,0.00,,"2,163.89"
,,,,,,,,,,,,,,,,,,,
,IN,AP,40002116,9000,900,,TR1406,,,,,SB,24/04/2018,24/04/2018,259.36,,0.00,,"2,423.25"
,IN,AP,40002329,9000,900,,Kim198,,,,,SB,21/06/2018,21/06/2018,41.22,,0.00,,"2,464.47"
,IN,AP,40002520,9000,900,,Invoice,,,,,SB,09/08/2018,09/08/2018,172.00,,0.00,,"2,636.47"
,IN,AP,40002516,9000,900,,CAFFE X2 PLTS,,,,,SB,10/08/2018,10/08/2018,258.43,,0.00,,"2,894.90"
,IN,AP,40002523,9000,900,,Invoice,,,,,SB,10/08/2018,10/08/2018,150.00,,0.00,,"3,044.90"
,IN,AP,40002650,9000,900,,Transport Tnt,,,,,SB,12/09/2018,12/09/2018,175.00,,0.00,,"3,219.90"
,IN,AP,40002861,9000,900,,Invoice,,,,,,18/10/2018,18/10/2018,5.93,,0.00,,"3,225.83"
,IN,AP,40003094,9000,900,,Invoice,,,,,,27/12/2018,27/12/2018,183.00,,0.00,,"3,408.83"
,IN,AP,40003240,9000,900,,Invoice,,,,,,28/12/2018,28/12/2018,5.93,,0.00,,"3,414.76"
,,,,,,,,,,,,,,,,,,,
,Account: 4800101 - Demurrage Charge,,,,,,,,,,,,,,,,,,
,Pr.,Mod.,Reference,Dept,Div,Suffix,Details,,,Cheque,,User,Doc Date,Post Date,Debit,,Credit,,Balance
,IN,AP,40002520,9000,900,,TRHU3750693 Demurrage,,,,,SB,09/08/2018,09/08/2018,120.00,,0.00,,120.00
,IN,AP,40002523,9000,900,,CRSU 1448613,,,,,SB,10/08/2018,10/08/2018,125.00,,0.00,,245.00
,JN,GL,22000059,1001,100,,Demurrage Fee CRSU1448613,,,13085,,SB,31/08/2018,31/08/2018,0.00,,89.60,,155.40
,,,,,,,,,,,,,,,,,,,
,Account: 5000100 - Bank Charges,,,,,,,,,,,,,,,,,,
,Pr.,Mod.,Reference,Dept,Div,Suffix,Details,,,Cheque,,User,Doc Date,Post Date,Debit,,Credit,,Balance
,,,,,,Opening Balance as at :01/01/2018,,,,,,,,,0.00,,0.00,,0.00
,JN,GL,22000369,1001,100,,Journal Entry,,,,,,05/01/2018,05/01/2018,7.01,,0.00,,7.01
,JN,GL,22000107,1001,100,,Journal Entry,,,,,,23/01/2018,23/01/2018,8.00,,0.00,,15.01
,JN,GL,22000370,1001,100,,Journal Entry,,,,,,29/01/2018,29/01/2018,48.74,,0.00,,63.75
,JN,GL,22000123,1001,100,,Journal Entry,,,,,,02/02/2018,02/02/2018,4.00,,0.00,,67.75
,JN,GL,22000371,1001,100,,Journal Entry,,,,,,12/02/2018,12/02/2018,25.02,,0.00,,92.77
,JN,GL,22000146,1001,100,,Journal Entry,,,,,,02/03/2018,02/03/2018,23.29,,0.00,,116.06
,JN,GL,22000372,1001,100,,Journal Entry,,,,,,02/03/2018,02/03/2018,67.41,,0.00,,183.47
,JN,GL,22000418,1001,100,,Journal Entry,,,,,,02/03/2018,02/03/2018,23.29,,0.00,,206.76
,JN,GL,22000373,1001,100,,Journal Entry,,,,,,20/03/2018,20/03/2018,66.91,,0.00,,273.67
,JN,GL,22000158,1001,100,,Journal Entry,,,,,,23/03/2018,23/03/2018,1.00,,0.00,,274.67
,JN,GL,22000160,1001,100,,Journal Entry,,,,,,23/03/2018,23/03/2018,1.00,,0.00,,275.67
,JN,GL,22000374,1001,100,,Journal Entry,,,,,,27/03/2018,27/03/2018,37.46,,0.00,,313.13
,JN,GL,22000420,1001,100,,Journal Entry,,,,,,29/03/2018,29/03/2018,4.66,,0.00,,317.79
,JN,GL,22000175,1001,100,,Journal Entry,,,,,,10/04/2018,10/04/2018,8.00,,0.00,,325.79
,JN,GL,22000375,1001,100,,Journal Entry,,,,,,25/04/2018,25/04/2018,46.05,,0.00,,371.84
,JN,GL,22000188,1001,100,,Journal Entry,,,,,,26/04/2018,26/04/2018,21.00,,0.00,,392.84
,JN,GL,22000191,1001,100,,Journal Entry,,,,,,03/05/2018,03/05/2018,1.00,,0.00,,393.84
,JN,GL,22000434,1001,100,,Journal Entry,,,,,,04/05/2018,04/05/2018,15.00,,0.00,,408.84
,JN,GL,22000194,1001,100,,Journal Entry,,,,,,09/05/2018,09/05/2018,1.00,,0.00,,409.84
,JN,GL,22000376,1001,100,,Journal Entry,,,,,,10/05/2018,10/05/2018,41.16,,0.00,,451.00
,JN,GL,22000402,1001,100,,Journal Entry,,,,,,11/05/2018,11/05/2018,15.04,,0.00,,466.04
,JN,GL,22000197,1001,100,,Journal Entry,,,,,,15/05/2018,15/05/2018,20.00,,0.00,,486.04
,JN,GL,22000377,1001,100,,Journal Entry,,,,,,18/05/2018,18/05/2018,13.59,,0.00,,499.63
,JN,GL,22000200,1001,100,,Journal Entry,,,,,,21/05/2018,21/05/2018,1.00,,0.00,,500.63
,JN,GL,22000378,1001,100,,Journal Entry,,,,,,25/05/2018,25/05/2018,67.19,,0.00,,567.82
,JN,GL,22000210,1001,100,,Journal Entry,,,,,,08/06/2018,08/06/2018,1.00,,0.00,,568.82
,JN,GL,22000380,1001,100,,Journal Entry,,,,,,11/06/2018,11/06/2018,63.09,,0.00,,631.91
,JN,GL,22000404,1001,100,,Journal Entry,,,,,,13/06/2018,13/06/2018,11.75,,0.00,,643.66
,JN,GL,22000215,1001,100,,Journal Entry,,,,,,19/06/2018,19/06/2018,20.00,,0.00,,663.66
,JN,GL,22000383,1001,100,,Journal Entry,,,,,,26/06/2018,26/06/2018,82.37,,0.00,,746.03
,JN,GL,22000384,1001,100,,Journal Entry,,,,,,09/07/2018,09/07/2018,46.70,,0.00,,792.73
,JN,GL,22000262,1001,100,,Journal Entry,,,,,,10/07/2018,10/07/2018,4.00,,0.00,,796.73
,JN,GL,22000385,1001,100,,Journal Entry,,,,,,24/07/2018,24/07/2018,88.28,,0.00,,885.01
,JN,GL,22000406,1001,100,,Journal Entry,,,,,,27/07/2018,27/07/2018,11.75,,0.00,,896.76
,JN,GL,22000274,1001,100,,Journal Entry,,,,,,31/07/2018,31/07/2018,4.00,,0.00,,900.76
,JN,GL,22000408,1001,100,,Journal Entry,,,,,,02/08/2018,02/08/2018,14.10,,0.00,,914.86
,IN,AP,40002425,9000,900,,SEPTEMBER 2017 TO AUGUST 2018,,,,,SB,07/08/2018,07/08/2018,180.00,,0.00,,"1,094.86"
,JN,GL,22000386,1001,100,,Journal Entry,,,,,,24/08/2018,24/08/2018,76.16,,0.00,,"1,171.02"
,JN,GL,22000292,1001,100,,Journal Entry,,,,,,28/08/2018,28/08/2018,4.00,,0.00,,"1,175.02"
,IN,AP,40003089,9000,900,,Invoice,,,,,,30/08/2018,30/08/2018,69.06,,0.00,,"1,244.08"
,JN,GL,22000388,1001,100,,Journal Entry,,,,,,31/08/2018,31/08/2018,72.30,,0.00,,"1,316.38"
,JN,GL,22000305,1001,100,,Journal Entry,,,,,,17/09/2018,17/09/2018,4.00,,0.00,,"1,320.38"
,JN,GL,22000306,1001,100,,Journal Entry,,,,,,18/09/2018,18/09/2018,4.00,,0.00,,"1,324.38"
,JN,GL,22000389,1001,100,,Journal Entry,,,,,,20/09/2018,20/09/2018,85.78,,0.00,,"1,410.16"
,JN,GL,22000309,1001,100,,Journal Entry,,,,,,25/09/2018,25/09/2018,1.00,,0.00,,"1,411.16"
,JN,GL,22000062,1001,100,,Bank Charges 100 Night Safe Bags,,,DD,,SB,27/09/2018,27/09/2018,15.00,,0.00,,"1,426.16"
,JN,GL,22000312,1001,100,,Journal Entry,,,,,,28/09/2018,28/09/2018,8.00,,0.00,,"1,434.16"
,JN,GL,22000428,1001,100,,Journal Entry,,,,,,29/09/2018,29/09/2018,4.66,,0.00,,"1,438.82"
,JN,GL,22000411,1001,100,,Journal Entry,,,,,,03/10/2018,03/10/2018,17.86,,0.00,,"1,456.68"
,JN,GL,22000391,1001,100,,Journal Entry,,,,,,10/10/2018,10/10/2018,108.37,,0.00,,"1,565.05"
,JN,GL,22000327,1001,100,,Journal Entry,,,,,,16/10/2018,16/10/2018,27.49,,0.00,,"1,592.54"
,JN,GL,22000328,1001,100,,Journal Entry,,,,,,18/10/2018,18/10/2018,1.00,,0.00,,"1,593.54"
,JN,GL,22000334,1001,100,,Journal Entry,,,,,,26/10/2018,26/10/2018,4.00,,0.00,,"1,597.54"
,JN,GL,22000392,1001,100,,Journal Entry,,,,,,31/10/2018,31/10/2018,73.73,,0.00,,"1,671.27"
,JN,GL,22000413,1001,100,,Journal Entry,,,,,,31/10/2018,31/10/2018,20.21,,0.00,,"1,691.48"
,JN,GL,22000341,1001,100,,Journal Entry,,,,,,05/11/2018,05/11/2018,1.00,,0.00,,"1,692.48"
,JN,GL,22000344,1001,100,,Journal Entry,,,,,,09/11/2018,09/11/2018,1.00,,0.00,,"1,693.48"
,JN,GL,22000393,1001,100,,Journal Entry,,,,,,13/11/2018,13/11/2018,97.46,,0.00,,"1,790.94"
,JN,GL,22000395,1001,100,,Journal Entry,,,,,,28/11/2018,28/11/2018,110.18,,0.00,,"1,901.12"
,JN,GL,22000415,1001,100,,Journal Entry,,,,,,05/12/2018,05/12/2018,16.45,,0.00,,"1,917.57"
,JN,GL,22000356,1001,100,,Journal Entry,,,,,,07/12/2018,07/12/2018,4.00,,0.00,,"1,921.57"
,IN,AP,40003277,9000,900,,Invoice,,,,,,19/12/2018,19/12/2018,76.74,,0.00,,"1,998.31"
,JN,GL,22000364,1001,100,,Journal Entry,,,,,,24/12/2018,24/12/2018,4.00,,0.00,,"2,002.31"
,JN,GL,22000364,1001,100,,Journal Entry,,,,,,24/12/2018,24/12/2018,1.00,,0.00,,"2,003.31"
,JN,GL,22000396,1001,100,,Journal Entry,,,,,,31/12/2018,31/12/2018,53.34,,0.00,,"2,056.65"
,JN,GL,22000435,1001,100,,Journal Entry,,,,,,31/12/2018,31/12/2018,10.00,,0.00,,"2,066.65"
,JN,GL,22000439,1001,100,,Journal Entry,,,,,,31/12/2018,31/12/2018,60.00,,0.00,,"2,126.65"
,JN,GL,22000439,1001,100,,Journal Entry,,,,,,31/12/2018,31/12/2018,50.00,,0.00,,"2,176.65"
,,,,,,,,,,,,,,,,,,,
,Account: 5000130 - Bank Charges - Other,,,,,,,,,,,,,,,,,,
,Pr.,Mod.,Reference,Dept,Div,Suffix,Details,,,Cheque,,User,Doc Date,Post Date,Debit,,Credit,,Balance
,,,,,,Opening Balance as at :01/01/2018,,,,,,,,,0.00,,0.00,,0.00
,IN,AP,40001750,9000,900,,Invoice,,,,,SB,19/02/2018,19/02/2018,54.36,,0.00,,54.36
,IN,AP,40002058,9000,900,,Payment For Jan & Feb '18,,,,,SB,13/04/2018,13/04/2018,35.64,,0.00,,90.00
,,,,,,,,,,,,,,,,,,,
,Account: 5100120 - Interest Received - Fixed Term Accounts,,,,,,,,,,,,,,,,,,
,Pr.,Mod.,Reference,Dept,Div,Suffix,Details,,,Cheque,,User,Doc Date,Post Date,Debit,,Credit,,Balance
,JN,GL,22000363,1001,100,,Journal Entry,,,,,,20/12/2018,20/12/2018,0.00,,8.05,,-8.05
,JN,GL,22000363,1001,100,,FWT On Interest,,,,,,20/12/2018,20/12/2018,1.20,,0.00,,-6.85
,JN,GL,22000396,1001,100,,Journal Entry,,,,,,31/12/2018,31/12/2018,0.00,,0.78,,-7.63
,JN,GL,22000396,1001,100,,Journal Entry,,,,,,31/12/2018,31/12/2018,0.11,,0.00,,-7.52
,JN,GL,22000439,1001,100,,Journal Entry,,,,,,31/12/2018,31/12/2018,0.00,,5.07,,-12.59
,JN,GL,22000439,1001,100,,Journal Entry,,,,,,31/12/2018,31/12/2018,0.76,,0.00,,-11.83
,,,,,,,,,,,,,,,,,,,
,Account: 5100130 - Interest Payable - Savings / Current Account,,,,,,,,,,,,,,,,,,
,Pr.,Mod.,Reference,Dept,Div,Suffix,Details,,,Cheque,,User,Doc Date,Post Date,Debit,,Credit,,Balance
,JN,GL,22000420,1001,100,,Journal Entry,,,,,,29/03/2018,29/03/2018,1.63,,0.00,,1.63
,JN,GL,22000435,1001,100,,Journal Entry,,,,,,31/12/2018,31/12/2018,0.01,,0.00,,1.64
,,,,,,,,,,,,,,,,,,,
,Account: 5300100 - DO NOT USE,,,,,,,,,,,,,,,,,,
,Pr.,Mod.,Reference,Dept,Div,Suffix,Details,,,Cheque,,User,Doc Date,Post Date,Debit,,Credit,,Balance
,JN,GL,22000072,1001,100,,Opening Balance,,,,,,01/01/2018,01/01/2018,0.00,,"13,630.26",,"-13,630.26"
,JN,GL,22000459,1001,100,,Journal Entry,,,,,,01/01/2018,01/01/2018,"13,630.26",,0.00,,0.00
,,,,,,,,,,,,,,,,,,,
,Account: 6030100 - Motor Vehicles - Heavy,,,,,,,,,,,,,,,,,,
,Pr.,Mod.,Reference,Dept,Div,Suffix,Details,,,Cheque,,User,Doc Date,Post Date,Debit,,Credit,,Balance
,JN,GL,22000072,0000,900,,Opening Balance,,,,,,01/01/2018,01/01/2018,"11,483.20",,0.00,,"11,483.20"
,,,,,,,,,,,,,,,,,,,
,,,,,,,,,,,,,,,,,,,
,Account: 6040100 - SAN GWANN FACTORY  - BUILDING OFFICE,,,,,,,,,,,,,,,,,,
,Pr.,Mod.,Reference,Dept,Div,Suffix,Details,,,Cheque,,User,Doc Date,Post Date,Debit,,Credit,,Balance
,,,,,,Opening Balance as at :01/01/2018,,,,,,,,,0.00,,0.00,,0.00
,,,,,,,,,,,,,,,,,,,
,Account: 6040101 - SAN GWANN FACTORY ELECTRICAL INSTALLATION,,,,,,,,,,,,,,,,,,
,Pr.,Mod.,Reference,Dept,Div,Suffix,Details,,,Cheque,,User,Doc Date,Post Date,Debit,,Credit,,Balance
,,,,,,Opening Balance as at :01/01/2018,,,,,,,,,0.00,,0.00,,0.00
,,,,,,,,,,,,,,,,,,,
,Account: 6040110 - SAN GWANN FACTORY - OFFICE EQUIPMENT,,,,,,,,,,,,,,,,,,
,Pr.,Mod.,Reference,Dept,Div,Suffix,Details,,,Cheque,,User,Doc Date,Post Date,Debit,,Credit,,Balance
,,,,,,Opening Balance as at :01/01/2018,,,,,,,,,0.00,,0.00,,0.00
,IN,AP,40001740,0000,900,,L1605,,,,,SB,31/01/2018,31/01/2018,337.00,,0.00,,337.00
,JN,GL,22000443,0000,900,,Journal Entry,,,,,,31/01/2018,31/01/2018,0.00,,337.00,,0.00
,,,,,,,,,,,,,,,,,,,
,Account: 6040131 - SAN GWANN FACTORY - PLANT & MACHINERY,,,,,,,,,,,,,,,,,,
,Pr.,Mod.,Reference,Dept,Div,Suffix,Details,,,Cheque,,User,Doc Date,Post Date,Debit,,Credit,,Balance
,,,,,,Opening Balance as at :01/01/2018,,,,,,,,,0.00,,0.00,,0.00
,,,,,,,,,,,,,,,,,,,
,Account: 6530100 - DEPRECIATION MOTOR VEHICLES - HEAVY,,,,,,,,,,,,,,,,,,
,Pr.,Mod.,Reference,Dept,Div,Suffix,Details,,,Cheque,,User,Doc Date,Post Date,Debit,,Credit,,Balance
,JN,GL,22000072,0000,900,,Opening Balance,,,,,,01/01/2018,01/01/2018,0.00,,"11,482.79",,"-11,482.79"
,,,,,,,,,,,,,,,,,,,
,Account: 6540110 - DEPRECIATION SAN GWANN FACTORY - OFFICE EQUI,,,,,,,,,,,,,,,,,,
,Pr.,Mod.,Reference,Dept,Div,Suffix,Details,,,Cheque,,User,Doc Date,Post Date,Debit,,Credit,,Balance
,,,,,,Opening Balance as at :01/01/2018,,,,,,,,,0.00,,0.00,,0.00
,,,,,,,,,,,,,,,,,,,
,,,,,,,,,,,,,,,,,,,
,,,,,,,,,,,,,,,,,,,
"Printed on Wed, September 18, 2019 at 10:57",,,,,,,,,,,,,,,,,,,
Page 1113 of 1113,,,,,,,,,,,,,,,,,,,
